LAUS_CODE	STATE_FIPS	COUNTY_FIPS	COUNTY	YEAR	ESTIMATED	LABOR_FORCE	EMPLOYED	UNEMPLOYED_LEVEL	UNEMPLOYED_RATE
CN0100100000000	01	001	Autauga County, AL	2001	NA	21955	21055	900	4.1
CN0100300000000	01	003	Baldwin County, AL	2001	NA	69161	66195	2966	4.3
CN0100500000000	01	005	Barbour County, AL	2001	NA	11250	10412	838	7.4
CN0100700000000	01	007	Bibb County, AL	2001	NA	9081	8468	613	6.8
CN0100900000000	01	009	Blount County, AL	2001	NA	25305	24393	912	3.6
CN0101100000000	01	011	Bullock County, AL	2001	NA	3912	3524	388	9.9
CN0101300000000	01	013	Butler County, AL	2001	NA	9003	8328	675	7.5
CN0101500000000	01	015	Calhoun County, AL	2001	NA	51578	48744	2834	5.5
CN0101700000000	01	017	Chambers County, AL	2001	NA	17424	16481	943	5.4
CN0101900000000	01	019	Cherokee County, AL	2001	NA	11339	10824	515	4.5
CN0102100000000	01	021	Chilton County, AL	2001	NA	19464	18533	931	4.8
CN0102300000000	01	023	Choctaw County, AL	2001	NA	5869	5452	417	7.1
CN0102500000000	01	025	Clarke County, AL	2001	NA	11019	9945	1074	9.7
CN0102700000000	01	027	Clay County, AL	2001	NA	6366	5981	385	6
CN0102900000000	01	029	Cleburne County, AL	2001	NA	6921	6559	362	5.2
CN0103100000000	01	031	Coffee County, AL	2001	NA	19276	18084	1192	6.2
CN0103300000000	01	033	Colbert County, AL	2001	NA	25609	23856	1753	6.8
CN0103500000000	01	035	Conecuh County, AL	2001	NA	5274	4890	384	7.3
CN0103700000000	01	037	Coosa County, AL	2001	NA	5300	4942	358	6.8
CN0103900000000	01	039	Covington County, AL	2001	NA	16846	15782	1064	6.3
CN0104100000000	01	041	Crenshaw County, AL	2001	NA	6000	5641	359	6
CN0104300000000	01	043	Cullman County, AL	2001	NA	37982	36230	1752	4.6
CN0104500000000	01	045	Dale County, AL	2001	NA	20127	19012	1115	5.5
CN0104700000000	01	047	Dallas County, AL	2001	NA	17483	15881	1602	9.2
CN0104900000000	01	049	DeKalb County, AL	2001	NA	32237	30689	1548	4.8
CN0105100000000	01	051	Elmore County, AL	2001	NA	31470	30138	1332	4.2
CN0105300000000	01	053	Escambia County, AL	2001	NA	15537	14585	952	6.1
CN0105500000000	01	055	Etowah County, AL	2001	NA	46764	43689	3075	6.6
CN0105700000000	01	057	Fayette County, AL	2001	NA	8145	7632	513	6.3
CN0105900000000	01	059	Franklin County, AL	2001	NA	13965	12902	1063	7.6
CN0106100000000	01	061	Geneva County, AL	2001	NA	12047	11276	771	6.4
CN0106300000000	01	063	Greene County, AL	2001	NA	3494	3245	249	7.1
CN0106500000000	01	065	Hale County, AL	2001	NA	7019	6513	506	7.2
CN0106700000000	01	067	Henry County, AL	2001	NA	7542	7137	405	5.4
CN0106900000000	01	069	Houston County, AL	2001	NA	44752	42833	1919	4.3
CN0107100000000	01	071	Jackson County, AL	2001	NA	27016	25256	1760	6.5
CN0107300000000	01	073	Jefferson County, AL	2001	NA	325883	311802	14081	4.3
CN0107500000000	01	075	Lamar County, AL	2001	NA	7220	6640	580	8
CN0107700000000	01	077	Lauderdale County, AL	2001	NA	42826	40026	2800	6.5
CN0107900000000	01	079	Lawrence County, AL	2001	NA	16521	15540	981	5.9
CN0108100000000	01	081	Lee County, AL	2001	NA	58218	55832	2386	4.1
CN0108300000000	01	083	Limestone County, AL	2001	NA	33256	31809	1447	4.4
CN0108500000000	01	085	Lowndes County, AL	2001	NA	5011	4650	361	7.2
CN0108700000000	01	087	Macon County, AL	2001	NA	8905	8389	516	5.8
CN0108900000000	01	089	Madison County, AL	2001	NA	149678	143919	5759	3.8
CN0109100000000	01	091	Marengo County, AL	2001	NA	8894	8365	529	5.9
CN0109300000000	01	093	Marion County, AL	2001	NA	12911	11793	1118	8.7
CN0109500000000	01	095	Marshall County, AL	2001	NA	39900	37697	2203	5.5
CN0109700000000	01	097	Mobile County, AL	2001	NA	183762	173439	10323	5.6
CN0109900000000	01	099	Monroe County, AL	2001	NA	9894	9180	714	7.2
CN0110100000000	01	101	Montgomery County, AL	2001	NA	104949	100201	4748	4.5
CN0110300000000	01	103	Morgan County, AL	2001	NA	56248	53372	2876	5.1
CN0110500000000	01	105	Perry County, AL	2001	NA	3873	3448	425	11
CN0110700000000	01	107	Pickens County, AL	2001	NA	8440	7732	708	8.4
CN0110900000000	01	109	Pike County, AL	2001	NA	13524	12806	718	5.3
CN0111100000000	01	111	Randolph County, AL	2001	NA	9927	9306	621	6.3
CN0111300000000	01	113	Russell County, AL	2001	NA	21461	20278	1183	5.5
CN0111500000000	01	115	St. Clair County, AL	2001	NA	31672	30347	1325	4.2
CN0111700000000	01	117	Shelby County, AL	2001	NA	84095	81644	2451	2.9
CN0111900000000	01	119	Sumter County, AL	2001	NA	5121	4690	431	8.4
CN0112100000000	01	121	Talladega County, AL	2001	NA	35832	33489	2343	6.5
CN0112300000000	01	123	Tallapoosa County, AL	2001	NA	19257	18117	1140	5.9
CN0112500000000	01	125	Tuscaloosa County, AL	2001	NA	81357	77953	3404	4.2
CN0112700000000	01	127	Walker County, AL	2001	NA	31227	29358	1869	6
CN0112900000000	01	129	Washington County, AL	2001	NA	7440	6776	664	8.9
CN0113100000000	01	131	Wilcox County, AL	2001	NA	3835	3448	387	10.1
CN0113300000000	01	133	Winston County, AL	2001	NA	10737	9732	1005	9.4
CN0201300000000	02	013	Aleutians East Borough, AK	2001	NA	1011	926	85	8.4
CN0201600000000	02	016	Aleutians West Census Area, AK	2001	NA	2636	2478	158	6
CN0202000000000	02	020	Anchorage Borough/municipality, AK	2001	NA	141933	134782	7151	5
CN0205000000000	02	050	Bethel Census Area, AK	2001	NA	6321	5688	633	10
CN0206000000000	02	060	Bristol Bay Borough, AK	2001	NA	947	895	52	5.5
CN0206800000000	02	068	Denali Borough, AK	2001	NA	1450	1355	95	6.6
CN0207000000000	02	070	Dillingham Census Area, AK	2001	NA	1914	1757	157	8.2
CN0209000000000	02	090	Fairbanks North Star Borough, AK	2001	NA	41423	38910	2513	6.1
CN0210000000000	02	100	Haines Borough, AK	2001	NA	1250	1125	125	10
CN0211000000000	02	110	Juneau Borough/city, AK	2001	NA	17986	17130	856	4.8
CN0212200000000	02	122	Kenai Peninsula Borough, AK	2001	NA	24340	22322	2018	8.3
CN0213000000000	02	130	Ketchikan Gateway Borough, AK	2001	NA	8136	7585	551	6.8
CN0215000000000	02	150	Kodiak Island Borough, AK	2001	NA	6446	5869	577	9
CN0215800000000	02	158	Kusilvak Census Area, AK	2001	NA	2346	1978	368	15.7
CN0216400000000	02	164	Lake and Peninsula Borough, AK	2001	NA	965	904	61	6.3
CN0217000000000	02	170	Matanuska-Susitna Borough, AK	2001	NA	29867	27719	2148	7.2
CN0218000000000	02	180	Nome Census Area, AK	2001	NA	3693	3329	364	9.9
CN0218500000000	02	185	North Slope Borough, AK	2001	NA	3712	3430	282	7.6
CN0218800000000	02	188	Northwest Arctic Borough, AK	2001	NA	3025	2722	303	10
CN0220100000000	02	201	Prince of Wales-Outer Ketchikan Census Area, AK	2001	NA	2362	1998	364	15.4
CN0222000000000	02	220	Sitka Borough/city, AK	2001	NA	4472	4257	215	4.8
CN0223200000000	02	232	Skagway-Hoonah-Angoon Census Area, AK	2001	NA	1842	1624	218	11.8
CN0224000000000	02	240	Southeast Fairbanks Census Area, AK	2001	NA	2128	1849	279	13.1
CN0226100000000	02	261	Valdez-Cordova Census Area, AK	2001	NA	5080	4635	445	8.8
CN0228000000000	02	280	Wrangell-Petersburg Census Area, AK	2001	NA	3039	2725	314	10.3
CN0228200000000	02	282	Yakutat Borough/city, AK	2001	NA	329	300	29	8.8
CN0229000000000	02	290	Yukon-Koyukuk Census Area, AK	2001	NA	2743	2439	304	11.1
CN0400100000000	04	001	Apache County, AZ	2001	NA	19191	17362	1829	9.5
CN0400300000000	04	003	Cochise County, AZ	2001	NA	50293	47830	2463	4.9
CN0400500000000	04	005	Coconino County, AZ	2001	NA	63573	60563	3010	4.7
CN0400700000000	04	007	Gila County, AZ	2001	NA	20408	19215	1193	5.8
CN0400900000000	04	009	Graham County, AZ	2001	NA	11910	11157	753	6.3
CN0401100000000	04	011	Greenlee County, AZ	2001	NA	3821	3545	276	7.2
CN0401200000000	04	012	La Paz County, AZ	2001	NA	7026	6554	472	6.7
CN0401300000000	04	013	Maricopa County, AZ	2001	NA	1655742	1586141	69601	4.2
CN0401500000000	04	015	Mohave County, AZ	2001	NA	72820	69294	3526	4.8
CN0401700000000	04	017	Navajo County, AZ	2001	NA	35144	32444	2700	7.7
CN0401900000000	04	019	Pima County, AZ	2001	NA	414956	396750	18206	4.4
CN0402100000000	04	021	Pinal County, AZ	2001	NA	71918	68013	3905	5.4
CN0402300000000	04	023	Santa Cruz County, AZ	2001	NA	15022	13693	1329	8.8
CN0402500000000	04	025	Yavapai County, AZ	2001	NA	78099	74599	3500	4.5
CN0402700000000	04	027	Yuma County, AZ	2001	NA	65360	54338	11022	16.9
CN0500100000000	05	001	Arkansas County, AR	2001	NA	10244	9762	482	4.7
CN0500300000000	05	003	Ashley County, AR	2001	NA	10282	9504	778	7.6
CN0500500000000	05	005	Baxter County, AR	2001	NA	16012	15126	886	5.5
CN0500700000000	05	007	Benton County, AR	2001	NA	79685	77285	2400	3
CN0500900000000	05	009	Boone County, AR	2001	NA	16006	15163	843	5.3
CN0501100000000	05	011	Bradley County, AR	2001	NA	5258	4875	383	7.3
CN0501300000000	05	013	Calhoun County, AR	2001	NA	2511	2367	144	5.7
CN0501500000000	05	015	Carroll County, AR	2001	NA	12881	12347	534	4.1
CN0501700000000	05	017	Chicot County, AR	2001	NA	5381	4901	480	8.9
CN0501900000000	05	019	Clark County, AR	2001	NA	11206	10679	527	4.7
CN0502100000000	05	021	Clay County, AR	2001	NA	7766	7215	551	7.1
CN0502300000000	05	023	Cleburne County, AR	2001	NA	10710	10196	514	4.8
CN0502500000000	05	025	Cleveland County, AR	2001	NA	3904	3679	225	5.8
CN0502700000000	05	027	Columbia County, AR	2001	NA	11035	10454	581	5.3
CN0502900000000	05	029	Conway County, AR	2001	NA	9334	8870	464	5
CN0503100000000	05	031	Craighead County, AR	2001	NA	41776	39812	1964	4.7
CN0503300000000	05	033	Crawford County, AR	2001	NA	24842	23801	1041	4.2
CN0503500000000	05	035	Crittenden County, AR	2001	NA	21470	20337	1133	5.3
CN0503700000000	05	037	Cross County, AR	2001	NA	8498	7994	504	5.9
CN0503900000000	05	039	Dallas County, AR	2001	NA	3776	3512	264	7
CN0504100000000	05	041	Desha County, AR	2001	NA	6217	5673	544	8.8
CN0504300000000	05	043	Drew County, AR	2001	NA	8436	7703	733	8.7
CN0504500000000	05	045	Faulkner County, AR	2001	NA	46067	43964	2103	4.6
CN0504700000000	05	047	Franklin County, AR	2001	NA	8031	7723	308	3.8
CN0504900000000	05	049	Fulton County, AR	2001	NA	4908	4656	252	5.1
CN0505100000000	05	051	Garland County, AR	2001	NA	37795	35958	1837	4.9
CN0505300000000	05	053	Grant County, AR	2001	NA	8132	7707	425	5.2
CN0505500000000	05	055	Greene County, AR	2001	NA	17411	16175	1236	7.1
CN0505700000000	05	057	Hempstead County, AR	2001	NA	10901	10386	515	4.7
CN0505900000000	05	059	Hot Spring County, AR	2001	NA	14092	13349	743	5.3
CN0506100000000	05	061	Howard County, AR	2001	NA	6405	6062	343	5.4
CN0506300000000	05	063	Independence County, AR	2001	NA	16927	15984	943	5.6
CN0506500000000	05	065	Izard County, AR	2001	NA	5053	4755	298	5.9
CN0506700000000	05	067	Jackson County, AR	2001	NA	7660	7077	583	7.6
CN0506900000000	05	069	Jefferson County, AR	2001	NA	35534	33068	2466	6.9
CN0507100000000	05	071	Johnson County, AR	2001	NA	10085	9600	485	4.8
CN0507300000000	05	073	Lafayette County, AR	2001	NA	3425	3247	178	5.2
CN0507500000000	05	075	Lawrence County, AR	2001	NA	7773	7253	520	6.7
CN0507700000000	05	077	Lee County, AR	2001	NA	3805	3452	353	9.3
CN0507900000000	05	079	Lincoln County, AR	2001	NA	5020	4656	364	7.3
CN0508100000000	05	081	Little River County, AR	2001	NA	6337	6073	264	4.2
CN0508300000000	05	083	Logan County, AR	2001	NA	9731	9233	498	5.1
CN0508500000000	05	085	Lonoke County, AR	2001	NA	26515	25486	1029	3.9
CN0508700000000	05	087	Madison County, AR	2001	NA	7013	6771	242	3.5
CN0508900000000	05	089	Marion County, AR	2001	NA	6528	6162	366	5.6
CN0509100000000	05	091	Miller County, AR	2001	NA	17989	17161	828	4.6
CN0509300000000	05	093	Mississippi County, AR	2001	NA	22107	19623	2484	11.2
CN0509500000000	05	095	Monroe County, AR	2001	NA	3992	3738	254	6.4
CN0509700000000	05	097	Montgomery County, AR	2001	NA	4070	3878	192	4.7
CN0509900000000	05	099	Nevada County, AR	2001	NA	4515	4296	219	4.9
CN0510100000000	05	101	Newton County, AR	2001	NA	3623	3424	199	5.5
CN0510300000000	05	103	Ouachita County, AR	2001	NA	12315	11398	917	7.4
CN0510500000000	05	105	Perry County, AR	2001	NA	4776	4516	260	5.4
CN0510700000000	05	107	Phillips County, AR	2001	NA	9395	8660	735	7.8
CN0510900000000	05	109	Pike County, AR	2001	NA	5343	5092	251	4.7
CN0511100000000	05	111	Poinsett County, AR	2001	NA	11318	10489	829	7.3
CN0511300000000	05	113	Polk County, AR	2001	NA	8934	8506	428	4.8
CN0511500000000	05	115	Pope County, AR	2001	NA	26523	25341	1182	4.5
CN0511700000000	05	117	Prairie County, AR	2001	NA	4354	4152	202	4.6
CN0511900000000	05	119	Pulaski County, AR	2001	NA	182147	174258	7889	4.3
CN0512100000000	05	121	Randolph County, AR	2001	NA	8157	7569	588	7.2
CN0512300000000	05	123	St. Francis County, AR	2001	NA	10726	9883	843	7.9
CN0512500000000	05	125	Saline County, AR	2001	NA	42614	41027	1587	3.7
CN0512700000000	05	127	Scott County, AR	2001	NA	4774	4575	199	4.2
CN0512900000000	05	129	Searcy County, AR	2001	NA	3225	3059	166	5.1
CN0513100000000	05	131	Sebastian County, AR	2001	NA	56227	53960	2267	4
CN0513300000000	05	133	Sevier County, AR	2001	NA	7284	6971	313	4.3
CN0513500000000	05	135	Sharp County, AR	2001	NA	6480	6074	406	6.3
CN0513700000000	05	137	Stone County, AR	2001	NA	4470	4216	254	5.7
CN0513900000000	05	139	Union County, AR	2001	NA	20173	19126	1047	5.2
CN0514100000000	05	141	Van Buren County, AR	2001	NA	6758	6332	426	6.3
CN0514300000000	05	143	Washington County, AR	2001	NA	84685	82066	2619	3.1
CN0514500000000	05	145	White County, AR	2001	NA	30498	28850	1648	5.4
CN0514700000000	05	147	Woodruff County, AR	2001	NA	3847	3595	252	6.6
CN0514900000000	05	149	Yell County, AR	2001	NA	9765	9392	373	3.8
CN0600100000000	06	001	Alameda County, CA	2001	NA	777742	740590	37152	4.8
CN0600300000000	06	003	Alpine County, CA	2001	NA	574	532	42	7.3
CN0600500000000	06	005	Amador County, CA	2001	NA	16133	15317	816	5.1
CN0600700000000	06	007	Butte County, CA	2001	NA	95129	88866	6263	6.6
CN0600900000000	06	009	Calaveras County, CA	2001	NA	19027	17987	1040	5.5
CN0601100000000	06	011	Colusa County, CA	2001	NA	9122	7954	1168	12.8
CN0601300000000	06	013	Contra Costa County, CA	2001	NA	508270	487694	20576	4
CN0601500000000	06	015	Del Norte County, CA	2001	NA	10213	9395	818	8
CN0601700000000	06	017	El Dorado County, CA	2001	NA	83987	80378	3609	4.3
CN0601900000000	06	019	Fresno County, CA	2001	NA	389457	347906	41551	10.7
CN0602100000000	06	021	Glenn County, CA	2001	NA	11229	10245	984	8.8
CN0602300000000	06	023	Humboldt County, CA	2001	NA	60390	56771	3619	6
CN0602500000000	06	025	Imperial County, CA	2001	NA	55538	46696	8842	15.9
CN0602700000000	06	027	Inyo County, CA	2001	NA	9027	8618	409	4.5
CN0602900000000	06	029	Kern County, CA	2001	NA	297710	272215	25495	8.6
CN0603100000000	06	031	Kings County, CA	2001	NA	50187	44823	5364	10.7
CN0603300000000	06	033	Lake County, CA	2001	NA	24768	23026	1742	7
CN0603500000000	06	035	Lassen County, CA	2001	NA	11665	10810	855	7.3
CN0603700000000	06	037	Los Angeles County, CA	2001	NA	4740529	4471537	268992	5.7
CN0603900000000	06	039	Madera County, CA	2001	NA	53905	48751	5154	9.6
CN0604100000000	06	041	Marin County, CA	2001	NA	139992	135077	4915	3.5
CN0604300000000	06	043	Mariposa County, CA	2001	NA	8475	7989	486	5.7
CN0604500000000	06	045	Mendocino County, CA	2001	NA	44626	41977	2649	5.9
CN0604700000000	06	047	Merced County, CA	2001	NA	91744	82427	9317	10.2
CN0604900000000	06	049	Modoc County, CA	2001	NA	3906	3635	271	6.9
CN0605100000000	06	051	Mono County, CA	2001	NA	7609	7253	356	4.7
CN0605300000000	06	053	Monterey County, CA	2001	NA	204638	188666	15972	7.8
CN0605500000000	06	055	Napa County, CA	2001	NA	70381	67829	2552	3.6
CN0605700000000	06	057	Nevada County, CA	2001	NA	46904	44847	2057	4.4
CN0605900000000	06	059	Orange County, CA	2001	NA	1511855	1452100	59755	4
CN0606100000000	06	061	Placer County, CA	2001	NA	138976	133402	5574	4
CN0606300000000	06	063	Plumas County, CA	2001	NA	9949	9194	755	7.6
CN0606500000000	06	065	Riverside County, CA	2001	NA	710475	671436	39039	5.5
CN0606700000000	06	067	Sacramento County, CA	2001	NA	624116	595878	28238	4.5
CN0606900000000	06	069	San Benito County, CA	2001	NA	27439	25697	1742	6.3
CN0607100000000	06	071	San Bernardino County, CA	2001	NA	762524	723879	38645	5.1
CN0607300000000	06	073	San Diego County, CA	2001	NA	1408427	1349524	58903	4.2
CN0607500000000	06	075	San Francisco County/city, CA	2001	NA	469037	445193	23844	5.1
CN0607700000000	06	077	San Joaquin County, CA	2001	NA	266043	246169	19874	7.5
CN0607900000000	06	079	San Luis Obispo County, CA	2001	NA	126060	120987	5073	4
CN0608100000000	06	081	San Mateo County, CA	2001	NA	392488	377527	14961	3.8
CN0608300000000	06	083	Santa Barbara County, CA	2001	NA	202857	193916	8941	4.4
CN0608500000000	06	085	Santa Clara County, CA	2001	NA	938612	891097	47515	5.1
CN0608700000000	06	087	Santa Cruz County, CA	2001	NA	150211	141618	8593	5.7
CN0608900000000	06	089	Shasta County, CA	2001	NA	77576	72656	4920	6.3
CN0609100000000	06	091	Sierra County, CA	2001	NA	1668	1542	126	7.6
CN0609300000000	06	093	Siskiyou County, CA	2001	NA	18959	17430	1529	8.1
CN0609500000000	06	095	Solano County, CA	2001	NA	196996	187928	9068	4.6
CN0609700000000	06	097	Sonoma County, CA	2001	NA	257645	248179	9466	3.7
CN0609900000000	06	099	Stanislaus County, CA	2001	NA	214093	196211	17882	8.4
CN0610100000000	06	101	Sutter County, CA	2001	NA	38423	34675	3748	9.8
CN0610300000000	06	103	Tehama County, CA	2001	NA	24552	22945	1607	6.5
CN0610500000000	06	105	Trinity County, CA	2001	NA	5389	4888	501	9.3
CN0610700000000	06	107	Tulare County, CA	2001	NA	175201	155174	20027	11.4
CN0610900000000	06	109	Tuolumne County, CA	2001	NA	23939	22537	1402	5.9
CN0611100000000	06	111	Ventura County, CA	2001	NA	398957	379622	19335	4.8
CN0611300000000	06	113	Yolo County, CA	2001	NA	88252	83734	4518	5.1
CN0611500000000	06	115	Yuba County, CA	2001	NA	24839	22723	2116	8.5
CN0800100000000	08	001	Adams County, CO	2001	NA	187343	179822	7521	4
CN0800300000000	08	003	Alamosa County, CO	2001	NA	7740	7413	327	4.2
CN0800500000000	08	005	Arapahoe County, CO	2001	NA	282082	271785	10297	3.7
CN0800700000000	08	007	Archuleta County, CO	2001	NA	5310	5100	210	4
CN0800900000000	08	009	Baca County, CO	2001	NA	2444	2371	73	3
CN0801100000000	08	011	Bent County, CO	2001	NA	2507	2399	108	4.3
CN0801300000000	08	013	Boulder County, CO	2001	NA	162354	156395	5959	3.7
CN0801400000000	08	014	Broomfield County/city, CO	2001	NA	22350	21541	809	3.6
CN0801500000000	08	015	Chaffee County, CO	2001	NA	7508	7208	300	4
CN0801700000000	08	017	Cheyenne County, CO	2001	NA	1282	1252	30	2.3
CN0801900000000	08	019	Clear Creek County, CO	2001	NA	5937	5738	199	3.4
CN0802100000000	08	021	Conejos County, CO	2001	NA	3597	3372	225	6.3
CN0802300000000	08	023	Costilla County, CO	2001	NA	1311	1202	109	8.3
CN0802500000000	08	025	Crowley County, CO	2001	NA	1532	1443	89	5.8
CN0802700000000	08	027	Custer County, CO	2001	NA	1791	1717	74	4.1
CN0802900000000	08	029	Delta County, CO	2001	NA	13324	12774	550	4.1
CN0803100000000	08	031	Denver County/city, CO	2001	NA	302235	288890	13345	4.4
CN0803300000000	08	033	Dolores County, CO	2001	NA	937	889	48	5.1
CN0803500000000	08	035	Douglas County, CO	2001	NA	113280	109647	3633	3.2
CN0803700000000	08	037	Eagle County, CO	2001	NA	26096	25294	802	3.1
CN0803900000000	08	039	Elbert County, CO	2001	NA	11951	11569	382	3.2
CN0804100000000	08	041	El Paso County, CO	2001	NA	268692	257415	11277	4.2
CN0804300000000	08	043	Fremont County, CO	2001	NA	18245	17328	917	5
CN0804500000000	08	045	Garfield County, CO	2001	NA	25581	24767	814	3.2
CN0804700000000	08	047	Gilpin County, CO	2001	NA	3235	3123	112	3.5
CN0804900000000	08	049	Grand County, CO	2001	NA	8035	7797	238	3
CN0805100000000	08	051	Gunnison County, CO	2001	NA	8333	8061	272	3.3
CN0805300000000	08	053	Hinsdale County, CO	2001	NA	649	627	22	3.4
CN0805500000000	08	055	Huerfano County, CO	2001	NA	3198	2995	203	6.3
CN0805700000000	08	057	Jackson County, CO	2001	NA	1037	1001	36	3.5
CN0805900000000	08	059	Jefferson County, CO	2001	NA	304238	293787	10451	3.4
CN0806100000000	08	061	Kiowa County, CO	2001	NA	936	910	26	2.8
CN0806300000000	08	063	Kit Carson County, CO	2001	NA	4307	4201	106	2.5
CN0806500000000	08	065	Lake County, CO	2001	NA	3991	3832	159	4
CN0806700000000	08	067	La Plata County, CO	2001	NA	25039	24235	804	3.2
CN0806900000000	08	069	Larimer County, CO	2001	NA	149756	144961	4795	3.2
CN0807100000000	08	071	Las Animas County, CO	2001	NA	7151	6825	326	4.6
CN0807300000000	08	073	Lincoln County, CO	2001	NA	2901	2814	87	3
CN0807500000000	08	075	Logan County, CO	2001	NA	10725	10387	338	3.2
CN0807700000000	08	077	Mesa County, CO	2001	NA	60299	57983	2316	3.8
CN0807900000000	08	079	Mineral County, CO	2001	NA	428	412	16	3.7
CN0808100000000	08	081	Moffat County, CO	2001	NA	7298	7014	284	3.9
CN0808300000000	08	083	Montezuma County, CO	2001	NA	11863	11342	521	4.4
CN0808500000000	08	085	Montrose County, CO	2001	NA	16922	16180	742	4.4
CN0808700000000	08	087	Morgan County, CO	2001	NA	13313	12888	425	3.2
CN0808900000000	08	089	Otero County, CO	2001	NA	9069	8648	421	4.6
CN0809100000000	08	091	Ouray County, CO	2001	NA	2335	2266	69	3
CN0809300000000	08	093	Park County, CO	2001	NA	8711	8410	301	3.5
CN0809500000000	08	095	Phillips County, CO	2001	NA	2377	2311	66	2.8
CN0809700000000	08	097	Pitkin County, CO	2001	NA	10195	9831	364	3.6
CN0809900000000	08	099	Prowers County, CO	2001	NA	7212	6982	230	3.2
CN0810100000000	08	101	Pueblo County, CO	2001	NA	64114	60806	3308	5.2
CN0810300000000	08	103	Rio Blanco County, CO	2001	NA	3483	3389	94	2.7
CN0810500000000	08	105	Rio Grande County, CO	2001	NA	6204	5869	335	5.4
CN0810700000000	08	107	Routt County, CO	2001	NA	13273	12893	380	2.9
CN0810900000000	08	109	Saguache County, CO	2001	NA	3040	2857	183	6
CN0811100000000	08	111	San Juan County, CO	2001	NA	515	480	35	6.8
CN0811300000000	08	113	San Miguel County, CO	2001	NA	4921	4735	186	3.8
CN0811500000000	08	115	Sedgwick County, CO	2001	NA	1545	1501	44	2.8
CN0811700000000	08	117	Summit County, CO	2001	NA	16139	15662	477	3
CN0811900000000	08	119	Teller County, CO	2001	NA	11992	11524	468	3.9
CN0812100000000	08	121	Washington County, CO	2001	NA	2823	2747	76	2.7
CN0812300000000	08	123	Weld County, CO	2001	NA	98046	94658	3388	3.5
CN0812500000000	08	125	Yuma County, CO	2001	NA	5977	5842	135	2.3
CN0900100000000	09	001	Fairfield County, CT	2001	NA	449338	435905	13433	3
CN0900300000000	09	003	Hartford County, CT	2001	NA	433800	419194	14606	3.4
CN0900500000000	09	005	Litchfield County, CT	2001	NA	100185	97263	2922	2.9
CN0900700000000	09	007	Middlesex County, CT	2001	NA	86623	84305	2318	2.7
CN0900900000000	09	009	New Haven County, CT	2001	NA	418502	404260	14242	3.4
CN0901100000000	09	011	New London County, CT	2001	NA	135726	131971	3755	2.8
CN0901300000000	09	013	Tolland County, CT	2001	NA	77035	75188	1847	2.4
CN0901500000000	09	015	Windham County, CT	2001	NA	58622	56689	1933	3.3
CN1000100000000	10	001	Kent County, DE	2001	NA	64923	62535	2388	3.7
CN1000300000000	10	003	New Castle County, DE	2001	NA	275308	265872	9436	3.4
CN1000500000000	10	005	Sussex County, DE	2001	NA	81555	78626	2929	3.6
CN1100100000000	11	001	District of Columbia	2001	NA	310515	290811	19704	6.3
CN1200100000000	12	001	Alachua County, FL	2001	NA	118547	114284	4263	3.6
CN1200300000000	12	003	Baker County, FL	2001	NA	10503	10060	443	4.2
CN1200500000000	12	005	Bay County, FL	2001	NA	72692	68857	3835	5.3
CN1200700000000	12	007	Bradford County, FL	2001	NA	10805	10313	492	4.6
CN1200900000000	12	009	Brevard County, FL	2001	NA	237019	226249	10770	4.5
CN1201100000000	12	011	Broward County, FL	2001	NA	887522	846010	41512	4.7
CN1201300000000	12	013	Calhoun County, FL	2001	NA	5248	4977	271	5.2
CN1201500000000	12	015	Charlotte County, FL	2001	NA	56187	53641	2546	4.5
CN1201700000000	12	017	Citrus County, FL	2001	NA	44653	42040	2613	5.9
CN1201900000000	12	019	Clay County, FL	2001	NA	75746	72749	2997	4
CN1202100000000	12	021	Collier County, FL	2001	NA	124316	119036	5280	4.2
CN1202300000000	12	023	Columbia County, FL	2001	NA	25903	24451	1452	5.6
CN1202700000000	12	027	DeSoto County, FL	2001	NA	13429	12744	685	5.1
CN1202900000000	12	029	Dixie County, FL	2001	NA	5273	4972	301	5.7
CN1203100000000	12	031	Duval County, FL	2001	NA	412753	394619	18134	4.4
CN1203300000000	12	033	Escambia County, FL	2001	NA	131677	125012	6665	5.1
CN1203500000000	12	035	Flagler County, FL	2001	NA	22175	21118	1057	4.8
CN1203700000000	12	037	Franklin County, FL	2001	NA	4600	4400	200	4.3
CN1203900000000	12	039	Gadsden County, FL	2001	NA	20290	19285	1005	5
CN1204100000000	12	041	Gilchrist County, FL	2001	NA	6589	6293	296	4.5
CN1204300000000	12	043	Glades County, FL	2001	NA	4329	4072	257	5.9
CN1204500000000	12	045	Gulf County, FL	2001	NA	5342	5025	317	5.9
CN1204700000000	12	047	Hamilton County, FL	2001	NA	4393	4052	341	7.8
CN1204900000000	12	049	Hardee County, FL	2001	NA	10778	10010	768	7.1
CN1205100000000	12	051	Hendry County, FL	2001	NA	17101	15770	1331	7.8
CN1205300000000	12	053	Hernando County, FL	2001	NA	50567	47829	2738	5.4
CN1205500000000	12	055	Highlands County, FL	2001	NA	34522	32679	1843	5.3
CN1205700000000	12	057	Hillsborough County, FL	2001	NA	539862	516621	23241	4.3
CN1205900000000	12	059	Holmes County, FL	2001	NA	7754	7271	483	6.2
CN1206100000000	12	061	Indian River County, FL	2001	NA	52803	49612	3191	6
CN1206300000000	12	063	Jackson County, FL	2001	NA	19641	18645	996	5.1
CN1206500000000	12	065	Jefferson County, FL	2001	NA	6318	6030	288	4.6
CN1206700000000	12	067	Lafayette County, FL	2001	NA	2663	2518	145	5.4
CN1206900000000	12	069	Lake County, FL	2001	NA	97392	92899	4493	4.6
CN1207100000000	12	071	Lee County, FL	2001	NA	219821	211335	8486	3.9
CN1207300000000	12	073	Leon County, FL	2001	NA	134525	129594	4931	3.7
CN1207500000000	12	075	Levy County, FL	2001	NA	14634	13865	769	5.3
CN1207700000000	12	077	Liberty County, FL	2001	NA	2706	2573	133	4.9
CN1207900000000	12	079	Madison County, FL	2001	NA	7412	7031	381	5.1
CN1208100000000	12	081	Manatee County, FL	2001	NA	125865	120586	5279	4.2
CN1208300000000	12	083	Marion County, FL	2001	NA	109925	104286	5639	5.1
CN1208500000000	12	085	Martin County, FL	2001	NA	58526	55511	3015	5.2
CN1208600000000	12	086	Miami-Dade County, FL	2001	NA	1104264	1049691	54573	4.9
CN1208700000000	12	087	Monroe County, FL	2001	NA	46671	45020	1651	3.5
CN1208900000000	12	089	Nassau County, FL	2001	NA	30728	29450	1278	4.2
CN1209100000000	12	091	Okaloosa County, FL	2001	NA	83055	79612	3443	4.1
CN1209300000000	12	093	Okeechobee County, FL	2001	NA	15675	14675	1000	6.4
CN1209500000000	12	095	Orange County, FL	2001	NA	509594	487402	22192	4.4
CN1209700000000	12	097	Osceola County, FL	2001	NA	93700	89394	4306	4.6
CN1209900000000	12	099	Palm Beach County, FL	2001	NA	568372	538842	29530	5.2
CN1210100000000	12	101	Pasco County, FL	2001	NA	155216	147745	7471	4.8
CN1210300000000	12	103	Pinellas County, FL	2001	NA	471589	450408	21181	4.5
CN1210500000000	12	105	Polk County, FL	2001	NA	237564	225189	12375	5.2
CN1210700000000	12	107	Putnam County, FL	2001	NA	29128	27497	1631	5.6
CN1210900000000	12	109	St. Johns County, FL	2001	NA	69083	66453	2630	3.8
CN1211100000000	12	111	St. Lucie County, FL	2001	NA	91292	85370	5922	6.5
CN1211300000000	12	113	Santa Rosa County, FL	2001	NA	55732	53115	2617	4.7
CN1211500000000	12	115	Sarasota County, FL	2001	NA	150916	144808	6108	4
CN1211700000000	12	117	Seminole County, FL	2001	NA	214534	205653	8881	4.1
CN1211900000000	12	119	Sumter County, FL	2001	NA	17481	16500	981	5.6
CN1212100000000	12	121	Suwannee County, FL	2001	NA	15574	14775	799	5.1
CN1212300000000	12	123	Taylor County, FL	2001	NA	8297	7730	567	6.8
CN1212500000000	12	125	Union County, FL	2001	NA	4760	4514	246	5.2
CN1212700000000	12	127	Volusia County, FL	2001	NA	215774	206227	9547	4.4
CN1212900000000	12	129	Wakulla County, FL	2001	NA	12309	11854	455	3.7
CN1213100000000	12	131	Walton County, FL	2001	NA	20757	19935	822	4
CN1213300000000	12	133	Washington County, FL	2001	NA	8848	8337	511	5.8
CN1300100000000	13	001	Appling County, GA	2001	NA	8395	7824	571	6.8
CN1300300000000	13	003	Atkinson County, GA	2001	NA	3327	3124	203	6.1
CN1300500000000	13	005	Bacon County, GA	2001	NA	4491	4246	245	5.5
CN1300700000000	13	007	Baker County, GA	2001	NA	1723	1639	84	4.9
CN1300900000000	13	009	Baldwin County, GA	2001	NA	18816	17971	845	4.5
CN1301100000000	13	011	Banks County, GA	2001	NA	7802	7523	279	3.6
CN1301300000000	13	013	Barrow County, GA	2001	NA	25919	24901	1018	3.9
CN1301500000000	13	015	Bartow County, GA	2001	NA	41483	39674	1809	4.4
CN1301700000000	13	017	Ben Hill County, GA	2001	NA	7837	7433	404	5.2
CN1301900000000	13	019	Berrien County, GA	2001	NA	7928	7601	327	4.1
CN1302100000000	13	021	Bibb County, GA	2001	NA	69231	66170	3061	4.4
CN1302300000000	13	023	Bleckley County, GA	2001	NA	5067	4802	265	5.2
CN1302500000000	13	025	Brantley County, GA	2001	NA	6813	6489	324	4.8
CN1302700000000	13	027	Brooks County, GA	2001	NA	7563	7207	356	4.7
CN1302900000000	13	029	Bryan County, GA	2001	NA	11898	11529	369	3.1
CN1303100000000	13	031	Bulloch County, GA	2001	NA	27469	26274	1195	4.4
CN1303300000000	13	033	Burke County, GA	2001	NA	9351	8780	571	6.1
CN1303500000000	13	035	Butts County, GA	2001	NA	9194	8784	410	4.5
CN1303700000000	13	037	Calhoun County, GA	2001	NA	2363	2207	156	6.6
CN1303900000000	13	039	Camden County, GA	2001	NA	17872	17199	673	3.8
CN1304300000000	13	043	Candler County, GA	2001	NA	3905	3720	185	4.7
CN1304500000000	13	045	Carroll County, GA	2001	NA	46154	43984	2170	4.7
CN1304700000000	13	047	Catoosa County, GA	2001	NA	30204	29309	895	3
CN1304900000000	13	049	Charlton County, GA	2001	NA	3941	3772	169	4.3
CN1305100000000	13	051	Chatham County, GA	2001	NA	111580	107564	4016	3.6
CN1305300000000	13	053	Chattahoochee County, GA	2001	NA	2603	2408	195	7.5
CN1305500000000	13	055	Chattooga County, GA	2001	NA	11186	10649	537	4.8
CN1305700000000	13	057	Cherokee County, GA	2001	NA	85741	83286	2455	2.9
CN1305900000000	13	059	Clarke County, GA	2001	NA	54603	52542	2061	3.8
CN1306100000000	13	061	Clay County, GA	2001	NA	1316	1238	78	5.9
CN1306300000000	13	063	Clayton County, GA	2001	NA	129379	124190	5189	4
CN1306500000000	13	065	Clinch County, GA	2001	NA	2427	2251	176	7.3
CN1306700000000	13	067	Cobb County, GA	2001	NA	363263	351172	12091	3.3
CN1306900000000	13	069	Coffee County, GA	2001	NA	16649	15742	907	5.4
CN1307100000000	13	071	Colquitt County, GA	2001	NA	18772	17711	1061	5.7
CN1307300000000	13	073	Columbia County, GA	2001	NA	47847	46403	1444	3
CN1307500000000	13	075	Cook County, GA	2001	NA	7146	6793	353	4.9
CN1307700000000	13	077	Coweta County, GA	2001	NA	49844	48102	1742	3.5
CN1307900000000	13	079	Crawford County, GA	2001	NA	5816	5569	247	4.2
CN1308100000000	13	081	Crisp County, GA	2001	NA	9397	8895	502	5.3
CN1308300000000	13	083	Dade County, GA	2001	NA	7839	7563	276	3.5
CN1308500000000	13	085	Dawson County, GA	2001	NA	9222	8934	288	3.1
CN1308700000000	13	087	Decatur County, GA	2001	NA	11952	11304	648	5.4
CN1308900000000	13	089	DeKalb County, GA	2001	NA	378313	362942	15371	4.1
CN1309100000000	13	091	Dodge County, GA	2001	NA	8348	7898	450	5.4
CN1309300000000	13	093	Dooly County, GA	2001	NA	4795	4537	258	5.4
CN1309500000000	13	095	Dougherty County, GA	2001	NA	40337	38121	2216	5.5
CN1309700000000	13	097	Douglas County, GA	2001	NA	52086	50387	1699	3.3
CN1309900000000	13	099	Early County, GA	2001	NA	5454	5191	263	4.8
CN1310100000000	13	101	Echols County, GA	2001	NA	1899	1828	71	3.7
CN1310300000000	13	103	Effingham County, GA	2001	NA	19747	19122	625	3.2
CN1310500000000	13	105	Elbert County, GA	2001	NA	9788	9239	549	5.6
CN1310700000000	13	107	Emanuel County, GA	2001	NA	9606	9027	579	6
CN1310900000000	13	109	Evans County, GA	2001	NA	4688	4496	192	4.1
CN1311100000000	13	111	Fannin County, GA	2001	NA	9198	8793	405	4.4
CN1311300000000	13	113	Fayette County, GA	2001	NA	50053	48640	1413	2.8
CN1311500000000	13	115	Floyd County, GA	2001	NA	45187	43155	2032	4.5
CN1311700000000	13	117	Forsyth County, GA	2001	NA	61106	59359	1747	2.9
CN1311900000000	13	119	Franklin County, GA	2001	NA	9884	9355	529	5.4
CN1312100000000	13	121	Fulton County, GA	2001	NA	439452	421301	18151	4.1
CN1312300000000	13	123	Gilmer County, GA	2001	NA	11469	11058	411	3.6
CN1312500000000	13	125	Glascock County, GA	2001	NA	1169	1117	52	4.4
CN1312700000000	13	127	Glynn County, GA	2001	NA	34768	33480	1288	3.7
CN1312900000000	13	129	Gordon County, GA	2001	NA	23787	22539	1248	5.2
CN1313100000000	13	131	Grady County, GA	2001	NA	11048	10572	476	4.3
CN1313300000000	13	133	Greene County, GA	2001	NA	6238	5811	427	6.8
CN1313500000000	13	135	Gwinnett County, GA	2001	NA	356582	344712	11870	3.3
CN1313700000000	13	137	Habersham County, GA	2001	NA	18428	17622	806	4.4
CN1313900000000	13	139	Hall County, GA	2001	NA	74433	71826	2607	3.5
CN1314100000000	13	141	Hancock County, GA	2001	NA	3310	3000	310	9.4
CN1314300000000	13	143	Haralson County, GA	2001	NA	12515	11958	557	4.5
CN1314500000000	13	145	Harris County, GA	2001	NA	13011	12557	454	3.5
CN1314700000000	13	147	Hart County, GA	2001	NA	11156	10507	649	5.8
CN1314900000000	13	149	Heard County, GA	2001	NA	5109	4855	254	5
CN1315100000000	13	151	Henry County, GA	2001	NA	71117	68973	2144	3
CN1315300000000	13	153	Houston County, GA	2001	NA	54816	52969	1847	3.4
CN1315500000000	13	155	Irwin County, GA	2001	NA	4418	4177	241	5.5
CN1315700000000	13	157	Jackson County, GA	2001	NA	21375	20460	915	4.3
CN1315900000000	13	159	Jasper County, GA	2001	NA	5801	5596	205	3.5
CN1316100000000	13	161	Jeff Davis County, GA	2001	NA	5637	5216	421	7.5
CN1316300000000	13	163	Jefferson County, GA	2001	NA	6636	6096	540	8.1
CN1316500000000	13	165	Jenkins County, GA	2001	NA	3543	3323	220	6.2
CN1316700000000	13	167	Johnson County, GA	2001	NA	3378	3173	205	6.1
CN1316900000000	13	169	Jones County, GA	2001	NA	11795	11376	419	3.6
CN1317100000000	13	171	Lamar County, GA	2001	NA	8129	7734	395	4.9
CN1317300000000	13	173	Lanier County, GA	2001	NA	3274	3135	139	4.2
CN1317500000000	13	175	Laurens County, GA	2001	NA	21343	20389	954	4.5
CN1317700000000	13	177	Lee County, GA	2001	NA	13701	13233	468	3.4
CN1317900000000	13	179	Liberty County, GA	2001	NA	19787	18810	977	4.9
CN1318100000000	13	181	Lincoln County, GA	2001	NA	3459	3171	288	8.3
CN1318300000000	13	183	Long County, GA	2001	NA	4528	4382	146	3.2
CN1318500000000	13	185	Lowndes County, GA	2001	NA	43496	41835	1661	3.8
CN1318700000000	13	187	Lumpkin County, GA	2001	NA	10939	10575	364	3.3
CN1318900000000	13	189	McDuffie County, GA	2001	NA	9985	9399	586	5.9
CN1319100000000	13	191	McIntosh County, GA	2001	NA	4875	4670	205	4.2
CN1319300000000	13	193	Macon County, GA	2001	NA	5307	4949	358	6.7
CN1319500000000	13	195	Madison County, GA	2001	NA	14036	13481	555	4
CN1319700000000	13	197	Marion County, GA	2001	NA	3306	3126	180	5.4
CN1319900000000	13	199	Meriwether County, GA	2001	NA	10031	9497	534	5.3
CN1320100000000	13	201	Miller County, GA	2001	NA	3218	3086	132	4.1
CN1320500000000	13	205	Mitchell County, GA	2001	NA	9793	9273	520	5.3
CN1320700000000	13	207	Monroe County, GA	2001	NA	11291	10867	424	3.8
CN1320900000000	13	209	Montgomery County, GA	2001	NA	3870	3614	256	6.6
CN1321100000000	13	211	Morgan County, GA	2001	NA	8223	7949	274	3.3
CN1321300000000	13	213	Murray County, GA	2001	NA	19678	18846	832	4.2
CN1321500000000	13	215	Muscogee County, GA	2001	NA	82264	78155	4109	5
CN1321700000000	13	217	Newton County, GA	2001	NA	33910	32679	1231	3.6
CN1321900000000	13	219	Oconee County, GA	2001	NA	14535	14141	394	2.7
CN1322100000000	13	221	Oglethorpe County, GA	2001	NA	6768	6502	266	3.9
CN1322300000000	13	223	Paulding County, GA	2001	NA	48051	46647	1404	2.9
CN1322500000000	13	225	Peach County, GA	2001	NA	10662	10172	490	4.6
CN1322700000000	13	227	Pickens County, GA	2001	NA	12880	12455	425	3.3
CN1322900000000	13	229	Pierce County, GA	2001	NA	7455	7130	325	4.4
CN1323100000000	13	231	Pike County, GA	2001	NA	6976	6703	273	3.9
CN1323300000000	13	233	Polk County, GA	2001	NA	18270	17388	882	4.8
CN1323500000000	13	235	Pulaski County, GA	2001	NA	4263	3994	269	6.3
CN1323700000000	13	237	Putnam County, GA	2001	NA	8974	8622	352	3.9
CN1323900000000	13	239	Quitman County, GA	2001	NA	1034	956	78	7.5
CN1324100000000	13	241	Rabun County, GA	2001	NA	7061	6786	275	3.9
CN1324300000000	13	243	Randolph County, GA	2001	NA	2888	2654	234	8.1
CN1324500000000	13	245	Richmond County, GA	2001	NA	86512	82298	4214	4.9
CN1324700000000	13	247	Rockdale County, GA	2001	NA	36867	35597	1270	3.4
CN1324900000000	13	249	Schley County, GA	2001	NA	1680	1599	81	4.8
CN1325100000000	13	251	Screven County, GA	2001	NA	6391	5952	439	6.9
CN1325300000000	13	253	Seminole County, GA	2001	NA	3980	3772	208	5.2
CN1325500000000	13	255	Spalding County, GA	2001	NA	28012	26670	1342	4.8
CN1325700000000	13	257	Stephens County, GA	2001	NA	13402	12722	680	5.1
CN1325900000000	13	259	Stewart County, GA	2001	NA	1972	1828	144	7.3
CN1326100000000	13	261	Sumter County, GA	2001	NA	14835	13993	842	5.7
CN1326300000000	13	263	Talbot County, GA	2001	NA	2821	2644	177	6.3
CN1326500000000	13	265	Taliaferro County, GA	2001	NA	800	728	72	9
CN1326700000000	13	267	Tattnall County, GA	2001	NA	8468	8039	429	5.1
CN1326900000000	13	269	Taylor County, GA	2001	NA	3304	3104	200	6.1
CN1327100000000	13	271	Telfair County, GA	2001	NA	4037	3570	467	11.6
CN1327300000000	13	273	Terrell County, GA	2001	NA	4553	4267	286	6.3
CN1327500000000	13	275	Thomas County, GA	2001	NA	20296	19443	853	4.2
CN1327700000000	13	277	Tift County, GA	2001	NA	18649	17798	851	4.6
CN1327900000000	13	279	Toombs County, GA	2001	NA	11692	10939	753	6.4
CN1328100000000	13	281	Towns County, GA	2001	NA	4424	4258	166	3.8
CN1328300000000	13	283	Treutlen County, GA	2001	NA	2600	2426	174	6.7
CN1328500000000	13	285	Troup County, GA	2001	NA	30775	29419	1356	4.4
CN1328700000000	13	287	Turner County, GA	2001	NA	4871	4566	305	6.3
CN1328900000000	13	289	Twiggs County, GA	2001	NA	4573	4326	247	5.4
CN1329100000000	13	291	Union County, GA	2001	NA	8327	8021	306	3.7
CN1329300000000	13	293	Upson County, GA	2001	NA	12264	11218	1046	8.5
CN1329500000000	13	295	Walker County, GA	2001	NA	30714	29399	1315	4.3
CN1329700000000	13	297	Walton County, GA	2001	NA	33417	32213	1204	3.6
CN1329900000000	13	299	Ware County, GA	2001	NA	14811	14016	795	5.4
CN1330100000000	13	301	Warren County, GA	2001	NA	2622	2404	218	8.3
CN1330300000000	13	303	Washington County, GA	2001	NA	8266	7840	426	5.2
CN1330500000000	13	305	Wayne County, GA	2001	NA	10923	10360	563	5.2
CN1330700000000	13	307	Webster County, GA	2001	NA	1015	964	51	5
CN1330900000000	13	309	Wheeler County, GA	2001	NA	2266	2099	167	7.4
CN1331100000000	13	311	White County, GA	2001	NA	10890	10497	393	3.6
CN1331300000000	13	313	Whitfield County, GA	2001	NA	43365	41425	1940	4.5
CN1331500000000	13	315	Wilcox County, GA	2001	NA	3315	3137	178	5.4
CN1331700000000	13	317	Wilkes County, GA	2001	NA	4788	4392	396	8.3
CN1331900000000	13	319	Wilkinson County, GA	2001	NA	4379	4175	204	4.7
CN1332100000000	13	321	Worth County, GA	2001	NA	10114	9602	512	5.1
CN1500100000000	15	001	Hawaii County, HI	2001	NA	75746	71762	3984	5.3
CN1500300000000	15	003	Honolulu County/city, HI	2001	NA	431962	413218	18744	4.3
CN1500700000000	15	007	Kauai County, HI	2001	NA	30261	28642	1619	5.4
CN1500900000000	15	009	Maui County, HI	2001	NA	72661	69566	3095	4.3
CN1600100000000	16	001	Ada County, ID	2001	NA	175653	168876	6777	3.9
CN1600300000000	16	003	Adams County, ID	2001	NA	1954	1734	220	11.3
CN1600500000000	16	005	Bannock County, ID	2001	NA	37879	35999	1880	5
CN1600700000000	16	007	Bear Lake County, ID	2001	NA	2970	2831	139	4.7
CN1600900000000	16	009	Benewah County, ID	2001	NA	4036	3612	424	10.5
CN1601100000000	16	011	Bingham County, ID	2001	NA	19962	19014	948	4.7
CN1601300000000	16	013	Blaine County, ID	2001	NA	12428	12003	425	3.4
CN1601500000000	16	015	Boise County, ID	2001	NA	3464	3323	141	4.1
CN1601700000000	16	017	Bonner County, ID	2001	NA	18079	16639	1440	8
CN1601900000000	16	019	Bonneville County, ID	2001	NA	42667	41124	1543	3.6
CN1602100000000	16	021	Boundary County, ID	2001	NA	4041	3661	380	9.4
CN1602300000000	16	023	Butte County, ID	2001	NA	1460	1396	64	4.4
CN1602500000000	16	025	Camas County, ID	2001	NA	562	541	21	3.7
CN1602700000000	16	027	Canyon County, ID	2001	NA	69061	65478	3583	5.2
CN1602900000000	16	029	Caribou County, ID	2001	NA	3431	3246	185	5.4
CN1603100000000	16	031	Cassia County, ID	2001	NA	10334	9834	500	4.8
CN1603300000000	16	033	Clark County, ID	2001	NA	559	529	30	5.4
CN1603500000000	16	035	Clearwater County, ID	2001	NA	3567	3040	527	14.8
CN1603700000000	16	037	Custer County, ID	2001	NA	2692	2524	168	6.2
CN1603900000000	16	039	Elmore County, ID	2001	NA	10960	10333	627	5.7
CN1604100000000	16	041	Franklin County, ID	2001	NA	5446	5234	212	3.9
CN1604300000000	16	043	Fremont County, ID	2001	NA	5874	5601	273	4.6
CN1604500000000	16	045	Gem County, ID	2001	NA	7227	6728	499	6.9
CN1604700000000	16	047	Gooding County, ID	2001	NA	7107	6827	280	3.9
CN1604900000000	16	049	Idaho County, ID	2001	NA	7017	6404	613	8.7
CN1605100000000	16	051	Jefferson County, ID	2001	NA	9211	8846	365	4
CN1605300000000	16	053	Jerome County, ID	2001	NA	9315	8927	388	4.2
CN1605500000000	16	055	Kootenai County, ID	2001	NA	59387	55189	4198	7.1
CN1605700000000	16	057	Latah County, ID	2001	NA	17409	16642	767	4.4
CN1605900000000	16	059	Lemhi County, ID	2001	NA	3888	3596	292	7.5
CN1606100000000	16	061	Lewis County, ID	2001	NA	1710	1587	123	7.2
CN1606300000000	16	063	Lincoln County, ID	2001	NA	2229	2138	91	4.1
CN1606500000000	16	065	Madison County, ID	2001	NA	13161	12738	423	3.2
CN1606700000000	16	067	Minidoka County, ID	2001	NA	9870	9308	562	5.7
CN1606900000000	16	069	Nez Perce County, ID	2001	NA	19605	18540	1065	5.4
CN1607100000000	16	071	Oneida County, ID	2001	NA	2001	1928	73	3.6
CN1607300000000	16	073	Owyhee County, ID	2001	NA	4875	4671	204	4.2
CN1607500000000	16	075	Payette County, ID	2001	NA	9927	9133	794	8
CN1607700000000	16	077	Power County, ID	2001	NA	3529	3324	205	5.8
CN1607900000000	16	079	Shoshone County, ID	2001	NA	5755	5039	716	12.4
CN1608100000000	16	081	Teton County, ID	2001	NA	3833	3732	101	2.6
CN1608300000000	16	083	Twin Falls County, ID	2001	NA	34414	32946	1468	4.3
CN1608500000000	16	085	Valley County, ID	2001	NA	4036	3724	312	7.7
CN1608700000000	16	087	Washington County, ID	2001	NA	5079	4742	337	6.6
CN1700100000000	17	001	Adams County, IL	2001	NA	35846	34330	1516	4.2
CN1700300000000	17	003	Alexander County, IL	2001	NA	3506	3231	275	7.8
CN1700500000000	17	005	Bond County, IL	2001	NA	8212	7820	392	4.8
CN1700700000000	17	007	Boone County, IL	2001	NA	22201	20854	1347	6.1
CN1700900000000	17	009	Brown County, IL	2001	NA	3002	2907	95	3.2
CN1701100000000	17	011	Bureau County, IL	2001	NA	18766	17839	927	4.9
CN1701300000000	17	013	Calhoun County, IL	2001	NA	2503	2356	147	5.9
CN1701500000000	17	015	Carroll County, IL	2001	NA	8545	7973	572	6.7
CN1701700000000	17	017	Cass County, IL	2001	NA	7156	6841	315	4.4
CN1701900000000	17	019	Champaign County, IL	2001	NA	99742	96206	3536	3.5
CN1702100000000	17	021	Christian County, IL	2001	NA	17081	16191	890	5.2
CN1702300000000	17	023	Clark County, IL	2001	NA	8804	8310	494	5.6
CN1702500000000	17	025	Clay County, IL	2001	NA	6995	6545	450	6.4
CN1702700000000	17	027	Clinton County, IL	2001	NA	18251	17480	771	4.2
CN1702900000000	17	029	Coles County, IL	2001	NA	27995	26665	1330	4.8
CN1703100000000	17	031	Cook County, IL	2001	NA	2711546	2547153	164393	6.1
CN1703300000000	17	033	Crawford County, IL	2001	NA	9646	9081	565	5.9
CN1703500000000	17	035	Cumberland County, IL	2001	NA	5870	5529	341	5.8
CN1703700000000	17	037	DeKalb County, IL	2001	NA	51485	49251	2234	4.3
CN1703900000000	17	039	De Witt County, IL	2001	NA	8767	8336	431	4.9
CN1704100000000	17	041	Douglas County, IL	2001	NA	10536	10097	439	4.2
CN1704300000000	17	043	DuPage County, IL	2001	NA	530060	506811	23249	4.4
CN1704500000000	17	045	Edgar County, IL	2001	NA	9917	9427	490	4.9
CN1704700000000	17	047	Edwards County, IL	2001	NA	3580	3408	172	4.8
CN1704900000000	17	049	Effingham County, IL	2001	NA	17907	17067	840	4.7
CN1705100000000	17	051	Fayette County, IL	2001	NA	10081	9439	642	6.4
CN1705300000000	17	053	Ford County, IL	2001	NA	7361	7042	319	4.3
CN1705500000000	17	055	Franklin County, IL	2001	NA	17103	15817	1286	7.5
CN1705700000000	17	057	Fulton County, IL	2001	NA	17442	16412	1030	5.9
CN1705900000000	17	059	Gallatin County, IL	2001	NA	2752	2591	161	5.9
CN1706100000000	17	061	Greene County, IL	2001	NA	6955	6578	377	5.4
CN1706300000000	17	063	Grundy County, IL	2001	NA	21197	19920	1277	6
CN1706500000000	17	065	Hamilton County, IL	2001	NA	4022	3798	224	5.6
CN1706700000000	17	067	Hancock County, IL	2001	NA	10774	10150	624	5.8
CN1706900000000	17	069	Hardin County, IL	2001	NA	1920	1791	129	6.7
CN1707100000000	17	071	Henderson County, IL	2001	NA	4247	4050	197	4.6
CN1707300000000	17	073	Henry County, IL	2001	NA	26850	25519	1331	5
CN1707500000000	17	075	Iroquois County, IL	2001	NA	16370	15506	864	5.3
CN1707700000000	17	077	Jackson County, IL	2001	NA	30651	29373	1278	4.2
CN1707900000000	17	079	Jasper County, IL	2001	NA	5349	5071	278	5.2
CN1708100000000	17	081	Jefferson County, IL	2001	NA	19457	18374	1083	5.6
CN1708300000000	17	083	Jersey County, IL	2001	NA	11071	10528	543	4.9
CN1708500000000	17	085	Jo Daviess County, IL	2001	NA	12810	12184	626	4.9
CN1708700000000	17	087	Johnson County, IL	2001	NA	4956	4676	280	5.6
CN1708900000000	17	089	Kane County, IL	2001	NA	229200	217540	11660	5.1
CN1709100000000	17	091	Kankakee County, IL	2001	NA	52155	49522	2633	5
CN1709300000000	17	093	Kendall County, IL	2001	NA	33731	32294	1437	4.3
CN1709500000000	17	095	Knox County, IL	2001	NA	27231	25739	1492	5.5
CN1709700000000	17	097	Lake County, IL	2001	NA	338306	324133	14173	4.2
CN1709900000000	17	099	LaSalle County, IL	2001	NA	56125	52943	3182	5.7
CN1710100000000	17	101	Lawrence County, IL	2001	NA	8131	7692	439	5.4
CN1710300000000	17	103	Lee County, IL	2001	NA	17609	16768	841	4.8
CN1710500000000	17	105	Livingston County, IL	2001	NA	19455	18622	833	4.3
CN1710700000000	17	107	Logan County, IL	2001	NA	14505	13890	615	4.2
CN1710900000000	17	109	McDonough County, IL	2001	NA	16601	15875	726	4.4
CN1711100000000	17	111	McHenry County, IL	2001	NA	154979	147730	7249	4.7
CN1711300000000	17	113	McLean County, IL	2001	NA	86175	83420	2755	3.2
CN1711500000000	17	115	Macon County, IL	2001	NA	54019	50795	3224	6
CN1711700000000	17	117	Macoupin County, IL	2001	NA	24218	22982	1236	5.1
CN1711900000000	17	119	Madison County, IL	2001	NA	132161	125872	6289	4.8
CN1712100000000	17	121	Marion County, IL	2001	NA	19987	18362	1625	8.1
CN1712300000000	17	123	Marshall County, IL	2001	NA	6893	6567	326	4.7
CN1712500000000	17	125	Mason County, IL	2001	NA	8008	7521	487	6.1
CN1712700000000	17	127	Massac County, IL	2001	NA	7172	6800	372	5.2
CN1712900000000	17	129	Menard County, IL	2001	NA	7003	6728	275	3.9
CN1713100000000	17	131	Mercer County, IL	2001	NA	8712	8241	471	5.4
CN1713300000000	17	133	Monroe County, IL	2001	NA	15680	15107	573	3.7
CN1713500000000	17	135	Montgomery County, IL	2001	NA	13838	12999	839	6.1
CN1713700000000	17	137	Morgan County, IL	2001	NA	18186	17382	804	4.4
CN1713900000000	17	139	Moultrie County, IL	2001	NA	7456	7118	338	4.5
CN1714100000000	17	141	Ogle County, IL	2001	NA	26193	24887	1306	5
CN1714300000000	17	143	Peoria County, IL	2001	NA	90438	86024	4414	4.9
CN1714500000000	17	145	Perry County, IL	2001	NA	10347	9695	652	6.3
CN1714700000000	17	147	Piatt County, IL	2001	NA	9043	8705	338	3.7
CN1714900000000	17	149	Pike County, IL	2001	NA	8574	8108	466	5.4
CN1715100000000	17	151	Pope County, IL	2001	NA	1996	1865	131	6.6
CN1715300000000	17	153	Pulaski County, IL	2001	NA	3036	2808	228	7.5
CN1715500000000	17	155	Putnam County, IL	2001	NA	3116	2942	174	5.6
CN1715700000000	17	157	Randolph County, IL	2001	NA	15502	14735	767	4.9
CN1715900000000	17	159	Richland County, IL	2001	NA	7556	7103	453	6
CN1716100000000	17	161	Rock Island County, IL	2001	NA	76505	73048	3457	4.5
CN1716300000000	17	163	St. Clair County, IL	2001	NA	118199	112105	6094	5.2
CN1716500000000	17	165	Saline County, IL	2001	NA	11545	10832	713	6.2
CN1716700000000	17	167	Sangamon County, IL	2001	NA	105107	101110	3997	3.8
CN1716900000000	17	169	Schuyler County, IL	2001	NA	4142	3964	178	4.3
CN1717100000000	17	171	Scott County, IL	2001	NA	2888	2745	143	5
CN1717300000000	17	173	Shelby County, IL	2001	NA	11651	11024	627	5.4
CN1717500000000	17	175	Stark County, IL	2001	NA	2885	2692	193	6.7
CN1717700000000	17	177	Stephenson County, IL	2001	NA	25607	24167	1440	5.6
CN1717900000000	17	179	Tazewell County, IL	2001	NA	66809	63821	2988	4.5
CN1718100000000	17	181	Union County, IL	2001	NA	8193	7722	471	5.7
CN1718300000000	17	183	Vermilion County, IL	2001	NA	37919	35482	2437	6.4
CN1718500000000	17	185	Wabash County, IL	2001	NA	6867	6514	353	5.1
CN1718700000000	17	187	Warren County, IL	2001	NA	9712	9271	441	4.5
CN1718900000000	17	189	Washington County, IL	2001	NA	8623	8276	347	4
CN1719100000000	17	191	Wayne County, IL	2001	NA	8462	7988	474	5.6
CN1719300000000	17	193	White County, IL	2001	NA	7705	7324	381	4.9
CN1719500000000	17	195	Whiteside County, IL	2001	NA	30448	28607	1841	6
CN1719700000000	17	197	Will County, IL	2001	NA	289741	275134	14607	5
CN1719900000000	17	199	Williamson County, IL	2001	NA	29893	28247	1646	5.5
CN1720100000000	17	201	Winnebago County, IL	2001	NA	143685	135499	8186	5.7
CN1720300000000	17	203	Woodford County, IL	2001	NA	18720	18068	652	3.5
CN1800100000000	18	001	Adams County, IN	2001	NA	15663	14887	776	5
CN1800300000000	18	003	Allen County, IN	2001	NA	175142	167870	7272	4.2
CN1800500000000	18	005	Bartholomew County, IN	2001	NA	36363	34880	1483	4.1
CN1800700000000	18	007	Benton County, IN	2001	NA	4827	4659	168	3.5
CN1800900000000	18	009	Blackford County, IN	2001	NA	7070	6674	396	5.6
CN1801100000000	18	011	Boone County, IN	2001	NA	24722	24024	698	2.8
CN1801300000000	18	013	Brown County, IN	2001	NA	7998	7681	317	4
CN1801500000000	18	015	Carroll County, IN	2001	NA	10720	10262	458	4.3
CN1801700000000	18	017	Cass County, IN	2001	NA	20479	19463	1016	5
CN1801900000000	18	019	Clark County, IN	2001	NA	52119	49807	2312	4.4
CN1802100000000	18	021	Clay County, IN	2001	NA	12962	12247	715	5.5
CN1802300000000	18	023	Clinton County, IN	2001	NA	16555	15883	672	4.1
CN1802500000000	18	025	Crawford County, IN	2001	NA	5240	4949	291	5.6
CN1802700000000	18	027	Daviess County, IN	2001	NA	13901	13366	535	3.8
CN1802900000000	18	029	Dearborn County, IN	2001	NA	24645	23683	962	3.9
CN1803100000000	18	031	Decatur County, IN	2001	NA	12999	12578	421	3.2
CN1803300000000	18	033	DeKalb County, IN	2001	NA	21500	20430	1070	5
CN1803500000000	18	035	Delaware County, IN	2001	NA	59499	56621	2878	4.8
CN1803700000000	18	037	Dubois County, IN	2001	NA	22103	21453	650	2.9
CN1803900000000	18	039	Elkhart County, IN	2001	NA	95337	90863	4474	4.7
CN1804100000000	18	041	Fayette County, IN	2001	NA	12137	11308	829	6.8
CN1804300000000	18	043	Floyd County, IN	2001	NA	37799	36267	1532	4.1
CN1804500000000	18	045	Fountain County, IN	2001	NA	8599	8206	393	4.6
CN1804700000000	18	047	Franklin County, IN	2001	NA	11355	10849	506	4.5
CN1804900000000	18	049	Fulton County, IN	2001	NA	10425	9821	604	5.8
CN1805100000000	18	051	Gibson County, IN	2001	NA	17052	16369	683	4
CN1805300000000	18	053	Grant County, IN	2001	NA	34848	32764	2084	6
CN1805500000000	18	055	Greene County, IN	2001	NA	16311	15365	946	5.8
CN1805700000000	18	057	Hamilton County, IN	2001	NA	107256	104621	2635	2.5
CN1805900000000	18	059	Hancock County, IN	2001	NA	31060	30135	925	3
CN1806100000000	18	061	Harrison County, IN	2001	NA	18669	17893	776	4.2
CN1806300000000	18	063	Hendricks County, IN	2001	NA	60082	58470	1612	2.7
CN1806500000000	18	065	Henry County, IN	2001	NA	23269	22055	1214	5.2
CN1806700000000	18	067	Howard County, IN	2001	NA	41175	38815	2360	5.7
CN1806900000000	18	069	Huntington County, IN	2001	NA	20611	19676	935	4.5
CN1807100000000	18	071	Jackson County, IN	2001	NA	21928	21018	910	4.1
CN1807300000000	18	073	Jasper County, IN	2001	NA	14928	14208	720	4.8
CN1807500000000	18	075	Jay County, IN	2001	NA	11000	10376	624	5.7
CN1807700000000	18	077	Jefferson County, IN	2001	NA	16267	15570	697	4.3
CN1807900000000	18	079	Jennings County, IN	2001	NA	14034	13362	672	4.8
CN1808100000000	18	081	Johnson County, IN	2001	NA	64848	63036	1812	2.8
CN1808300000000	18	083	Knox County, IN	2001	NA	19429	18696	733	3.8
CN1808500000000	18	085	Kosciusko County, IN	2001	NA	38626	37004	1622	4.2
CN1808700000000	18	087	LaGrange County, IN	2001	NA	16497	15703	794	4.8
CN1808900000000	18	089	Lake County, IN	2001	NA	226943	215748	11195	4.9
CN1809100000000	18	091	LaPorte County, IN	2001	NA	53928	51298	2630	4.9
CN1809300000000	18	093	Lawrence County, IN	2001	NA	23130	21532	1598	6.9
CN1809500000000	18	095	Madison County, IN	2001	NA	63832	60919	2913	4.6
CN1809700000000	18	097	Marion County, IN	2001	NA	459505	442014	17491	3.8
CN1809900000000	18	099	Marshall County, IN	2001	NA	22575	21602	973	4.3
CN1810100000000	18	101	Martin County, IN	2001	NA	5127	4886	241	4.7
CN1810300000000	18	103	Miami County, IN	2001	NA	17519	16597	922	5.3
CN1810500000000	18	105	Monroe County, IN	2001	NA	64688	62249	2439	3.8
CN1810700000000	18	107	Montgomery County, IN	2001	NA	19533	18801	732	3.7
CN1810900000000	18	109	Morgan County, IN	2001	NA	35889	34689	1200	3.3
CN1811100000000	18	111	Newton County, IN	2001	NA	7227	6915	312	4.3
CN1811300000000	18	113	Noble County, IN	2001	NA	23937	22593	1344	5.6
CN1811500000000	18	115	Ohio County, IN	2001	NA	2982	2871	111	3.7
CN1811700000000	18	117	Orange County, IN	2001	NA	9492	8834	658	6.9
CN1811900000000	18	119	Owen County, IN	2001	NA	11102	10594	508	4.6
CN1812100000000	18	121	Parke County, IN	2001	NA	8044	7673	371	4.6
CN1812300000000	18	123	Perry County, IN	2001	NA	9172	8683	489	5.3
CN1812500000000	18	125	Pike County, IN	2001	NA	6303	6058	245	3.9
CN1812700000000	18	127	Porter County, IN	2001	NA	78553	75533	3020	3.8
CN1812900000000	18	129	Posey County, IN	2001	NA	13956	13471	485	3.5
CN1813100000000	18	131	Pulaski County, IN	2001	NA	6776	6456	320	4.7
CN1813300000000	18	133	Putnam County, IN	2001	NA	17278	16626	652	3.8
CN1813500000000	18	135	Randolph County, IN	2001	NA	13752	13020	732	5.3
CN1813700000000	18	137	Ripley County, IN	2001	NA	13987	13499	488	3.5
CN1813900000000	18	139	Rush County, IN	2001	NA	9643	9287	356	3.7
CN1814100000000	18	141	St. Joseph County, IN	2001	NA	132924	126831	6093	4.6
CN1814300000000	18	143	Scott County, IN	2001	NA	11117	10557	560	5
CN1814500000000	18	145	Shelby County, IN	2001	NA	23864	22982	882	3.7
CN1814700000000	18	147	Spencer County, IN	2001	NA	10517	10048	469	4.5
CN1814900000000	18	149	Starke County, IN	2001	NA	10676	10042	634	5.9
CN1815100000000	18	151	Steuben County, IN	2001	NA	17498	16569	929	5.3
CN1815300000000	18	153	Sullivan County, IN	2001	NA	9204	8697	507	5.5
CN1815500000000	18	155	Switzerland County, IN	2001	NA	5973	5777	196	3.3
CN1815700000000	18	157	Tippecanoe County, IN	2001	NA	78779	76025	2754	3.5
CN1815900000000	18	159	Tipton County, IN	2001	NA	8559	8139	420	4.9
CN1816100000000	18	161	Union County, IN	2001	NA	3764	3595	169	4.5
CN1816300000000	18	163	Vanderburgh County, IN	2001	NA	91021	87502	3519	3.9
CN1816500000000	18	165	Vermillion County, IN	2001	NA	8068	7639	429	5.3
CN1816700000000	18	167	Vigo County, IN	2001	NA	50503	47932	2571	5.1
CN1816900000000	18	169	Wabash County, IN	2001	NA	18028	17099	929	5.2
CN1817100000000	18	171	Warren County, IN	2001	NA	4554	4404	150	3.3
CN1817300000000	18	173	Warrick County, IN	2001	NA	28905	27899	1006	3.5
CN1817500000000	18	175	Washington County, IN	2001	NA	14092	13322	770	5.5
CN1817700000000	18	177	Wayne County, IN	2001	NA	34617	32820	1797	5.2
CN1817900000000	18	179	Wells County, IN	2001	NA	14769	14189	580	3.9
CN1818100000000	18	181	White County, IN	2001	NA	13352	12708	644	4.8
CN1818300000000	18	183	Whitley County, IN	2001	NA	17203	16422	781	4.5
CN1900100000000	19	001	Adair County, IA	2001	NA	4558	4433	125	2.7
CN1900300000000	19	003	Adams County, IA	2001	NA	2292	2195	97	4.2
CN1900500000000	19	005	Allamakee County, IA	2001	NA	8459	8121	338	4
CN1900700000000	19	007	Appanoose County, IA	2001	NA	6481	6146	335	5.2
CN1900900000000	19	009	Audubon County, IA	2001	NA	3539	3425	114	3.2
CN1901100000000	19	011	Benton County, IA	2001	NA	13954	13522	432	3.1
CN1901300000000	19	013	Black Hawk County, IA	2001	NA	69260	66885	2375	3.4
CN1901500000000	19	015	Boone County, IA	2001	NA	14929	14516	413	2.8
CN1901700000000	19	017	Bremer County, IA	2001	NA	13047	12643	404	3.1
CN1901900000000	19	019	Buchanan County, IA	2001	NA	10826	10404	422	3.9
CN1902100000000	19	021	Buena Vista County, IA	2001	NA	10622	10339	283	2.7
CN1902300000000	19	023	Butler County, IA	2001	NA	8255	7895	360	4.4
CN1902500000000	19	025	Calhoun County, IA	2001	NA	5328	5153	175	3.3
CN1902700000000	19	027	Carroll County, IA	2001	NA	12307	11994	313	2.5
CN1902900000000	19	029	Cass County, IA	2001	NA	7896	7584	312	4
CN1903100000000	19	031	Cedar County, IA	2001	NA	10676	10374	302	2.8
CN1903300000000	19	033	Cerro Gordo County, IA	2001	NA	25034	24174	860	3.4
CN1903500000000	19	035	Cherokee County, IA	2001	NA	7222	7009	213	2.9
CN1903700000000	19	037	Chickasaw County, IA	2001	NA	6715	6297	418	6.2
CN1903900000000	19	039	Clarke County, IA	2001	NA	4987	4785	202	4.1
CN1904100000000	19	041	Clay County, IA	2001	NA	9777	9471	306	3.1
CN1904300000000	19	043	Clayton County, IA	2001	NA	10407	9926	481	4.6
CN1904500000000	19	045	Clinton County, IA	2001	NA	26415	25241	1174	4.4
CN1904700000000	19	047	Crawford County, IA	2001	NA	8993	8715	278	3.1
CN1904900000000	19	049	Dallas County, IA	2001	NA	24572	23995	577	2.3
CN1905100000000	19	051	Davis County, IA	2001	NA	4333	4157	176	4.1
CN1905300000000	19	053	Decatur County, IA	2001	NA	4454	4303	151	3.4
CN1905500000000	19	055	Delaware County, IA	2001	NA	10637	10254	383	3.6
CN1905700000000	19	057	Des Moines County, IA	2001	NA	22167	21060	1107	5
CN1905900000000	19	059	Dickinson County, IA	2001	NA	9487	9175	312	3.3
CN1906100000000	19	061	Dubuque County, IA	2001	NA	47964	45981	1983	4.1
CN1906300000000	19	063	Emmet County, IA	2001	NA	5738	5518	220	3.8
CN1906500000000	19	065	Fayette County, IA	2001	NA	11548	11001	547	4.7
CN1906700000000	19	067	Floyd County, IA	2001	NA	8635	8268	367	4.3
CN1906900000000	19	069	Franklin County, IA	2001	NA	5952	5752	200	3.4
CN1907100000000	19	071	Fremont County, IA	2001	NA	4660	4536	124	2.7
CN1907300000000	19	073	Greene County, IA	2001	NA	4992	4802	190	3.8
CN1907500000000	19	075	Grundy County, IA	2001	NA	6558	6381	177	2.7
CN1907700000000	19	077	Guthrie County, IA	2001	NA	6039	5857	182	3
CN1907900000000	19	079	Hamilton County, IA	2001	NA	8774	8500	274	3.1
CN1908100000000	19	081	Hancock County, IA	2001	NA	6354	6190	164	2.6
CN1908300000000	19	083	Hardin County, IA	2001	NA	9870	9523	347	3.5
CN1908500000000	19	085	Harrison County, IA	2001	NA	8074	7782	292	3.6
CN1908700000000	19	087	Henry County, IA	2001	NA	10439	10025	414	4
CN1908900000000	19	089	Howard County, IA	2001	NA	5292	5117	175	3.3
CN1909100000000	19	091	Humboldt County, IA	2001	NA	5348	5171	177	3.3
CN1909300000000	19	093	Ida County, IA	2001	NA	4111	4001	110	2.7
CN1909500000000	19	095	Iowa County, IA	2001	NA	8930	8716	214	2.4
CN1909700000000	19	097	Jackson County, IA	2001	NA	11336	10801	535	4.7
CN1909900000000	19	099	Jasper County, IA	2001	NA	20233	19603	630	3.1
CN1910100000000	19	101	Jefferson County, IA	2001	NA	8836	8393	443	5
CN1910300000000	19	103	Johnson County, IA	2001	NA	68849	67350	1499	2.2
CN1910500000000	19	105	Jones County, IA	2001	NA	10483	10090	393	3.7
CN1910700000000	19	107	Keokuk County, IA	2001	NA	6082	5839	243	4
CN1910900000000	19	109	Kossuth County, IA	2001	NA	9136	8872	264	2.9
CN1911100000000	19	111	Lee County, IA	2001	NA	18377	17190	1187	6.5
CN1911300000000	19	113	Linn County, IA	2001	NA	112586	109057	3529	3.1
CN1911500000000	19	115	Louisa County, IA	2001	NA	6298	6080	218	3.5
CN1911700000000	19	117	Lucas County, IA	2001	NA	4888	4720	168	3.4
CN1911900000000	19	119	Lyon County, IA	2001	NA	6592	6436	156	2.4
CN1912100000000	19	121	Madison County, IA	2001	NA	7698	7437	261	3.4
CN1912300000000	19	123	Mahaska County, IA	2001	NA	11789	11380	409	3.5
CN1912500000000	19	125	Marion County, IA	2001	NA	17737	17149	588	3.3
CN1912700000000	19	127	Marshall County, IA	2001	NA	20891	20224	667	3.2
CN1912900000000	19	129	Mills County, IA	2001	NA	7892	7667	225	2.9
CN1913100000000	19	131	Mitchell County, IA	2001	NA	5676	5510	166	2.9
CN1913300000000	19	133	Monona County, IA	2001	NA	5105	4919	186	3.6
CN1913500000000	19	135	Monroe County, IA	2001	NA	3837	3670	167	4.4
CN1913700000000	19	137	Montgomery County, IA	2001	NA	6095	5811	284	4.7
CN1913900000000	19	139	Muscatine County, IA	2001	NA	22513	21713	800	3.6
CN1914100000000	19	141	O'Brien County, IA	2001	NA	7945	7739	206	2.6
CN1914300000000	19	143	Osceola County, IA	2001	NA	3696	3581	115	3.1
CN1914500000000	19	145	Page County, IA	2001	NA	7712	7324	388	5
CN1914700000000	19	147	Palo Alto County, IA	2001	NA	5335	5137	198	3.7
CN1914900000000	19	149	Plymouth County, IA	2001	NA	13876	13476	400	2.9
CN1915100000000	19	151	Pocahontas County, IA	2001	NA	4403	4251	152	3.5
CN1915300000000	19	153	Polk County, IA	2001	NA	218483	212153	6330	2.9
CN1915500000000	19	155	Pottawattamie County, IA	2001	NA	47835	46347	1488	3.1
CN1915700000000	19	157	Poweshiek County, IA	2001	NA	10695	10351	344	3.2
CN1915900000000	19	159	Ringgold County, IA	2001	NA	2681	2597	84	3.1
CN1916100000000	19	161	Sac County, IA	2001	NA	6138	5958	180	2.9
CN1916300000000	19	163	Scott County, IA	2001	NA	85495	82085	3410	4
CN1916500000000	19	165	Shelby County, IA	2001	NA	7346	7150	196	2.7
CN1916700000000	19	167	Sioux County, IA	2001	NA	18170	17741	429	2.4
CN1916900000000	19	169	Story County, IA	2001	NA	46407	45433	974	2.1
CN1917100000000	19	171	Tama County, IA	2001	NA	9474	9139	335	3.5
CN1917300000000	19	173	Taylor County, IA	2001	NA	3440	3299	141	4.1
CN1917500000000	19	175	Union County, IA	2001	NA	6643	6395	248	3.7
CN1917700000000	19	177	Van Buren County, IA	2001	NA	4007	3834	173	4.3
CN1917900000000	19	179	Wapello County, IA	2001	NA	18220	17383	837	4.6
CN1918100000000	19	181	Warren County, IA	2001	NA	23776	23161	615	2.6
CN1918300000000	19	183	Washington County, IA	2001	NA	11630	11306	324	2.8
CN1918500000000	19	185	Wayne County, IA	2001	NA	3349	3232	117	3.5
CN1918700000000	19	187	Webster County, IA	2001	NA	20071	19340	731	3.6
CN1918900000000	19	189	Winnebago County, IA	2001	NA	6530	6355	175	2.7
CN1919100000000	19	191	Winneshiek County, IA	2001	NA	12569	12204	365	2.9
CN1919300000000	19	193	Woodbury County, IA	2001	NA	55289	53531	1758	3.2
CN1919500000000	19	195	Worth County, IA	2001	NA	4336	4191	145	3.3
CN1919700000000	19	197	Wright County, IA	2001	NA	7580	7327	253	3.3
CN2000100000000	20	001	Allen County, KS	2001	NA	7228	6794	434	6
CN2000300000000	20	003	Anderson County, KS	2001	NA	4051	3841	210	5.2
CN2000500000000	20	005	Atchison County, KS	2001	NA	8045	7638	407	5.1
CN2000700000000	20	007	Barber County, KS	2001	NA	2519	2435	84	3.3
CN2000900000000	20	009	Barton County, KS	2001	NA	14090	13640	450	3.2
CN2001100000000	20	011	Bourbon County, KS	2001	NA	8764	8430	334	3.8
CN2001300000000	20	013	Brown County, KS	2001	NA	5172	4893	279	5.4
CN2001500000000	20	015	Butler County, KS	2001	NA	30460	29264	1196	3.9
CN2001700000000	20	017	Chase County, KS	2001	NA	1550	1493	57	3.7
CN2001900000000	20	019	Chautauqua County, KS	2001	NA	1883	1790	93	4.9
CN2002100000000	20	021	Cherokee County, KS	2001	NA	10532	9936	596	5.7
CN2002300000000	20	023	Cheyenne County, KS	2001	NA	1496	1451	45	3
CN2002500000000	20	025	Clark County, KS	2001	NA	1166	1136	30	2.6
CN2002700000000	20	027	Clay County, KS	2001	NA	4452	4270	182	4.1
CN2002900000000	20	029	Cloud County, KS	2001	NA	5181	4993	188	3.6
CN2003100000000	20	031	Coffey County, KS	2001	NA	4597	4363	234	5.1
CN2003300000000	20	033	Comanche County, KS	2001	NA	1003	977	26	2.6
CN2003500000000	20	035	Cowley County, KS	2001	NA	17776	17031	745	4.2
CN2003700000000	20	037	Crawford County, KS	2001	NA	18762	17819	943	5
CN2003900000000	20	039	Decatur County, KS	2001	NA	1798	1748	50	2.8
CN2004100000000	20	041	Dickinson County, KS	2001	NA	9864	9477	387	3.9
CN2004300000000	20	043	Doniphan County, KS	2001	NA	4235	3912	323	7.6
CN2004500000000	20	045	Douglas County, KS	2001	NA	58558	56673	1885	3.2
CN2004700000000	20	047	Edwards County, KS	2001	NA	1666	1619	47	2.8
CN2004900000000	20	049	Elk County, KS	2001	NA	1464	1387	77	5.3
CN2005100000000	20	051	Ellis County, KS	2001	NA	15397	14955	442	2.9
CN2005300000000	20	053	Ellsworth County, KS	2001	NA	3102	2996	106	3.4
CN2005500000000	20	055	Finney County, KS	2001	NA	18522	17217	1305	7
CN2005700000000	20	057	Ford County, KS	2001	NA	15484	15003	481	3.1
CN2005900000000	20	059	Franklin County, KS	2001	NA	13115	12486	629	4.8
CN2006100000000	20	061	Geary County, KS	2001	NA	10994	10391	603	5.5
CN2006300000000	20	063	Gove County, KS	2001	NA	1507	1468	39	2.6
CN2006500000000	20	065	Graham County, KS	2001	NA	1366	1322	44	3.2
CN2006700000000	20	067	Grant County, KS	2001	NA	3687	3583	104	2.8
CN2006900000000	20	069	Gray County, KS	2001	NA	3005	2928	77	2.6
CN2007100000000	20	071	Greeley County, KS	2001	NA	787	760	27	3.4
CN2007300000000	20	073	Greenwood County, KS	2001	NA	3536	3356	180	5.1
CN2007500000000	20	075	Hamilton County, KS	2001	NA	1255	1218	37	2.9
CN2007700000000	20	077	Harper County, KS	2001	NA	3076	2965	111	3.6
CN2007900000000	20	079	Harvey County, KS	2001	NA	17473	16876	597	3.4
CN2008100000000	20	081	Haskell County, KS	2001	NA	2036	1979	57	2.8
CN2008300000000	20	083	Hodgeman County, KS	2001	NA	934	904	30	3.2
CN2008500000000	20	085	Jackson County, KS	2001	NA	6638	6348	290	4.4
CN2008700000000	20	087	Jefferson County, KS	2001	NA	9774	9377	397	4.1
CN2008900000000	20	089	Jewell County, KS	2001	NA	1816	1764	52	2.9
CN2009100000000	20	091	Johnson County, KS	2001	NA	262563	252706	9857	3.8
CN2009300000000	20	093	Kearny County, KS	2001	NA	1913	1851	62	3.2
CN2009500000000	20	095	Kingman County, KS	2001	NA	4147	3998	149	3.6
CN2009700000000	20	097	Kiowa County, KS	2001	NA	1490	1442	48	3.2
CN2009900000000	20	099	Labette County, KS	2001	NA	10720	10137	583	5.4
CN2010100000000	20	101	Lane County, KS	2001	NA	1110	1071	39	3.5
CN2010300000000	20	103	Leavenworth County, KS	2001	NA	31117	29539	1578	5.1
CN2010500000000	20	105	Lincoln County, KS	2001	NA	1786	1722	64	3.6
CN2010700000000	20	107	Linn County, KS	2001	NA	4700	4419	281	6
CN2010900000000	20	109	Logan County, KS	2001	NA	1537	1490	47	3.1
CN2011100000000	20	111	Lyon County, KS	2001	NA	18551	17799	752	4.1
CN2011300000000	20	113	McPherson County, KS	2001	NA	15026	14490	536	3.6
CN2011500000000	20	115	Marion County, KS	2001	NA	6555	6328	227	3.5
CN2011700000000	20	117	Marshall County, KS	2001	NA	5483	5276	207	3.8
CN2011900000000	20	119	Meade County, KS	2001	NA	2105	2044	61	2.9
CN2012100000000	20	121	Miami County, KS	2001	NA	15128	14498	630	4.2
CN2012300000000	20	123	Mitchell County, KS	2001	NA	3263	3146	117	3.6
CN2012500000000	20	125	Montgomery County, KS	2001	NA	16196	15152	1044	6.4
CN2012700000000	20	127	Morris County, KS	2001	NA	2912	2792	120	4.1
CN2012900000000	20	129	Morton County, KS	2001	NA	1664	1618	46	2.8
CN2013100000000	20	131	Nemaha County, KS	2001	NA	4926	4751	175	3.6
CN2013300000000	20	133	Neosho County, KS	2001	NA	8275	7834	441	5.3
CN2013500000000	20	135	Ness County, KS	2001	NA	1717	1669	48	2.8
CN2013700000000	20	137	Norton County, KS	2001	NA	2532	2442	90	3.6
CN2013900000000	20	139	Osage County, KS	2001	NA	8770	8359	411	4.7
CN2014100000000	20	141	Osborne County, KS	2001	NA	2264	2185	79	3.5
CN2014300000000	20	143	Ottawa County, KS	2001	NA	3287	3166	121	3.7
CN2014500000000	20	145	Pawnee County, KS	2001	NA	3441	3337	104	3
CN2014700000000	20	147	Phillips County, KS	2001	NA	3014	2925	89	3
CN2014900000000	20	149	Pottawatomie County, KS	2001	NA	9286	8927	359	3.9
CN2015100000000	20	151	Pratt County, KS	2001	NA	4987	4846	141	2.8
CN2015300000000	20	153	Rawlins County, KS	2001	NA	1350	1305	45	3.3
CN2015500000000	20	155	Reno County, KS	2001	NA	31821	30402	1419	4.5
CN2015700000000	20	157	Republic County, KS	2001	NA	2873	2776	97	3.4
CN2015900000000	20	159	Rice County, KS	2001	NA	5133	4943	190	3.7
CN2016100000000	20	161	Riley County, KS	2001	NA	30142	29169	973	3.2
CN2016300000000	20	163	Rooks County, KS	2001	NA	2671	2579	92	3.4
CN2016500000000	20	165	Rush County, KS	2001	NA	1665	1607	58	3.5
CN2016700000000	20	167	Russell County, KS	2001	NA	3243	3081	162	5
CN2016900000000	20	169	Saline County, KS	2001	NA	29487	28401	1086	3.7
CN2017100000000	20	171	Scott County, KS	2001	NA	2914	2844	70	2.4
CN2017300000000	20	173	Sedgwick County, KS	2001	NA	237443	227793	9650	4.1
CN2017500000000	20	175	Seward County, KS	2001	NA	10145	9773	372	3.7
CN2017700000000	20	177	Shawnee County, KS	2001	NA	91149	87382	3767	4.1
CN2017900000000	20	179	Sheridan County, KS	2001	NA	1442	1406	36	2.5
CN2018100000000	20	181	Sherman County, KS	2001	NA	3727	3613	114	3.1
CN2018300000000	20	183	Smith County, KS	2001	NA	2130	2059	71	3.3
CN2018500000000	20	185	Stafford County, KS	2001	NA	2210	2138	72	3.3
CN2018700000000	20	187	Stanton County, KS	2001	NA	1217	1187	30	2.5
CN2018900000000	20	189	Stevens County, KS	2001	NA	2283	2203	80	3.5
CN2019100000000	20	191	Sumner County, KS	2001	NA	12574	12055	519	4.1
CN2019300000000	20	193	Thomas County, KS	2001	NA	4235	4116	119	2.8
CN2019500000000	20	195	Trego County, KS	2001	NA	1625	1577	48	3
CN2019700000000	20	197	Wabaunsee County, KS	2001	NA	3688	3558	130	3.5
CN2019900000000	20	199	Wallace County, KS	2001	NA	908	882	26	2.9
CN2020100000000	20	201	Washington County, KS	2001	NA	3302	3182	120	3.6
CN2020300000000	20	203	Wichita County, KS	2001	NA	1196	1158	38	3.2
CN2020500000000	20	205	Wilson County, KS	2001	NA	4755	4480	275	5.8
CN2020700000000	20	207	Woodson County, KS	2001	NA	1686	1581	105	6.2
CN2020900000000	20	209	Wyandotte County, KS	2001	NA	73333	67926	5407	7.4
CN2100100000000	21	001	Adair County, KY	2001	NA	8731	8316	415	4.8
CN2100300000000	21	003	Allen County, KY	2001	NA	8728	8203	525	6
CN2100500000000	21	005	Anderson County, KY	2001	NA	10332	9817	515	5
CN2100700000000	21	007	Ballard County, KY	2001	NA	4178	3902	276	6.6
CN2100900000000	21	009	Barren County, KY	2001	NA	19375	18411	964	5
CN2101100000000	21	011	Bath County, KY	2001	NA	5046	4675	371	7.4
CN2101300000000	21	013	Bell County, KY	2001	NA	9824	9013	811	8.3
CN2101500000000	21	015	Boone County, KY	2001	NA	50296	48350	1946	3.9
CN2101700000000	21	017	Bourbon County, KY	2001	NA	9950	9495	455	4.6
CN2101900000000	21	019	Boyd County, KY	2001	NA	21523	20140	1383	6.4
CN2102100000000	21	021	Boyle County, KY	2001	NA	13568	12834	734	5.4
CN2102300000000	21	023	Bracken County, KY	2001	NA	4188	3990	198	4.7
CN2102500000000	21	025	Breathitt County, KY	2001	NA	5399	4989	410	7.6
CN2102700000000	21	027	Breckinridge County, KY	2001	NA	8775	8226	549	6.3
CN2102900000000	21	029	Bullitt County, KY	2001	NA	33257	31861	1396	4.2
CN2103100000000	21	031	Butler County, KY	2001	NA	6732	6365	367	5.5
CN2103300000000	21	033	Caldwell County, KY	2001	NA	6277	5957	320	5.1
CN2103500000000	21	035	Calloway County, KY	2001	NA	17320	16423	897	5.2
CN2103700000000	21	037	Campbell County, KY	2001	NA	46072	44064	2008	4.4
CN2103900000000	21	039	Carlisle County, KY	2001	NA	2428	2272	156	6.4
CN2104100000000	21	041	Carroll County, KY	2001	NA	5247	4947	300	5.7
CN2104300000000	21	043	Carter County, KY	2001	NA	12505	11228	1277	10.2
CN2104500000000	21	045	Casey County, KY	2001	NA	7215	6729	486	6.7
CN2104700000000	21	047	Christian County, KY	2001	NA	26486	24723	1763	6.7
CN2104900000000	21	049	Clark County, KY	2001	NA	16986	16090	896	5.3
CN2105100000000	21	051	Clay County, KY	2001	NA	7321	6778	543	7.4
CN2105300000000	21	053	Clinton County, KY	2001	NA	4689	4401	288	6.1
CN2105500000000	21	055	Crittenden County, KY	2001	NA	4406	4074	332	7.5
CN2105700000000	21	057	Cumberland County, KY	2001	NA	3258	3073	185	5.7
CN2105900000000	21	059	Daviess County, KY	2001	NA	46359	44034	2325	5
CN2106100000000	21	061	Edmonson County, KY	2001	NA	5026	4723	303	6
CN2106300000000	21	063	Elliott County, KY	2001	NA	2556	2333	223	8.7
CN2106500000000	21	065	Estill County, KY	2001	NA	6084	5707	377	6.2
CN2106700000000	21	067	Fayette County, KY	2001	NA	147819	142345	5474	3.7
CN2106900000000	21	069	Fleming County, KY	2001	NA	6690	6358	332	5
CN2107100000000	21	071	Floyd County, KY	2001	NA	13935	13012	923	6.6
CN2107300000000	21	073	Franklin County, KY	2001	NA	25158	24228	930	3.7
CN2107500000000	21	075	Fulton County, KY	2001	NA	3208	3004	204	6.4
CN2107700000000	21	077	Gallatin County, KY	2001	NA	3890	3710	180	4.6
CN2107900000000	21	079	Garrard County, KY	2001	NA	7567	7208	359	4.7
CN2108100000000	21	081	Grant County, KY	2001	NA	11759	11169	590	5
CN2108300000000	21	083	Graves County, KY	2001	NA	17118	15999	1119	6.5
CN2108500000000	21	085	Grayson County, KY	2001	NA	11541	10681	860	7.5
CN2108700000000	21	087	Green County, KY	2001	NA	5565	5267	298	5.4
CN2108900000000	21	089	Greenup County, KY	2001	NA	15898	14908	990	6.2
CN2109100000000	21	091	Hancock County, KY	2001	NA	4145	3902	243	5.9
CN2109300000000	21	093	Hardin County, KY	2001	NA	43178	40986	2192	5.1
CN2109500000000	21	095	Harlan County, KY	2001	NA	9985	9218	767	7.7
CN2109700000000	21	097	Harrison County, KY	2001	NA	9269	8794	475	5.1
CN2109900000000	21	099	Hart County, KY	2001	NA	7761	7343	418	5.4
CN2110100000000	21	101	Henderson County, KY	2001	NA	23101	22021	1080	4.7
CN2110300000000	21	103	Henry County, KY	2001	NA	7685	7353	332	4.3
CN2110500000000	21	105	Hickman County, KY	2001	NA	2418	2277	141	5.8
CN2110700000000	21	107	Hopkins County, KY	2001	NA	21096	19884	1212	5.7
CN2110900000000	21	109	Jackson County, KY	2001	NA	4894	4498	396	8.1
CN2111100000000	21	111	Jefferson County, KY	2001	NA	355396	338825	16571	4.7
CN2111300000000	21	113	Jessamine County, KY	2001	NA	20660	19877	783	3.8
CN2111500000000	21	115	Johnson County, KY	2001	NA	9269	8708	561	6.1
CN2111700000000	21	117	Kenton County, KY	2001	NA	82206	78724	3482	4.2
CN2111900000000	21	119	Knott County, KY	2001	NA	5659	5276	383	6.8
CN2112100000000	21	121	Knox County, KY	2001	NA	11218	10503	715	6.4
CN2112300000000	21	123	Larue County, KY	2001	NA	6367	6056	311	4.9
CN2112500000000	21	125	Laurel County, KY	2001	NA	25062	23817	1245	5
CN2112700000000	21	127	Lawrence County, KY	2001	NA	5549	5095	454	8.2
CN2112900000000	21	129	Lee County, KY	2001	NA	2523	2344	179	7.1
CN2113100000000	21	131	Leslie County, KY	2001	NA	3880	3644	236	6.1
CN2113300000000	21	133	Letcher County, KY	2001	NA	8849	8298	551	6.2
CN2113500000000	21	135	Lewis County, KY	2001	NA	5583	5140	443	7.9
CN2113700000000	21	137	Lincoln County, KY	2001	NA	11130	10457	673	6
CN2113900000000	21	139	Livingston County, KY	2001	NA	4961	4644	317	6.4
CN2114100000000	21	141	Logan County, KY	2001	NA	13232	12358	874	6.6
CN2114300000000	21	143	Lyon County, KY	2001	NA	3299	3099	200	6.1
CN2114500000000	21	145	McCracken County, KY	2001	NA	31501	29878	1623	5.2
CN2114700000000	21	147	McCreary County, KY	2001	NA	6368	5765	603	9.5
CN2114900000000	21	149	McLean County, KY	2001	NA	4661	4390	271	5.8
CN2115100000000	21	151	Madison County, KY	2001	NA	37620	35854	1766	4.7
CN2115300000000	21	153	Magoffin County, KY	2001	NA	4489	4043	446	9.9
CN2115500000000	21	155	Marion County, KY	2001	NA	8779	8276	503	5.7
CN2115700000000	21	157	Marshall County, KY	2001	NA	14854	13905	949	6.4
CN2115900000000	21	159	Martin County, KY	2001	NA	3712	3467	245	6.6
CN2116100000000	21	161	Mason County, KY	2001	NA	8487	8094	393	4.6
CN2116300000000	21	163	Meade County, KY	2001	NA	11655	11059	596	5.1
CN2116500000000	21	165	Menifee County, KY	2001	NA	2647	2442	205	7.7
CN2116700000000	21	167	Mercer County, KY	2001	NA	10736	10192	544	5.1
CN2116900000000	21	169	Metcalfe County, KY	2001	NA	4598	4361	237	5.2
CN2117100000000	21	171	Monroe County, KY	2001	NA	5198	4740	458	8.8
CN2117300000000	21	173	Montgomery County, KY	2001	NA	11478	10771	707	6.2
CN2117500000000	21	175	Morgan County, KY	2001	NA	5231	4800	431	8.2
CN2117700000000	21	177	Muhlenberg County, KY	2001	NA	13026	11957	1069	8.2
CN2117900000000	21	179	Nelson County, KY	2001	NA	19560	18556	1004	5.1
CN2118100000000	21	181	Nicholas County, KY	2001	NA	3225	3029	196	6.1
CN2118300000000	21	183	Ohio County, KY	2001	NA	10660	10017	643	6
CN2118500000000	21	185	Oldham County, KY	2001	NA	23938	23105	833	3.5
CN2118700000000	21	187	Owen County, KY	2001	NA	5046	4831	215	4.3
CN2118900000000	21	189	Owsley County, KY	2001	NA	1581	1473	108	6.8
CN2119100000000	21	191	Pendleton County, KY	2001	NA	7166	6840	326	4.5
CN2119300000000	21	193	Perry County, KY	2001	NA	10336	9650	686	6.6
CN2119500000000	21	195	Pike County, KY	2001	NA	25169	23753	1416	5.6
CN2119700000000	21	197	Powell County, KY	2001	NA	5901	5487	414	7
CN2119900000000	21	199	Pulaski County, KY	2001	NA	26612	24856	1756	6.6
CN2120100000000	21	201	Robertson County, KY	2001	NA	1096	1044	52	4.7
CN2120300000000	21	203	Rockcastle County, KY	2001	NA	7118	6663	455	6.4
CN2120500000000	21	205	Rowan County, KY	2001	NA	11107	10452	655	5.9
CN2120700000000	21	207	Russell County, KY	2001	NA	7760	7278	482	6.2
CN2120900000000	21	209	Scott County, KY	2001	NA	18617	17888	729	3.9
CN2121100000000	21	211	Shelby County, KY	2001	NA	18343	17562	781	4.3
CN2121300000000	21	213	Simpson County, KY	2001	NA	8569	8105	464	5.4
CN2121500000000	21	215	Spencer County, KY	2001	NA	6840	6561	279	4.1
CN2121700000000	21	217	Taylor County, KY	2001	NA	11768	11173	595	5.1
CN2121900000000	21	219	Todd County, KY	2001	NA	5908	5526	382	6.5
CN2122100000000	21	221	Trigg County, KY	2001	NA	5954	5614	340	5.7
CN2122300000000	21	223	Trimble County, KY	2001	NA	4158	3936	222	5.3
CN2122500000000	21	225	Union County, KY	2001	NA	7403	6995	408	5.5
CN2122700000000	21	227	Warren County, KY	2001	NA	50031	47664	2367	4.7
CN2122900000000	21	229	Washington County, KY	2001	NA	5388	5071	317	5.9
CN2123100000000	21	231	Wayne County, KY	2001	NA	8417	7805	612	7.3
CN2123300000000	21	233	Webster County, KY	2001	NA	6708	6400	308	4.6
CN2123500000000	21	235	Whitley County, KY	2001	NA	14575	13706	869	6
CN2123700000000	21	237	Wolfe County, KY	2001	NA	2465	2250	215	8.7
CN2123900000000	21	239	Woodford County, KY	2001	NA	13308	12790	518	3.9
CN2200100000000	22	001	Acadia Parish, LA	2001	NA	23711	22289	1422	6
CN2200300000000	22	003	Allen Parish, LA	2001	NA	8627	7981	646	7.5
CN2200500000000	22	005	Ascension Parish, LA	2001	NA	38751	36592	2159	5.6
CN2200700000000	22	007	Assumption Parish, LA	2001	NA	10391	9761	630	6.1
CN2200900000000	22	009	Avoyelles Parish, LA	2001	NA	15776	14618	1158	7.3
CN2201100000000	22	011	Beauregard Parish, LA	2001	NA	13979	13095	884	6.3
CN2201300000000	22	013	Bienville Parish, LA	2001	NA	5914	5421	493	8.3
CN2201500000000	22	015	Bossier Parish, LA	2001	NA	47233	44737	2496	5.3
CN2201700000000	22	017	Caddo Parish, LA	2001	NA	114170	107314	6856	6
CN2201900000000	22	019	Calcasieu Parish, LA	2001	NA	85903	81011	4892	5.7
CN2202100000000	22	021	Caldwell Parish, LA	2001	NA	4341	4002	339	7.8
CN2202300000000	22	023	Cameron Parish, LA	2001	NA	4458	4224	234	5.2
CN2202500000000	22	025	Catahoula Parish, LA	2001	NA	4085	3702	383	9.4
CN2202700000000	22	027	Claiborne Parish, LA	2001	NA	6743	6277	466	6.9
CN2202900000000	22	029	Concordia Parish, LA	2001	NA	7562	6830	732	9.7
CN2203100000000	22	031	De Soto Parish, LA	2001	NA	10756	10010	746	6.9
CN2203300000000	22	033	East Baton Rouge Parish, LA	2001	NA	202952	192284	10668	5.3
CN2203500000000	22	035	East Carroll Parish, LA	2001	NA	3113	2739	374	12
CN2203700000000	22	037	East Feliciana Parish, LA	2001	NA	8103	7583	520	6.4
CN2203900000000	22	039	Evangeline Parish, LA	2001	NA	11954	11147	807	6.8
CN2204100000000	22	041	Franklin Parish, LA	2001	NA	8120	7410	710	8.7
CN2204300000000	22	043	Grant Parish, LA	2001	NA	7903	7366	537	6.8
CN2204500000000	22	045	Iberia Parish, LA	2001	NA	30868	29115	1753	5.7
CN2204700000000	22	047	Iberville Parish, LA	2001	NA	12391	11464	927	7.5
CN2204900000000	22	049	Jackson Parish, LA	2001	NA	6658	6211	447	6.7
CN2205100000000	22	051	Jefferson Parish, LA	2001	NA	227874	216932	10942	4.8
CN2205300000000	22	053	Jefferson Davis Parish, LA	2001	NA	12843	12078	765	6
CN2205500000000	22	055	Lafayette Parish, LA	2001	NA	99544	95345	4199	4.2
CN2205700000000	22	057	Lafourche Parish, LA	2001	NA	42164	40257	1907	4.5
CN2205900000000	22	059	LaSalle Parish, LA	2001	NA	5955	5567	388	6.5
CN2206100000000	22	061	Lincoln Parish, LA	2001	NA	18691	17537	1154	6.2
CN2206300000000	22	063	Livingston Parish, LA	2001	NA	45223	42673	2550	5.6
CN2206500000000	22	065	Madison Parish, LA	2001	NA	5089	4598	491	9.6
CN2206700000000	22	067	Morehouse Parish, LA	2001	NA	12636	11563	1073	8.5
CN2206900000000	22	069	Natchitoches Parish, LA	2001	NA	16886	15753	1133	6.7
CN2207100000000	22	071	Orleans Parish, LA	2001	NA	206259	194236	12023	5.8
CN2207300000000	22	073	Ouachita Parish, LA	2001	NA	70916	67059	3857	5.4
CN2207500000000	22	075	Plaquemines Parish, LA	2001	NA	11000	10383	617	5.6
CN2207700000000	22	077	Pointe Coupee Parish, LA	2001	NA	9538	8881	657	6.9
CN2207900000000	22	079	Rapides Parish, LA	2001	NA	55644	52311	3333	6
CN2208100000000	22	081	Red River Parish, LA	2001	NA	3593	3304	289	8
CN2208300000000	22	083	Richland Parish, LA	2001	NA	8591	7939	652	7.6
CN2208500000000	22	085	Sabine Parish, LA	2001	NA	9295	8703	592	6.4
CN2208700000000	22	087	St. Bernard Parish, LA	2001	NA	31642	29830	1812	5.7
CN2208900000000	22	089	St. Charles Parish, LA	2001	NA	23722	22431	1291	5.4
CN2209100000000	22	091	St. Helena Parish, LA	2001	NA	3967	3713	254	6.4
CN2209300000000	22	093	St. James Parish, LA	2001	NA	8779	7967	812	9.2
CN2209500000000	22	095	St. John the Baptist Parish, LA	2001	NA	20030	18657	1373	6.9
CN2209700000000	22	097	St. Landry Parish, LA	2001	NA	32884	30611	2273	6.9
CN2209900000000	22	099	St. Martin Parish, LA	2001	NA	22142	20721	1421	6.4
CN2210100000000	22	101	St. Mary Parish, LA	2001	NA	22630	21031	1599	7.1
CN2210300000000	22	103	St. Tammany Parish, LA	2001	NA	97371	92825	4546	4.7
CN2210500000000	22	105	Tangipahoa Parish, LA	2001	NA	45853	42698	3155	6.9
CN2210700000000	22	107	Tensas Parish, LA	2001	NA	2254	2057	197	8.7
CN2210900000000	22	109	Terrebonne Parish, LA	2001	NA	47155	44940	2215	4.7
CN2211100000000	22	111	Union Parish, LA	2001	NA	10414	9788	626	6
CN2211300000000	22	113	Vermilion Parish, LA	2001	NA	23584	22260	1324	5.6
CN2211500000000	22	115	Vernon Parish, LA	2001	NA	18499	17282	1217	6.6
CN2211700000000	22	117	Washington Parish, LA	2001	NA	17064	15836	1228	7.2
CN2211900000000	22	119	Webster Parish, LA	2001	NA	18373	17049	1324	7.2
CN2212100000000	22	121	West Baton Rouge Parish, LA	2001	NA	10022	9455	567	5.7
CN2212300000000	22	123	West Carroll Parish, LA	2001	NA	4875	4337	538	11
CN2212500000000	22	125	West Feliciana Parish, LA	2001	NA	4746	4392	354	7.5
CN2212700000000	22	127	Winn Parish, LA	2001	NA	6099	5641	458	7.5
CN2300100000000	23	001	Androscoggin County, ME	2001	NA	55097	52910	2187	4
CN2300300000000	23	003	Aroostook County, ME	2001	NA	34048	32504	1544	4.5
CN2300500000000	23	005	Cumberland County, ME	2001	NA	149431	145219	4212	2.8
CN2300700000000	23	007	Franklin County, ME	2001	NA	14111	13360	751	5.3
CN2300900000000	23	009	Hancock County, ME	2001	NA	28708	27524	1184	4.1
CN2301100000000	23	011	Kennebec County, ME	2001	NA	60739	58420	2319	3.8
CN2301300000000	23	013	Knox County, ME	2001	NA	20956	20310	646	3.1
CN2301500000000	23	015	Lincoln County, ME	2001	NA	17645	17055	590	3.3
CN2301700000000	23	017	Oxford County, ME	2001	NA	27532	26244	1288	4.7
CN2301900000000	23	019	Penobscot County, ME	2001	NA	75763	72646	3117	4.1
CN2302100000000	23	021	Piscataquis County, ME	2001	NA	7886	7440	446	5.7
CN2302300000000	23	023	Sagadahoc County, ME	2001	NA	18452	17873	579	3.1
CN2302500000000	23	025	Somerset County, ME	2001	NA	24623	23141	1482	6
CN2302700000000	23	027	Waldo County, ME	2001	NA	19415	18587	828	4.3
CN2302900000000	23	029	Washington County, ME	2001	NA	15397	14363	1034	6.7
CN2303100000000	23	031	York County, ME	2001	NA	104520	100960	3560	3.4
CN2400100000000	24	001	Allegany County, MD	2001	NA	33110	31028	2082	6.3
CN2400300000000	24	003	Anne Arundel County, MD	2001	NA	270943	261656	9287	3.4
CN2400500000000	24	005	Baltimore County, MD	2001	NA	412304	395297	17007	4.1
CN2400900000000	24	009	Calvert County, MD	2001	NA	41159	39852	1307	3.2
CN2401100000000	24	011	Caroline County, MD	2001	NA	15512	14799	713	4.6
CN2401300000000	24	013	Carroll County, MD	2001	NA	85611	82879	2732	3.2
CN2401500000000	24	015	Cecil County, MD	2001	NA	46301	44493	1808	3.9
CN2401700000000	24	017	Charles County, MD	2001	NA	66254	64161	2093	3.2
CN2401900000000	24	019	Dorchester County, MD	2001	NA	16031	15025	1006	6.3
CN2402100000000	24	021	Frederick County, MD	2001	NA	111918	108398	3520	3.1
CN2402300000000	24	023	Garrett County, MD	2001	NA	14930	14136	794	5.3
CN2402500000000	24	025	Harford County, MD	2001	NA	121814	117329	4485	3.7
CN2402700000000	24	027	Howard County, MD	2001	NA	148307	143845	4462	3
CN2402900000000	24	029	Kent County, MD	2001	NA	10392	9969	423	4.1
CN2403100000000	24	031	Montgomery County, MD	2001	NA	492186	477132	15054	3.1
CN2403300000000	24	033	Prince George's County, MD	2001	NA	432379	414310	18069	4.2
CN2403500000000	24	035	Queen Anne's County, MD	2001	NA	23099	22314	785	3.4
CN2403700000000	24	037	St. Mary's County, MD	2001	NA	45586	44066	1520	3.3
CN2403900000000	24	039	Somerset County, MD	2001	NA	10860	10137	723	6.7
CN2404100000000	24	041	Talbot County, MD	2001	NA	18110	17472	638	3.5
CN2404300000000	24	043	Washington County, MD	2001	NA	67014	64063	2951	4.4
CN2404500000000	24	045	Wicomico County, MD	2001	NA	47426	45187	2239	4.7
CN2404700000000	24	047	Worcester County, MD	2001	NA	26982	25228	1754	6.5
CN2451000000000	24	510	Baltimore city, MD	2001	NA	279761	261410	18351	6.6
CN2500100000000	25	001	Barnstable County, MA	2001	NA	114662	110183	4479	3.9
CN2500300000000	25	003	Berkshire County, MA	2001	NA	70674	68170	2504	3.5
CN2500500000000	25	005	Bristol County, MA	2001	NA	278000	264733	13267	4.8
CN2500700000000	25	007	Dukes County, MA	2001	NA	10094	9796	298	3
CN2500900000000	25	009	Essex County, MA	2001	NA	376738	361438	15300	4.1
CN2501100000000	25	011	Franklin County, MA	2001	NA	38983	37772	1211	3.1
CN2501300000000	25	013	Hampden County, MA	2001	NA	220472	211137	9335	4.2
CN2501500000000	25	015	Hampshire County, MA	2001	NA	85973	83631	2342	2.7
CN2501700000000	25	017	Middlesex County, MA	2001	NA	825602	798331	27271	3.3
CN2501900000000	25	019	Nantucket County/town, MA	2001	NA	7079	6962	117	1.7
CN2502100000000	25	021	Norfolk County, MA	2001	NA	357499	346157	11342	3.2
CN2502300000000	25	023	Plymouth County, MA	2001	NA	252886	244010	8876	3.5
CN2502500000000	25	025	Suffolk County, MA	2001	NA	351958	337308	14650	4.2
CN2502700000000	25	027	Worcester County, MA	2001	NA	390669	375508	15161	3.9
CN2600100000000	26	001	Alcona County, MI	2001	NA	4321	3873	448	10.4
CN2600300000000	26	003	Alger County, MI	2001	NA	4422	4139	283	6.4
CN2600500000000	26	005	Allegan County, MI	2001	NA	57521	54977	2544	4.4
CN2600700000000	26	007	Alpena County, MI	2001	NA	15681	14429	1252	8
CN2600900000000	26	009	Antrim County, MI	2001	NA	11641	10875	766	6.6
CN2601100000000	26	011	Arenac County, MI	2001	NA	7676	7065	611	8
CN2601300000000	26	013	Baraga County, MI	2001	NA	4014	3646	368	9.2
CN2601500000000	26	015	Barry County, MI	2001	NA	30503	29106	1397	4.6
CN2601700000000	26	017	Bay County, MI	2001	NA	56307	53220	3087	5.5
CN2601900000000	26	019	Benzie County, MI	2001	NA	8412	7899	513	6.1
CN2602100000000	26	021	Berrien County, MI	2001	NA	81361	76783	4578	5.6
CN2602300000000	26	023	Branch County, MI	2001	NA	23392	22104	1288	5.5
CN2602500000000	26	025	Calhoun County, MI	2001	NA	70635	66806	3829	5.4
CN2602700000000	26	027	Cass County, MI	2001	NA	26944	25659	1285	4.8
CN2602900000000	26	029	Charlevoix County, MI	2001	NA	13826	12978	848	6.1
CN2603100000000	26	031	Cheboygan County, MI	2001	NA	12999	11724	1275	9.8
CN2603300000000	26	033	Chippewa County, MI	2001	NA	17448	16106	1342	7.7
CN2603500000000	26	035	Clare County, MI	2001	NA	12900	11950	950	7.4
CN2603700000000	26	037	Clinton County, MI	2001	NA	35889	34664	1225	3.4
CN2603900000000	26	039	Crawford County, MI	2001	NA	6741	6356	385	5.7
CN2604100000000	26	041	Delta County, MI	2001	NA	19991	18665	1326	6.6
CN2604300000000	26	043	Dickinson County, MI	2001	NA	14172	13447	725	5.1
CN2604500000000	26	045	Eaton County, MI	2001	NA	58161	55997	2164	3.7
CN2604700000000	26	047	Emmet County, MI	2001	NA	18234	17076	1158	6.4
CN2604900000000	26	049	Genesee County, MI	2001	NA	215652	202254	13398	6.2
CN2605100000000	26	051	Gladwin County, MI	2001	NA	11030	10242	788	7.1
CN2605300000000	26	053	Gogebic County, MI	2001	NA	7974	7388	586	7.3
CN2605500000000	26	055	Grand Traverse County, MI	2001	NA	45647	43424	2223	4.9
CN2605700000000	26	057	Gratiot County, MI	2001	NA	19486	18378	1108	5.7
CN2605900000000	26	059	Hillsdale County, MI	2001	NA	23978	22505	1473	6.1
CN2606100000000	26	061	Houghton County, MI	2001	NA	17033	15974	1059	6.2
CN2606300000000	26	063	Huron County, MI	2001	NA	17363	16062	1301	7.5
CN2606500000000	26	065	Ingham County, MI	2001	NA	154468	148267	6201	4
CN2606700000000	26	067	Ionia County, MI	2001	NA	30044	28478	1566	5.2
CN2606900000000	26	069	Iosco County, MI	2001	NA	11085	10027	1058	9.5
CN2607100000000	26	071	Iron County, MI	2001	NA	5738	5355	383	6.7
CN2607300000000	26	073	Isabella County, MI	2001	NA	35222	33812	1410	4
CN2607500000000	26	075	Jackson County, MI	2001	NA	79659	75349	4310	5.4
CN2607700000000	26	077	Kalamazoo County, MI	2001	NA	131690	126075	5615	4.3
CN2607900000000	26	079	Kalkaska County, MI	2001	NA	8592	7949	643	7.5
CN2608100000000	26	081	Kent County, MI	2001	NA	320943	305541	15402	4.8
CN2608300000000	26	083	Keweenaw County, MI	2001	NA	1058	971	87	8.2
CN2608500000000	26	085	Lake County, MI	2001	NA	4473	4123	350	7.8
CN2608700000000	26	087	Lapeer County, MI	2001	NA	45633	42837	2796	6.1
CN2608900000000	26	089	Leelanau County, MI	2001	NA	11117	10691	426	3.8
CN2609100000000	26	091	Lenawee County, MI	2001	NA	52109	49251	2858	5.5
CN2609300000000	26	093	Livingston County, MI	2001	NA	89973	86826	3147	3.5
CN2609500000000	26	095	Luce County, MI	2001	NA	2852	2657	195	6.8
CN2609700000000	26	097	Mackinac County, MI	2001	NA	6873	6251	622	9
CN2609900000000	26	099	Macomb County, MI	2001	NA	428355	407043	21312	5
CN2610100000000	26	101	Manistee County, MI	2001	NA	12034	11238	796	6.6
CN2610300000000	26	103	Marquette County, MI	2001	NA	34444	32497	1947	5.7
CN2610500000000	26	105	Mason County, MI	2001	NA	15433	13966	1467	9.5
CN2610700000000	26	107	Mecosta County, MI	2001	NA	19086	18011	1075	5.6
CN2610900000000	26	109	Menominee County, MI	2001	NA	13356	12598	758	5.7
CN2611100000000	26	111	Midland County, MI	2001	NA	42711	40842	1869	4.4
CN2611300000000	26	113	Missaukee County, MI	2001	NA	6748	6272	476	7.1
CN2611500000000	26	115	Monroe County, MI	2001	NA	77290	73737	3553	4.6
CN2611700000000	26	117	Montcalm County, MI	2001	NA	30245	28333	1912	6.3
CN2611900000000	26	119	Montmorency County, MI	2001	NA	4162	3727	435	10.5
CN2612100000000	26	121	Muskegon County, MI	2001	NA	85594	80267	5327	6.2
CN2612300000000	26	123	Newaygo County, MI	2001	NA	23334	21843	1491	6.4
CN2612500000000	26	125	Oakland County, MI	2001	NA	661465	634356	27109	4.1
CN2612700000000	26	127	Oceana County, MI	2001	NA	13457	12467	990	7.4
CN2612900000000	26	129	Ogemaw County, MI	2001	NA	9690	8953	737	7.6
CN2613100000000	26	131	Ontonagon County, MI	2001	NA	3555	3280	275	7.7
CN2613300000000	26	133	Osceola County, MI	2001	NA	11141	10368	773	6.9
CN2613500000000	26	135	Oscoda County, MI	2001	NA	3875	3525	350	9
CN2613700000000	26	137	Otsego County, MI	2001	NA	12341	11590	751	6.1
CN2613900000000	26	139	Ottawa County, MI	2001	NA	134622	128891	5731	4.3
CN2614100000000	26	141	Presque Isle County, MI	2001	NA	6618	5976	642	9.7
CN2614300000000	26	143	Roscommon County, MI	2001	NA	10444	9735	709	6.8
CN2614500000000	26	145	Saginaw County, MI	2001	NA	99608	93696	5912	5.9
CN2614700000000	26	147	St. Clair County, MI	2001	NA	86032	80850	5182	6
CN2614900000000	26	149	St. Joseph County, MI	2001	NA	32093	30085	2008	6.3
CN2615100000000	26	151	Sanilac County, MI	2001	NA	22004	20479	1525	6.9
CN2615300000000	26	153	Schoolcraft County, MI	2001	NA	3906	3544	362	9.3
CN2615500000000	26	155	Shiawassee County, MI	2001	NA	36588	34518	2070	5.7
CN2615700000000	26	157	Tuscola County, MI	2001	NA	29085	27117	1968	6.8
CN2615900000000	26	159	Van Buren County, MI	2001	NA	39595	37401	2194	5.5
CN2616100000000	26	161	Washtenaw County, MI	2001	NA	190909	185111	5798	3
CN2616300000000	26	163	Wayne County, MI	2001	NA	942230	888352	53878	5.7
CN2616500000000	26	165	Wexford County, MI	2001	NA	15031	13735	1296	8.6
CN2700100000000	27	001	Aitkin County, MN	2001	NA	7330	6864	466	6.4
CN2700300000000	27	003	Anoka County, MN	2001	NA	181995	175577	6418	3.5
CN2700500000000	27	005	Becker County, MN	2001	NA	16268	15413	855	5.3
CN2700700000000	27	007	Beltrami County, MN	2001	NA	20868	19909	959	4.6
CN2700900000000	27	009	Benton County, MN	2001	NA	21269	20349	920	4.3
CN2701100000000	27	011	Big Stone County, MN	2001	NA	2848	2725	123	4.3
CN2701300000000	27	013	Blue Earth County, MN	2001	NA	34428	33402	1026	3
CN2701500000000	27	015	Brown County, MN	2001	NA	15561	14929	632	4.1
CN2701700000000	27	017	Carlton County, MN	2001	NA	15938	15026	912	5.7
CN2701900000000	27	019	Carver County, MN	2001	NA	42307	40938	1369	3.2
CN2702100000000	27	021	Cass County, MN	2001	NA	13734	12949	785	5.7
CN2702300000000	27	023	Chippewa County, MN	2001	NA	7433	7070	363	4.9
CN2702500000000	27	025	Chisago County, MN	2001	NA	24097	23013	1084	4.5
CN2702700000000	27	027	Clay County, MN	2001	NA	28358	27417	941	3.3
CN2702900000000	27	029	Clearwater County, MN	2001	NA	4388	3960	428	9.8
CN2703100000000	27	031	Cook County, MN	2001	NA	3219	3069	150	4.7
CN2703300000000	27	033	Cottonwood County, MN	2001	NA	6471	6228	243	3.8
CN2703500000000	27	035	Crow Wing County, MN	2001	NA	29936	28613	1323	4.4
CN2703700000000	27	037	Dakota County, MN	2001	NA	219504	212745	6759	3.1
CN2703900000000	27	039	Dodge County, MN	2001	NA	10481	10123	358	3.4
CN2704100000000	27	041	Douglas County, MN	2001	NA	18684	18006	678	3.6
CN2704300000000	27	043	Faribault County, MN	2001	NA	8529	8165	364	4.3
CN2704500000000	27	045	Fillmore County, MN	2001	NA	11992	11560	432	3.6
CN2704700000000	27	047	Freeborn County, MN	2001	NA	17397	16600	797	4.6
CN2704900000000	27	049	Goodhue County, MN	2001	NA	25755	24883	872	3.4
CN2705100000000	27	051	Grant County, MN	2001	NA	3316	3135	181	5.5
CN2705300000000	27	053	Hennepin County, MN	2001	NA	666946	643865	23081	3.5
CN2705500000000	27	055	Houston County, MN	2001	NA	11126	10640	486	4.4
CN2705700000000	27	057	Hubbard County, MN	2001	NA	9345	8870	475	5.1
CN2705900000000	27	059	Isanti County, MN	2001	NA	18506	17721	785	4.2
CN2706100000000	27	061	Itasca County, MN	2001	NA	22210	20825	1385	6.2
CN2706300000000	27	063	Jackson County, MN	2001	NA	6429	6219	210	3.3
CN2706500000000	27	065	Kanabec County, MN	2001	NA	8040	7529	511	6.4
CN2706700000000	27	067	Kandiyohi County, MN	2001	NA	23223	22399	824	3.5
CN2706900000000	27	069	Kittson County, MN	2001	NA	2647	2510	137	5.2
CN2707100000000	27	071	Koochiching County, MN	2001	NA	7246	6837	409	5.6
CN2707300000000	27	073	Lac qui Parle County, MN	2001	NA	4241	4070	171	4
CN2707500000000	27	075	Lake County, MN	2001	NA	6279	5954	325	5.2
CN2707700000000	27	077	Lake of the Woods County, MN	2001	NA	2343	2238	105	4.5
CN2707900000000	27	079	Le Sueur County, MN	2001	NA	15015	14267	748	5
CN2708100000000	27	081	Lincoln County, MN	2001	NA	3539	3414	125	3.5
CN2708300000000	27	083	Lyon County, MN	2001	NA	14934	14386	548	3.7
CN2708500000000	27	085	McLeod County, MN	2001	NA	20234	19496	738	3.6
CN2708700000000	27	087	Mahnomen County, MN	2001	NA	2661	2511	150	5.6
CN2708900000000	27	089	Marshall County, MN	2001	NA	5238	4872	366	7
CN2709100000000	27	091	Martin County, MN	2001	NA	11998	11530	468	3.9
CN2709300000000	27	093	Meeker County, MN	2001	NA	12581	11974	607	4.8
CN2709500000000	27	095	Mille Lacs County, MN	2001	NA	11953	11308	645	5.4
CN2709700000000	27	097	Morrison County, MN	2001	NA	17162	16241	921	5.4
CN2709900000000	27	099	Mower County, MN	2001	NA	20266	19570	696	3.4
CN2710100000000	27	101	Murray County, MN	2001	NA	5673	5462	211	3.7
CN2710300000000	27	103	Nicollet County, MN	2001	NA	18492	17937	555	3
CN2710500000000	27	105	Nobles County, MN	2001	NA	11415	11031	384	3.4
CN2710700000000	27	107	Norman County, MN	2001	NA	3787	3625	162	4.3
CN2710900000000	27	109	Olmsted County, MN	2001	NA	74134	72033	2101	2.8
CN2711100000000	27	111	Otter Tail County, MN	2001	NA	29620	28306	1314	4.4
CN2711300000000	27	113	Pennington County, MN	2001	NA	7875	7475	400	5.1
CN2711500000000	27	115	Pine County, MN	2001	NA	13942	13074	868	6.2
CN2711700000000	27	117	Pipestone County, MN	2001	NA	5569	5381	188	3.4
CN2711900000000	27	119	Polk County, MN	2001	NA	15941	15167	774	4.9
CN2712100000000	27	121	Pope County, MN	2001	NA	6056	5835	221	3.6
CN2712300000000	27	123	Ramsey County, MN	2001	NA	285372	275427	9945	3.5
CN2712500000000	27	125	Red Lake County, MN	2001	NA	2238	2079	159	7.1
CN2712700000000	27	127	Redwood County, MN	2001	NA	8989	8626	363	4
CN2712900000000	27	129	Renville County, MN	2001	NA	9250	8785	465	5
CN2713100000000	27	131	Rice County, MN	2001	NA	32330	31174	1156	3.6
CN2713300000000	27	133	Rock County, MN	2001	NA	5324	5187	137	2.6
CN2713500000000	27	135	Roseau County, MN	2001	NA	9498	9163	335	3.5
CN2713700000000	27	137	St. Louis County, MN	2001	NA	103362	97442	5920	5.7
CN2713900000000	27	139	Scott County, MN	2001	NA	57894	55967	1927	3.3
CN2714100000000	27	141	Sherburne County, MN	2001	NA	39496	38001	1495	3.8
CN2714300000000	27	143	Sibley County, MN	2001	NA	9007	8658	349	3.9
CN2714500000000	27	145	Stearns County, MN	2001	NA	79619	76602	3017	3.8
CN2714700000000	27	147	Steele County, MN	2001	NA	19658	18910	748	3.8
CN2714900000000	27	149	Stevens County, MN	2001	NA	5763	5565	198	3.4
CN2715100000000	27	151	Swift County, MN	2001	NA	5753	5495	258	4.5
CN2715300000000	27	153	Todd County, MN	2001	NA	12721	12151	570	4.5
CN2715500000000	27	155	Traverse County, MN	2001	NA	1869	1783	86	4.6
CN2715700000000	27	157	Wabasha County, MN	2001	NA	12514	12096	418	3.3
CN2715900000000	27	159	Wadena County, MN	2001	NA	6673	6279	394	5.9
CN2716100000000	27	161	Waseca County, MN	2001	NA	10699	10302	397	3.7
CN2716300000000	27	163	Washington County, MN	2001	NA	119974	116379	3595	3
CN2716500000000	27	165	Watonwan County, MN	2001	NA	6117	5904	213	3.5
CN2716700000000	27	167	Wilkin County, MN	2001	NA	3577	3436	141	3.9
CN2716900000000	27	169	Winona County, MN	2001	NA	28846	27785	1061	3.7
CN2717100000000	27	171	Wright County, MN	2001	NA	54097	52035	2062	3.8
CN2717300000000	27	173	Yellow Medicine County, MN	2001	NA	5804	5498	306	5.3
CN2800100000000	28	001	Adams County, MS	2001	NA	14048	13115	933	6.6
CN2800300000000	28	003	Alcorn County, MS	2001	NA	16339	15422	917	5.6
CN2800500000000	28	005	Amite County, MS	2001	NA	5317	5042	275	5.2
CN2800700000000	28	007	Attala County, MS	2001	NA	7995	7426	569	7.1
CN2800900000000	28	009	Benton County, MS	2001	NA	2930	2729	201	6.9
CN2801100000000	28	011	Bolivar County, MS	2001	NA	15864	14747	1117	7
CN2801300000000	28	013	Calhoun County, MS	2001	NA	6699	6149	550	8.2
CN2801500000000	28	015	Carroll County, MS	2001	NA	4964	4674	290	5.8
CN2801700000000	28	017	Chickasaw County, MS	2001	NA	8373	7526	847	10.1
CN2801900000000	28	019	Choctaw County, MS	2001	NA	3850	3501	349	9.1
CN2802100000000	28	021	Claiborne County, MS	2001	NA	4136	3809	327	7.9
CN2802300000000	28	023	Clarke County, MS	2001	NA	7501	6805	696	9.3
CN2802500000000	28	025	Clay County, MS	2001	NA	9736	8951	785	8.1
CN2802700000000	28	027	Coahoma County, MS	2001	NA	11498	10654	844	7.3
CN2802900000000	28	029	Copiah County, MS	2001	NA	12305	11598	707	5.7
CN2803100000000	28	031	Covington County, MS	2001	NA	8200	7784	416	5.1
CN2803300000000	28	033	DeSoto County, MS	2001	NA	60820	59105	1715	2.8
CN2803500000000	28	035	Forrest County, MS	2001	NA	34883	33366	1517	4.3
CN2803700000000	28	037	Franklin County, MS	2001	NA	3262	3032	230	7.1
CN2803900000000	28	039	George County, MS	2001	NA	8129	7461	668	8.2
CN2804100000000	28	041	Greene County, MS	2001	NA	4686	4336	350	7.5
CN2804300000000	28	043	Grenada County, MS	2001	NA	10182	9544	638	6.3
CN2804500000000	28	045	Hancock County, MS	2001	NA	19707	18894	813	4.1
CN2804700000000	28	047	Harrison County, MS	2001	NA	90562	86648	3914	4.3
CN2804900000000	28	049	Hinds County, MS	2001	NA	122510	116587	5923	4.8
CN2805100000000	28	051	Holmes County, MS	2001	NA	7181	6282	899	12.5
CN2805300000000	28	053	Humphreys County, MS	2001	NA	4157	3710	447	10.8
CN2805500000000	28	055	Issaquena County, MS	2001	NA	853	754	99	11.6
CN2805700000000	28	057	Itawamba County, MS	2001	NA	10723	10154	569	5.3
CN2805900000000	28	059	Jackson County, MS	2001	NA	60487	57061	3426	5.7
CN2806100000000	28	061	Jasper County, MS	2001	NA	7284	6855	429	5.9
CN2806300000000	28	063	Jefferson County, MS	2001	NA	2970	2619	351	11.8
CN2806500000000	28	065	Jefferson Davis County, MS	2001	NA	5285	4875	410	7.8
CN2806700000000	28	067	Jones County, MS	2001	NA	29035	27726	1309	4.5
CN2806900000000	28	069	Kemper County, MS	2001	NA	4387	4045	342	7.8
CN2807100000000	28	071	Lafayette County, MS	2001	NA	19218	18494	724	3.8
CN2807300000000	28	073	Lamar County, MS	2001	NA	20229	19520	709	3.5
CN2807500000000	28	075	Lauderdale County, MS	2001	NA	33576	31742	1834	5.5
CN2807700000000	28	077	Lawrence County, MS	2001	NA	5470	5062	408	7.5
CN2807900000000	28	079	Leake County, MS	2001	NA	9162	8634	528	5.8
CN2808100000000	28	081	Lee County, MS	2001	NA	38834	36932	1902	4.9
CN2808300000000	28	083	Leflore County, MS	2001	NA	14279	12996	1283	9
CN2808500000000	28	085	Lincoln County, MS	2001	NA	14464	13684	780	5.4
CN2808700000000	28	087	Lowndes County, MS	2001	NA	27186	25455	1731	6.4
CN2808900000000	28	089	Madison County, MS	2001	NA	40194	38660	1534	3.8
CN2809100000000	28	091	Marion County, MS	2001	NA	10314	9733	581	5.6
CN2809300000000	28	093	Marshall County, MS	2001	NA	15321	14356	965	6.3
CN2809500000000	28	095	Monroe County, MS	2001	NA	17058	15705	1353	7.9
CN2809700000000	28	097	Montgomery County, MS	2001	NA	5107	4665	442	8.7
CN2809900000000	28	099	Neshoba County, MS	2001	NA	13139	12412	727	5.5
CN2810100000000	28	101	Newton County, MS	2001	NA	9476	8959	517	5.5
CN2810300000000	28	103	Noxubee County, MS	2001	NA	4519	4065	454	10
CN2810500000000	28	105	Oktibbeha County, MS	2001	NA	20642	19656	986	4.8
CN2810700000000	28	107	Panola County, MS	2001	NA	14575	13458	1117	7.7
CN2810900000000	28	109	Pearl River County, MS	2001	NA	21283	20347	936	4.4
CN2811100000000	28	111	Perry County, MS	2001	NA	5147	4853	294	5.7
CN2811300000000	28	113	Pike County, MS	2001	NA	15462	14483	979	6.3
CN2811500000000	28	115	Pontotoc County, MS	2001	NA	13372	12659	713	5.3
CN2811700000000	28	117	Prentiss County, MS	2001	NA	12029	11414	615	5.1
CN2811900000000	28	119	Quitman County, MS	2001	NA	3967	3636	331	8.3
CN2812100000000	28	121	Rankin County, MS	2001	NA	65176	62977	2199	3.4
CN2812300000000	28	123	Scott County, MS	2001	NA	12536	11918	618	4.9
CN2812500000000	28	125	Sharkey County, MS	2001	NA	2615	2363	252	9.6
CN2812700000000	28	127	Simpson County, MS	2001	NA	11837	11259	578	4.9
CN2812900000000	28	129	Smith County, MS	2001	NA	7131	6777	354	5
CN2813100000000	28	131	Stone County, MS	2001	NA	6745	6425	320	4.7
CN2813300000000	28	133	Sunflower County, MS	2001	NA	10327	9238	1089	10.5
CN2813500000000	28	135	Tallahatchie County, MS	2001	NA	5812	5287	525	9
CN2813700000000	28	137	Tate County, MS	2001	NA	11648	11141	507	4.4
CN2813900000000	28	139	Tippah County, MS	2001	NA	9377	8805	572	6.1
CN2814100000000	28	141	Tishomingo County, MS	2001	NA	8545	7911	634	7.4
CN2814300000000	28	143	Tunica County, MS	2001	NA	4070	3827	243	6
CN2814500000000	28	145	Union County, MS	2001	NA	12161	11571	590	4.9
CN2814700000000	28	147	Walthall County, MS	2001	NA	6044	5677	367	6.1
CN2814900000000	28	149	Warren County, MS	2001	NA	23608	22499	1109	4.7
CN2815100000000	28	151	Washington County, MS	2001	NA	25037	22766	2271	9.1
CN2815300000000	28	153	Wayne County, MS	2001	NA	8686	8103	583	6.7
CN2815500000000	28	155	Webster County, MS	2001	NA	4347	3954	393	9
CN2815700000000	28	157	Wilkinson County, MS	2001	NA	3401	3143	258	7.6
CN2815900000000	28	159	Winston County, MS	2001	NA	8110	7316	794	9.8
CN2816100000000	28	161	Yalobusha County, MS	2001	NA	5586	5229	357	6.4
CN2816300000000	28	163	Yazoo County, MS	2001	NA	10458	9750	708	6.8
CN2900100000000	29	001	Adair County, MO	2001	NA	13838	13242	596	4.3
CN2900300000000	29	003	Andrew County, MO	2001	NA	9142	8740	402	4.4
CN2900500000000	29	005	Atchison County, MO	2001	NA	3586	3465	121	3.4
CN2900700000000	29	007	Audrain County, MO	2001	NA	13199	12627	572	4.3
CN2900900000000	29	009	Barry County, MO	2001	NA	17871	17088	783	4.4
CN2901100000000	29	011	Barton County, MO	2001	NA	6814	6555	259	3.8
CN2901300000000	29	013	Bates County, MO	2001	NA	8148	7753	395	4.8
CN2901500000000	29	015	Benton County, MO	2001	NA	8039	7526	513	6.4
CN2901700000000	29	017	Bollinger County, MO	2001	NA	6318	5944	374	5.9
CN2901900000000	29	019	Boone County, MO	2001	NA	79995	77582	2413	3
CN2902100000000	29	021	Buchanan County, MO	2001	NA	43397	41183	2214	5.1
CN2902300000000	29	023	Butler County, MO	2001	NA	20348	19203	1145	5.6
CN2902500000000	29	025	Caldwell County, MO	2001	NA	4447	4245	202	4.5
CN2902700000000	29	027	Callaway County, MO	2001	NA	22453	21585	868	3.9
CN2902900000000	29	029	Camden County, MO	2001	NA	20416	19355	1061	5.2
CN2903100000000	29	031	Cape Girardeau County, MO	2001	NA	39934	38376	1558	3.9
CN2903300000000	29	033	Carroll County, MO	2001	NA	5503	5258	245	4.5
CN2903500000000	29	035	Carter County, MO	2001	NA	2656	2484	172	6.5
CN2903700000000	29	037	Cass County, MO	2001	NA	45716	43968	1748	3.8
CN2903900000000	29	039	Cedar County, MO	2001	NA	6349	6031	318	5
CN2904100000000	29	041	Chariton County, MO	2001	NA	4603	4350	253	5.5
CN2904300000000	29	043	Christian County, MO	2001	NA	31953	30657	1296	4.1
CN2904500000000	29	045	Clark County, MO	2001	NA	3563	3347	216	6.1
CN2904700000000	29	047	Clay County, MO	2001	NA	108107	104413	3694	3.4
CN2904900000000	29	049	Clinton County, MO	2001	NA	10078	9682	396	3.9
CN2905100000000	29	051	Cole County, MO	2001	NA	40173	38783	1390	3.5
CN2905300000000	29	053	Cooper County, MO	2001	NA	8500	8091	409	4.8
CN2905500000000	29	055	Crawford County, MO	2001	NA	11619	11007	612	5.3
CN2905700000000	29	057	Dade County, MO	2001	NA	4030	3862	168	4.2
CN2905900000000	29	059	Dallas County, MO	2001	NA	7241	6856	385	5.3
CN2906100000000	29	061	Daviess County, MO	2001	NA	4152	3972	180	4.3
CN2906300000000	29	063	DeKalb County, MO	2001	NA	5018	4771	247	4.9
CN2906500000000	29	065	Dent County, MO	2001	NA	6916	6443	473	6.8
CN2906700000000	29	067	Douglas County, MO	2001	NA	6437	5974	463	7.2
CN2906900000000	29	069	Dunklin County, MO	2001	NA	15326	14366	960	6.3
CN2907100000000	29	071	Franklin County, MO	2001	NA	51798	49243	2555	4.9
CN2907300000000	29	073	Gasconade County, MO	2001	NA	8041	7645	396	4.9
CN2907500000000	29	075	Gentry County, MO	2001	NA	3556	3410	146	4.1
CN2907700000000	29	077	Greene County, MO	2001	NA	132960	127852	5108	3.8
CN2907900000000	29	079	Grundy County, MO	2001	NA	5434	5202	232	4.3
CN2908100000000	29	081	Harrison County, MO	2001	NA	4745	4572	173	3.6
CN2908300000000	29	083	Henry County, MO	2001	NA	11403	10797	606	5.3
CN2908500000000	29	085	Hickory County, MO	2001	NA	3509	3267	242	6.9
CN2908700000000	29	087	Holt County, MO	2001	NA	2826	2708	118	4.2
CN2908900000000	29	089	Howard County, MO	2001	NA	5396	5170	226	4.2
CN2909100000000	29	091	Howell County, MO	2001	NA	19430	18557	873	4.5
CN2909300000000	29	093	Iron County, MO	2001	NA	5139	4794	345	6.7
CN2909500000000	29	095	Jackson County, MO	2001	NA	347409	330481	16928	4.9
CN2909700000000	29	097	Jasper County, MO	2001	NA	54331	51958	2373	4.4
CN2909900000000	29	099	Jefferson County, MO	2001	NA	112300	107261	5039	4.5
CN2910100000000	29	101	Johnson County, MO	2001	NA	24771	23760	1011	4.1
CN2910300000000	29	103	Knox County, MO	2001	NA	2347	2243	104	4.4
CN2910500000000	29	105	Laclede County, MO	2001	NA	17121	16149	972	5.7
CN2910700000000	29	107	Lafayette County, MO	2001	NA	17360	16626	734	4.2
CN2910900000000	29	109	Lawrence County, MO	2001	NA	18738	17916	822	4.4
CN2911100000000	29	111	Lewis County, MO	2001	NA	5694	5427	267	4.7
CN2911300000000	29	113	Lincoln County, MO	2001	NA	21616	20611	1005	4.6
CN2911500000000	29	115	Linn County, MO	2001	NA	7307	6826	481	6.6
CN2911700000000	29	117	Livingston County, MO	2001	NA	7711	7412	299	3.9
CN2911900000000	29	119	McDonald County, MO	2001	NA	11012	10535	477	4.3
CN2912100000000	29	121	Macon County, MO	2001	NA	8532	7915	617	7.2
CN2912300000000	29	123	Madison County, MO	2001	NA	5730	5374	356	6.2
CN2912500000000	29	125	Maries County, MO	2001	NA	4761	4523	238	5
CN2912700000000	29	127	Marion County, MO	2001	NA	15114	14361	753	5
CN2912900000000	29	129	Mercer County, MO	2001	NA	2090	2017	73	3.5
CN2913100000000	29	131	Miller County, MO	2001	NA	13071	12345	726	5.6
CN2913300000000	29	133	Mississippi County, MO	2001	NA	6411	5912	499	7.8
CN2913500000000	29	135	Moniteau County, MO	2001	NA	7559	7224	335	4.4
CN2913700000000	29	137	Monroe County, MO	2001	NA	4845	4587	258	5.3
CN2913900000000	29	139	Montgomery County, MO	2001	NA	6530	6210	320	4.9
CN2914100000000	29	141	Morgan County, MO	2001	NA	9777	9189	588	6
CN2914300000000	29	143	New Madrid County, MO	2001	NA	9705	9071	634	6.5
CN2914500000000	29	145	Newton County, MO	2001	NA	27592	26194	1398	5.1
CN2914700000000	29	147	Nodaway County, MO	2001	NA	12797	12410	387	3
CN2914900000000	29	149	Oregon County, MO	2001	NA	4492	4275	217	4.8
CN2915100000000	29	151	Osage County, MO	2001	NA	7466	7100	366	4.9
CN2915300000000	29	153	Ozark County, MO	2001	NA	4642	4389	253	5.5
CN2915500000000	29	155	Pemiscot County, MO	2001	NA	8486	7857	629	7.4
CN2915700000000	29	157	Perry County, MO	2001	NA	10363	9972	391	3.8
CN2915900000000	29	159	Pettis County, MO	2001	NA	21642	20423	1219	5.6
CN2916100000000	29	161	Phelps County, MO	2001	NA	20626	19757	869	4.2
CN2916300000000	29	163	Pike County, MO	2001	NA	9075	8631	444	4.9
CN2916500000000	29	165	Platte County, MO	2001	NA	45665	44217	1448	3.2
CN2916700000000	29	167	Polk County, MO	2001	NA	13314	12712	602	4.5
CN2916900000000	29	169	Pulaski County, MO	2001	NA	15787	14890	897	5.7
CN2917100000000	29	171	Putnam County, MO	2001	NA	2647	2542	105	4
CN2917300000000	29	173	Ralls County, MO	2001	NA	5771	5497	274	4.7
CN2917500000000	29	175	Randolph County, MO	2001	NA	12396	11751	645	5.2
CN2917700000000	29	177	Ray County, MO	2001	NA	11989	11485	504	4.2
CN2917900000000	29	179	Reynolds County, MO	2001	NA	2679	2469	210	7.8
CN2918100000000	29	181	Ripley County, MO	2001	NA	6260	5871	389	6.2
CN2918300000000	29	183	St. Charles County, MO	2001	NA	171694	165610	6084	3.5
CN2918500000000	29	185	St. Clair County, MO	2001	NA	4621	4378	243	5.3
CN2918600000000	29	186	Ste. Genevieve County, MO	2001	NA	9681	9232	449	4.6
CN2918700000000	29	187	St. Francois County, MO	2001	NA	26634	24959	1675	6.3
CN2918900000000	29	189	St. Louis County, MO	2001	NA	556592	533966	22626	4.1
CN2919500000000	29	195	Saline County, MO	2001	NA	12729	12107	622	4.9
CN2919700000000	29	197	Schuyler County, MO	2001	NA	2243	2117	126	5.6
CN2919900000000	29	199	Scotland County, MO	2001	NA	2732	2629	103	3.8
CN2920100000000	29	201	Scott County, MO	2001	NA	20968	19819	1149	5.5
CN2920300000000	29	203	Shannon County, MO	2001	NA	4074	3808	266	6.5
CN2920500000000	29	205	Shelby County, MO	2001	NA	3689	3487	202	5.5
CN2920700000000	29	207	Stoddard County, MO	2001	NA	15456	14554	902	5.8
CN2920900000000	29	209	Stone County, MO	2001	NA	15281	14096	1185	7.8
CN2921100000000	29	211	Sullivan County, MO	2001	NA	4034	3865	169	4.2
CN2921300000000	29	213	Taney County, MO	2001	NA	24576	22500	2076	8.4
CN2921500000000	29	215	Texas County, MO	2001	NA	11426	10757	669	5.9
CN2921700000000	29	217	Vernon County, MO	2001	NA	10785	10380	405	3.8
CN2921900000000	29	219	Warren County, MO	2001	NA	13973	13304	669	4.8
CN2922100000000	29	221	Washington County, MO	2001	NA	9988	9266	722	7.2
CN2922300000000	29	223	Wayne County, MO	2001	NA	5625	5213	412	7.3
CN2922500000000	29	225	Webster County, MO	2001	NA	15595	14868	727	4.7
CN2922700000000	29	227	Worth County, MO	2001	NA	1309	1262	47	3.6
CN2922900000000	29	229	Wright County, MO	2001	NA	8593	8046	547	6.4
CN2951000000000	29	510	St. Louis city, MO	2001	NA	163524	152249	11275	6.9
CN3000100000000	30	001	Beaverhead County, MT	2001	NA	5164	4988	176	3.4
CN3000300000000	30	003	Big Horn County, MT	2001	NA	5129	4523	606	11.8
CN3000500000000	30	005	Blaine County, MT	2001	NA	2904	2771	133	4.6
CN3000700000000	30	007	Broadwater County, MT	2001	NA	2183	2088	95	4.4
CN3000900000000	30	009	Carbon County, MT	2001	NA	5041	4834	207	4.1
CN3001100000000	30	011	Carter County, MT	2001	NA	728	705	23	3.2
CN3001300000000	30	013	Cascade County, MT	2001	NA	38244	36535	1709	4.5
CN3001500000000	30	015	Chouteau County, MT	2001	NA	2715	2619	96	3.5
CN3001700000000	30	017	Custer County, MT	2001	NA	5832	5597	235	4
CN3001900000000	30	019	Daniels County, MT	2001	NA	920	880	40	4.3
CN3002100000000	30	021	Dawson County, MT	2001	NA	4456	4297	159	3.6
CN3002300000000	30	023	Deer Lodge County, MT	2001	NA	4236	3957	279	6.6
CN3002500000000	30	025	Fallon County, MT	2001	NA	1545	1500	45	2.9
CN3002700000000	30	027	Fergus County, MT	2001	NA	6071	5756	315	5.2
CN3002900000000	30	029	Flathead County, MT	2001	NA	39911	37804	2107	5.3
CN3003100000000	30	031	Gallatin County, MT	2001	NA	41500	40108	1392	3.4
CN3003300000000	30	033	Garfield County, MT	2001	NA	679	657	22	3.2
CN3003500000000	30	035	Glacier County, MT	2001	NA	5757	5330	427	7.4
CN3003700000000	30	037	Golden Valley County, MT	2001	NA	492	469	23	4.7
CN3003900000000	30	039	Granite County, MT	2001	NA	1329	1247	82	6.2
CN3004100000000	30	041	Hill County, MT	2001	NA	7881	7541	340	4.3
CN3004300000000	30	043	Jefferson County, MT	2001	NA	5335	5103	232	4.3
CN3004500000000	30	045	Judith Basin County, MT	2001	NA	1159	1112	47	4.1
CN3004700000000	30	047	Lake County, MT	2001	NA	11735	10891	844	7.2
CN3004900000000	30	049	Lewis and Clark County, MT	2001	NA	30876	29645	1231	4
CN3005100000000	30	051	Liberty County, MT	2001	NA	882	848	34	3.9
CN3005300000000	30	053	Lincoln County, MT	2001	NA	7676	7015	661	8.6
CN3005500000000	30	055	McCone County, MT	2001	NA	1054	1023	31	2.9
CN3005700000000	30	057	Madison County, MT	2001	NA	3336	3188	148	4.4
CN3005900000000	30	059	Meagher County, MT	2001	NA	949	895	54	5.7
CN3006100000000	30	061	Mineral County, MT	2001	NA	1977	1851	126	6.4
CN3006300000000	30	063	Missoula County, MT	2001	NA	54827	52670	2157	3.9
CN3006500000000	30	065	Musselshell County, MT	2001	NA	2035	1921	114	5.6
CN3006700000000	30	067	Park County, MT	2001	NA	8644	8237	407	4.7
CN3006900000000	30	069	Petroleum County, MT	2001	NA	221	211	10	4.5
CN3007100000000	30	071	Phillips County, MT	2001	NA	2225	2132	93	4.2
CN3007300000000	30	073	Pondera County, MT	2001	NA	2884	2760	124	4.3
CN3007500000000	30	075	Powder River County, MT	2001	NA	941	912	29	3.1
CN3007700000000	30	077	Powell County, MT	2001	NA	2762	2608	154	5.6
CN3007900000000	30	079	Prairie County, MT	2001	NA	594	563	31	5.2
CN3008100000000	30	081	Ravalli County, MT	2001	NA	17201	16339	862	5
CN3008300000000	30	083	Richland County, MT	2001	NA	4828	4602	226	4.7
CN3008500000000	30	085	Roosevelt County, MT	2001	NA	4127	3886	241	5.8
CN3008700000000	30	087	Rosebud County, MT	2001	NA	4233	3983	250	5.9
CN3008900000000	30	089	Sanders County, MT	2001	NA	4375	4061	314	7.2
CN3009100000000	30	091	Sheridan County, MT	2001	NA	1910	1833	77	4
CN3009300000000	30	093	Silver Bow County, MT	2001	NA	16994	16114	880	5.2
CN3009500000000	30	095	Stillwater County, MT	2001	NA	4632	4460	172	3.7
CN3009700000000	30	097	Sweet Grass County, MT	2001	NA	2039	1978	61	3
CN3009900000000	30	099	Teton County, MT	2001	NA	2918	2804	114	3.9
CN3010100000000	30	101	Toole County, MT	2001	NA	2424	2338	86	3.5
CN3010300000000	30	103	Treasure County, MT	2001	NA	439	424	15	3.4
CN3010500000000	30	105	Valley County, MT	2001	NA	3702	3548	154	4.2
CN3010700000000	30	107	Wheatland County, MT	2001	NA	1086	1042	44	4.1
CN3010900000000	30	109	Wibaux County, MT	2001	NA	517	499	18	3.5
CN3011100000000	30	111	Yellowstone County, MT	2001	NA	71814	69208	2606	3.6
CN3100100000000	31	001	Adams County, NE	2001	NA	17101	16578	523	3.1
CN3100300000000	31	003	Antelope County, NE	2001	NA	3875	3753	122	3.1
CN3100500000000	31	005	Arthur County, NE	2001	NA	275	266	9	3.3
CN3100700000000	31	007	Banner County, NE	2001	NA	419	410	9	2.1
CN3100900000000	31	009	Blaine County, NE	2001	NA	315	307	8	2.5
CN3101100000000	31	011	Boone County, NE	2001	NA	3200	3100	100	3.1
CN3101300000000	31	013	Box Butte County, NE	2001	NA	5813	5559	254	4.4
CN3101500000000	31	015	Boyd County, NE	2001	NA	1237	1194	43	3.5
CN3101700000000	31	017	Brown County, NE	2001	NA	1895	1830	65	3.4
CN3101900000000	31	019	Buffalo County, NE	2001	NA	25082	24484	598	2.4
CN3102100000000	31	021	Burt County, NE	2001	NA	4081	3926	155	3.8
CN3102300000000	31	023	Butler County, NE	2001	NA	4706	4553	153	3.3
CN3102500000000	31	025	Cass County, NE	2001	NA	13638	13201	437	3.2
CN3102700000000	31	027	Cedar County, NE	2001	NA	5016	4890	126	2.5
CN3102900000000	31	029	Chase County, NE	2001	NA	2077	2026	51	2.5
CN3103100000000	31	031	Cherry County, NE	2001	NA	3538	3459	79	2.2
CN3103300000000	31	033	Cheyenne County, NE	2001	NA	5916	5771	145	2.5
CN3103500000000	31	035	Clay County, NE	2001	NA	3494	3383	111	3.2
CN3103700000000	31	037	Colfax County, NE	2001	NA	5818	5671	147	2.5
CN3103900000000	31	039	Cuming County, NE	2001	NA	5633	5502	131	2.3
CN3104100000000	31	041	Custer County, NE	2001	NA	6418	6263	155	2.4
CN3104300000000	31	043	Dakota County, NE	2001	NA	10886	10551	335	3.1
CN3104500000000	31	045	Dawes County, NE	2001	NA	4874	4733	141	2.9
CN3104700000000	31	047	Dawson County, NE	2001	NA	12211	11775	436	3.6
CN3104900000000	31	049	Deuel County, NE	2001	NA	1136	1105	31	2.7
CN3105100000000	31	051	Dixon County, NE	2001	NA	3290	3209	81	2.5
CN3105300000000	31	053	Dodge County, NE	2001	NA	19698	18946	752	3.8
CN3105500000000	31	055	Douglas County, NE	2001	NA	260138	250988	9150	3.5
CN3105700000000	31	057	Dundy County, NE	2001	NA	1226	1197	29	2.4
CN3105900000000	31	059	Fillmore County, NE	2001	NA	3443	3340	103	3
CN3106100000000	31	061	Franklin County, NE	2001	NA	1834	1779	55	3
CN3106300000000	31	063	Frontier County, NE	2001	NA	1796	1755	41	2.3
CN3106500000000	31	065	Furnas County, NE	2001	NA	2574	2505	69	2.7
CN3106700000000	31	067	Gage County, NE	2001	NA	12838	12446	392	3.1
CN3106900000000	31	069	Garden County, NE	2001	NA	1116	1079	37	3.3
CN3107100000000	31	071	Garfield County, NE	2001	NA	1030	1002	28	2.7
CN3107300000000	31	073	Gosper County, NE	2001	NA	1093	1060	33	3
CN3107500000000	31	075	Grant County, NE	2001	NA	431	420	11	2.6
CN3107700000000	31	077	Greeley County, NE	2001	NA	1393	1351	42	3
CN3107900000000	31	079	Hall County, NE	2001	NA	28793	27847	946	3.3
CN3108100000000	31	081	Hamilton County, NE	2001	NA	4952	4827	125	2.5
CN3108300000000	31	083	Harlan County, NE	2001	NA	1956	1904	52	2.7
CN3108500000000	31	085	Hayes County, NE	2001	NA	598	581	17	2.8
CN3108700000000	31	087	Hitchcock County, NE	2001	NA	1517	1463	54	3.6
CN3108900000000	31	089	Holt County, NE	2001	NA	6204	6012	192	3.1
CN3109100000000	31	091	Hooker County, NE	2001	NA	436	421	15	3.4
CN3109300000000	31	093	Howard County, NE	2001	NA	3519	3414	105	3
CN3109500000000	31	095	Jefferson County, NE	2001	NA	4318	4122	196	4.5
CN3109700000000	31	097	Johnson County, NE	2001	NA	2625	2546	79	3
CN3109900000000	31	099	Kearney County, NE	2001	NA	3761	3672	89	2.4
CN3110100000000	31	101	Keith County, NE	2001	NA	4990	4845	145	2.9
CN3110300000000	31	103	Keya Paha County, NE	2001	NA	443	432	11	2.5
CN3110500000000	31	105	Kimball County, NE	2001	NA	2203	2148	55	2.5
CN3110700000000	31	107	Knox County, NE	2001	NA	4690	4517	173	3.7
CN3110900000000	31	109	Lancaster County, NE	2001	NA	151530	147481	4049	2.7
CN3111100000000	31	111	Lincoln County, NE	2001	NA	19581	18956	625	3.2
CN3111300000000	31	113	Logan County, NE	2001	NA	444	433	11	2.5
CN3111500000000	31	115	Loup County, NE	2001	NA	342	332	10	2.9
CN3111700000000	31	117	McPherson County, NE	2001	NA	292	287	5	1.7
CN3111900000000	31	119	Madison County, NE	2001	NA	19168	18486	682	3.6
CN3112100000000	31	121	Merrick County, NE	2001	NA	4216	4092	124	2.9
CN3112300000000	31	123	Morrill County, NE	2001	NA	2808	2718	90	3.2
CN3112500000000	31	125	Nance County, NE	2001	NA	2069	1997	72	3.5
CN3112700000000	31	127	Nemaha County, NE	2001	NA	3825	3690	135	3.5
CN3112900000000	31	129	Nuckolls County, NE	2001	NA	2485	2413	72	2.9
CN3113100000000	31	131	Otoe County, NE	2001	NA	8369	8086	283	3.4
CN3113300000000	31	133	Pawnee County, NE	2001	NA	1673	1616	57	3.4
CN3113500000000	31	135	Perkins County, NE	2001	NA	1669	1632	37	2.2
CN3113700000000	31	137	Phelps County, NE	2001	NA	5378	5239	139	2.6
CN3113900000000	31	139	Pierce County, NE	2001	NA	4117	3995	122	3
CN3114100000000	31	141	Platte County, NE	2001	NA	17439	16828	611	3.5
CN3114300000000	31	143	Polk County, NE	2001	NA	3055	2972	83	2.7
CN3114500000000	31	145	Red Willow County, NE	2001	NA	6033	5875	158	2.6
CN3114700000000	31	147	Richardson County, NE	2001	NA	4704	4482	222	4.7
CN3114900000000	31	149	Rock County, NE	2001	NA	998	967	31	3.1
CN3115100000000	31	151	Saline County, NE	2001	NA	7929	7702	227	2.9
CN3115300000000	31	153	Sarpy County, NE	2001	NA	67380	65616	1764	2.6
CN3115500000000	31	155	Saunders County, NE	2001	NA	11113	10759	354	3.2
CN3115700000000	31	157	Scotts Bluff County, NE	2001	NA	18656	17900	756	4.1
CN3115900000000	31	159	Seward County, NE	2001	NA	9398	9138	260	2.8
CN3116100000000	31	161	Sheridan County, NE	2001	NA	3200	3113	87	2.7
CN3116300000000	31	163	Sherman County, NE	2001	NA	1833	1784	49	2.7
CN3116500000000	31	165	Sioux County, NE	2001	NA	793	777	16	2
CN3116700000000	31	167	Stanton County, NE	2001	NA	3450	3357	93	2.7
CN3116900000000	31	169	Thayer County, NE	2001	NA	3039	2939	100	3.3
CN3117100000000	31	171	Thomas County, NE	2001	NA	407	385	22	5.4
CN3117300000000	31	173	Thurston County, NE	2001	NA	2751	2582	169	6.1
CN3117500000000	31	175	Valley County, NE	2001	NA	2372	2298	74	3.1
CN3117700000000	31	177	Washington County, NE	2001	NA	11045	10736	309	2.8
CN3117900000000	31	179	Wayne County, NE	2001	NA	5501	5350	151	2.7
CN3118100000000	31	181	Webster County, NE	2001	NA	2012	1955	57	2.8
CN3118300000000	31	183	Wheeler County, NE	2001	NA	516	504	12	2.3
CN3118500000000	31	185	York County, NE	2001	NA	7622	7416	206	2.7
CN3200100000000	32	001	Churchill County, NV	2001	NA	11941	11200	741	6.2
CN3200300000000	32	003	Clark County, NV	2001	NA	767224	725947	41277	5.4
CN3200500000000	32	005	Douglas County, NV	2001	NA	21857	20848	1009	4.6
CN3200700000000	32	007	Elko County, NV	2001	NA	23755	22610	1145	4.8
CN3200900000000	32	009	Esmeralda County, NV	2001	NA	517	479	38	7.4
CN3201100000000	32	011	Eureka County, NV	2001	NA	777	746	31	4
CN3201300000000	32	013	Humboldt County, NV	2001	NA	7592	7173	419	5.5
CN3201500000000	32	015	Lander County, NV	2001	NA	2727	2541	186	6.8
CN3201700000000	32	017	Lincoln County, NV	2001	NA	1766	1671	95	5.4
CN3201900000000	32	019	Lyon County, NV	2001	NA	19201	18102	1099	5.7
CN3202100000000	32	021	Mineral County, NV	2001	NA	2140	1982	158	7.4
CN3202300000000	32	023	Nye County, NV	2001	NA	14527	13402	1125	7.7
CN3202700000000	32	027	Pershing County, NV	2001	NA	2586	2463	123	4.8
CN3202900000000	32	029	Storey County, NV	2001	NA	2031	1955	76	3.7
CN3203100000000	32	031	Washoe County, NV	2001	NA	202510	193740	8770	4.3
CN3203300000000	32	033	White Pine County, NV	2001	NA	3683	3516	167	4.5
CN3251000000000	32	510	Carson City, NV	2001	NA	27248	25888	1360	5
CN3300100000000	33	001	Belknap County, NH	2001	NA	31389	30453	936	3
CN3300300000000	33	003	Carroll County, NH	2001	NA	23917	23176	741	3.1
CN3300500000000	33	005	Cheshire County, NH	2001	NA	40172	38966	1206	3
CN3300700000000	33	007	Coos County, NH	2001	NA	17071	16171	900	5.3
CN3300900000000	33	009	Grafton County, NH	2001	NA	45007	43795	1212	2.7
CN3301100000000	33	011	Hillsborough County, NH	2001	NA	216244	208619	7625	3.5
CN3301300000000	33	013	Merrimack County, NH	2001	NA	76063	73897	2166	2.8
CN3301500000000	33	015	Rockingham County, NH	2001	NA	163719	157155	6564	4
CN3301700000000	33	017	Strafford County, NH	2001	NA	62519	60483	2036	3.3
CN3301900000000	33	019	Sullivan County, NH	2001	NA	21653	21065	588	2.7
CN3400100000000	34	001	Atlantic County, NJ	2001	NA	129230	123129	6101	4.7
CN3400300000000	34	003	Bergen County, NJ	2001	NA	465449	448100	17349	3.7
CN3400500000000	34	005	Burlington County, NJ	2001	NA	221834	213995	7839	3.5
CN3400700000000	34	007	Camden County, NJ	2001	NA	251911	241009	10902	4.3
CN3400900000000	34	009	Cape May County, NJ	2001	NA	55112	51454	3658	6.6
CN3401100000000	34	011	Cumberland County, NJ	2001	NA	64946	60738	4208	6.5
CN3401300000000	34	013	Essex County, NJ	2001	NA	364711	345299	19412	5.3
CN3401500000000	34	015	Gloucester County, NJ	2001	NA	134778	129456	5322	3.9
CN3401700000000	34	017	Hudson County, NJ	2001	NA	295819	279414	16405	5.5
CN3401900000000	34	019	Hunterdon County, NJ	2001	NA	68536	66628	1908	2.8
CN3402100000000	34	021	Mercer County, NJ	2001	NA	182076	175290	6786	3.7
CN3402300000000	34	023	Middlesex County, NJ	2001	NA	404653	388454	16199	4
CN3402500000000	34	025	Monmouth County, NJ	2001	NA	319461	307451	12010	3.8
CN3402700000000	34	027	Morris County, NJ	2001	NA	260412	251963	8449	3.2
CN3402900000000	34	029	Ocean County, NJ	2001	NA	235470	225784	9686	4.1
CN3403100000000	34	031	Passaic County, NJ	2001	NA	235267	222637	12630	5.4
CN3403300000000	34	033	Salem County, NJ	2001	NA	30793	29435	1358	4.4
CN3403500000000	34	035	Somerset County, NJ	2001	NA	167313	161909	5404	3.2
CN3403700000000	34	037	Sussex County, NJ	2001	NA	79952	77042	2910	3.6
CN3403900000000	34	039	Union County, NJ	2001	NA	264533	252422	12111	4.6
CN3404100000000	34	041	Warren County, NJ	2001	NA	56572	54617	1955	3.5
CN3500100000000	35	001	Bernalillo County, NM	2001	NA	290898	278762	12136	4.2
CN3500300000000	35	003	Catron County, NM	2001	NA	1507	1415	92	6.1
CN3500500000000	35	005	Chaves County, NM	2001	NA	25741	24299	1442	5.6
CN3500600000000	35	006	Cibola County, NM	2001	NA	10127	9505	622	6.1
CN3500700000000	35	007	Colfax County, NM	2001	NA	6942	6584	358	5.2
CN3500900000000	35	009	Curry County, NM	2001	NA	18893	18083	810	4.3
CN3501100000000	35	011	De Baca County, NM	2001	NA	963	915	48	5
CN3501300000000	35	013	Dona Ana County, NM	2001	NA	76778	72121	4657	6.1
CN3501500000000	35	015	Eddy County, NM	2001	NA	23404	22238	1166	5
CN3501700000000	35	017	Grant County, NM	2001	NA	13016	12199	817	6.3
CN3501900000000	35	019	Guadalupe County, NM	2001	NA	1668	1537	131	7.9
CN3502100000000	35	021	Harding County, NM	2001	NA	393	376	17	4.3
CN3502300000000	35	023	Hidalgo County, NM	2001	NA	2568	2414	154	6
CN3502500000000	35	025	Lea County, NM	2001	NA	23600	22590	1010	4.3
CN3502700000000	35	027	Lincoln County, NM	2001	NA	9733	9322	411	4.2
CN3502800000000	35	028	Los Alamos County, NM	2001	NA	10355	10089	266	2.6
CN3502900000000	35	029	Luna County, NM	2001	NA	10704	8932	1772	16.6
CN3503100000000	35	031	McKinley County, NM	2001	NA	24710	23188	1522	6.2
CN3503300000000	35	033	Mora County, NM	2001	NA	2004	1808	196	9.8
CN3503500000000	35	035	Otero County, NM	2001	NA	24386	23081	1305	5.4
CN3503700000000	35	037	Quay County, NM	2001	NA	4162	3939	223	5.4
CN3503900000000	35	039	Rio Arriba County, NM	2001	NA	19200	18041	1159	6
CN3504100000000	35	041	Roosevelt County, NM	2001	NA	8442	8110	332	3.9
CN3504300000000	35	043	Sandoval County, NM	2001	NA	44535	42479	2056	4.6
CN3504500000000	35	045	San Juan County, NM	2001	NA	50484	47780	2704	5.4
CN3504700000000	35	047	San Miguel County, NM	2001	NA	12706	11943	763	6
CN3504900000000	35	049	Santa Fe County, NM	2001	NA	70826	68272	2554	3.6
CN3505100000000	35	051	Sierra County, NM	2001	NA	5344	5093	251	4.7
CN3505300000000	35	053	Socorro County, NM	2001	NA	8162	7735	427	5.2
CN3505500000000	35	055	Taos County, NM	2001	NA	15794	14748	1046	6.6
CN3505700000000	35	057	Torrance County, NM	2001	NA	7406	7075	331	4.5
CN3505900000000	35	059	Union County, NM	2001	NA	2038	1967	71	3.5
CN3506100000000	35	061	Valencia County, NM	2001	NA	30461	29000	1461	4.8
CN3600100000000	36	001	Albany County, NY	2001	NA	154732	149564	5168	3.3
CN3600300000000	36	003	Allegany County, NY	2001	NA	22998	21908	1090	4.7
CN3600500000000	36	005	Bronx County, NY	2001	NA	488643	453138	35505	7.3
CN3600700000000	36	007	Broome County, NY	2001	NA	98088	93925	4163	4.2
CN3600900000000	36	009	Cattaraugus County, NY	2001	NA	41021	38959	2062	5
CN3601100000000	36	011	Cayuga County, NY	2001	NA	39912	38209	1703	4.3
CN3601300000000	36	013	Chautauqua County, NY	2001	NA	66936	63824	3112	4.6
CN3601500000000	36	015	Chemung County, NY	2001	NA	42367	40274	2093	4.9
CN3601700000000	36	017	Chenango County, NY	2001	NA	24514	23411	1103	4.5
CN3601900000000	36	019	Clinton County, NY	2001	NA	38768	37042	1726	4.5
CN3602100000000	36	021	Columbia County, NY	2001	NA	31122	30034	1088	3.5
CN3602300000000	36	023	Cortland County, NY	2001	NA	24661	23498	1163	4.7
CN3602500000000	36	025	Delaware County, NY	2001	NA	22184	21267	917	4.1
CN3602700000000	36	027	Dutchess County, NY	2001	NA	140038	135221	4817	3.4
CN3602900000000	36	029	Erie County, NY	2001	NA	460247	438786	21461	4.7
CN3603100000000	36	031	Essex County, NY	2001	NA	18568	17724	844	4.5
CN3603300000000	36	033	Franklin County, NY	2001	NA	21836	20532	1304	6
CN3603500000000	36	035	Fulton County, NY	2001	NA	26264	25079	1185	4.5
CN3603700000000	36	037	Genesee County, NY	2001	NA	32205	30822	1383	4.3
CN3603900000000	36	039	Greene County, NY	2001	NA	22490	21474	1016	4.5
CN3604100000000	36	041	Hamilton County, NY	2001	NA	2754	2622	132	4.8
CN3604300000000	36	043	Herkimer County, NY	2001	NA	31095	29704	1391	4.5
CN3604500000000	36	045	Jefferson County, NY	2001	NA	44876	42051	2825	6.3
CN3604700000000	36	047	Kings County, NY	2001	NA	1040426	973413	67013	6.4
CN3604900000000	36	049	Lewis County, NY	2001	NA	12493	11732	761	6.1
CN3605100000000	36	051	Livingston County, NY	2001	NA	32685	31262	1423	4.4
CN3605300000000	36	053	Madison County, NY	2001	NA	34974	33397	1577	4.5
CN3605500000000	36	055	Monroe County, NY	2001	NA	373508	358170	15338	4.1
CN3605700000000	36	057	Montgomery County, NY	2001	NA	23608	22431	1177	5
CN3605900000000	36	059	Nassau County, NY	2001	NA	670974	646155	24819	3.7
CN3606100000000	36	061	New York County, NY	2001	NA	866642	817837	48805	5.6
CN3606300000000	36	063	Niagara County, NY	2001	NA	108470	102519	5951	5.5
CN3606500000000	36	065	Oneida County, NY	2001	NA	109312	104334	4978	4.6
CN3606700000000	36	067	Onondaga County, NY	2001	NA	228985	219789	9196	4
CN3606900000000	36	069	Ontario County, NY	2001	NA	54356	52204	2152	4
CN3607100000000	36	071	Orange County, NY	2001	NA	163868	157879	5989	3.7
CN3607300000000	36	073	Orleans County, NY	2001	NA	19926	18903	1023	5.1
CN3607500000000	36	075	Oswego County, NY	2001	NA	58350	55246	3104	5.3
CN3607700000000	36	077	Otsego County, NY	2001	NA	30155	28876	1279	4.2
CN3607900000000	36	079	Putnam County, NY	2001	NA	52507	50839	1668	3.2
CN3608100000000	36	081	Queens County, NY	2001	NA	1063736	1007593	56143	5.3
CN3608300000000	36	083	Rensselaer County, NY	2001	NA	80796	77726	3070	3.8
CN3608500000000	36	085	Richmond County, NY	2001	NA	218353	207249	11104	5.1
CN3608700000000	36	087	Rockland County, NY	2001	NA	144364	139272	5092	3.5
CN3608900000000	36	089	St. Lawrence County, NY	2001	NA	48721	45759	2962	6.1
CN3609100000000	36	091	Saratoga County, NY	2001	NA	112163	108414	3749	3.3
CN3609300000000	36	093	Schenectady County, NY	2001	NA	72300	69850	2450	3.4
CN3609500000000	36	095	Schoharie County, NY	2001	NA	15243	14596	647	4.2
CN3609700000000	36	097	Schuyler County, NY	2001	NA	9418	8912	506	5.4
CN3609900000000	36	099	Seneca County, NY	2001	NA	16501	15795	706	4.3
CN3610100000000	36	101	Steuben County, NY	2001	NA	48307	45938	2369	4.9
CN3610300000000	36	103	Suffolk County, NY	2001	NA	737015	709002	28013	3.8
CN3610500000000	36	105	Sullivan County, NY	2001	NA	33262	31753	1509	4.5
CN3610700000000	36	107	Tioga County, NY	2001	NA	26467	25380	1087	4.1
CN3610900000000	36	109	Tompkins County, NY	2001	NA	51243	49518	1725	3.4
CN3611100000000	36	111	Ulster County, NY	2001	NA	88191	84850	3341	3.8
CN3611300000000	36	113	Warren County, NY	2001	NA	33280	31809	1471	4.4
CN3611500000000	36	115	Washington County, NY	2001	NA	30098	28888	1210	4
CN3611700000000	36	117	Wayne County, NY	2001	NA	48694	46452	2242	4.6
CN3611900000000	36	119	Westchester County, NY	2001	NA	463716	446213	17503	3.8
CN3612100000000	36	121	Wyoming County, NY	2001	NA	20305	19310	995	4.9
CN3612300000000	36	123	Yates County, NY	2001	NA	12025	11567	458	3.8
CN3700100000000	37	001	Alamance County, NC	2001	NA	69145	65330	3815	5.5
CN3700300000000	37	003	Alexander County, NC	2001	NA	19264	18150	1114	5.8
CN3700500000000	37	005	Alleghany County, NC	2001	NA	5279	4831	448	8.5
CN3700700000000	37	007	Anson County, NC	2001	NA	11304	10354	950	8.4
CN3700900000000	37	009	Ashe County, NC	2001	NA	12682	11679	1003	7.9
CN3701100000000	37	011	Avery County, NC	2001	NA	8066	7629	437	5.4
CN3701300000000	37	013	Beaufort County, NC	2001	NA	20097	18383	1714	8.5
CN3701500000000	37	015	Bertie County, NC	2001	NA	8319	7666	653	7.8
CN3701700000000	37	017	Bladen County, NC	2001	NA	14955	13668	1287	8.6
CN3701900000000	37	019	Brunswick County, NC	2001	NA	36921	34872	2049	5.5
CN3702100000000	37	021	Buncombe County, NC	2001	NA	109607	104953	4654	4.2
CN3702300000000	37	023	Burke County, NC	2001	NA	45586	42630	2956	6.5
CN3702500000000	37	025	Cabarrus County, NC	2001	NA	74980	71379	3601	4.8
CN3702700000000	37	027	Caldwell County, NC	2001	NA	42285	39560	2725	6.4
CN3702900000000	37	029	Camden County, NC	2001	NA	3410	3277	133	3.9
CN3703100000000	37	031	Carteret County, NC	2001	NA	29774	28190	1584	5.3
CN3703300000000	37	033	Caswell County, NC	2001	NA	10891	10170	721	6.6
CN3703500000000	37	035	Catawba County, NC	2001	NA	80956	75890	5066	6.3
CN3703700000000	37	037	Chatham County, NC	2001	NA	28368	27236	1132	4
CN3703900000000	37	039	Cherokee County, NC	2001	NA	10275	9386	889	8.7
CN3704100000000	37	041	Chowan County, NC	2001	NA	6437	6089	348	5.4
CN3704300000000	37	043	Clay County, NC	2001	NA	3969	3776	193	4.9
CN3704500000000	37	045	Cleveland County, NC	2001	NA	49968	45407	4561	9.1
CN3704700000000	37	047	Columbus County, NC	2001	NA	23288	21367	1921	8.2
CN3704900000000	37	049	Craven County, NC	2001	NA	38719	36547	2172	5.6
CN3705100000000	37	051	Cumberland County, NC	2001	NA	119623	112431	7192	6
CN3705300000000	37	053	Currituck County, NC	2001	NA	9692	9403	289	3
CN3705500000000	37	055	Dare County, NC	2001	NA	19160	18094	1066	5.6
CN3705700000000	37	057	Davidson County, NC	2001	NA	80338	75428	4910	6.1
CN3705900000000	37	059	Davie County, NC	2001	NA	18968	17984	984	5.2
CN3706100000000	37	061	Duplin County, NC	2001	NA	22744	21355	1389	6.1
CN3706300000000	37	063	Durham County, NC	2001	NA	126994	121510	5484	4.3
CN3706500000000	37	065	Edgecombe County, NC	2001	NA	25431	23351	2080	8.2
CN3706700000000	37	067	Forsyth County, NC	2001	NA	164557	156969	7588	4.6
CN3706900000000	37	069	Franklin County, NC	2001	NA	25015	23791	1224	4.9
CN3707100000000	37	071	Gaston County, NC	2001	NA	102061	94421	7640	7.5
CN3707300000000	37	073	Gates County, NC	2001	NA	4673	4470	203	4.3
CN3707500000000	37	075	Graham County, NC	2001	NA	3932	3583	349	8.9
CN3707700000000	37	077	Granville County, NC	2001	NA	23328	21870	1458	6.3
CN3707900000000	37	079	Greene County, NC	2001	NA	8662	8084	578	6.7
CN3708100000000	37	081	Guilford County, NC	2001	NA	236816	225058	11758	5
CN3708300000000	37	083	Halifax County, NC	2001	NA	22838	20637	2201	9.6
CN3708500000000	37	085	Harnett County, NC	2001	NA	43074	40438	2636	6.1
CN3708700000000	37	087	Haywood County, NC	2001	NA	26572	25087	1485	5.6
CN3708900000000	37	089	Henderson County, NC	2001	NA	43385	41538	1847	4.3
CN3709100000000	37	091	Hertford County, NC	2001	NA	9779	9083	696	7.1
CN3709300000000	37	093	Hoke County, NC	2001	NA	14854	13875	979	6.6
CN3709500000000	37	095	Hyde County, NC	2001	NA	2763	2564	199	7.2
CN3709700000000	37	097	Iredell County, NC	2001	NA	66458	62653	3805	5.7
CN3709900000000	37	099	Jackson County, NC	2001	NA	19108	18294	814	4.3
CN3710100000000	37	101	Johnston County, NC	2001	NA	65957	63186	2771	4.2
CN3710300000000	37	103	Jones County, NC	2001	NA	4621	4363	258	5.6
CN3710500000000	37	105	Lee County, NC	2001	NA	24918	23416	1502	6
CN3710700000000	37	107	Lenoir County, NC	2001	NA	27556	25372	2184	7.9
CN3710900000000	37	109	Lincoln County, NC	2001	NA	35623	33270	2353	6.6
CN3711100000000	37	111	McDowell County, NC	2001	NA	21327	19800	1527	7.2
CN3711300000000	37	113	Macon County, NC	2001	NA	14531	13868	663	4.6
CN3711500000000	37	115	Madison County, NC	2001	NA	9612	9087	525	5.5
CN3711700000000	37	117	Martin County, NC	2001	NA	11750	10937	813	6.9
CN3711900000000	37	119	Mecklenburg County, NC	2001	NA	409161	391446	17715	4.3
CN3712100000000	37	121	Mitchell County, NC	2001	NA	7806	7107	699	9
CN3712300000000	37	123	Montgomery County, NC	2001	NA	12771	11910	861	6.7
CN3712500000000	37	125	Moore County, NC	2001	NA	35126	33429	1697	4.8
CN3712700000000	37	127	Nash County, NC	2001	NA	44128	41361	2767	6.3
CN3712900000000	37	129	New Hanover County, NC	2001	NA	89716	85313	4403	4.9
CN3713100000000	37	131	Northampton County, NC	2001	NA	8639	7914	725	8.4
CN3713300000000	37	133	Onslow County, NC	2001	NA	54280	51325	2955	5.4
CN3713500000000	37	135	Orange County, NC	2001	NA	66565	64284	2281	3.4
CN3713700000000	37	137	Pamlico County, NC	2001	NA	5359	5066	293	5.5
CN3713900000000	37	139	Pasquotank County, NC	2001	NA	15473	14701	772	5
CN3714100000000	37	141	Pender County, NC	2001	NA	19945	18833	1112	5.6
CN3714300000000	37	143	Perquimans County, NC	2001	NA	4850	4587	263	5.4
CN3714500000000	37	145	Person County, NC	2001	NA	18818	17543	1275	6.8
CN3714700000000	37	147	Pitt County, NC	2001	NA	69840	65804	4036	5.8
CN3714900000000	37	149	Polk County, NC	2001	NA	8790	8418	372	4.2
CN3715100000000	37	151	Randolph County, NC	2001	NA	73599	69587	4012	5.5
CN3715300000000	37	153	Richmond County, NC	2001	NA	21318	19570	1748	8.2
CN3715500000000	37	155	Robeson County, NC	2001	NA	52319	47268	5051	9.7
CN3715700000000	37	157	Rockingham County, NC	2001	NA	46637	43457	3180	6.8
CN3715900000000	37	159	Rowan County, NC	2001	NA	65453	61195	4258	6.5
CN3716100000000	37	161	Rutherford County, NC	2001	NA	30691	28408	2283	7.4
CN3716300000000	37	163	Sampson County, NC	2001	NA	29288	27500	1788	6.1
CN3716500000000	37	165	Scotland County, NC	2001	NA	16077	14592	1485	9.2
CN3716700000000	37	167	Stanly County, NC	2001	NA	29543	27459	2084	7.1
CN3716900000000	37	169	Stokes County, NC	2001	NA	24193	22925	1268	5.2
CN3717100000000	37	171	Surry County, NC	2001	NA	36837	34571	2266	6.2
CN3717300000000	37	173	Swain County, NC	2001	NA	6721	6189	532	7.9
CN3717500000000	37	175	Transylvania County, NC	2001	NA	13371	12701	670	5
CN3717700000000	37	177	Tyrrell County, NC	2001	NA	1892	1741	151	8
CN3717900000000	37	179	Union County, NC	2001	NA	70966	68110	2856	4
CN3718100000000	37	181	Vance County, NC	2001	NA	20242	18417	1825	9
CN3718300000000	37	183	Wake County, NC	2001	NA	378061	363186	14875	3.9
CN3718500000000	37	185	Warren County, NC	2001	NA	8160	7468	692	8.5
CN3718700000000	37	187	Washington County, NC	2001	NA	5943	5525	418	7
CN3718900000000	37	189	Watauga County, NC	2001	NA	23710	22860	850	3.6
CN3719100000000	37	191	Wayne County, NC	2001	NA	51606	48722	2884	5.6
CN3719300000000	37	193	Wilkes County, NC	2001	NA	33682	31675	2007	6
CN3719500000000	37	195	Wilson County, NC	2001	NA	37910	35144	2766	7.3
CN3719700000000	37	197	Yadkin County, NC	2001	NA	19352	18360	992	5.1
CN3719900000000	37	199	Yancey County, NC	2001	NA	8240	7440	800	9.7
CN3800100000000	38	001	Adams County, ND	2001	NA	1189	1157	32	2.7
CN3800300000000	38	003	Barnes County, ND	2001	NA	5895	5722	173	2.9
CN3800500000000	38	005	Benson County, ND	2001	NA	2593	2440	153	5.9
CN3800700000000	38	007	Billings County, ND	2001	NA	496	485	11	2.2
CN3800900000000	38	009	Bottineau County, ND	2001	NA	3477	3363	114	3.3
CN3801100000000	38	011	Bowman County, ND	2001	NA	1764	1726	38	2.2
CN3801300000000	38	013	Burke County, ND	2001	NA	957	927	30	3.1
CN3801500000000	38	015	Burleigh County, ND	2001	NA	40547	39577	970	2.4
CN3801700000000	38	017	Cass County, ND	2001	NA	76054	74445	1609	2.1
CN3801900000000	38	019	Cavalier County, ND	2001	NA	2293	2220	73	3.2
CN3802100000000	38	021	Dickey County, ND	2001	NA	2977	2904	73	2.5
CN3802300000000	38	023	Divide County, ND	2001	NA	1007	979	28	2.8
CN3802500000000	38	025	Dunn County, ND	2001	NA	1719	1662	57	3.3
CN3802700000000	38	027	Eddy County, ND	2001	NA	1369	1312	57	4.2
CN3802900000000	38	029	Emmons County, ND	2001	NA	1975	1886	89	4.5
CN3803100000000	38	031	Foster County, ND	2001	NA	1843	1789	54	2.9
CN3803300000000	38	033	Golden Valley County, ND	2001	NA	893	871	22	2.5
CN3803500000000	38	035	Grand Forks County, ND	2001	NA	36039	35021	1018	2.8
CN3803700000000	38	037	Grant County, ND	2001	NA	1356	1314	42	3.1
CN3803900000000	38	039	Griggs County, ND	2001	NA	1360	1328	32	2.4
CN3804100000000	38	041	Hettinger County, ND	2001	NA	1218	1184	34	2.8
CN3804300000000	38	043	Kidder County, ND	2001	NA	1260	1195	65	5.2
CN3804500000000	38	045	LaMoure County, ND	2001	NA	2260	2190	70	3.1
CN3804700000000	38	047	Logan County, ND	2001	NA	1024	994	30	2.9
CN3804900000000	38	049	McHenry County, ND	2001	NA	2793	2657	136	4.9
CN3805100000000	38	051	McIntosh County, ND	2001	NA	1500	1457	43	2.9
CN3805300000000	38	053	McKenzie County, ND	2001	NA	2677	2603	74	2.8
CN3805500000000	38	055	McLean County, ND	2001	NA	4430	4215	215	4.9
CN3805700000000	38	057	Mercer County, ND	2001	NA	4474	4290	184	4.1
CN3805900000000	38	059	Morton County, ND	2001	NA	13808	13371	437	3.2
CN3806100000000	38	061	Mountrail County, ND	2001	NA	2948	2823	125	4.2
CN3806300000000	38	063	Nelson County, ND	2001	NA	1815	1748	67	3.7
CN3806500000000	38	065	Oliver County, ND	2001	NA	1102	1060	42	3.8
CN3806700000000	38	067	Pembina County, ND	2001	NA	4706	4503	203	4.3
CN3806900000000	38	069	Pierce County, ND	2001	NA	1915	1833	82	4.3
CN3807100000000	38	071	Ramsey County, ND	2001	NA	6249	6048	201	3.2
CN3807300000000	38	073	Ransom County, ND	2001	NA	3036	2964	72	2.4
CN3807500000000	38	075	Renville County, ND	2001	NA	1292	1261	31	2.4
CN3807700000000	38	077	Richland County, ND	2001	NA	8997	8726	271	3
CN3807900000000	38	079	Rolette County, ND	2001	NA	5616	5142	474	8.4
CN3808100000000	38	081	Sargent County, ND	2001	NA	2263	2191	72	3.2
CN3808300000000	38	083	Sheridan County, ND	2001	NA	797	754	43	5.4
CN3808500000000	38	085	Sioux County, ND	2001	NA	1309	1244	65	5
CN3808700000000	38	087	Slope County, ND	2001	NA	392	383	9	2.3
CN3808900000000	38	089	Stark County, ND	2001	NA	12323	11990	333	2.7
CN3809100000000	38	091	Steele County, ND	2001	NA	1126	1104	22	2
CN3809300000000	38	093	Stutsman County, ND	2001	NA	11741	11441	300	2.6
CN3809500000000	38	095	Towner County, ND	2001	NA	1360	1320	40	2.9
CN3809700000000	38	097	Traill County, ND	2001	NA	4248	4120	128	3
CN3809900000000	38	099	Walsh County, ND	2001	NA	6349	6138	211	3.3
CN3810100000000	38	101	Ward County, ND	2001	NA	27923	27025	898	3.2
CN3810300000000	38	103	Wells County, ND	2001	NA	2253	2166	87	3.9
CN3810500000000	38	105	Williams County, ND	2001	NA	10809	10551	258	2.4
CN3900100000000	39	001	Adams County, OH	2001	NA	12488	11560	928	7.4
CN3900300000000	39	003	Allen County, OH	2001	NA	51549	48955	2594	5
CN3900500000000	39	005	Ashland County, OH	2001	NA	27237	26013	1224	4.5
CN3900700000000	39	007	Ashtabula County, OH	2001	NA	49542	46561	2981	6
CN3900900000000	39	009	Athens County, OH	2001	NA	28427	27039	1388	4.9
CN3901100000000	39	011	Auglaize County, OH	2001	NA	24957	23890	1067	4.3
CN3901300000000	39	013	Belmont County, OH	2001	NA	30971	29250	1721	5.6
CN3901500000000	39	015	Brown County, OH	2001	NA	20839	19619	1220	5.9
CN3901700000000	39	017	Butler County, OH	2001	NA	175136	168168	6968	4
CN3901900000000	39	019	Carroll County, OH	2001	NA	14308	13620	688	4.8
CN3902100000000	39	021	Champaign County, OH	2001	NA	20687	19756	931	4.5
CN3902300000000	39	023	Clark County, OH	2001	NA	72761	69062	3699	5.1
CN3902500000000	39	025	Clermont County, OH	2001	NA	96639	92727	3912	4
CN3902700000000	39	027	Clinton County, OH	2001	NA	21841	21031	810	3.7
CN3902900000000	39	029	Columbiana County, OH	2001	NA	53804	50908	2896	5.4
CN3903100000000	39	031	Coshocton County, OH	2001	NA	17809	16855	954	5.4
CN3903300000000	39	033	Crawford County, OH	2001	NA	23655	22306	1349	5.7
CN3903500000000	39	035	Cuyahoga County, OH	2001	NA	685478	660597	24881	3.6
CN3903700000000	39	037	Darke County, OH	2001	NA	28210	27001	1209	4.3
CN3903900000000	39	039	Defiance County, OH	2001	NA	20907	19904	1003	4.8
CN3904100000000	39	041	Delaware County, OH	2001	NA	67098	65195	1903	2.8
CN3904300000000	39	043	Erie County, OH	2001	NA	42374	40364	2010	4.7
CN3904500000000	39	045	Fairfield County, OH	2001	NA	67221	64880	2341	3.5
CN3904700000000	39	047	Fayette County, OH	2001	NA	15527	14894	633	4.1
CN3904900000000	39	049	Franklin County, OH	2001	NA	599424	579080	20344	3.4
CN3905100000000	39	051	Fulton County, OH	2001	NA	22668	21649	1019	4.5
CN3905300000000	39	053	Gallia County, OH	2001	NA	13354	12517	837	6.3
CN3905500000000	39	055	Geauga County, OH	2001	NA	49185	47819	1366	2.8
CN3905700000000	39	057	Greene County, OH	2001	NA	76389	73420	2969	3.9
CN3905900000000	39	059	Guernsey County, OH	2001	NA	18758	17709	1049	5.6
CN3906100000000	39	061	Hamilton County, OH	2001	NA	425528	408575	16953	4
CN3906300000000	39	063	Hancock County, OH	2001	NA	39042	37600	1442	3.7
CN3906500000000	39	065	Hardin County, OH	2001	NA	15558	14815	743	4.8
CN3906700000000	39	067	Harrison County, OH	2001	NA	7383	7024	359	4.9
CN3906900000000	39	069	Henry County, OH	2001	NA	15221	14490	731	4.8
CN3907100000000	39	071	Highland County, OH	2001	NA	19458	18477	981	5
CN3907300000000	39	073	Hocking County, OH	2001	NA	13281	12537	744	5.6
CN3907500000000	39	075	Holmes County, OH	2001	NA	18125	17593	532	2.9
CN3907700000000	39	077	Huron County, OH	2001	NA	30562	28721	1841	6
CN3907900000000	39	079	Jackson County, OH	2001	NA	14591	13624	967	6.6
CN3908100000000	39	081	Jefferson County, OH	2001	NA	31774	29899	1875	5.9
CN3908300000000	39	083	Knox County, OH	2001	NA	27966	26805	1161	4.2
CN3908500000000	39	085	Lake County, OH	2001	NA	129787	125514	4273	3.3
CN3908700000000	39	087	Lawrence County, OH	2001	NA	26161	24508	1653	6.3
CN3908900000000	39	089	Licking County, OH	2001	NA	78370	75313	3057	3.9
CN3909100000000	39	091	Logan County, OH	2001	NA	24305	23393	912	3.8
CN3909300000000	39	093	Lorain County, OH	2001	NA	148983	143021	5962	4
CN3909500000000	39	095	Lucas County, OH	2001	NA	226796	215491	11305	5
CN3909700000000	39	097	Madison County, OH	2001	NA	19401	18688	713	3.7
CN3909900000000	39	099	Mahoning County, OH	2001	NA	118315	111505	6810	5.8
CN3910100000000	39	101	Marion County, OH	2001	NA	32024	30552	1472	4.6
CN3910300000000	39	103	Medina County, OH	2001	NA	86298	83689	2609	3
CN3910500000000	39	105	Meigs County, OH	2001	NA	9774	9099	675	6.9
CN3910700000000	39	107	Mercer County, OH	2001	NA	21778	20795	983	4.5
CN3910900000000	39	109	Miami County, OH	2001	NA	54304	51978	2326	4.3
CN3911100000000	39	111	Monroe County, OH	2001	NA	6022	5641	381	6.3
CN3911300000000	39	113	Montgomery County, OH	2001	NA	278640	265836	12804	4.6
CN3911500000000	39	115	Morgan County, OH	2001	NA	6681	6125	556	8.3
CN3911700000000	39	117	Morrow County, OH	2001	NA	17036	16187	849	5
CN3911900000000	39	119	Muskingum County, OH	2001	NA	42158	39735	2423	5.7
CN3912100000000	39	121	Noble County, OH	2001	NA	5737	5411	326	5.7
CN3912300000000	39	123	Ottawa County, OH	2001	NA	21379	20173	1206	5.6
CN3912500000000	39	125	Paulding County, OH	2001	NA	10723	10233	490	4.6
CN3912700000000	39	127	Perry County, OH	2001	NA	16353	15424	929	5.7
CN3912900000000	39	129	Pickaway County, OH	2001	NA	23786	22730	1056	4.4
CN3913100000000	39	131	Pike County, OH	2001	NA	11567	10704	863	7.5
CN3913300000000	39	133	Portage County, OH	2001	NA	84822	81211	3611	4.3
CN3913500000000	39	135	Preble County, OH	2001	NA	21989	21021	968	4.4
CN3913700000000	39	137	Putnam County, OH	2001	NA	17935	17216	719	4
CN3913900000000	39	139	Richland County, OH	2001	NA	63122	59840	3282	5.2
CN3914100000000	39	141	Ross County, OH	2001	NA	33472	31669	1803	5.4
CN3914300000000	39	143	Sandusky County, OH	2001	NA	32802	31282	1520	4.6
CN3914500000000	39	145	Scioto County, OH	2001	NA	32404	30188	2216	6.8
CN3914700000000	39	147	Seneca County, OH	2001	NA	31168	29620	1548	5
CN3914900000000	39	149	Shelby County, OH	2001	NA	25778	24709	1069	4.1
CN3915100000000	39	151	Stark County, OH	2001	NA	193549	185161	8388	4.3
CN3915300000000	39	153	Summit County, OH	2001	NA	280317	267469	12848	4.6
CN3915500000000	39	155	Trumbull County, OH	2001	NA	106873	100260	6613	6.2
CN3915700000000	39	157	Tuscarawas County, OH	2001	NA	46652	44533	2119	4.5
CN3915900000000	39	159	Union County, OH	2001	NA	22900	22189	711	3.1
CN3916100000000	39	161	Van Wert County, OH	2001	NA	15356	14531	825	5.4
CN3916300000000	39	163	Vinton County, OH	2001	NA	5521	5106	415	7.5
CN3916500000000	39	165	Warren County, OH	2001	NA	86842	83667	3175	3.7
CN3916700000000	39	167	Washington County, OH	2001	NA	31361	29870	1491	4.8
CN3916900000000	39	169	Wayne County, OH	2001	NA	59670	57357	2313	3.9
CN3917100000000	39	171	Williams County, OH	2001	NA	20782	19716	1066	5.1
CN3917300000000	39	173	Wood County, OH	2001	NA	66608	64000	2608	3.9
CN3917500000000	39	175	Wyandot County, OH	2001	NA	12808	12266	542	4.2
CN4000100000000	40	001	Adair County, OK	2001	NA	9170	8792	378	4.1
CN4000300000000	40	003	Alfalfa County, OK	2001	NA	2527	2451	76	3
CN4000500000000	40	005	Atoka County, OK	2001	NA	5297	5064	233	4.4
CN4000700000000	40	007	Beaver County, OK	2001	NA	3010	2931	79	2.6
CN4000900000000	40	009	Beckham County, OK	2001	NA	8855	8576	279	3.2
CN4001100000000	40	011	Blaine County, OK	2001	NA	4673	4471	202	4.3
CN4001300000000	40	013	Bryan County, OK	2001	NA	17626	17036	590	3.3
CN4001500000000	40	015	Caddo County, OK	2001	NA	12266	11716	550	4.5
CN4001700000000	40	017	Canadian County, OK	2001	NA	47628	46159	1469	3.1
CN4001900000000	40	019	Carter County, OK	2001	NA	21475	20651	824	3.8
CN4002100000000	40	021	Cherokee County, OK	2001	NA	19098	18444	654	3.4
CN4002300000000	40	023	Choctaw County, OK	2001	NA	6304	5974	330	5.2
CN4002500000000	40	025	Cimarron County, OK	2001	NA	1534	1491	43	2.8
CN4002700000000	40	027	Cleveland County, OK	2001	NA	114172	110609	3563	3.1
CN4002900000000	40	029	Coal County, OK	2001	NA	2518	2384	134	5.3
CN4003100000000	40	031	Comanche County, OK	2001	NA	42532	40886	1646	3.9
CN4003300000000	40	033	Cotton County, OK	2001	NA	2806	2707	99	3.5
CN4003500000000	40	035	Craig County, OK	2001	NA	6770	6506	264	3.9
CN4003700000000	40	037	Creek County, OK	2001	NA	32175	31015	1160	3.6
CN4003900000000	40	039	Custer County, OK	2001	NA	13153	12748	405	3.1
CN4004100000000	40	041	Delaware County, OK	2001	NA	16241	15592	649	4
CN4004300000000	40	043	Dewey County, OK	2001	NA	2343	2277	66	2.8
CN4004500000000	40	045	Ellis County, OK	2001	NA	2118	2061	57	2.7
CN4004700000000	40	047	Garfield County, OK	2001	NA	27591	26750	841	3
CN4004900000000	40	049	Garvin County, OK	2001	NA	12897	12419	478	3.7
CN4005100000000	40	051	Grady County, OK	2001	NA	22158	21434	724	3.3
CN4005300000000	40	053	Grant County, OK	2001	NA	2493	2423	70	2.8
CN4005500000000	40	055	Greer County, OK	2001	NA	2284	2186	98	4.3
CN4005700000000	40	057	Harmon County, OK	2001	NA	1435	1386	49	3.4
CN4005900000000	40	059	Harper County, OK	2001	NA	1926	1870	56	2.9
CN4006100000000	40	061	Haskell County, OK	2001	NA	5501	5270	231	4.2
CN4006300000000	40	063	Hughes County, OK	2001	NA	5321	5031	290	5.5
CN4006500000000	40	065	Jackson County, OK	2001	NA	11990	11604	386	3.2
CN4006700000000	40	067	Jefferson County, OK	2001	NA	2627	2516	111	4.2
CN4006900000000	40	069	Johnston County, OK	2001	NA	4562	4342	220	4.8
CN4007100000000	40	071	Kay County, OK	2001	NA	22836	21897	939	4.1
CN4007300000000	40	073	Kingfisher County, OK	2001	NA	7286	7108	178	2.4
CN4007500000000	40	075	Kiowa County, OK	2001	NA	4557	4408	149	3.3
CN4007700000000	40	077	Latimer County, OK	2001	NA	4644	4417	227	4.9
CN4007900000000	40	079	Le Flore County, OK	2001	NA	20935	19847	1088	5.2
CN4008100000000	40	081	Lincoln County, OK	2001	NA	14989	14412	577	3.8
CN4008300000000	40	083	Logan County, OK	2001	NA	17347	16852	495	2.9
CN4008500000000	40	085	Love County, OK	2001	NA	4312	4143	169	3.9
CN4008700000000	40	087	McClain County, OK	2001	NA	13975	13469	506	3.6
CN4008900000000	40	089	McCurtain County, OK	2001	NA	15629	14804	825	5.3
CN4009100000000	40	091	McIntosh County, OK	2001	NA	8058	7653	405	5
CN4009300000000	40	093	Major County, OK	2001	NA	3841	3735	106	2.8
CN4009500000000	40	095	Marshall County, OK	2001	NA	5679	5444	235	4.1
CN4009700000000	40	097	Mayes County, OK	2001	NA	17870	17124	746	4.2
CN4009900000000	40	099	Murray County, OK	2001	NA	6026	5782	244	4
CN4010100000000	40	101	Muskogee County, OK	2001	NA	28947	27712	1235	4.3
CN4010300000000	40	103	Noble County, OK	2001	NA	5531	5315	216	3.9
CN4010500000000	40	105	Nowata County, OK	2001	NA	4832	4625	207	4.3
CN4010700000000	40	107	Okfuskee County, OK	2001	NA	4749	4550	199	4.2
CN4010900000000	40	109	Oklahoma County, OK	2001	NA	330780	317977	12803	3.9
CN4011100000000	40	111	Okmulgee County, OK	2001	NA	17067	16263	804	4.7
CN4011300000000	40	113	Osage County, OK	2001	NA	21001	20287	714	3.4
CN4011500000000	40	115	Ottawa County, OK	2001	NA	15581	14707	874	5.6
CN4011700000000	40	117	Pawnee County, OK	2001	NA	7975	7661	314	3.9
CN4011900000000	40	119	Payne County, OK	2001	NA	35058	34070	988	2.8
CN4012100000000	40	121	Pittsburg County, OK	2001	NA	17941	17160	781	4.4
CN4012300000000	40	123	Pontotoc County, OK	2001	NA	16690	16037	653	3.9
CN4012500000000	40	125	Pottawatomie County, OK	2001	NA	30029	28709	1320	4.4
CN4012700000000	40	127	Pushmataha County, OK	2001	NA	4771	4486	285	6
CN4012900000000	40	129	Roger Mills County, OK	2001	NA	1814	1771	43	2.4
CN4013100000000	40	131	Rogers County, OK	2001	NA	37014	35892	1122	3
CN4013300000000	40	133	Seminole County, OK	2001	NA	10655	10149	506	4.7
CN4013500000000	40	135	Sequoyah County, OK	2001	NA	17387	16534	853	4.9
CN4013700000000	40	137	Stephens County, OK	2001	NA	19410	18717	693	3.6
CN4013900000000	40	139	Texas County, OK	2001	NA	10612	10322	290	2.7
CN4014100000000	40	141	Tillman County, OK	2001	NA	3697	3546	151	4.1
CN4014300000000	40	143	Tulsa County, OK	2001	NA	297963	288031	9932	3.3
CN4014500000000	40	145	Wagoner County, OK	2001	NA	30011	29122	889	3
CN4014700000000	40	147	Washington County, OK	2001	NA	23383	22647	736	3.1
CN4014900000000	40	149	Washita County, OK	2001	NA	5891	5723	168	2.9
CN4015100000000	40	151	Woods County, OK	2001	NA	4530	4409	121	2.7
CN4015300000000	40	153	Woodward County, OK	2001	NA	9561	9282	279	2.9
CN4100100000000	41	001	Baker County, OR	2001	NA	7304	6682	622	8.5
CN4100300000000	41	003	Benton County, OR	2001	NA	41638	39775	1863	4.5
CN4100500000000	41	005	Clackamas County, OR	2001	NA	188360	178475	9885	5.2
CN4100700000000	41	007	Clatsop County, OR	2001	NA	17988	16951	1037	5.8
CN4100900000000	41	009	Columbia County, OR	2001	NA	22764	21010	1754	7.7
CN4101100000000	41	011	Coos County, OR	2001	NA	26594	24348	2246	8.4
CN4101300000000	41	013	Crook County, OR	2001	NA	8738	7999	739	8.5
CN4101500000000	41	015	Curry County, OR	2001	NA	8786	8157	629	7.2
CN4101700000000	41	017	Deschutes County, OR	2001	NA	63423	59328	4095	6.5
CN4101900000000	41	019	Douglas County, OR	2001	NA	46284	42397	3887	8.4
CN4102100000000	41	021	Gilliam County, OR	2001	NA	1020	959	61	6
CN4102300000000	41	023	Grant County, OR	2001	NA	3751	3403	348	9.3
CN4102500000000	41	025	Harney County, OR	2001	NA	3687	3230	457	12.4
CN4102700000000	41	027	Hood River County, OR	2001	NA	11688	10795	893	7.6
CN4102900000000	41	029	Jackson County, OR	2001	NA	92188	86137	6051	6.6
CN4103100000000	41	031	Jefferson County, OR	2001	NA	8720	8131	589	6.8
CN4103300000000	41	033	Josephine County, OR	2001	NA	31697	29045	2652	8.4
CN4103500000000	41	035	Klamath County, OR	2001	NA	29798	27236	2562	8.6
CN4103700000000	41	037	Lake County, OR	2001	NA	3434	3114	320	9.3
CN4103900000000	41	039	Lane County, OR	2001	NA	169887	158313	11574	6.8
CN4104100000000	41	041	Lincoln County, OR	2001	NA	21180	19660	1520	7.2
CN4104300000000	41	043	Linn County, OR	2001	NA	52038	48042	3996	7.7
CN4104500000000	41	045	Malheur County, OR	2001	NA	13056	11970	1086	8.3
CN4104700000000	41	047	Marion County, OR	2001	NA	144866	135571	9295	6.4
CN4104900000000	41	049	Morrow County, OR	2001	NA	5546	5121	425	7.7
CN4105100000000	41	051	Multnomah County, OR	2001	NA	380121	356323	23798	6.3
CN4105300000000	41	053	Polk County, OR	2001	NA	33431	31524	1907	5.7
CN4105500000000	41	055	Sherman County, OR	2001	NA	907	815	92	10.1
CN4105700000000	41	057	Tillamook County, OR	2001	NA	11736	11012	724	6.2
CN4105900000000	41	059	Umatilla County, OR	2001	NA	36501	33938	2563	7
CN4106100000000	41	061	Union County, OR	2001	NA	12106	11338	768	6.3
CN4106300000000	41	063	Wallowa County, OR	2001	NA	3541	3215	326	9.2
CN4106500000000	41	065	Wasco County, OR	2001	NA	12731	11626	1105	8.7
CN4106700000000	41	067	Washington County, OR	2001	NA	263932	249533	14399	5.5
CN4106900000000	41	069	Wheeler County, OR	2001	NA	709	651	58	8.2
CN4107100000000	41	071	Yamhill County, OR	2001	NA	43772	41084	2688	6.1
CN4200100000000	42	001	Adams County, PA	2001	NA	51103	49124	1979	3.9
CN4200300000000	42	003	Allegheny County, PA	2001	NA	644520	616135	28385	4.4
CN4200500000000	42	005	Armstrong County, PA	2001	NA	33813	31608	2205	6.5
CN4200700000000	42	007	Beaver County, PA	2001	NA	90338	85777	4561	5
CN4200900000000	42	009	Bedford County, PA	2001	NA	24240	22520	1720	7.1
CN4201100000000	42	011	Berks County, PA	2001	NA	196976	187597	9379	4.8
CN4201300000000	42	013	Blair County, PA	2001	NA	63815	60211	3604	5.6
CN4201500000000	42	015	Bradford County, PA	2001	NA	31824	30243	1581	5
CN4201700000000	42	017	Bucks County, PA	2001	NA	336091	322673	13418	4
CN4201900000000	42	019	Butler County, PA	2001	NA	91778	87527	4251	4.6
CN4202100000000	42	021	Cambria County, PA	2001	NA	66701	62270	4431	6.6
CN4202300000000	42	023	Cameron County, PA	2001	NA	2643	2417	226	8.6
CN4202500000000	42	025	Carbon County, PA	2001	NA	29572	27872	1700	5.7
CN4202700000000	42	027	Centre County, PA	2001	NA	70583	67899	2684	3.8
CN4202900000000	42	029	Chester County, PA	2001	NA	242002	233753	8249	3.4
CN4203100000000	42	031	Clarion County, PA	2001	NA	19670	18692	978	5
CN4203300000000	42	033	Clearfield County, PA	2001	NA	40311	37521	2790	6.9
CN4203500000000	42	035	Clinton County, PA	2001	NA	18484	17308	1176	6.4
CN4203700000000	42	037	Columbia County, PA	2001	NA	32041	30176	1865	5.8
CN4203900000000	42	039	Crawford County, PA	2001	NA	43035	40309	2726	6.3
CN4204100000000	42	041	Cumberland County, PA	2001	NA	115926	111492	4434	3.8
CN4204300000000	42	043	Dauphin County, PA	2001	NA	133012	127334	5678	4.3
CN4204500000000	42	045	Delaware County, PA	2001	NA	280794	269017	11777	4.2
CN4204700000000	42	047	Elk County, PA	2001	NA	18051	16752	1299	7.2
CN4204900000000	42	049	Erie County, PA	2001	NA	140237	132515	7722	5.5
CN4205100000000	42	051	Fayette County, PA	2001	NA	65390	61306	4084	6.2
CN4205300000000	42	053	Forest County, PA	2001	NA	2230	1946	284	12.7
CN4205500000000	42	055	Franklin County, PA	2001	NA	67952	64834	3118	4.6
CN4205700000000	42	057	Fulton County, PA	2001	NA	7438	6989	449	6
CN4205900000000	42	059	Greene County, PA	2001	NA	17067	16091	976	5.7
CN4206100000000	42	061	Huntingdon County, PA	2001	NA	21609	19944	1665	7.7
CN4206300000000	42	063	Indiana County, PA	2001	NA	43051	40764	2287	5.3
CN4206500000000	42	065	Jefferson County, PA	2001	NA	21436	20039	1397	6.5
CN4206700000000	42	067	Juniata County, PA	2001	NA	11717	11169	548	4.7
CN4206900000000	42	069	Lackawanna County, PA	2001	NA	105059	99240	5819	5.5
CN4207100000000	42	071	Lancaster County, PA	2001	NA	255424	246660	8764	3.4
CN4207300000000	42	073	Lawrence County, PA	2001	NA	44344	41856	2488	5.6
CN4207500000000	42	075	Lebanon County, PA	2001	NA	65926	63542	2384	3.6
CN4207700000000	42	077	Lehigh County, PA	2001	NA	166059	158719	7340	4.4
CN4207900000000	42	079	Luzerne County, PA	2001	NA	155935	147130	8805	5.6
CN4208100000000	42	081	Lycoming County, PA	2001	NA	60205	56953	3252	5.4
CN4208300000000	42	083	McKean County, PA	2001	NA	22114	20885	1229	5.6
CN4208500000000	42	085	Mercer County, PA	2001	NA	55798	52817	2981	5.3
CN4208700000000	42	087	Mifflin County, PA	2001	NA	22013	20632	1381	6.3
CN4208900000000	42	089	Monroe County, PA	2001	NA	71393	67996	3397	4.8
CN4209100000000	42	091	Montgomery County, PA	2001	NA	418261	402667	15594	3.7
CN4209300000000	42	093	Montour County, PA	2001	NA	8636	8269	367	4.2
CN4209500000000	42	095	Northampton County, PA	2001	NA	141091	134945	6146	4.4
CN4209700000000	42	097	Northumberland County, PA	2001	NA	45582	43116	2466	5.4
CN4209900000000	42	099	Perry County, PA	2001	NA	23713	22659	1054	4.4
CN4210100000000	42	101	Philadelphia County/city, PA	2001	NA	637214	598088	39126	6.1
CN4210300000000	42	103	Pike County, PA	2001	NA	22270	21199	1071	4.8
CN4210500000000	42	105	Potter County, PA	2001	NA	8993	8549	444	4.9
CN4210700000000	42	107	Schuylkill County, PA	2001	NA	70146	65567	4579	6.5
CN4210900000000	42	109	Snyder County, PA	2001	NA	19097	18291	806	4.2
CN4211100000000	42	111	Somerset County, PA	2001	NA	38224	35978	2246	5.9
CN4211300000000	42	113	Sullivan County, PA	2001	NA	3081	2915	166	5.4
CN4211500000000	42	115	Susquehanna County, PA	2001	NA	21181	19980	1201	5.7
CN4211700000000	42	117	Tioga County, PA	2001	NA	20507	19217	1290	6.3
CN4211900000000	42	119	Union County, PA	2001	NA	17663	16847	816	4.6
CN4212100000000	42	121	Venango County, PA	2001	NA	26586	25187	1399	5.3
CN4212300000000	42	123	Warren County, PA	2001	NA	22574	21523	1051	4.7
CN4212500000000	42	125	Washington County, PA	2001	NA	100729	95555	5174	5.1
CN4212700000000	42	127	Wayne County, PA	2001	NA	22997	21863	1134	4.9
CN4212900000000	42	129	Westmoreland County, PA	2001	NA	185060	175553	9507	5.1
CN4213100000000	42	131	Wyoming County, PA	2001	NA	13990	13260	730	5.2
CN4213300000000	42	133	York County, PA	2001	NA	211311	202209	9102	4.3
CN4400100000000	44	001	Bristol County, RI	2001	NA	26711	25718	993	3.7
CN4400300000000	44	003	Kent County, RI	2001	NA	92814	88937	3877	4.2
CN4400500000000	44	005	Newport County, RI	2001	NA	44428	42709	1719	3.9
CN4400700000000	44	007	Providence County, RI	2001	NA	310556	294798	15758	5.1
CN4400900000000	44	009	Washington County, RI	2001	NA	69358	66884	2474	3.6
CN4500100000000	45	001	Abbeville County, SC	2001	NA	12302	11491	811	6.6
CN4500300000000	45	003	Aiken County, SC	2001	NA	68414	65004	3410	5
CN4500500000000	45	005	Allendale County, SC	2001	NA	3630	3408	222	6.1
CN4500700000000	45	007	Anderson County, SC	2001	NA	83150	78693	4457	5.4
CN4500900000000	45	009	Bamberg County, SC	2001	NA	6399	5976	423	6.6
CN4501100000000	45	011	Barnwell County, SC	2001	NA	9970	9275	695	7
CN4501300000000	45	013	Beaufort County, SC	2001	NA	51281	49295	1986	3.9
CN4501500000000	45	015	Berkeley County, SC	2001	NA	64707	61862	2845	4.4
CN4501700000000	45	017	Calhoun County, SC	2001	NA	7048	6630	418	5.9
CN4501900000000	45	019	Charleston County, SC	2001	NA	149901	143672	6229	4.2
CN4502100000000	45	021	Cherokee County, SC	2001	NA	25459	23675	1784	7
CN4502300000000	45	023	Chester County, SC	2001	NA	16253	15002	1251	7.7
CN4502500000000	45	025	Chesterfield County, SC	2001	NA	18873	17461	1412	7.5
CN4502700000000	45	027	Clarendon County, SC	2001	NA	12678	11718	960	7.6
CN4502900000000	45	029	Colleton County, SC	2001	NA	15742	14946	796	5.1
CN4503100000000	45	031	Darlington County, SC	2001	NA	30807	28860	1947	6.3
CN4503300000000	45	033	Dillon County, SC	2001	NA	12964	11767	1197	9.2
CN4503500000000	45	035	Dorchester County, SC	2001	NA	46987	45051	1936	4.1
CN4503700000000	45	037	Edgefield County, SC	2001	NA	10187	9696	491	4.8
CN4503900000000	45	039	Fairfield County, SC	2001	NA	11169	10227	942	8.4
CN4504100000000	45	041	Florence County, SC	2001	NA	59133	55865	3268	5.5
CN4504300000000	45	043	Georgetown County, SC	2001	NA	26109	24172	1937	7.4
CN4504500000000	45	045	Greenville County, SC	2001	NA	202199	194579	7620	3.8
CN4504700000000	45	047	Greenwood County, SC	2001	NA	32589	30355	2234	6.9
CN4504900000000	45	049	Hampton County, SC	2001	NA	8088	7586	502	6.2
CN4505100000000	45	051	Horry County, SC	2001	NA	103215	98119	5096	4.9
CN4505300000000	45	053	Jasper County, SC	2001	NA	9044	8649	395	4.4
CN4505500000000	45	055	Kershaw County, SC	2001	NA	26912	25521	1391	5.2
CN4505700000000	45	057	Lancaster County, SC	2001	NA	29992	28352	1640	5.5
CN4505900000000	45	059	Laurens County, SC	2001	NA	34157	31937	2220	6.5
CN4506100000000	45	061	Lee County, SC	2001	NA	8147	7569	578	7.1
CN4506300000000	45	063	Lexington County, SC	2001	NA	117194	113005	4189	3.6
CN4506500000000	45	065	McCormick County, SC	2001	NA	3686	3329	357	9.7
CN4506700000000	45	067	Marion County, SC	2001	NA	14559	12765	1794	12.3
CN4506900000000	45	069	Marlboro County, SC	2001	NA	12331	11152	1179	9.6
CN4507100000000	45	071	Newberry County, SC	2001	NA	17163	16090	1073	6.3
CN4507300000000	45	073	Oconee County, SC	2001	NA	32129	30380	1749	5.4
CN4507500000000	45	075	Orangeburg County, SC	2001	NA	39807	36379	3428	8.6
CN4507700000000	45	077	Pickens County, SC	2001	NA	57216	54343	2873	5
CN4507900000000	45	079	Richland County, SC	2001	NA	159120	152465	6655	4.2
CN4508100000000	45	081	Saluda County, SC	2001	NA	9225	8743	482	5.2
CN4508300000000	45	083	Spartanburg County, SC	2001	NA	128219	121292	6927	5.4
CN4508500000000	45	085	Sumter County, SC	2001	NA	43466	40614	2852	6.6
CN4508700000000	45	087	Union County, SC	2001	NA	14035	12780	1255	8.9
CN4508900000000	45	089	Williamsburg County, SC	2001	NA	14994	13458	1536	10.2
CN4509100000000	45	091	York County, SC	2001	NA	89041	84736	4305	4.8
CN4600300000000	46	003	Aurora County, SD	2001	NA	1563	1521	42	2.7
CN4600500000000	46	005	Beadle County, SD	2001	NA	9286	8977	309	3.3
CN4600700000000	46	007	Bennett County, SD	2001	NA	1386	1331	55	4
CN4600900000000	46	009	Bon Homme County, SD	2001	NA	3330	3215	115	3.5
CN4601100000000	46	011	Brookings County, SD	2001	NA	16966	16500	466	2.7
CN4601300000000	46	013	Brown County, SD	2001	NA	20485	19862	623	3
CN4601500000000	46	015	Brule County, SD	2001	NA	2855	2782	73	2.6
CN4601700000000	46	017	Buffalo County, SD	2001	NA	533	487	46	8.6
CN4601900000000	46	019	Butte County, SD	2001	NA	4843	4688	155	3.2
CN4602100000000	46	021	Campbell County, SD	2001	NA	880	838	42	4.8
CN4602300000000	46	023	Charles Mix County, SD	2001	NA	4182	4050	132	3.2
CN4602500000000	46	025	Clark County, SD	2001	NA	2056	1954	102	5
CN4602700000000	46	027	Clay County, SD	2001	NA	6942	6746	196	2.8
CN4602900000000	46	029	Codington County, SD	2001	NA	15608	15066	542	3.5
CN4603100000000	46	031	Corson County, SD	2001	NA	1375	1291	84	6.1
CN4603300000000	46	033	Custer County, SD	2001	NA	4308	4165	143	3.3
CN4603500000000	46	035	Davison County, SD	2001	NA	10760	10490	270	2.5
CN4603700000000	46	037	Day County, SD	2001	NA	3051	2893	158	5.2
CN4603900000000	46	039	Deuel County, SD	2001	NA	2530	2429	101	4
CN4604100000000	46	041	Dewey County, SD	2001	NA	2445	2217	228	9.3
CN4604300000000	46	043	Douglas County, SD	2001	NA	1707	1663	44	2.6
CN4604500000000	46	045	Edmunds County, SD	2001	NA	2130	2069	61	2.9
CN4604700000000	46	047	Fall River County, SD	2001	NA	3615	3473	142	3.9
CN4604900000000	46	049	Faulk County, SD	2001	NA	1202	1168	34	2.8
CN4605100000000	46	051	Grant County, SD	2001	NA	4170	4014	156	3.7
CN4605300000000	46	053	Gregory County, SD	2001	NA	2417	2333	84	3.5
CN4605500000000	46	055	Haakon County, SD	2001	NA	1231	1204	27	2.2
CN4605700000000	46	057	Hamlin County, SD	2001	NA	2805	2708	97	3.5
CN4605900000000	46	059	Hand County, SD	2001	NA	1969	1918	51	2.6
CN4606100000000	46	061	Hanson County, SD	2001	NA	1736	1691	45	2.6
CN4606300000000	46	063	Harding County, SD	2001	NA	763	743	20	2.6
CN4606500000000	46	065	Hughes County, SD	2001	NA	9792	9565	227	2.3
CN4606700000000	46	067	Hutchinson County, SD	2001	NA	3875	3751	124	3.2
CN4606900000000	46	069	Hyde County, SD	2001	NA	856	833	23	2.7
CN4607100000000	46	071	Jackson County, SD	2001	NA	1184	1129	55	4.6
CN4607300000000	46	073	Jerauld County, SD	2001	NA	1279	1241	38	3
CN4607500000000	46	075	Jones County, SD	2001	NA	730	715	15	2.1
CN4607700000000	46	077	Kingsbury County, SD	2001	NA	3051	2955	96	3.1
CN4607900000000	46	079	Lake County, SD	2001	NA	6668	6474	194	2.9
CN4608100000000	46	081	Lawrence County, SD	2001	NA	11529	11159	370	3.2
CN4608300000000	46	083	Lincoln County, SD	2001	NA	15382	15049	333	2.2
CN4608500000000	46	085	Lyman County, SD	2001	NA	1950	1865	85	4.4
CN4608700000000	46	087	McCook County, SD	2001	NA	2984	2893	91	3
CN4608900000000	46	089	McPherson County, SD	2001	NA	1285	1241	44	3.4
CN4609100000000	46	091	Marshall County, SD	2001	NA	2093	1981	112	5.4
CN4609300000000	46	093	Meade County, SD	2001	NA	12361	12007	354	2.9
CN4609500000000	46	095	Mellette County, SD	2001	NA	931	893	38	4.1
CN4609700000000	46	097	Miner County, SD	2001	NA	1276	1216	60	4.7
CN4609900000000	46	099	Minnehaha County, SD	2001	NA	89737	87520	2217	2.5
CN4610100000000	46	101	Moody County, SD	2001	NA	3826	3656	170	4.4
CN4610200000000	46	102	Oglala Lakota County, SD	2001	NA	3666	3376	290	7.9
CN4610300000000	46	103	Pennington County, SD	2001	NA	49928	48474	1454	2.9
CN4610500000000	46	105	Perkins County, SD	2001	NA	1781	1730	51	2.9
CN4610700000000	46	107	Potter County, SD	2001	NA	1426	1377	49	3.4
CN4610900000000	46	109	Roberts County, SD	2001	NA	4524	4310	214	4.7
CN4611100000000	46	111	Sanborn County, SD	2001	NA	1497	1452	45	3
CN4611500000000	46	115	Spink County, SD	2001	NA	3351	3232	119	3.6
CN4611700000000	46	117	Stanley County, SD	2001	NA	1879	1834	45	2.4
CN4611900000000	46	119	Sully County, SD	2001	NA	905	883	22	2.4
CN4612100000000	46	121	Todd County, SD	2001	NA	3332	3161	171	5.1
CN4612300000000	46	123	Tripp County, SD	2001	NA	3219	3121	98	3
CN4612500000000	46	125	Turner County, SD	2001	NA	4720	4587	133	2.8
CN4612700000000	46	127	Union County, SD	2001	NA	7435	7205	230	3.1
CN4612900000000	46	129	Walworth County, SD	2001	NA	2858	2754	104	3.6
CN4613500000000	46	135	Yankton County, SD	2001	NA	11511	11144	367	3.2
CN4613700000000	46	137	Ziebach County, SD	2001	NA	826	760	66	8
CN4700100000000	47	001	Anderson County, TN	2001	NA	34416	32837	1579	4.6
CN4700300000000	47	003	Bedford County, TN	2001	NA	19860	18854	1006	5.1
CN4700500000000	47	005	Benton County, TN	2001	NA	7100	6597	503	7.1
CN4700700000000	47	007	Bledsoe County, TN	2001	NA	4961	4723	238	4.8
CN4700900000000	47	009	Blount County, TN	2001	NA	55827	53510	2317	4.2
CN4701100000000	47	011	Bradley County, TN	2001	NA	44935	43111	1824	4.1
CN4701300000000	47	013	Campbell County, TN	2001	NA	16222	15227	995	6.1
CN4701500000000	47	015	Cannon County, TN	2001	NA	6380	6125	255	4
CN4701700000000	47	017	Carroll County, TN	2001	NA	13891	12882	1009	7.3
CN4701900000000	47	019	Carter County, TN	2001	NA	27653	26305	1348	4.9
CN4702100000000	47	021	Cheatham County, TN	2001	NA	19624	18975	649	3.3
CN4702300000000	47	023	Chester County, TN	2001	NA	7506	7169	337	4.5
CN4702500000000	47	025	Claiborne County, TN	2001	NA	12473	11809	664	5.3
CN4702700000000	47	027	Clay County, TN	2001	NA	3564	3320	244	6.8
CN4702900000000	47	029	Cocke County, TN	2001	NA	15477	14324	1153	7.4
CN4703100000000	47	031	Coffee County, TN	2001	NA	24126	23066	1060	4.4
CN4703300000000	47	033	Crockett County, TN	2001	NA	6721	6346	375	5.6
CN4703500000000	47	035	Cumberland County, TN	2001	NA	20836	19506	1330	6.4
CN4703700000000	47	037	Davidson County, TN	2001	NA	307002	296183	10819	3.5
CN4703900000000	47	039	Decatur County, TN	2001	NA	5520	5137	383	6.9
CN4704100000000	47	041	DeKalb County, TN	2001	NA	8491	8046	445	5.2
CN4704300000000	47	043	Dickson County, TN	2001	NA	22233	21269	964	4.3
CN4704500000000	47	045	Dyer County, TN	2001	NA	17602	16459	1143	6.5
CN4704700000000	47	047	Fayette County, TN	2001	NA	14575	13797	778	5.3
CN4704900000000	47	049	Fentress County, TN	2001	NA	6738	6159	579	8.6
CN4705100000000	47	051	Franklin County, TN	2001	NA	19185	18402	783	4.1
CN4705300000000	47	053	Gibson County, TN	2001	NA	22616	20900	1716	7.6
CN4705500000000	47	055	Giles County, TN	2001	NA	14827	13924	903	6.1
CN4705700000000	47	057	Grainger County, TN	2001	NA	9756	9193	563	5.8
CN4705900000000	47	059	Greene County, TN	2001	NA	30879	28592	2287	7.4
CN4706100000000	47	061	Grundy County, TN	2001	NA	5545	5234	311	5.6
CN4706300000000	47	063	Hamblen County, TN	2001	NA	29913	28170	1743	5.8
CN4706500000000	47	065	Hamilton County, TN	2001	NA	158891	153238	5653	3.6
CN4706700000000	47	067	Hancock County, TN	2001	NA	2554	2376	178	7
CN4706900000000	47	069	Hardeman County, TN	2001	NA	11004	10240	764	6.9
CN4707100000000	47	071	Hardin County, TN	2001	NA	11470	10756	714	6.2
CN4707300000000	47	073	Hawkins County, TN	2001	NA	25102	23809	1293	5.2
CN4707500000000	47	075	Haywood County, TN	2001	NA	9360	8689	671	7.2
CN4707700000000	47	077	Henderson County, TN	2001	NA	12552	11707	845	6.7
CN4707900000000	47	079	Henry County, TN	2001	NA	14673	13794	879	6
CN4708100000000	47	081	Hickman County, TN	2001	NA	9878	9383	495	5
CN4708300000000	47	083	Houston County, TN	2001	NA	3625	3371	254	7
CN4708500000000	47	085	Humphreys County, TN	2001	NA	8759	8205	554	6.3
CN4708700000000	47	087	Jackson County, TN	2001	NA	5022	4734	288	5.7
CN4708900000000	47	089	Jefferson County, TN	2001	NA	22529	21351	1178	5.2
CN4709100000000	47	091	Johnson County, TN	2001	NA	6772	6249	523	7.7
CN4709300000000	47	093	Knox County, TN	2001	NA	205825	199138	6687	3.2
CN4709500000000	47	095	Lake County, TN	2001	NA	2577	2410	167	6.5
CN4709700000000	47	097	Lauderdale County, TN	2001	NA	11013	10158	855	7.8
CN4709900000000	47	099	Lawrence County, TN	2001	NA	18624	16921	1703	9.1
CN4710100000000	47	101	Lewis County, TN	2001	NA	5283	4936	347	6.6
CN4710300000000	47	103	Lincoln County, TN	2001	NA	15874	15190	684	4.3
CN4710500000000	47	105	Loudon County, TN	2001	NA	20179	19345	834	4.1
CN4710700000000	47	107	McMinn County, TN	2001	NA	23354	21785	1569	6.7
CN4710900000000	47	109	McNairy County, TN	2001	NA	11978	11288	690	5.8
CN4711100000000	47	111	Macon County, TN	2001	NA	10468	9885	583	5.6
CN4711300000000	47	113	Madison County, TN	2001	NA	46010	43732	2278	5
CN4711500000000	47	115	Marion County, TN	2001	NA	13042	12371	671	5.1
CN4711700000000	47	117	Marshall County, TN	2001	NA	13850	13135	715	5.2
CN4711900000000	47	119	Maury County, TN	2001	NA	36622	35124	1498	4.1
CN4712100000000	47	121	Meigs County, TN	2001	NA	4820	4504	316	6.6
CN4712300000000	47	123	Monroe County, TN	2001	NA	17386	16158	1228	7.1
CN4712500000000	47	125	Montgomery County, TN	2001	NA	59924	57312	2612	4.4
CN4712700000000	47	127	Moore County, TN	2001	NA	2998	2890	108	3.6
CN4712900000000	47	129	Morgan County, TN	2001	NA	7733	7265	468	6.1
CN4713100000000	47	131	Obion County, TN	2001	NA	16558	15809	749	4.5
CN4713300000000	47	133	Overton County, TN	2001	NA	9545	8960	585	6.1
CN4713500000000	47	135	Perry County, TN	2001	NA	3360	3126	234	7
CN4713700000000	47	137	Pickett County, TN	2001	NA	2143	1955	188	8.8
CN4713900000000	47	139	Polk County, TN	2001	NA	7396	7042	354	4.8
CN4714100000000	47	141	Putnam County, TN	2001	NA	31679	30219	1460	4.6
CN4714300000000	47	143	Rhea County, TN	2001	NA	12840	12134	706	5.5
CN4714500000000	47	145	Roane County, TN	2001	NA	24969	23820	1149	4.6
CN4714700000000	47	147	Robertson County, TN	2001	NA	30035	28775	1260	4.2
CN4714900000000	47	149	Rutherford County, TN	2001	NA	105142	101305	3837	3.6
CN4715100000000	47	151	Scott County, TN	2001	NA	8793	8203	590	6.7
CN4715300000000	47	153	Sequatchie County, TN	2001	NA	5394	5138	256	4.7
CN4715500000000	47	155	Sevier County, TN	2001	NA	40086	37930	2156	5.4
CN4715700000000	47	157	Shelby County, TN	2001	NA	438554	419566	18988	4.3
CN4715900000000	47	159	Smith County, TN	2001	NA	8904	8477	427	4.8
CN4716100000000	47	161	Stewart County, TN	2001	NA	5601	5302	299	5.3
CN4716300000000	47	163	Sullivan County, TN	2001	NA	73259	70200	3059	4.2
CN4716500000000	47	165	Sumner County, TN	2001	NA	71773	68584	3189	4.4
CN4716700000000	47	167	Tipton County, TN	2001	NA	25778	24600	1178	4.6
CN4716900000000	47	169	Trousdale County, TN	2001	NA	3600	3403	197	5.5
CN4717100000000	47	171	Unicoi County, TN	2001	NA	8157	7671	486	6
CN4717300000000	47	173	Union County, TN	2001	NA	8402	8049	353	4.2
CN4717500000000	47	175	Van Buren County, TN	2001	NA	2613	2451	162	6.2
CN4717700000000	47	177	Warren County, TN	2001	NA	18798	17576	1222	6.5
CN4717900000000	47	179	Washington County, TN	2001	NA	55303	52698	2605	4.7
CN4718100000000	47	181	Wayne County, TN	2001	NA	6729	6119	610	9.1
CN4718300000000	47	183	Weakley County, TN	2001	NA	17073	16086	987	5.8
CN4718500000000	47	185	White County, TN	2001	NA	10587	9971	616	5.8
CN4718700000000	47	187	Williamson County, TN	2001	NA	71564	69569	1995	2.8
CN4718900000000	47	189	Wilson County, TN	2001	NA	50511	48655	1856	3.7
CN4800100000000	48	001	Anderson County, TX	2001	NA	19894	18712	1182	5.9
CN4800300000000	48	003	Andrews County, TX	2001	NA	5674	5435	239	4.2
CN4800500000000	48	005	Angelina County, TX	2001	NA	38566	36476	2090	5.4
CN4800700000000	48	007	Aransas County, TX	2001	NA	9893	9261	632	6.4
CN4800900000000	48	009	Archer County, TX	2001	NA	5011	4850	161	3.2
CN4801100000000	48	011	Armstrong County, TX	2001	NA	1085	1049	36	3.3
CN4801300000000	48	013	Atascosa County, TX	2001	NA	17721	16907	814	4.6
CN4801500000000	48	015	Austin County, TX	2001	NA	12186	11707	479	3.9
CN4801700000000	48	017	Bailey County, TX	2001	NA	3317	3161	156	4.7
CN4801900000000	48	019	Bandera County, TX	2001	NA	8928	8572	356	4
CN4802100000000	48	021	Bastrop County, TX	2001	NA	30526	29122	1404	4.6
CN4802300000000	48	023	Baylor County, TX	2001	NA	1854	1764	90	4.9
CN4802500000000	48	025	Bee County, TX	2001	NA	11351	10670	681	6
CN4802700000000	48	027	Bell County, TX	2001	NA	102961	97989	4972	4.8
CN4802900000000	48	029	Bexar County, TX	2001	NA	670948	640055	30893	4.6
CN4803100000000	48	031	Blanco County, TX	2001	NA	4417	4253	164	3.7
CN4803300000000	48	033	Borden County, TX	2001	NA	441	427	14	3.2
CN4803500000000	48	035	Bosque County, TX	2001	NA	8036	7638	398	5
CN4803700000000	48	037	Bowie County, TX	2001	NA	40535	38481	2054	5.1
CN4803900000000	48	039	Brazoria County, TX	2001	NA	122355	116255	6100	5
CN4804100000000	48	041	Brazos County, TX	2001	NA	79882	76866	3016	3.8
CN4804300000000	48	043	Brewster County, TX	2001	NA	4721	4531	190	4
CN4804500000000	48	045	Briscoe County, TX	2001	NA	867	832	35	4
CN4804700000000	48	047	Brooks County, TX	2001	NA	3111	2927	184	5.9
CN4804900000000	48	049	Brown County, TX	2001	NA	17869	17030	839	4.7
CN4805100000000	48	051	Burleson County, TX	2001	NA	7936	7627	309	3.9
CN4805300000000	48	053	Burnet County, TX	2001	NA	17960	17206	754	4.2
CN4805500000000	48	055	Caldwell County, TX	2001	NA	15271	14515	756	5
CN4805700000000	48	057	Calhoun County, TX	2001	NA	9454	8803	651	6.9
CN4805900000000	48	059	Callahan County, TX	2001	NA	6233	5965	268	4.3
CN4806100000000	48	061	Cameron County, TX	2001	NA	130981	120785	10196	7.8
CN4806300000000	48	063	Camp County, TX	2001	NA	5288	5002	286	5.4
CN4806500000000	48	065	Carson County, TX	2001	NA	3294	3178	116	3.5
CN4806700000000	48	067	Cass County, TX	2001	NA	13448	12581	867	6.4
CN4806900000000	48	069	Castro County, TX	2001	NA	3894	3737	157	4
CN4807100000000	48	071	Chambers County, TX	2001	NA	13296	12703	593	4.5
CN4807300000000	48	073	Cherokee County, TX	2001	NA	20766	19723	1043	5
CN4807500000000	48	075	Childress County, TX	2001	NA	3076	2926	150	4.9
CN4807700000000	48	077	Clay County, TX	2001	NA	6137	5930	207	3.4
CN4807900000000	48	079	Cochran County, TX	2001	NA	1604	1515	89	5.5
CN4808100000000	48	081	Coke County, TX	2001	NA	1626	1553	73	4.5
CN4808300000000	48	083	Coleman County, TX	2001	NA	4168	3962	206	4.9
CN4808500000000	48	085	Collin County, TX	2001	NA	318349	305193	13156	4.1
CN4808700000000	48	087	Collingsworth County, TX	2001	NA	1641	1580	61	3.7
CN4808900000000	48	089	Colorado County, TX	2001	NA	9870	9451	419	4.2
CN4809100000000	48	091	Comal County, TX	2001	NA	42014	40218	1796	4.3
CN4809300000000	48	093	Comanche County, TX	2001	NA	6794	6519	275	4
CN4809500000000	48	095	Concho County, TX	2001	NA	1449	1375	74	5.1
CN4809700000000	48	097	Cooke County, TX	2001	NA	18938	18035	903	4.8
CN4809900000000	48	099	Coryell County, TX	2001	NA	23935	22509	1426	6
CN4810100000000	48	101	Cottle County, TX	2001	NA	961	915	46	4.8
CN4810300000000	48	103	Crane County, TX	2001	NA	1484	1411	73	4.9
CN4810500000000	48	105	Crockett County, TX	2001	NA	2040	1969	71	3.5
CN4810700000000	48	107	Crosby County, TX	2001	NA	2986	2839	147	4.9
CN4810900000000	48	109	Culberson County, TX	2001	NA	1547	1474	73	4.7
CN4811100000000	48	111	Dallam County, TX	2001	NA	3309	3207	102	3.1
CN4811300000000	48	113	Dallas County, TX	2001	NA	1192682	1129816	62866	5.3
CN4811500000000	48	115	Dawson County, TX	2001	NA	5973	5656	317	5.3
CN4811700000000	48	117	Deaf Smith County, TX	2001	NA	8230	7856	374	4.5
CN4811900000000	48	119	Delta County, TX	2001	NA	2510	2376	134	5.3
CN4812100000000	48	121	Denton County, TX	2001	NA	277221	267519	9702	3.5
CN4812300000000	48	123	DeWitt County, TX	2001	NA	9251	8836	415	4.5
CN4812500000000	48	125	Dickens County, TX	2001	NA	1101	1047	54	4.9
CN4812700000000	48	127	Dimmit County, TX	2001	NA	3875	3577	298	7.7
CN4812900000000	48	129	Donley County, TX	2001	NA	1880	1799	81	4.3
CN4813100000000	48	131	Duval County, TX	2001	NA	5222	4889	333	6.4
CN4813300000000	48	133	Eastland County, TX	2001	NA	8698	8274	424	4.9
CN4813500000000	48	135	Ector County, TX	2001	NA	57617	54808	2809	4.9
CN4813700000000	48	137	Edwards County, TX	2001	NA	1040	993	47	4.5
CN4813900000000	48	139	Ellis County, TX	2001	NA	60906	58260	2646	4.3
CN4814100000000	48	141	El Paso County, TX	2001	NA	275336	255436	19900	7.2
CN4814300000000	48	143	Erath County, TX	2001	NA	16944	16298	646	3.8
CN4814500000000	48	145	Falls County, TX	2001	NA	7232	6834	398	5.5
CN4814700000000	48	147	Fannin County, TX	2001	NA	13881	12980	901	6.5
CN4814900000000	48	149	Fayette County, TX	2001	NA	11821	11399	422	3.6
CN4815100000000	48	151	Fisher County, TX	2001	NA	2180	2095	85	3.9
CN4815300000000	48	153	Floyd County, TX	2001	NA	3478	3285	193	5.5
CN4815500000000	48	155	Foard County, TX	2001	NA	783	753	30	3.8
CN4815700000000	48	157	Fort Bend County, TX	2001	NA	194220	186708	7512	3.9
CN4815900000000	48	159	Franklin County, TX	2001	NA	4624	4432	192	4.2
CN4816100000000	48	161	Freestone County, TX	2001	NA	8822	8431	391	4.4
CN4816300000000	48	163	Frio County, TX	2001	NA	6230	5826	404	6.5
CN4816500000000	48	165	Gaines County, TX	2001	NA	6312	6028	284	4.5
CN4816700000000	48	167	Galveston County, TX	2001	NA	129811	123099	6712	5.2
CN4816900000000	48	169	Garza County, TX	2001	NA	2329	2242	87	3.7
CN4817100000000	48	171	Gillespie County, TX	2001	NA	10843	10470	373	3.4
CN4817300000000	48	173	Glasscock County, TX	2001	NA	741	719	22	3
CN4817500000000	48	175	Goliad County, TX	2001	NA	3323	3184	139	4.2
CN4817700000000	48	177	Gonzales County, TX	2001	NA	9241	8905	336	3.6
CN4817900000000	48	179	Gray County, TX	2001	NA	10144	9699	445	4.4
CN4818100000000	48	181	Grayson County, TX	2001	NA	55945	52997	2948	5.3
CN4818300000000	48	183	Gregg County, TX	2001	NA	55929	52887	3042	5.4
CN4818500000000	48	185	Grimes County, TX	2001	NA	9951	9403	548	5.5
CN4818700000000	48	187	Guadalupe County, TX	2001	NA	46480	44700	1780	3.8
CN4818900000000	48	189	Hale County, TX	2001	NA	17137	16346	791	4.6
CN4819100000000	48	191	Hall County, TX	2001	NA	1740	1647	93	5.3
CN4819300000000	48	193	Hamilton County, TX	2001	NA	4212	4053	159	3.8
CN4819500000000	48	195	Hansford County, TX	2001	NA	2875	2791	84	2.9
CN4819700000000	48	197	Hardeman County, TX	2001	NA	2441	2348	93	3.8
CN4819900000000	48	199	Hardin County, TX	2001	NA	23338	21902	1436	6.2
CN4820100000000	48	201	Harris County, TX	2001	NA	1751413	1669710	81703	4.7
CN4820300000000	48	203	Harrison County, TX	2001	NA	29189	27607	1582	5.4
CN4820500000000	48	205	Hartley County, TX	2001	NA	2453	2375	78	3.2
CN4820700000000	48	207	Haskell County, TX	2001	NA	3118	2995	123	3.9
CN4820900000000	48	209	Hays County, TX	2001	NA	57959	55698	2261	3.9
CN4821100000000	48	211	Hemphill County, TX	2001	NA	1975	1922	53	2.7
CN4821300000000	48	213	Henderson County, TX	2001	NA	33153	31628	1525	4.6
CN4821500000000	48	215	Hidalgo County, TX	2001	NA	219181	198257	20924	9.5
CN4821700000000	48	217	Hill County, TX	2001	NA	15301	14439	862	5.6
CN4821900000000	48	219	Hockley County, TX	2001	NA	11307	10866	441	3.9
CN4822100000000	48	221	Hood County, TX	2001	NA	20591	19648	943	4.6
CN4822300000000	48	223	Hopkins County, TX	2001	NA	16256	15527	729	4.5
CN4822500000000	48	225	Houston County, TX	2001	NA	9546	9045	501	5.2
CN4822700000000	48	227	Howard County, TX	2001	NA	13983	13288	695	5
CN4822900000000	48	229	Hudspeth County, TX	2001	NA	1312	1242	70	5.3
CN4823100000000	48	231	Hunt County, TX	2001	NA	38670	36790	1880	4.9
CN4823300000000	48	233	Hutchinson County, TX	2001	NA	11130	10657	473	4.2
CN4823500000000	48	235	Irion County, TX	2001	NA	931	901	30	3.2
CN4823700000000	48	237	Jack County, TX	2001	NA	3789	3626	163	4.3
CN4823900000000	48	239	Jackson County, TX	2001	NA	6867	6562	305	4.4
CN4824100000000	48	241	Jasper County, TX	2001	NA	15540	14217	1323	8.5
CN4824300000000	48	243	Jeff Davis County, TX	2001	NA	1202	1157	45	3.7
CN4824500000000	48	245	Jefferson County, TX	2001	NA	111449	103562	7887	7.1
CN4824700000000	48	247	Jim Hogg County, TX	2001	NA	2205	2100	105	4.8
CN4824900000000	48	249	Jim Wells County, TX	2001	NA	17453	16487	966	5.5
CN4825100000000	48	251	Johnson County, TX	2001	NA	67485	64536	2949	4.4
CN4825300000000	48	253	Jones County, TX	2001	NA	7555	7167	388	5.1
CN4825500000000	48	255	Karnes County, TX	2001	NA	5388	5089	299	5.5
CN4825700000000	48	257	Kaufman County, TX	2001	NA	38728	36767	1961	5.1
CN4825900000000	48	259	Kendall County, TX	2001	NA	12407	11933	474	3.8
CN4826100000000	48	261	Kenedy County, TX	2001	NA	208	201	7	3.4
CN4826300000000	48	263	Kent County, TX	2001	NA	441	427	14	3.2
CN4826500000000	48	265	Kerr County, TX	2001	NA	19487	18658	829	4.3
CN4826700000000	48	267	Kimble County, TX	2001	NA	2290	2216	74	3.2
CN4826900000000	48	269	King County, TX	2001	NA	239	232	7	2.9
CN4827100000000	48	271	Kinney County, TX	2001	NA	1257	1171	86	6.8
CN4827300000000	48	273	Kleberg County, TX	2001	NA	14061	13357	704	5
CN4827500000000	48	275	Knox County, TX	2001	NA	1857	1778	79	4.3
CN4827700000000	48	277	Lamar County, TX	2001	NA	22877	21454	1423	6.2
CN4827900000000	48	279	Lamb County, TX	2001	NA	7218	6833	385	5.3
CN4828100000000	48	281	Lampasas County, TX	2001	NA	8848	8465	383	4.3
CN4828300000000	48	283	La Salle County, TX	2001	NA	2215	2065	150	6.8
CN4828500000000	48	285	Lavaca County, TX	2001	NA	9406	9093	313	3.3
CN4828700000000	48	287	Lee County, TX	2001	NA	8311	7972	339	4.1
CN4828900000000	48	289	Leon County, TX	2001	NA	7165	6800	365	5.1
CN4829100000000	48	291	Liberty County, TX	2001	NA	30660	28792	1868	6.1
CN4829300000000	48	293	Limestone County, TX	2001	NA	9852	9389	463	4.7
CN4829500000000	48	295	Lipscomb County, TX	2001	NA	1489	1440	49	3.3
CN4829700000000	48	297	Live Oak County, TX	2001	NA	4957	4736	221	4.5
CN4829900000000	48	299	Llano County, TX	2001	NA	7496	7147	349	4.7
CN4830100000000	48	301	Loving County, TX	2001	NA	48	45	3	6.3
CN4830300000000	48	303	Lubbock County, TX	2001	NA	131300	126517	4783	3.6
CN4830500000000	48	305	Lynn County, TX	2001	NA	3039	2892	147	4.8
CN4830700000000	48	307	McCulloch County, TX	2001	NA	3664	3450	214	5.8
CN4830900000000	48	309	McLennan County, TX	2001	NA	103945	99033	4912	4.7
CN4831100000000	48	311	McMullen County, TX	2001	NA	439	422	17	3.9
CN4831300000000	48	313	Madison County, TX	2001	NA	4942	4687	255	5.2
CN4831500000000	48	315	Marion County, TX	2001	NA	4613	4312	301	6.5
CN4831700000000	48	317	Martin County, TX	2001	NA	2185	2097	88	4
CN4831900000000	48	319	Mason County, TX	2001	NA	2105	2044	61	2.9
CN4832100000000	48	321	Matagorda County, TX	2001	NA	17441	16107	1334	7.6
CN4832300000000	48	323	Maverick County, TX	2001	NA	16593	13692	2901	17.5
CN4832500000000	48	325	Medina County, TX	2001	NA	18232	17419	813	4.5
CN4832700000000	48	327	Menard County, TX	2001	NA	1133	1082	51	4.5
CN4832900000000	48	329	Midland County, TX	2001	NA	59805	57566	2239	3.7
CN4833100000000	48	331	Milam County, TX	2001	NA	11771	11244	527	4.5
CN4833300000000	48	333	Mills County, TX	2001	NA	2462	2374	88	3.6
CN4833500000000	48	335	Mitchell County, TX	2001	NA	3449	3252	197	5.7
CN4833700000000	48	337	Montague County, TX	2001	NA	9014	8598	416	4.6
CN4833900000000	48	339	Montgomery County, TX	2001	NA	160068	153806	6262	3.9
CN4834100000000	48	341	Moore County, TX	2001	NA	10066	9732	334	3.3
CN4834300000000	48	343	Morris County, TX	2001	NA	5924	5517	407	6.9
CN4834500000000	48	345	Motley County, TX	2001	NA	678	654	24	3.5
CN4834700000000	48	347	Nacogdoches County, TX	2001	NA	29717	28331	1386	4.7
CN4834900000000	48	349	Navarro County, TX	2001	NA	21163	20018	1145	5.4
CN4835100000000	48	351	Newton County, TX	2001	NA	5956	5369	587	9.9
CN4835300000000	48	353	Nolan County, TX	2001	NA	7218	6852	366	5.1
CN4835500000000	48	355	Nueces County, TX	2001	NA	149202	141346	7856	5.3
CN4835700000000	48	357	Ochiltree County, TX	2001	NA	4937	4786	151	3.1
CN4835900000000	48	359	Oldham County, TX	2001	NA	1169	1133	36	3.1
CN4836100000000	48	361	Orange County, TX	2001	NA	40471	37268	3203	7.9
CN4836300000000	48	363	Palo Pinto County, TX	2001	NA	13288	12669	619	4.7
CN4836500000000	48	365	Panola County, TX	2001	NA	10638	10054	584	5.5
CN4836700000000	48	367	Parker County, TX	2001	NA	46847	45022	1825	3.9
CN4836900000000	48	369	Parmer County, TX	2001	NA	4603	4435	168	3.6
CN4837100000000	48	371	Pecos County, TX	2001	NA	7009	6655	354	5.1
CN4837300000000	48	373	Polk County, TX	2001	NA	16002	15012	990	6.2
CN4837500000000	48	375	Potter County, TX	2001	NA	53010	50164	2846	5.4
CN4837700000000	48	377	Presidio County, TX	2001	NA	3300	2794	506	15.3
CN4837900000000	48	379	Rains County, TX	2001	NA	4463	4240	223	5
CN4838100000000	48	381	Randall County, TX	2001	NA	60421	58878	1543	2.6
CN4838300000000	48	383	Reagan County, TX	2001	NA	1665	1610	55	3.3
CN4838500000000	48	385	Real County, TX	2001	NA	1309	1236	73	5.6
CN4838700000000	48	387	Red River County, TX	2001	NA	6693	6146	547	8.2
CN4838900000000	48	389	Reeves County, TX	2001	NA	4987	4624	363	7.3
CN4839100000000	48	391	Refugio County, TX	2001	NA	3638	3473	165	4.5
CN4839300000000	48	393	Roberts County, TX	2001	NA	521	508	13	2.5
CN4839500000000	48	395	Robertson County, TX	2001	NA	7106	6760	346	4.9
CN4839700000000	48	397	Rockwall County, TX	2001	NA	25767	24724	1043	4
CN4839900000000	48	399	Runnels County, TX	2001	NA	5205	4971	234	4.5
CN4840100000000	48	401	Rusk County, TX	2001	NA	21317	20226	1091	5.1
CN4840300000000	48	403	Sabine County, TX	2001	NA	3749	3362	387	10.3
CN4840500000000	48	405	San Augustine County, TX	2001	NA	3787	3574	213	5.6
CN4840700000000	48	407	San Jacinto County, TX	2001	NA	9529	9054	475	5
CN4840900000000	48	409	San Patricio County, TX	2001	NA	27709	26062	1647	5.9
CN4841100000000	48	411	San Saba County, TX	2001	NA	2869	2744	125	4.4
CN4841300000000	48	413	Schleicher County, TX	2001	NA	1575	1525	50	3.2
CN4841500000000	48	415	Scurry County, TX	2001	NA	7233	6854	379	5.2
CN4841700000000	48	417	Shackelford County, TX	2001	NA	1737	1682	55	3.2
CN4841900000000	48	419	Shelby County, TX	2001	NA	11735	11097	638	5.4
CN4842100000000	48	421	Sherman County, TX	2001	NA	1687	1640	47	2.8
CN4842300000000	48	423	Smith County, TX	2001	NA	87341	83085	4256	4.9
CN4842500000000	48	425	Somervell County, TX	2001	NA	3453	3300	153	4.4
CN4842700000000	48	427	Starr County, TX	2001	NA	18614	15684	2930	15.7
CN4842900000000	48	429	Stephens County, TX	2001	NA	4337	4158	179	4.1
CN4843100000000	48	431	Sterling County, TX	2001	NA	760	733	27	3.6
CN4843300000000	48	433	Stonewall County, TX	2001	NA	854	817	37	4.3
CN4843500000000	48	435	Sutton County, TX	2001	NA	2264	2189	75	3.3
CN4843700000000	48	437	Swisher County, TX	2001	NA	3907	3743	164	4.2
CN4843900000000	48	439	Tarrant County, TX	2001	NA	802338	767054	35284	4.4
CN4844100000000	48	441	Taylor County, TX	2001	NA	61582	58886	2696	4.4
CN4844300000000	48	443	Terrell County, TX	2001	NA	495	470	25	5.1
CN4844500000000	48	445	Terry County, TX	2001	NA	5775	5467	308	5.3
CN4844700000000	48	447	Throckmorton County, TX	2001	NA	989	958	31	3.1
CN4844900000000	48	449	Titus County, TX	2001	NA	13366	12768	598	4.5
CN4845100000000	48	451	Tom Green County, TX	2001	NA	51330	49351	1979	3.9
CN4845300000000	48	453	Travis County, TX	2001	NA	493452	471949	21503	4.4
CN4845500000000	48	455	Trinity County, TX	2001	NA	5637	5308	329	5.8
CN4845700000000	48	457	Tyler County, TX	2001	NA	8113	7526	587	7.2
CN4845900000000	48	459	Upshur County, TX	2001	NA	16807	15936	871	5.2
CN4846100000000	48	461	Upton County, TX	2001	NA	1569	1504	65	4.1
CN4846300000000	48	463	Uvalde County, TX	2001	NA	11357	10626	731	6.4
CN4846500000000	48	465	Val Verde County, TX	2001	NA	17712	16608	1104	6.2
CN4846700000000	48	467	Van Zandt County, TX	2001	NA	23118	22078	1040	4.5
CN4846900000000	48	469	Victoria County, TX	2001	NA	43189	41359	1830	4.2
CN4847100000000	48	471	Walker County, TX	2001	NA	25037	23721	1316	5.3
CN4847300000000	48	473	Waller County, TX	2001	NA	15428	14741	687	4.5
CN4847500000000	48	475	Ward County, TX	2001	NA	4469	4218	251	5.6
CN4847700000000	48	477	Washington County, TX	2001	NA	15178	14626	552	3.6
CN4847900000000	48	479	Webb County, TX	2001	NA	73104	68340	4764	6.5
CN4848100000000	48	481	Wharton County, TX	2001	NA	20379	19444	935	4.6
CN4848300000000	48	483	Wheeler County, TX	2001	NA	2725	2621	104	3.8
CN4848500000000	48	485	Wichita County, TX	2001	NA	62011	59231	2780	4.5
CN4848700000000	48	487	Wilbarger County, TX	2001	NA	7334	7062	272	3.7
CN4848900000000	48	489	Willacy County, TX	2001	NA	7230	6443	787	10.9
CN4849100000000	48	491	Williamson County, TX	2001	NA	153827	147548	6279	4.1
CN4849300000000	48	493	Wilson County, TX	2001	NA	15863	15196	667	4.2
CN4849500000000	48	495	Winkler County, TX	2001	NA	2942	2779	163	5.5
CN4849700000000	48	497	Wise County, TX	2001	NA	25871	24820	1051	4.1
CN4849900000000	48	499	Wood County, TX	2001	NA	16380	15481	899	5.5
CN4850100000000	48	501	Yoakum County, TX	2001	NA	3503	3353	150	4.3
CN4850300000000	48	503	Young County, TX	2001	NA	8750	8320	430	4.9
CN4850500000000	48	505	Zapata County, TX	2001	NA	4152	3852	300	7.2
CN4850700000000	48	507	Zavala County, TX	2001	NA	3746	3251	495	13.2
CN4900100000000	49	001	Beaver County, UT	2001	NA	2976	2861	115	3.9
CN4900300000000	49	003	Box Elder County, UT	2001	NA	20494	19549	945	4.6
CN4900500000000	49	005	Cache County, UT	2001	NA	50088	48361	1727	3.4
CN4900700000000	49	007	Carbon County, UT	2001	NA	9080	8498	582	6.4
CN4900900000000	49	009	Daggett County, UT	2001	NA	472	449	23	4.9
CN4901100000000	49	011	Davis County, UT	2001	NA	121979	117006	4973	4.1
CN4901300000000	49	013	Duchesne County, UT	2001	NA	6768	6412	356	5.3
CN4901500000000	49	015	Emery County, UT	2001	NA	4764	4445	319	6.7
CN4901700000000	49	017	Garfield County, UT	2001	NA	2577	2372	205	8
CN4901900000000	49	019	Grand County, UT	2001	NA	4729	4401	328	6.9
CN4902100000000	49	021	Iron County, UT	2001	NA	17247	16466	781	4.5
CN4902300000000	49	023	Juab County, UT	2001	NA	3775	3590	185	4.9
CN4902500000000	49	025	Kane County, UT	2001	NA	3169	3033	136	4.3
CN4902700000000	49	027	Millard County, UT	2001	NA	5650	5418	232	4.1
CN4902900000000	49	029	Morgan County, UT	2001	NA	3464	3329	135	3.9
CN4903100000000	49	031	Piute County, UT	2001	NA	773	728	45	5.8
CN4903300000000	49	033	Rich County, UT	2001	NA	1174	1136	38	3.2
CN4903500000000	49	035	Salt Lake County, UT	2001	NA	492535	470934	21601	4.4
CN4903700000000	49	037	San Juan County, UT	2001	NA	4579	4195	384	8.4
CN4903900000000	49	039	Sanpete County, UT	2001	NA	10068	9528	540	5.4
CN4904100000000	49	041	Sevier County, UT	2001	NA	8576	8180	396	4.6
CN4904300000000	49	043	Summit County, UT	2001	NA	18879	18001	878	4.7
CN4904500000000	49	045	Tooele County, UT	2001	NA	21395	20371	1024	4.8
CN4904700000000	49	047	Uintah County, UT	2001	NA	12212	11667	545	4.5
CN4904900000000	49	049	Utah County, UT	2001	NA	183457	175924	7533	4.1
CN4905100000000	49	051	Wasatch County, UT	2001	NA	7909	7550	359	4.5
CN4905300000000	49	053	Washington County, UT	2001	NA	42021	40287	1734	4.1
CN4905500000000	49	055	Wayne County, UT	2001	NA	1442	1369	73	5.1
CN4905700000000	49	057	Weber County, UT	2001	NA	101828	96548	5280	5.2
CN5000100000000	50	001	Addison County, VT	2001	NA	20427	19800	627	3.1
CN5000300000000	50	003	Bennington County, VT	2001	NA	20013	19252	761	3.8
CN5000500000000	50	005	Caledonia County, VT	2001	NA	15633	15014	619	4
CN5000700000000	50	007	Chittenden County, VT	2001	NA	85086	82694	2392	2.8
CN5000900000000	50	009	Essex County, VT	2001	NA	3251	3112	139	4.3
CN5001100000000	50	011	Franklin County, VT	2001	NA	24676	23784	892	3.6
CN5001300000000	50	013	Grand Isle County, VT	2001	NA	3858	3699	159	4.1
CN5001500000000	50	015	Lamoille County, VT	2001	NA	13427	12947	480	3.6
CN5001700000000	50	017	Orange County, VT	2001	NA	15686	15243	443	2.8
CN5001900000000	50	019	Orleans County, VT	2001	NA	13279	12594	685	5.2
CN5002100000000	50	021	Rutland County, VT	2001	NA	33952	32758	1194	3.5
CN5002300000000	50	023	Washington County, VT	2001	NA	32640	31547	1093	3.3
CN5002500000000	50	025	Windham County, VT	2001	NA	24073	23301	772	3.2
CN5002700000000	50	027	Windsor County, VT	2001	NA	31052	30141	911	2.9
CN5100100000000	51	001	Accomack County, VA	2001	NA	18346	17726	620	3.4
CN5100300000000	51	003	Albemarle County, VA	2001	NA	44165	43207	958	2.2
CN5100500000000	51	005	Alleghany County, VA	2001	NA	7796	7469	327	4.2
CN5100700000000	51	007	Amelia County, VA	2001	NA	5920	5769	151	2.6
CN5100900000000	51	009	Amherst County, VA	2001	NA	15178	14623	555	3.7
CN5101100000000	51	011	Appomattox County, VA	2001	NA	6730	6438	292	4.3
CN5101300000000	51	013	Arlington County, VA	2001	NA	119188	116308	2880	2.4
CN5101500000000	51	015	Augusta County, VA	2001	NA	35182	34201	981	2.8
CN5101700000000	51	017	Bath County, VA	2001	NA	2716	2614	102	3.8
CN5101900000000	51	019	Bedford County, VA	2001	NA	34296	33157	1139	3.3
CN5102100000000	51	021	Bland County, VA	2001	NA	3048	2875	173	5.7
CN5102300000000	51	023	Botetourt County, VA	2001	NA	16684	16238	446	2.7
CN5102500000000	51	025	Brunswick County, VA	2001	NA	6859	6486	373	5.4
CN5102700000000	51	027	Buchanan County, VA	2001	NA	8881	8344	537	6
CN5102900000000	51	029	Buckingham County, VA	2001	NA	6204	5990	214	3.4
CN5103100000000	51	031	Campbell County, VA	2001	NA	26134	25019	1115	4.3
CN5103300000000	51	033	Caroline County, VA	2001	NA	11072	10735	337	3
CN5103500000000	51	035	Carroll County, VA	2001	NA	14830	13803	1027	6.9
CN5103600000000	51	036	Charles City County, VA	2001	NA	3698	3517	181	4.9
CN5103700000000	51	037	Charlotte County, VA	2001	NA	5480	5243	237	4.3
CN5104100000000	51	041	Chesterfield County, VA	2001	NA	144983	141222	3761	2.6
CN5104300000000	51	043	Clarke County, VA	2001	NA	7068	6910	158	2.2
CN5104500000000	51	045	Craig County, VA	2001	NA	2505	2432	73	2.9
CN5104700000000	51	047	Culpeper County, VA	2001	NA	17352	16898	454	2.6
CN5104900000000	51	049	Cumberland County, VA	2001	NA	4214	4096	118	2.8
CN5105100000000	51	051	Dickenson County, VA	2001	NA	5491	5104	387	7
CN5105300000000	51	053	Dinwiddie County, VA	2001	NA	11981	11618	363	3
CN5105700000000	51	057	Essex County, VA	2001	NA	5258	5087	171	3.3
CN5105900000000	51	059	Fairfax County, VA	2001	NA	556089	541978	14111	2.5
CN5106100000000	51	061	Fauquier County, VA	2001	NA	31078	30409	669	2.2
CN5106300000000	51	063	Floyd County, VA	2001	NA	6855	6560	295	4.3
CN5106500000000	51	065	Fluvanna County, VA	2001	NA	10639	10374	265	2.5
CN5106700000000	51	067	Franklin County, VA	2001	NA	24933	23925	1008	4
CN5106900000000	51	069	Frederick County, VA	2001	NA	33608	32664	944	2.8
CN5107100000000	51	071	Giles County, VA	2001	NA	7916	7465	451	5.7
CN5107300000000	51	073	Gloucester County, VA	2001	NA	18121	17675	446	2.5
CN5107500000000	51	075	Goochland County, VA	2001	NA	9128	8899	229	2.5
CN5107700000000	51	077	Grayson County, VA	2001	NA	7940	7336	604	7.6
CN5107900000000	51	079	Greene County, VA	2001	NA	8618	8420	198	2.3
CN5108100000000	51	081	Greensville County, VA	2001	NA	4097	3907	190	4.6
CN5108300000000	51	083	Halifax County, VA	2001	NA	16725	15500	1225	7.3
CN5108500000000	51	085	Hanover County, VA	2001	NA	48679	47455	1224	2.5
CN5108700000000	51	087	Henrico County, VA	2001	NA	147695	143342	4353	2.9
CN5108900000000	51	089	Henry County, VA	2001	NA	28546	26848	1698	5.9
CN5109100000000	51	091	Highland County, VA	2001	NA	1137	1101	36	3.2
CN5109300000000	51	093	Isle of Wight County, VA	2001	NA	15397	14985	412	2.7
CN5109500000000	51	095	James City County, VA	2001	NA	24268	23651	617	2.5
CN5109700000000	51	097	King and Queen County, VA	2001	NA	3156	3052	104	3.3
CN5109900000000	51	099	King George County, VA	2001	NA	8722	8508	214	2.5
CN5110100000000	51	101	King William County, VA	2001	NA	7214	7002	212	2.9
CN5110300000000	51	103	Lancaster County, VA	2001	NA	4938	4633	305	6.2
CN5110500000000	51	105	Lee County, VA	2001	NA	9056	8605	451	5
CN5110700000000	51	107	Loudoun County, VA	2001	NA	109398	106665	2733	2.5
CN5110900000000	51	109	Louisa County, VA	2001	NA	13180	12769	411	3.1
CN5111100000000	51	111	Lunenburg County, VA	2001	NA	5399	5155	244	4.5
CN5111300000000	51	113	Madison County, VA	2001	NA	6791	6640	151	2.2
CN5111500000000	51	115	Mathews County, VA	2001	NA	4356	4226	130	3
CN5111700000000	51	117	Mecklenburg County, VA	2001	NA	14174	13344	830	5.9
CN5111900000000	51	119	Middlesex County, VA	2001	NA	4632	4508	124	2.7
CN5112100000000	51	121	Montgomery County, VA	2001	NA	40953	39594	1359	3.3
CN5112500000000	51	125	Nelson County, VA	2001	NA	7120	6885	235	3.3
CN5112700000000	51	127	New Kent County, VA	2001	NA	7536	7309	227	3
CN5113100000000	51	131	Northampton County, VA	2001	NA	5669	5460	209	3.7
CN5113300000000	51	133	Northumberland County, VA	2001	NA	5501	5222	279	5.1
CN5113500000000	51	135	Nottoway County, VA	2001	NA	6265	6015	250	4
CN5113700000000	51	137	Orange County, VA	2001	NA	12932	12583	349	2.7
CN5113900000000	51	139	Page County, VA	2001	NA	12164	11754	410	3.4
CN5114100000000	51	141	Patrick County, VA	2001	NA	9591	9084	507	5.3
CN5114300000000	51	143	Pittsylvania County, VA	2001	NA	32501	30592	1909	5.9
CN5114500000000	51	145	Powhatan County, VA	2001	NA	11561	11269	292	2.5
CN5114700000000	51	147	Prince Edward County, VA	2001	NA	8232	7885	347	4.2
CN5114900000000	51	149	Prince George County, VA	2001	NA	13593	13117	476	3.5
CN5115300000000	51	153	Prince William County, VA	2001	NA	160696	156730	3966	2.5
CN5115500000000	51	155	Pulaski County, VA	2001	NA	17737	16475	1262	7.1
CN5115700000000	51	157	Rappahannock County, VA	2001	NA	3740	3651	89	2.4
CN5115900000000	51	159	Richmond County, VA	2001	NA	3442	3299	143	4.2
CN5116100000000	51	161	Roanoke County, VA	2001	NA	46496	45353	1143	2.5
CN5116300000000	51	163	Rockbridge County, VA	2001	NA	10881	10560	321	3
CN5116500000000	51	165	Rockingham County, VA	2001	NA	36893	35996	897	2.4
CN5116700000000	51	167	Russell County, VA	2001	NA	11903	11139	764	6.4
CN5116900000000	51	169	Scott County, VA	2001	NA	9767	9314	453	4.6
CN5117100000000	51	171	Shenandoah County, VA	2001	NA	18787	18327	460	2.4
CN5117300000000	51	173	Smyth County, VA	2001	NA	15565	14570	995	6.4
CN5117500000000	51	175	Southampton County, VA	2001	NA	7411	7171	240	3.2
CN5117700000000	51	177	Spotsylvania County, VA	2001	NA	50930	49855	1075	2.1
CN5117900000000	51	179	Stafford County, VA	2001	NA	50738	49613	1125	2.2
CN5118100000000	51	181	Surry County, VA	2001	NA	3457	3342	115	3.3
CN5118300000000	51	183	Sussex County, VA	2001	NA	4471	4259	212	4.7
CN5118500000000	51	185	Tazewell County, VA	2001	NA	19384	18426	958	4.9
CN5118700000000	51	187	Warren County, VA	2001	NA	16800	16328	472	2.8
CN5119100000000	51	191	Washington County, VA	2001	NA	25534	24241	1293	5.1
CN5119300000000	51	193	Westmoreland County, VA	2001	NA	7676	7361	315	4.1
CN5119500000000	51	195	Wise County, VA	2001	NA	16387	15614	773	4.7
CN5119700000000	51	197	Wythe County, VA	2001	NA	14318	13340	978	6.8
CN5119900000000	51	199	York County, VA	2001	NA	27967	27271	696	2.5
CN5151000000000	51	510	Alexandria city, VA	2001	NA	81631	79416	2215	2.7
CN5152000000000	51	520	Bristol city, VA	2001	NA	7585	7268	317	4.2
CN5153000000000	51	530	Buena Vista city, VA	2001	NA	3293	3180	113	3.4
CN5154000000000	51	540	Charlottesville city, VA	2001	NA	19097	18408	689	3.6
CN5155000000000	51	550	Chesapeake city, VA	2001	NA	101138	98156	2982	2.9
CN5157000000000	51	570	Colonial Heights city, VA	2001	NA	8679	8402	277	3.2
CN5158000000000	51	580	Covington city, VA	2001	NA	2980	2837	143	4.8
CN5159000000000	51	590	Danville city, VA	2001	NA	21448	19949	1499	7
CN5159500000000	51	595	Emporia city, VA	2001	NA	2407	2305	102	4.2
CN5160000000000	51	600	Fairfax city, VA	2001	NA	12540	12337	203	1.6
CN5161000000000	51	610	Falls Church city, VA	2001	NA	6221	6053	168	2.7
CN5162000000000	51	620	Franklin city, VA	2001	NA	3549	3393	156	4.4
CN5163000000000	51	630	Fredericksburg city, VA	2001	NA	10578	10200	378	3.6
CN5164000000000	51	640	Galax city, VA	2001	NA	3186	2994	192	6
CN5165000000000	51	650	Hampton city, VA	2001	NA	64976	62699	2277	3.5
CN5166000000000	51	660	Harrisonburg city, VA	2001	NA	19992	19436	556	2.8
CN5167000000000	51	670	Hopewell city, VA	2001	NA	9973	9509	464	4.7
CN5167800000000	51	678	Lexington city, VA	2001	NA	2317	2225	92	4
CN5168000000000	51	680	Lynchburg city, VA	2001	NA	30018	28770	1248	4.2
CN5168300000000	51	683	Manassas city, VA	2001	NA	19644	19022	622	3.2
CN5168500000000	51	685	Manassas Park city, VA	2001	NA	5995	5886	109	1.8
CN5169000000000	51	690	Martinsville city, VA	2001	NA	6617	6098	519	7.8
CN5170000000000	51	700	Newport News city, VA	2001	NA	84162	81164	2998	3.6
CN5171000000000	51	710	Norfolk city, VA	2001	NA	94794	90698	4096	4.3
CN5172000000000	51	720	Norton city, VA	2001	NA	1524	1454	70	4.6
CN5173000000000	51	730	Petersburg city, VA	2001	NA	14018	13242	776	5.5
CN5173500000000	51	735	Poquoson city, VA	2001	NA	5883	5743	140	2.4
CN5174000000000	51	740	Portsmouth city, VA	2001	NA	43530	41611	1919	4.4
CN5175000000000	51	750	Radford city, VA	2001	NA	7439	7130	309	4.2
CN5176000000000	51	760	Richmond city, VA	2001	NA	96231	92218	4013	4.2
CN5177000000000	51	770	Roanoke city, VA	2001	NA	47125	45457	1668	3.5
CN5177500000000	51	775	Salem city, VA	2001	NA	13005	12633	372	2.9
CN5179000000000	51	790	Staunton city, VA	2001	NA	11622	11284	338	2.9
CN5180000000000	51	800	Suffolk city, VA	2001	NA	31024	30055	969	3.1
CN5181000000000	51	810	Virginia Beach city, VA	2001	NA	210475	204339	6136	2.9
CN5182000000000	51	820	Waynesboro city, VA	2001	NA	9352	9005	347	3.7
CN5183000000000	51	830	Williamsburg city, VA	2001	NA	4673	4406	267	5.7
CN5184000000000	51	840	Winchester city, VA	2001	NA	13083	12663	420	3.2
CN5300100000000	53	001	Adams County, WA	2001	NA	8080	7342	738	9.1
CN5300300000000	53	003	Asotin County, WA	2001	NA	9805	9232	573	5.8
CN5300500000000	53	005	Benton County, WA	2001	NA	76504	71859	4645	6.1
CN5300700000000	53	007	Chelan County, WA	2001	NA	34823	31844	2979	8.6
CN5300900000000	53	009	Clallam County, WA	2001	NA	25620	23496	2124	8.3
CN5301100000000	53	011	Clark County, WA	2001	NA	179908	167007	12901	7.2
CN5301300000000	53	013	Columbia County, WA	2001	NA	1684	1521	163	9.7
CN5301500000000	53	015	Cowlitz County, WA	2001	NA	42179	38000	4179	9.9
CN5301700000000	53	017	Douglas County, WA	2001	NA	17211	15885	1326	7.7
CN5301900000000	53	019	Ferry County, WA	2001	NA	2858	2519	339	11.9
CN5302100000000	53	021	Franklin County, WA	2001	NA	23247	21286	1961	8.4
CN5302300000000	53	023	Garfield County, WA	2001	NA	1052	995	57	5.4
CN5302500000000	53	025	Grant County, WA	2001	NA	35186	31874	3312	9.4
CN5302700000000	53	027	Grays Harbor County, WA	2001	NA	28393	25649	2744	9.7
CN5302900000000	53	029	Island County, WA	2001	NA	28729	26886	1843	6.4
CN5303100000000	53	031	Jefferson County, WA	2001	NA	11928	11125	803	6.7
CN5303300000000	53	033	King County, WA	2001	NA	992822	945223	47599	4.8
CN5303500000000	53	035	Kitsap County, WA	2001	NA	104775	98130	6645	6.3
CN5303700000000	53	037	Kittitas County, WA	2001	NA	17044	15853	1191	7
CN5303900000000	53	039	Klickitat County, WA	2001	NA	9177	8092	1085	11.8
CN5304100000000	53	041	Lewis County, WA	2001	NA	28852	26233	2619	9.1
CN5304300000000	53	043	Lincoln County, WA	2001	NA	4519	4243	276	6.1
CN5304500000000	53	045	Mason County, WA	2001	NA	20475	18818	1657	8.1
CN5304700000000	53	047	Okanogan County, WA	2001	NA	18842	16860	1982	10.5
CN5304900000000	53	049	Pacific County, WA	2001	NA	8492	7738	754	8.9
CN5305100000000	53	051	Pend Oreille County, WA	2001	NA	4642	4203	439	9.5
CN5305300000000	53	053	Pierce County, WA	2001	NA	333309	310416	22893	6.9
CN5305500000000	53	055	San Juan County, WA	2001	NA	7424	7046	378	5.1
CN5305700000000	53	057	Skagit County, WA	2001	NA	50935	47105	3830	7.5
CN5305900000000	53	059	Skamania County, WA	2001	NA	4870	4303	567	11.6
CN5306100000000	53	061	Snohomish County, WA	2001	NA	329236	312771	16465	5
CN5306300000000	53	063	Spokane County, WA	2001	NA	209491	194929	14562	7
CN5306500000000	53	065	Stevens County, WA	2001	NA	17115	15461	1654	9.7
CN5306700000000	53	067	Thurston County, WA	2001	NA	106819	100329	6490	6.1
CN5306900000000	53	069	Wahkiakum County, WA	2001	NA	1575	1438	137	8.7
CN5307100000000	53	071	Walla Walla County, WA	2001	NA	27136	25265	1871	6.9
CN5307300000000	53	073	Whatcom County, WA	2001	NA	87105	81122	5983	6.9
CN5307500000000	53	075	Whitman County, WA	2001	NA	18442	17587	855	4.6
CN5307700000000	53	077	Yakima County, WA	2001	NA	109066	98190	10876	10
CN5400100000000	54	001	Barbour County, WV	2001	NA	6755	6314	441	6.5
CN5400300000000	54	003	Berkeley County, WV	2001	NA	40550	39014	1536	3.8
CN5400500000000	54	005	Boone County, WV	2001	NA	9712	9215	497	5.1
CN5400700000000	54	007	Braxton County, WV	2001	NA	5779	5412	367	6.4
CN5400900000000	54	009	Brooke County, WV	2001	NA	11716	11146	570	4.9
CN5401100000000	54	011	Cabell County, WV	2001	NA	44477	42366	2111	4.7
CN5401300000000	54	013	Calhoun County, WV	2001	NA	2884	2593	291	10.1
CN5401500000000	54	015	Clay County, WV	2001	NA	3606	3348	258	7.2
CN5401700000000	54	017	Doddridge County, WV	2001	NA	2928	2770	158	5.4
CN5401900000000	54	019	Fayette County, WV	2001	NA	18459	17330	1129	6.1
CN5402100000000	54	021	Gilmer County, WV	2001	NA	2932	2773	159	5.4
CN5402300000000	54	023	Grant County, WV	2001	NA	5736	5486	250	4.4
CN5402500000000	54	025	Greenbrier County, WV	2001	NA	15149	14276	873	5.8
CN5402700000000	54	027	Hampshire County, WV	2001	NA	9331	8989	342	3.7
CN5402900000000	54	029	Hancock County, WV	2001	NA	15448	14781	667	4.3
CN5403100000000	54	031	Hardy County, WV	2001	NA	6859	6610	249	3.6
CN5403300000000	54	033	Harrison County, WV	2001	NA	31082	29474	1608	5.2
CN5403500000000	54	035	Jackson County, WV	2001	NA	12649	11970	679	5.4
CN5403700000000	54	037	Jefferson County, WV	2001	NA	23304	22556	748	3.2
CN5403900000000	54	039	Kanawha County, WV	2001	NA	96760	92351	4409	4.6
CN5404100000000	54	041	Lewis County, WV	2001	NA	7417	7017	400	5.4
CN5404300000000	54	043	Lincoln County, WV	2001	NA	8156	7618	538	6.6
CN5404500000000	54	045	Logan County, WV	2001	NA	13601	12838	763	5.6
CN5404700000000	54	047	McDowell County, WV	2001	NA	7036	6490	546	7.8
CN5404900000000	54	049	Marion County, WV	2001	NA	26328	25007	1321	5
CN5405100000000	54	051	Marshall County, WV	2001	NA	15846	14922	924	5.8
CN5405300000000	54	053	Mason County, WV	2001	NA	10446	9694	752	7.2
CN5405500000000	54	055	Mercer County, WV	2001	NA	25736	24484	1252	4.9
CN5405700000000	54	057	Mineral County, WV	2001	NA	13010	12315	695	5.3
CN5405900000000	54	059	Mingo County, WV	2001	NA	9013	8443	570	6.3
CN5406100000000	54	061	Monongalia County, WV	2001	NA	41934	40360	1574	3.8
CN5406300000000	54	063	Monroe County, WV	2001	NA	5843	5584	259	4.4
CN5406500000000	54	065	Morgan County, WV	2001	NA	7339	7048	291	4
CN5406700000000	54	067	Nicholas County, WV	2001	NA	10898	10285	613	5.6
CN5406900000000	54	069	Ohio County, WV	2001	NA	22071	21124	947	4.3
CN5407100000000	54	071	Pendleton County, WV	2001	NA	3755	3579	176	4.7
CN5407300000000	54	073	Pleasants County, WV	2001	NA	3344	3155	189	5.7
CN5407500000000	54	075	Pocahontas County, WV	2001	NA	4003	3739	264	6.6
CN5407700000000	54	077	Preston County, WV	2001	NA	13547	12867	680	5
CN5407900000000	54	079	Putnam County, WV	2001	NA	26243	25146	1097	4.2
CN5408100000000	54	081	Raleigh County, WV	2001	NA	33068	31438	1630	4.9
CN5408300000000	54	083	Randolph County, WV	2001	NA	12902	12170	732	5.7
CN5408500000000	54	085	Ritchie County, WV	2001	NA	4587	4287	300	6.5
CN5408700000000	54	087	Roane County, WV	2001	NA	6006	5424	582	9.7
CN5408900000000	54	089	Summers County, WV	2001	NA	4760	4450	310	6.5
CN5409100000000	54	091	Taylor County, WV	2001	NA	7003	6634	369	5.3
CN5409300000000	54	093	Tucker County, WV	2001	NA	3271	3086	185	5.7
CN5409500000000	54	095	Tyler County, WV	2001	NA	3789	3569	220	5.8
CN5409700000000	54	097	Upshur County, WV	2001	NA	10884	10323	561	5.2
CN5409900000000	54	099	Wayne County, WV	2001	NA	17699	16736	963	5.4
CN5410100000000	54	101	Webster County, WV	2001	NA	3184	2971	213	6.7
CN5410300000000	54	103	Wetzel County, WV	2001	NA	6867	6321	546	8
CN5410500000000	54	105	Wirt County, WV	2001	NA	2555	2391	164	6.4
CN5410700000000	54	107	Wood County, WV	2001	NA	42264	40285	1979	4.7
CN5410900000000	54	109	Wyoming County, WV	2001	NA	8606	8088	518	6
CN5500100000000	55	001	Adams County, WI	2001	NA	9077	8606	471	5.2
CN5500300000000	55	003	Ashland County, WI	2001	NA	9115	8566	549	6
CN5500500000000	55	005	Barron County, WI	2001	NA	25246	24020	1226	4.9
CN5500700000000	55	007	Bayfield County, WI	2001	NA	7935	7478	457	5.8
CN5500900000000	55	009	Brown County, WI	2001	NA	132025	126704	5321	4
CN5501100000000	55	011	Buffalo County, WI	2001	NA	8190	7816	374	4.6
CN5501300000000	55	013	Burnett County, WI	2001	NA	8074	7646	428	5.3
CN5501500000000	55	015	Calumet County, WI	2001	NA	24400	23408	992	4.1
CN5501700000000	55	017	Chippewa County, WI	2001	NA	30595	28879	1716	5.6
CN5501900000000	55	019	Clark County, WI	2001	NA	17977	16916	1061	5.9
CN5502100000000	55	021	Columbia County, WI	2001	NA	30582	29227	1355	4.4
CN5502300000000	55	023	Crawford County, WI	2001	NA	9282	8797	485	5.2
CN5502500000000	55	025	Dane County, WI	2001	NA	272289	264566	7723	2.8
CN5502700000000	55	027	Dodge County, WI	2001	NA	47477	45072	2405	5.1
CN5502900000000	55	029	Door County, WI	2001	NA	17037	16219	818	4.8
CN5503100000000	55	031	Douglas County, WI	2001	NA	22594	21450	1144	5.1
CN5503300000000	55	033	Dunn County, WI	2001	NA	22821	21864	957	4.2
CN5503500000000	55	035	Eau Claire County, WI	2001	NA	53705	51548	2157	4
CN5503700000000	55	037	Florence County, WI	2001	NA	2648	2522	126	4.8
CN5503900000000	55	039	Fond du Lac County, WI	2001	NA	56256	53906	2350	4.2
CN5504100000000	55	041	Forest County, WI	2001	NA	4928	4616	312	6.3
CN5504300000000	55	043	Grant County, WI	2001	NA	28184	26875	1309	4.6
CN5504500000000	55	045	Green County, WI	2001	NA	20085	19235	850	4.2
CN5504700000000	55	047	Green Lake County, WI	2001	NA	10942	10352	590	5.4
CN5504900000000	55	049	Iowa County, WI	2001	NA	13928	13427	501	3.6
CN5505100000000	55	051	Iron County, WI	2001	NA	3273	3014	259	7.9
CN5505300000000	55	053	Jackson County, WI	2001	NA	9795	9220	575	5.9
CN5505500000000	55	055	Jefferson County, WI	2001	NA	43067	41324	1743	4
CN5505700000000	55	057	Juneau County, WI	2001	NA	13125	12271	854	6.5
CN5505900000000	55	059	Kenosha County, WI	2001	NA	81181	76921	4260	5.2
CN5506100000000	55	061	Kewaunee County, WI	2001	NA	11662	11203	459	3.9
CN5506300000000	55	063	La Crosse County, WI	2001	NA	62020	59652	2368	3.8
CN5506500000000	55	065	Lafayette County, WI	2001	NA	9392	9021	371	4
CN5506700000000	55	067	Langlade County, WI	2001	NA	11060	10372	688	6.2
CN5506900000000	55	069	Lincoln County, WI	2001	NA	16243	15408	835	5.1
CN5507100000000	55	071	Manitowoc County, WI	2001	NA	47248	44801	2447	5.2
CN5507300000000	55	073	Marathon County, WI	2001	NA	72773	69745	3028	4.2
CN5507500000000	55	075	Marinette County, WI	2001	NA	22637	21257	1380	6.1
CN5507700000000	55	077	Marquette County, WI	2001	NA	7720	7211	509	6.6
CN5507800000000	55	078	Menominee County, WI	2001	NA	1684	1499	185	11
CN5507900000000	55	079	Milwaukee County, WI	2001	NA	473068	447127	25941	5.5
CN5508100000000	55	081	Monroe County, WI	2001	NA	22316	21270	1046	4.7
CN5508300000000	55	083	Oconto County, WI	2001	NA	19780	18704	1076	5.4
CN5508500000000	55	085	Oneida County, WI	2001	NA	19966	18839	1127	5.6
CN5508700000000	55	087	Outagamie County, WI	2001	NA	93909	90030	3879	4.1
CN5508900000000	55	089	Ozaukee County, WI	2001	NA	47604	45951	1653	3.5
CN5509100000000	55	091	Pepin County, WI	2001	NA	3980	3804	176	4.4
CN5509300000000	55	093	Pierce County, WI	2001	NA	22828	22053	775	3.4
CN5509500000000	55	095	Polk County, WI	2001	NA	23336	22097	1239	5.3
CN5509700000000	55	097	Portage County, WI	2001	NA	38955	37281	1674	4.3
CN5509900000000	55	099	Price County, WI	2001	NA	8498	8023	475	5.6
CN5510100000000	55	101	Racine County, WI	2001	NA	99399	93764	5635	5.7
CN5510300000000	55	103	Richland County, WI	2001	NA	9764	9346	418	4.3
CN5510500000000	55	105	Rock County, WI	2001	NA	83189	78526	4663	5.6
CN5510700000000	55	107	Rusk County, WI	2001	NA	7927	7446	481	6.1
CN5510900000000	55	109	St. Croix County, WI	2001	NA	39261	37747	1514	3.9
CN5511100000000	55	111	Sauk County, WI	2001	NA	34204	32925	1279	3.7
CN5511300000000	55	113	Sawyer County, WI	2001	NA	8771	8251	520	5.9
CN5511500000000	55	115	Shawano County, WI	2001	NA	22390	21299	1091	4.9
CN5511700000000	55	117	Sheboygan County, WI	2001	NA	64373	61868	2505	3.9
CN5511900000000	55	119	Taylor County, WI	2001	NA	11103	10546	557	5
CN5512100000000	55	121	Trempealeau County, WI	2001	NA	15715	14906	809	5.1
CN5512300000000	55	123	Vernon County, WI	2001	NA	14616	13928	688	4.7
CN5512500000000	55	125	Vilas County, WI	2001	NA	11292	10667	625	5.5
CN5512700000000	55	127	Walworth County, WI	2001	NA	54814	52640	2174	4
CN5512900000000	55	129	Washburn County, WI	2001	NA	8185	7688	497	6.1
CN5513100000000	55	131	Washington County, WI	2001	NA	70376	67625	2751	3.9
CN5513300000000	55	133	Waukesha County, WI	2001	NA	211037	203293	7744	3.7
CN5513500000000	55	135	Waupaca County, WI	2001	NA	28092	26778	1314	4.7
CN5513700000000	55	137	Waushara County, WI	2001	NA	12345	11680	665	5.4
CN5513900000000	55	139	Winnebago County, WI	2001	NA	91273	87792	3481	3.8
CN5514100000000	55	141	Wood County, WI	2001	NA	41065	39056	2009	4.9
CN5600100000000	56	001	Albany County, WY	2001	NA	18485	17850	635	3.4
CN5600300000000	56	003	Big Horn County, WY	2001	NA	5326	5075	251	4.7
CN5600500000000	56	005	Campbell County, WY	2001	NA	21384	20814	570	2.7
CN5600700000000	56	007	Carbon County, WY	2001	NA	7965	7617	348	4.4
CN5600900000000	56	009	Converse County, WY	2001	NA	6517	6267	250	3.8
CN5601100000000	56	011	Crook County, WY	2001	NA	3109	3001	108	3.5
CN5601300000000	56	013	Fremont County, WY	2001	NA	18104	17186	918	5.1
CN5601500000000	56	015	Goshen County, WY	2001	NA	6137	5893	244	4
CN5601700000000	56	017	Hot Springs County, WY	2001	NA	2631	2523	108	4.1
CN5601900000000	56	019	Johnson County, WY	2001	NA	3525	3388	137	3.9
CN5602100000000	56	021	Laramie County, WY	2001	NA	40025	38401	1624	4.1
CN5602300000000	56	023	Lincoln County, WY	2001	NA	7544	7248	296	3.9
CN5602500000000	56	025	Natrona County, WY	2001	NA	37097	35721	1376	3.7
CN5602700000000	56	027	Niobrara County, WY	2001	NA	1215	1167	48	4
CN5602900000000	56	029	Park County, WY	2001	NA	14340	13737	603	4.2
CN5603100000000	56	031	Platte County, WY	2001	NA	4169	3995	174	4.2
CN5603300000000	56	033	Sheridan County, WY	2001	NA	14648	14071	577	3.9
CN5603500000000	56	035	Sublette County, WY	2001	NA	3749	3651	98	2.6
CN5603700000000	56	037	Sweetwater County, WY	2001	NA	20843	20032	811	3.9
CN5603900000000	56	039	Teton County, WY	2001	NA	14238	13865	373	2.6
CN5604100000000	56	041	Uinta County, WY	2001	NA	10776	10375	401	3.7
CN5604300000000	56	043	Washakie County, WY	2001	NA	4222	4039	183	4.3
CN5604500000000	56	045	Weston County, WY	2001	NA	3313	3175	138	4.2
CN7200100000000	72	001	Adjuntas Municipio, PR	2001	NA	5075	4388	687	13.5
CN7200300000000	72	003	Aguada Municipio, PR	2001	NA	14102	11934	2168	15.4
CN7200500000000	72	005	Aguadilla Municipio, PR	2001	NA	20096	17138	2958	14.7
CN7200700000000	72	007	Aguas Buenas Municipio, PR	2001	NA	8735	7699	1036	11.9
CN7200900000000	72	009	Aibonito Municipio, PR	2001	NA	7460	6569	891	11.9
CN7201100000000	72	011	Anasco Municipio, PR	2001	NA	9848	8294	1554	15.8
CN7201300000000	72	013	Arecibo Municipio, PR	2001	NA	32182	28189	3993	12.4
CN7201500000000	72	015	Arroyo Municipio, PR	2001	NA	4907	4141	766	15.6
CN7201700000000	72	017	Barceloneta Municipio, PR	2001	NA	7002	5943	1059	15.1
CN7201900000000	72	019	Barranquitas Municipio, PR	2001	NA	7177	6366	811	11.3
CN7202100000000	72	021	Bayamon Municipio, PR	2001	NA	81441	74595	6846	8.4
CN7202300000000	72	023	Cabo Rojo Municipio, PR	2001	NA	17406	15540	1866	10.7
CN7202500000000	72	025	Caguas Municipio, PR	2001	NA	51890	46533	5357	10.3
CN7202700000000	72	027	Camuy Municipio, PR	2001	NA	11795	10310	1485	12.6
CN7202900000000	72	029	Canovanas Municipio, PR	2001	NA	13306	11502	1804	13.6
CN7203100000000	72	031	Carolina Municipio, PR	2001	NA	74921	68434	6487	8.7
CN7203300000000	72	033	Catano Municipio, PR	2001	NA	8458	7551	907	10.7
CN7203500000000	72	035	Cayey Municipio, PR	2001	NA	15239	13435	1804	11.8
CN7203700000000	72	037	Ceiba Municipio, PR	2001	NA	5722	5026	696	12.2
CN7203900000000	72	039	Ciales Municipio, PR	2001	NA	4910	4141	769	15.7
CN7204100000000	72	041	Cidra Municipio, PR	2001	NA	13768	12268	1500	10.9
CN7204300000000	72	043	Coamo Municipio, PR	2001	NA	11028	9568	1460	13.2
CN7204500000000	72	045	Comerio Municipio, PR	2001	NA	4800	4111	689	14.4
CN7204700000000	72	047	Corozal Municipio, PR	2001	NA	9785	8713	1072	11
CN7204900000000	72	049	Culebra Municipio, PR	2001	NA	785	728	57	7.3
CN7205100000000	72	051	Dorado Municipio, PR	2001	NA	11764	10714	1050	8.9
CN7205300000000	72	053	Fajardo Municipio, PR	2001	NA	14374	12329	2045	14.2
CN7205400000000	72	054	Florida Municipio, PR	2001	NA	3472	2948	524	15.1
CN7205500000000	72	055	Guanica Municipio, PR	2001	NA	5855	4786	1069	18.3
CN7205700000000	72	057	Guayama Municipio, PR	2001	NA	12437	10694	1743	14
CN7205900000000	72	059	Guayanilla Municipio, PR	2001	NA	6193	5166	1027	16.6
CN7206100000000	72	061	Guaynabo Municipio, PR	2001	NA	42516	39836	2680	6.3
CN7206300000000	72	063	Gurabo Municipio, PR	2001	NA	13474	12004	1470	10.9
CN7206500000000	72	065	Hatillo Municipio, PR	2001	NA	11629	10216	1413	12.2
CN7206700000000	72	067	Hormigueros Municipio, PR	2001	NA	6232	5539	693	11.1
CN7206900000000	72	069	Humacao Municipio, PR	2001	NA	19871	17036	2835	14.3
CN7207100000000	72	071	Isabela Municipio, PR	2001	NA	14232	11985	2247	15.8
CN7207300000000	72	073	Jayuya Municipio, PR	2001	NA	4302	3691	611	14.2
CN7207500000000	72	075	Juana Diaz Municipio, PR	2001	NA	14634	12586	2048	14
CN7207700000000	72	077	Juncos Municipio, PR	2001	NA	11810	10236	1574	13.3
CN7207900000000	72	079	Lajas Municipio, PR	2001	NA	7969	6822	1147	14.4
CN7208100000000	72	081	Lares Municipio, PR	2001	NA	10191	8867	1324	13
CN7208300000000	72	083	Las Marias Municipio, PR	2001	NA	3640	3045	595	16.3
CN7208500000000	72	085	Las Piedras Municipio, PR	2001	NA	11566	9818	1748	15.1
CN7208700000000	72	087	Loiza Municipio, PR	2001	NA	8277	7234	1043	12.6
CN7208900000000	72	089	Luquillo Municipio, PR	2001	NA	6857	5678	1179	17.2
CN7209100000000	72	091	Manati Municipio, PR	2001	NA	13597	11637	1960	14.4
CN7209300000000	72	093	Maricao Municipio, PR	2001	NA	2023	1691	332	16.4
CN7209500000000	72	095	Maunabo Municipio, PR	2001	NA	3539	2919	620	17.5
CN7209700000000	72	097	Mayaguez Municipio, PR	2001	NA	31378	26835	4543	14.5
CN7209900000000	72	099	Moca Municipio, PR	2001	NA	13192	11239	1953	14.8
CN7210100000000	72	101	Morovis Municipio, PR	2001	NA	8456	7194	1262	14.9
CN7210300000000	72	103	Naguabo Municipio, PR	2001	NA	7166	6095	1071	14.9
CN7210500000000	72	105	Naranjito Municipio, PR	2001	NA	8237	7379	858	10.4
CN7210700000000	72	107	Orocovis Municipio, PR	2001	NA	5245	4379	866	16.5
CN7210900000000	72	109	Patillas Municipio, PR	2001	NA	5216	4401	815	15.6
CN7211100000000	72	111	Penuelas Municipio, PR	2001	NA	7546	6411	1135	15
CN7211300000000	72	113	Ponce Municipio, PR	2001	NA	57713	50578	7135	12.4
CN7211500000000	72	115	Quebradillas Municipio, PR	2001	NA	8019	6939	1080	13.5
CN7211700000000	72	117	Rincon Municipio, PR	2001	NA	4898	4138	760	15.5
CN7211900000000	72	119	Rio Grande Municipio, PR	2001	NA	16765	14635	2130	12.7
CN7212100000000	72	121	Sabana Grande Municipio, PR	2001	NA	8250	7149	1101	13.3
CN7212300000000	72	123	Salinas Municipio, PR	2001	NA	8307	7122	1185	14.3
CN7212500000000	72	125	San German Municipio, PR	2001	NA	12164	10326	1838	15.1
CN7212700000000	72	127	San Juan Municipio, PR	2001	NA	168986	155453	13533	8
CN7212900000000	72	129	San Lorenzo Municipio, PR	2001	NA	13091	11614	1477	11.3
CN7213100000000	72	131	San Sebastian Municipio, PR	2001	NA	13845	11701	2144	15.5
CN7213300000000	72	133	Santa Isabel Municipio, PR	2001	NA	8007	7054	953	11.9
CN7213500000000	72	135	Toa Alta Municipio, PR	2001	NA	24049	22189	1860	7.7
CN7213700000000	72	137	Toa Baja Municipio, PR	2001	NA	34245	31440	2805	8.2
CN7213900000000	72	139	Trujillo Alto Municipio, PR	2001	NA	30780	28537	2243	7.3
CN7214100000000	72	141	Utuado Municipio, PR	2001	NA	9239	7978	1261	13.6
CN7214300000000	72	143	Vega Alta Municipio, PR	2001	NA	11720	10421	1299	11.1
CN7214500000000	72	145	Vega Baja Municipio, PR	2001	NA	19554	17138	2416	12.4
CN7214700000000	72	147	Vieques Municipio, PR	2001	NA	2323	1999	324	13.9
CN7214900000000	72	149	Villalba Municipio, PR	2001	NA	7564	6546	1018	13.5
CN7215100000000	72	151	Yabucoa Municipio, PR	2001	NA	10751	8746	2005	18.6
CN7215300000000	72	153	Yauco Municipio, PR	2001	NA	14416	12475	1941	13.5
NA	NA	NA	NA	NA	NA	NA	NA	NA	NA
SOURCE:  BLS, LAUS	NA	NA	NA	NA	NA	NA	NA	NA	NA
March 18, 2016	NA	NA	NA	NA	NA	NA	NA	NA	NA
