LAUS_CODE	STATE_FIPS	COUNTY_FIPS	COUNTY	YEAR	ESTIMATED	LABOR_FORCE	EMPLOYED	UNEMPLOYED_LEVEL	UNEMPLOYED_RATE
CN0100100000000	01	001	Autauga County, AL	2007	NA	24383	23577	806	3.3
CN0100300000000	01	003	Baldwin County, AL	2007	NA	82659	80099	2560	3.1
CN0100500000000	01	005	Barbour County, AL	2007	NA	10334	9684	650	6.3
CN0100700000000	01	007	Bibb County, AL	2007	NA	8791	8432	359	4.1
CN0100900000000	01	009	Blount County, AL	2007	NA	26629	25780	849	3.2
CN0101100000000	01	011	Bullock County, AL	2007	NA	3653	3308	345	9.4
CN0101300000000	01	013	Butler County, AL	2007	NA	9099	8539	560	6.2
CN0101500000000	01	015	Calhoun County, AL	2007	NA	54861	52709	2152	3.9
CN0101700000000	01	017	Chambers County, AL	2007	NA	15474	14469	1005	6.5
CN0101900000000	01	019	Cherokee County, AL	2007	NA	11984	11484	500	4.2
CN0102100000000	01	021	Chilton County, AL	2007	NA	19737	19067	670	3.4
CN0102300000000	01	023	Choctaw County, AL	2007	NA	5183	4875	308	5.9
CN0102500000000	01	025	Clarke County, AL	2007	NA	10358	9730	628	6.1
CN0102700000000	01	027	Clay County, AL	2007	NA	6113	5775	338	5.5
CN0102900000000	01	029	Cleburne County, AL	2007	NA	6483	6246	237	3.7
CN0103100000000	01	031	Coffee County, AL	2007	NA	21077	20275	802	3.8
CN0103300000000	01	033	Colbert County, AL	2007	NA	25386	24216	1170	4.6
CN0103500000000	01	035	Conecuh County, AL	2007	NA	4965	4646	319	6.4
CN0103700000000	01	037	Coosa County, AL	2007	NA	4686	4415	271	5.8
CN0103900000000	01	039	Covington County, AL	2007	NA	17070	16409	661	3.9
CN0104100000000	01	041	Crenshaw County, AL	2007	NA	6546	6264	282	4.3
CN0104300000000	01	043	Cullman County, AL	2007	NA	39367	38047	1320	3.4
CN0104500000000	01	045	Dale County, AL	2007	NA	20250	19450	800	4
CN0104700000000	01	047	Dallas County, AL	2007	NA	15555	14259	1296	8.3
CN0104900000000	01	049	DeKalb County, AL	2007	NA	31013	29689	1324	4.3
CN0105100000000	01	051	Elmore County, AL	2007	NA	35805	34620	1185	3.3
CN0105300000000	01	053	Escambia County, AL	2007	NA	14288	13530	758	5.3
CN0105500000000	01	055	Etowah County, AL	2007	NA	45459	43431	2028	4.5
CN0105700000000	01	057	Fayette County, AL	2007	NA	7387	7039	348	4.7
CN0105900000000	01	059	Franklin County, AL	2007	NA	13742	13108	634	4.6
CN0106100000000	01	061	Geneva County, AL	2007	NA	11535	11137	398	3.5
CN0106300000000	01	063	Greene County, AL	2007	NA	3284	3075	209	6.4
CN0106500000000	01	065	Hale County, AL	2007	NA	6976	6602	374	5.4
CN0106700000000	01	067	Henry County, AL	2007	NA	7540	7135	405	5.4
CN0106900000000	01	069	Houston County, AL	2007	NA	47179	45607	1572	3.3
CN0107100000000	01	071	Jackson County, AL	2007	NA	27020	25799	1221	4.5
CN0107300000000	01	073	Jefferson County, AL	2007	NA	314739	302603	12136	3.9
CN0107500000000	01	075	Lamar County, AL	2007	NA	5854	5488	366	6.3
CN0107700000000	01	077	Lauderdale County, AL	2007	NA	43257	41389	1868	4.3
CN0107900000000	01	079	Lawrence County, AL	2007	NA	15807	15160	647	4.1
CN0108100000000	01	081	Lee County, AL	2007	NA	65326	62949	2377	3.6
CN0108300000000	01	083	Limestone County, AL	2007	NA	36340	35123	1217	3.3
CN0108500000000	01	085	Lowndes County, AL	2007	NA	4758	4400	358	7.5
CN0108700000000	01	087	Macon County, AL	2007	NA	8865	8385	480	5.4
CN0108900000000	01	089	Madison County, AL	2007	NA	165286	160218	5068	3.1
CN0109100000000	01	091	Marengo County, AL	2007	NA	8150	7718	432	5.3
CN0109300000000	01	093	Marion County, AL	2007	NA	12974	12297	677	5.2
CN0109500000000	01	095	Marshall County, AL	2007	NA	41311	39890	1421	3.4
CN0109700000000	01	097	Mobile County, AL	2007	NA	184490	177096	7394	4
CN0109900000000	01	099	Monroe County, AL	2007	NA	8945	8369	576	6.4
CN0110100000000	01	101	Montgomery County, AL	2007	NA	106156	101798	4358	4.1
CN0110300000000	01	103	Morgan County, AL	2007	NA	56642	54654	1988	3.5
CN0110500000000	01	105	Perry County, AL	2007	NA	3543	3244	299	8.4
CN0110700000000	01	107	Pickens County, AL	2007	NA	8015	7613	402	5
CN0110900000000	01	109	Pike County, AL	2007	NA	15575	14947	628	4
CN0111100000000	01	111	Randolph County, AL	2007	NA	9487	9005	482	5.1
CN0111300000000	01	113	Russell County, AL	2007	NA	21734	20414	1320	6.1
CN0111500000000	01	115	St. Clair County, AL	2007	NA	36040	34813	1227	3.4
CN0111700000000	01	117	Shelby County, AL	2007	NA	99647	97043	2604	2.6
CN0111900000000	01	119	Sumter County, AL	2007	NA	4778	4466	312	6.5
CN0112100000000	01	121	Talladega County, AL	2007	NA	38922	36898	2024	5.2
CN0112300000000	01	123	Tallapoosa County, AL	2007	NA	18311	17340	971	5.3
CN0112500000000	01	125	Tuscaloosa County, AL	2007	NA	89008	86080	2928	3.3
CN0112700000000	01	127	Walker County, AL	2007	NA	29056	27800	1256	4.3
CN0112900000000	01	129	Washington County, AL	2007	NA	7002	6586	416	5.9
CN0113100000000	01	131	Wilcox County, AL	2007	NA	3438	3106	332	9.7
CN0113300000000	01	133	Winston County, AL	2007	NA	10287	9712	575	5.6
CN0201300000000	02	013	Aleutians East Borough, AK	2007	NA	1094	1007	87	8
CN0201600000000	02	016	Aleutians West Census Area, AK	2007	NA	3085	2917	168	5.4
CN0202000000000	02	020	Anchorage Borough/municipality, AK	2007	NA	151051	143336	7715	5.1
CN0205000000000	02	050	Bethel Census Area, AK	2007	NA	6951	6062	889	12.8
CN0206000000000	02	060	Bristol Bay Borough, AK	2007	NA	1064	1014	50	4.7
CN0206800000000	02	068	Denali Borough, AK	2007	NA	1602	1502	100	6.2
CN0207000000000	02	070	Dillingham Census Area, AK	2007	NA	2045	1858	187	9.1
CN0209000000000	02	090	Fairbanks North Star Borough, AK	2007	NA	45385	42858	2527	5.6
CN0210000000000	02	100	Haines Borough, AK	2007	NA	1446	1339	107	7.4
CN0211000000000	02	110	Juneau Borough/city, AK	2007	NA	18459	17626	833	4.5
CN0212200000000	02	122	Kenai Peninsula Borough, AK	2007	NA	25700	23674	2026	7.9
CN0213000000000	02	130	Ketchikan Gateway Borough, AK	2007	NA	8222	7757	465	5.7
CN0215000000000	02	150	Kodiak Island Borough, AK	2007	NA	6141	5756	385	6.3
CN0215800000000	02	158	Kusilvak Census Area, AK	2007	NA	2584	2057	527	20.4
CN0216400000000	02	164	Lake and Peninsula Borough, AK	2007	NA	1166	1102	64	5.5
CN0217000000000	02	170	Matanuska-Susitna Borough, AK	2007	NA	39800	36934	2866	7.2
CN0218000000000	02	180	Nome Census Area, AK	2007	NA	3796	3374	422	11.1
CN0218500000000	02	185	North Slope Borough, AK	2007	NA	4672	4420	252	5.4
CN0218800000000	02	188	Northwest Arctic Borough, AK	2007	NA	2968	2646	322	10.8
CN0220100000000	02	201	Prince of Wales-Outer Ketchikan Census Area, AK	2007	NA	2275	1966	309	13.6
CN0222000000000	02	220	Sitka Borough/city, AK	2007	NA	4635	4398	237	5.1
CN0223200000000	02	232	Skagway-Hoonah-Angoon Census Area, AK	2007	NA	1925	1685	240	12.5
CN0224000000000	02	240	Southeast Fairbanks Census Area, AK	2007	NA	3555	3246	309	8.7
CN0226100000000	02	261	Valdez-Cordova Census Area, AK	2007	NA	5219	4778	441	8.4
CN0228000000000	02	280	Wrangell-Petersburg Census Area, AK	2007	NA	2875	2598	277	9.6
CN0228200000000	02	282	Yakutat Borough/city, AK	2007	NA	308	287	21	6.8
CN0229000000000	02	290	Yukon-Koyukuk Census Area, AK	2007	NA	2763	2382	381	13.8
CN0400100000000	04	001	Apache County, AZ	2007	NA	20200	18427	1773	8.8
CN0400300000000	04	003	Cochise County, AZ	2007	NA	57271	54934	2337	4.1
CN0400500000000	04	005	Coconino County, AZ	2007	NA	70736	68093	2643	3.7
CN0400700000000	04	007	Gila County, AZ	2007	NA	21166	20256	910	4.3
CN0400900000000	04	009	Graham County, AZ	2007	NA	14294	13680	614	4.3
CN0401100000000	04	011	Greenlee County, AZ	2007	NA	3998	3868	130	3.3
CN0401200000000	04	012	La Paz County, AZ	2007	NA	7655	7262	393	5.1
CN0401300000000	04	013	Maricopa County, AZ	2007	NA	1945290	1881907	63383	3.3
CN0401500000000	04	015	Mohave County, AZ	2007	NA	91440	87174	4266	4.7
CN0401700000000	04	017	Navajo County, AZ	2007	NA	38244	35783	2461	6.4
CN0401900000000	04	019	Pima County, AZ	2007	NA	458486	441553	16933	3.7
CN0402100000000	04	021	Pinal County, AZ	2007	NA	111626	106534	5092	4.6
CN0402300000000	04	023	Santa Cruz County, AZ	2007	NA	17162	15893	1269	7.4
CN0402500000000	04	025	Yavapai County, AZ	2007	NA	97606	93996	3610	3.7
CN0402700000000	04	027	Yuma County, AZ	2007	NA	78841	67756	11085	14.1
CN0500100000000	05	001	Arkansas County, AR	2007	NA	11988	10942	1046	8.7
CN0500300000000	05	003	Ashley County, AR	2007	NA	9483	8712	771	8.1
CN0500500000000	05	005	Baxter County, AR	2007	NA	17748	16787	961	5.4
CN0500700000000	05	007	Benton County, AR	2007	NA	105064	101125	3939	3.7
CN0500900000000	05	009	Boone County, AR	2007	NA	16987	16127	860	5.1
CN0501100000000	05	011	Bradley County, AR	2007	NA	5799	5446	353	6.1
CN0501300000000	05	013	Calhoun County, AR	2007	NA	2638	2461	177	6.7
CN0501500000000	05	015	Carroll County, AR	2007	NA	14021	13416	605	4.3
CN0501700000000	05	017	Chicot County, AR	2007	NA	4995	4583	412	8.2
CN0501900000000	05	019	Clark County, AR	2007	NA	11069	10451	618	5.6
CN0502100000000	05	021	Clay County, AR	2007	NA	6751	6125	626	9.3
CN0502300000000	05	023	Cleburne County, AR	2007	NA	11687	10977	710	6.1
CN0502500000000	05	025	Cleveland County, AR	2007	NA	4180	3942	238	5.7
CN0502700000000	05	027	Columbia County, AR	2007	NA	11040	10320	720	6.5
CN0502900000000	05	029	Conway County, AR	2007	NA	10073	9583	490	4.9
CN0503100000000	05	031	Craighead County, AR	2007	NA	45989	43687	2302	5
CN0503300000000	05	033	Crawford County, AR	2007	NA	28569	27174	1395	4.9
CN0503500000000	05	035	Crittenden County, AR	2007	NA	22416	20955	1461	6.5
CN0503700000000	05	037	Cross County, AR	2007	NA	8457	7833	624	7.4
CN0503900000000	05	039	Dallas County, AR	2007	NA	3881	3608	273	7
CN0504100000000	05	041	Desha County, AR	2007	NA	6177	5567	610	9.9
CN0504300000000	05	043	Drew County, AR	2007	NA	8501	7870	631	7.4
CN0504500000000	05	045	Faulkner County, AR	2007	NA	55212	52793	2419	4.4
CN0504700000000	05	047	Franklin County, AR	2007	NA	8600	8215	385	4.5
CN0504900000000	05	049	Fulton County, AR	2007	NA	5169	4912	257	5
CN0505100000000	05	051	Garland County, AR	2007	NA	42727	40380	2347	5.5
CN0505300000000	05	053	Grant County, AR	2007	NA	8587	8162	425	4.9
CN0505500000000	05	055	Greene County, AR	2007	NA	18678	17463	1215	6.5
CN0505700000000	05	057	Hempstead County, AR	2007	NA	10978	10332	646	5.9
CN0505900000000	05	059	Hot Spring County, AR	2007	NA	15477	14654	823	5.3
CN0506100000000	05	061	Howard County, AR	2007	NA	6452	6101	351	5.4
CN0506300000000	05	063	Independence County, AR	2007	NA	17393	16321	1072	6.2
CN0506500000000	05	065	Izard County, AR	2007	NA	5445	5125	320	5.9
CN0506700000000	05	067	Jackson County, AR	2007	NA	7891	7297	594	7.5
CN0506900000000	05	069	Jefferson County, AR	2007	NA	35578	32915	2663	7.5
CN0507100000000	05	071	Johnson County, AR	2007	NA	11443	10892	551	4.8
CN0507300000000	05	073	Lafayette County, AR	2007	NA	3143	2908	235	7.5
CN0507500000000	05	075	Lawrence County, AR	2007	NA	7400	6894	506	6.8
CN0507700000000	05	077	Lee County, AR	2007	NA	3634	3294	340	9.4
CN0507900000000	05	079	Lincoln County, AR	2007	NA	5044	4649	395	7.8
CN0508100000000	05	081	Little River County, AR	2007	NA	6539	6267	272	4.2
CN0508300000000	05	083	Logan County, AR	2007	NA	10575	10048	527	5
CN0508500000000	05	085	Lonoke County, AR	2007	NA	31711	30328	1383	4.4
CN0508700000000	05	087	Madison County, AR	2007	NA	7781	7464	317	4.1
CN0508900000000	05	089	Marion County, AR	2007	NA	7052	6671	381	5.4
CN0509100000000	05	091	Miller County, AR	2007	NA	19792	18910	882	4.5
CN0509300000000	05	093	Mississippi County, AR	2007	NA	21616	20044	1572	7.3
CN0509500000000	05	095	Monroe County, AR	2007	NA	3897	3636	261	6.7
CN0509700000000	05	097	Montgomery County, AR	2007	NA	4263	4038	225	5.3
CN0509900000000	05	099	Nevada County, AR	2007	NA	4363	4115	248	5.7
CN0510100000000	05	101	Newton County, AR	2007	NA	3520	3342	178	5.1
CN0510300000000	05	103	Ouachita County, AR	2007	NA	12054	11178	876	7.3
CN0510500000000	05	105	Perry County, AR	2007	NA	4835	4601	234	4.8
CN0510700000000	05	107	Phillips County, AR	2007	NA	9060	8403	657	7.3
CN0510900000000	05	109	Pike County, AR	2007	NA	5240	4944	296	5.6
CN0511100000000	05	111	Poinsett County, AR	2007	NA	10923	10132	791	7.2
CN0511300000000	05	113	Polk County, AR	2007	NA	8904	8467	437	4.9
CN0511500000000	05	115	Pope County, AR	2007	NA	30274	28835	1439	4.8
CN0511700000000	05	117	Prairie County, AR	2007	NA	4436	4182	254	5.7
CN0511900000000	05	119	Pulaski County, AR	2007	NA	191162	182117	9045	4.7
CN0512100000000	05	121	Randolph County, AR	2007	NA	7666	6956	710	9.3
CN0512300000000	05	123	St. Francis County, AR	2007	NA	10561	9546	1015	9.6
CN0512500000000	05	125	Saline County, AR	2007	NA	49069	47019	2050	4.2
CN0512700000000	05	127	Scott County, AR	2007	NA	4880	4655	225	4.6
CN0512900000000	05	129	Searcy County, AR	2007	NA	3628	3451	177	4.9
CN0513100000000	05	131	Sebastian County, AR	2007	NA	62414	59205	3209	5.1
CN0513300000000	05	133	Sevier County, AR	2007	NA	7801	7480	321	4.1
CN0513500000000	05	135	Sharp County, AR	2007	NA	6448	6015	433	6.7
CN0513700000000	05	137	Stone County, AR	2007	NA	4804	4531	273	5.7
CN0513900000000	05	139	Union County, AR	2007	NA	19462	18130	1332	6.8
CN0514100000000	05	141	Van Buren County, AR	2007	NA	7058	6640	418	5.9
CN0514300000000	05	143	Washington County, AR	2007	NA	104859	100817	4042	3.9
CN0514500000000	05	145	White County, AR	2007	NA	32094	29988	2106	6.6
CN0514700000000	05	147	Woodruff County, AR	2007	NA	3539	3231	308	8.7
CN0514900000000	05	149	Yell County, AR	2007	NA	10645	10189	456	4.3
CN0600100000000	06	001	Alameda County, CA	2007	NA	745198	710144	35054	4.7
CN0600300000000	06	003	Alpine County, CA	2007	NA	493	454	39	7.9
CN0600500000000	06	005	Amador County, CA	2007	NA	17703	16675	1028	5.8
CN0600700000000	06	007	Butte County, CA	2007	NA	101228	94489	6739	6.7
CN0600900000000	06	009	Calaveras County, CA	2007	NA	20725	19394	1331	6.4
CN0601100000000	06	011	Colusa County, CA	2007	NA	10217	9015	1202	11.8
CN0601300000000	06	013	Contra Costa County, CA	2007	NA	514317	490220	24097	4.7
CN0601500000000	06	015	Del Norte County, CA	2007	NA	11029	10199	830	7.5
CN0601700000000	06	017	El Dorado County, CA	2007	NA	90382	85707	4675	5.2
CN0601900000000	06	019	Fresno County, CA	2007	NA	418579	382789	35790	8.6
CN0602100000000	06	021	Glenn County, CA	2007	NA	11975	10921	1054	8.8
CN0602300000000	06	023	Humboldt County, CA	2007	NA	59282	55775	3507	5.9
CN0602500000000	06	025	Imperial County, CA	2007	NA	65967	54052	11915	18.1
CN0602700000000	06	027	Inyo County, CA	2007	NA	8885	8447	438	4.9
CN0602900000000	06	029	Kern County, CA	2007	NA	345187	316959	28228	8.2
CN0603100000000	06	031	Kings County, CA	2007	NA	57327	52353	4974	8.7
CN0603300000000	06	033	Lake County, CA	2007	NA	24041	22010	2031	8.4
CN0603500000000	06	035	Lassen County, CA	2007	NA	12436	11422	1014	8.2
CN0603700000000	06	037	Los Angeles County, CA	2007	NA	4864160	4614776	249384	5.1
CN0603900000000	06	039	Madera County, CA	2007	NA	63365	58620	4745	7.5
CN0604100000000	06	041	Marin County, CA	2007	NA	131904	127083	4821	3.7
CN0604300000000	06	043	Mariposa County, CA	2007	NA	9061	8515	546	6
CN0604500000000	06	045	Mendocino County, CA	2007	NA	43115	40744	2371	5.5
CN0604700000000	06	047	Merced County, CA	2007	NA	99843	89797	10046	10.1
CN0604900000000	06	049	Modoc County, CA	2007	NA	3896	3582	314	8.1
CN0605100000000	06	051	Mono County, CA	2007	NA	8132	7741	391	4.8
CN0605300000000	06	053	Monterey County, CA	2007	NA	205460	190781	14679	7.1
CN0605500000000	06	055	Napa County, CA	2007	NA	73232	70286	2946	4
CN0605700000000	06	057	Nevada County, CA	2007	NA	50125	47719	2406	4.8
CN0605900000000	06	059	Orange County, CA	2007	NA	1606177	1543703	62474	3.9
CN0606100000000	06	061	Placer County, CA	2007	NA	172478	164247	8231	4.8
CN0606300000000	06	063	Plumas County, CA	2007	NA	9948	9099	849	8.5
CN0606500000000	06	065	Riverside County, CA	2007	NA	902047	847618	54429	6
CN0606700000000	06	067	Sacramento County, CA	2007	NA	675800	639075	36725	5.4
CN0606900000000	06	069	San Benito County, CA	2007	NA	24005	22269	1736	7.2
CN0607100000000	06	071	San Bernardino County, CA	2007	NA	862191	813867	48324	5.6
CN0607300000000	06	073	San Diego County, CA	2007	NA	1515351	1446347	69004	4.6
CN0607500000000	06	075	San Francisco County/city, CA	2007	NA	432564	414199	18365	4.2
CN0607700000000	06	077	San Joaquin County, CA	2007	NA	288638	265279	23359	8.1
CN0607900000000	06	079	San Luis Obispo County, CA	2007	NA	134026	128276	5750	4.3
CN0608100000000	06	081	San Mateo County, CA	2007	NA	369503	355415	14088	3.8
CN0608300000000	06	083	Santa Barbara County, CA	2007	NA	213473	204163	9310	4.4
CN0608500000000	06	085	Santa Clara County, CA	2007	NA	843437	803877	39560	4.7
CN0608700000000	06	087	Santa Cruz County, CA	2007	NA	144713	136158	8555	5.9
CN0608900000000	06	089	Shasta County, CA	2007	NA	82540	76350	6190	7.5
CN0609100000000	06	091	Sierra County, CA	2007	NA	1610	1482	128	8
CN0609300000000	06	093	Siskiyou County, CA	2007	NA	18786	17192	1594	8.5
CN0609500000000	06	095	Solano County, CA	2007	NA	208196	197214	10982	5.3
CN0609700000000	06	097	Sonoma County, CA	2007	NA	257316	246143	11173	4.3
CN0609900000000	06	099	Stanislaus County, CA	2007	NA	226889	207202	19687	8.7
CN0610100000000	06	101	Sutter County, CA	2007	NA	40987	37022	3965	9.7
CN0610300000000	06	103	Tehama County, CA	2007	NA	24859	23061	1798	7.2
CN0610500000000	06	105	Trinity County, CA	2007	NA	5024	4499	525	10.4
CN0610700000000	06	107	Tulare County, CA	2007	NA	191568	173855	17713	9.2
CN0610900000000	06	109	Tuolumne County, CA	2007	NA	25775	24176	1599	6.2
CN0611100000000	06	111	Ventura County, CA	2007	NA	423062	402396	20666	4.9
CN0611300000000	06	113	Yolo County, CA	2007	NA	97518	91928	5590	5.7
CN0611500000000	06	115	Yuba County, CA	2007	NA	27345	24813	2532	9.3
CN0800100000000	08	001	Adams County, CO	2007	NA	219560	210306	9254	4.2
CN0800300000000	08	003	Alamosa County, CO	2007	NA	8352	8022	330	4
CN0800500000000	08	005	Arapahoe County, CO	2007	NA	304913	293497	11416	3.7
CN0800700000000	08	007	Archuleta County, CO	2007	NA	6604	6354	250	3.8
CN0800900000000	08	009	Baca County, CO	2007	NA	2398	2338	60	2.5
CN0801100000000	08	011	Bent County, CO	2007	NA	2424	2307	117	4.8
CN0801300000000	08	013	Boulder County, CO	2007	NA	173647	167953	5694	3.3
CN0801400000000	08	014	Broomfield County/city, CO	2007	NA	29984	28928	1056	3.5
CN0801500000000	08	015	Chaffee County, CO	2007	NA	8211	7918	293	3.6
CN0801700000000	08	017	Cheyenne County, CO	2007	NA	1366	1332	34	2.5
CN0801900000000	08	019	Clear Creek County, CO	2007	NA	5648	5441	207	3.7
CN0802100000000	08	021	Conejos County, CO	2007	NA	3640	3438	202	5.5
CN0802300000000	08	023	Costilla County, CO	2007	NA	1303	1211	92	7.1
CN0802500000000	08	025	Crowley County, CO	2007	NA	1923	1802	121	6.3
CN0802700000000	08	027	Custer County, CO	2007	NA	1994	1915	79	4
CN0802900000000	08	029	Delta County, CO	2007	NA	16412	15871	541	3.3
CN0803100000000	08	031	Denver County/city, CO	2007	NA	314781	301750	13031	4.1
CN0803300000000	08	033	Dolores County, CO	2007	NA	1030	979	51	5
CN0803500000000	08	035	Douglas County, CO	2007	NA	154953	150126	4827	3.1
CN0803700000000	08	037	Eagle County, CO	2007	NA	30929	30053	876	2.8
CN0803900000000	08	039	Elbert County, CO	2007	NA	12798	12327	471	3.7
CN0804100000000	08	041	El Paso County, CO	2007	NA	297494	284858	12636	4.2
CN0804300000000	08	043	Fremont County, CO	2007	NA	19646	18720	926	4.7
CN0804500000000	08	045	Garfield County, CO	2007	NA	34945	34088	857	2.5
CN0804700000000	08	047	Gilpin County, CO	2007	NA	3414	3295	119	3.5
CN0804900000000	08	049	Grand County, CO	2007	NA	9158	8920	238	2.6
CN0805100000000	08	051	Gunnison County, CO	2007	NA	9522	9254	268	2.8
CN0805300000000	08	053	Hinsdale County, CO	2007	NA	608	591	17	2.8
CN0805500000000	08	055	Huerfano County, CO	2007	NA	3353	3194	159	4.7
CN0805700000000	08	057	Jackson County, CO	2007	NA	1103	1075	28	2.5
CN0805900000000	08	059	Jefferson County, CO	2007	NA	303357	292287	11070	3.6
CN0806100000000	08	061	Kiowa County, CO	2007	NA	911	887	24	2.6
CN0806300000000	08	063	Kit Carson County, CO	2007	NA	4475	4355	120	2.7
CN0806500000000	08	065	Lake County, CO	2007	NA	4028	3884	144	3.6
CN0806700000000	08	067	La Plata County, CO	2007	NA	31007	30143	864	2.8
CN0806900000000	08	069	Larimer County, CO	2007	NA	172024	166224	5800	3.4
CN0807100000000	08	071	Las Animas County, CO	2007	NA	8695	8381	314	3.6
CN0807300000000	08	073	Lincoln County, CO	2007	NA	3014	2922	92	3.1
CN0807500000000	08	075	Logan County, CO	2007	NA	11321	10975	346	3.1
CN0807700000000	08	077	Mesa County, CO	2007	NA	77873	75412	2461	3.2
CN0807900000000	08	079	Mineral County, CO	2007	NA	471	451	20	4.2
CN0808100000000	08	081	Moffat County, CO	2007	NA	8521	8260	261	3.1
CN0808300000000	08	083	Montezuma County, CO	2007	NA	13172	12664	508	3.9
CN0808500000000	08	085	Montrose County, CO	2007	NA	20744	20003	741	3.6
CN0808700000000	08	087	Morgan County, CO	2007	NA	14221	13746	475	3.3
CN0808900000000	08	089	Otero County, CO	2007	NA	8813	8374	439	5
CN0809100000000	08	091	Ouray County, CO	2007	NA	3051	2962	89	2.9
CN0809300000000	08	093	Park County, CO	2007	NA	9602	9256	346	3.6
CN0809500000000	08	095	Phillips County, CO	2007	NA	2420	2354	66	2.7
CN0809700000000	08	097	Pitkin County, CO	2007	NA	11271	10967	304	2.7
CN0809900000000	08	099	Prowers County, CO	2007	NA	6790	6556	234	3.4
CN0810100000000	08	101	Pueblo County, CO	2007	NA	71808	68431	3377	4.7
CN0810300000000	08	103	Rio Blanco County, CO	2007	NA	5344	5234	110	2.1
CN0810500000000	08	105	Rio Grande County, CO	2007	NA	6543	6284	259	4
CN0810700000000	08	107	Routt County, CO	2007	NA	15692	15285	407	2.6
CN0810900000000	08	109	Saguache County, CO	2007	NA	3158	2993	165	5.2
CN0811100000000	08	111	San Juan County, CO	2007	NA	563	540	23	4.1
CN0811300000000	08	113	San Miguel County, CO	2007	NA	5652	5477	175	3.1
CN0811500000000	08	115	Sedgwick County, CO	2007	NA	1826	1786	40	2.2
CN0811700000000	08	117	Summit County, CO	2007	NA	17129	16663	466	2.7
CN0811900000000	08	119	Teller County, CO	2007	NA	12415	11936	479	3.9
CN0812100000000	08	121	Washington County, CO	2007	NA	2880	2803	77	2.7
CN0812300000000	08	123	Weld County, CO	2007	NA	117044	112271	4773	4.1
CN0812500000000	08	125	Yuma County, CO	2007	NA	6734	6591	143	2.1
CN0900100000000	09	001	Fairfield County, CT	2007	NA	466532	448188	18344	3.9
CN0900300000000	09	003	Hartford County, CT	2007	NA	452749	430746	22003	4.9
CN0900500000000	09	005	Litchfield County, CT	2007	NA	104535	100133	4402	4.2
CN0900700000000	09	007	Middlesex County, CT	2007	NA	93011	89397	3614	3.9
CN0900900000000	09	009	New Haven County, CT	2007	NA	444223	422247	21976	4.9
CN0901100000000	09	011	New London County, CT	2007	NA	147559	141400	6159	4.2
CN0901300000000	09	013	Tolland County, CT	2007	NA	83967	80742	3225	3.8
CN0901500000000	09	015	Windham County, CT	2007	NA	63624	60303	3321	5.2
CN1000100000000	10	001	Kent County, DE	2007	NA	75038	72517	2521	3.4
CN1000300000000	10	003	New Castle County, DE	2007	NA	275852	266221	9631	3.5
CN1000500000000	10	005	Sussex County, DE	2007	NA	92683	89574	3109	3.4
CN1100100000000	11	001	District of Columbia	2007	NA	322237	304426	17811	5.5
CN1200100000000	12	001	Alachua County, FL	2007	NA	129010	125102	3908	3
CN1200300000000	12	003	Baker County, FL	2007	NA	11913	11477	436	3.7
CN1200500000000	12	005	Bay County, FL	2007	NA	86754	83532	3222	3.7
CN1200700000000	12	007	Bradford County, FL	2007	NA	12341	11917	424	3.4
CN1200900000000	12	009	Brevard County, FL	2007	NA	265782	254099	11683	4.4
CN1201100000000	12	011	Broward County, FL	2007	NA	1000426	964482	35944	3.6
CN1201300000000	12	013	Calhoun County, FL	2007	NA	5550	5345	205	3.7
CN1201500000000	12	015	Charlotte County, FL	2007	NA	69876	66269	3607	5.2
CN1201700000000	12	017	Citrus County, FL	2007	NA	55641	52797	2844	5.1
CN1201900000000	12	019	Clay County, FL	2007	NA	93804	90475	3329	3.5
CN1202100000000	12	021	Collier County, FL	2007	NA	151925	145183	6742	4.4
CN1202300000000	12	023	Columbia County, FL	2007	NA	30955	29823	1132	3.7
CN1202700000000	12	027	DeSoto County, FL	2007	NA	14328	13620	708	4.9
CN1202900000000	12	029	Dixie County, FL	2007	NA	5535	5290	245	4.4
CN1203100000000	12	031	Duval County, FL	2007	NA	441216	422676	18540	4.2
CN1203300000000	12	033	Escambia County, FL	2007	NA	140808	135212	5596	4
CN1203500000000	12	035	Flagler County, FL	2007	NA	30928	28887	2041	6.6
CN1203700000000	12	037	Franklin County, FL	2007	NA	4922	4763	159	3.2
CN1203900000000	12	039	Gadsden County, FL	2007	NA	20770	19853	917	4.4
CN1204100000000	12	041	Gilchrist County, FL	2007	NA	7613	7318	295	3.9
CN1204300000000	12	043	Glades County, FL	2007	NA	4789	4559	230	4.8
CN1204500000000	12	045	Gulf County, FL	2007	NA	6269	6027	242	3.9
CN1204700000000	12	047	Hamilton County, FL	2007	NA	4627	4411	216	4.7
CN1204900000000	12	049	Hardee County, FL	2007	NA	11858	11313	545	4.6
CN1205100000000	12	051	Hendry County, FL	2007	NA	18008	16654	1354	7.5
CN1205300000000	12	053	Hernando County, FL	2007	NA	61681	58059	3622	5.9
CN1205500000000	12	055	Highlands County, FL	2007	NA	40249	38284	1965	4.9
CN1205700000000	12	057	Hillsborough County, FL	2007	NA	595244	570539	24705	4.2
CN1205900000000	12	059	Holmes County, FL	2007	NA	8769	8455	314	3.6
CN1206100000000	12	061	Indian River County, FL	2007	NA	62723	59155	3568	5.7
CN1206300000000	12	063	Jackson County, FL	2007	NA	21538	20679	859	4
CN1206500000000	12	065	Jefferson County, FL	2007	NA	6749	6519	230	3.4
CN1206700000000	12	067	Lafayette County, FL	2007	NA	2921	2833	88	3
CN1206900000000	12	069	Lake County, FL	2007	NA	132744	127162	5582	4.2
CN1207100000000	12	071	Lee County, FL	2007	NA	290882	277066	13816	4.7
CN1207300000000	12	073	Leon County, FL	2007	NA	144890	140326	4564	3.1
CN1207500000000	12	075	Levy County, FL	2007	NA	16793	16072	721	4.3
CN1207700000000	12	077	Liberty County, FL	2007	NA	3667	3563	104	2.8
CN1207900000000	12	079	Madison County, FL	2007	NA	6954	6526	428	6.2
CN1208100000000	12	081	Manatee County, FL	2007	NA	147550	141381	6169	4.2
CN1208300000000	12	083	Marion County, FL	2007	NA	137247	130851	6396	4.7
CN1208500000000	12	085	Martin County, FL	2007	NA	64940	62057	2883	4.4
CN1208600000000	12	086	Miami-Dade County, FL	2007	NA	1226005	1188136	37869	3.1
CN1208700000000	12	087	Monroe County, FL	2007	NA	44757	43532	1225	2.7
CN1208900000000	12	089	Nassau County, FL	2007	NA	35191	33994	1197	3.4
CN1209100000000	12	091	Okaloosa County, FL	2007	NA	97527	94552	2975	3.1
CN1209300000000	12	093	Okeechobee County, FL	2007	NA	17537	16608	929	5.3
CN1209500000000	12	095	Orange County, FL	2007	NA	594761	571946	22815	3.8
CN1209700000000	12	097	Osceola County, FL	2007	NA	132902	127164	5738	4.3
CN1209900000000	12	099	Palm Beach County, FL	2007	NA	626062	598221	27841	4.4
CN1210100000000	12	101	Pasco County, FL	2007	NA	193243	183551	9692	5
CN1210300000000	12	103	Pinellas County, FL	2007	NA	450329	431617	18712	4.2
CN1210500000000	12	105	Polk County, FL	2007	NA	268193	255915	12278	4.6
CN1210700000000	12	107	Putnam County, FL	2007	NA	31945	30420	1525	4.8
CN1210900000000	12	109	St. Johns County, FL	2007	NA	92427	89382	3045	3.3
CN1211100000000	12	111	St. Lucie County, FL	2007	NA	123851	116666	7185	5.8
CN1211300000000	12	113	Santa Rosa County, FL	2007	NA	69649	67061	2588	3.7
CN1211500000000	12	115	Sarasota County, FL	2007	NA	171609	163784	7825	4.6
CN1211700000000	12	117	Seminole County, FL	2007	NA	238644	229929	8715	3.7
CN1211900000000	12	119	Sumter County, FL	2007	NA	31509	30390	1119	3.6
CN1212100000000	12	121	Suwannee County, FL	2007	NA	17350	16707	643	3.7
CN1212300000000	12	123	Taylor County, FL	2007	NA	8814	8431	383	4.3
CN1212500000000	12	125	Union County, FL	2007	NA	5136	4973	163	3.2
CN1212700000000	12	127	Volusia County, FL	2007	NA	252491	241896	10595	4.2
CN1212900000000	12	129	Wakulla County, FL	2007	NA	15109	14650	459	3
CN1213100000000	12	131	Walton County, FL	2007	NA	31252	30380	872	2.8
CN1213300000000	12	133	Washington County, FL	2007	NA	9652	9259	393	4.1
CN1300100000000	13	001	Appling County, GA	2007	NA	9079	8599	480	5.3
CN1300300000000	13	003	Atkinson County, GA	2007	NA	3390	3198	192	5.7
CN1300500000000	13	005	Bacon County, GA	2007	NA	4738	4511	227	4.8
CN1300700000000	13	007	Baker County, GA	2007	NA	1657	1574	83	5
CN1300900000000	13	009	Baldwin County, GA	2007	NA	20745	19590	1155	5.6
CN1301100000000	13	011	Banks County, GA	2007	NA	10601	10283	318	3
CN1301300000000	13	013	Barrow County, GA	2007	NA	33863	32447	1416	4.2
CN1301500000000	13	015	Bartow County, GA	2007	NA	45865	43620	2245	4.9
CN1301700000000	13	017	Ben Hill County, GA	2007	NA	7891	7348	543	6.9
CN1301900000000	13	019	Berrien County, GA	2007	NA	8801	8419	382	4.3
CN1302100000000	13	021	Bibb County, GA	2007	NA	73788	69952	3836	5.2
CN1302300000000	13	023	Bleckley County, GA	2007	NA	5364	5084	280	5.2
CN1302500000000	13	025	Brantley County, GA	2007	NA	7559	7220	339	4.5
CN1302700000000	13	027	Brooks County, GA	2007	NA	8407	8047	360	4.3
CN1302900000000	13	029	Bryan County, GA	2007	NA	16623	16054	569	3.4
CN1303100000000	13	031	Bulloch County, GA	2007	NA	32393	30994	1399	4.3
CN1303300000000	13	033	Burke County, GA	2007	NA	9979	9208	771	7.7
CN1303500000000	13	035	Butts County, GA	2007	NA	10151	9628	523	5.2
CN1303700000000	13	037	Calhoun County, GA	2007	NA	2175	2032	143	6.6
CN1303900000000	13	039	Camden County, GA	2007	NA	21609	20742	867	4
CN1304300000000	13	043	Candler County, GA	2007	NA	4418	4223	195	4.4
CN1304500000000	13	045	Carroll County, GA	2007	NA	53240	50688	2552	4.8
CN1304700000000	13	047	Catoosa County, GA	2007	NA	35453	34177	1276	3.6
CN1304900000000	13	049	Charlton County, GA	2007	NA	4595	4377	218	4.7
CN1305100000000	13	051	Chatham County, GA	2007	NA	133680	128394	5286	4
CN1305300000000	13	053	Chattahoochee County, GA	2007	NA	1704	1543	161	9.4
CN1305500000000	13	055	Chattooga County, GA	2007	NA	10922	10279	643	5.9
CN1305700000000	13	057	Cherokee County, GA	2007	NA	109716	105748	3968	3.6
CN1305900000000	13	059	Clarke County, GA	2007	NA	64398	61911	2487	3.9
CN1306100000000	13	061	Clay County, GA	2007	NA	1476	1394	82	5.6
CN1306300000000	13	063	Clayton County, GA	2007	NA	136206	128444	7762	5.7
CN1306500000000	13	065	Clinch County, GA	2007	NA	2763	2616	147	5.3
CN1306700000000	13	067	Cobb County, GA	2007	NA	380566	365319	15247	4
CN1306900000000	13	069	Coffee County, GA	2007	NA	16522	15547	975	5.9
CN1307100000000	13	071	Colquitt County, GA	2007	NA	20474	19561	913	4.5
CN1307300000000	13	073	Columbia County, GA	2007	NA	59917	57652	2265	3.8
CN1307500000000	13	075	Cook County, GA	2007	NA	7134	6731	403	5.6
CN1307700000000	13	077	Coweta County, GA	2007	NA	59681	57316	2365	4
CN1307900000000	13	079	Crawford County, GA	2007	NA	6124	5837	287	4.7
CN1308100000000	13	081	Crisp County, GA	2007	NA	10625	10011	614	5.8
CN1308300000000	13	083	Dade County, GA	2007	NA	8436	8080	356	4.2
CN1308500000000	13	085	Dawson County, GA	2007	NA	11103	10693	410	3.7
CN1308700000000	13	087	Decatur County, GA	2007	NA	11769	11062	707	6
CN1308900000000	13	089	DeKalb County, GA	2007	NA	393836	374934	18902	4.8
CN1309100000000	13	091	Dodge County, GA	2007	NA	9524	9051	473	5
CN1309300000000	13	093	Dooly County, GA	2007	NA	4927	4668	259	5.3
CN1309500000000	13	095	Dougherty County, GA	2007	NA	42009	39662	2347	5.6
CN1309700000000	13	097	Douglas County, GA	2007	NA	64829	61815	3014	4.6
CN1309900000000	13	099	Early County, GA	2007	NA	5334	5037	297	5.6
CN1310100000000	13	101	Echols County, GA	2007	NA	2251	2182	69	3.1
CN1310300000000	13	103	Effingham County, GA	2007	NA	28501	27560	941	3.3
CN1310500000000	13	105	Elbert County, GA	2007	NA	9862	9303	559	5.7
CN1310700000000	13	107	Emanuel County, GA	2007	NA	10829	10271	558	5.2
CN1310900000000	13	109	Evans County, GA	2007	NA	4985	4771	214	4.3
CN1311100000000	13	111	Fannin County, GA	2007	NA	11000	10588	412	3.7
CN1311300000000	13	113	Fayette County, GA	2007	NA	53556	51506	2050	3.8
CN1311500000000	13	115	Floyd County, GA	2007	NA	49791	47450	2341	4.7
CN1311700000000	13	117	Forsyth County, GA	2007	NA	84302	81520	2782	3.3
CN1311900000000	13	119	Franklin County, GA	2007	NA	10448	9938	510	4.9
CN1312100000000	13	121	Fulton County, GA	2007	NA	488891	465409	23482	4.8
CN1312300000000	13	123	Gilmer County, GA	2007	NA	14221	13715	506	3.6
CN1312500000000	13	125	Glascock County, GA	2007	NA	1119	1062	57	5.1
CN1312700000000	13	127	Glynn County, GA	2007	NA	40736	39275	1461	3.6
CN1312900000000	13	129	Gordon County, GA	2007	NA	26858	25598	1260	4.7
CN1313100000000	13	131	Grady County, GA	2007	NA	12272	11779	493	4
CN1313300000000	13	133	Greene County, GA	2007	NA	7458	7061	397	5.3
CN1313500000000	13	135	Gwinnett County, GA	2007	NA	421203	404504	16699	4
CN1313700000000	13	137	Habersham County, GA	2007	NA	20218	19416	802	4
CN1313900000000	13	139	Hall County, GA	2007	NA	90768	87514	3254	3.6
CN1314100000000	13	141	Hancock County, GA	2007	NA	3304	3027	277	8.4
CN1314300000000	13	143	Haralson County, GA	2007	NA	12872	12270	602	4.7
CN1314500000000	13	145	Harris County, GA	2007	NA	16064	15490	574	3.6
CN1314700000000	13	147	Hart County, GA	2007	NA	10834	10132	702	6.5
CN1314900000000	13	149	Heard County, GA	2007	NA	4900	4656	244	5
CN1315100000000	13	151	Henry County, GA	2007	NA	96909	92705	4204	4.3
CN1315300000000	13	153	Houston County, GA	2007	NA	68319	65683	2636	3.9
CN1315500000000	13	155	Irwin County, GA	2007	NA	4307	4048	259	6
CN1315700000000	13	157	Jackson County, GA	2007	NA	26964	25849	1115	4.1
CN1315900000000	13	159	Jasper County, GA	2007	NA	6438	6129	309	4.8
CN1316100000000	13	161	Jeff Davis County, GA	2007	NA	5267	4910	357	6.8
CN1316300000000	13	163	Jefferson County, GA	2007	NA	7098	6594	504	7.1
CN1316500000000	13	165	Jenkins County, GA	2007	NA	3329	3034	295	8.9
CN1316700000000	13	167	Johnson County, GA	2007	NA	3729	3511	218	5.8
CN1316900000000	13	169	Jones County, GA	2007	NA	14054	13460	594	4.2
CN1317100000000	13	171	Lamar County, GA	2007	NA	7923	7526	397	5
CN1317300000000	13	173	Lanier County, GA	2007	NA	4052	3902	150	3.7
CN1317500000000	13	175	Laurens County, GA	2007	NA	22430	21304	1126	5
CN1317700000000	13	177	Lee County, GA	2007	NA	17684	17042	642	3.6
CN1317900000000	13	179	Liberty County, GA	2007	NA	24269	23006	1263	5.2
CN1318100000000	13	181	Lincoln County, GA	2007	NA	3838	3617	221	5.8
CN1318300000000	13	183	Long County, GA	2007	NA	5928	5710	218	3.7
CN1318500000000	13	185	Lowndes County, GA	2007	NA	53698	51634	2064	3.8
CN1318700000000	13	187	Lumpkin County, GA	2007	NA	13154	12612	542	4.1
CN1318900000000	13	189	McDuffie County, GA	2007	NA	10595	9927	668	6.3
CN1319100000000	13	191	McIntosh County, GA	2007	NA	5398	5178	220	4.1
CN1319300000000	13	193	Macon County, GA	2007	NA	5089	4719	370	7.3
CN1319500000000	13	195	Madison County, GA	2007	NA	15835	15246	589	3.7
CN1319700000000	13	197	Marion County, GA	2007	NA	3322	3166	156	4.7
CN1319900000000	13	199	Meriwether County, GA	2007	NA	9572	9012	560	5.9
CN1320100000000	13	201	Miller County, GA	2007	NA	3579	3422	157	4.4
CN1320500000000	13	205	Mitchell County, GA	2007	NA	10420	9886	534	5.1
CN1320700000000	13	207	Monroe County, GA	2007	NA	13547	12994	553	4.1
CN1320900000000	13	209	Montgomery County, GA	2007	NA	4597	4385	212	4.6
CN1321100000000	13	211	Morgan County, GA	2007	NA	9498	9086	412	4.3
CN1321300000000	13	213	Murray County, GA	2007	NA	21072	20115	957	4.5
CN1321500000000	13	215	Muscogee County, GA	2007	NA	85604	81150	4454	5.2
CN1321700000000	13	217	Newton County, GA	2007	NA	46421	43991	2430	5.2
CN1321900000000	13	219	Oconee County, GA	2007	NA	18031	17496	535	3
CN1322100000000	13	221	Oglethorpe County, GA	2007	NA	7731	7434	297	3.8
CN1322300000000	13	223	Paulding County, GA	2007	NA	65995	63316	2679	4.1
CN1322500000000	13	225	Peach County, GA	2007	NA	11537	10909	628	5.4
CN1322700000000	13	227	Pickens County, GA	2007	NA	15150	14582	568	3.7
CN1322900000000	13	229	Pierce County, GA	2007	NA	8572	8235	337	3.9
CN1323100000000	13	231	Pike County, GA	2007	NA	8076	7734	342	4.2
CN1323300000000	13	233	Polk County, GA	2007	NA	20967	20035	932	4.4
CN1323500000000	13	235	Pulaski County, GA	2007	NA	4649	4465	184	4
CN1323700000000	13	237	Putnam County, GA	2007	NA	10414	9960	454	4.4
CN1323900000000	13	239	Quitman County, GA	2007	NA	1060	1003	57	5.4
CN1324100000000	13	241	Rabun County, GA	2007	NA	7277	6852	425	5.8
CN1324300000000	13	243	Randolph County, GA	2007	NA	2745	2568	177	6.4
CN1324500000000	13	245	Richmond County, GA	2007	NA	90907	85362	5545	6.1
CN1324700000000	13	247	Rockdale County, GA	2007	NA	40365	38349	2016	5
CN1324900000000	13	249	Schley County, GA	2007	NA	1823	1715	108	5.9
CN1325100000000	13	251	Screven County, GA	2007	NA	7239	6888	351	4.8
CN1325300000000	13	253	Seminole County, GA	2007	NA	3990	3773	217	5.4
CN1325500000000	13	255	Spalding County, GA	2007	NA	28269	26672	1597	5.6
CN1325700000000	13	257	Stephens County, GA	2007	NA	13590	12933	657	4.8
CN1325900000000	13	259	Stewart County, GA	2007	NA	2272	2129	143	6.3
CN1326100000000	13	261	Sumter County, GA	2007	NA	14796	13748	1048	7.1
CN1326300000000	13	263	Talbot County, GA	2007	NA	3160	2958	202	6.4
CN1326500000000	13	265	Taliaferro County, GA	2007	NA	848	781	67	7.9
CN1326700000000	13	267	Tattnall County, GA	2007	NA	9144	8708	436	4.8
CN1326900000000	13	269	Taylor County, GA	2007	NA	3333	3137	196	5.9
CN1327100000000	13	271	Telfair County, GA	2007	NA	4998	4612	386	7.7
CN1327300000000	13	273	Terrell County, GA	2007	NA	4430	4166	264	6
CN1327500000000	13	275	Thomas County, GA	2007	NA	22989	22047	942	4.1
CN1327700000000	13	277	Tift County, GA	2007	NA	19128	18121	1007	5.3
CN1327900000000	13	279	Toombs County, GA	2007	NA	13864	13209	655	4.7
CN1328100000000	13	281	Towns County, GA	2007	NA	6025	5803	222	3.7
CN1328300000000	13	283	Treutlen County, GA	2007	NA	2714	2557	157	5.8
CN1328500000000	13	285	Troup County, GA	2007	NA	30448	28721	1727	5.7
CN1328700000000	13	287	Turner County, GA	2007	NA	4942	4615	327	6.6
CN1328900000000	13	289	Twiggs County, GA	2007	NA	4668	4406	262	5.6
CN1329100000000	13	291	Union County, GA	2007	NA	11442	11029	413	3.6
CN1329300000000	13	293	Upson County, GA	2007	NA	12011	11244	767	6.4
CN1329500000000	13	295	Walker County, GA	2007	NA	33084	31617	1467	4.4
CN1329700000000	13	297	Walton County, GA	2007	NA	41084	39207	1877	4.6
CN1329900000000	13	299	Ware County, GA	2007	NA	15148	14411	737	4.9
CN1330100000000	13	301	Warren County, GA	2007	NA	2455	2271	184	7.5
CN1330300000000	13	303	Washington County, GA	2007	NA	8333	7863	470	5.6
CN1330500000000	13	305	Wayne County, GA	2007	NA	12072	11420	652	5.4
CN1330700000000	13	307	Webster County, GA	2007	NA	1246	1190	56	4.5
CN1330900000000	13	309	Wheeler County, GA	2007	NA	2965	2813	152	5.1
CN1331100000000	13	311	White County, GA	2007	NA	12910	12448	462	3.6
CN1331300000000	13	313	Whitfield County, GA	2007	NA	47042	44901	2141	4.6
CN1331500000000	13	315	Wilcox County, GA	2007	NA	3302	3109	193	5.8
CN1331700000000	13	317	Wilkes County, GA	2007	NA	4572	4269	303	6.6
CN1331900000000	13	319	Wilkinson County, GA	2007	NA	4584	4337	247	5.4
CN1332100000000	13	321	Worth County, GA	2007	NA	10184	9640	544	5.3
CN1500100000000	15	001	Hawaii County, HI	2007	NA	84784	81772	3012	3.6
CN1500300000000	15	003	Honolulu County/city, HI	2007	NA	442512	430846	11666	2.6
CN1500700000000	15	007	Kauai County, HI	2007	NA	32665	31783	882	2.7
CN1500900000000	15	009	Maui County, HI	2007	NA	78434	76134	2300	2.9
CN1600100000000	16	001	Ada County, ID	2007	NA	196740	191500	5240	2.7
CN1600300000000	16	003	Adams County, ID	2007	NA	1999	1884	115	5.8
CN1600500000000	16	005	Bannock County, ID	2007	NA	41291	40063	1228	3
CN1600700000000	16	007	Bear Lake County, ID	2007	NA	3158	3085	73	2.3
CN1600900000000	16	009	Benewah County, ID	2007	NA	4061	3811	250	6.2
CN1601100000000	16	011	Bingham County, ID	2007	NA	22242	21652	590	2.7
CN1601300000000	16	013	Blaine County, ID	2007	NA	13677	13356	321	2.3
CN1601500000000	16	015	Boise County, ID	2007	NA	3576	3453	123	3.4
CN1601700000000	16	017	Bonner County, ID	2007	NA	20645	19845	800	3.9
CN1601900000000	16	019	Bonneville County, ID	2007	NA	50283	49166	1117	2.2
CN1602100000000	16	021	Boundary County, ID	2007	NA	4576	4291	285	6.2
CN1602300000000	16	023	Butte County, ID	2007	NA	1369	1335	34	2.5
CN1602500000000	16	025	Camas County, ID	2007	NA	618	602	16	2.6
CN1602700000000	16	027	Canyon County, ID	2007	NA	83264	80180	3084	3.7
CN1602900000000	16	029	Caribou County, ID	2007	NA	3863	3752	111	2.9
CN1603100000000	16	031	Cassia County, ID	2007	NA	10795	10453	342	3.2
CN1603300000000	16	033	Clark County, ID	2007	NA	554	541	13	2.3
CN1603500000000	16	035	Clearwater County, ID	2007	NA	3208	2967	241	7.5
CN1603700000000	16	037	Custer County, ID	2007	NA	2329	2249	80	3.4
CN1603900000000	16	039	Elmore County, ID	2007	NA	11249	10809	440	3.9
CN1604100000000	16	041	Franklin County, ID	2007	NA	5751	5626	125	2.2
CN1604300000000	16	043	Fremont County, ID	2007	NA	5777	5586	191	3.3
CN1604500000000	16	045	Gem County, ID	2007	NA	7098	6826	272	3.8
CN1604700000000	16	047	Gooding County, ID	2007	NA	8805	8612	193	2.2
CN1604900000000	16	049	Idaho County, ID	2007	NA	7079	6717	362	5.1
CN1605100000000	16	051	Jefferson County, ID	2007	NA	11121	10847	274	2.5
CN1605300000000	16	053	Jerome County, ID	2007	NA	9827	9546	281	2.9
CN1605500000000	16	055	Kootenai County, ID	2007	NA	69433	67106	2327	3.4
CN1605700000000	16	057	Latah County, ID	2007	NA	17003	16534	469	2.8
CN1605900000000	16	059	Lemhi County, ID	2007	NA	3745	3572	173	4.6
CN1606100000000	16	061	Lewis County, ID	2007	NA	1703	1658	45	2.6
CN1606300000000	16	063	Lincoln County, ID	2007	NA	2565	2476	89	3.5
CN1606500000000	16	065	Madison County, ID	2007	NA	16441	16085	356	2.2
CN1606700000000	16	067	Minidoka County, ID	2007	NA	10051	9659	392	3.9
CN1606900000000	16	069	Nez Perce County, ID	2007	NA	19011	18437	574	3
CN1607100000000	16	071	Oneida County, ID	2007	NA	2381	2339	42	1.8
CN1607300000000	16	073	Owyhee County, ID	2007	NA	4488	4402	86	1.9
CN1607500000000	16	075	Payette County, ID	2007	NA	10520	10076	444	4.2
CN1607700000000	16	077	Power County, ID	2007	NA	3753	3602	151	4
CN1607900000000	16	079	Shoshone County, ID	2007	NA	5864	5552	312	5.3
CN1608100000000	16	081	Teton County, ID	2007	NA	5069	4983	86	1.7
CN1608300000000	16	083	Twin Falls County, ID	2007	NA	37746	36699	1047	2.8
CN1608500000000	16	085	Valley County, ID	2007	NA	5021	4812	209	4.2
CN1608700000000	16	087	Washington County, ID	2007	NA	4687	4489	198	4.2
CN1700100000000	17	001	Adams County, IL	2007	NA	39619	38088	1531	3.9
CN1700300000000	17	003	Alexander County, IL	2007	NA	3279	3011	268	8.2
CN1700500000000	17	005	Bond County, IL	2007	NA	8771	8320	451	5.1
CN1700700000000	17	007	Boone County, IL	2007	NA	26764	25014	1750	6.5
CN1700900000000	17	009	Brown County, IL	2007	NA	3479	3384	95	2.7
CN1701100000000	17	011	Bureau County, IL	2007	NA	19494	18551	943	4.8
CN1701300000000	17	013	Calhoun County, IL	2007	NA	2656	2482	174	6.6
CN1701500000000	17	015	Carroll County, IL	2007	NA	8768	8330	438	5
CN1701700000000	17	017	Cass County, IL	2007	NA	7713	7384	329	4.3
CN1701900000000	17	019	Champaign County, IL	2007	NA	105132	100739	4393	4.2
CN1702100000000	17	021	Christian County, IL	2007	NA	17998	17103	895	5
CN1702300000000	17	023	Clark County, IL	2007	NA	8979	8484	495	5.5
CN1702500000000	17	025	Clay County, IL	2007	NA	7003	6618	385	5.5
CN1702700000000	17	027	Clinton County, IL	2007	NA	19352	18446	906	4.7
CN1702900000000	17	029	Coles County, IL	2007	NA	27971	26756	1215	4.3
CN1703100000000	17	031	Cook County, IL	2007	NA	2615750	2478215	137535	5.3
CN1703300000000	17	033	Crawford County, IL	2007	NA	9821	9290	531	5.4
CN1703500000000	17	035	Cumberland County, IL	2007	NA	5806	5513	293	5
CN1703700000000	17	037	DeKalb County, IL	2007	NA	59179	56635	2544	4.3
CN1703900000000	17	039	De Witt County, IL	2007	NA	8604	8191	413	4.8
CN1704100000000	17	041	Douglas County, IL	2007	NA	10561	10114	447	4.2
CN1704300000000	17	043	DuPage County, IL	2007	NA	530011	509543	20468	3.9
CN1704500000000	17	045	Edgar County, IL	2007	NA	10614	10072	542	5.1
CN1704700000000	17	047	Edwards County, IL	2007	NA	3457	3289	168	4.9
CN1704900000000	17	049	Effingham County, IL	2007	NA	18869	18109	760	4
CN1705100000000	17	051	Fayette County, IL	2007	NA	10344	9698	646	6.2
CN1705300000000	17	053	Ford County, IL	2007	NA	7350	6988	362	4.9
CN1705500000000	17	055	Franklin County, IL	2007	NA	18270	16848	1422	7.8
CN1705700000000	17	057	Fulton County, IL	2007	NA	17927	16985	942	5.3
CN1705900000000	17	059	Gallatin County, IL	2007	NA	2666	2502	164	6.2
CN1706100000000	17	061	Greene County, IL	2007	NA	7183	6827	356	5
CN1706300000000	17	063	Grundy County, IL	2007	NA	25757	24282	1475	5.7
CN1706500000000	17	065	Hamilton County, IL	2007	NA	4312	4072	240	5.6
CN1706700000000	17	067	Hancock County, IL	2007	NA	9979	9443	536	5.4
CN1706900000000	17	069	Hardin County, IL	2007	NA	1712	1574	138	8.1
CN1707100000000	17	071	Henderson County, IL	2007	NA	4059	3844	215	5.3
CN1707300000000	17	073	Henry County, IL	2007	NA	27831	26504	1327	4.8
CN1707500000000	17	075	Iroquois County, IL	2007	NA	16821	15985	836	5
CN1707700000000	17	077	Jackson County, IL	2007	NA	33163	31649	1514	4.6
CN1707900000000	17	079	Jasper County, IL	2007	NA	5207	4941	266	5.1
CN1708100000000	17	081	Jefferson County, IL	2007	NA	21365	20318	1047	4.9
CN1708300000000	17	083	Jersey County, IL	2007	NA	11867	11230	637	5.4
CN1708500000000	17	085	Jo Daviess County, IL	2007	NA	13790	13237	553	4
CN1708700000000	17	087	Johnson County, IL	2007	NA	5286	4954	332	6.3
CN1708900000000	17	089	Kane County, IL	2007	NA	269449	257360	12089	4.5
CN1709100000000	17	091	Kankakee County, IL	2007	NA	55889	52393	3496	6.3
CN1709300000000	17	093	Kendall County, IL	2007	NA	55716	53308	2408	4.3
CN1709500000000	17	095	Knox County, IL	2007	NA	25636	24356	1280	5
CN1709700000000	17	097	Lake County, IL	2007	NA	372457	354669	17788	4.8
CN1709900000000	17	099	LaSalle County, IL	2007	NA	59225	55708	3517	5.9
CN1710100000000	17	101	Lawrence County, IL	2007	NA	8422	8020	402	4.8
CN1710300000000	17	103	Lee County, IL	2007	NA	18624	17687	937	5
CN1710500000000	17	105	Livingston County, IL	2007	NA	19679	18808	871	4.4
CN1710700000000	17	107	Logan County, IL	2007	NA	13537	12891	646	4.8
CN1710900000000	17	109	McDonough County, IL	2007	NA	17292	16563	729	4.2
CN1711100000000	17	111	McHenry County, IL	2007	NA	178885	171106	7779	4.3
CN1711300000000	17	113	McLean County, IL	2007	NA	90552	87179	3373	3.7
CN1711500000000	17	115	Macon County, IL	2007	NA	54603	51550	3053	5.6
CN1711700000000	17	117	Macoupin County, IL	2007	NA	24830	23361	1469	5.9
CN1711900000000	17	119	Madison County, IL	2007	NA	141006	133485	7521	5.3
CN1712100000000	17	121	Marion County, IL	2007	NA	18907	17709	1198	6.3
CN1712300000000	17	123	Marshall County, IL	2007	NA	7345	7027	318	4.3
CN1712500000000	17	125	Mason County, IL	2007	NA	7425	6943	482	6.5
CN1712700000000	17	127	Massac County, IL	2007	NA	7668	7240	428	5.6
CN1712900000000	17	129	Menard County, IL	2007	NA	6978	6671	307	4.4
CN1713100000000	17	131	Mercer County, IL	2007	NA	8990	8508	482	5.4
CN1713300000000	17	133	Monroe County, IL	2007	NA	18611	17829	782	4.2
CN1713500000000	17	135	Montgomery County, IL	2007	NA	13676	12784	892	6.5
CN1713700000000	17	137	Morgan County, IL	2007	NA	18106	17225	881	4.9
CN1713900000000	17	139	Moultrie County, IL	2007	NA	8192	7897	295	3.6
CN1714100000000	17	141	Ogle County, IL	2007	NA	28026	26481	1545	5.5
CN1714300000000	17	143	Peoria County, IL	2007	NA	97797	93323	4474	4.6
CN1714500000000	17	145	Perry County, IL	2007	NA	10033	9209	824	8.2
CN1714700000000	17	147	Piatt County, IL	2007	NA	9084	8742	342	3.8
CN1714900000000	17	149	Pike County, IL	2007	NA	8797	8400	397	4.5
CN1715100000000	17	151	Pope County, IL	2007	NA	1976	1839	137	6.9
CN1715300000000	17	153	Pulaski County, IL	2007	NA	2946	2738	208	7.1
CN1715500000000	17	155	Putnam County, IL	2007	NA	3235	3049	186	5.7
CN1715700000000	17	157	Randolph County, IL	2007	NA	15727	14913	814	5.2
CN1715900000000	17	159	Richland County, IL	2007	NA	7836	7471	365	4.7
CN1716100000000	17	161	Rock Island County, IL	2007	NA	80369	76766	3603	4.5
CN1716300000000	17	163	St. Clair County, IL	2007	NA	125692	118080	7612	6.1
CN1716500000000	17	165	Saline County, IL	2007	NA	12751	11941	810	6.4
CN1716700000000	17	167	Sangamon County, IL	2007	NA	108005	103218	4787	4.4
CN1716900000000	17	169	Schuyler County, IL	2007	NA	4447	4269	178	4
CN1717100000000	17	171	Scott County, IL	2007	NA	2790	2648	142	5.1
CN1717300000000	17	173	Shelby County, IL	2007	NA	11259	10721	538	4.8
CN1717500000000	17	175	Stark County, IL	2007	NA	3004	2852	152	5.1
CN1717700000000	17	177	Stephenson County, IL	2007	NA	25541	24248	1293	5.1
CN1717900000000	17	179	Tazewell County, IL	2007	NA	73660	70563	3097	4.2
CN1718100000000	17	181	Union County, IL	2007	NA	8437	7863	574	6.8
CN1718300000000	17	183	Vermilion County, IL	2007	NA	37863	35545	2318	6.1
CN1718500000000	17	185	Wabash County, IL	2007	NA	6438	6088	350	5.4
CN1718700000000	17	187	Warren County, IL	2007	NA	9232	8822	410	4.4
CN1718900000000	17	189	Washington County, IL	2007	NA	8553	8165	388	4.5
CN1719100000000	17	191	Wayne County, IL	2007	NA	8444	8048	396	4.7
CN1719300000000	17	193	White County, IL	2007	NA	8035	7626	409	5.1
CN1719500000000	17	195	Whiteside County, IL	2007	NA	30904	29275	1629	5.3
CN1719700000000	17	197	Will County, IL	2007	NA	361414	344122	17292	4.8
CN1719900000000	17	199	Williamson County, IL	2007	NA	36347	34021	2326	6.4
CN1720100000000	17	201	Winnebago County, IL	2007	NA	149201	140334	8867	5.9
CN1720300000000	17	203	Woodford County, IL	2007	NA	21530	20794	736	3.4
CN1800100000000	18	001	Adams County, IN	2007	NA	15959	15277	682	4.3
CN1800300000000	18	003	Allen County, IN	2007	NA	180707	172101	8606	4.8
CN1800500000000	18	005	Bartholomew County, IN	2007	NA	38544	37156	1388	3.6
CN1800700000000	18	007	Benton County, IN	2007	NA	4337	4146	191	4.4
CN1800900000000	18	009	Blackford County, IN	2007	NA	6550	6172	378	5.8
CN1801100000000	18	011	Boone County, IN	2007	NA	27960	26995	965	3.5
CN1801300000000	18	013	Brown County, IN	2007	NA	7614	7280	334	4.4
CN1801500000000	18	015	Carroll County, IN	2007	NA	9926	9523	403	4.1
CN1801700000000	18	017	Cass County, IN	2007	NA	18673	17758	915	4.9
CN1801900000000	18	019	Clark County, IN	2007	NA	55140	52748	2392	4.3
CN1802100000000	18	021	Clay County, IN	2007	NA	12878	12132	746	5.8
CN1802300000000	18	023	Clinton County, IN	2007	NA	16769	16013	756	4.5
CN1802500000000	18	025	Crawford County, IN	2007	NA	5238	4920	318	6.1
CN1802700000000	18	027	Daviess County, IN	2007	NA	15123	14660	463	3.1
CN1802900000000	18	029	Dearborn County, IN	2007	NA	26093	24778	1315	5
CN1803100000000	18	031	Decatur County, IN	2007	NA	12309	11751	558	4.5
CN1803300000000	18	033	DeKalb County, IN	2007	NA	20698	19564	1134	5.5
CN1803500000000	18	035	Delaware County, IN	2007	NA	55139	52222	2917	5.3
CN1803700000000	18	037	Dubois County, IN	2007	NA	22150	21470	680	3.1
CN1803900000000	18	039	Elkhart County, IN	2007	NA	101303	96658	4645	4.6
CN1804100000000	18	041	Fayette County, IN	2007	NA	10431	9675	756	7.2
CN1804300000000	18	043	Floyd County, IN	2007	NA	37949	36375	1574	4.1
CN1804500000000	18	045	Fountain County, IN	2007	NA	8652	8289	363	4.2
CN1804700000000	18	047	Franklin County, IN	2007	NA	11785	11135	650	5.5
CN1804900000000	18	049	Fulton County, IN	2007	NA	10364	9863	501	4.8
CN1805100000000	18	051	Gibson County, IN	2007	NA	16759	15994	765	4.6
CN1805300000000	18	053	Grant County, IN	2007	NA	31680	29731	1949	6.2
CN1805500000000	18	055	Greene County, IN	2007	NA	15810	15000	810	5.1
CN1805700000000	18	057	Hamilton County, IN	2007	NA	140741	136618	4123	2.9
CN1805900000000	18	059	Hancock County, IN	2007	NA	35818	34470	1348	3.8
CN1806100000000	18	061	Harrison County, IN	2007	NA	19410	18538	872	4.5
CN1806300000000	18	063	Hendricks County, IN	2007	NA	72418	70048	2370	3.3
CN1806500000000	18	065	Henry County, IN	2007	NA	22464	21164	1300	5.8
CN1806700000000	18	067	Howard County, IN	2007	NA	37588	35523	2065	5.5
CN1806900000000	18	069	Huntington County, IN	2007	NA	20025	19076	949	4.7
CN1807100000000	18	071	Jackson County, IN	2007	NA	21892	21036	856	3.9
CN1807300000000	18	073	Jasper County, IN	2007	NA	15511	14775	736	4.7
CN1807500000000	18	075	Jay County, IN	2007	NA	11609	11105	504	4.3
CN1807700000000	18	077	Jefferson County, IN	2007	NA	17081	16243	838	4.9
CN1807900000000	18	079	Jennings County, IN	2007	NA	13665	12964	701	5.1
CN1808100000000	18	081	Johnson County, IN	2007	NA	73207	70649	2558	3.5
CN1808300000000	18	083	Knox County, IN	2007	NA	19724	18934	790	4
CN1808500000000	18	085	Kosciusko County, IN	2007	NA	41085	39272	1813	4.4
CN1808700000000	18	087	LaGrange County, IN	2007	NA	17028	16196	832	4.9
CN1808900000000	18	089	Lake County, IN	2007	NA	226108	214416	11692	5.2
CN1809100000000	18	091	LaPorte County, IN	2007	NA	52577	49915	2662	5.1
CN1809300000000	18	093	Lawrence County, IN	2007	NA	22133	20696	1437	6.5
CN1809500000000	18	095	Madison County, IN	2007	NA	60540	56701	3839	6.3
CN1809700000000	18	097	Marion County, IN	2007	NA	460046	439218	20828	4.5
CN1809900000000	18	099	Marshall County, IN	2007	NA	22795	21693	1102	4.8
CN1810100000000	18	101	Martin County, IN	2007	NA	5133	4933	200	3.9
CN1810300000000	18	103	Miami County, IN	2007	NA	16465	15532	933	5.7
CN1810500000000	18	105	Monroe County, IN	2007	NA	68676	66116	2560	3.7
CN1810700000000	18	107	Montgomery County, IN	2007	NA	19251	18509	742	3.9
CN1810900000000	18	109	Morgan County, IN	2007	NA	36810	35273	1537	4.2
CN1811100000000	18	111	Newton County, IN	2007	NA	6967	6601	366	5.3
CN1811300000000	18	113	Noble County, IN	2007	NA	23161	21903	1258	5.4
CN1811500000000	18	115	Ohio County, IN	2007	NA	3026	2877	149	4.9
CN1811700000000	18	117	Orange County, IN	2007	NA	10455	9918	537	5.1
CN1811900000000	18	119	Owen County, IN	2007	NA	11192	10641	551	4.9
CN1812100000000	18	121	Parke County, IN	2007	NA	8025	7626	399	5
CN1812300000000	18	123	Perry County, IN	2007	NA	9706	9275	431	4.4
CN1812500000000	18	125	Pike County, IN	2007	NA	6007	5749	258	4.3
CN1812700000000	18	127	Porter County, IN	2007	NA	83076	79893	3183	3.8
CN1812900000000	18	129	Posey County, IN	2007	NA	13364	12796	568	4.3
CN1813100000000	18	131	Pulaski County, IN	2007	NA	6800	6518	282	4.1
CN1813300000000	18	133	Putnam County, IN	2007	NA	17518	16581	937	5.3
CN1813500000000	18	135	Randolph County, IN	2007	NA	12656	11942	714	5.6
CN1813700000000	18	137	Ripley County, IN	2007	NA	13911	13280	631	4.5
CN1813900000000	18	139	Rush County, IN	2007	NA	9448	9020	428	4.5
CN1814100000000	18	141	St. Joseph County, IN	2007	NA	132785	126293	6492	4.9
CN1814300000000	18	143	Scott County, IN	2007	NA	11053	10473	580	5.2
CN1814500000000	18	145	Shelby County, IN	2007	NA	23582	22557	1025	4.3
CN1814700000000	18	147	Spencer County, IN	2007	NA	10427	9992	435	4.2
CN1814900000000	18	149	Starke County, IN	2007	NA	10453	9835	618	5.9
CN1815100000000	18	151	Steuben County, IN	2007	NA	16494	15506	988	6
CN1815300000000	18	153	Sullivan County, IN	2007	NA	8918	8426	492	5.5
CN1815500000000	18	155	Switzerland County, IN	2007	NA	5687	5466	221	3.9
CN1815700000000	18	157	Tippecanoe County, IN	2007	NA	81511	78292	3219	3.9
CN1815900000000	18	159	Tipton County, IN	2007	NA	7708	7349	359	4.7
CN1816100000000	18	161	Union County, IN	2007	NA	3619	3449	170	4.7
CN1816300000000	18	163	Vanderburgh County, IN	2007	NA	90815	86554	4261	4.7
CN1816500000000	18	165	Vermillion County, IN	2007	NA	7890	7447	443	5.6
CN1816700000000	18	167	Vigo County, IN	2007	NA	50120	47466	2654	5.3
CN1816900000000	18	169	Wabash County, IN	2007	NA	16993	16173	820	4.8
CN1817100000000	18	171	Warren County, IN	2007	NA	4991	4831	160	3.2
CN1817300000000	18	173	Warrick County, IN	2007	NA	30489	29304	1185	3.9
CN1817500000000	18	175	Washington County, IN	2007	NA	14011	13277	734	5.2
CN1817700000000	18	177	Wayne County, IN	2007	NA	33800	31984	1816	5.4
CN1817900000000	18	179	Wells County, IN	2007	NA	14671	14062	609	4.2
CN1818100000000	18	181	White County, IN	2007	NA	12286	11744	542	4.4
CN1818300000000	18	183	Whitley County, IN	2007	NA	17736	16943	793	4.5
CN1900100000000	19	001	Adair County, IA	2007	NA	4400	4246	154	3.5
CN1900300000000	19	003	Adams County, IA	2007	NA	2099	2012	87	4.1
CN1900500000000	19	005	Allamakee County, IA	2007	NA	8163	7775	388	4.8
CN1900700000000	19	007	Appanoose County, IA	2007	NA	5958	5551	407	6.8
CN1900900000000	19	009	Audubon County, IA	2007	NA	3276	3148	128	3.9
CN1901100000000	19	011	Benton County, IA	2007	NA	14271	13716	555	3.9
CN1901300000000	19	013	Black Hawk County, IA	2007	NA	72687	69979	2708	3.7
CN1901500000000	19	015	Boone County, IA	2007	NA	15484	14979	505	3.3
CN1901700000000	19	017	Bremer County, IA	2007	NA	13831	13401	430	3.1
CN1901900000000	19	019	Buchanan County, IA	2007	NA	11031	10571	460	4.2
CN1902100000000	19	021	Buena Vista County, IA	2007	NA	10388	10060	328	3.2
CN1902300000000	19	023	Butler County, IA	2007	NA	8260	7929	331	4
CN1902500000000	19	025	Calhoun County, IA	2007	NA	5215	5045	170	3.3
CN1902700000000	19	027	Carroll County, IA	2007	NA	12239	11918	321	2.6
CN1902900000000	19	029	Cass County, IA	2007	NA	7605	7291	314	4.1
CN1903100000000	19	031	Cedar County, IA	2007	NA	10899	10547	352	3.2
CN1903300000000	19	033	Cerro Gordo County, IA	2007	NA	25646	24645	1001	3.9
CN1903500000000	19	035	Cherokee County, IA	2007	NA	6624	6385	239	3.6
CN1903700000000	19	037	Chickasaw County, IA	2007	NA	6535	6263	272	4.2
CN1903900000000	19	039	Clarke County, IA	2007	NA	4826	4626	200	4.1
CN1904100000000	19	041	Clay County, IA	2007	NA	9756	9453	303	3.1
CN1904300000000	19	043	Clayton County, IA	2007	NA	9742	9273	469	4.8
CN1904500000000	19	045	Clinton County, IA	2007	NA	27443	26422	1021	3.7
CN1904700000000	19	047	Crawford County, IA	2007	NA	9302	8996	306	3.3
CN1904900000000	19	049	Dallas County, IA	2007	NA	32546	31617	929	2.9
CN1905100000000	19	051	Davis County, IA	2007	NA	4080	3896	184	4.5
CN1905300000000	19	053	Decatur County, IA	2007	NA	4196	4026	170	4.1
CN1905500000000	19	055	Delaware County, IA	2007	NA	10770	10388	382	3.5
CN1905700000000	19	057	Des Moines County, IA	2007	NA	21064	20134	930	4.4
CN1905900000000	19	059	Dickinson County, IA	2007	NA	9744	9364	380	3.9
CN1906100000000	19	061	Dubuque County, IA	2007	NA	52040	49974	2066	4
CN1906300000000	19	063	Emmet County, IA	2007	NA	5928	5710	218	3.7
CN1906500000000	19	065	Fayette County, IA	2007	NA	10903	10425	478	4.4
CN1906700000000	19	067	Floyd County, IA	2007	NA	8712	8323	389	4.5
CN1906900000000	19	069	Franklin County, IA	2007	NA	5964	5755	209	3.5
CN1907100000000	19	071	Fremont County, IA	2007	NA	3957	3798	159	4
CN1907300000000	19	073	Greene County, IA	2007	NA	4989	4813	176	3.5
CN1907500000000	19	075	Grundy County, IA	2007	NA	6805	6589	216	3.2
CN1907700000000	19	077	Guthrie County, IA	2007	NA	5857	5634	223	3.8
CN1907900000000	19	079	Hamilton County, IA	2007	NA	8645	8369	276	3.2
CN1908100000000	19	081	Hancock County, IA	2007	NA	6038	5811	227	3.8
CN1908300000000	19	083	Hardin County, IA	2007	NA	9057	8714	343	3.8
CN1908500000000	19	085	Harrison County, IA	2007	NA	7780	7455	325	4.2
CN1908700000000	19	087	Henry County, IA	2007	NA	10313	9830	483	4.7
CN1908900000000	19	089	Howard County, IA	2007	NA	5243	5052	191	3.6
CN1909100000000	19	091	Humboldt County, IA	2007	NA	5199	5039	160	3.1
CN1909300000000	19	093	Ida County, IA	2007	NA	4035	3901	134	3.3
CN1909500000000	19	095	Iowa County, IA	2007	NA	8612	8295	317	3.7
CN1909700000000	19	097	Jackson County, IA	2007	NA	11174	10654	520	4.7
CN1909900000000	19	099	Jasper County, IA	2007	NA	17936	16803	1133	6.3
CN1910100000000	19	101	Jefferson County, IA	2007	NA	8370	8027	343	4.1
CN1910300000000	19	103	Johnson County, IA	2007	NA	77590	75493	2097	2.7
CN1910500000000	19	105	Jones County, IA	2007	NA	10453	10021	432	4.1
CN1910700000000	19	107	Keokuk County, IA	2007	NA	5629	5394	235	4.2
CN1910900000000	19	109	Kossuth County, IA	2007	NA	8980	8658	322	3.6
CN1911100000000	19	111	Lee County, IA	2007	NA	17332	16341	991	5.7
CN1911300000000	19	113	Linn County, IA	2007	NA	118163	113836	4327	3.7
CN1911500000000	19	115	Louisa County, IA	2007	NA	6431	6196	235	3.7
CN1911700000000	19	117	Lucas County, IA	2007	NA	4774	4590	184	3.9
CN1911900000000	19	119	Lyon County, IA	2007	NA	6681	6521	160	2.4
CN1912100000000	19	121	Madison County, IA	2007	NA	8278	7937	341	4.1
CN1912300000000	19	123	Mahaska County, IA	2007	NA	11747	11322	425	3.6
CN1912500000000	19	125	Marion County, IA	2007	NA	17815	17179	636	3.6
CN1912700000000	19	127	Marshall County, IA	2007	NA	20469	19644	825	4
CN1912900000000	19	129	Mills County, IA	2007	NA	8086	7787	299	3.7
CN1913100000000	19	131	Mitchell County, IA	2007	NA	5571	5386	185	3.3
CN1913300000000	19	133	Monona County, IA	2007	NA	4585	4334	251	5.5
CN1913500000000	19	135	Monroe County, IA	2007	NA	4174	4002	172	4.1
CN1913700000000	19	137	Montgomery County, IA	2007	NA	5554	5209	345	6.2
CN1913900000000	19	139	Muscatine County, IA	2007	NA	23997	23188	809	3.4
CN1914100000000	19	141	O'Brien County, IA	2007	NA	7741	7508	233	3
CN1914300000000	19	143	Osceola County, IA	2007	NA	3349	3238	111	3.3
CN1914500000000	19	145	Page County, IA	2007	NA	8375	7991	384	4.6
CN1914700000000	19	147	Palo Alto County, IA	2007	NA	5437	5254	183	3.4
CN1914900000000	19	149	Plymouth County, IA	2007	NA	14433	13994	439	3
CN1915100000000	19	151	Pocahontas County, IA	2007	NA	4132	4001	131	3.2
CN1915300000000	19	153	Polk County, IA	2007	NA	237576	229306	8270	3.5
CN1915500000000	19	155	Pottawattamie County, IA	2007	NA	48121	46077	2044	4.2
CN1915700000000	19	157	Poweshiek County, IA	2007	NA	10749	10329	420	3.9
CN1915900000000	19	159	Ringgold County, IA	2007	NA	2455	2353	102	4.2
CN1916100000000	19	161	Sac County, IA	2007	NA	5798	5599	199	3.4
CN1916300000000	19	163	Scott County, IA	2007	NA	88870	85553	3317	3.7
CN1916500000000	19	165	Shelby County, IA	2007	NA	7539	7295	244	3.2
CN1916700000000	19	167	Sioux County, IA	2007	NA	19339	18850	489	2.5
CN1916900000000	19	169	Story County, IA	2007	NA	48044	46713	1331	2.8
CN1917100000000	19	171	Tama County, IA	2007	NA	8983	8594	389	4.3
CN1917300000000	19	173	Taylor County, IA	2007	NA	3357	3221	136	4.1
CN1917500000000	19	175	Union County, IA	2007	NA	6580	6312	268	4.1
CN1917700000000	19	177	Van Buren County, IA	2007	NA	3951	3783	168	4.3
CN1917900000000	19	179	Wapello County, IA	2007	NA	18850	18034	816	4.3
CN1918100000000	19	181	Warren County, IA	2007	NA	25475	24644	831	3.3
CN1918300000000	19	183	Washington County, IA	2007	NA	11943	11536	407	3.4
CN1918500000000	19	185	Wayne County, IA	2007	NA	3208	3063	145	4.5
CN1918700000000	19	187	Webster County, IA	2007	NA	19830	19045	785	4
CN1918900000000	19	189	Winnebago County, IA	2007	NA	5767	5568	199	3.5
CN1919100000000	19	191	Winneshiek County, IA	2007	NA	12425	11973	452	3.6
CN1919300000000	19	193	Woodbury County, IA	2007	NA	54875	52748	2127	3.9
CN1919500000000	19	195	Worth County, IA	2007	NA	4525	4356	169	3.7
CN1919700000000	19	197	Wright County, IA	2007	NA	7003	6729	274	3.9
CN2000100000000	20	001	Allen County, KS	2007	NA	7497	7194	303	4
CN2000300000000	20	003	Anderson County, KS	2007	NA	4144	3949	195	4.7
CN2000500000000	20	005	Atchison County, KS	2007	NA	8781	8376	405	4.6
CN2000700000000	20	007	Barber County, KS	2007	NA	2618	2534	84	3.2
CN2000900000000	20	009	Barton County, KS	2007	NA	14869	14351	518	3.5
CN2001100000000	20	011	Bourbon County, KS	2007	NA	8857	8465	392	4.4
CN2001300000000	20	013	Brown County, KS	2007	NA	5509	5282	227	4.1
CN2001500000000	20	015	Butler County, KS	2007	NA	32414	31075	1339	4.1
CN2001700000000	20	017	Chase County, KS	2007	NA	1584	1520	64	4
CN2001900000000	20	019	Chautauqua County, KS	2007	NA	1781	1697	84	4.7
CN2002100000000	20	021	Cherokee County, KS	2007	NA	11108	10565	543	4.9
CN2002300000000	20	023	Cheyenne County, KS	2007	NA	1416	1366	50	3.5
CN2002500000000	20	025	Clark County, KS	2007	NA	1206	1169	37	3.1
CN2002700000000	20	027	Clay County, KS	2007	NA	5067	4897	170	3.4
CN2002900000000	20	029	Cloud County, KS	2007	NA	5590	5391	199	3.6
CN2003100000000	20	031	Coffey County, KS	2007	NA	5101	4871	230	4.5
CN2003300000000	20	033	Comanche County, KS	2007	NA	1079	1046	33	3.1
CN2003500000000	20	035	Cowley County, KS	2007	NA	18211	17486	725	4
CN2003700000000	20	037	Crawford County, KS	2007	NA	20216	19230	986	4.9
CN2003900000000	20	039	Decatur County, KS	2007	NA	1664	1612	52	3.1
CN2004100000000	20	041	Dickinson County, KS	2007	NA	10611	10199	412	3.9
CN2004300000000	20	043	Doniphan County, KS	2007	NA	4551	4333	218	4.8
CN2004500000000	20	045	Douglas County, KS	2007	NA	62110	59692	2418	3.9
CN2004700000000	20	047	Edwards County, KS	2007	NA	1636	1580	56	3.4
CN2004900000000	20	049	Elk County, KS	2007	NA	1423	1341	82	5.8
CN2005100000000	20	051	Ellis County, KS	2007	NA	17143	16666	477	2.8
CN2005300000000	20	053	Ellsworth County, KS	2007	NA	3690	3566	124	3.4
CN2005500000000	20	055	Finney County, KS	2007	NA	17903	17291	612	3.4
CN2005700000000	20	057	Ford County, KS	2007	NA	16647	16121	526	3.2
CN2005900000000	20	059	Franklin County, KS	2007	NA	13817	13115	702	5.1
CN2006100000000	20	061	Geary County, KS	2007	NA	11921	11397	524	4.4
CN2006300000000	20	063	Gove County, KS	2007	NA	1502	1457	45	3
CN2006500000000	20	065	Graham County, KS	2007	NA	1481	1435	46	3.1
CN2006700000000	20	067	Grant County, KS	2007	NA	3957	3845	112	2.8
CN2006900000000	20	069	Gray County, KS	2007	NA	3155	3071	84	2.7
CN2007100000000	20	071	Greeley County, KS	2007	NA	698	675	23	3.3
CN2007300000000	20	073	Greenwood County, KS	2007	NA	3570	3404	166	4.6
CN2007500000000	20	075	Hamilton County, KS	2007	NA	1250	1207	43	3.4
CN2007700000000	20	077	Harper County, KS	2007	NA	3395	3292	103	3
CN2007900000000	20	079	Harvey County, KS	2007	NA	17969	17301	668	3.7
CN2008100000000	20	081	Haskell County, KS	2007	NA	2152	2090	62	2.9
CN2008300000000	20	083	Hodgeman County, KS	2007	NA	903	867	36	4
CN2008500000000	20	085	Jackson County, KS	2007	NA	6945	6561	384	5.5
CN2008700000000	20	087	Jefferson County, KS	2007	NA	9606	9127	479	5
CN2008900000000	20	089	Jewell County, KS	2007	NA	1918	1863	55	2.9
CN2009100000000	20	091	Johnson County, KS	2007	NA	298890	286748	12142	4.1
CN2009300000000	20	093	Kearny County, KS	2007	NA	2128	2059	69	3.2
CN2009500000000	20	095	Kingman County, KS	2007	NA	4285	4140	145	3.4
CN2009700000000	20	097	Kiowa County, KS	2007	NA	1492	1422	70	4.7
CN2009900000000	20	099	Labette County, KS	2007	NA	11351	10790	561	4.9
CN2010100000000	20	101	Lane County, KS	2007	NA	1066	1028	38	3.6
CN2010300000000	20	103	Leavenworth County, KS	2007	NA	32857	31086	1771	5.4
CN2010500000000	20	105	Lincoln County, KS	2007	NA	1828	1757	71	3.9
CN2010700000000	20	107	Linn County, KS	2007	NA	4752	4446	306	6.4
CN2010900000000	20	109	Logan County, KS	2007	NA	1775	1725	50	2.8
CN2011100000000	20	111	Lyon County, KS	2007	NA	19695	18888	807	4.1
CN2011300000000	20	113	McPherson County, KS	2007	NA	16742	16161	581	3.5
CN2011500000000	20	115	Marion County, KS	2007	NA	6697	6452	245	3.7
CN2011700000000	20	117	Marshall County, KS	2007	NA	6058	5867	191	3.2
CN2011900000000	20	119	Meade County, KS	2007	NA	2304	2237	67	2.9
CN2012100000000	20	121	Miami County, KS	2007	NA	16470	15698	772	4.7
CN2012300000000	20	123	Mitchell County, KS	2007	NA	3336	3218	118	3.5
CN2012500000000	20	125	Montgomery County, KS	2007	NA	17582	16725	857	4.9
CN2012700000000	20	127	Morris County, KS	2007	NA	2968	2824	144	4.9
CN2012900000000	20	129	Morton County, KS	2007	NA	1683	1637	46	2.7
CN2013100000000	20	131	Nemaha County, KS	2007	NA	5619	5447	172	3.1
CN2013300000000	20	133	Neosho County, KS	2007	NA	9291	8909	382	4.1
CN2013500000000	20	135	Ness County, KS	2007	NA	1734	1683	51	2.9
CN2013700000000	20	137	Norton County, KS	2007	NA	2696	2609	87	3.2
CN2013900000000	20	139	Osage County, KS	2007	NA	8526	8060	466	5.5
CN2014100000000	20	141	Osborne County, KS	2007	NA	2208	2124	84	3.8
CN2014300000000	20	143	Ottawa County, KS	2007	NA	3258	3134	124	3.8
CN2014500000000	20	145	Pawnee County, KS	2007	NA	3991	3867	124	3.1
CN2014700000000	20	147	Phillips County, KS	2007	NA	3229	3132	97	3
CN2014900000000	20	149	Pottawatomie County, KS	2007	NA	11553	11177	376	3.3
CN2015100000000	20	151	Pratt County, KS	2007	NA	5706	5529	177	3.1
CN2015300000000	20	153	Rawlins County, KS	2007	NA	1234	1190	44	3.6
CN2015500000000	20	155	Reno County, KS	2007	NA	32485	31113	1372	4.2
CN2015700000000	20	157	Republic County, KS	2007	NA	2756	2668	88	3.2
CN2015900000000	20	159	Rice County, KS	2007	NA	5605	5389	216	3.9
CN2016100000000	20	161	Riley County, KS	2007	NA	39474	38239	1235	3.1
CN2016300000000	20	163	Rooks County, KS	2007	NA	2655	2557	98	3.7
CN2016500000000	20	165	Rush County, KS	2007	NA	1645	1584	61	3.7
CN2016700000000	20	167	Russell County, KS	2007	NA	3488	3361	127	3.6
CN2016900000000	20	169	Saline County, KS	2007	NA	30271	29196	1075	3.6
CN2017100000000	20	171	Scott County, KS	2007	NA	2588	2516	72	2.8
CN2017300000000	20	173	Sedgwick County, KS	2007	NA	250715	240113	10602	4.2
CN2017500000000	20	175	Seward County, KS	2007	NA	10447	10094	353	3.4
CN2017700000000	20	177	Shawnee County, KS	2007	NA	91388	87152	4236	4.6
CN2017900000000	20	179	Sheridan County, KS	2007	NA	1553	1510	43	2.8
CN2018100000000	20	181	Sherman County, KS	2007	NA	3632	3528	104	2.9
CN2018300000000	20	183	Smith County, KS	2007	NA	2178	2109	69	3.2
CN2018500000000	20	185	Stafford County, KS	2007	NA	2132	2054	78	3.7
CN2018700000000	20	187	Stanton County, KS	2007	NA	1120	1087	33	2.9
CN2018900000000	20	189	Stevens County, KS	2007	NA	2254	2180	74	3.3
CN2019100000000	20	191	Sumner County, KS	2007	NA	11816	11295	521	4.4
CN2019300000000	20	193	Thomas County, KS	2007	NA	4140	4015	125	3
CN2019500000000	20	195	Trego County, KS	2007	NA	1691	1635	56	3.3
CN2019700000000	20	197	Wabaunsee County, KS	2007	NA	3657	3511	146	4
CN2019900000000	20	199	Wallace County, KS	2007	NA	904	878	26	2.9
CN2020100000000	20	201	Washington County, KS	2007	NA	3334	3221	113	3.4
CN2020300000000	20	203	Wichita County, KS	2007	NA	1237	1200	37	3
CN2020500000000	20	205	Wilson County, KS	2007	NA	5516	5311	205	3.7
CN2020700000000	20	207	Woodson County, KS	2007	NA	1668	1582	86	5.2
CN2020900000000	20	209	Wyandotte County, KS	2007	NA	71446	66013	5433	7.6
CN2100100000000	21	001	Adair County, KY	2007	NA	8912	8393	519	5.8
CN2100300000000	21	003	Allen County, KY	2007	NA	8235	7754	481	5.8
CN2100500000000	21	005	Anderson County, KY	2007	NA	11038	10489	549	5
CN2100700000000	21	007	Ballard County, KY	2007	NA	4229	3996	233	5.5
CN2100900000000	21	009	Barren County, KY	2007	NA	19497	18489	1008	5.2
CN2101100000000	21	011	Bath County, KY	2007	NA	5049	4670	379	7.5
CN2101300000000	21	013	Bell County, KY	2007	NA	9494	8734	760	8
CN2101500000000	21	015	Boone County, KY	2007	NA	61711	58999	2712	4.4
CN2101700000000	21	017	Bourbon County, KY	2007	NA	9689	9217	472	4.9
CN2101900000000	21	019	Boyd County, KY	2007	NA	22838	21660	1178	5.2
CN2102100000000	21	021	Boyle County, KY	2007	NA	12705	11938	767	6
CN2102300000000	21	023	Bracken County, KY	2007	NA	4259	4005	254	6
CN2102500000000	21	025	Breathitt County, KY	2007	NA	5641	5247	394	7
CN2102700000000	21	027	Breckinridge County, KY	2007	NA	9098	8551	547	6
CN2102900000000	21	029	Bullitt County, KY	2007	NA	38936	36739	2197	5.6
CN2103100000000	21	031	Butler County, KY	2007	NA	5602	5247	355	6.3
CN2103300000000	21	033	Caldwell County, KY	2007	NA	6630	6279	351	5.3
CN2103500000000	21	035	Calloway County, KY	2007	NA	17749	16794	955	5.4
CN2103700000000	21	037	Campbell County, KY	2007	NA	44530	42314	2216	5
CN2103900000000	21	039	Carlisle County, KY	2007	NA	2260	2123	137	6.1
CN2104100000000	21	041	Carroll County, KY	2007	NA	5726	5417	309	5.4
CN2104300000000	21	043	Carter County, KY	2007	NA	13501	12543	958	7.1
CN2104500000000	21	045	Casey County, KY	2007	NA	7320	6916	404	5.5
CN2104700000000	21	047	Christian County, KY	2007	NA	29455	27592	1863	6.3
CN2104900000000	21	049	Clark County, KY	2007	NA	17233	16396	837	4.9
CN2105100000000	21	051	Clay County, KY	2007	NA	6997	6256	741	10.6
CN2105300000000	21	053	Clinton County, KY	2007	NA	4639	4396	243	5.2
CN2105500000000	21	055	Crittenden County, KY	2007	NA	3797	3566	231	6.1
CN2105700000000	21	057	Cumberland County, KY	2007	NA	2964	2759	205	6.9
CN2105900000000	21	059	Daviess County, KY	2007	NA	47117	44838	2279	4.8
CN2106100000000	21	061	Edmonson County, KY	2007	NA	5322	4985	337	6.3
CN2106300000000	21	063	Elliott County, KY	2007	NA	3040	2812	228	7.5
CN2106500000000	21	065	Estill County, KY	2007	NA	6119	5725	394	6.4
CN2106700000000	21	067	Fayette County, KY	2007	NA	151234	145196	6038	4
CN2106900000000	21	069	Fleming County, KY	2007	NA	6484	6067	417	6.4
CN2107100000000	21	071	Floyd County, KY	2007	NA	15081	14103	978	6.5
CN2107300000000	21	073	Franklin County, KY	2007	NA	25090	23959	1131	4.5
CN2107500000000	21	075	Fulton County, KY	2007	NA	2706	2504	202	7.5
CN2107700000000	21	077	Gallatin County, KY	2007	NA	3893	3684	209	5.4
CN2107900000000	21	079	Garrard County, KY	2007	NA	7685	7253	432	5.6
CN2108100000000	21	081	Grant County, KY	2007	NA	12590	11898	692	5.5
CN2108300000000	21	083	Graves County, KY	2007	NA	15948	14950	998	6.3
CN2108500000000	21	085	Grayson County, KY	2007	NA	11251	10340	911	8.1
CN2108700000000	21	087	Green County, KY	2007	NA	5631	5285	346	6.1
CN2108900000000	21	089	Greenup County, KY	2007	NA	17487	16537	950	5.4
CN2109100000000	21	091	Hancock County, KY	2007	NA	4189	3974	215	5.1
CN2109300000000	21	093	Hardin County, KY	2007	NA	47394	44983	2411	5.1
CN2109500000000	21	095	Harlan County, KY	2007	NA	10160	9250	910	9
CN2109700000000	21	097	Harrison County, KY	2007	NA	9232	8782	450	4.9
CN2109900000000	21	099	Hart County, KY	2007	NA	8137	7704	433	5.3
CN2110100000000	21	101	Henderson County, KY	2007	NA	22689	21551	1138	5
CN2110300000000	21	103	Henry County, KY	2007	NA	7819	7405	414	5.3
CN2110500000000	21	105	Hickman County, KY	2007	NA	2033	1895	138	6.8
CN2110700000000	21	107	Hopkins County, KY	2007	NA	23298	21919	1379	5.9
CN2110900000000	21	109	Jackson County, KY	2007	NA	4340	3749	591	13.6
CN2111100000000	21	111	Jefferson County, KY	2007	NA	356083	337283	18800	5.3
CN2111300000000	21	113	Jessamine County, KY	2007	NA	22825	21813	1012	4.4
CN2111500000000	21	115	Johnson County, KY	2007	NA	9666	9075	591	6.1
CN2111700000000	21	117	Kenton County, KY	2007	NA	83537	79535	4002	4.8
CN2111900000000	21	119	Knott County, KY	2007	NA	6232	5805	427	6.9
CN2112100000000	21	121	Knox County, KY	2007	NA	12621	11775	846	6.7
CN2112300000000	21	123	Larue County, KY	2007	NA	6933	6581	352	5.1
CN2112500000000	21	125	Laurel County, KY	2007	NA	26612	25204	1408	5.3
CN2112700000000	21	127	Lawrence County, KY	2007	NA	5815	5362	453	7.8
CN2112900000000	21	129	Lee County, KY	2007	NA	2822	2637	185	6.6
CN2113100000000	21	131	Leslie County, KY	2007	NA	3561	3251	310	8.7
CN2113300000000	21	133	Letcher County, KY	2007	NA	8747	8098	649	7.4
CN2113500000000	21	135	Lewis County, KY	2007	NA	5602	5178	424	7.6
CN2113700000000	21	137	Lincoln County, KY	2007	NA	10611	9920	691	6.5
CN2113900000000	21	139	Livingston County, KY	2007	NA	4845	4583	262	5.4
CN2114100000000	21	141	Logan County, KY	2007	NA	12396	11735	661	5.3
CN2114300000000	21	143	Lyon County, KY	2007	NA	3278	3069	209	6.4
CN2114500000000	21	145	McCracken County, KY	2007	NA	31596	30059	1537	4.9
CN2114700000000	21	147	McCreary County, KY	2007	NA	5841	5315	526	9
CN2114900000000	21	149	McLean County, KY	2007	NA	4573	4307	266	5.8
CN2115100000000	21	151	Madison County, KY	2007	NA	42634	40622	2012	4.7
CN2115300000000	21	153	Magoffin County, KY	2007	NA	4346	3896	450	10.4
CN2115500000000	21	155	Marion County, KY	2007	NA	10271	9743	528	5.1
CN2115700000000	21	157	Marshall County, KY	2007	NA	14796	13945	851	5.8
CN2115900000000	21	159	Martin County, KY	2007	NA	3445	3175	270	7.8
CN2116100000000	21	161	Mason County, KY	2007	NA	8809	8404	405	4.6
CN2116300000000	21	163	Meade County, KY	2007	NA	11617	10918	699	6
CN2116500000000	21	165	Menifee County, KY	2007	NA	2637	2413	224	8.5
CN2116700000000	21	167	Mercer County, KY	2007	NA	10620	10073	547	5.2
CN2116900000000	21	169	Metcalfe County, KY	2007	NA	4425	4179	246	5.6
CN2117100000000	21	171	Monroe County, KY	2007	NA	4858	4528	330	6.8
CN2117300000000	21	173	Montgomery County, KY	2007	NA	12241	11532	709	5.8
CN2117500000000	21	175	Morgan County, KY	2007	NA	4969	4537	432	8.7
CN2117700000000	21	177	Muhlenberg County, KY	2007	NA	13548	12471	1077	7.9
CN2117900000000	21	179	Nelson County, KY	2007	NA	21294	20066	1228	5.8
CN2118100000000	21	181	Nicholas County, KY	2007	NA	3016	2827	189	6.3
CN2118300000000	21	183	Ohio County, KY	2007	NA	12009	11381	628	5.2
CN2118500000000	21	185	Oldham County, KY	2007	NA	27555	26246	1309	4.8
CN2118700000000	21	187	Owen County, KY	2007	NA	5266	5001	265	5
CN2118900000000	21	189	Owsley County, KY	2007	NA	1577	1432	145	9.2
CN2119100000000	21	191	Pendleton County, KY	2007	NA	7308	6881	427	5.8
CN2119300000000	21	193	Perry County, KY	2007	NA	11415	10618	797	7
CN2119500000000	21	195	Pike County, KY	2007	NA	25145	23668	1477	5.9
CN2119700000000	21	197	Powell County, KY	2007	NA	5669	5295	374	6.6
CN2119900000000	21	199	Pulaski County, KY	2007	NA	27166	25565	1601	5.9
CN2120100000000	21	201	Robertson County, KY	2007	NA	1065	1014	51	4.8
CN2120300000000	21	203	Rockcastle County, KY	2007	NA	7239	6762	477	6.6
CN2120500000000	21	205	Rowan County, KY	2007	NA	12183	11532	651	5.3
CN2120700000000	21	207	Russell County, KY	2007	NA	8136	7637	499	6.1
CN2120900000000	21	209	Scott County, KY	2007	NA	22332	21360	972	4.4
CN2121100000000	21	211	Shelby County, KY	2007	NA	21258	20261	997	4.7
CN2121300000000	21	213	Simpson County, KY	2007	NA	9345	8873	472	5.1
CN2121500000000	21	215	Spencer County, KY	2007	NA	8919	8387	532	6
CN2121700000000	21	217	Taylor County, KY	2007	NA	13726	12993	733	5.3
CN2121900000000	21	219	Todd County, KY	2007	NA	5020	4693	327	6.5
CN2122100000000	21	221	Trigg County, KY	2007	NA	6266	5900	366	5.8
CN2122300000000	21	223	Trimble County, KY	2007	NA	4353	4085	268	6.2
CN2122500000000	21	225	Union County, KY	2007	NA	7084	6691	393	5.5
CN2122700000000	21	227	Warren County, KY	2007	NA	57538	55042	2496	4.3
CN2122900000000	21	229	Washington County, KY	2007	NA	5406	5105	301	5.6
CN2123100000000	21	231	Wayne County, KY	2007	NA	8575	8014	561	6.5
CN2123300000000	21	233	Webster County, KY	2007	NA	6530	6148	382	5.8
CN2123500000000	21	235	Whitley County, KY	2007	NA	15011	14057	954	6.4
CN2123700000000	21	237	Wolfe County, KY	2007	NA	2315	2090	225	9.7
CN2123900000000	21	239	Woodford County, KY	2007	NA	13264	12751	513	3.9
CN2200100000000	22	001	Acadia Parish, LA	2007	NA	26303	25315	988	3.8
CN2200300000000	22	003	Allen Parish, LA	2007	NA	8809	8308	501	5.7
CN2200500000000	22	005	Ascension Parish, LA	2007	NA	48952	47011	1941	4
CN2200700000000	22	007	Assumption Parish, LA	2007	NA	10461	9973	488	4.7
CN2200900000000	22	009	Avoyelles Parish, LA	2007	NA	15993	15168	825	5.2
CN2201100000000	22	011	Beauregard Parish, LA	2007	NA	14268	13567	701	4.9
CN2201300000000	22	013	Bienville Parish, LA	2007	NA	6575	6215	360	5.5
CN2201500000000	22	015	Bossier Parish, LA	2007	NA	53018	50847	2171	4.1
CN2201700000000	22	017	Caddo Parish, LA	2007	NA	118612	112445	6167	5.2
CN2201900000000	22	019	Calcasieu Parish, LA	2007	NA	91888	88154	3734	4.1
CN2202100000000	22	021	Caldwell Parish, LA	2007	NA	4546	4328	218	4.8
CN2202300000000	22	023	Cameron Parish, LA	2007	NA	3559	3429	130	3.7
CN2202500000000	22	025	Catahoula Parish, LA	2007	NA	4162	3921	241	5.8
CN2202700000000	22	027	Claiborne Parish, LA	2007	NA	6710	6340	370	5.5
CN2202900000000	22	029	Concordia Parish, LA	2007	NA	7333	6889	444	6.1
CN2203100000000	22	031	De Soto Parish, LA	2007	NA	11384	10728	656	5.8
CN2203300000000	22	033	East Baton Rouge Parish, LA	2007	NA	216650	207813	8837	4.1
CN2203500000000	22	035	East Carroll Parish, LA	2007	NA	3069	2770	299	9.7
CN2203700000000	22	037	East Feliciana Parish, LA	2007	NA	8052	7669	383	4.8
CN2203900000000	22	039	Evangeline Parish, LA	2007	NA	12333	11707	626	5.1
CN2204100000000	22	041	Franklin Parish, LA	2007	NA	7789	7268	521	6.7
CN2204300000000	22	043	Grant Parish, LA	2007	NA	8680	8276	404	4.7
CN2204500000000	22	045	Iberia Parish, LA	2007	NA	34429	33154	1275	3.7
CN2204700000000	22	047	Iberville Parish, LA	2007	NA	12270	11548	722	5.9
CN2204900000000	22	049	Jackson Parish, LA	2007	NA	6471	6189	282	4.4
CN2205100000000	22	051	Jefferson Parish, LA	2007	NA	221408	213445	7963	3.6
CN2205300000000	22	053	Jefferson Davis Parish, LA	2007	NA	14599	14093	506	3.5
CN2205500000000	22	055	Lafayette Parish, LA	2007	NA	110161	106874	3287	3
CN2205700000000	22	057	Lafourche Parish, LA	2007	NA	48824	47397	1427	2.9
CN2205900000000	22	059	LaSalle Parish, LA	2007	NA	6249	6011	238	3.8
CN2206100000000	22	061	Lincoln Parish, LA	2007	NA	18918	17984	934	4.9
CN2206300000000	22	063	Livingston Parish, LA	2007	NA	55882	53715	2167	3.9
CN2206500000000	22	065	Madison Parish, LA	2007	NA	4453	4153	300	6.7
CN2206700000000	22	067	Morehouse Parish, LA	2007	NA	11673	10727	946	8.1
CN2206900000000	22	069	Natchitoches Parish, LA	2007	NA	17455	16557	898	5.1
CN2207100000000	22	071	Orleans Parish, LA	2007	NA	107655	102197	5458	5.1
CN2207300000000	22	073	Ouachita Parish, LA	2007	NA	71680	68068	3612	5
CN2207500000000	22	075	Plaquemines Parish, LA	2007	NA	9015	8662	353	3.9
CN2207700000000	22	077	Pointe Coupee Parish, LA	2007	NA	9516	9069	447	4.7
CN2207900000000	22	079	Rapides Parish, LA	2007	NA	59862	57345	2517	4.2
CN2208100000000	22	081	Red River Parish, LA	2007	NA	3470	3241	229	6.6
CN2208300000000	22	083	Richland Parish, LA	2007	NA	8710	8162	548	6.3
CN2208500000000	22	085	Sabine Parish, LA	2007	NA	9441	9018	423	4.5
CN2208700000000	22	087	St. Bernard Parish, LA	2007	NA	9757	9336	421	4.3
CN2208900000000	22	089	St. Charles Parish, LA	2007	NA	26273	25275	998	3.8
CN2209100000000	22	091	St. Helena Parish, LA	2007	NA	4216	3899	317	7.5
CN2209300000000	22	093	St. James Parish, LA	2007	NA	8634	8037	597	6.9
CN2209500000000	22	095	St. John the Baptist Parish, LA	2007	NA	22505	21380	1125	5
CN2209700000000	22	097	St. Landry Parish, LA	2007	NA	37493	35764	1729	4.6
CN2209900000000	22	099	St. Martin Parish, LA	2007	NA	23666	22792	874	3.7
CN2210100000000	22	101	St. Mary Parish, LA	2007	NA	23359	22360	999	4.3
CN2210300000000	22	103	St. Tammany Parish, LA	2007	NA	116435	112699	3736	3.2
CN2210500000000	22	105	Tangipahoa Parish, LA	2007	NA	52370	49959	2411	4.6
CN2210700000000	22	107	Tensas Parish, LA	2007	NA	2212	2046	166	7.5
CN2210900000000	22	109	Terrebonne Parish, LA	2007	NA	54759	53108	1651	3
CN2211100000000	22	111	Union Parish, LA	2007	NA	10198	9679	519	5.1
CN2211300000000	22	113	Vermilion Parish, LA	2007	NA	24128	23198	930	3.9
CN2211500000000	22	115	Vernon Parish, LA	2007	NA	21174	20195	979	4.6
CN2211700000000	22	117	Washington Parish, LA	2007	NA	15885	14958	927	5.8
CN2211900000000	22	119	Webster Parish, LA	2007	NA	19807	18777	1030	5.2
CN2212100000000	22	121	West Baton Rouge Parish, LA	2007	NA	10632	10195	437	4.1
CN2212300000000	22	123	West Carroll Parish, LA	2007	NA	4485	4059	426	9.5
CN2212500000000	22	125	West Feliciana Parish, LA	2007	NA	4788	4521	267	5.6
CN2212700000000	22	127	Winn Parish, LA	2007	NA	6375	6054	321	5
CN2300100000000	23	001	Androscoggin County, ME	2007	NA	58125	55454	2671	4.6
CN2300300000000	23	003	Aroostook County, ME	2007	NA	35128	32921	2207	6.3
CN2300500000000	23	005	Cumberland County, ME	2007	NA	157386	151982	5404	3.4
CN2300700000000	23	007	Franklin County, ME	2007	NA	14111	13254	857	6.1
CN2300900000000	23	009	Hancock County, ME	2007	NA	29442	27835	1607	5.5
CN2301100000000	23	011	Kennebec County, ME	2007	NA	62804	59929	2875	4.6
CN2301300000000	23	013	Knox County, ME	2007	NA	21090	20174	916	4.3
CN2301500000000	23	015	Lincoln County, ME	2007	NA	18187	17424	763	4.2
CN2301700000000	23	017	Oxford County, ME	2007	NA	28305	26645	1660	5.9
CN2301900000000	23	019	Penobscot County, ME	2007	NA	78551	74526	4025	5.1
CN2302100000000	23	021	Piscataquis County, ME	2007	NA	7426	6869	557	7.5
CN2302300000000	23	023	Sagadahoc County, ME	2007	NA	18899	18164	735	3.9
CN2302500000000	23	025	Somerset County, ME	2007	NA	24886	23165	1721	6.9
CN2302700000000	23	027	Waldo County, ME	2007	NA	18872	17847	1025	5.4
CN2302900000000	23	029	Washington County, ME	2007	NA	14494	13383	1111	7.7
CN2303100000000	23	031	York County, ME	2007	NA	112738	108199	4539	4
CN2400100000000	24	001	Allegany County, MD	2007	NA	34917	33139	1778	5.1
CN2400300000000	24	003	Anne Arundel County, MD	2007	NA	279882	271502	8380	3
CN2400500000000	24	005	Baltimore County, MD	2007	NA	427026	411968	15058	3.5
CN2400900000000	24	009	Calvert County, MD	2007	NA	47616	46280	1336	2.8
CN2401100000000	24	011	Caroline County, MD	2007	NA	16199	15529	670	4.1
CN2401300000000	24	013	Carroll County, MD	2007	NA	93995	91246	2749	2.9
CN2401500000000	24	015	Cecil County, MD	2007	NA	50522	48588	1934	3.8
CN2401700000000	24	017	Charles County, MD	2007	NA	75920	73725	2195	2.9
CN2401900000000	24	019	Dorchester County, MD	2007	NA	16661	15700	961	5.8
CN2402100000000	24	021	Frederick County, MD	2007	NA	123692	120143	3549	2.9
CN2402300000000	24	023	Garrett County, MD	2007	NA	16673	15945	728	4.4
CN2402500000000	24	025	Harford County, MD	2007	NA	131696	127310	4386	3.3
CN2402700000000	24	027	Howard County, MD	2007	NA	159215	155198	4017	2.5
CN2402900000000	24	029	Kent County, MD	2007	NA	11125	10735	390	3.5
CN2403100000000	24	031	Montgomery County, MD	2007	NA	509769	496401	13368	2.6
CN2403300000000	24	033	Prince George's County, MD	2007	NA	445492	429521	15971	3.6
CN2403500000000	24	035	Queen Anne's County, MD	2007	NA	26036	25230	806	3.1
CN2403700000000	24	037	St. Mary's County, MD	2007	NA	50810	49312	1498	2.9
CN2403900000000	24	039	Somerset County, MD	2007	NA	11168	10573	595	5.3
CN2404100000000	24	041	Talbot County, MD	2007	NA	18864	18231	633	3.4
CN2404300000000	24	043	Washington County, MD	2007	NA	68045	65091	2954	4.3
CN2404500000000	24	045	Wicomico County, MD	2007	NA	52137	50113	2024	3.9
CN2404700000000	24	047	Worcester County, MD	2007	NA	27481	25881	1600	5.8
CN2451000000000	24	510	Baltimore city, MD	2007	NA	275151	259986	15165	5.5
CN2500100000000	25	001	Barnstable County, MA	2007	NA	121322	115367	5955	4.9
CN2500300000000	25	003	Berkshire County, MA	2007	NA	72820	69538	3282	4.5
CN2500500000000	25	005	Bristol County, MA	2007	NA	290169	272931	17238	5.9
CN2500700000000	25	007	Dukes County, MA	2007	NA	11128	10726	402	3.6
CN2500900000000	25	009	Essex County, MA	2007	NA	373827	355585	18242	4.9
CN2501100000000	25	011	Franklin County, MA	2007	NA	39104	37435	1669	4.3
CN2501300000000	25	013	Hampden County, MA	2007	NA	223699	210928	12771	5.7
CN2501500000000	25	015	Hampshire County, MA	2007	NA	88300	84879	3421	3.9
CN2501700000000	25	017	Middlesex County, MA	2007	NA	816978	786271	30707	3.8
CN2501900000000	25	019	Nantucket County/town, MA	2007	NA	8527	8323	204	2.4
CN2502100000000	25	021	Norfolk County, MA	2007	NA	354533	340362	14171	4
CN2502300000000	25	023	Plymouth County, MA	2007	NA	259937	247187	12750	4.9
CN2502500000000	25	025	Suffolk County, MA	2007	NA	364284	347532	16752	4.6
CN2502700000000	25	027	Worcester County, MA	2007	NA	401374	381033	20341	5.1
CN2600100000000	26	001	Alcona County, MI	2007	NA	4300	3858	442	10.3
CN2600300000000	26	003	Alger County, MI	2007	NA	4393	4022	371	8.4
CN2600500000000	26	005	Allegan County, MI	2007	NA	56007	52431	3576	6.4
CN2600700000000	26	007	Alpena County, MI	2007	NA	14901	13645	1256	8.4
CN2600900000000	26	009	Antrim County, MI	2007	NA	11860	10901	959	8.1
CN2601100000000	26	011	Arenac County, MI	2007	NA	7868	7093	775	9.9
CN2601300000000	26	013	Baraga County, MI	2007	NA	4263	3716	547	12.8
CN2601500000000	26	015	Barry County, MI	2007	NA	30385	28719	1666	5.5
CN2601700000000	26	017	Bay County, MI	2007	NA	55027	51253	3774	6.9
CN2601900000000	26	019	Benzie County, MI	2007	NA	8995	8271	724	8
CN2602100000000	26	021	Berrien County, MI	2007	NA	79672	74135	5537	6.9
CN2602300000000	26	023	Branch County, MI	2007	NA	22254	20601	1653	7.4
CN2602500000000	26	025	Calhoun County, MI	2007	NA	69772	64905	4867	7
CN2602700000000	26	027	Cass County, MI	2007	NA	27196	25642	1554	5.7
CN2602900000000	26	029	Charlevoix County, MI	2007	NA	14117	12877	1240	8.8
CN2603100000000	26	031	Cheboygan County, MI	2007	NA	12466	11172	1294	10.4
CN2603300000000	26	033	Chippewa County, MI	2007	NA	17520	15965	1555	8.9
CN2603500000000	26	035	Clare County, MI	2007	NA	13211	11798	1413	10.7
CN2603700000000	26	037	Clinton County, MI	2007	NA	37861	35778	2083	5.5
CN2603900000000	26	039	Crawford County, MI	2007	NA	6655	6120	535	8
CN2604100000000	26	041	Delta County, MI	2007	NA	20145	18599	1546	7.7
CN2604300000000	26	043	Dickinson County, MI	2007	NA	14389	13512	877	6.1
CN2604500000000	26	045	Eaton County, MI	2007	NA	58968	55859	3109	5.3
CN2604700000000	26	047	Emmet County, MI	2007	NA	19810	18013	1797	9.1
CN2604900000000	26	049	Genesee County, MI	2007	NA	208354	190881	17473	8.4
CN2605100000000	26	051	Gladwin County, MI	2007	NA	10686	9603	1083	10.1
CN2605300000000	26	053	Gogebic County, MI	2007	NA	7625	7029	596	7.8
CN2605500000000	26	055	Grand Traverse County, MI	2007	NA	49059	45808	3251	6.6
CN2605700000000	26	057	Gratiot County, MI	2007	NA	19857	18125	1732	8.7
CN2605900000000	26	059	Hillsdale County, MI	2007	NA	21781	19866	1915	8.8
CN2606100000000	26	061	Houghton County, MI	2007	NA	17657	16379	1278	7.2
CN2606300000000	26	063	Huron County, MI	2007	NA	16714	15377	1337	8
CN2606500000000	26	065	Ingham County, MI	2007	NA	153495	143929	9566	6.2
CN2606700000000	26	067	Ionia County, MI	2007	NA	30484	28179	2305	7.6
CN2606900000000	26	069	Iosco County, MI	2007	NA	10895	9802	1093	10
CN2607100000000	26	071	Iron County, MI	2007	NA	5938	5496	442	7.4
CN2607300000000	26	073	Isabella County, MI	2007	NA	38743	36705	2038	5.3
CN2607500000000	26	075	Jackson County, MI	2007	NA	77563	71629	5934	7.7
CN2607700000000	26	077	Kalamazoo County, MI	2007	NA	134661	127431	7230	5.4
CN2607900000000	26	079	Kalkaska County, MI	2007	NA	8709	8004	705	8.1
CN2608100000000	26	081	Kent County, MI	2007	NA	323454	304257	19197	5.9
CN2608300000000	26	083	Keweenaw County, MI	2007	NA	1059	943	116	11
CN2608500000000	26	085	Lake County, MI	2007	NA	4074	3646	428	10.5
CN2608700000000	26	087	Lapeer County, MI	2007	NA	44306	40778	3528	8
CN2608900000000	26	089	Leelanau County, MI	2007	NA	11362	10738	624	5.5
CN2609100000000	26	091	Lenawee County, MI	2007	NA	49663	45710	3953	8
CN2609300000000	26	093	Livingston County, MI	2007	NA	94930	89902	5028	5.3
CN2609500000000	26	095	Luce County, MI	2007	NA	2773	2520	253	9.1
CN2609700000000	26	097	Mackinac County, MI	2007	NA	6430	5779	651	10.1
CN2609900000000	26	099	Macomb County, MI	2007	NA	421017	391423	29594	7
CN2610100000000	26	101	Manistee County, MI	2007	NA	11982	10963	1019	8.5
CN2610300000000	26	103	Marquette County, MI	2007	NA	35891	33633	2258	6.3
CN2610500000000	26	105	Mason County, MI	2007	NA	14924	13756	1168	7.8
CN2610700000000	26	107	Mecosta County, MI	2007	NA	20058	18535	1523	7.6
CN2610900000000	26	109	Menominee County, MI	2007	NA	13207	12439	768	5.8
CN2611100000000	26	111	Midland County, MI	2007	NA	43003	40609	2394	5.6
CN2611300000000	26	113	Missaukee County, MI	2007	NA	6526	5968	558	8.6
CN2611500000000	26	115	Monroe County, MI	2007	NA	77356	72129	5227	6.8
CN2611700000000	26	117	Montcalm County, MI	2007	NA	26870	23726	3144	11.7
CN2611900000000	26	119	Montmorency County, MI	2007	NA	4176	3623	553	13.2
CN2612100000000	26	121	Muskegon County, MI	2007	NA	89458	82943	6515	7.3
CN2612300000000	26	123	Newaygo County, MI	2007	NA	22955	21126	1829	8
CN2612500000000	26	125	Oakland County, MI	2007	NA	625693	589416	36277	5.8
CN2612700000000	26	127	Oceana County, MI	2007	NA	14400	13185	1215	8.4
CN2612900000000	26	129	Ogemaw County, MI	2007	NA	9651	8832	819	8.5
CN2613100000000	26	131	Ontonagon County, MI	2007	NA	3417	3129	288	8.4
CN2613300000000	26	133	Osceola County, MI	2007	NA	9895	9098	797	8.1
CN2613500000000	26	135	Oscoda County, MI	2007	NA	4013	3589	424	10.6
CN2613700000000	26	137	Otsego County, MI	2007	NA	12333	11188	1145	9.3
CN2613900000000	26	139	Ottawa County, MI	2007	NA	135826	128067	7759	5.7
CN2614100000000	26	141	Presque Isle County, MI	2007	NA	6106	5331	775	12.7
CN2614300000000	26	143	Roscommon County, MI	2007	NA	10473	9444	1029	9.8
CN2614500000000	26	145	Saginaw County, MI	2007	NA	96947	89941	7006	7.2
CN2614700000000	26	147	St. Clair County, MI	2007	NA	83783	76711	7072	8.4
CN2614900000000	26	149	St. Joseph County, MI	2007	NA	31678	29652	2026	6.4
CN2615100000000	26	151	Sanilac County, MI	2007	NA	21820	19836	1984	9.1
CN2615300000000	26	153	Schoolcraft County, MI	2007	NA	3957	3524	433	10.9
CN2615500000000	26	155	Shiawassee County, MI	2007	NA	36158	33169	2989	8.3
CN2615700000000	26	157	Tuscola County, MI	2007	NA	28600	26167	2433	8.5
CN2615900000000	26	159	Van Buren County, MI	2007	NA	40190	37367	2823	7
CN2616100000000	26	161	Washtenaw County, MI	2007	NA	188362	179146	9216	4.9
CN2616300000000	26	163	Wayne County, MI	2007	NA	883501	810552	72949	8.3
CN2616500000000	26	165	Wexford County, MI	2007	NA	14590	13325	1265	8.7
CN2700100000000	27	001	Aitkin County, MN	2007	NA	7718	7193	525	6.8
CN2700300000000	27	003	Anoka County, MN	2007	NA	189600	180992	8608	4.5
CN2700500000000	27	005	Becker County, MN	2007	NA	16852	15889	963	5.7
CN2700700000000	27	007	Beltrami County, MN	2007	NA	21174	19897	1277	6
CN2700900000000	27	009	Benton County, MN	2007	NA	22936	21792	1144	5
CN2701100000000	27	011	Big Stone County, MN	2007	NA	2801	2668	133	4.7
CN2701300000000	27	013	Blue Earth County, MN	2007	NA	36387	35023	1364	3.7
CN2701500000000	27	015	Brown County, MN	2007	NA	14676	13966	710	4.8
CN2701700000000	27	017	Carlton County, MN	2007	NA	17208	16232	976	5.7
CN2701900000000	27	019	Carver County, MN	2007	NA	49658	47699	1959	3.9
CN2702100000000	27	021	Cass County, MN	2007	NA	14260	13244	1016	7.1
CN2702300000000	27	023	Chippewa County, MN	2007	NA	7071	6768	303	4.3
CN2702500000000	27	025	Chisago County, MN	2007	NA	27346	25756	1590	5.8
CN2702700000000	27	027	Clay County, MN	2007	NA	31280	30201	1079	3.4
CN2702900000000	27	029	Clearwater County, MN	2007	NA	3872	3475	397	10.3
CN2703100000000	27	031	Cook County, MN	2007	NA	3133	2982	151	4.8
CN2703300000000	27	033	Cottonwood County, MN	2007	NA	6261	6009	252	4
CN2703500000000	27	035	Crow Wing County, MN	2007	NA	32719	30893	1826	5.6
CN2703700000000	27	037	Dakota County, MN	2007	NA	229769	220453	9316	4.1
CN2703900000000	27	039	Dodge County, MN	2007	NA	11028	10552	476	4.3
CN2704100000000	27	041	Douglas County, MN	2007	NA	20039	19154	885	4.4
CN2704300000000	27	043	Faribault County, MN	2007	NA	7777	7370	407	5.2
CN2704500000000	27	045	Fillmore County, MN	2007	NA	11157	10590	567	5.1
CN2704700000000	27	047	Freeborn County, MN	2007	NA	16336	15530	806	4.9
CN2704900000000	27	049	Goodhue County, MN	2007	NA	25003	23768	1235	4.9
CN2705100000000	27	051	Grant County, MN	2007	NA	3018	2840	178	5.9
CN2705300000000	27	053	Hennepin County, MN	2007	NA	655691	629005	26686	4.1
CN2705500000000	27	055	Houston County, MN	2007	NA	10980	10424	556	5.1
CN2705700000000	27	057	Hubbard County, MN	2007	NA	9188	8603	585	6.4
CN2705900000000	27	059	Isanti County, MN	2007	NA	21689	20397	1292	6
CN2706100000000	27	061	Itasca County, MN	2007	NA	22250	20637	1613	7.2
CN2706300000000	27	063	Jackson County, MN	2007	NA	6532	6280	252	3.9
CN2706500000000	27	065	Kanabec County, MN	2007	NA	7917	7263	654	8.3
CN2706700000000	27	067	Kandiyohi County, MN	2007	NA	23434	22430	1004	4.3
CN2706900000000	27	069	Kittson County, MN	2007	NA	2486	2344	142	5.7
CN2707100000000	27	071	Koochiching County, MN	2007	NA	6517	6063	454	7
CN2707300000000	27	073	Lac qui Parle County, MN	2007	NA	4055	3887	168	4.1
CN2707500000000	27	075	Lake County, MN	2007	NA	6131	5856	275	4.5
CN2707700000000	27	077	Lake of the Woods County, MN	2007	NA	2298	2182	116	5
CN2707900000000	27	079	Le Sueur County, MN	2007	NA	14183	13311	872	6.1
CN2708100000000	27	081	Lincoln County, MN	2007	NA	3210	3064	146	4.5
CN2708300000000	27	083	Lyon County, MN	2007	NA	14454	13902	552	3.8
CN2708500000000	27	085	McLeod County, MN	2007	NA	20388	19365	1023	5
CN2708700000000	27	087	Mahnomen County, MN	2007	NA	2430	2266	164	6.7
CN2708900000000	27	089	Marshall County, MN	2007	NA	5172	4759	413	8
CN2709100000000	27	091	Martin County, MN	2007	NA	11257	10762	495	4.4
CN2709300000000	27	093	Meeker County, MN	2007	NA	12380	11646	734	5.9
CN2709500000000	27	095	Mille Lacs County, MN	2007	NA	12282	11343	939	7.6
CN2709700000000	27	097	Morrison County, MN	2007	NA	17315	16250	1065	6.2
CN2709900000000	27	099	Mower County, MN	2007	NA	20346	19523	823	4
CN2710100000000	27	101	Murray County, MN	2007	NA	5382	5152	230	4.3
CN2710300000000	27	103	Nicollet County, MN	2007	NA	19264	18565	699	3.6
CN2710500000000	27	105	Nobles County, MN	2007	NA	11134	10748	386	3.5
CN2710700000000	27	107	Norman County, MN	2007	NA	3551	3370	181	5.1
CN2710900000000	27	109	Olmsted County, MN	2007	NA	79951	76931	3020	3.8
CN2711100000000	27	111	Otter Tail County, MN	2007	NA	29322	27773	1549	5.3
CN2711300000000	27	113	Pennington County, MN	2007	NA	8550	7961	589	6.9
CN2711500000000	27	115	Pine County, MN	2007	NA	13713	12664	1049	7.6
CN2711700000000	27	117	Pipestone County, MN	2007	NA	5292	5094	198	3.7
CN2711900000000	27	119	Polk County, MN	2007	NA	16675	15910	765	4.6
CN2712100000000	27	121	Pope County, MN	2007	NA	6101	5830	271	4.4
CN2712300000000	27	123	Ramsey County, MN	2007	NA	271469	259552	11917	4.4
CN2712500000000	27	125	Red Lake County, MN	2007	NA	2297	2111	186	8.1
CN2712700000000	27	127	Redwood County, MN	2007	NA	8272	7882	390	4.7
CN2712900000000	27	129	Renville County, MN	2007	NA	8482	8037	445	5.2
CN2713100000000	27	131	Rice County, MN	2007	NA	32138	30545	1593	5
CN2713300000000	27	133	Rock County, MN	2007	NA	4925	4769	156	3.2
CN2713500000000	27	135	Roseau County, MN	2007	NA	9755	9140	615	6.3
CN2713700000000	27	137	St. Louis County, MN	2007	NA	103338	97591	5747	5.6
CN2713900000000	27	139	Scott County, MN	2007	NA	73099	70143	2956	4
CN2714100000000	27	141	Sherburne County, MN	2007	NA	48738	46299	2439	5
CN2714300000000	27	143	Sibley County, MN	2007	NA	8694	8256	438	5
CN2714500000000	27	145	Stearns County, MN	2007	NA	83223	79426	3797	4.6
CN2714700000000	27	147	Steele County, MN	2007	NA	20401	19523	878	4.3
CN2714900000000	27	149	Stevens County, MN	2007	NA	5640	5430	210	3.7
CN2715100000000	27	151	Swift County, MN	2007	NA	5313	5036	277	5.2
CN2715300000000	27	153	Todd County, MN	2007	NA	12228	11565	663	5.4
CN2715500000000	27	155	Traverse County, MN	2007	NA	1839	1744	95	5.2
CN2715700000000	27	157	Wabasha County, MN	2007	NA	12215	11672	543	4.4
CN2715900000000	27	159	Wadena County, MN	2007	NA	6271	5805	466	7.4
CN2716100000000	27	161	Waseca County, MN	2007	NA	10257	9770	487	4.7
CN2716300000000	27	163	Washington County, MN	2007	NA	127837	122731	5106	4
CN2716500000000	27	165	Watonwan County, MN	2007	NA	5487	5211	276	5
CN2716700000000	27	167	Wilkin County, MN	2007	NA	3484	3352	132	3.8
CN2716900000000	27	169	Winona County, MN	2007	NA	28603	27411	1192	4.2
CN2717100000000	27	171	Wright County, MN	2007	NA	66107	62767	3340	5.1
CN2717300000000	27	173	Yellow Medicine County, MN	2007	NA	5687	5444	243	4.3
CN2800100000000	28	001	Adams County, MS	2007	NA	13391	12539	852	6.4
CN2800300000000	28	003	Alcorn County, MS	2007	NA	15416	14359	1057	6.9
CN2800500000000	28	005	Amite County, MS	2007	NA	5157	4833	324	6.3
CN2800700000000	28	007	Attala County, MS	2007	NA	7349	6795	554	7.5
CN2800900000000	28	009	Benton County, MS	2007	NA	2913	2641	272	9.3
CN2801100000000	28	011	Bolivar County, MS	2007	NA	15573	14323	1250	8
CN2801300000000	28	013	Calhoun County, MS	2007	NA	6072	5582	490	8.1
CN2801500000000	28	015	Carroll County, MS	2007	NA	4996	4680	316	6.3
CN2801700000000	28	017	Chickasaw County, MS	2007	NA	7427	6688	739	10
CN2801900000000	28	019	Choctaw County, MS	2007	NA	3480	3219	261	7.5
CN2802100000000	28	021	Claiborne County, MS	2007	NA	3573	3182	391	10.9
CN2802300000000	28	023	Clarke County, MS	2007	NA	7083	6565	518	7.3
CN2802500000000	28	025	Clay County, MS	2007	NA	7924	6749	1175	14.8
CN2802700000000	28	027	Coahoma County, MS	2007	NA	10415	9487	928	8.9
CN2802900000000	28	029	Copiah County, MS	2007	NA	12173	11278	895	7.4
CN2803100000000	28	031	Covington County, MS	2007	NA	8815	8345	470	5.3
CN2803300000000	28	033	DeSoto County, MS	2007	NA	76812	73815	2997	3.9
CN2803500000000	28	035	Forrest County, MS	2007	NA	37064	35224	1840	5
CN2803700000000	28	037	Franklin County, MS	2007	NA	3137	2920	217	6.9
CN2803900000000	28	039	George County, MS	2007	NA	9107	8463	644	7.1
CN2804100000000	28	041	Greene County, MS	2007	NA	4934	4562	372	7.5
CN2804300000000	28	043	Grenada County, MS	2007	NA	9651	8958	693	7.2
CN2804500000000	28	045	Hancock County, MS	2007	NA	18300	17349	951	5.2
CN2804700000000	28	047	Harrison County, MS	2007	NA	86384	81818	4566	5.3
CN2804900000000	28	049	Hinds County, MS	2007	NA	117887	111407	6480	5.5
CN2805100000000	28	051	Holmes County, MS	2007	NA	7162	6393	769	10.7
CN2805300000000	28	053	Humphreys County, MS	2007	NA	4357	3975	382	8.8
CN2805500000000	28	055	Issaquena County, MS	2007	NA	706	652	54	7.6
CN2805700000000	28	057	Itawamba County, MS	2007	NA	10036	9325	711	7.1
CN2805900000000	28	059	Jackson County, MS	2007	NA	59623	56377	3246	5.4
CN2806100000000	28	061	Jasper County, MS	2007	NA	7557	7102	455	6
CN2806300000000	28	063	Jefferson County, MS	2007	NA	2779	2415	364	13.1
CN2806500000000	28	065	Jefferson Davis County, MS	2007	NA	5252	4885	367	7
CN2806700000000	28	067	Jones County, MS	2007	NA	31314	29886	1428	4.6
CN2806900000000	28	069	Kemper County, MS	2007	NA	4108	3789	319	7.8
CN2807100000000	28	071	Lafayette County, MS	2007	NA	22115	21072	1043	4.7
CN2807300000000	28	073	Lamar County, MS	2007	NA	23865	22860	1005	4.2
CN2807500000000	28	075	Lauderdale County, MS	2007	NA	33274	31163	2111	6.3
CN2807700000000	28	077	Lawrence County, MS	2007	NA	5150	4765	385	7.5
CN2807900000000	28	079	Leake County, MS	2007	NA	8152	7636	516	6.3
CN2808100000000	28	081	Lee County, MS	2007	NA	37650	35357	2293	6.1
CN2808300000000	28	083	Leflore County, MS	2007	NA	13829	12731	1098	7.9
CN2808500000000	28	085	Lincoln County, MS	2007	NA	14222	13312	910	6.4
CN2808700000000	28	087	Lowndes County, MS	2007	NA	26208	24262	1946	7.4
CN2808900000000	28	089	Madison County, MS	2007	NA	45385	43266	2119	4.7
CN2809100000000	28	091	Marion County, MS	2007	NA	10329	9683	646	6.3
CN2809300000000	28	093	Marshall County, MS	2007	NA	15413	14270	1143	7.4
CN2809500000000	28	095	Monroe County, MS	2007	NA	16536	15021	1515	9.2
CN2809700000000	28	097	Montgomery County, MS	2007	NA	4493	4084	409	9.1
CN2809900000000	28	099	Neshoba County, MS	2007	NA	13988	13284	704	5
CN2810100000000	28	101	Newton County, MS	2007	NA	9570	9036	534	5.6
CN2810300000000	28	103	Noxubee County, MS	2007	NA	4018	3518	500	12.4
CN2810500000000	28	105	Oktibbeha County, MS	2007	NA	19921	18619	1302	6.5
CN2810700000000	28	107	Panola County, MS	2007	NA	14994	13808	1186	7.9
CN2810900000000	28	109	Pearl River County, MS	2007	NA	21604	20333	1271	5.9
CN2811100000000	28	111	Perry County, MS	2007	NA	5130	4784	346	6.7
CN2811300000000	28	113	Pike County, MS	2007	NA	15421	14405	1016	6.6
CN2811500000000	28	115	Pontotoc County, MS	2007	NA	13195	12345	850	6.4
CN2811700000000	28	117	Prentiss County, MS	2007	NA	11107	10277	830	7.5
CN2811900000000	28	119	Quitman County, MS	2007	NA	3780	3470	310	8.2
CN2812100000000	28	121	Rankin County, MS	2007	NA	73005	70131	2874	3.9
CN2812300000000	28	123	Scott County, MS	2007	NA	13266	12619	647	4.9
CN2812500000000	28	125	Sharkey County, MS	2007	NA	2549	2339	210	8.2
CN2812700000000	28	127	Simpson County, MS	2007	NA	11566	10933	633	5.5
CN2812900000000	28	129	Smith County, MS	2007	NA	6732	6370	362	5.4
CN2813100000000	28	131	Stone County, MS	2007	NA	7700	7268	432	5.6
CN2813300000000	28	133	Sunflower County, MS	2007	NA	10892	9853	1039	9.5
CN2813500000000	28	135	Tallahatchie County, MS	2007	NA	6034	5571	463	7.7
CN2813700000000	28	137	Tate County, MS	2007	NA	11838	11132	706	6
CN2813900000000	28	139	Tippah County, MS	2007	NA	9237	8586	651	7
CN2814100000000	28	141	Tishomingo County, MS	2007	NA	7974	7342	632	7.9
CN2814300000000	28	143	Tunica County, MS	2007	NA	4392	4047	345	7.9
CN2814500000000	28	145	Union County, MS	2007	NA	11808	11086	722	6.1
CN2814700000000	28	147	Walthall County, MS	2007	NA	5878	5510	368	6.3
CN2814900000000	28	149	Warren County, MS	2007	NA	22131	20783	1348	6.1
CN2815100000000	28	151	Washington County, MS	2007	NA	22053	20204	1849	8.4
CN2815300000000	28	153	Wayne County, MS	2007	NA	8678	8122	556	6.4
CN2815500000000	28	155	Webster County, MS	2007	NA	3413	3137	276	8.1
CN2815700000000	28	157	Wilkinson County, MS	2007	NA	3597	3294	303	8.4
CN2815900000000	28	159	Winston County, MS	2007	NA	8025	7496	529	6.6
CN2816100000000	28	161	Yalobusha County, MS	2007	NA	5319	4911	408	7.7
CN2816300000000	28	163	Yazoo County, MS	2007	NA	10156	9387	769	7.6
CN2900100000000	29	001	Adair County, MO	2007	NA	13500	12851	649	4.8
CN2900300000000	29	003	Andrew County, MO	2007	NA	10197	9795	402	3.9
CN2900500000000	29	005	Atchison County, MO	2007	NA	3209	3069	140	4.4
CN2900700000000	29	007	Audrain County, MO	2007	NA	12293	11688	605	4.9
CN2900900000000	29	009	Barry County, MO	2007	NA	17739	16874	865	4.9
CN2901100000000	29	011	Barton County, MO	2007	NA	5722	5226	496	8.7
CN2901300000000	29	013	Bates County, MO	2007	NA	7921	7440	481	6.1
CN2901500000000	29	015	Benton County, MO	2007	NA	8358	7861	497	5.9
CN2901700000000	29	017	Bollinger County, MO	2007	NA	5739	5427	312	5.4
CN2901900000000	29	019	Boone County, MO	2007	NA	87412	84162	3250	3.7
CN2902100000000	29	021	Buchanan County, MO	2007	NA	48263	46115	2148	4.5
CN2902300000000	29	023	Butler County, MO	2007	NA	21386	19981	1405	6.6
CN2902500000000	29	025	Caldwell County, MO	2007	NA	4374	4135	239	5.5
CN2902700000000	29	027	Callaway County, MO	2007	NA	22741	21734	1007	4.4
CN2902900000000	29	029	Camden County, MO	2007	NA	22017	20942	1075	4.9
CN2903100000000	29	031	Cape Girardeau County, MO	2007	NA	38991	37317	1674	4.3
CN2903300000000	29	033	Carroll County, MO	2007	NA	5226	4962	264	5.1
CN2903500000000	29	035	Carter County, MO	2007	NA	2904	2721	183	6.3
CN2903700000000	29	037	Cass County, MO	2007	NA	50176	47686	2490	5
CN2903900000000	29	039	Cedar County, MO	2007	NA	6483	6114	369	5.7
CN2904100000000	29	041	Chariton County, MO	2007	NA	3936	3717	219	5.6
CN2904300000000	29	043	Christian County, MO	2007	NA	39791	38246	1545	3.9
CN2904500000000	29	045	Clark County, MO	2007	NA	3601	3402	199	5.5
CN2904700000000	29	047	Clay County, MO	2007	NA	116357	111327	5030	4.3
CN2904900000000	29	049	Clinton County, MO	2007	NA	10394	9857	537	5.2
CN2905100000000	29	051	Cole County, MO	2007	NA	40140	38575	1565	3.9
CN2905300000000	29	053	Cooper County, MO	2007	NA	9187	8775	412	4.5
CN2905500000000	29	055	Crawford County, MO	2007	NA	12165	11309	856	7
CN2905700000000	29	057	Dade County, MO	2007	NA	3745	3546	199	5.3
CN2905900000000	29	059	Dallas County, MO	2007	NA	7501	7105	396	5.3
CN2906100000000	29	061	Daviess County, MO	2007	NA	4031	3850	181	4.5
CN2906300000000	29	063	DeKalb County, MO	2007	NA	5259	4986	273	5.2
CN2906500000000	29	065	Dent County, MO	2007	NA	6654	6207	447	6.7
CN2906700000000	29	067	Douglas County, MO	2007	NA	5881	5534	347	5.9
CN2906900000000	29	069	Dunklin County, MO	2007	NA	14273	13128	1145	8
CN2907100000000	29	071	Franklin County, MO	2007	NA	52534	49604	2930	5.6
CN2907300000000	29	073	Gasconade County, MO	2007	NA	8110	7662	448	5.5
CN2907500000000	29	075	Gentry County, MO	2007	NA	3398	3259	139	4.1
CN2907700000000	29	077	Greene County, MO	2007	NA	141794	136126	5668	4
CN2907900000000	29	079	Grundy County, MO	2007	NA	4804	4572	232	4.8
CN2908100000000	29	081	Harrison County, MO	2007	NA	4547	4340	207	4.6
CN2908300000000	29	083	Henry County, MO	2007	NA	10911	10298	613	5.6
CN2908500000000	29	085	Hickory County, MO	2007	NA	3422	3166	256	7.5
CN2908700000000	29	087	Holt County, MO	2007	NA	2702	2566	136	5
CN2908900000000	29	089	Howard County, MO	2007	NA	5136	4907	229	4.5
CN2909100000000	29	091	Howell County, MO	2007	NA	19812	18889	923	4.7
CN2909300000000	29	093	Iron County, MO	2007	NA	5372	5085	287	5.3
CN2909500000000	29	095	Jackson County, MO	2007	NA	336581	316869	19712	5.9
CN2909700000000	29	097	Jasper County, MO	2007	NA	56572	54023	2549	4.5
CN2909900000000	29	099	Jefferson County, MO	2007	NA	116051	110041	6010	5.2
CN2910100000000	29	101	Johnson County, MO	2007	NA	26272	25055	1217	4.6
CN2910300000000	29	103	Knox County, MO	2007	NA	2344	2255	89	3.8
CN2910500000000	29	105	Laclede County, MO	2007	NA	17588	16607	981	5.6
CN2910700000000	29	107	Lafayette County, MO	2007	NA	16448	15599	849	5.2
CN2910900000000	29	109	Lawrence County, MO	2007	NA	19267	18487	780	4
CN2911100000000	29	111	Lewis County, MO	2007	NA	5682	5457	225	4
CN2911300000000	29	113	Lincoln County, MO	2007	NA	26364	24869	1495	5.7
CN2911500000000	29	115	Linn County, MO	2007	NA	6455	6043	412	6.4
CN2911700000000	29	117	Livingston County, MO	2007	NA	7160	6845	315	4.4
CN2911900000000	29	119	McDonald County, MO	2007	NA	11504	11028	476	4.1
CN2912100000000	29	121	Macon County, MO	2007	NA	8044	7643	401	5
CN2912300000000	29	123	Madison County, MO	2007	NA	6056	5711	345	5.7
CN2912500000000	29	125	Maries County, MO	2007	NA	4772	4524	248	5.2
CN2912700000000	29	127	Marion County, MO	2007	NA	14435	13670	765	5.3
CN2912900000000	29	129	Mercer County, MO	2007	NA	1804	1730	74	4.1
CN2913100000000	29	131	Miller County, MO	2007	NA	13345	12643	702	5.3
CN2913300000000	29	133	Mississippi County, MO	2007	NA	5878	5492	386	6.6
CN2913500000000	29	135	Moniteau County, MO	2007	NA	7487	7141	346	4.6
CN2913700000000	29	137	Monroe County, MO	2007	NA	4351	4102	249	5.7
CN2913900000000	29	139	Montgomery County, MO	2007	NA	6123	5789	334	5.5
CN2914100000000	29	141	Morgan County, MO	2007	NA	9334	8758	576	6.2
CN2914300000000	29	143	New Madrid County, MO	2007	NA	8924	8310	614	6.9
CN2914500000000	29	145	Newton County, MO	2007	NA	27856	26541	1315	4.7
CN2914700000000	29	147	Nodaway County, MO	2007	NA	12575	12104	471	3.7
CN2914900000000	29	149	Oregon County, MO	2007	NA	4554	4318	236	5.2
CN2915100000000	29	151	Osage County, MO	2007	NA	7371	7023	348	4.7
CN2915300000000	29	153	Ozark County, MO	2007	NA	4388	4158	230	5.2
CN2915500000000	29	155	Pemiscot County, MO	2007	NA	8130	7594	536	6.6
CN2915700000000	29	157	Perry County, MO	2007	NA	10416	10006	410	3.9
CN2915900000000	29	159	Pettis County, MO	2007	NA	20973	19877	1096	5.2
CN2916100000000	29	161	Phelps County, MO	2007	NA	21975	20889	1086	4.9
CN2916300000000	29	163	Pike County, MO	2007	NA	8885	8438	447	5
CN2916500000000	29	165	Platte County, MO	2007	NA	48683	46764	1919	3.9
CN2916700000000	29	167	Polk County, MO	2007	NA	14375	13686	689	4.8
CN2916900000000	29	169	Pulaski County, MO	2007	NA	18724	17755	969	5.2
CN2917100000000	29	171	Putnam County, MO	2007	NA	2489	2351	138	5.5
CN2917300000000	29	173	Ralls County, MO	2007	NA	5598	5324	274	4.9
CN2917500000000	29	175	Randolph County, MO	2007	NA	13122	12418	704	5.4
CN2917700000000	29	177	Ray County, MO	2007	NA	11477	10866	611	5.3
CN2917900000000	29	179	Reynolds County, MO	2007	NA	2635	2454	181	6.9
CN2918100000000	29	181	Ripley County, MO	2007	NA	6645	6202	443	6.7
CN2918300000000	29	183	St. Charles County, MO	2007	NA	192549	184674	7875	4.1
CN2918500000000	29	185	St. Clair County, MO	2007	NA	4224	3948	276	6.5
CN2918600000000	29	186	Ste. Genevieve County, MO	2007	NA	9932	9468	464	4.7
CN2918700000000	29	187	St. Francois County, MO	2007	NA	29341	27628	1713	5.8
CN2918900000000	29	189	St. Louis County, MO	2007	NA	526028	499911	26117	5
CN2919500000000	29	195	Saline County, MO	2007	NA	11701	11110	591	5.1
CN2919700000000	29	197	Schuyler County, MO	2007	NA	2165	2041	124	5.7
CN2919900000000	29	199	Scotland County, MO	2007	NA	2512	2392	120	4.8
CN2920100000000	29	201	Scott County, MO	2007	NA	19933	18768	1165	5.8
CN2920300000000	29	203	Shannon County, MO	2007	NA	3716	3461	255	6.9
CN2920500000000	29	205	Shelby County, MO	2007	NA	3320	3154	166	5
CN2920700000000	29	207	Stoddard County, MO	2007	NA	15519	14525	994	6.4
CN2920900000000	29	209	Stone County, MO	2007	NA	16361	15309	1052	6.4
CN2921100000000	29	211	Sullivan County, MO	2007	NA	3294	3091	203	6.2
CN2921300000000	29	213	Taney County, MO	2007	NA	27358	25500	1858	6.8
CN2921500000000	29	215	Texas County, MO	2007	NA	11013	10387	626	5.7
CN2921700000000	29	217	Vernon County, MO	2007	NA	10077	9584	493	4.9
CN2921900000000	29	219	Warren County, MO	2007	NA	16150	15278	872	5.4
CN2922100000000	29	221	Washington County, MO	2007	NA	10006	9179	827	8.3
CN2922300000000	29	223	Wayne County, MO	2007	NA	5691	5297	394	6.9
CN2922500000000	29	225	Webster County, MO	2007	NA	17034	16218	816	4.8
CN2922700000000	29	227	Worth County, MO	2007	NA	1147	1094	53	4.6
CN2922900000000	29	229	Wright County, MO	2007	NA	8087	7603	484	6
CN2951000000000	29	510	St. Louis city, MO	2007	NA	157604	146435	11169	7.1
CN3000100000000	30	001	Beaverhead County, MT	2007	NA	5033	4892	141	2.8
CN3000300000000	30	003	Big Horn County, MT	2007	NA	5078	4740	338	6.7
CN3000500000000	30	005	Blaine County, MT	2007	NA	2858	2749	109	3.8
CN3000700000000	30	007	Broadwater County, MT	2007	NA	2371	2294	77	3.2
CN3000900000000	30	009	Carbon County, MT	2007	NA	5350	5197	153	2.9
CN3001100000000	30	011	Carter County, MT	2007	NA	685	664	21	3.1
CN3001300000000	30	013	Cascade County, MT	2007	NA	39577	38199	1378	3.5
CN3001500000000	30	015	Chouteau County, MT	2007	NA	2517	2438	79	3.1
CN3001700000000	30	017	Custer County, MT	2007	NA	5760	5567	193	3.4
CN3001900000000	30	019	Daniels County, MT	2007	NA	768	747	21	2.7
CN3002100000000	30	021	Dawson County, MT	2007	NA	4255	4135	120	2.8
CN3002300000000	30	023	Deer Lodge County, MT	2007	NA	3901	3715	186	4.8
CN3002500000000	30	025	Fallon County, MT	2007	NA	1741	1706	35	2
CN3002700000000	30	027	Fergus County, MT	2007	NA	5862	5630	232	4
CN3002900000000	30	029	Flathead County, MT	2007	NA	45734	43927	1807	4
CN3003100000000	30	031	Gallatin County, MT	2007	NA	50406	49082	1324	2.6
CN3003300000000	30	033	Garfield County, MT	2007	NA	643	624	19	3
CN3003500000000	30	035	Glacier County, MT	2007	NA	5812	5346	466	8
CN3003700000000	30	037	Golden Valley County, MT	2007	NA	561	539	22	3.9
CN3003900000000	30	039	Granite County, MT	2007	NA	1283	1222	61	4.8
CN3004100000000	30	041	Hill County, MT	2007	NA	8078	7745	333	4.1
CN3004300000000	30	043	Jefferson County, MT	2007	NA	5851	5668	183	3.1
CN3004500000000	30	045	Judith Basin County, MT	2007	NA	1046	1007	39	3.7
CN3004700000000	30	047	Lake County, MT	2007	NA	11641	11006	635	5.5
CN3004900000000	30	049	Lewis and Clark County, MT	2007	NA	33292	32281	1011	3
CN3005100000000	30	051	Liberty County, MT	2007	NA	799	776	23	2.9
CN3005300000000	30	053	Lincoln County, MT	2007	NA	7811	7227	584	7.5
CN3005500000000	30	055	McCone County, MT	2007	NA	1000	978	22	2.2
CN3005700000000	30	057	Madison County, MT	2007	NA	4446	4319	127	2.9
CN3005900000000	30	059	Meagher County, MT	2007	NA	901	850	51	5.7
CN3006100000000	30	061	Mineral County, MT	2007	NA	1968	1875	93	4.7
CN3006300000000	30	063	Missoula County, MT	2007	NA	59156	57129	2027	3.4
CN3006500000000	30	065	Musselshell County, MT	2007	NA	2037	1928	109	5.4
CN3006700000000	30	067	Park County, MT	2007	NA	9075	8755	320	3.5
CN3006900000000	30	069	Petroleum County, MT	2007	NA	235	223	12	5.1
CN3007100000000	30	071	Phillips County, MT	2007	NA	2055	1969	86	4.2
CN3007300000000	30	073	Pondera County, MT	2007	NA	2721	2613	108	4
CN3007500000000	30	075	Powder River County, MT	2007	NA	898	869	29	3.2
CN3007700000000	30	077	Powell County, MT	2007	NA	2644	2503	141	5.3
CN3007900000000	30	079	Prairie County, MT	2007	NA	545	526	19	3.5
CN3008100000000	30	081	Ravalli County, MT	2007	NA	18648	17813	835	4.5
CN3008300000000	30	083	Richland County, MT	2007	NA	5436	5305	131	2.4
CN3008500000000	30	085	Roosevelt County, MT	2007	NA	3855	3614	241	6.3
CN3008700000000	30	087	Rosebud County, MT	2007	NA	3922	3718	204	5.2
CN3008900000000	30	089	Sanders County, MT	2007	NA	4683	4374	309	6.6
CN3009100000000	30	091	Sheridan County, MT	2007	NA	1731	1684	47	2.7
CN3009300000000	30	093	Silver Bow County, MT	2007	NA	17398	16765	633	3.6
CN3009500000000	30	095	Stillwater County, MT	2007	NA	4508	4366	142	3.1
CN3009700000000	30	097	Sweet Grass County, MT	2007	NA	2920	2866	54	1.8
CN3009900000000	30	099	Teton County, MT	2007	NA	3063	2968	95	3.1
CN3010100000000	30	101	Toole County, MT	2007	NA	2454	2392	62	2.5
CN3010300000000	30	103	Treasure County, MT	2007	NA	405	392	13	3.2
CN3010500000000	30	105	Valley County, MT	2007	NA	3637	3511	126	3.5
CN3010700000000	30	107	Wheatland County, MT	2007	NA	1038	1003	35	3.4
CN3010900000000	30	109	Wibaux County, MT	2007	NA	515	501	14	2.7
CN3011100000000	30	111	Yellowstone County, MT	2007	NA	81465	79262	2203	2.7
CN3100100000000	31	001	Adams County, NE	2007	NA	17374	16903	471	2.7
CN3100300000000	31	003	Antelope County, NE	2007	NA	3631	3528	103	2.8
CN3100500000000	31	005	Arthur County, NE	2007	NA	238	229	9	3.8
CN3100700000000	31	007	Banner County, NE	2007	NA	403	395	8	2
CN3100900000000	31	009	Blaine County, NE	2007	NA	238	229	9	3.8
CN3101100000000	31	011	Boone County, NE	2007	NA	3169	3092	77	2.4
CN3101300000000	31	013	Box Butte County, NE	2007	NA	5613	5433	180	3.2
CN3101500000000	31	015	Boyd County, NE	2007	NA	1075	1043	32	3
CN3101700000000	31	017	Brown County, NE	2007	NA	1813	1765	48	2.6
CN3101900000000	31	019	Buffalo County, NE	2007	NA	28042	27414	628	2.2
CN3102100000000	31	021	Burt County, NE	2007	NA	3910	3754	156	4
CN3102300000000	31	023	Butler County, NE	2007	NA	4831	4709	122	2.5
CN3102500000000	31	025	Cass County, NE	2007	NA	13876	13417	459	3.3
CN3102700000000	31	027	Cedar County, NE	2007	NA	4776	4660	116	2.4
CN3102900000000	31	029	Chase County, NE	2007	NA	1996	1947	49	2.5
CN3103100000000	31	031	Cherry County, NE	2007	NA	3389	3313	76	2.2
CN3103300000000	31	033	Cheyenne County, NE	2007	NA	5242	5116	126	2.4
CN3103500000000	31	035	Clay County, NE	2007	NA	3111	3025	86	2.8
CN3103700000000	31	037	Colfax County, NE	2007	NA	5646	5522	124	2.2
CN3103900000000	31	039	Cuming County, NE	2007	NA	4995	4860	135	2.7
CN3104100000000	31	041	Custer County, NE	2007	NA	6005	5877	128	2.1
CN3104300000000	31	043	Dakota County, NE	2007	NA	10928	10490	438	4
CN3104500000000	31	045	Dawes County, NE	2007	NA	4802	4671	131	2.7
CN3104700000000	31	047	Dawson County, NE	2007	NA	12349	11973	376	3
CN3104900000000	31	049	Deuel County, NE	2007	NA	1050	1020	30	2.9
CN3105100000000	31	051	Dixon County, NE	2007	NA	3313	3209	104	3.1
CN3105300000000	31	053	Dodge County, NE	2007	NA	19826	19194	632	3.2
CN3105500000000	31	055	Douglas County, NE	2007	NA	269973	260826	9147	3.4
CN3105700000000	31	057	Dundy County, NE	2007	NA	1016	990	26	2.6
CN3105900000000	31	059	Fillmore County, NE	2007	NA	3173	3093	80	2.5
CN3106100000000	31	061	Franklin County, NE	2007	NA	1797	1747	50	2.8
CN3106300000000	31	063	Frontier County, NE	2007	NA	1660	1622	38	2.3
CN3106500000000	31	065	Furnas County, NE	2007	NA	2469	2395	74	3
CN3106700000000	31	067	Gage County, NE	2007	NA	12510	12062	448	3.6
CN3106900000000	31	069	Garden County, NE	2007	NA	936	911	25	2.7
CN3107100000000	31	071	Garfield County, NE	2007	NA	1037	1011	26	2.5
CN3107300000000	31	073	Gosper County, NE	2007	NA	1043	1010	33	3.2
CN3107500000000	31	075	Grant County, NE	2007	NA	385	375	10	2.6
CN3107700000000	31	077	Greeley County, NE	2007	NA	1278	1244	34	2.7
CN3107900000000	31	079	Hall County, NE	2007	NA	30960	30101	859	2.8
CN3108100000000	31	081	Hamilton County, NE	2007	NA	5640	5515	125	2.2
CN3108300000000	31	083	Harlan County, NE	2007	NA	1812	1765	47	2.6
CN3108500000000	31	085	Hayes County, NE	2007	NA	460	444	16	3.5
CN3108700000000	31	087	Hitchcock County, NE	2007	NA	1442	1403	39	2.7
CN3108900000000	31	089	Holt County, NE	2007	NA	6038	5883	155	2.6
CN3109100000000	31	091	Hooker County, NE	2007	NA	465	452	13	2.8
CN3109300000000	31	093	Howard County, NE	2007	NA	3708	3606	102	2.8
CN3109500000000	31	095	Jefferson County, NE	2007	NA	4576	4451	125	2.7
CN3109700000000	31	097	Johnson County, NE	2007	NA	2874	2790	84	2.9
CN3109900000000	31	099	Kearney County, NE	2007	NA	3808	3724	84	2.2
CN3110100000000	31	101	Keith County, NE	2007	NA	4662	4544	118	2.5
CN3110300000000	31	103	Keya Paha County, NE	2007	NA	379	365	14	3.7
CN3110500000000	31	105	Kimball County, NE	2007	NA	1974	1919	55	2.8
CN3110700000000	31	107	Knox County, NE	2007	NA	4712	4573	139	2.9
CN3110900000000	31	109	Lancaster County, NE	2007	NA	157366	152970	4396	2.8
CN3111100000000	31	111	Lincoln County, NE	2007	NA	21756	21182	574	2.6
CN3111300000000	31	113	Logan County, NE	2007	NA	471	458	13	2.8
CN3111500000000	31	115	Loup County, NE	2007	NA	333	319	14	4.2
CN3111700000000	31	117	McPherson County, NE	2007	NA	300	294	6	2
CN3111900000000	31	119	Madison County, NE	2007	NA	18819	18225	594	3.2
CN3112100000000	31	121	Merrick County, NE	2007	NA	4174	4054	120	2.9
CN3112300000000	31	123	Morrill County, NE	2007	NA	2778	2705	73	2.6
CN3112500000000	31	125	Nance County, NE	2007	NA	2020	1970	50	2.5
CN3112700000000	31	127	Nemaha County, NE	2007	NA	3505	3371	134	3.8
CN3112900000000	31	129	Nuckolls County, NE	2007	NA	2240	2181	59	2.6
CN3113100000000	31	131	Otoe County, NE	2007	NA	8949	8681	268	3
CN3113300000000	31	133	Pawnee County, NE	2007	NA	1587	1540	47	3
CN3113500000000	31	135	Perkins County, NE	2007	NA	1577	1539	38	2.4
CN3113700000000	31	137	Phelps County, NE	2007	NA	5101	4985	116	2.3
CN3113900000000	31	139	Pierce County, NE	2007	NA	3954	3836	118	3
CN3114100000000	31	141	Platte County, NE	2007	NA	18401	17953	448	2.4
CN3114300000000	31	143	Polk County, NE	2007	NA	2967	2884	83	2.8
CN3114500000000	31	145	Red Willow County, NE	2007	NA	5921	5772	149	2.5
CN3114700000000	31	147	Richardson County, NE	2007	NA	4272	4097	175	4.1
CN3114900000000	31	149	Rock County, NE	2007	NA	877	854	23	2.6
CN3115100000000	31	151	Saline County, NE	2007	NA	8315	8094	221	2.7
CN3115300000000	31	153	Sarpy County, NE	2007	NA	76803	74562	2241	2.9
CN3115500000000	31	155	Saunders County, NE	2007	NA	10958	10619	339	3.1
CN3115700000000	31	157	Scotts Bluff County, NE	2007	NA	19485	18909	576	3
CN3115900000000	31	159	Seward County, NE	2007	NA	8893	8650	243	2.7
CN3116100000000	31	161	Sheridan County, NE	2007	NA	3108	3025	83	2.7
CN3116300000000	31	163	Sherman County, NE	2007	NA	1909	1858	51	2.7
CN3116500000000	31	165	Sioux County, NE	2007	NA	707	687	20	2.8
CN3116700000000	31	167	Stanton County, NE	2007	NA	3554	3449	105	3
CN3116900000000	31	169	Thayer County, NE	2007	NA	2863	2787	76	2.7
CN3117100000000	31	171	Thomas County, NE	2007	NA	378	364	14	3.7
CN3117300000000	31	173	Thurston County, NE	2007	NA	2988	2793	195	6.5
CN3117500000000	31	175	Valley County, NE	2007	NA	2572	2511	61	2.4
CN3117700000000	31	177	Washington County, NE	2007	NA	11268	10948	320	2.8
CN3117900000000	31	179	Wayne County, NE	2007	NA	5304	5169	135	2.5
CN3118100000000	31	181	Webster County, NE	2007	NA	1803	1744	59	3.3
CN3118300000000	31	183	Wheeler County, NE	2007	NA	417	405	12	2.9
CN3118500000000	31	185	York County, NE	2007	NA	7648	7440	208	2.7
CN3200100000000	32	001	Churchill County, NV	2007	NA	13152	12585	567	4.3
CN3200300000000	32	003	Clark County, NV	2007	NA	951064	908308	42756	4.5
CN3200500000000	32	005	Douglas County, NV	2007	NA	22599	21503	1096	4.8
CN3200700000000	32	007	Elko County, NV	2007	NA	26420	25555	865	3.3
CN3200900000000	32	009	Esmeralda County, NV	2007	NA	473	458	15	3.2
CN3201100000000	32	011	Eureka County, NV	2007	NA	809	775	34	4.2
CN3201300000000	32	013	Humboldt County, NV	2007	NA	7959	7675	284	3.6
CN3201500000000	32	015	Lander County, NV	2007	NA	3386	3277	109	3.2
CN3201700000000	32	017	Lincoln County, NV	2007	NA	1722	1650	72	4.2
CN3201900000000	32	019	Lyon County, NV	2007	NA	22279	20853	1426	6.4
CN3202100000000	32	021	Mineral County, NV	2007	NA	2236	2097	139	6.2
CN3202300000000	32	023	Nye County, NV	2007	NA	17812	16655	1157	6.5
CN3202700000000	32	027	Pershing County, NV	2007	NA	2492	2368	124	5
CN3202900000000	32	029	Storey County, NV	2007	NA	2396	2278	118	4.9
CN3203100000000	32	031	Washoe County, NV	2007	NA	222441	212915	9526	4.3
CN3203300000000	32	033	White Pine County, NV	2007	NA	4749	4576	173	3.6
CN3251000000000	32	510	Carson City, NV	2007	NA	28410	27047	1363	4.8
CN3300100000000	33	001	Belknap County, NH	2007	NA	32409	31253	1156	3.6
CN3300300000000	33	003	Carroll County, NH	2007	NA	25496	24620	876	3.4
CN3300500000000	33	005	Cheshire County, NH	2007	NA	42088	40597	1491	3.5
CN3300700000000	33	007	Coos County, NH	2007	NA	16698	15928	770	4.6
CN3300900000000	33	009	Grafton County, NH	2007	NA	48284	46858	1426	3
CN3301100000000	33	011	Hillsborough County, NH	2007	NA	228214	220129	8085	3.5
CN3301300000000	33	013	Merrimack County, NH	2007	NA	80318	77657	2661	3.3
CN3301500000000	33	015	Rockingham County, NH	2007	NA	173675	167110	6565	3.8
CN3301700000000	33	017	Strafford County, NH	2007	NA	68206	65980	2226	3.3
CN3301900000000	33	019	Sullivan County, NH	2007	NA	22548	21875	673	3
CN3400100000000	34	001	Atlantic County, NJ	2007	NA	135104	127177	7927	5.9
CN3400300000000	34	003	Bergen County, NJ	2007	NA	471472	455223	16249	3.4
CN3400500000000	34	005	Burlington County, NJ	2007	NA	237634	228511	9123	3.8
CN3400700000000	34	007	Camden County, NJ	2007	NA	262569	249877	12692	4.8
CN3400900000000	34	009	Cape May County, NJ	2007	NA	56472	52765	3707	6.6
CN3401100000000	34	011	Cumberland County, NJ	2007	NA	68174	63719	4455	6.5
CN3401300000000	34	013	Essex County, NJ	2007	NA	361575	342249	19326	5.3
CN3401500000000	34	015	Gloucester County, NJ	2007	NA	153893	147255	6638	4.3
CN3401700000000	34	017	Hudson County, NJ	2007	NA	290029	275553	14476	5
CN3401900000000	34	019	Hunterdon County, NJ	2007	NA	72048	69995	2053	2.8
CN3402100000000	34	021	Mercer County, NJ	2007	NA	196360	188835	7525	3.8
CN3402300000000	34	023	Middlesex County, NJ	2007	NA	420390	404171	16219	3.9
CN3402500000000	34	025	Monmouth County, NJ	2007	NA	331122	318729	12393	3.7
CN3402700000000	34	027	Morris County, NJ	2007	NA	271713	263489	8224	3
CN3402900000000	34	029	Ocean County, NJ	2007	NA	256510	244810	11700	4.6
CN3403100000000	34	031	Passaic County, NJ	2007	NA	236506	223853	12653	5.3
CN3403300000000	34	033	Salem County, NJ	2007	NA	31279	29729	1550	5
CN3403500000000	34	035	Somerset County, NJ	2007	NA	179245	173688	5557	3.1
CN3403700000000	34	037	Sussex County, NJ	2007	NA	84106	80801	3305	3.9
CN3403900000000	34	039	Union County, NJ	2007	NA	267086	255096	11990	4.5
CN3404100000000	34	041	Warren County, NJ	2007	NA	58513	56291	2222	3.8
CN3500100000000	35	001	Bernalillo County, NM	2007	NA	312319	301166	11153	3.6
CN3500300000000	35	003	Catron County, NM	2007	NA	1505	1432	73	4.9
CN3500500000000	35	005	Chaves County, NM	2007	NA	26808	25763	1045	3.9
CN3500600000000	35	006	Cibola County, NM	2007	NA	11968	11463	505	4.2
CN3500700000000	35	007	Colfax County, NM	2007	NA	6560	6328	232	3.5
CN3500900000000	35	009	Curry County, NM	2007	NA	20964	20368	596	2.8
CN3501100000000	35	011	De Baca County, NM	2007	NA	779	749	30	3.9
CN3501300000000	35	013	Dona Ana County, NM	2007	NA	86938	83322	3616	4.2
CN3501500000000	35	015	Eddy County, NM	2007	NA	26054	25280	774	3
CN3501700000000	35	017	Grant County, NM	2007	NA	12230	11762	468	3.8
CN3501900000000	35	019	Guadalupe County, NM	2007	NA	1791	1686	105	5.9
CN3502100000000	35	021	Harding County, NM	2007	NA	389	378	11	2.8
CN3502300000000	35	023	Hidalgo County, NM	2007	NA	2518	2442	76	3
CN3502500000000	35	025	Lea County, NM	2007	NA	27686	26999	687	2.5
CN3502700000000	35	027	Lincoln County, NM	2007	NA	10883	10547	336	3.1
CN3502800000000	35	028	Los Alamos County, NM	2007	NA	10485	10257	228	2.2
CN3502900000000	35	029	Luna County, NM	2007	NA	12315	11067	1248	10.1
CN3503100000000	35	031	McKinley County, NM	2007	NA	26725	25483	1242	4.6
CN3503300000000	35	033	Mora County, NM	2007	NA	2018	1859	159	7.9
CN3503500000000	35	035	Otero County, NM	2007	NA	25992	25003	989	3.8
CN3503700000000	35	037	Quay County, NM	2007	NA	3839	3665	174	4.5
CN3503900000000	35	039	Rio Arriba County, NM	2007	NA	20310	19345	965	4.8
CN3504100000000	35	041	Roosevelt County, NM	2007	NA	9512	9244	268	2.8
CN3504300000000	35	043	Sandoval County, NM	2007	NA	54017	51700	2317	4.3
CN3504500000000	35	045	San Juan County, NM	2007	NA	55637	53758	1879	3.4
CN3504700000000	35	047	San Miguel County, NM	2007	NA	13342	12784	558	4.2
CN3504900000000	35	049	Santa Fe County, NM	2007	NA	78018	75672	2346	3
CN3505100000000	35	051	Sierra County, NM	2007	NA	5545	5349	196	3.5
CN3505300000000	35	053	Socorro County, NM	2007	NA	9350	9050	300	3.2
CN3505500000000	35	055	Taos County, NM	2007	NA	17745	16877	868	4.9
CN3505700000000	35	057	Torrance County, NM	2007	NA	7086	6757	329	4.6
CN3505900000000	35	059	Union County, NM	2007	NA	1874	1823	51	2.7
CN3506100000000	35	061	Valencia County, NM	2007	NA	30827	29620	1207	3.9
CN3600100000000	36	001	Albany County, NY	2007	NA	158712	152567	6145	3.9
CN3600300000000	36	003	Allegany County, NY	2007	NA	23405	22129	1276	5.5
CN3600500000000	36	005	Bronx County, NY	2007	NA	512479	477487	34992	6.8
CN3600700000000	36	007	Broome County, NY	2007	NA	96858	92549	4309	4.4
CN3600900000000	36	009	Cattaraugus County, NY	2007	NA	41269	39164	2105	5.1
CN3601100000000	36	011	Cayuga County, NY	2007	NA	41137	39312	1825	4.4
CN3601300000000	36	013	Chautauqua County, NY	2007	NA	66781	63790	2991	4.5
CN3601500000000	36	015	Chemung County, NY	2007	NA	40956	39080	1876	4.6
CN3601700000000	36	017	Chenango County, NY	2007	NA	24405	23200	1205	4.9
CN3601900000000	36	019	Clinton County, NY	2007	NA	39784	37556	2228	5.6
CN3602100000000	36	021	Columbia County, NY	2007	NA	31765	30530	1235	3.9
CN3602300000000	36	023	Cortland County, NY	2007	NA	23737	22508	1229	5.2
CN3602500000000	36	025	Delaware County, NY	2007	NA	23129	22128	1001	4.3
CN3602700000000	36	027	Dutchess County, NY	2007	NA	145515	139838	5677	3.9
CN3602900000000	36	029	Erie County, NY	2007	NA	465331	443492	21839	4.7
CN3603100000000	36	031	Essex County, NY	2007	NA	18557	17506	1051	5.7
CN3603300000000	36	033	Franklin County, NY	2007	NA	22634	21379	1255	5.5
CN3603500000000	36	035	Fulton County, NY	2007	NA	27345	25875	1470	5.4
CN3603700000000	36	037	Genesee County, NY	2007	NA	32868	31375	1493	4.5
CN3603900000000	36	039	Greene County, NY	2007	NA	24124	22978	1146	4.8
CN3604100000000	36	041	Hamilton County, NY	2007	NA	3208	3057	151	4.7
CN3604300000000	36	043	Herkimer County, NY	2007	NA	30974	29456	1518	4.9
CN3604500000000	36	045	Jefferson County, NY	2007	NA	48137	45510	2627	5.5
CN3604700000000	36	047	Kings County, NY	2007	NA	1086423	1027298	59125	5.4
CN3604900000000	36	049	Lewis County, NY	2007	NA	12487	11809	678	5.4
CN3605100000000	36	051	Livingston County, NY	2007	NA	32250	30671	1579	4.9
CN3605300000000	36	053	Madison County, NY	2007	NA	35960	34286	1674	4.7
CN3605500000000	36	055	Monroe County, NY	2007	NA	373025	356559	16466	4.4
CN3605700000000	36	057	Montgomery County, NY	2007	NA	24476	23045	1431	5.8
CN3605900000000	36	059	Nassau County, NY	2007	NA	694915	669351	25564	3.7
CN3606100000000	36	061	New York County, NY	2007	NA	917566	877728	39838	4.3
CN3606300000000	36	063	Niagara County, NY	2007	NA	111370	105428	5942	5.3
CN3606500000000	36	065	Oneida County, NY	2007	NA	109920	105220	4700	4.3
CN3606700000000	36	067	Onondaga County, NY	2007	NA	232522	223044	9478	4.1
CN3606900000000	36	069	Ontario County, NY	2007	NA	56227	53872	2355	4.2
CN3607100000000	36	071	Orange County, NY	2007	NA	179230	171540	7690	4.3
CN3607300000000	36	073	Orleans County, NY	2007	NA	19476	18349	1127	5.8
CN3607500000000	36	075	Oswego County, NY	2007	NA	59415	56086	3329	5.6
CN3607700000000	36	077	Otsego County, NY	2007	NA	31622	30194	1428	4.5
CN3607900000000	36	079	Putnam County, NY	2007	NA	55673	53787	1886	3.4
CN3608100000000	36	081	Queens County, NY	2007	NA	1102350	1052959	49391	4.5
CN3608300000000	36	083	Rensselaer County, NY	2007	NA	83128	79590	3538	4.3
CN3608500000000	36	085	Richmond County, NY	2007	NA	239789	228808	10981	4.6
CN3608700000000	36	087	Rockland County, NY	2007	NA	153871	147944	5927	3.9
CN3608900000000	36	089	St. Lawrence County, NY	2007	NA	49337	46476	2861	5.8
CN3609100000000	36	091	Saratoga County, NY	2007	NA	119421	115047	4374	3.7
CN3609300000000	36	093	Schenectady County, NY	2007	NA	75551	72418	3133	4.1
CN3609500000000	36	095	Schoharie County, NY	2007	NA	15725	14816	909	5.8
CN3609700000000	36	097	Schuyler County, NY	2007	NA	9965	9468	497	5
CN3609900000000	36	099	Seneca County, NY	2007	NA	16993	16237	756	4.4
CN3610100000000	36	101	Steuben County, NY	2007	NA	44734	42386	2348	5.2
CN3610300000000	36	103	Suffolk County, NY	2007	NA	787940	757541	30399	3.9
CN3610500000000	36	105	Sullivan County, NY	2007	NA	35227	33391	1836	5.2
CN3610700000000	36	107	Tioga County, NY	2007	NA	26179	24952	1227	4.7
CN3610900000000	36	109	Tompkins County, NY	2007	NA	55351	53485	1866	3.4
CN3611100000000	36	111	Ulster County, NY	2007	NA	90485	86555	3930	4.3
CN3611300000000	36	113	Warren County, NY	2007	NA	36324	34706	1618	4.5
CN3611500000000	36	115	Washington County, NY	2007	NA	32403	31060	1343	4.1
CN3611700000000	36	117	Wayne County, NY	2007	NA	47564	45317	2247	4.7
CN3611900000000	36	119	Westchester County, NY	2007	NA	489581	471440	18141	3.7
CN3612100000000	36	121	Wyoming County, NY	2007	NA	21424	20375	1049	4.9
CN3612300000000	36	123	Yates County, NY	2007	NA	13055	12508	547	4.2
CN3700100000000	37	001	Alamance County, NC	2007	NA	69983	66446	3537	5.1
CN3700300000000	37	003	Alexander County, NC	2007	NA	18206	17254	952	5.2
CN3700500000000	37	005	Alleghany County, NC	2007	NA	4898	4645	253	5.2
CN3700700000000	37	007	Anson County, NC	2007	NA	10302	9547	755	7.3
CN3700900000000	37	009	Ashe County, NC	2007	NA	13078	12423	655	5
CN3701100000000	37	011	Avery County, NC	2007	NA	8257	7870	387	4.7
CN3701300000000	37	013	Beaufort County, NC	2007	NA	21313	20122	1191	5.6
CN3701500000000	37	015	Bertie County, NC	2007	NA	8818	8325	493	5.6
CN3701700000000	37	017	Bladen County, NC	2007	NA	15668	14702	966	6.2
CN3701900000000	37	019	Brunswick County, NC	2007	NA	47823	45649	2174	4.5
CN3702100000000	37	021	Buncombe County, NC	2007	NA	120202	115970	4232	3.5
CN3702300000000	37	023	Burke County, NC	2007	NA	40070	37685	2385	6
CN3702500000000	37	025	Cabarrus County, NC	2007	NA	82663	79012	3651	4.4
CN3702700000000	37	027	Caldwell County, NC	2007	NA	38427	35713	2714	7.1
CN3702900000000	37	029	Camden County, NC	2007	NA	4620	4436	184	4
CN3703100000000	37	031	Carteret County, NC	2007	NA	33229	31899	1330	4
CN3703300000000	37	033	Caswell County, NC	2007	NA	10706	9993	713	6.7
CN3703500000000	37	035	Catawba County, NC	2007	NA	76408	72207	4201	5.5
CN3703700000000	37	037	Chatham County, NC	2007	NA	32498	31263	1235	3.8
CN3703900000000	37	039	Cherokee County, NC	2007	NA	10231	9596	635	6.2
CN3704100000000	37	041	Chowan County, NC	2007	NA	7123	6687	436	6.1
CN3704300000000	37	043	Clay County, NC	2007	NA	4903	4706	197	4
CN3704500000000	37	045	Cleveland County, NC	2007	NA	49360	46420	2940	6
CN3704700000000	37	047	Columbus County, NC	2007	NA	24348	23037	1311	5.4
CN3704900000000	37	049	Craven County, NC	2007	NA	43233	41388	1845	4.3
CN3705100000000	37	051	Cumberland County, NC	2007	NA	129424	122573	6851	5.3
CN3705300000000	37	053	Currituck County, NC	2007	NA	12530	12134	396	3.2
CN3705500000000	37	055	Dare County, NC	2007	NA	22662	21560	1102	4.9
CN3705700000000	37	057	Davidson County, NC	2007	NA	79345	74935	4410	5.6
CN3705900000000	37	059	Davie County, NC	2007	NA	20580	19581	999	4.9
CN3706100000000	37	061	Duplin County, NC	2007	NA	24280	23201	1079	4.4
CN3706300000000	37	063	Durham County, NC	2007	NA	136544	131366	5178	3.8
CN3706500000000	37	065	Edgecombe County, NC	2007	NA	24242	22429	1813	7.5
CN3706700000000	37	067	Forsyth County, NC	2007	NA	173449	165850	7599	4.4
CN3706900000000	37	069	Franklin County, NC	2007	NA	26930	25737	1193	4.4
CN3707100000000	37	071	Gaston County, NC	2007	NA	97592	92055	5537	5.7
CN3707300000000	37	073	Gates County, NC	2007	NA	4987	4774	213	4.3
CN3707500000000	37	075	Graham County, NC	2007	NA	4678	4344	334	7.1
CN3707700000000	37	077	Granville County, NC	2007	NA	25096	23815	1281	5.1
CN3707900000000	37	079	Greene County, NC	2007	NA	9174	8676	498	5.4
CN3708100000000	37	081	Guilford County, NC	2007	NA	247292	235637	11655	4.7
CN3708300000000	37	083	Halifax County, NC	2007	NA	24355	22793	1562	6.4
CN3708500000000	37	085	Harnett County, NC	2007	NA	47956	45634	2322	4.8
CN3708700000000	37	087	Haywood County, NC	2007	NA	27421	26316	1105	4
CN3708900000000	37	089	Henderson County, NC	2007	NA	48419	46724	1695	3.5
CN3709100000000	37	091	Hertford County, NC	2007	NA	9925	9406	519	5.2
CN3709300000000	37	093	Hoke County, NC	2007	NA	19126	18157	969	5.1
CN3709500000000	37	095	Hyde County, NC	2007	NA	2689	2536	153	5.7
CN3709700000000	37	097	Iredell County, NC	2007	NA	79857	76196	3661	4.6
CN3709900000000	37	099	Jackson County, NC	2007	NA	21884	21080	804	3.7
CN3710100000000	37	101	Johnston County, NC	2007	NA	75088	72010	3078	4.1
CN3710300000000	37	103	Jones County, NC	2007	NA	4820	4606	214	4.4
CN3710500000000	37	105	Lee County, NC	2007	NA	26470	24975	1495	5.6
CN3710700000000	37	107	Lenoir County, NC	2007	NA	27936	26463	1473	5.3
CN3710900000000	37	109	Lincoln County, NC	2007	NA	39774	37819	1955	4.9
CN3711100000000	37	111	McDowell County, NC	2007	NA	21439	20245	1194	5.6
CN3711300000000	37	113	Macon County, NC	2007	NA	16643	15963	680	4.1
CN3711500000000	37	115	Madison County, NC	2007	NA	9830	9442	388	3.9
CN3711700000000	37	117	Martin County, NC	2007	NA	12022	11386	636	5.3
CN3711900000000	37	119	Mecklenburg County, NC	2007	NA	456736	436055	20681	4.5
CN3712100000000	37	121	Mitchell County, NC	2007	NA	7344	6822	522	7.1
CN3712300000000	37	123	Montgomery County, NC	2007	NA	11922	11171	751	6.3
CN3712500000000	37	125	Moore County, NC	2007	NA	37189	35495	1694	4.6
CN3712700000000	37	127	Nash County, NC	2007	NA	46370	43912	2458	5.3
CN3712900000000	37	129	New Hanover County, NC	2007	NA	104304	100377	3927	3.8
CN3713100000000	37	131	Northampton County, NC	2007	NA	9084	8542	542	6
CN3713300000000	37	133	Onslow County, NC	2007	NA	59887	57207	2680	4.5
CN3713500000000	37	135	Orange County, NC	2007	NA	67916	65724	2192	3.2
CN3713700000000	37	137	Pamlico County, NC	2007	NA	5600	5361	239	4.3
CN3713900000000	37	139	Pasquotank County, NC	2007	NA	18288	17374	914	5
CN3714100000000	37	141	Pender County, NC	2007	NA	23590	22594	996	4.2
CN3714300000000	37	143	Perquimans County, NC	2007	NA	5337	5060	277	5.2
CN3714500000000	37	145	Person County, NC	2007	NA	18861	17593	1268	6.7
CN3714700000000	37	147	Pitt County, NC	2007	NA	79009	75003	4006	5.1
CN3714900000000	37	149	Polk County, NC	2007	NA	9701	9370	331	3.4
CN3715100000000	37	151	Randolph County, NC	2007	NA	74238	70754	3484	4.7
CN3715300000000	37	153	Richmond County, NC	2007	NA	20691	19152	1539	7.4
CN3715500000000	37	155	Robeson County, NC	2007	NA	56833	53332	3501	6.2
CN3715700000000	37	157	Rockingham County, NC	2007	NA	44568	41822	2746	6.2
CN3715900000000	37	159	Rowan County, NC	2007	NA	70465	66228	4237	6
CN3716100000000	37	161	Rutherford County, NC	2007	NA	30295	28352	1943	6.4
CN3716300000000	37	163	Sampson County, NC	2007	NA	33022	31712	1310	4
CN3716500000000	37	165	Scotland County, NC	2007	NA	14507	13058	1449	10
CN3716700000000	37	167	Stanly County, NC	2007	NA	30681	29191	1490	4.9
CN3716900000000	37	169	Stokes County, NC	2007	NA	23807	22765	1042	4.4
CN3717100000000	37	171	Surry County, NC	2007	NA	35132	33263	1869	5.3
CN3717300000000	37	173	Swain County, NC	2007	NA	7292	6833	459	6.3
CN3717500000000	37	175	Transylvania County, NC	2007	NA	13357	12864	493	3.7
CN3717700000000	37	177	Tyrrell County, NC	2007	NA	2213	2088	125	5.6
CN3717900000000	37	179	Union County, NC	2007	NA	91672	88052	3620	3.9
CN3718100000000	37	181	Vance County, NC	2007	NA	19622	18320	1302	6.6
CN3718300000000	37	183	Wake County, NC	2007	NA	441589	426174	15415	3.5
CN3718500000000	37	185	Warren County, NC	2007	NA	7796	7311	485	6.2
CN3718700000000	37	187	Washington County, NC	2007	NA	6412	5999	413	6.4
CN3718900000000	37	189	Watauga County, NC	2007	NA	24743	23905	838	3.4
CN3719100000000	37	191	Wayne County, NC	2007	NA	52722	50347	2375	4.5
CN3719300000000	37	193	Wilkes County, NC	2007	NA	31357	29660	1697	5.4
CN3719500000000	37	195	Wilson County, NC	2007	NA	40724	38173	2551	6.3
CN3719700000000	37	197	Yadkin County, NC	2007	NA	19086	18271	815	4.3
CN3719900000000	37	199	Yancey County, NC	2007	NA	8077	7609	468	5.8
CN3800100000000	38	001	Adams County, ND	2007	NA	1294	1262	32	2.5
CN3800300000000	38	003	Barnes County, ND	2007	NA	6029	5840	189	3.1
CN3800500000000	38	005	Benson County, ND	2007	NA	2644	2470	174	6.6
CN3800700000000	38	007	Billings County, ND	2007	NA	507	494	13	2.6
CN3800900000000	38	009	Bottineau County, ND	2007	NA	3423	3300	123	3.6
CN3801100000000	38	011	Bowman County, ND	2007	NA	1763	1727	36	2
CN3801300000000	38	013	Burke County, ND	2007	NA	1016	990	26	2.6
CN3801500000000	38	015	Burleigh County, ND	2007	NA	47237	45984	1253	2.7
CN3801700000000	38	017	Cass County, ND	2007	NA	87690	85446	2244	2.6
CN3801900000000	38	019	Cavalier County, ND	2007	NA	2092	2029	63	3
CN3802100000000	38	021	Dickey County, ND	2007	NA	2947	2868	79	2.7
CN3802300000000	38	023	Divide County, ND	2007	NA	900	870	30	3.3
CN3802500000000	38	025	Dunn County, ND	2007	NA	1691	1626	65	3.8
CN3802700000000	38	027	Eddy County, ND	2007	NA	1293	1222	71	5.5
CN3802900000000	38	029	Emmons County, ND	2007	NA	1703	1615	88	5.2
CN3803100000000	38	031	Foster County, ND	2007	NA	1701	1643	58	3.4
CN3803300000000	38	033	Golden Valley County, ND	2007	NA	877	853	24	2.7
CN3803500000000	38	035	Grand Forks County, ND	2007	NA	39381	38252	1129	2.9
CN3803700000000	38	037	Grant County, ND	2007	NA	1200	1157	43	3.6
CN3803900000000	38	039	Griggs County, ND	2007	NA	1313	1278	35	2.7
CN3804100000000	38	041	Hettinger County, ND	2007	NA	1155	1109	46	4
CN3804300000000	38	043	Kidder County, ND	2007	NA	1225	1166	59	4.8
CN3804500000000	38	045	LaMoure County, ND	2007	NA	2187	2118	69	3.2
CN3804700000000	38	047	Logan County, ND	2007	NA	928	895	33	3.6
CN3804900000000	38	049	McHenry County, ND	2007	NA	2726	2590	136	5
CN3805100000000	38	051	McIntosh County, ND	2007	NA	1420	1380	40	2.8
CN3805300000000	38	053	McKenzie County, ND	2007	NA	2928	2838	90	3.1
CN3805500000000	38	055	McLean County, ND	2007	NA	4726	4508	218	4.6
CN3805700000000	38	057	Mercer County, ND	2007	NA	4753	4556	197	4.1
CN3805900000000	38	059	Morton County, ND	2007	NA	15021	14516	505	3.4
CN3806100000000	38	061	Mountrail County, ND	2007	NA	2972	2801	171	5.8
CN3806300000000	38	063	Nelson County, ND	2007	NA	1642	1575	67	4.1
CN3806500000000	38	065	Oliver County, ND	2007	NA	1131	1083	48	4.2
CN3806700000000	38	067	Pembina County, ND	2007	NA	4022	3797	225	5.6
CN3806900000000	38	069	Pierce County, ND	2007	NA	1913	1827	86	4.5
CN3807100000000	38	071	Ramsey County, ND	2007	NA	5890	5657	233	4
CN3807300000000	38	073	Ransom County, ND	2007	NA	3061	2965	96	3.1
CN3807500000000	38	075	Renville County, ND	2007	NA	1291	1252	39	3
CN3807700000000	38	077	Richland County, ND	2007	NA	8996	8696	300	3.3
CN3807900000000	38	079	Rolette County, ND	2007	NA	5157	4690	467	9.1
CN3808100000000	38	081	Sargent County, ND	2007	NA	2226	2145	81	3.6
CN3808300000000	38	083	Sheridan County, ND	2007	NA	635	603	32	5
CN3808500000000	38	085	Sioux County, ND	2007	NA	1292	1210	82	6.3
CN3808700000000	38	087	Slope County, ND	2007	NA	629	619	10	1.6
CN3808900000000	38	089	Stark County, ND	2007	NA	13947	13601	346	2.5
CN3809100000000	38	091	Steele County, ND	2007	NA	1119	1093	26	2.3
CN3809300000000	38	093	Stutsman County, ND	2007	NA	11876	11537	339	2.9
CN3809500000000	38	095	Towner County, ND	2007	NA	1144	1099	45	3.9
CN3809700000000	38	097	Traill County, ND	2007	NA	4237	4096	141	3.3
CN3809900000000	38	099	Walsh County, ND	2007	NA	5733	5492	241	4.2
CN3810100000000	38	101	Ward County, ND	2007	NA	29340	28461	879	3
CN3810300000000	38	103	Wells County, ND	2007	NA	2132	2034	98	4.6
CN3810500000000	38	105	Williams County, ND	2007	NA	13081	12833	248	1.9
CN3900100000000	39	001	Adams County, OH	2007	NA	13547	12506	1041	7.7
CN3900300000000	39	003	Allen County, OH	2007	NA	52259	48969	3290	6.3
CN3900500000000	39	005	Ashland County, OH	2007	NA	27654	26000	1654	6
CN3900700000000	39	007	Ashtabula County, OH	2007	NA	49729	46259	3470	7
CN3900900000000	39	009	Athens County, OH	2007	NA	30610	28746	1864	6.1
CN3901100000000	39	011	Auglaize County, OH	2007	NA	27156	25952	1204	4.4
CN3901300000000	39	013	Belmont County, OH	2007	NA	32878	31038	1840	5.6
CN3901500000000	39	015	Brown County, OH	2007	NA	21794	20381	1413	6.5
CN3901700000000	39	017	Butler County, OH	2007	NA	190611	180864	9747	5.1
CN3901900000000	39	019	Carroll County, OH	2007	NA	13935	13074	861	6.2
CN3902100000000	39	021	Champaign County, OH	2007	NA	21041	19800	1241	5.9
CN3902300000000	39	023	Clark County, OH	2007	NA	71363	66921	4442	6.2
CN3902500000000	39	025	Clermont County, OH	2007	NA	106078	100704	5374	5.1
CN3902700000000	39	027	Clinton County, OH	2007	NA	24450	23287	1163	4.8
CN3902900000000	39	029	Columbiana County, OH	2007	NA	53532	50208	3324	6.2
CN3903100000000	39	031	Coshocton County, OH	2007	NA	17513	16314	1199	6.8
CN3903300000000	39	033	Crawford County, OH	2007	NA	22347	20787	1560	7
CN3903500000000	39	035	Cuyahoga County, OH	2007	NA	653686	616532	37154	5.7
CN3903700000000	39	037	Darke County, OH	2007	NA	28313	26722	1591	5.6
CN3903900000000	39	039	Defiance County, OH	2007	NA	20795	19625	1170	5.6
CN3904100000000	39	041	Delaware County, OH	2007	NA	90447	86843	3604	4
CN3904300000000	39	043	Erie County, OH	2007	NA	42673	40097	2576	6
CN3904500000000	39	045	Fairfield County, OH	2007	NA	75513	71734	3779	5
CN3904700000000	39	047	Fayette County, OH	2007	NA	16895	16084	811	4.8
CN3904900000000	39	049	Franklin County, OH	2007	NA	622081	592795	29286	4.7
CN3905100000000	39	051	Fulton County, OH	2007	NA	23293	21825	1468	6.3
CN3905300000000	39	053	Gallia County, OH	2007	NA	14506	13608	898	6.2
CN3905500000000	39	055	Geauga County, OH	2007	NA	51658	49313	2345	4.5
CN3905700000000	39	057	Greene County, OH	2007	NA	79675	75499	4176	5.2
CN3905900000000	39	059	Guernsey County, OH	2007	NA	19889	18613	1276	6.4
CN3906100000000	39	061	Hamilton County, OH	2007	NA	437604	415449	22155	5.1
CN3906300000000	39	063	Hancock County, OH	2007	NA	41600	39728	1872	4.5
CN3906500000000	39	065	Hardin County, OH	2007	NA	15806	14863	943	6
CN3906700000000	39	067	Harrison County, OH	2007	NA	7417	6956	461	6.2
CN3906900000000	39	069	Henry County, OH	2007	NA	15931	14929	1002	6.3
CN3907100000000	39	071	Highland County, OH	2007	NA	21567	20287	1280	5.9
CN3907300000000	39	073	Hocking County, OH	2007	NA	14229	13321	908	6.4
CN3907500000000	39	075	Holmes County, OH	2007	NA	19739	18942	797	4
CN3907700000000	39	077	Huron County, OH	2007	NA	29739	27327	2412	8.1
CN3907900000000	39	079	Jackson County, OH	2007	NA	15922	14658	1264	7.9
CN3908100000000	39	081	Jefferson County, OH	2007	NA	32008	29969	2039	6.4
CN3908300000000	39	083	Knox County, OH	2007	NA	31128	29451	1677	5.4
CN3908500000000	39	085	Lake County, OH	2007	NA	133810	127339	6471	4.8
CN3908700000000	39	087	Lawrence County, OH	2007	NA	29601	28052	1549	5.2
CN3908900000000	39	089	Licking County, OH	2007	NA	83633	79207	4426	5.3
CN3909100000000	39	091	Logan County, OH	2007	NA	25324	24067	1257	5
CN3909300000000	39	093	Lorain County, OH	2007	NA	159594	150486	9108	5.7
CN3909500000000	39	095	Lucas County, OH	2007	NA	224338	209175	15163	6.8
CN3909700000000	39	097	Madison County, OH	2007	NA	20097	19043	1054	5.2
CN3909900000000	39	099	Mahoning County, OH	2007	NA	117091	109793	7298	6.2
CN3910100000000	39	101	Marion County, OH	2007	NA	32970	31165	1805	5.5
CN3910300000000	39	103	Medina County, OH	2007	NA	96074	91442	4632	4.8
CN3910500000000	39	105	Meigs County, OH	2007	NA	9274	8446	828	8.9
CN3910700000000	39	107	Mercer County, OH	2007	NA	24591	23648	943	3.8
CN3910900000000	39	109	Miami County, OH	2007	NA	55278	52280	2998	5.4
CN3911100000000	39	111	Monroe County, OH	2007	NA	5571	5116	455	8.2
CN3911300000000	39	113	Montgomery County, OH	2007	NA	271298	254523	16775	6.2
CN3911500000000	39	115	Morgan County, OH	2007	NA	5757	5220	537	9.3
CN3911700000000	39	117	Morrow County, OH	2007	NA	18013	16963	1050	5.8
CN3911900000000	39	119	Muskingum County, OH	2007	NA	39097	36062	3035	7.8
CN3912100000000	39	121	Noble County, OH	2007	NA	5830	5399	431	7.4
CN3912300000000	39	123	Ottawa County, OH	2007	NA	21764	20195	1569	7.2
CN3912500000000	39	125	Paulding County, OH	2007	NA	10970	10423	547	5
CN3912700000000	39	127	Perry County, OH	2007	NA	16449	15243	1206	7.3
CN3912900000000	39	129	Pickaway County, OH	2007	NA	24536	23048	1488	6.1
CN3913100000000	39	131	Pike County, OH	2007	NA	10922	9887	1035	9.5
CN3913300000000	39	133	Portage County, OH	2007	NA	92197	87293	4904	5.3
CN3913500000000	39	135	Preble County, OH	2007	NA	21688	20437	1251	5.8
CN3913700000000	39	137	Putnam County, OH	2007	NA	18282	17406	876	4.8
CN3913900000000	39	139	Richland County, OH	2007	NA	62590	58534	4056	6.5
CN3914100000000	39	141	Ross County, OH	2007	NA	35056	32642	2414	6.9
CN3914300000000	39	143	Sandusky County, OH	2007	NA	33950	31887	2063	6.1
CN3914500000000	39	145	Scioto County, OH	2007	NA	32298	29898	2400	7.4
CN3914700000000	39	147	Seneca County, OH	2007	NA	31225	29440	1785	5.7
CN3914900000000	39	149	Shelby County, OH	2007	NA	28444	27077	1367	4.8
CN3915100000000	39	151	Stark County, OH	2007	NA	192111	180927	11184	5.8
CN3915300000000	39	153	Summit County, OH	2007	NA	297444	281395	16049	5.4
CN3915500000000	39	155	Trumbull County, OH	2007	NA	106325	99690	6635	6.2
CN3915700000000	39	157	Tuscarawas County, OH	2007	NA	48239	45658	2581	5.4
CN3915900000000	39	159	Union County, OH	2007	NA	25475	24373	1102	4.3
CN3916100000000	39	161	Van Wert County, OH	2007	NA	15584	14726	858	5.5
CN3916300000000	39	163	Vinton County, OH	2007	NA	5895	5432	463	7.9
CN3916500000000	39	165	Warren County, OH	2007	NA	108163	103190	4973	4.6
CN3916700000000	39	167	Washington County, OH	2007	NA	33179	31462	1717	5.2
CN3916900000000	39	169	Wayne County, OH	2007	NA	60204	57299	2905	4.8
CN3917100000000	39	171	Williams County, OH	2007	NA	19786	18591	1195	6
CN3917300000000	39	173	Wood County, OH	2007	NA	69423	65714	3709	5.3
CN3917500000000	39	175	Wyandot County, OH	2007	NA	12245	11448	797	6.5
CN4000100000000	40	001	Adair County, OK	2007	NA	10876	10360	516	4.7
CN4000300000000	40	003	Alfalfa County, OK	2007	NA	2329	2227	102	4.4
CN4000500000000	40	005	Atoka County, OK	2007	NA	5914	5593	321	5.4
CN4000700000000	40	007	Beaver County, OK	2007	NA	3083	3001	82	2.7
CN4000900000000	40	009	Beckham County, OK	2007	NA	11609	11328	281	2.4
CN4001100000000	40	011	Blaine County, OK	2007	NA	4943	4734	209	4.2
CN4001300000000	40	013	Bryan County, OK	2007	NA	20677	19953	724	3.5
CN4001500000000	40	015	Caddo County, OK	2007	NA	11938	11345	593	5
CN4001700000000	40	017	Canadian County, OK	2007	NA	50999	49067	1932	3.8
CN4001900000000	40	019	Carter County, OK	2007	NA	25602	24729	873	3.4
CN4002100000000	40	021	Cherokee County, OK	2007	NA	23189	22247	942	4.1
CN4002300000000	40	023	Choctaw County, OK	2007	NA	6841	6478	363	5.3
CN4002500000000	40	025	Cimarron County, OK	2007	NA	1262	1214	48	3.8
CN4002700000000	40	027	Cleveland County, OK	2007	NA	117837	113477	4360	3.7
CN4002900000000	40	029	Coal County, OK	2007	NA	2499	2344	155	6.2
CN4003100000000	40	031	Comanche County, OK	2007	NA	44888	42939	1949	4.3
CN4003300000000	40	033	Cotton County, OK	2007	NA	3964	3858	106	2.7
CN4003500000000	40	035	Craig County, OK	2007	NA	7404	7063	341	4.6
CN4003700000000	40	037	Creek County, OK	2007	NA	30982	29624	1358	4.4
CN4003900000000	40	039	Custer County, OK	2007	NA	14502	14061	441	3
CN4004100000000	40	041	Delaware County, OK	2007	NA	18393	17552	841	4.6
CN4004300000000	40	043	Dewey County, OK	2007	NA	2450	2375	75	3.1
CN4004500000000	40	045	Ellis County, OK	2007	NA	2375	2316	59	2.5
CN4004700000000	40	047	Garfield County, OK	2007	NA	30294	29405	889	2.9
CN4004900000000	40	049	Garvin County, OK	2007	NA	14506	14031	475	3.3
CN4005100000000	40	051	Grady County, OK	2007	NA	22769	21768	1001	4.4
CN4005300000000	40	053	Grant County, OK	2007	NA	2539	2457	82	3.2
CN4005500000000	40	055	Greer County, OK	2007	NA	2002	1904	98	4.9
CN4005700000000	40	057	Harmon County, OK	2007	NA	1338	1292	46	3.4
CN4005900000000	40	059	Harper County, OK	2007	NA	1878	1825	53	2.8
CN4006100000000	40	061	Haskell County, OK	2007	NA	5651	5422	229	4.1
CN4006300000000	40	063	Hughes County, OK	2007	NA	4858	4561	297	6.1
CN4006500000000	40	065	Jackson County, OK	2007	NA	12580	12153	427	3.4
CN4006700000000	40	067	Jefferson County, OK	2007	NA	2354	2238	116	4.9
CN4006900000000	40	069	Johnston County, OK	2007	NA	5097	4878	219	4.3
CN4007100000000	40	071	Kay County, OK	2007	NA	22926	21962	964	4.2
CN4007300000000	40	073	Kingfisher County, OK	2007	NA	8357	8137	220	2.6
CN4007500000000	40	075	Kiowa County, OK	2007	NA	3963	3789	174	4.4
CN4007700000000	40	077	Latimer County, OK	2007	NA	4210	4000	210	5
CN4007900000000	40	079	Le Flore County, OK	2007	NA	21178	20003	1175	5.5
CN4008100000000	40	081	Lincoln County, OK	2007	NA	13908	13323	585	4.2
CN4008300000000	40	083	Logan County, OK	2007	NA	16991	16336	655	3.9
CN4008500000000	40	085	Love County, OK	2007	NA	5098	4940	158	3.1
CN4008700000000	40	087	McClain County, OK	2007	NA	14734	14172	562	3.8
CN4008900000000	40	089	McCurtain County, OK	2007	NA	13853	12967	886	6.4
CN4009100000000	40	091	McIntosh County, OK	2007	NA	8498	8037	461	5.4
CN4009300000000	40	093	Major County, OK	2007	NA	3967	3857	110	2.8
CN4009500000000	40	095	Marshall County, OK	2007	NA	6379	6102	277	4.3
CN4009700000000	40	097	Mayes County, OK	2007	NA	18255	17468	787	4.3
CN4009900000000	40	099	Murray County, OK	2007	NA	8113	7881	232	2.9
CN4010100000000	40	101	Muskogee County, OK	2007	NA	29586	27955	1631	5.5
CN4010300000000	40	103	Noble County, OK	2007	NA	5932	5732	200	3.4
CN4010500000000	40	105	Nowata County, OK	2007	NA	4912	4668	244	5
CN4010700000000	40	107	Okfuskee County, OK	2007	NA	4665	4434	231	5
CN4010900000000	40	109	Oklahoma County, OK	2007	NA	323354	309044	14310	4.4
CN4011100000000	40	111	Okmulgee County, OK	2007	NA	16063	15177	886	5.5
CN4011300000000	40	113	Osage County, OK	2007	NA	20153	19310	843	4.2
CN4011500000000	40	115	Ottawa County, OK	2007	NA	16941	16105	836	4.9
CN4011700000000	40	117	Pawnee County, OK	2007	NA	7376	7042	334	4.5
CN4011900000000	40	119	Payne County, OK	2007	NA	37680	36285	1395	3.7
CN4012100000000	40	121	Pittsburg County, OK	2007	NA	22653	21777	876	3.9
CN4012300000000	40	123	Pontotoc County, OK	2007	NA	20008	19289	719	3.6
CN4012500000000	40	125	Pottawatomie County, OK	2007	NA	32774	31409	1365	4.2
CN4012700000000	40	127	Pushmataha County, OK	2007	NA	5226	4969	257	4.9
CN4012900000000	40	129	Roger Mills County, OK	2007	NA	1869	1818	51	2.7
CN4013100000000	40	131	Rogers County, OK	2007	NA	39870	38352	1518	3.8
CN4013300000000	40	133	Seminole County, OK	2007	NA	10568	9991	577	5.5
CN4013500000000	40	135	Sequoyah County, OK	2007	NA	17912	16872	1040	5.8
CN4013700000000	40	137	Stephens County, OK	2007	NA	21561	20776	785	3.6
CN4013900000000	40	139	Texas County, OK	2007	NA	9376	9081	295	3.1
CN4014100000000	40	141	Tillman County, OK	2007	NA	3456	3295	161	4.7
CN4014300000000	40	143	Tulsa County, OK	2007	NA	291603	280376	11227	3.9
CN4014500000000	40	145	Wagoner County, OK	2007	NA	32564	31324	1240	3.8
CN4014700000000	40	147	Washington County, OK	2007	NA	26923	25994	929	3.5
CN4014900000000	40	149	Washita County, OK	2007	NA	5957	5777	180	3
CN4015100000000	40	151	Woods County, OK	2007	NA	4424	4163	261	5.9
CN4015300000000	40	153	Woodward County, OK	2007	NA	12002	11686	316	2.6
CN4100100000000	41	001	Baker County, OR	2007	NA	7292	6870	422	5.8
CN4100300000000	41	003	Benton County, OR	2007	NA	42323	40576	1747	4.1
CN4100500000000	41	005	Clackamas County, OR	2007	NA	196402	187434	8968	4.6
CN4100700000000	41	007	Clatsop County, OR	2007	NA	19891	18962	929	4.7
CN4100900000000	41	009	Columbia County, OR	2007	NA	23745	22391	1354	5.7
CN4101100000000	41	011	Coos County, OR	2007	NA	28219	26364	1855	6.6
CN4101300000000	41	013	Crook County, OR	2007	NA	9790	9183	607	6.2
CN4101500000000	41	015	Curry County, OR	2007	NA	9510	8889	621	6.5
CN4101700000000	41	017	Deschutes County, OR	2007	NA	81675	77625	4050	5
CN4101900000000	41	019	Douglas County, OR	2007	NA	47035	43421	3614	7.7
CN4102100000000	41	021	Gilliam County, OR	2007	NA	1046	999	47	4.5
CN4102300000000	41	023	Grant County, OR	2007	NA	3437	3161	276	8
CN4102500000000	41	025	Harney County, OR	2007	NA	3317	3075	242	7.3
CN4102700000000	41	027	Hood River County, OR	2007	NA	12884	12303	581	4.5
CN4102900000000	41	029	Jackson County, OR	2007	NA	101473	95750	5723	5.6
CN4103100000000	41	031	Jefferson County, OR	2007	NA	9289	8662	627	6.7
CN4103300000000	41	033	Josephine County, OR	2007	NA	34862	32405	2457	7
CN4103500000000	41	035	Klamath County, OR	2007	NA	30573	28458	2115	6.9
CN4103700000000	41	037	Lake County, OR	2007	NA	3639	3375	264	7.3
CN4103900000000	41	039	Lane County, OR	2007	NA	181463	172060	9403	5.2
CN4104100000000	41	041	Lincoln County, OR	2007	NA	22510	21272	1238	5.5
CN4104300000000	41	043	Linn County, OR	2007	NA	53653	50267	3386	6.3
CN4104500000000	41	045	Malheur County, OR	2007	NA	12719	12003	716	5.6
CN4104700000000	41	047	Marion County, OR	2007	NA	151768	143586	8182	5.4
CN4104900000000	41	049	Morrow County, OR	2007	NA	5326	5036	290	5.4
CN4105100000000	41	051	Multnomah County, OR	2007	NA	379156	360681	18475	4.9
CN4105300000000	41	053	Polk County, OR	2007	NA	38469	36579	1890	4.9
CN4105500000000	41	055	Sherman County, OR	2007	NA	930	885	45	4.8
CN4105700000000	41	057	Tillamook County, OR	2007	NA	12433	11821	612	4.9
CN4105900000000	41	059	Umatilla County, OR	2007	NA	36645	34522	2123	5.8
CN4106100000000	41	061	Union County, OR	2007	NA	12235	11562	673	5.5
CN4106300000000	41	063	Wallowa County, OR	2007	NA	3648	3427	221	6.1
CN4106500000000	41	065	Wasco County, OR	2007	NA	13239	12589	650	4.9
CN4106700000000	41	067	Washington County, OR	2007	NA	283981	271750	12231	4.3
CN4106900000000	41	069	Wheeler County, OR	2007	NA	611	577	34	5.6
CN4107100000000	41	071	Yamhill County, OR	2007	NA	46583	44255	2328	5
CN4200100000000	42	001	Adams County, PA	2007	NA	55892	54028	1864	3.3
CN4200300000000	42	003	Allegheny County, PA	2007	NA	633672	607439	26233	4.1
CN4200500000000	42	005	Armstrong County, PA	2007	NA	32834	31192	1642	5
CN4200700000000	42	007	Beaver County, PA	2007	NA	88933	84904	4029	4.5
CN4200900000000	42	009	Bedford County, PA	2007	NA	23545	22215	1330	5.6
CN4201100000000	42	011	Berks County, PA	2007	NA	203068	194447	8621	4.2
CN4201300000000	42	013	Blair County, PA	2007	NA	65094	62365	2729	4.2
CN4201500000000	42	015	Bradford County, PA	2007	NA	30827	29368	1459	4.7
CN4201700000000	42	017	Bucks County, PA	2007	NA	347367	334141	13226	3.8
CN4201900000000	42	019	Butler County, PA	2007	NA	96948	93055	3893	4
CN4202100000000	42	021	Cambria County, PA	2007	NA	68335	64702	3633	5.3
CN4202300000000	42	023	Cameron County, PA	2007	NA	2555	2401	154	6
CN4202500000000	42	025	Carbon County, PA	2007	NA	31081	29413	1668	5.4
CN4202700000000	42	027	Centre County, PA	2007	NA	73700	71112	2588	3.5
CN4202900000000	42	029	Chester County, PA	2007	NA	267222	258865	8357	3.1
CN4203100000000	42	031	Clarion County, PA	2007	NA	20286	19319	967	4.8
CN4203300000000	42	033	Clearfield County, PA	2007	NA	40780	38551	2229	5.5
CN4203500000000	42	035	Clinton County, PA	2007	NA	19149	18145	1004	5.2
CN4203700000000	42	037	Columbia County, PA	2007	NA	35206	33429	1777	5
CN4203900000000	42	039	Crawford County, PA	2007	NA	42787	40674	2113	4.9
CN4204100000000	42	041	Cumberland County, PA	2007	NA	123188	119168	4020	3.3
CN4204300000000	42	043	Dauphin County, PA	2007	NA	135823	130509	5314	3.9
CN4204500000000	42	045	Delaware County, PA	2007	NA	283132	271606	11526	4.1
CN4204700000000	42	047	Elk County, PA	2007	NA	17483	16659	824	4.7
CN4204900000000	42	049	Erie County, PA	2007	NA	140590	133805	6785	4.8
CN4205100000000	42	051	Fayette County, PA	2007	NA	65659	61917	3742	5.7
CN4205300000000	42	053	Forest County, PA	2007	NA	2394	2237	157	6.6
CN4205500000000	42	055	Franklin County, PA	2007	NA	80752	78014	2738	3.4
CN4205700000000	42	057	Fulton County, PA	2007	NA	8104	7652	452	5.6
CN4205900000000	42	059	Greene County, PA	2007	NA	18128	17223	905	5
CN4206100000000	42	061	Huntingdon County, PA	2007	NA	22187	21044	1143	5.2
CN4206300000000	42	063	Indiana County, PA	2007	NA	45705	43578	2127	4.7
CN4206500000000	42	065	Jefferson County, PA	2007	NA	23094	22027	1067	4.6
CN4206700000000	42	067	Juniata County, PA	2007	NA	12488	11962	526	4.2
CN4206900000000	42	069	Lackawanna County, PA	2007	NA	106909	101792	5117	4.8
CN4207100000000	42	071	Lancaster County, PA	2007	NA	269595	260379	9216	3.4
CN4207300000000	42	073	Lawrence County, PA	2007	NA	44068	41769	2299	5.2
CN4207500000000	42	075	Lebanon County, PA	2007	NA	72124	69628	2496	3.5
CN4207700000000	42	077	Lehigh County, PA	2007	NA	175800	168063	7737	4.4
CN4207900000000	42	079	Luzerne County, PA	2007	NA	159118	151181	7937	5
CN4208100000000	42	081	Lycoming County, PA	2007	NA	59328	56408	2920	4.9
CN4208300000000	42	083	McKean County, PA	2007	NA	21676	20591	1085	5
CN4208500000000	42	085	Mercer County, PA	2007	NA	55433	52359	3074	5.5
CN4208700000000	42	087	Mifflin County, PA	2007	NA	22514	21338	1176	5.2
CN4208900000000	42	089	Monroe County, PA	2007	NA	81613	77608	4005	4.9
CN4209100000000	42	091	Montgomery County, PA	2007	NA	430052	415122	14930	3.5
CN4209300000000	42	093	Montour County, PA	2007	NA	9214	8859	355	3.9
CN4209500000000	42	095	Northampton County, PA	2007	NA	151894	145194	6700	4.4
CN4209700000000	42	097	Northumberland County, PA	2007	NA	47308	44904	2404	5.1
CN4209900000000	42	099	Perry County, PA	2007	NA	24560	23565	995	4.1
CN4210100000000	42	101	Philadelphia County/city, PA	2007	NA	620518	582727	37791	6.1
CN4210300000000	42	103	Pike County, PA	2007	NA	27631	26134	1497	5.4
CN4210500000000	42	105	Potter County, PA	2007	NA	7756	7196	560	7.2
CN4210700000000	42	107	Schuylkill County, PA	2007	NA	73592	69906	3686	5
CN4210900000000	42	109	Snyder County, PA	2007	NA	19834	18913	921	4.6
CN4211100000000	42	111	Somerset County, PA	2007	NA	38870	36732	2138	5.5
CN4211300000000	42	113	Sullivan County, PA	2007	NA	2996	2858	138	4.6
CN4211500000000	42	115	Susquehanna County, PA	2007	NA	21647	20707	940	4.3
CN4211700000000	42	117	Tioga County, PA	2007	NA	20374	19259	1115	5.5
CN4211900000000	42	119	Union County, PA	2007	NA	17676	16746	930	5.3
CN4212100000000	42	121	Venango County, PA	2007	NA	26073	24791	1282	4.9
CN4212300000000	42	123	Warren County, PA	2007	NA	21423	20447	976	4.6
CN4212500000000	42	125	Washington County, PA	2007	NA	104070	99305	4765	4.6
CN4212700000000	42	127	Wayne County, PA	2007	NA	25655	24580	1075	4.2
CN4212900000000	42	129	Westmoreland County, PA	2007	NA	185838	177330	8508	4.6
CN4213100000000	42	131	Wyoming County, PA	2007	NA	14413	13654	759	5.3
CN4213300000000	42	133	York County, PA	2007	NA	225424	216856	8568	3.8
CN4400100000000	44	001	Bristol County, RI	2007	NA	27647	26403	1244	4.5
CN4400300000000	44	003	Kent County, RI	2007	NA	97802	92912	4890	5
CN4400500000000	44	005	Newport County, RI	2007	NA	45374	43313	2061	4.5
CN4400700000000	44	007	Providence County, RI	2007	NA	328144	309733	18411	5.6
CN4400900000000	44	009	Washington County, RI	2007	NA	74206	71040	3166	4.3
CN4500100000000	45	001	Abbeville County, SC	2007	NA	11511	10580	931	8.1
CN4500300000000	45	003	Aiken County, SC	2007	NA	74572	70571	4001	5.4
CN4500500000000	45	005	Allendale County, SC	2007	NA	3546	3180	366	10.3
CN4500700000000	45	007	Anderson County, SC	2007	NA	84980	80072	4908	5.8
CN4500900000000	45	009	Bamberg County, SC	2007	NA	6232	5664	568	9.1
CN4501100000000	45	011	Barnwell County, SC	2007	NA	8818	7996	822	9.3
CN4501300000000	45	013	Beaufort County, SC	2007	NA	63906	61117	2789	4.4
CN4501500000000	45	015	Berkeley County, SC	2007	NA	77641	73923	3718	4.8
CN4501700000000	45	017	Calhoun County, SC	2007	NA	6896	6465	431	6.3
CN4501900000000	45	019	Charleston County, SC	2007	NA	173525	165971	7554	4.4
CN4502100000000	45	021	Cherokee County, SC	2007	NA	25257	23543	1714	6.8
CN4502300000000	45	023	Chester County, SC	2007	NA	15475	13788	1687	10.9
CN4502500000000	45	025	Chesterfield County, SC	2007	NA	18468	17037	1431	7.7
CN4502700000000	45	027	Clarendon County, SC	2007	NA	12641	11580	1061	8.4
CN4502900000000	45	029	Colleton County, SC	2007	NA	16458	15456	1002	6.1
CN4503100000000	45	031	Darlington County, SC	2007	NA	30770	28762	2008	6.5
CN4503300000000	45	033	Dillon County, SC	2007	NA	12978	11797	1181	9.1
CN4503500000000	45	035	Dorchester County, SC	2007	NA	62138	59419	2719	4.4
CN4503700000000	45	037	Edgefield County, SC	2007	NA	10975	10281	694	6.3
CN4503900000000	45	039	Fairfield County, SC	2007	NA	11118	10174	944	8.5
CN4504100000000	45	041	Florence County, SC	2007	NA	62583	58784	3799	6.1
CN4504300000000	45	043	Georgetown County, SC	2007	NA	29139	27340	1799	6.2
CN4504500000000	45	045	Greenville County, SC	2007	NA	220826	210480	10346	4.7
CN4504700000000	45	047	Greenwood County, SC	2007	NA	30936	28799	2137	6.9
CN4504900000000	45	049	Hampton County, SC	2007	NA	7855	7330	525	6.7
CN4505100000000	45	051	Horry County, SC	2007	NA	130268	123740	6528	5
CN4505300000000	45	053	Jasper County, SC	2007	NA	10062	9602	460	4.6
CN4505500000000	45	055	Kershaw County, SC	2007	NA	29633	28045	1588	5.4
CN4505700000000	45	057	Lancaster County, SC	2007	NA	29787	26932	2855	9.6
CN4505900000000	45	059	Laurens County, SC	2007	NA	33357	30968	2389	7.2
CN4506100000000	45	061	Lee County, SC	2007	NA	8137	7476	661	8.1
CN4506300000000	45	063	Lexington County, SC	2007	NA	131525	126132	5393	4.1
CN4506500000000	45	065	McCormick County, SC	2007	NA	3496	3148	348	10
CN4506700000000	45	067	Marion County, SC	2007	NA	12854	11372	1482	11.5
CN4506900000000	45	069	Marlboro County, SC	2007	NA	11832	10426	1406	11.9
CN4507100000000	45	071	Newberry County, SC	2007	NA	18019	17008	1011	5.6
CN4507300000000	45	073	Oconee County, SC	2007	NA	30225	28149	2076	6.9
CN4507500000000	45	075	Orangeburg County, SC	2007	NA	40302	37031	3271	8.1
CN4507700000000	45	077	Pickens County, SC	2007	NA	58130	55185	2945	5.1
CN4507900000000	45	079	Richland County, SC	2007	NA	179489	170088	9401	5.2
CN4508100000000	45	081	Saluda County, SC	2007	NA	9116	8632	484	5.3
CN4508300000000	45	083	Spartanburg County, SC	2007	NA	134253	126674	7579	5.6
CN4508500000000	45	085	Sumter County, SC	2007	NA	44599	41465	3134	7
CN4508700000000	45	087	Union County, SC	2007	NA	11657	10611	1046	9
CN4508900000000	45	089	Williamsburg County, SC	2007	NA	15258	13885	1373	9
CN4509100000000	45	091	York County, SC	2007	NA	104653	99009	5644	5.4
CN4600300000000	46	003	Aurora County, SD	2007	NA	1381	1341	40	2.9
CN4600500000000	46	005	Beadle County, SD	2007	NA	9448	9217	231	2.4
CN4600700000000	46	007	Bennett County, SD	2007	NA	1389	1333	56	4
CN4600900000000	46	009	Bon Homme County, SD	2007	NA	3091	2974	117	3.8
CN4601100000000	46	011	Brookings County, SD	2007	NA	19704	19279	425	2.2
CN4601300000000	46	013	Brown County, SD	2007	NA	21248	20758	490	2.3
CN4601500000000	46	015	Brule County, SD	2007	NA	2814	2741	73	2.6
CN4601700000000	46	017	Buffalo County, SD	2007	NA	489	435	54	11
CN4601900000000	46	019	Butte County, SD	2007	NA	5341	5198	143	2.7
CN4602100000000	46	021	Campbell County, SD	2007	NA	836	810	26	3.1
CN4602300000000	46	023	Charles Mix County, SD	2007	NA	4030	3895	135	3.3
CN4602500000000	46	025	Clark County, SD	2007	NA	1834	1768	66	3.6
CN4602700000000	46	027	Clay County, SD	2007	NA	7614	7423	191	2.5
CN4602900000000	46	029	Codington County, SD	2007	NA	16778	16334	444	2.6
CN4603100000000	46	031	Corson County, SD	2007	NA	1352	1276	76	5.6
CN4603300000000	46	033	Custer County, SD	2007	NA	4712	4582	130	2.8
CN4603500000000	46	035	Davison County, SD	2007	NA	11285	11009	276	2.4
CN4603700000000	46	037	Day County, SD	2007	NA	2874	2737	137	4.8
CN4603900000000	46	039	Deuel County, SD	2007	NA	2677	2584	93	3.5
CN4604100000000	46	041	Dewey County, SD	2007	NA	2515	2274	241	9.6
CN4604300000000	46	043	Douglas County, SD	2007	NA	1675	1633	42	2.5
CN4604500000000	46	045	Edmunds County, SD	2007	NA	2062	2010	52	2.5
CN4604700000000	46	047	Fall River County, SD	2007	NA	3753	3632	121	3.2
CN4604900000000	46	049	Faulk County, SD	2007	NA	1119	1084	35	3.1
CN4605100000000	46	051	Grant County, SD	2007	NA	4227	4085	142	3.4
CN4605300000000	46	053	Gregory County, SD	2007	NA	2374	2298	76	3.2
CN4605500000000	46	055	Haakon County, SD	2007	NA	1166	1137	29	2.5
CN4605700000000	46	057	Hamlin County, SD	2007	NA	3003	2919	84	2.8
CN4605900000000	46	059	Hand County, SD	2007	NA	1873	1822	51	2.7
CN4606100000000	46	061	Hanson County, SD	2007	NA	1977	1918	59	3
CN4606300000000	46	063	Harding County, SD	2007	NA	748	729	19	2.5
CN4606500000000	46	065	Hughes County, SD	2007	NA	10230	9992	238	2.3
CN4606700000000	46	067	Hutchinson County, SD	2007	NA	3783	3669	114	3
CN4606900000000	46	069	Hyde County, SD	2007	NA	734	710	24	3.3
CN4607100000000	46	071	Jackson County, SD	2007	NA	1207	1143	64	5.3
CN4607300000000	46	073	Jerauld County, SD	2007	NA	1379	1346	33	2.4
CN4607500000000	46	075	Jones County, SD	2007	NA	702	687	15	2.1
CN4607700000000	46	077	Kingsbury County, SD	2007	NA	2952	2868	84	2.8
CN4607900000000	46	079	Lake County, SD	2007	NA	6889	6690	199	2.9
CN4608100000000	46	081	Lawrence County, SD	2007	NA	13460	13119	341	2.5
CN4608300000000	46	083	Lincoln County, SD	2007	NA	21201	20723	478	2.3
CN4608500000000	46	085	Lyman County, SD	2007	NA	1971	1886	85	4.3
CN4608700000000	46	087	McCook County, SD	2007	NA	2789	2713	76	2.7
CN4608900000000	46	089	McPherson County, SD	2007	NA	1130	1083	47	4.2
CN4609100000000	46	091	Marshall County, SD	2007	NA	2070	1983	87	4.2
CN4609300000000	46	093	Meade County, SD	2007	NA	12470	12118	352	2.8
CN4609500000000	46	095	Mellette County, SD	2007	NA	887	848	39	4.4
CN4609700000000	46	097	Miner County, SD	2007	NA	1200	1158	42	3.5
CN4609900000000	46	099	Minnehaha County, SD	2007	NA	99419	96929	2490	2.5
CN4610100000000	46	101	Moody County, SD	2007	NA	4060	3909	151	3.7
CN4610200000000	46	102	Oglala Lakota County, SD	2007	NA	3798	3501	297	7.8
CN4610300000000	46	103	Pennington County, SD	2007	NA	54352	52890	1462	2.7
CN4610500000000	46	105	Perkins County, SD	2007	NA	1646	1598	48	2.9
CN4610700000000	46	107	Potter County, SD	2007	NA	1306	1268	38	2.9
CN4610900000000	46	109	Roberts County, SD	2007	NA	4878	4682	196	4
CN4611100000000	46	111	Sanborn County, SD	2007	NA	1471	1435	36	2.4
CN4611500000000	46	115	Spink County, SD	2007	NA	3393	3286	107	3.2
CN4611700000000	46	117	Stanley County, SD	2007	NA	1927	1883	44	2.3
CN4611900000000	46	119	Sully County, SD	2007	NA	992	970	22	2.2
CN4612100000000	46	121	Todd County, SD	2007	NA	3428	3231	197	5.7
CN4612300000000	46	123	Tripp County, SD	2007	NA	3007	2920	87	2.9
CN4612500000000	46	125	Turner County, SD	2007	NA	4305	4178	127	3
CN4612700000000	46	127	Union County, SD	2007	NA	8207	7961	246	3
CN4612900000000	46	129	Walworth County, SD	2007	NA	2714	2608	106	3.9
CN4613500000000	46	135	Yankton County, SD	2007	NA	12299	11984	315	2.6
CN4613700000000	46	137	Ziebach County, SD	2007	NA	865	814	51	5.9
CN4700100000000	47	001	Anderson County, TN	2007	NA	35887	34369	1518	4.2
CN4700300000000	47	003	Bedford County, TN	2007	NA	22991	21887	1104	4.8
CN4700500000000	47	005	Benton County, TN	2007	NA	7003	6576	427	6.1
CN4700700000000	47	007	Bledsoe County, TN	2007	NA	4943	4657	286	5.8
CN4700900000000	47	009	Blount County, TN	2007	NA	62908	60431	2477	3.9
CN4701100000000	47	011	Bradley County, TN	2007	NA	48328	46164	2164	4.5
CN4701300000000	47	013	Campbell County, TN	2007	NA	17046	16138	908	5.3
CN4701500000000	47	015	Cannon County, TN	2007	NA	6445	6133	312	4.8
CN4701700000000	47	017	Carroll County, TN	2007	NA	13841	12969	872	6.3
CN4701900000000	47	019	Carter County, TN	2007	NA	29725	28282	1443	4.9
CN4702100000000	47	021	Cheatham County, TN	2007	NA	20541	19754	787	3.8
CN4702300000000	47	023	Chester County, TN	2007	NA	7918	7502	416	5.3
CN4702500000000	47	025	Claiborne County, TN	2007	NA	13246	12536	710	5.4
CN4702700000000	47	027	Clay County, TN	2007	NA	3528	3248	280	7.9
CN4702900000000	47	029	Cocke County, TN	2007	NA	16605	15563	1042	6.3
CN4703100000000	47	031	Coffee County, TN	2007	NA	26001	24821	1180	4.5
CN4703300000000	47	033	Crockett County, TN	2007	NA	6596	6191	405	6.1
CN4703500000000	47	035	Cumberland County, TN	2007	NA	23213	21939	1274	5.5
CN4703700000000	47	037	Davidson County, TN	2007	NA	325361	312929	12432	3.8
CN4703900000000	47	039	Decatur County, TN	2007	NA	5790	5467	323	5.6
CN4704100000000	47	041	DeKalb County, TN	2007	NA	10422	9959	463	4.4
CN4704300000000	47	043	Dickson County, TN	2007	NA	23382	22410	972	4.2
CN4704500000000	47	045	Dyer County, TN	2007	NA	17554	16685	869	5
CN4704700000000	47	047	Fayette County, TN	2007	NA	18005	16913	1092	6.1
CN4704900000000	47	049	Fentress County, TN	2007	NA	7842	7348	494	6.3
CN4705100000000	47	051	Franklin County, TN	2007	NA	20283	19286	997	4.9
CN4705300000000	47	053	Gibson County, TN	2007	NA	21111	19654	1457	6.9
CN4705500000000	47	055	Giles County, TN	2007	NA	13464	12626	838	6.2
CN4705700000000	47	057	Grainger County, TN	2007	NA	10219	9682	537	5.3
CN4705900000000	47	059	Greene County, TN	2007	NA	31718	29533	2185	6.9
CN4706100000000	47	061	Grundy County, TN	2007	NA	5994	5639	355	5.9
CN4706300000000	47	063	Hamblen County, TN	2007	NA	30399	28963	1436	4.7
CN4706500000000	47	065	Hamilton County, TN	2007	NA	168789	162123	6666	3.9
CN4706700000000	47	067	Hancock County, TN	2007	NA	2466	2327	139	5.6
CN4706900000000	47	069	Hardeman County, TN	2007	NA	11647	10887	760	6.5
CN4707100000000	47	071	Hardin County, TN	2007	NA	12014	11360	654	5.4
CN4707300000000	47	073	Hawkins County, TN	2007	NA	26405	25196	1209	4.6
CN4707500000000	47	075	Haywood County, TN	2007	NA	9911	9221	690	7
CN4707700000000	47	077	Henderson County, TN	2007	NA	12167	11382	785	6.5
CN4707900000000	47	079	Henry County, TN	2007	NA	14172	13294	878	6.2
CN4708100000000	47	081	Hickman County, TN	2007	NA	10107	9560	547	5.4
CN4708300000000	47	083	Houston County, TN	2007	NA	3916	3704	212	5.4
CN4708500000000	47	085	Humphreys County, TN	2007	NA	9183	8676	507	5.5
CN4708700000000	47	087	Jackson County, TN	2007	NA	4991	4651	340	6.8
CN4708900000000	47	089	Jefferson County, TN	2007	NA	24508	23258	1250	5.1
CN4709100000000	47	091	Johnson County, TN	2007	NA	7415	7000	415	5.6
CN4709300000000	47	093	Knox County, TN	2007	NA	229804	221965	7839	3.4
CN4709500000000	47	095	Lake County, TN	2007	NA	2721	2562	159	5.8
CN4709700000000	47	097	Lauderdale County, TN	2007	NA	10478	9788	690	6.6
CN4709900000000	47	099	Lawrence County, TN	2007	NA	16755	15399	1356	8.1
CN4710100000000	47	101	Lewis County, TN	2007	NA	5441	5045	396	7.3
CN4710300000000	47	103	Lincoln County, TN	2007	NA	17528	16905	623	3.6
CN4710500000000	47	105	Loudon County, TN	2007	NA	23300	22395	905	3.9
CN4710700000000	47	107	McMinn County, TN	2007	NA	24906	23530	1376	5.5
CN4710900000000	47	109	McNairy County, TN	2007	NA	12420	11676	744	6
CN4711100000000	47	111	Macon County, TN	2007	NA	10569	9938	631	6
CN4711300000000	47	113	Madison County, TN	2007	NA	49023	46606	2417	4.9
CN4711500000000	47	115	Marion County, TN	2007	NA	13154	12378	776	5.9
CN4711700000000	47	117	Marshall County, TN	2007	NA	13070	12087	983	7.5
CN4711900000000	47	119	Maury County, TN	2007	NA	36916	34037	2879	7.8
CN4712100000000	47	121	Meigs County, TN	2007	NA	4929	4622	307	6.2
CN4712300000000	47	123	Monroe County, TN	2007	NA	19630	18481	1149	5.9
CN4712500000000	47	125	Montgomery County, TN	2007	NA	68883	65642	3241	4.7
CN4712700000000	47	127	Moore County, TN	2007	NA	3196	3064	132	4.1
CN4712900000000	47	129	Morgan County, TN	2007	NA	8494	8003	491	5.8
CN4713100000000	47	131	Obion County, TN	2007	NA	15737	14866	871	5.5
CN4713300000000	47	133	Overton County, TN	2007	NA	10189	9454	735	7.2
CN4713500000000	47	135	Perry County, TN	2007	NA	3157	2916	241	7.6
CN4713700000000	47	137	Pickett County, TN	2007	NA	1937	1780	157	8.1
CN4713900000000	47	139	Polk County, TN	2007	NA	7148	6789	359	5
CN4714100000000	47	141	Putnam County, TN	2007	NA	35659	34045	1614	4.5
CN4714300000000	47	143	Rhea County, TN	2007	NA	13174	12410	764	5.8
CN4714500000000	47	145	Roane County, TN	2007	NA	27068	25877	1191	4.4
CN4714700000000	47	147	Robertson County, TN	2007	NA	33095	31654	1441	4.4
CN4714900000000	47	149	Rutherford County, TN	2007	NA	130630	125789	4841	3.7
CN4715100000000	47	151	Scott County, TN	2007	NA	8771	8156	615	7
CN4715300000000	47	153	Sequatchie County, TN	2007	NA	6185	5886	299	4.8
CN4715500000000	47	155	Sevier County, TN	2007	NA	48350	45955	2395	5
CN4715700000000	47	157	Shelby County, TN	2007	NA	446771	424197	22574	5.1
CN4715900000000	47	159	Smith County, TN	2007	NA	9148	8659	489	5.3
CN4716100000000	47	161	Stewart County, TN	2007	NA	5896	5536	360	6.1
CN4716300000000	47	163	Sullivan County, TN	2007	NA	74033	71092	2941	4
CN4716500000000	47	165	Sumner County, TN	2007	NA	79517	76262	3255	4.1
CN4716700000000	47	167	Tipton County, TN	2007	NA	28295	26840	1455	5.1
CN4716900000000	47	169	Trousdale County, TN	2007	NA	3686	3477	209	5.7
CN4717100000000	47	171	Unicoi County, TN	2007	NA	8429	7988	441	5.2
CN4717300000000	47	173	Union County, TN	2007	NA	8826	8435	391	4.4
CN4717500000000	47	175	Van Buren County, TN	2007	NA	2505	2356	149	5.9
CN4717700000000	47	177	Warren County, TN	2007	NA	17935	16793	1142	6.4
CN4717900000000	47	179	Washington County, TN	2007	NA	61604	59119	2485	4
CN4718100000000	47	181	Wayne County, TN	2007	NA	6671	6180	491	7.4
CN4718300000000	47	183	Weakley County, TN	2007	NA	15734	14711	1023	6.5
CN4718500000000	47	185	White County, TN	2007	NA	10612	9971	641	6
CN4718700000000	47	187	Williamson County, TN	2007	NA	88210	84981	3229	3.7
CN4718900000000	47	189	Wilson County, TN	2007	NA	57487	55167	2320	4
CN4800100000000	48	001	Anderson County, TX	2007	NA	20033	19024	1009	5
CN4800300000000	48	003	Andrews County, TX	2007	NA	6678	6465	213	3.2
CN4800500000000	48	005	Angelina County, TX	2007	NA	39625	37905	1720	4.3
CN4800700000000	48	007	Aransas County, TX	2007	NA	10996	10554	442	4
CN4800900000000	48	009	Archer County, TX	2007	NA	5100	4939	161	3.2
CN4801100000000	48	011	Armstrong County, TX	2007	NA	1068	1032	36	3.4
CN4801300000000	48	013	Atascosa County, TX	2007	NA	18717	17957	760	4.1
CN4801500000000	48	015	Austin County, TX	2007	NA	12820	12342	478	3.7
CN4801700000000	48	017	Bailey County, TX	2007	NA	3277	3137	140	4.3
CN4801900000000	48	019	Bandera County, TX	2007	NA	9579	9219	360	3.8
CN4802100000000	48	021	Bastrop County, TX	2007	NA	33376	31996	1380	4.1
CN4802300000000	48	023	Baylor County, TX	2007	NA	2024	1948	76	3.8
CN4802500000000	48	025	Bee County, TX	2007	NA	11178	10523	655	5.9
CN4802700000000	48	027	Bell County, TX	2007	NA	118579	113309	5270	4.4
CN4802900000000	48	029	Bexar County, TX	2007	NA	733499	703469	30030	4.1
CN4803100000000	48	031	Blanco County, TX	2007	NA	4764	4609	155	3.3
CN4803300000000	48	033	Borden County, TX	2007	NA	372	357	15	4
CN4803500000000	48	035	Bosque County, TX	2007	NA	8167	7821	346	4.2
CN4803700000000	48	037	Bowie County, TX	2007	NA	42908	40897	2011	4.7
CN4803900000000	48	039	Brazoria County, TX	2007	NA	137904	131893	6011	4.4
CN4804100000000	48	041	Brazos County, TX	2007	NA	88105	84943	3162	3.6
CN4804300000000	48	043	Brewster County, TX	2007	NA	5217	5046	171	3.3
CN4804500000000	48	045	Briscoe County, TX	2007	NA	712	682	30	4.2
CN4804700000000	48	047	Brooks County, TX	2007	NA	3081	2917	164	5.3
CN4804900000000	48	049	Brown County, TX	2007	NA	18504	17752	752	4.1
CN4805100000000	48	051	Burleson County, TX	2007	NA	7732	7436	296	3.8
CN4805300000000	48	053	Burnet County, TX	2007	NA	21718	20970	748	3.4
CN4805500000000	48	055	Caldwell County, TX	2007	NA	15408	14728	680	4.4
CN4805700000000	48	057	Calhoun County, TX	2007	NA	9245	8837	408	4.4
CN4805900000000	48	059	Callahan County, TX	2007	NA	6924	6691	233	3.4
CN4806100000000	48	061	Cameron County, TX	2007	NA	142753	134375	8378	5.9
CN4806300000000	48	063	Camp County, TX	2007	NA	5549	5299	250	4.5
CN4806500000000	48	065	Carson County, TX	2007	NA	3349	3246	103	3.1
CN4806700000000	48	067	Cass County, TX	2007	NA	12972	12279	693	5.3
CN4806900000000	48	069	Castro County, TX	2007	NA	3423	3297	126	3.7
CN4807100000000	48	071	Chambers County, TX	2007	NA	13816	13179	637	4.6
CN4807300000000	48	073	Cherokee County, TX	2007	NA	20252	19287	965	4.8
CN4807500000000	48	075	Childress County, TX	2007	NA	3010	2865	145	4.8
CN4807700000000	48	077	Clay County, TX	2007	NA	6212	5997	215	3.5
CN4807900000000	48	079	Cochran County, TX	2007	NA	1477	1404	73	4.9
CN4808100000000	48	081	Coke County, TX	2007	NA	1377	1301	76	5.5
CN4808300000000	48	083	Coleman County, TX	2007	NA	4367	4216	151	3.5
CN4808500000000	48	085	Collin County, TX	2007	NA	395832	380804	15028	3.8
CN4808700000000	48	087	Collingsworth County, TX	2007	NA	1534	1483	51	3.3
CN4808900000000	48	089	Colorado County, TX	2007	NA	10442	10070	372	3.6
CN4809100000000	48	091	Comal County, TX	2007	NA	52364	50496	1868	3.6
CN4809300000000	48	093	Comanche County, TX	2007	NA	6462	6219	243	3.8
CN4809500000000	48	095	Concho County, TX	2007	NA	1315	1250	65	4.9
CN4809700000000	48	097	Cooke County, TX	2007	NA	21646	20879	767	3.5
CN4809900000000	48	099	Coryell County, TX	2007	NA	23247	21887	1360	5.9
CN4810100000000	48	101	Cottle County, TX	2007	NA	819	786	33	4
CN4810300000000	48	103	Crane County, TX	2007	NA	1645	1579	66	4
CN4810500000000	48	105	Crockett County, TX	2007	NA	2068	2008	60	2.9
CN4810700000000	48	107	Crosby County, TX	2007	NA	2638	2514	124	4.7
CN4810900000000	48	109	Culberson County, TX	2007	NA	1752	1705	47	2.7
CN4811100000000	48	111	Dallam County, TX	2007	NA	3236	3146	90	2.8
CN4811300000000	48	113	Dallas County, TX	2007	NA	1137194	1085427	51767	4.6
CN4811500000000	48	115	Dawson County, TX	2007	NA	5074	4812	262	5.2
CN4811700000000	48	117	Deaf Smith County, TX	2007	NA	8706	8398	308	3.5
CN4811900000000	48	119	Delta County, TX	2007	NA	2301	2193	108	4.7
CN4812100000000	48	121	Denton County, TX	2007	NA	337573	324605	12968	3.8
CN4812300000000	48	123	DeWitt County, TX	2007	NA	8987	8637	350	3.9
CN4812500000000	48	125	Dickens County, TX	2007	NA	1176	1131	45	3.8
CN4812700000000	48	127	Dimmit County, TX	2007	NA	3956	3709	247	6.2
CN4812900000000	48	129	Donley County, TX	2007	NA	1805	1727	78	4.3
CN4813100000000	48	131	Duval County, TX	2007	NA	5133	4883	250	4.9
CN4813300000000	48	133	Eastland County, TX	2007	NA	8119	7771	348	4.3
CN4813500000000	48	135	Ector County, TX	2007	NA	66597	64372	2225	3.3
CN4813700000000	48	137	Edwards County, TX	2007	NA	1001	962	39	3.9
CN4813900000000	48	139	Ellis County, TX	2007	NA	69138	66183	2955	4.3
CN4814100000000	48	141	El Paso County, TX	2007	NA	291099	274246	16853	5.8
CN4814300000000	48	143	Erath County, TX	2007	NA	17914	17273	641	3.6
CN4814500000000	48	145	Falls County, TX	2007	NA	6796	6443	353	5.2
CN4814700000000	48	147	Fannin County, TX	2007	NA	13376	12692	684	5.1
CN4814900000000	48	149	Fayette County, TX	2007	NA	12051	11670	381	3.2
CN4815100000000	48	151	Fisher County, TX	2007	NA	1972	1895	77	3.9
CN4815300000000	48	153	Floyd County, TX	2007	NA	3131	2970	161	5.1
CN4815500000000	48	155	Foard County, TX	2007	NA	686	661	25	3.6
CN4815700000000	48	157	Fort Bend County, TX	2007	NA	252965	242849	10116	4
CN4815900000000	48	159	Franklin County, TX	2007	NA	5430	5223	207	3.8
CN4816100000000	48	161	Freestone County, TX	2007	NA	9890	9533	357	3.6
CN4816300000000	48	163	Frio County, TX	2007	NA	6504	6189	315	4.8
CN4816500000000	48	165	Gaines County, TX	2007	NA	6399	6163	236	3.7
CN4816700000000	48	167	Galveston County, TX	2007	NA	138036	131749	6287	4.6
CN4816900000000	48	169	Garza County, TX	2007	NA	2425	2343	82	3.4
CN4817100000000	48	171	Gillespie County, TX	2007	NA	12904	12548	356	2.8
CN4817300000000	48	173	Glasscock County, TX	2007	NA	600	579	21	3.5
CN4817500000000	48	175	Goliad County, TX	2007	NA	3440	3311	129	3.8
CN4817700000000	48	177	Gonzales County, TX	2007	NA	9680	9314	366	3.8
CN4817900000000	48	179	Gray County, TX	2007	NA	11155	10781	374	3.4
CN4818100000000	48	181	Grayson County, TX	2007	NA	55226	52706	2520	4.6
CN4818300000000	48	183	Gregg County, TX	2007	NA	62388	60043	2345	3.8
CN4818500000000	48	185	Grimes County, TX	2007	NA	10447	9967	480	4.6
CN4818700000000	48	187	Guadalupe County, TX	2007	NA	55441	53362	2079	3.7
CN4818900000000	48	189	Hale County, TX	2007	NA	16208	15458	750	4.6
CN4819100000000	48	191	Hall County, TX	2007	NA	1398	1324	74	5.3
CN4819300000000	48	193	Hamilton County, TX	2007	NA	4024	3884	140	3.5
CN4819500000000	48	195	Hansford County, TX	2007	NA	2505	2430	75	3
CN4819700000000	48	197	Hardeman County, TX	2007	NA	2321	2238	83	3.6
CN4819900000000	48	199	Hardin County, TX	2007	NA	25726	24548	1178	4.6
CN4820100000000	48	201	Harris County, TX	2007	NA	1898209	1818000	80209	4.2
CN4820300000000	48	203	Harrison County, TX	2007	NA	32064	30653	1411	4.4
CN4820500000000	48	205	Hartley County, TX	2007	NA	2287	2214	73	3.2
CN4820700000000	48	207	Haskell County, TX	2007	NA	3054	2947	107	3.5
CN4820900000000	48	209	Hays County, TX	2007	NA	73243	70537	2706	3.7
CN4821100000000	48	211	Hemphill County, TX	2007	NA	2646	2592	54	2
CN4821300000000	48	213	Henderson County, TX	2007	NA	34143	32642	1501	4.4
CN4821500000000	48	215	Hidalgo County, TX	2007	NA	271679	254038	17641	6.5
CN4821700000000	48	217	Hill County, TX	2007	NA	15362	14652	710	4.6
CN4821900000000	48	219	Hockley County, TX	2007	NA	11376	10969	407	3.6
CN4822100000000	48	221	Hood County, TX	2007	NA	23773	22805	968	4.1
CN4822300000000	48	223	Hopkins County, TX	2007	NA	16946	16302	644	3.8
CN4822500000000	48	225	Houston County, TX	2007	NA	7853	7396	457	5.8
CN4822700000000	48	227	Howard County, TX	2007	NA	13881	13319	562	4
CN4822900000000	48	229	Hudspeth County, TX	2007	NA	1525	1449	76	5
CN4823100000000	48	231	Hunt County, TX	2007	NA	37612	35895	1717	4.6
CN4823300000000	48	233	Hutchinson County, TX	2007	NA	11086	10649	437	3.9
CN4823500000000	48	235	Irion County, TX	2007	NA	924	897	27	2.9
CN4823700000000	48	237	Jack County, TX	2007	NA	4969	4819	150	3
CN4823900000000	48	239	Jackson County, TX	2007	NA	6632	6384	248	3.7
CN4824100000000	48	241	Jasper County, TX	2007	NA	15478	14614	864	5.6
CN4824300000000	48	243	Jeff Davis County, TX	2007	NA	1180	1141	39	3.3
CN4824500000000	48	245	Jefferson County, TX	2007	NA	112121	106045	6076	5.4
CN4824700000000	48	247	Jim Hogg County, TX	2007	NA	2735	2633	102	3.7
CN4824900000000	48	249	Jim Wells County, TX	2007	NA	21118	20288	830	3.9
CN4825100000000	48	251	Johnson County, TX	2007	NA	71728	68780	2948	4.1
CN4825300000000	48	253	Jones County, TX	2007	NA	7624	7267	357	4.7
CN4825500000000	48	255	Karnes County, TX	2007	NA	5193	4906	287	5.5
CN4825700000000	48	257	Kaufman County, TX	2007	NA	45212	43114	2098	4.6
CN4825900000000	48	259	Kendall County, TX	2007	NA	15371	14841	530	3.4
CN4826100000000	48	261	Kenedy County, TX	2007	NA	236	229	7	3
CN4826300000000	48	263	Kent County, TX	2007	NA	423	409	14	3.3
CN4826500000000	48	265	Kerr County, TX	2007	NA	22532	21758	774	3.4
CN4826700000000	48	267	Kimble County, TX	2007	NA	2229	2155	74	3.3
CN4826900000000	48	269	King County, TX	2007	NA	175	167	8	4.6
CN4827100000000	48	271	Kinney County, TX	2007	NA	1354	1291	63	4.7
CN4827300000000	48	273	Kleberg County, TX	2007	NA	15963	15310	653	4.1
CN4827500000000	48	275	Knox County, TX	2007	NA	1806	1740	66	3.7
CN4827700000000	48	277	Lamar County, TX	2007	NA	24128	23018	1110	4.6
CN4827900000000	48	279	Lamb County, TX	2007	NA	6969	6692	277	4
CN4828100000000	48	281	Lampasas County, TX	2007	NA	10107	9738	369	3.7
CN4828300000000	48	283	La Salle County, TX	2007	NA	2754	2621	133	4.8
CN4828500000000	48	285	Lavaca County, TX	2007	NA	10104	9791	313	3.1
CN4828700000000	48	287	Lee County, TX	2007	NA	8865	8560	305	3.4
CN4828900000000	48	289	Leon County, TX	2007	NA	7562	7252	310	4.1
CN4829100000000	48	291	Liberty County, TX	2007	NA	30617	29033	1584	5.2
CN4829300000000	48	293	Limestone County, TX	2007	NA	10322	9891	431	4.2
CN4829500000000	48	295	Lipscomb County, TX	2007	NA	1840	1793	47	2.6
CN4829700000000	48	297	Live Oak County, TX	2007	NA	5027	4834	193	3.8
CN4829900000000	48	299	Llano County, TX	2007	NA	8151	7829	322	4
CN4830100000000	48	301	Loving County, TX	2007	NA	41	38	3	7.3
CN4830300000000	48	303	Lubbock County, TX	2007	NA	136021	131183	4838	3.6
CN4830500000000	48	305	Lynn County, TX	2007	NA	2674	2544	130	4.9
CN4830700000000	48	307	McCulloch County, TX	2007	NA	3700	3559	141	3.8
CN4830900000000	48	309	McLennan County, TX	2007	NA	110278	105656	4622	4.2
CN4831100000000	48	311	McMullen County, TX	2007	NA	336	319	17	5.1
CN4831300000000	48	313	Madison County, TX	2007	NA	4980	4751	229	4.6
CN4831500000000	48	315	Marion County, TX	2007	NA	5072	4842	230	4.5
CN4831700000000	48	317	Martin County, TX	2007	NA	2130	2054	76	3.6
CN4831900000000	48	319	Mason County, TX	2007	NA	2372	2307	65	2.7
CN4832100000000	48	321	Matagorda County, TX	2007	NA	16480	15508	972	5.9
CN4832300000000	48	323	Maverick County, TX	2007	NA	19826	17576	2250	11.3
CN4832500000000	48	325	Medina County, TX	2007	NA	19395	18592	803	4.1
CN4832700000000	48	327	Menard County, TX	2007	NA	1066	1029	37	3.5
CN4832900000000	48	329	Midland County, TX	2007	NA	71276	69256	2020	2.8
CN4833100000000	48	331	Milam County, TX	2007	NA	12218	11712	506	4.1
CN4833300000000	48	333	Mills County, TX	2007	NA	2291	2208	83	3.6
CN4833500000000	48	335	Mitchell County, TX	2007	NA	3273	3105	168	5.1
CN4833700000000	48	337	Montague County, TX	2007	NA	10256	9898	358	3.5
CN4833900000000	48	339	Montgomery County, TX	2007	NA	202727	194979	7748	3.8
CN4834100000000	48	341	Moore County, TX	2007	NA	10644	10337	307	2.9
CN4834300000000	48	343	Morris County, TX	2007	NA	6044	5730	314	5.2
CN4834500000000	48	345	Motley County, TX	2007	NA	683	656	27	4
CN4834700000000	48	347	Nacogdoches County, TX	2007	NA	30250	29007	1243	4.1
CN4834900000000	48	349	Navarro County, TX	2007	NA	20632	19629	1003	4.9
CN4835100000000	48	351	Newton County, TX	2007	NA	5750	5382	368	6.4
CN4835300000000	48	353	Nolan County, TX	2007	NA	7535	7260	275	3.6
CN4835500000000	48	355	Nueces County, TX	2007	NA	157697	151010	6687	4.2
CN4835700000000	48	357	Ochiltree County, TX	2007	NA	5226	5090	136	2.6
CN4835900000000	48	359	Oldham County, TX	2007	NA	932	896	36	3.9
CN4836100000000	48	361	Orange County, TX	2007	NA	40595	38499	2096	5.2
CN4836300000000	48	363	Palo Pinto County, TX	2007	NA	13864	13358	506	3.6
CN4836500000000	48	365	Panola County, TX	2007	NA	12376	11909	467	3.8
CN4836700000000	48	367	Parker County, TX	2007	NA	52087	50013	2074	4
CN4836900000000	48	369	Parmer County, TX	2007	NA	4352	4216	136	3.1
CN4837100000000	48	371	Pecos County, TX	2007	NA	6555	6281	274	4.2
CN4837300000000	48	373	Polk County, TX	2007	NA	16600	15638	962	5.8
CN4837500000000	48	375	Potter County, TX	2007	NA	56684	54536	2148	3.8
CN4837700000000	48	377	Presidio County, TX	2007	NA	3209	2925	284	8.9
CN4837900000000	48	379	Rains County, TX	2007	NA	5118	4903	215	4.2
CN4838100000000	48	381	Randall County, TX	2007	NA	66973	65024	1949	2.9
CN4838300000000	48	383	Reagan County, TX	2007	NA	2395	2346	49	2
CN4838500000000	48	385	Real County, TX	2007	NA	1372	1319	53	3.9
CN4838700000000	48	387	Red River County, TX	2007	NA	6056	5757	299	4.9
CN4838900000000	48	389	Reeves County, TX	2007	NA	4089	3878	211	5.2
CN4839100000000	48	391	Refugio County, TX	2007	NA	3863	3721	142	3.7
CN4839300000000	48	393	Roberts County, TX	2007	NA	561	548	13	2.3
CN4839500000000	48	395	Robertson County, TX	2007	NA	6906	6562	344	5
CN4839700000000	48	397	Rockwall County, TX	2007	NA	36927	35492	1435	3.9
CN4839900000000	48	399	Runnels County, TX	2007	NA	4415	4223	192	4.3
CN4840100000000	48	401	Rusk County, TX	2007	NA	23413	22450	963	4.1
CN4840300000000	48	403	Sabine County, TX	2007	NA	3384	3113	271	8
CN4840500000000	48	405	San Augustine County, TX	2007	NA	3498	3310	188	5.4
CN4840700000000	48	407	San Jacinto County, TX	2007	NA	9972	9460	512	5.1
CN4840900000000	48	409	San Patricio County, TX	2007	NA	29076	27668	1408	4.8
CN4841100000000	48	411	San Saba County, TX	2007	NA	2470	2356	114	4.6
CN4841300000000	48	413	Schleicher County, TX	2007	NA	1415	1366	49	3.5
CN4841500000000	48	415	Scurry County, TX	2007	NA	7288	7014	274	3.8
CN4841700000000	48	417	Shackelford County, TX	2007	NA	2045	1992	53	2.6
CN4841900000000	48	419	Shelby County, TX	2007	NA	12175	11665	510	4.2
CN4842100000000	48	421	Sherman County, TX	2007	NA	1341	1295	46	3.4
CN4842300000000	48	423	Smith County, TX	2007	NA	96729	92718	4011	4.1
CN4842500000000	48	425	Somervell County, TX	2007	NA	3887	3716	171	4.4
CN4842700000000	48	427	Starr County, TX	2007	NA	21264	19022	2242	10.5
CN4842900000000	48	429	Stephens County, TX	2007	NA	4470	4314	156	3.5
CN4843100000000	48	431	Sterling County, TX	2007	NA	790	768	22	2.8
CN4843300000000	48	433	Stonewall County, TX	2007	NA	878	850	28	3.2
CN4843500000000	48	435	Sutton County, TX	2007	NA	3105	3040	65	2.1
CN4843700000000	48	437	Swisher County, TX	2007	NA	3486	3338	148	4.2
CN4843900000000	48	439	Tarrant County, TX	2007	NA	868680	831857	36823	4.2
CN4844100000000	48	441	Taylor County, TX	2007	NA	65430	63191	2239	3.4
CN4844300000000	48	443	Terrell County, TX	2007	NA	357	339	18	5
CN4844500000000	48	445	Terry County, TX	2007	NA	5712	5452	260	4.6
CN4844700000000	48	447	Throckmorton County, TX	2007	NA	969	933	36	3.7
CN4844900000000	48	449	Titus County, TX	2007	NA	14278	13748	530	3.7
CN4845100000000	48	451	Tom Green County, TX	2007	NA	51711	49822	1889	3.7
CN4845300000000	48	453	Travis County, TX	2007	NA	528962	510019	18943	3.6
CN4845500000000	48	455	Trinity County, TX	2007	NA	5840	5563	277	4.7
CN4845700000000	48	457	Tyler County, TX	2007	NA	8044	7607	437	5.4
CN4845900000000	48	459	Upshur County, TX	2007	NA	19147	18387	760	4
CN4846100000000	48	461	Upton County, TX	2007	NA	1661	1611	50	3
CN4846300000000	48	463	Uvalde County, TX	2007	NA	10957	10386	571	5.2
CN4846500000000	48	465	Val Verde County, TX	2007	NA	20220	19130	1090	5.4
CN4846700000000	48	467	Van Zandt County, TX	2007	NA	25331	24354	977	3.9
CN4846900000000	48	469	Victoria County, TX	2007	NA	44439	42916	1523	3.4
CN4847100000000	48	471	Walker County, TX	2007	NA	25823	24613	1210	4.7
CN4847300000000	48	473	Waller County, TX	2007	NA	16028	15312	716	4.5
CN4847500000000	48	475	Ward County, TX	2007	NA	4860	4682	178	3.7
CN4847700000000	48	477	Washington County, TX	2007	NA	16030	15447	583	3.6
CN4847900000000	48	479	Webb County, TX	2007	NA	89295	85129	4166	4.7
CN4848100000000	48	481	Wharton County, TX	2007	NA	20580	19730	850	4.1
CN4848300000000	48	483	Wheeler County, TX	2007	NA	3052	2976	76	2.5
CN4848500000000	48	485	Wichita County, TX	2007	NA	61745	59170	2575	4.2
CN4848700000000	48	487	Wilbarger County, TX	2007	NA	7660	7403	257	3.4
CN4848900000000	48	489	Willacy County, TX	2007	NA	7539	6932	607	8.1
CN4849100000000	48	491	Williamson County, TX	2007	NA	193070	185976	7094	3.7
CN4849300000000	48	493	Wilson County, TX	2007	NA	18150	17416	734	4
CN4849500000000	48	495	Winkler County, TX	2007	NA	3341	3236	105	3.1
CN4849700000000	48	497	Wise County, TX	2007	NA	27323	26194	1129	4.1
CN4849900000000	48	499	Wood County, TX	2007	NA	17919	17119	800	4.5
CN4850100000000	48	501	Yoakum County, TX	2007	NA	3874	3749	125	3.2
CN4850300000000	48	503	Young County, TX	2007	NA	9541	9236	305	3.2
CN4850500000000	48	505	Zapata County, TX	2007	NA	4943	4682	261	5.3
CN4850700000000	48	507	Zavala County, TX	2007	NA	3713	3322	391	10.5
CN4900100000000	49	001	Beaver County, UT	2007	NA	3175	3095	80	2.5
CN4900300000000	49	003	Box Elder County, UT	2007	NA	23460	22834	626	2.7
CN4900500000000	49	005	Cache County, UT	2007	NA	60730	59486	1244	2
CN4900700000000	49	007	Carbon County, UT	2007	NA	9635	9283	352	3.7
CN4900900000000	49	009	Daggett County, UT	2007	NA	518	500	18	3.5
CN4901100000000	49	011	Davis County, UT	2007	NA	144613	140977	3636	2.5
CN4901300000000	49	013	Duchesne County, UT	2007	NA	9218	9011	207	2.2
CN4901500000000	49	015	Emery County, UT	2007	NA	5134	4962	172	3.4
CN4901700000000	49	017	Garfield County, UT	2007	NA	2727	2602	125	4.6
CN4901900000000	49	019	Grand County, UT	2007	NA	5170	4932	238	4.6
CN4902100000000	49	021	Iron County, UT	2007	NA	21007	20399	608	2.9
CN4902300000000	49	023	Juab County, UT	2007	NA	4112	3983	129	3.1
CN4902500000000	49	025	Kane County, UT	2007	NA	3491	3381	110	3.2
CN4902700000000	49	027	Millard County, UT	2007	NA	6207	6052	155	2.5
CN4902900000000	49	029	Morgan County, UT	2007	NA	3994	3889	105	2.6
CN4903100000000	49	031	Piute County, UT	2007	NA	927	906	21	2.3
CN4903300000000	49	033	Rich County, UT	2007	NA	1444	1415	29	2
CN4903500000000	49	035	Salt Lake County, UT	2007	NA	550691	536924	13767	2.5
CN4903700000000	49	037	San Juan County, UT	2007	NA	4970	4712	258	5.2
CN4903900000000	49	039	Sanpete County, UT	2007	NA	10955	10618	337	3.1
CN4904100000000	49	041	Sevier County, UT	2007	NA	9479	9220	259	2.7
CN4904300000000	49	043	Summit County, UT	2007	NA	21785	21243	542	2.5
CN4904500000000	49	045	Tooele County, UT	2007	NA	26910	26153	757	2.8
CN4904700000000	49	047	Uintah County, UT	2007	NA	17270	16913	357	2.1
CN4904900000000	49	049	Utah County, UT	2007	NA	223138	217722	5416	2.4
CN4905100000000	49	051	Wasatch County, UT	2007	NA	10732	10459	273	2.5
CN4905300000000	49	053	Washington County, UT	2007	NA	63506	61762	1744	2.7
CN4905500000000	49	055	Wayne County, UT	2007	NA	1399	1342	57	4.1
CN4905700000000	49	057	Weber County, UT	2007	NA	112739	109285	3454	3.1
CN5000100000000	50	001	Addison County, VT	2007	NA	21557	20726	831	3.9
CN5000300000000	50	003	Bennington County, VT	2007	NA	20477	19650	827	4
CN5000500000000	50	005	Caledonia County, VT	2007	NA	16729	15982	747	4.5
CN5000700000000	50	007	Chittenden County, VT	2007	NA	88330	85355	2975	3.4
CN5000900000000	50	009	Essex County, VT	2007	NA	3264	3092	172	5.3
CN5001100000000	50	011	Franklin County, VT	2007	NA	25965	24842	1123	4.3
CN5001300000000	50	013	Grand Isle County, VT	2007	NA	4197	3968	229	5.5
CN5001500000000	50	015	Lamoille County, VT	2007	NA	15112	14395	717	4.7
CN5001700000000	50	017	Orange County, VT	2007	NA	16481	15866	615	3.7
CN5001900000000	50	019	Orleans County, VT	2007	NA	14364	13489	875	6.1
CN5002100000000	50	021	Rutland County, VT	2007	NA	35702	34142	1560	4.4
CN5002300000000	50	023	Washington County, VT	2007	NA	34153	32760	1393	4.1
CN5002500000000	50	025	Windham County, VT	2007	NA	24701	23696	1005	4.1
CN5002700000000	50	027	Windsor County, VT	2007	NA	32699	31596	1103	3.4
CN5100100000000	51	001	Accomack County, VA	2007	NA	18780	18008	772	4.1
CN5100300000000	51	003	Albemarle County, VA	2007	NA	51326	50177	1149	2.2
CN5100500000000	51	005	Alleghany County, VA	2007	NA	6979	6675	304	4.4
CN5100700000000	51	007	Amelia County, VA	2007	NA	6564	6383	181	2.8
CN5100900000000	51	009	Amherst County, VA	2007	NA	15528	14988	540	3.5
CN5101100000000	51	011	Appomattox County, VA	2007	NA	6997	6725	272	3.9
CN5101300000000	51	013	Arlington County, VA	2007	NA	131366	128839	2527	1.9
CN5101500000000	51	015	Augusta County, VA	2007	NA	37183	36204	979	2.6
CN5101700000000	51	017	Bath County, VA	2007	NA	2930	2837	93	3.2
CN5101900000000	51	019	Bedford County, VA	2007	NA	37721	36597	1124	3
CN5102100000000	51	021	Bland County, VA	2007	NA	3385	3257	128	3.8
CN5102300000000	51	023	Botetourt County, VA	2007	NA	17421	16962	459	2.6
CN5102500000000	51	025	Brunswick County, VA	2007	NA	6873	6543	330	4.8
CN5102700000000	51	027	Buchanan County, VA	2007	NA	8657	8235	422	4.9
CN5102900000000	51	029	Buckingham County, VA	2007	NA	6998	6756	242	3.5
CN5103100000000	51	031	Campbell County, VA	2007	NA	27253	26320	933	3.4
CN5103300000000	51	033	Caroline County, VA	2007	NA	13902	13385	517	3.7
CN5103500000000	51	035	Carroll County, VA	2007	NA	13901	13116	785	5.6
CN5103600000000	51	036	Charles City County, VA	2007	NA	3809	3660	149	3.9
CN5103700000000	51	037	Charlotte County, VA	2007	NA	5268	4988	280	5.3
CN5104100000000	51	041	Chesterfield County, VA	2007	NA	165682	161332	4350	2.6
CN5104300000000	51	043	Clarke County, VA	2007	NA	8017	7802	215	2.7
CN5104500000000	51	045	Craig County, VA	2007	NA	2559	2464	95	3.7
CN5104700000000	51	047	Culpeper County, VA	2007	NA	20225	19497	728	3.6
CN5104900000000	51	049	Cumberland County, VA	2007	NA	4592	4445	147	3.2
CN5105100000000	51	051	Dickenson County, VA	2007	NA	5787	5484	303	5.2
CN5105300000000	51	053	Dinwiddie County, VA	2007	NA	12841	12399	442	3.4
CN5105700000000	51	057	Essex County, VA	2007	NA	5491	5290	201	3.7
CN5105900000000	51	059	Fairfax County, VA	2007	NA	581377	568732	12645	2.2
CN5106100000000	51	061	Fauquier County, VA	2007	NA	36930	36005	925	2.5
CN5106300000000	51	063	Floyd County, VA	2007	NA	7107	6859	248	3.5
CN5106500000000	51	065	Fluvanna County, VA	2007	NA	13799	13473	326	2.4
CN5106700000000	51	067	Franklin County, VA	2007	NA	26388	25509	879	3.3
CN5106900000000	51	069	Frederick County, VA	2007	NA	41122	39905	1217	3
CN5107100000000	51	071	Giles County, VA	2007	NA	8144	7778	366	4.5
CN5107300000000	51	073	Gloucester County, VA	2007	NA	20549	20039	510	2.5
CN5107500000000	51	075	Goochland County, VA	2007	NA	11126	10860	266	2.4
CN5107700000000	51	077	Grayson County, VA	2007	NA	7121	6757	364	5.1
CN5107900000000	51	079	Greene County, VA	2007	NA	10420	10198	222	2.1
CN5108100000000	51	081	Greensville County, VA	2007	NA	4288	4095	193	4.5
CN5108300000000	51	083	Halifax County, VA	2007	NA	15403	14422	981	6.4
CN5108500000000	51	085	Hanover County, VA	2007	NA	54737	53387	1350	2.5
CN5108700000000	51	087	Henrico County, VA	2007	NA	162619	158125	4494	2.8
CN5108900000000	51	089	Henry County, VA	2007	NA	25752	24336	1416	5.5
CN5109100000000	51	091	Highland County, VA	2007	NA	1127	1089	38	3.4
CN5109300000000	51	093	Isle of Wight County, VA	2007	NA	18589	18057	532	2.9
CN5109500000000	51	095	James City County, VA	2007	NA	31343	30571	772	2.5
CN5109700000000	51	097	King and Queen County, VA	2007	NA	3330	3214	116	3.5
CN5109900000000	51	099	King George County, VA	2007	NA	9352	9023	329	3.5
CN5110100000000	51	101	King William County, VA	2007	NA	8461	8232	229	2.7
CN5110300000000	51	103	Lancaster County, VA	2007	NA	5318	5086	232	4.4
CN5110500000000	51	105	Lee County, VA	2007	NA	9585	9186	399	4.2
CN5110700000000	51	107	Loudoun County, VA	2007	NA	163971	160532	3439	2.1
CN5110900000000	51	109	Louisa County, VA	2007	NA	16152	15683	469	2.9
CN5111100000000	51	111	Lunenburg County, VA	2007	NA	5508	5258	250	4.5
CN5111300000000	51	113	Madison County, VA	2007	NA	7352	7156	196	2.7
CN5111500000000	51	115	Mathews County, VA	2007	NA	4427	4314	113	2.6
CN5111700000000	51	117	Mecklenburg County, VA	2007	NA	13192	12525	667	5.1
CN5111900000000	51	119	Middlesex County, VA	2007	NA	5041	4890	151	3
CN5112100000000	51	121	Montgomery County, VA	2007	NA	44293	42874	1419	3.2
CN5112500000000	51	125	Nelson County, VA	2007	NA	7904	7692	212	2.7
CN5112700000000	51	127	New Kent County, VA	2007	NA	9415	9159	256	2.7
CN5113100000000	51	131	Northampton County, VA	2007	NA	5959	5717	242	4.1
CN5113300000000	51	133	Northumberland County, VA	2007	NA	5947	5689	258	4.3
CN5113500000000	51	135	Nottoway County, VA	2007	NA	6577	6322	255	3.9
CN5113700000000	51	137	Orange County, VA	2007	NA	15396	14903	493	3.2
CN5113900000000	51	139	Page County, VA	2007	NA	11328	10755	573	5.1
CN5114100000000	51	141	Patrick County, VA	2007	NA	9049	8682	367	4.1
CN5114300000000	51	143	Pittsylvania County, VA	2007	NA	30955	29185	1770	5.7
CN5114500000000	51	145	Powhatan County, VA	2007	NA	14287	13950	337	2.4
CN5114700000000	51	147	Prince Edward County, VA	2007	NA	9053	8637	416	4.6
CN5114900000000	51	149	Prince George County, VA	2007	NA	14693	14219	474	3.2
CN5115300000000	51	153	Prince William County, VA	2007	NA	200311	195368	4943	2.5
CN5115500000000	51	155	Pulaski County, VA	2007	NA	17706	16730	976	5.5
CN5115700000000	51	157	Rappahannock County, VA	2007	NA	4314	4206	108	2.5
CN5115900000000	51	159	Richmond County, VA	2007	NA	3500	3348	152	4.3
CN5116100000000	51	161	Roanoke County, VA	2007	NA	48977	47743	1234	2.5
CN5116300000000	51	163	Rockbridge County, VA	2007	NA	11240	10912	328	2.9
CN5116500000000	51	165	Rockingham County, VA	2007	NA	41530	40497	1033	2.5
CN5116700000000	51	167	Russell County, VA	2007	NA	11772	11165	607	5.2
CN5116900000000	51	169	Scott County, VA	2007	NA	9804	9350	454	4.6
CN5117100000000	51	171	Shenandoah County, VA	2007	NA	20009	19372	637	3.2
CN5117300000000	51	173	Smyth County, VA	2007	NA	15065	14244	821	5.4
CN5117500000000	51	175	Southampton County, VA	2007	NA	7673	7397	276	3.6
CN5117700000000	51	177	Spotsylvania County, VA	2007	NA	64669	63030	1639	2.5
CN5117900000000	51	179	Stafford County, VA	2007	NA	64503	62816	1687	2.6
CN5118100000000	51	181	Surry County, VA	2007	NA	3730	3603	127	3.4
CN5118300000000	51	183	Sussex County, VA	2007	NA	4464	4264	200	4.5
CN5118500000000	51	185	Tazewell County, VA	2007	NA	20298	19384	914	4.5
CN5118700000000	51	187	Warren County, VA	2007	NA	19438	18846	592	3
CN5119100000000	51	191	Washington County, VA	2007	NA	26738	25524	1214	4.5
CN5119300000000	51	193	Westmoreland County, VA	2007	NA	8313	7964	349	4.2
CN5119500000000	51	195	Wise County, VA	2007	NA	17456	16769	687	3.9
CN5119700000000	51	197	Wythe County, VA	2007	NA	15475	14784	691	4.5
CN5119900000000	51	199	York County, VA	2007	NA	31002	30233	769	2.5
CN5151000000000	51	510	Alexandria city, VA	2007	NA	89476	87484	1992	2.2
CN5152000000000	51	520	Bristol city, VA	2007	NA	7966	7557	409	5.1
CN5153000000000	51	530	Buena Vista city, VA	2007	NA	3376	3255	121	3.6
CN5154000000000	51	540	Charlottesville city, VA	2007	NA	21246	20596	650	3.1
CN5155000000000	51	550	Chesapeake city, VA	2007	NA	114338	110894	3444	3
CN5157000000000	51	570	Colonial Heights city, VA	2007	NA	9205	8906	299	3.2
CN5158000000000	51	580	Covington city, VA	2007	NA	2704	2545	159	5.9
CN5159000000000	51	590	Danville city, VA	2007	NA	19709	18250	1459	7.4
CN5159500000000	51	595	Emporia city, VA	2007	NA	2456	2305	151	6.1
CN5160000000000	51	600	Fairfax city, VA	2007	NA	13902	13550	352	2.5
CN5161000000000	51	610	Falls Church city, VA	2007	NA	6661	6456	205	3.1
CN5162000000000	51	620	Franklin city, VA	2007	NA	3924	3743	181	4.6
CN5163000000000	51	630	Fredericksburg city, VA	2007	NA	12429	11872	557	4.5
CN5164000000000	51	640	Galax city, VA	2007	NA	3124	2948	176	5.6
CN5165000000000	51	650	Hampton city, VA	2007	NA	68492	66052	2440	3.6
CN5166000000000	51	660	Harrisonburg city, VA	2007	NA	22762	22100	662	2.9
CN5167000000000	51	670	Hopewell city, VA	2007	NA	10437	9950	487	4.7
CN5167800000000	51	678	Lexington city, VA	2007	NA	2367	2258	109	4.6
CN5168000000000	51	680	Lynchburg city, VA	2007	NA	33610	32350	1260	3.7
CN5168300000000	51	683	Manassas city, VA	2007	NA	19776	19200	576	2.9
CN5168500000000	51	685	Manassas Park city, VA	2007	NA	6562	6395	167	2.5
CN5169000000000	51	690	Martinsville city, VA	2007	NA	5919	5432	487	8.2
CN5170000000000	51	700	Newport News city, VA	2007	NA	87554	84430	3124	3.6
CN5171000000000	51	710	Norfolk city, VA	2007	NA	99742	95656	4086	4.1
CN5172000000000	51	720	Norton city, VA	2007	NA	1565	1501	64	4.1
CN5173000000000	51	730	Petersburg city, VA	2007	NA	14087	13206	881	6.3
CN5173500000000	51	735	Poquoson city, VA	2007	NA	6327	6183	144	2.3
CN5174000000000	51	740	Portsmouth city, VA	2007	NA	46428	44483	1945	4.2
CN5175000000000	51	750	Radford city, VA	2007	NA	7757	7443	314	4
CN5176000000000	51	760	Richmond city, VA	2007	NA	98875	94548	4327	4.4
CN5177000000000	51	770	Roanoke city, VA	2007	NA	46289	44547	1742	3.8
CN5177500000000	51	775	Salem city, VA	2007	NA	13370	12975	395	3
CN5179000000000	51	790	Staunton city, VA	2007	NA	11609	11251	358	3.1
CN5180000000000	51	800	Suffolk city, VA	2007	NA	39794	38487	1307	3.3
CN5181000000000	51	810	Virginia Beach city, VA	2007	NA	222978	216854	6124	2.7
CN5182000000000	51	820	Waynesboro city, VA	2007	NA	10090	9742	348	3.4
CN5183000000000	51	830	Williamsburg city, VA	2007	NA	5112	4825	287	5.6
CN5184000000000	51	840	Winchester city, VA	2007	NA	14328	13868	460	3.2
CN5300100000000	53	001	Adams County, WA	2007	NA	8021	7495	526	6.6
CN5300300000000	53	003	Asotin County, WA	2007	NA	10264	9733	531	5.2
CN5300500000000	53	005	Benton County, WA	2007	NA	86073	81368	4705	5.5
CN5300700000000	53	007	Chelan County, WA	2007	NA	40622	38390	2232	5.5
CN5300900000000	53	009	Clallam County, WA	2007	NA	30007	28041	1966	6.6
CN5301100000000	53	011	Clark County, WA	2007	NA	209985	196792	13193	6.3
CN5301300000000	53	013	Columbia County, WA	2007	NA	1531	1417	114	7.4
CN5301500000000	53	015	Cowlitz County, WA	2007	NA	43809	40721	3088	7
CN5301700000000	53	017	Douglas County, WA	2007	NA	20956	19853	1103	5.3
CN5301900000000	53	019	Ferry County, WA	2007	NA	2975	2711	264	8.9
CN5302100000000	53	021	Franklin County, WA	2007	NA	32463	30208	2255	6.9
CN5302300000000	53	023	Garfield County, WA	2007	NA	1018	963	55	5.4
CN5302500000000	53	025	Grant County, WA	2007	NA	40534	37905	2629	6.5
CN5302700000000	53	027	Grays Harbor County, WA	2007	NA	31481	28996	2485	7.9
CN5302900000000	53	029	Island County, WA	2007	NA	32973	31150	1823	5.5
CN5303100000000	53	031	Jefferson County, WA	2007	NA	13696	12968	728	5.3
CN5303300000000	53	033	King County, WA	2007	NA	1067240	1033216	34024	3.2
CN5303500000000	53	035	Kitsap County, WA	2007	NA	123028	116967	6061	4.9
CN5303700000000	53	037	Kittitas County, WA	2007	NA	20360	19265	1095	5.4
CN5303900000000	53	039	Klickitat County, WA	2007	NA	9756	9028	728	7.5
CN5304100000000	53	041	Lewis County, WA	2007	NA	31212	28762	2450	7.8
CN5304300000000	53	043	Lincoln County, WA	2007	NA	4704	4429	275	5.8
CN5304500000000	53	045	Mason County, WA	2007	NA	25189	23543	1646	6.5
CN5304700000000	53	047	Okanogan County, WA	2007	NA	20642	19194	1448	7
CN5304900000000	53	049	Pacific County, WA	2007	NA	9293	8591	702	7.6
CN5305100000000	53	051	Pend Oreille County, WA	2007	NA	5290	4874	416	7.9
CN5305300000000	53	053	Pierce County, WA	2007	NA	387377	366760	20617	5.3
CN5305500000000	53	055	San Juan County, WA	2007	NA	8486	8160	326	3.8
CN5305700000000	53	057	Skagit County, WA	2007	NA	57934	54870	3064	5.3
CN5305900000000	53	059	Skamania County, WA	2007	NA	5059	4682	377	7.5
CN5306100000000	53	061	Snohomish County, WA	2007	NA	363266	350475	12791	3.5
CN5306300000000	53	063	Spokane County, WA	2007	NA	233681	221245	12436	5.3
CN5306500000000	53	065	Stevens County, WA	2007	NA	18631	17145	1486	8
CN5306700000000	53	067	Thurston County, WA	2007	NA	128000	121724	6276	4.9
CN5306900000000	53	069	Wahkiakum County, WA	2007	NA	1667	1544	123	7.4
CN5307100000000	53	071	Walla Walla County, WA	2007	NA	29172	27603	1569	5.4
CN5307300000000	53	073	Whatcom County, WA	2007	NA	106348	101371	4977	4.7
CN5307500000000	53	075	Whitman County, WA	2007	NA	20298	19433	865	4.3
CN5307700000000	53	077	Yakima County, WA	2007	NA	120128	111716	8412	7
CN5400100000000	54	001	Barbour County, WV	2007	NA	6733	6366	367	5.5
CN5400300000000	54	003	Berkeley County, WV	2007	NA	45993	44102	1891	4.1
CN5400500000000	54	005	Boone County, WV	2007	NA	9453	9007	446	4.7
CN5400700000000	54	007	Braxton County, WV	2007	NA	6019	5689	330	5.5
CN5400900000000	54	009	Brooke County, WV	2007	NA	10948	10298	650	5.9
CN5401100000000	54	011	Cabell County, WV	2007	NA	45655	43794	1861	4.1
CN5401300000000	54	013	Calhoun County, WV	2007	NA	2754	2560	194	7
CN5401500000000	54	015	Clay County, WV	2007	NA	3500	3255	245	7
CN5401700000000	54	017	Doddridge County, WV	2007	NA	2823	2685	138	4.9
CN5401900000000	54	019	Fayette County, WV	2007	NA	18141	17154	987	5.4
CN5402100000000	54	021	Gilmer County, WV	2007	NA	3106	2980	126	4.1
CN5402300000000	54	023	Grant County, WV	2007	NA	5310	5032	278	5.2
CN5402500000000	54	025	Greenbrier County, WV	2007	NA	15614	14669	945	6.1
CN5402700000000	54	027	Hampshire County, WV	2007	NA	9693	9343	350	3.6
CN5402900000000	54	029	Hancock County, WV	2007	NA	14419	13589	830	5.8
CN5403100000000	54	031	Hardy County, WV	2007	NA	7222	6918	304	4.2
CN5403300000000	54	033	Harrison County, WV	2007	NA	30762	29452	1310	4.3
CN5403500000000	54	035	Jackson County, WV	2007	NA	12055	11470	585	4.9
CN5403700000000	54	037	Jefferson County, WV	2007	NA	25251	24439	812	3.2
CN5403900000000	54	039	Kanawha County, WV	2007	NA	92044	88360	3684	4
CN5404100000000	54	041	Lewis County, WV	2007	NA	7374	6997	377	5.1
CN5404300000000	54	043	Lincoln County, WV	2007	NA	8018	7582	436	5.4
CN5404500000000	54	045	Logan County, WV	2007	NA	12888	12212	676	5.2
CN5404700000000	54	047	McDowell County, WV	2007	NA	6944	6429	515	7.4
CN5404900000000	54	049	Marion County, WV	2007	NA	26269	25156	1113	4.2
CN5405100000000	54	051	Marshall County, WV	2007	NA	14867	14081	786	5.3
CN5405300000000	54	053	Mason County, WV	2007	NA	10357	9643	714	6.9
CN5405500000000	54	055	Mercer County, WV	2007	NA	24823	23780	1043	4.2
CN5405700000000	54	057	Mineral County, WV	2007	NA	13397	12766	631	4.7
CN5405900000000	54	059	Mingo County, WV	2007	NA	8806	8305	501	5.7
CN5406100000000	54	061	Monongalia County, WV	2007	NA	47423	45933	1490	3.1
CN5406300000000	54	063	Monroe County, WV	2007	NA	5954	5675	279	4.7
CN5406500000000	54	065	Morgan County, WV	2007	NA	7084	6750	334	4.7
CN5406700000000	54	067	Nicholas County, WV	2007	NA	10793	10255	538	5
CN5406900000000	54	069	Ohio County, WV	2007	NA	21089	20200	889	4.2
CN5407100000000	54	071	Pendleton County, WV	2007	NA	3807	3666	141	3.7
CN5407300000000	54	073	Pleasants County, WV	2007	NA	3163	2982	181	5.7
CN5407500000000	54	075	Pocahontas County, WV	2007	NA	3747	3474	273	7.3
CN5407700000000	54	077	Preston County, WV	2007	NA	14859	14218	641	4.3
CN5407900000000	54	079	Putnam County, WV	2007	NA	27468	26446	1022	3.7
CN5408100000000	54	081	Raleigh County, WV	2007	NA	32751	31296	1455	4.4
CN5408300000000	54	083	Randolph County, WV	2007	NA	13086	12420	666	5.1
CN5408500000000	54	085	Ritchie County, WV	2007	NA	4628	4391	237	5.1
CN5408700000000	54	087	Roane County, WV	2007	NA	5595	5235	360	6.4
CN5408900000000	54	089	Summers County, WV	2007	NA	4754	4469	285	6
CN5409100000000	54	091	Taylor County, WV	2007	NA	6946	6608	338	4.9
CN5409300000000	54	093	Tucker County, WV	2007	NA	2994	2812	182	6.1
CN5409500000000	54	095	Tyler County, WV	2007	NA	3675	3447	228	6.2
CN5409700000000	54	097	Upshur County, WV	2007	NA	10830	10353	477	4.4
CN5409900000000	54	099	Wayne County, WV	2007	NA	17752	16920	832	4.7
CN5410100000000	54	101	Webster County, WV	2007	NA	3373	3182	191	5.7
CN5410300000000	54	103	Wetzel County, WV	2007	NA	6311	5878	433	6.9
CN5410500000000	54	105	Wirt County, WV	2007	NA	2489	2341	148	5.9
CN5410700000000	54	107	Wood County, WV	2007	NA	41151	39229	1922	4.7
CN5410900000000	54	109	Wyoming County, WV	2007	NA	8204	7700	504	6.1
CN5500100000000	55	001	Adams County, WI	2007	NA	10105	9439	666	6.6
CN5500300000000	55	003	Ashland County, WI	2007	NA	9059	8515	544	6
CN5500500000000	55	005	Barron County, WI	2007	NA	25035	23556	1479	5.9
CN5500700000000	55	007	Bayfield County, WI	2007	NA	8168	7629	539	6.6
CN5500900000000	55	009	Brown County, WI	2007	NA	139064	132673	6391	4.6
CN5501100000000	55	011	Buffalo County, WI	2007	NA	8234	7874	360	4.4
CN5501300000000	55	013	Burnett County, WI	2007	NA	8110	7554	556	6.9
CN5501500000000	55	015	Calumet County, WI	2007	NA	25551	24336	1215	4.8
CN5501700000000	55	017	Chippewa County, WI	2007	NA	33801	31980	1821	5.4
CN5501900000000	55	019	Clark County, WI	2007	NA	17798	16780	1018	5.7
CN5502100000000	55	021	Columbia County, WI	2007	NA	31157	29585	1572	5
CN5502300000000	55	023	Crawford County, WI	2007	NA	9725	9198	527	5.4
CN5502500000000	55	025	Dane County, WI	2007	NA	292809	282673	10136	3.5
CN5502700000000	55	027	Dodge County, WI	2007	NA	46916	44532	2384	5.1
CN5502900000000	55	029	Door County, WI	2007	NA	17012	16091	921	5.4
CN5503100000000	55	031	Douglas County, WI	2007	NA	23176	22016	1160	5
CN5503300000000	55	033	Dunn County, WI	2007	NA	25963	24795	1168	4.5
CN5503500000000	55	035	Eau Claire County, WI	2007	NA	57275	54873	2402	4.2
CN5503700000000	55	037	Florence County, WI	2007	NA	2500	2351	149	6
CN5503900000000	55	039	Fond du Lac County, WI	2007	NA	56882	54193	2689	4.7
CN5504100000000	55	041	Forest County, WI	2007	NA	5027	4668	359	7.1
CN5504300000000	55	043	Grant County, WI	2007	NA	28222	26865	1357	4.8
CN5504500000000	55	045	Green County, WI	2007	NA	20355	19398	957	4.7
CN5504700000000	55	047	Green Lake County, WI	2007	NA	10498	9927	571	5.4
CN5504900000000	55	049	Iowa County, WI	2007	NA	14048	13412	636	4.5
CN5505100000000	55	051	Iron County, WI	2007	NA	3065	2819	246	8
CN5505300000000	55	053	Jackson County, WI	2007	NA	9863	9306	557	5.6
CN5505500000000	55	055	Jefferson County, WI	2007	NA	42244	40188	2056	4.9
CN5505700000000	55	057	Juneau County, WI	2007	NA	13299	12496	803	6
CN5505900000000	55	059	Kenosha County, WI	2007	NA	84396	80060	4336	5.1
CN5506100000000	55	061	Kewaunee County, WI	2007	NA	11720	11177	543	4.6
CN5506300000000	55	063	La Crosse County, WI	2007	NA	64425	61901	2524	3.9
CN5506500000000	55	065	Lafayette County, WI	2007	NA	9314	8928	386	4.1
CN5506700000000	55	067	Langlade County, WI	2007	NA	10689	10031	658	6.2
CN5506900000000	55	069	Lincoln County, WI	2007	NA	15570	14690	880	5.7
CN5507100000000	55	071	Manitowoc County, WI	2007	NA	44712	42275	2437	5.5
CN5507300000000	55	073	Marathon County, WI	2007	NA	75971	72651	3320	4.4
CN5507500000000	55	075	Marinette County, WI	2007	NA	22337	20942	1395	6.2
CN5507700000000	55	077	Marquette County, WI	2007	NA	7925	7441	484	6.1
CN5507800000000	55	078	Menominee County, WI	2007	NA	1650	1478	172	10.4
CN5507900000000	55	079	Milwaukee County, WI	2007	NA	469736	442497	27239	5.8
CN5508100000000	55	081	Monroe County, WI	2007	NA	24073	22963	1110	4.6
CN5508300000000	55	083	Oconto County, WI	2007	NA	20353	19086	1267	6.2
CN5508500000000	55	085	Oneida County, WI	2007	NA	19432	18232	1200	6.2
CN5508700000000	55	087	Outagamie County, WI	2007	NA	97153	92643	4510	4.6
CN5508900000000	55	089	Ozaukee County, WI	2007	NA	47848	46016	1832	3.8
CN5509100000000	55	091	Pepin County, WI	2007	NA	4121	3912	209	5.1
CN5509300000000	55	093	Pierce County, WI	2007	NA	23806	22767	1039	4.4
CN5509500000000	55	095	Polk County, WI	2007	NA	24222	22715	1507	6.2
CN5509700000000	55	097	Portage County, WI	2007	NA	41954	40073	1881	4.5
CN5509900000000	55	099	Price County, WI	2007	NA	8232	7811	421	5.1
CN5510100000000	55	101	Racine County, WI	2007	NA	100263	94374	5889	5.9
CN5510300000000	55	103	Richland County, WI	2007	NA	9940	9420	520	5.2
CN5510500000000	55	105	Rock County, WI	2007	NA	84388	79647	4741	5.6
CN5510700000000	55	107	Rusk County, WI	2007	NA	7306	6772	534	7.3
CN5510900000000	55	109	St. Croix County, WI	2007	NA	47330	45004	2326	4.9
CN5511100000000	55	111	Sauk County, WI	2007	NA	35050	33395	1655	4.7
CN5511300000000	55	113	Sawyer County, WI	2007	NA	9571	8921	650	6.8
CN5511500000000	55	115	Shawano County, WI	2007	NA	22167	21001	1166	5.3
CN5511700000000	55	117	Sheboygan County, WI	2007	NA	66076	63287	2789	4.2
CN5511900000000	55	119	Taylor County, WI	2007	NA	10471	9871	600	5.7
CN5512100000000	55	121	Trempealeau County, WI	2007	NA	16308	15577	731	4.5
CN5512300000000	55	123	Vernon County, WI	2007	NA	14217	13477	740	5.2
CN5512500000000	55	125	Vilas County, WI	2007	NA	11588	10847	741	6.4
CN5512700000000	55	127	Walworth County, WI	2007	NA	56079	53487	2592	4.6
CN5512900000000	55	129	Washburn County, WI	2007	NA	7902	7361	541	6.8
CN5513100000000	55	131	Washington County, WI	2007	NA	73845	70663	3182	4.3
CN5513300000000	55	133	Waukesha County, WI	2007	NA	214220	205558	8662	4
CN5513500000000	55	135	Waupaca County, WI	2007	NA	28194	26694	1500	5.3
CN5513700000000	55	137	Waushara County, WI	2007	NA	12718	11975	743	5.8
CN5513900000000	55	139	Winnebago County, WI	2007	NA	93681	89412	4269	4.6
CN5514100000000	55	141	Wood County, WI	2007	NA	41927	39705	2222	5.3
CN5600100000000	56	001	Albany County, WY	2007	NA	18535	18087	448	2.4
CN5600300000000	56	003	Big Horn County, WY	2007	NA	4865	4668	197	4
CN5600500000000	56	005	Campbell County, WY	2007	NA	25965	25440	525	2
CN5600700000000	56	007	Carbon County, WY	2007	NA	8234	7996	238	2.9
CN5600900000000	56	009	Converse County, WY	2007	NA	6892	6696	196	2.8
CN5601100000000	56	011	Crook County, WY	2007	NA	3396	3303	93	2.7
CN5601300000000	56	013	Fremont County, WY	2007	NA	17893	17221	672	3.8
CN5601500000000	56	015	Goshen County, WY	2007	NA	5861	5671	190	3.2
CN5601700000000	56	017	Hot Springs County, WY	2007	NA	2350	2272	78	3.3
CN5601900000000	56	019	Johnson County, WY	2007	NA	3888	3759	129	3.3
CN5602100000000	56	021	Laramie County, WY	2007	NA	41835	40350	1485	3.5
CN5602300000000	56	023	Lincoln County, WY	2007	NA	8892	8668	224	2.5
CN5602500000000	56	025	Natrona County, WY	2007	NA	39943	38905	1038	2.6
CN5602700000000	56	027	Niobrara County, WY	2007	NA	1190	1154	36	3
CN5602900000000	56	029	Park County, WY	2007	NA	14091	13648	443	3.1
CN5603100000000	56	031	Platte County, WY	2007	NA	3913	3757	156	4
CN5603300000000	56	033	Sheridan County, WY	2007	NA	15654	15211	443	2.8
CN5603500000000	56	035	Sublette County, WY	2007	NA	6608	6512	96	1.5
CN5603700000000	56	037	Sweetwater County, WY	2007	NA	23712	23184	528	2.2
CN5603900000000	56	039	Teton County, WY	2007	NA	14375	14058	317	2.2
CN5604100000000	56	041	Uinta County, WY	2007	NA	11113	10818	295	2.7
CN5604300000000	56	043	Washakie County, WY	2007	NA	4194	4048	146	3.5
CN5604500000000	56	045	Weston County, WY	2007	NA	3159	3059	100	3.2
CN7200100000000	72	001	Adjuntas Municipio, PR	2007	NA	5206	4474	732	14.1
CN7200300000000	72	003	Aguada Municipio, PR	2007	NA	16278	14205	2073	12.7
CN7200500000000	72	005	Aguadilla Municipio, PR	2007	NA	22557	19657	2900	12.9
CN7200700000000	72	007	Aguas Buenas Municipio, PR	2007	NA	9766	8556	1210	12.4
CN7200900000000	72	009	Aibonito Municipio, PR	2007	NA	8076	6973	1103	13.7
CN7201100000000	72	011	Anasco Municipio, PR	2007	NA	11148	9711	1437	12.9
CN7201300000000	72	013	Arecibo Municipio, PR	2007	NA	33965	29866	4099	12.1
CN7201500000000	72	015	Arroyo Municipio, PR	2007	NA	5803	4895	908	15.6
CN7201700000000	72	017	Barceloneta Municipio, PR	2007	NA	7469	6354	1115	14.9
CN7201900000000	72	019	Barranquitas Municipio, PR	2007	NA	7900	6888	1012	12.8
CN7202100000000	72	021	Bayamon Municipio, PR	2007	NA	84040	76436	7604	9
CN7202300000000	72	023	Cabo Rojo Municipio, PR	2007	NA	21096	19106	1990	9.4
CN7202500000000	72	025	Caguas Municipio, PR	2007	NA	55241	49106	6135	11.1
CN7202700000000	72	027	Camuy Municipio, PR	2007	NA	13171	11770	1401	10.6
CN7202900000000	72	029	Canovanas Municipio, PR	2007	NA	14838	12856	1982	13.4
CN7203100000000	72	031	Carolina Municipio, PR	2007	NA	78610	71822	6788	8.6
CN7203300000000	72	033	Catano Municipio, PR	2007	NA	8080	7093	987	12.2
CN7203500000000	72	035	Cayey Municipio, PR	2007	NA	16067	13989	2078	12.9
CN7203700000000	72	037	Ceiba Municipio, PR	2007	NA	6105	5275	830	13.6
CN7203900000000	72	039	Ciales Municipio, PR	2007	NA	5296	4441	855	16.1
CN7204100000000	72	041	Cidra Municipio, PR	2007	NA	16104	14069	2035	12.6
CN7204300000000	72	043	Coamo Municipio, PR	2007	NA	11623	10067	1556	13.4
CN7204500000000	72	045	Comerio Municipio, PR	2007	NA	4861	4155	706	14.5
CN7204700000000	72	047	Corozal Municipio, PR	2007	NA	10861	9466	1395	12.8
CN7204900000000	72	049	Culebra Municipio, PR	2007	NA	858	800	58	6.8
CN7205100000000	72	051	Dorado Municipio, PR	2007	NA	13110	11815	1295	9.9
CN7205300000000	72	053	Fajardo Municipio, PR	2007	NA	15534	13459	2075	13.4
CN7205400000000	72	054	Florida Municipio, PR	2007	NA	4324	3745	579	13.4
CN7205500000000	72	055	Guanica Municipio, PR	2007	NA	6567	5557	1010	15.4
CN7205700000000	72	057	Guayama Municipio, PR	2007	NA	14966	12918	2048	13.7
CN7205900000000	72	059	Guayanilla Municipio, PR	2007	NA	6954	5939	1015	14.6
CN7206100000000	72	061	Guaynabo Municipio, PR	2007	NA	45395	42362	3033	6.7
CN7206300000000	72	063	Gurabo Municipio, PR	2007	NA	16033	14279	1754	10.9
CN7206500000000	72	065	Hatillo Municipio, PR	2007	NA	13211	11581	1630	12.3
CN7206700000000	72	067	Hormigueros Municipio, PR	2007	NA	6830	6102	728	10.7
CN7206900000000	72	069	Humacao Municipio, PR	2007	NA	21295	18130	3165	14.9
CN7207100000000	72	071	Isabela Municipio, PR	2007	NA	16159	14174	1985	12.3
CN7207300000000	72	073	Jayuya Municipio, PR	2007	NA	4559	3896	663	14.5
CN7207500000000	72	075	Juana Diaz Municipio, PR	2007	NA	17587	15484	2103	12
CN7207700000000	72	077	Juncos Municipio, PR	2007	NA	13513	11709	1804	13.4
CN7207900000000	72	079	Lajas Municipio, PR	2007	NA	9140	7934	1206	13.2
CN7208100000000	72	081	Lares Municipio, PR	2007	NA	12030	10617	1413	11.7
CN7208300000000	72	083	Las Marias Municipio, PR	2007	NA	4271	3801	470	11
CN7208500000000	72	085	Las Piedras Municipio, PR	2007	NA	13190	11410	1780	13.5
CN7208700000000	72	087	Loiza Municipio, PR	2007	NA	8950	7730	1220	13.6
CN7208900000000	72	089	Luquillo Municipio, PR	2007	NA	7313	6199	1114	15.2
CN7209100000000	72	091	Manati Municipio, PR	2007	NA	15068	12983	2085	13.8
CN7209300000000	72	093	Maricao Municipio, PR	2007	NA	1841	1579	262	14.2
CN7209500000000	72	095	Maunabo Municipio, PR	2007	NA	3748	3019	729	19.5
CN7209700000000	72	097	Mayaguez Municipio, PR	2007	NA	30885	27000	3885	12.6
CN7209900000000	72	099	Moca Municipio, PR	2007	NA	15551	13717	1834	11.8
CN7210100000000	72	101	Morovis Municipio, PR	2007	NA	9435	8034	1401	14.8
CN7210300000000	72	103	Naguabo Municipio, PR	2007	NA	7716	6473	1243	16.1
CN7210500000000	72	105	Naranjito Municipio, PR	2007	NA	8740	7714	1026	11.7
CN7210700000000	72	107	Orocovis Municipio, PR	2007	NA	5526	4700	826	14.9
CN7210900000000	72	109	Patillas Municipio, PR	2007	NA	6211	5188	1023	16.5
CN7211100000000	72	111	Penuelas Municipio, PR	2007	NA	9096	7776	1320	14.5
CN7211300000000	72	113	Ponce Municipio, PR	2007	NA	65445	58109	7336	11.2
CN7211500000000	72	115	Quebradillas Municipio, PR	2007	NA	8861	7786	1075	12.1
CN7211700000000	72	117	Rincon Municipio, PR	2007	NA	5740	5023	717	12.5
CN7211900000000	72	119	Rio Grande Municipio, PR	2007	NA	18266	16192	2074	11.4
CN7212100000000	72	121	Sabana Grande Municipio, PR	2007	NA	9677	8325	1352	14
CN7212300000000	72	123	Salinas Municipio, PR	2007	NA	8891	7570	1321	14.9
CN7212500000000	72	125	San German Municipio, PR	2007	NA	13283	11550	1733	13
CN7212700000000	72	127	San Juan Municipio, PR	2007	NA	172437	158470	13967	8.1
CN7212900000000	72	129	San Lorenzo Municipio, PR	2007	NA	14740	12907	1833	12.4
CN7213100000000	72	131	San Sebastian Municipio, PR	2007	NA	15861	13837	2024	12.8
CN7213300000000	72	133	Santa Isabel Municipio, PR	2007	NA	8518	7307	1211	14.2
CN7213500000000	72	135	Toa Alta Municipio, PR	2007	NA	30318	27813	2505	8.3
CN7213700000000	72	137	Toa Baja Municipio, PR	2007	NA	36123	32909	3214	8.9
CN7213900000000	72	139	Trujillo Alto Municipio, PR	2007	NA	35625	32943	2682	7.5
CN7214100000000	72	141	Utuado Municipio, PR	2007	NA	9177	7817	1360	14.8
CN7214300000000	72	143	Vega Alta Municipio, PR	2007	NA	12663	11235	1428	11.3
CN7214500000000	72	145	Vega Baja Municipio, PR	2007	NA	21115	18445	2670	12.6
CN7214700000000	72	147	Vieques Municipio, PR	2007	NA	3317	2955	362	10.9
CN7214900000000	72	149	Villalba Municipio, PR	2007	NA	9479	8223	1256	13.3
CN7215100000000	72	151	Yabucoa Municipio, PR	2007	NA	11425	9348	2077	18.2
CN7215300000000	72	153	Yauco Municipio, PR	2007	NA	16635	14451	2184	13.1
NA	NA	NA	NA	NA	NA	NA	NA	NA	NA
SOURCE:  BLS, LAUS	NA	NA	NA	NA	NA	NA	NA	NA	NA
March 18, 2016	NA	NA	NA	NA	NA	NA	NA	NA	NA
