LAUS_CODE	STATE_FIPS	COUNTY_FIPS	COUNTY	YEAR	ESTIMATED	LABOR_FORCE	EMPLOYED	UNEMPLOYED_LEVEL	UNEMPLOYED_RATE
CN0100100000000	01	001	Autauga County, AL	2006	NA	24398	23585	813	3.3
CN0100300000000	01	003	Baldwin County, AL	2006	NA	79711	77147	2564	3.2
CN0100500000000	01	005	Barbour County, AL	2006	NA	10705	10096	609	5.7
CN0100700000000	01	007	Bibb County, AL	2006	NA	8850	8477	373	4.2
CN0100900000000	01	009	Blount County, AL	2006	NA	26770	25902	868	3.2
CN0101100000000	01	011	Bullock County, AL	2006	NA	3702	3372	330	8.9
CN0101300000000	01	013	Butler County, AL	2006	NA	9238	8709	529	5.7
CN0101500000000	01	015	Calhoun County, AL	2006	NA	54063	51872	2191	4.1
CN0101700000000	01	017	Chambers County, AL	2006	NA	15749	14828	921	5.8
CN0101900000000	01	019	Cherokee County, AL	2006	NA	11854	11352	502	4.2
CN0102100000000	01	021	Chilton County, AL	2006	NA	19771	19059	712	3.6
CN0102300000000	01	023	Choctaw County, AL	2006	NA	5329	5030	299	5.6
CN0102500000000	01	025	Clarke County, AL	2006	NA	10261	9622	639	6.2
CN0102700000000	01	027	Clay County, AL	2006	NA	6182	5902	280	4.5
CN0102900000000	01	029	Cleburne County, AL	2006	NA	6639	6406	233	3.5
CN0103100000000	01	031	Coffee County, AL	2006	NA	20691	19917	774	3.7
CN0103300000000	01	033	Colbert County, AL	2006	NA	25307	24128	1179	4.7
CN0103500000000	01	035	Conecuh County, AL	2006	NA	5123	4833	290	5.7
CN0103700000000	01	037	Coosa County, AL	2006	NA	4794	4525	269	5.6
CN0103900000000	01	039	Covington County, AL	2006	NA	17195	16529	666	3.9
CN0104100000000	01	041	Crenshaw County, AL	2006	NA	6595	6332	263	4
CN0104300000000	01	043	Cullman County, AL	2006	NA	39375	38026	1349	3.4
CN0104500000000	01	045	Dale County, AL	2006	NA	20480	19522	958	4.7
CN0104700000000	01	047	Dallas County, AL	2006	NA	15903	14594	1309	8.2
CN0104900000000	01	049	DeKalb County, AL	2006	NA	31493	30176	1317	4.2
CN0105100000000	01	051	Elmore County, AL	2006	NA	35169	33968	1201	3.4
CN0105300000000	01	053	Escambia County, AL	2006	NA	14348	13634	714	5
CN0105500000000	01	055	Etowah County, AL	2006	NA	46521	44546	1975	4.2
CN0105700000000	01	057	Fayette County, AL	2006	NA	7743	7414	329	4.2
CN0105900000000	01	059	Franklin County, AL	2006	NA	13939	13291	648	4.6
CN0106100000000	01	061	Geneva County, AL	2006	NA	11699	11257	442	3.8
CN0106300000000	01	063	Greene County, AL	2006	NA	3392	3201	191	5.6
CN0106500000000	01	065	Hale County, AL	2006	NA	7170	6792	378	5.3
CN0106700000000	01	067	Henry County, AL	2006	NA	7506	7204	302	4
CN0106900000000	01	069	Houston County, AL	2006	NA	46701	45099	1602	3.4
CN0107100000000	01	071	Jackson County, AL	2006	NA	27066	25852	1214	4.5
CN0107300000000	01	073	Jefferson County, AL	2006	NA	316750	304027	12723	4
CN0107500000000	01	075	Lamar County, AL	2006	NA	6043	5727	316	5.2
CN0107700000000	01	077	Lauderdale County, AL	2006	NA	42593	40795	1798	4.2
CN0107900000000	01	079	Lawrence County, AL	2006	NA	15644	14889	755	4.8
CN0108100000000	01	081	Lee County, AL	2006	NA	64828	62616	2212	3.4
CN0108300000000	01	083	Limestone County, AL	2006	NA	35764	34458	1306	3.7
CN0108500000000	01	085	Lowndes County, AL	2006	NA	4814	4448	366	7.6
CN0108700000000	01	087	Macon County, AL	2006	NA	8836	8368	468	5.3
CN0108900000000	01	089	Madison County, AL	2006	NA	161332	156018	5314	3.3
CN0109100000000	01	091	Marengo County, AL	2006	NA	8592	8193	399	4.6
CN0109300000000	01	093	Marion County, AL	2006	NA	13504	12913	591	4.4
CN0109500000000	01	095	Marshall County, AL	2006	NA	41986	40527	1459	3.5
CN0109700000000	01	097	Mobile County, AL	2006	NA	182019	174428	7591	4.2
CN0109900000000	01	099	Monroe County, AL	2006	NA	9323	8759	564	6
CN0110100000000	01	101	Montgomery County, AL	2006	NA	105711	101297	4414	4.2
CN0110300000000	01	103	Morgan County, AL	2006	NA	55887	53635	2252	4
CN0110500000000	01	105	Perry County, AL	2006	NA	3586	3284	302	8.4
CN0110700000000	01	107	Pickens County, AL	2006	NA	8113	7703	410	5.1
CN0110900000000	01	109	Pike County, AL	2006	NA	15166	14557	609	4
CN0111100000000	01	111	Randolph County, AL	2006	NA	9758	9237	521	5.3
CN0111300000000	01	113	Russell County, AL	2006	NA	21467	20204	1263	5.9
CN0111500000000	01	115	St. Clair County, AL	2006	NA	35053	33819	1234	3.5
CN0111700000000	01	117	Shelby County, AL	2006	NA	98394	95698	2696	2.7
CN0111900000000	01	119	Sumter County, AL	2006	NA	4791	4465	326	6.8
CN0112100000000	01	121	Talladega County, AL	2006	NA	39456	37413	2043	5.2
CN0112300000000	01	123	Tallapoosa County, AL	2006	NA	18536	17595	941	5.1
CN0112500000000	01	125	Tuscaloosa County, AL	2006	NA	87495	84619	2876	3.3
CN0112700000000	01	127	Walker County, AL	2006	NA	29877	28516	1361	4.6
CN0112900000000	01	129	Washington County, AL	2006	NA	6901	6501	400	5.8
CN0113100000000	01	131	Wilcox County, AL	2006	NA	3571	3260	311	8.7
CN0113300000000	01	133	Winston County, AL	2006	NA	10591	10067	524	4.9
CN0201300000000	02	013	Aleutians East Borough, AK	2006	NA	1141	1044	97	8.5
CN0201600000000	02	016	Aleutians West Census Area, AK	2006	NA	3214	3031	183	5.7
CN0202000000000	02	020	Anchorage Borough/municipality, AK	2006	NA	151530	143482	8048	5.3
CN0205000000000	02	050	Bethel Census Area, AK	2006	NA	6980	6057	923	13.2
CN0206000000000	02	060	Bristol Bay Borough, AK	2006	NA	1021	966	55	5.4
CN0206800000000	02	068	Denali Borough, AK	2006	NA	1648	1552	96	5.8
CN0207000000000	02	070	Dillingham Census Area, AK	2006	NA	2103	1902	201	9.6
CN0209000000000	02	090	Fairbanks North Star Borough, AK	2006	NA	45211	42634	2577	5.7
CN0210000000000	02	100	Haines Borough, AK	2006	NA	1453	1336	117	8.1
CN0211000000000	02	110	Juneau Borough/city, AK	2006	NA	18544	17645	899	4.8
CN0212200000000	02	122	Kenai Peninsula Borough, AK	2006	NA	25460	23373	2087	8.2
CN0213000000000	02	130	Ketchikan Gateway Borough, AK	2006	NA	8100	7603	497	6.1
CN0215000000000	02	150	Kodiak Island Borough, AK	2006	NA	6148	5688	460	7.5
CN0215800000000	02	158	Kusilvak Census Area, AK	2006	NA	2539	2012	527	20.8
CN0216400000000	02	164	Lake and Peninsula Borough, AK	2006	NA	1081	1015	66	6.1
CN0217000000000	02	170	Matanuska-Susitna Borough, AK	2006	NA	39042	36118	2924	7.5
CN0218000000000	02	180	Nome Census Area, AK	2006	NA	3897	3427	470	12.1
CN0218500000000	02	185	North Slope Borough, AK	2006	NA	4144	3860	284	6.9
CN0218800000000	02	188	Northwest Arctic Borough, AK	2006	NA	2963	2627	336	11.3
CN0220100000000	02	201	Prince of Wales-Outer Ketchikan Census Area, AK	2006	NA	2353	2016	337	14.3
CN0222000000000	02	220	Sitka Borough/city, AK	2006	NA	4684	4431	253	5.4
CN0223200000000	02	232	Skagway-Hoonah-Angoon Census Area, AK	2006	NA	1898	1657	241	12.7
CN0224000000000	02	240	Southeast Fairbanks Census Area, AK	2006	NA	3344	2986	358	10.7
CN0226100000000	02	261	Valdez-Cordova Census Area, AK	2006	NA	5192	4749	443	8.5
CN0228000000000	02	280	Wrangell-Petersburg Census Area, AK	2006	NA	2907	2629	278	9.6
CN0228200000000	02	282	Yakutat Borough/city, AK	2006	NA	311	281	30	9.6
CN0229000000000	02	290	Yukon-Koyukuk Census Area, AK	2006	NA	2790	2424	366	13.1
CN0400100000000	04	001	Apache County, AZ	2006	NA	20365	18320	2045	10
CN0400300000000	04	003	Cochise County, AZ	2006	NA	57210	54625	2585	4.5
CN0400500000000	04	005	Coconino County, AZ	2006	NA	69512	66470	3042	4.4
CN0400700000000	04	007	Gila County, AZ	2006	NA	20972	19878	1094	5.2
CN0400900000000	04	009	Graham County, AZ	2006	NA	13124	12456	668	5.1
CN0401100000000	04	011	Greenlee County, AZ	2006	NA	3774	3631	143	3.8
CN0401200000000	04	012	La Paz County, AZ	2006	NA	7759	7311	448	5.8
CN0401300000000	04	013	Maricopa County, AZ	2006	NA	1920575	1851719	68856	3.6
CN0401500000000	04	015	Mohave County, AZ	2006	NA	92888	88852	4036	4.3
CN0401700000000	04	017	Navajo County, AZ	2006	NA	38224	35396	2828	7.4
CN0401900000000	04	019	Pima County, AZ	2006	NA	451861	433523	18338	4.1
CN0402100000000	04	021	Pinal County, AZ	2006	NA	102937	97775	5162	5
CN0402300000000	04	023	Santa Cruz County, AZ	2006	NA	16746	15468	1278	7.6
CN0402500000000	04	025	Yavapai County, AZ	2006	NA	96732	92833	3899	4
CN0402700000000	04	027	Yuma County, AZ	2006	NA	77764	66129	11635	15
CN0500100000000	05	001	Arkansas County, AR	2006	NA	11749	10860	889	7.6
CN0500300000000	05	003	Ashley County, AR	2006	NA	9798	9067	731	7.5
CN0500500000000	05	005	Baxter County, AR	2006	NA	17534	16604	930	5.3
CN0500700000000	05	007	Benton County, AR	2006	NA	103728	100267	3461	3.3
CN0500900000000	05	009	Boone County, AR	2006	NA	17099	16256	843	4.9
CN0501100000000	05	011	Bradley County, AR	2006	NA	5719	5320	399	7
CN0501300000000	05	013	Calhoun County, AR	2006	NA	2672	2487	185	6.9
CN0501500000000	05	015	Carroll County, AR	2006	NA	14034	13429	605	4.3
CN0501700000000	05	017	Chicot County, AR	2006	NA	5031	4611	420	8.3
CN0501900000000	05	019	Clark County, AR	2006	NA	11021	10411	610	5.5
CN0502100000000	05	021	Clay County, AR	2006	NA	7138	6557	581	8.1
CN0502300000000	05	023	Cleburne County, AR	2006	NA	11643	11062	581	5
CN0502500000000	05	025	Cleveland County, AR	2006	NA	4238	3981	257	6.1
CN0502700000000	05	027	Columbia County, AR	2006	NA	11148	10475	673	6
CN0502900000000	05	029	Conway County, AR	2006	NA	9939	9451	488	4.9
CN0503100000000	05	031	Craighead County, AR	2006	NA	45843	43648	2195	4.8
CN0503300000000	05	033	Crawford County, AR	2006	NA	28157	26886	1271	4.5
CN0503500000000	05	035	Crittenden County, AR	2006	NA	22464	20939	1525	6.8
CN0503700000000	05	037	Cross County, AR	2006	NA	8654	8030	624	7.2
CN0503900000000	05	039	Dallas County, AR	2006	NA	3952	3694	258	6.5
CN0504100000000	05	041	Desha County, AR	2006	NA	6356	5778	578	9.1
CN0504300000000	05	043	Drew County, AR	2006	NA	8595	7911	684	8
CN0504500000000	05	045	Faulkner County, AR	2006	NA	53586	51235	2351	4.4
CN0504700000000	05	047	Franklin County, AR	2006	NA	8586	8217	369	4.3
CN0504900000000	05	049	Fulton County, AR	2006	NA	5128	4869	259	5.1
CN0505100000000	05	051	Garland County, AR	2006	NA	42313	40108	2205	5.2
CN0505300000000	05	053	Grant County, AR	2006	NA	8689	8266	423	4.9
CN0505500000000	05	055	Greene County, AR	2006	NA	19060	17981	1079	5.7
CN0505700000000	05	057	Hempstead County, AR	2006	NA	11097	10497	600	5.4
CN0505900000000	05	059	Hot Spring County, AR	2006	NA	15604	14798	806	5.2
CN0506100000000	05	061	Howard County, AR	2006	NA	6511	6160	351	5.4
CN0506300000000	05	063	Independence County, AR	2006	NA	17664	16695	969	5.5
CN0506500000000	05	065	Izard County, AR	2006	NA	5416	5082	334	6.2
CN0506700000000	05	067	Jackson County, AR	2006	NA	7925	7316	609	7.7
CN0506900000000	05	069	Jefferson County, AR	2006	NA	36465	33607	2858	7.8
CN0507100000000	05	071	Johnson County, AR	2006	NA	11184	10611	573	5.1
CN0507300000000	05	073	Lafayette County, AR	2006	NA	3158	2936	222	7
CN0507500000000	05	075	Lawrence County, AR	2006	NA	7479	6974	505	6.8
CN0507700000000	05	077	Lee County, AR	2006	NA	3618	3287	331	9.1
CN0507900000000	05	079	Lincoln County, AR	2006	NA	5196	4782	414	8
CN0508100000000	05	081	Little River County, AR	2006	NA	6535	6240	295	4.5
CN0508300000000	05	083	Logan County, AR	2006	NA	10322	9822	500	4.8
CN0508500000000	05	085	Lonoke County, AR	2006	NA	31679	30337	1342	4.2
CN0508700000000	05	087	Madison County, AR	2006	NA	7923	7638	285	3.6
CN0508900000000	05	089	Marion County, AR	2006	NA	6995	6633	362	5.2
CN0509100000000	05	091	Miller County, AR	2006	NA	19572	18662	910	4.6
CN0509300000000	05	093	Mississippi County, AR	2006	NA	21268	19610	1658	7.8
CN0509500000000	05	095	Monroe County, AR	2006	NA	3892	3613	279	7.2
CN0509700000000	05	097	Montgomery County, AR	2006	NA	4401	4195	206	4.7
CN0509900000000	05	099	Nevada County, AR	2006	NA	4446	4201	245	5.5
CN0510100000000	05	101	Newton County, AR	2006	NA	3608	3422	186	5.2
CN0510300000000	05	103	Ouachita County, AR	2006	NA	12531	11525	1006	8
CN0510500000000	05	105	Perry County, AR	2006	NA	4905	4661	244	5
CN0510700000000	05	107	Phillips County, AR	2006	NA	9148	8404	744	8.1
CN0510900000000	05	109	Pike County, AR	2006	NA	5375	5104	271	5
CN0511100000000	05	111	Poinsett County, AR	2006	NA	11359	10603	756	6.7
CN0511300000000	05	113	Polk County, AR	2006	NA	8928	8504	424	4.7
CN0511500000000	05	115	Pope County, AR	2006	NA	30229	28796	1433	4.7
CN0511700000000	05	117	Prairie County, AR	2006	NA	4517	4263	254	5.6
CN0511900000000	05	119	Pulaski County, AR	2006	NA	189922	180838	9084	4.8
CN0512100000000	05	121	Randolph County, AR	2006	NA	7829	7268	561	7.2
CN0512300000000	05	123	St. Francis County, AR	2006	NA	10814	9847	967	8.9
CN0512500000000	05	125	Saline County, AR	2006	NA	48576	46446	2130	4.4
CN0512700000000	05	127	Scott County, AR	2006	NA	4938	4720	218	4.4
CN0512900000000	05	129	Searcy County, AR	2006	NA	3559	3390	169	4.7
CN0513100000000	05	131	Sebastian County, AR	2006	NA	60935	58127	2808	4.6
CN0513300000000	05	133	Sevier County, AR	2006	NA	7781	7467	314	4
CN0513500000000	05	135	Sharp County, AR	2006	NA	6557	6117	440	6.7
CN0513700000000	05	137	Stone County, AR	2006	NA	4767	4503	264	5.5
CN0513900000000	05	139	Union County, AR	2006	NA	19852	18532	1320	6.6
CN0514100000000	05	141	Van Buren County, AR	2006	NA	7118	6690	428	6
CN0514300000000	05	143	Washington County, AR	2006	NA	103155	99421	3734	3.6
CN0514500000000	05	145	White County, AR	2006	NA	32299	30463	1836	5.7
CN0514700000000	05	147	Woodruff County, AR	2006	NA	3581	3285	296	8.3
CN0514900000000	05	149	Yell County, AR	2006	NA	10914	10425	489	4.5
CN0600100000000	06	001	Alameda County, CA	2006	NA	733836	701275	32561	4.4
CN0600300000000	06	003	Alpine County, CA	2006	NA	482	451	31	6.4
CN0600500000000	06	005	Amador County, CA	2006	NA	17236	16315	921	5.3
CN0600700000000	06	007	Butte County, CA	2006	NA	99752	93557	6195	6.2
CN0600900000000	06	009	Calaveras County, CA	2006	NA	20596	19390	1206	5.9
CN0601100000000	06	011	Colusa County, CA	2006	NA	9915	8701	1214	12.2
CN0601300000000	06	013	Contra Costa County, CA	2006	NA	510424	488580	21844	4.3
CN0601500000000	06	015	Del Norte County, CA	2006	NA	10793	10053	740	6.9
CN0601700000000	06	017	El Dorado County, CA	2006	NA	91558	87339	4219	4.6
CN0601900000000	06	019	Fresno County, CA	2006	NA	410430	377532	32898	8
CN0602100000000	06	021	Glenn County, CA	2006	NA	11612	10681	931	8
CN0602300000000	06	023	Humboldt County, CA	2006	NA	59404	56124	3280	5.5
CN0602500000000	06	025	Imperial County, CA	2006	NA	63023	53304	9719	15.4
CN0602700000000	06	027	Inyo County, CA	2006	NA	9010	8599	411	4.6
CN0602900000000	06	029	Kern County, CA	2006	NA	336093	310742	25351	7.5
CN0603100000000	06	031	Kings County, CA	2006	NA	54995	50355	4640	8.4
CN0603300000000	06	033	Lake County, CA	2006	NA	24273	22410	1863	7.7
CN0603500000000	06	035	Lassen County, CA	2006	NA	12217	11253	964	7.9
CN0603700000000	06	037	Los Angeles County, CA	2006	NA	4807873	4577565	230308	4.8
CN0603900000000	06	039	Madera County, CA	2006	NA	62732	58352	4380	7
CN0604100000000	06	041	Marin County, CA	2006	NA	130575	125967	4608	3.5
CN0604300000000	06	043	Mariposa County, CA	2006	NA	9008	8499	509	5.7
CN0604500000000	06	045	Mendocino County, CA	2006	NA	43242	40993	2249	5.2
CN0604700000000	06	047	Merced County, CA	2006	NA	97919	88681	9238	9.4
CN0604900000000	06	049	Modoc County, CA	2006	NA	3981	3672	309	7.8
CN0605100000000	06	051	Mono County, CA	2006	NA	8238	7874	364	4.4
CN0605300000000	06	053	Monterey County, CA	2006	NA	203070	189023	14047	6.9
CN0605500000000	06	055	Napa County, CA	2006	NA	71692	68927	2765	3.9
CN0605700000000	06	057	Nevada County, CA	2006	NA	49610	47443	2167	4.4
CN0605900000000	06	059	Orange County, CA	2006	NA	1597788	1543471	54317	3.4
CN0606100000000	06	061	Placer County, CA	2006	NA	168855	161825	7030	4.2
CN0606300000000	06	063	Plumas County, CA	2006	NA	10086	9314	772	7.7
CN0606500000000	06	065	Riverside County, CA	2006	NA	881248	836872	44376	5
CN0606700000000	06	067	Sacramento County, CA	2006	NA	668817	637010	31807	4.8
CN0606900000000	06	069	San Benito County, CA	2006	NA	24164	22433	1731	7.2
CN0607100000000	06	071	San Bernardino County, CA	2006	NA	860020	818622	41398	4.8
CN0607300000000	06	073	San Diego County, CA	2006	NA	1496145	1436821	59324	4
CN0607500000000	06	075	San Francisco County/city, CA	2006	NA	415749	398293	17456	4.2
CN0607700000000	06	077	San Joaquin County, CA	2006	NA	283597	262552	21045	7.4
CN0607900000000	06	079	San Luis Obispo County, CA	2006	NA	132376	127166	5210	3.9
CN0608100000000	06	081	San Mateo County, CA	2006	NA	364007	350645	13362	3.7
CN0608300000000	06	083	Santa Barbara County, CA	2006	NA	210884	202365	8519	4
CN0608500000000	06	085	Santa Clara County, CA	2006	NA	821565	784773	36792	4.5
CN0608700000000	06	087	Santa Cruz County, CA	2006	NA	143053	134990	8063	5.6
CN0608900000000	06	089	Shasta County, CA	2006	NA	82446	77008	5438	6.6
CN0609100000000	06	091	Sierra County, CA	2006	NA	1587	1469	118	7.4
CN0609300000000	06	093	Siskiyou County, CA	2006	NA	18596	17107	1489	8
CN0609500000000	06	095	Solano County, CA	2006	NA	207849	197727	10122	4.9
CN0609700000000	06	097	Sonoma County, CA	2006	NA	253990	243840	10150	4
CN0609900000000	06	099	Stanislaus County, CA	2006	NA	224294	206447	17847	8
CN0610100000000	06	101	Sutter County, CA	2006	NA	40363	36753	3610	8.9
CN0610300000000	06	103	Tehama County, CA	2006	NA	25054	23432	1622	6.5
CN0610500000000	06	105	Trinity County, CA	2006	NA	5058	4558	500	9.9
CN0610700000000	06	107	Tulare County, CA	2006	NA	187407	171467	15940	8.5
CN0610900000000	06	109	Tuolumne County, CA	2006	NA	25806	24316	1490	5.8
CN0611100000000	06	111	Ventura County, CA	2006	NA	419562	401509	18053	4.3
CN0611300000000	06	113	Yolo County, CA	2006	NA	93606	88766	4840	5.2
CN0611500000000	06	115	Yuba County, CA	2006	NA	26551	24218	2333	8.8
CN0800100000000	08	001	Adams County, CO	2006	NA	217152	206644	10508	4.8
CN0800300000000	08	003	Alamosa County, CO	2006	NA	8231	7849	382	4.6
CN0800500000000	08	005	Arapahoe County, CO	2006	NA	302717	289805	12912	4.3
CN0800700000000	08	007	Archuleta County, CO	2006	NA	6452	6186	266	4.1
CN0800900000000	08	009	Baca County, CO	2006	NA	2423	2348	75	3.1
CN0801100000000	08	011	Bent County, CO	2006	NA	2409	2274	135	5.6
CN0801300000000	08	013	Boulder County, CO	2006	NA	170598	164263	6335	3.7
CN0801400000000	08	014	Broomfield County/city, CO	2006	NA	25442	24355	1087	4.3
CN0801500000000	08	015	Chaffee County, CO	2006	NA	8148	7795	353	4.3
CN0801700000000	08	017	Cheyenne County, CO	2006	NA	1349	1313	36	2.7
CN0801900000000	08	019	Clear Creek County, CO	2006	NA	5791	5557	234	4
CN0802100000000	08	021	Conejos County, CO	2006	NA	3770	3523	247	6.6
CN0802300000000	08	023	Costilla County, CO	2006	NA	1326	1214	112	8.4
CN0802500000000	08	025	Crowley County, CO	2006	NA	1590	1482	108	6.8
CN0802700000000	08	027	Custer County, CO	2006	NA	1949	1866	83	4.3
CN0802900000000	08	029	Delta County, CO	2006	NA	15873	15240	633	4
CN0803100000000	08	031	Denver County/city, CO	2006	NA	306021	291349	14672	4.8
CN0803300000000	08	033	Dolores County, CO	2006	NA	985	921	64	6.5
CN0803500000000	08	035	Douglas County, CO	2006	NA	151085	145720	5365	3.6
CN0803700000000	08	037	Eagle County, CO	2006	NA	29827	28823	1004	3.4
CN0803900000000	08	039	Elbert County, CO	2006	NA	13123	12602	521	4
CN0804100000000	08	041	El Paso County, CO	2006	NA	295570	281919	13651	4.6
CN0804300000000	08	043	Fremont County, CO	2006	NA	19440	18362	1078	5.5
CN0804500000000	08	045	Garfield County, CO	2006	NA	33227	32244	983	3
CN0804700000000	08	047	Gilpin County, CO	2006	NA	3406	3269	137	4
CN0804900000000	08	049	Grand County, CO	2006	NA	8773	8488	285	3.2
CN0805100000000	08	051	Gunnison County, CO	2006	NA	9514	9215	299	3.1
CN0805300000000	08	053	Hinsdale County, CO	2006	NA	618	599	19	3.1
CN0805500000000	08	055	Huerfano County, CO	2006	NA	3371	3168	203	6
CN0805700000000	08	057	Jackson County, CO	2006	NA	1108	1076	32	2.9
CN0805900000000	08	059	Jefferson County, CO	2006	NA	304252	291546	12706	4.2
CN0806100000000	08	061	Kiowa County, CO	2006	NA	888	858	30	3.4
CN0806300000000	08	063	Kit Carson County, CO	2006	NA	4485	4349	136	3
CN0806500000000	08	065	Lake County, CO	2006	NA	4019	3849	170	4.2
CN0806700000000	08	067	La Plata County, CO	2006	NA	30309	29290	1019	3.4
CN0806900000000	08	069	Larimer County, CO	2006	NA	169350	162695	6655	3.9
CN0807100000000	08	071	Las Animas County, CO	2006	NA	8456	8114	342	4
CN0807300000000	08	073	Lincoln County, CO	2006	NA	3059	2950	109	3.6
CN0807500000000	08	075	Logan County, CO	2006	NA	11129	10745	384	3.5
CN0807700000000	08	077	Mesa County, CO	2006	NA	74156	71219	2937	4
CN0807900000000	08	079	Mineral County, CO	2006	NA	453	431	22	4.9
CN0808100000000	08	081	Moffat County, CO	2006	NA	8350	8036	314	3.8
CN0808300000000	08	083	Montezuma County, CO	2006	NA	13163	12582	581	4.4
CN0808500000000	08	085	Montrose County, CO	2006	NA	20286	19474	812	4
CN0808700000000	08	087	Morgan County, CO	2006	NA	14345	13789	556	3.9
CN0808900000000	08	089	Otero County, CO	2006	NA	9326	8761	565	6.1
CN0809100000000	08	091	Ouray County, CO	2006	NA	3009	2915	94	3.1
CN0809300000000	08	093	Park County, CO	2006	NA	9741	9357	384	3.9
CN0809500000000	08	095	Phillips County, CO	2006	NA	2395	2314	81	3.4
CN0809700000000	08	097	Pitkin County, CO	2006	NA	11262	10909	353	3.1
CN0809900000000	08	099	Prowers County, CO	2006	NA	6938	6535	403	5.8
CN0810100000000	08	101	Pueblo County, CO	2006	NA	70426	66466	3960	5.6
CN0810300000000	08	103	Rio Blanco County, CO	2006	NA	4735	4607	128	2.7
CN0810500000000	08	105	Rio Grande County, CO	2006	NA	6616	6309	307	4.6
CN0810700000000	08	107	Routt County, CO	2006	NA	14986	14508	478	3.2
CN0810900000000	08	109	Saguache County, CO	2006	NA	3198	2999	199	6.2
CN0811100000000	08	111	San Juan County, CO	2006	NA	551	524	27	4.9
CN0811300000000	08	113	San Miguel County, CO	2006	NA	5445	5261	184	3.4
CN0811500000000	08	115	Sedgwick County, CO	2006	NA	1628	1578	50	3.1
CN0811700000000	08	117	Summit County, CO	2006	NA	16845	16324	521	3.1
CN0811900000000	08	119	Teller County, CO	2006	NA	12800	12256	544	4.3
CN0812100000000	08	121	Washington County, CO	2006	NA	2898	2798	100	3.5
CN0812300000000	08	123	Weld County, CO	2006	NA	114953	109578	5375	4.7
CN0812500000000	08	125	Yuma County, CO	2006	NA	6506	6336	170	2.6
CN0900100000000	09	001	Fairfield County, CT	2006	NA	459839	442204	17635	3.8
CN0900300000000	09	003	Hartford County, CT	2006	NA	445627	424469	21158	4.7
CN0900500000000	09	005	Litchfield County, CT	2006	NA	103802	99647	4155	4
CN0900700000000	09	007	Middlesex County, CT	2006	NA	91260	87921	3339	3.7
CN0900900000000	09	009	New Haven County, CT	2006	NA	437427	416565	20862	4.8
CN0901100000000	09	011	New London County, CT	2006	NA	145569	139598	5971	4.1
CN0901300000000	09	013	Tolland County, CT	2006	NA	82675	79562	3113	3.8
CN0901500000000	09	015	Windham County, CT	2006	NA	62458	59229	3229	5.2
CN1000100000000	10	001	Kent County, DE	2006	NA	74093	71705	2388	3.2
CN1000300000000	10	003	New Castle County, DE	2006	NA	274789	264399	10390	3.8
CN1000500000000	10	005	Sussex County, DE	2006	NA	92302	89295	3007	3.3
CN1100100000000	11	001	District of Columbia	2006	NA	316083	297786	18297	5.8
CN1200100000000	12	001	Alachua County, FL	2006	NA	125843	122471	3372	2.7
CN1200300000000	12	003	Baker County, FL	2006	NA	11548	11219	329	2.8
CN1200500000000	12	005	Bay County, FL	2006	NA	85748	83077	2671	3.1
CN1200700000000	12	007	Bradford County, FL	2006	NA	12191	11843	348	2.9
CN1200900000000	12	009	Brevard County, FL	2006	NA	265618	256936	8682	3.3
CN1201100000000	12	011	Broward County, FL	2006	NA	983211	952640	30571	3.1
CN1201300000000	12	013	Calhoun County, FL	2006	NA	5386	5216	170	3.2
CN1201500000000	12	015	Charlotte County, FL	2006	NA	69533	67201	2332	3.4
CN1201700000000	12	017	Citrus County, FL	2006	NA	54552	52465	2087	3.8
CN1201900000000	12	019	Clay County, FL	2006	NA	91630	88878	2752	3
CN1202100000000	12	021	Collier County, FL	2006	NA	152464	147706	4758	3.1
CN1202300000000	12	023	Columbia County, FL	2006	NA	29805	28844	961	3.2
CN1202700000000	12	027	DeSoto County, FL	2006	NA	14209	13691	518	3.6
CN1202900000000	12	029	Dixie County, FL	2006	NA	5698	5499	199	3.5
CN1203100000000	12	031	Duval County, FL	2006	NA	432151	416893	15258	3.5
CN1203300000000	12	033	Escambia County, FL	2006	NA	138216	133846	4370	3.2
CN1203500000000	12	035	Flagler County, FL	2006	NA	30723	29335	1388	4.5
CN1203700000000	12	037	Franklin County, FL	2006	NA	5054	4903	151	3
CN1203900000000	12	039	Gadsden County, FL	2006	NA	21029	20303	726	3.5
CN1204100000000	12	041	Gilchrist County, FL	2006	NA	7728	7505	223	2.9
CN1204300000000	12	043	Glades County, FL	2006	NA	4691	4509	182	3.9
CN1204500000000	12	045	Gulf County, FL	2006	NA	6419	6221	198	3.1
CN1204700000000	12	047	Hamilton County, FL	2006	NA	4641	4463	178	3.8
CN1204900000000	12	049	Hardee County, FL	2006	NA	11982	11506	476	4
CN1205100000000	12	051	Hendry County, FL	2006	NA	17698	16578	1120	6.3
CN1205300000000	12	053	Hernando County, FL	2006	NA	59884	57191	2693	4.5
CN1205500000000	12	055	Highlands County, FL	2006	NA	40797	39270	1527	3.7
CN1205700000000	12	057	Hillsborough County, FL	2006	NA	585548	566146	19402	3.3
CN1205900000000	12	059	Holmes County, FL	2006	NA	8625	8362	263	3
CN1206100000000	12	061	Indian River County, FL	2006	NA	61703	59163	2540	4.1
CN1206300000000	12	063	Jackson County, FL	2006	NA	21288	20527	761	3.6
CN1206500000000	12	065	Jefferson County, FL	2006	NA	7066	6863	203	2.9
CN1206700000000	12	067	Lafayette County, FL	2006	NA	2850	2771	79	2.8
CN1206900000000	12	069	Lake County, FL	2006	NA	126341	122105	4236	3.4
CN1207100000000	12	071	Lee County, FL	2006	NA	287157	278772	8385	2.9
CN1207300000000	12	073	Leon County, FL	2006	NA	140574	136722	3852	2.7
CN1207500000000	12	075	Levy County, FL	2006	NA	16500	15917	583	3.5
CN1207700000000	12	077	Liberty County, FL	2006	NA	3537	3444	93	2.6
CN1207900000000	12	079	Madison County, FL	2006	NA	7339	6960	379	5.2
CN1208100000000	12	081	Manatee County, FL	2006	NA	149208	144644	4564	3.1
CN1208300000000	12	083	Marion County, FL	2006	NA	134179	129573	4606	3.4
CN1208500000000	12	085	Martin County, FL	2006	NA	65247	62964	2283	3.5
CN1208600000000	12	086	Miami-Dade County, FL	2006	NA	1192179	1159006	33173	2.8
CN1208700000000	12	087	Monroe County, FL	2006	NA	44497	43396	1101	2.5
CN1208900000000	12	089	Nassau County, FL	2006	NA	34093	33111	982	2.9
CN1209100000000	12	091	Okaloosa County, FL	2006	NA	98731	96352	2379	2.4
CN1209300000000	12	093	Okeechobee County, FL	2006	NA	17473	16748	725	4.1
CN1209500000000	12	095	Orange County, FL	2006	NA	575327	557220	18107	3.1
CN1209700000000	12	097	Osceola County, FL	2006	NA	124996	120750	4246	3.4
CN1209900000000	12	099	Palm Beach County, FL	2006	NA	619269	596415	22854	3.7
CN1210100000000	12	101	Pasco County, FL	2006	NA	187047	179799	7248	3.9
CN1210300000000	12	103	Pinellas County, FL	2006	NA	453148	437883	15265	3.4
CN1210500000000	12	105	Polk County, FL	2006	NA	264259	254605	9654	3.7
CN1210700000000	12	107	Putnam County, FL	2006	NA	31781	30597	1184	3.7
CN1210900000000	12	109	St. Johns County, FL	2006	NA	88575	86169	2406	2.7
CN1211100000000	12	111	St. Lucie County, FL	2006	NA	119477	114472	5005	4.2
CN1211300000000	12	113	Santa Rosa County, FL	2006	NA	69789	67688	2101	3
CN1211500000000	12	115	Sarasota County, FL	2006	NA	172810	167383	5427	3.1
CN1211700000000	12	117	Seminole County, FL	2006	NA	234285	227390	6895	2.9
CN1211900000000	12	119	Sumter County, FL	2006	NA	29768	28936	832	2.8
CN1212100000000	12	121	Suwannee County, FL	2006	NA	16956	16405	551	3.2
CN1212300000000	12	123	Taylor County, FL	2006	NA	8755	8408	347	4
CN1212500000000	12	125	Union County, FL	2006	NA	5122	4987	135	2.6
CN1212700000000	12	127	Volusia County, FL	2006	NA	250088	241875	8213	3.3
CN1212900000000	12	129	Wakulla County, FL	2006	NA	15450	15067	383	2.5
CN1213100000000	12	131	Walton County, FL	2006	NA	31122	30441	681	2.2
CN1213300000000	12	133	Washington County, FL	2006	NA	9598	9279	319	3.3
CN1300100000000	13	001	Appling County, GA	2006	NA	8834	8344	490	5.5
CN1300300000000	13	003	Atkinson County, GA	2006	NA	3376	3195	181	5.4
CN1300500000000	13	005	Bacon County, GA	2006	NA	4789	4570	219	4.6
CN1300700000000	13	007	Baker County, GA	2006	NA	1781	1691	90	5.1
CN1300900000000	13	009	Baldwin County, GA	2006	NA	20941	19804	1137	5.4
CN1301100000000	13	011	Banks County, GA	2006	NA	9592	9283	309	3.2
CN1301300000000	13	013	Barrow County, GA	2006	NA	32009	30653	1356	4.2
CN1301500000000	13	015	Bartow County, GA	2006	NA	44896	42696	2200	4.9
CN1301700000000	13	017	Ben Hill County, GA	2006	NA	8237	7770	467	5.7
CN1301900000000	13	019	Berrien County, GA	2006	NA	8936	8566	370	4.1
CN1302100000000	13	021	Bibb County, GA	2006	NA	73392	69204	4188	5.7
CN1302300000000	13	023	Bleckley County, GA	2006	NA	5153	4851	302	5.9
CN1302500000000	13	025	Brantley County, GA	2006	NA	7650	7291	359	4.7
CN1302700000000	13	027	Brooks County, GA	2006	NA	8525	8174	351	4.1
CN1302900000000	13	029	Bryan County, GA	2006	NA	16108	15539	569	3.5
CN1303100000000	13	031	Bulloch County, GA	2006	NA	31426	30076	1350	4.3
CN1303300000000	13	033	Burke County, GA	2006	NA	9863	9201	662	6.7
CN1303500000000	13	035	Butts County, GA	2006	NA	10047	9506	541	5.4
CN1303700000000	13	037	Calhoun County, GA	2006	NA	2427	2282	145	6
CN1303900000000	13	039	Camden County, GA	2006	NA	20884	20024	860	4.1
CN1304300000000	13	043	Candler County, GA	2006	NA	4595	4401	194	4.2
CN1304500000000	13	045	Carroll County, GA	2006	NA	50874	48381	2493	4.9
CN1304700000000	13	047	Catoosa County, GA	2006	NA	36037	34649	1388	3.9
CN1304900000000	13	049	Charlton County, GA	2006	NA	4574	4365	209	4.6
CN1305100000000	13	051	Chatham County, GA	2006	NA	127947	122727	5220	4.1
CN1305300000000	13	053	Chattahoochee County, GA	2006	NA	2508	2264	244	9.7
CN1305500000000	13	055	Chattooga County, GA	2006	NA	10866	10323	543	5
CN1305700000000	13	057	Cherokee County, GA	2006	NA	104485	100633	3852	3.7
CN1305900000000	13	059	Clarke County, GA	2006	NA	62595	59905	2690	4.3
CN1306100000000	13	061	Clay County, GA	2006	NA	1547	1480	67	4.3
CN1306300000000	13	063	Clayton County, GA	2006	NA	135385	127426	7959	5.9
CN1306500000000	13	065	Clinch County, GA	2006	NA	2778	2640	138	5
CN1306700000000	13	067	Cobb County, GA	2006	NA	372993	357118	15875	4.3
CN1306900000000	13	069	Coffee County, GA	2006	NA	16837	15937	900	5.3
CN1307100000000	13	071	Colquitt County, GA	2006	NA	20614	19740	874	4.2
CN1307300000000	13	073	Columbia County, GA	2006	NA	58260	55871	2389	4.1
CN1307500000000	13	075	Cook County, GA	2006	NA	7120	6740	380	5.3
CN1307700000000	13	077	Coweta County, GA	2006	NA	57736	55317	2419	4.2
CN1307900000000	13	079	Crawford County, GA	2006	NA	6243	5924	319	5.1
CN1308100000000	13	081	Crisp County, GA	2006	NA	10353	9751	602	5.8
CN1308300000000	13	083	Dade County, GA	2006	NA	8652	8291	361	4.2
CN1308500000000	13	085	Dawson County, GA	2006	NA	10634	10230	404	3.8
CN1308700000000	13	087	Decatur County, GA	2006	NA	12018	11330	688	5.7
CN1308900000000	13	089	DeKalb County, GA	2006	NA	386291	366471	19820	5.1
CN1309100000000	13	091	Dodge County, GA	2006	NA	9550	9079	471	4.9
CN1309300000000	13	093	Dooly County, GA	2006	NA	4861	4591	270	5.6
CN1309500000000	13	095	Dougherty County, GA	2006	NA	41454	38964	2490	6
CN1309700000000	13	097	Douglas County, GA	2006	NA	62225	59106	3119	5
CN1309900000000	13	099	Early County, GA	2006	NA	5691	5404	287	5
CN1310100000000	13	101	Echols County, GA	2006	NA	2370	2296	74	3.1
CN1310300000000	13	103	Effingham County, GA	2006	NA	27084	26165	919	3.4
CN1310500000000	13	105	Elbert County, GA	2006	NA	9987	9343	644	6.4
CN1310700000000	13	107	Emanuel County, GA	2006	NA	10802	10251	551	5.1
CN1310900000000	13	109	Evans County, GA	2006	NA	4930	4709	221	4.5
CN1311100000000	13	111	Fannin County, GA	2006	NA	10769	10338	431	4
CN1311300000000	13	113	Fayette County, GA	2006	NA	53673	51536	2137	4
CN1311500000000	13	115	Floyd County, GA	2006	NA	49315	47104	2211	4.5
CN1311700000000	13	117	Forsyth County, GA	2006	NA	79777	77107	2670	3.3
CN1311900000000	13	119	Franklin County, GA	2006	NA	10724	10183	541	5
CN1312100000000	13	121	Fulton County, GA	2006	NA	472127	448380	23747	5
CN1312300000000	13	123	Gilmer County, GA	2006	NA	14153	13641	512	3.6
CN1312500000000	13	125	Glascock County, GA	2006	NA	1216	1154	62	5.1
CN1312700000000	13	127	Glynn County, GA	2006	NA	39804	38239	1565	3.9
CN1312900000000	13	129	Gordon County, GA	2006	NA	27073	25891	1182	4.4
CN1313100000000	13	131	Grady County, GA	2006	NA	12265	11775	490	4
CN1313300000000	13	133	Greene County, GA	2006	NA	6953	6553	400	5.8
CN1313500000000	13	135	Gwinnett County, GA	2006	NA	409907	392746	17161	4.2
CN1313700000000	13	137	Habersham County, GA	2006	NA	19768	18974	794	4
CN1313900000000	13	139	Hall County, GA	2006	NA	86454	83160	3294	3.8
CN1314100000000	13	141	Hancock County, GA	2006	NA	3442	3149	293	8.5
CN1314300000000	13	143	Haralson County, GA	2006	NA	12782	12173	609	4.8
CN1314500000000	13	145	Harris County, GA	2006	NA	15709	15113	596	3.8
CN1314700000000	13	147	Hart County, GA	2006	NA	10943	10239	704	6.4
CN1314900000000	13	149	Heard County, GA	2006	NA	4913	4671	242	4.9
CN1315100000000	13	151	Henry County, GA	2006	NA	92567	88332	4235	4.6
CN1315300000000	13	153	Houston County, GA	2006	NA	66050	63249	2801	4.2
CN1315500000000	13	155	Irwin County, GA	2006	NA	4723	4486	237	5
CN1315700000000	13	157	Jackson County, GA	2006	NA	26711	25615	1096	4.1
CN1315900000000	13	159	Jasper County, GA	2006	NA	6390	6085	305	4.8
CN1316100000000	13	161	Jeff Davis County, GA	2006	NA	5545	5149	396	7.1
CN1316300000000	13	163	Jefferson County, GA	2006	NA	7044	6591	453	6.4
CN1316500000000	13	165	Jenkins County, GA	2006	NA	3564	3369	195	5.5
CN1316700000000	13	167	Johnson County, GA	2006	NA	3781	3578	203	5.4
CN1316900000000	13	169	Jones County, GA	2006	NA	13869	13174	695	5
CN1317100000000	13	171	Lamar County, GA	2006	NA	7810	7370	440	5.6
CN1317300000000	13	173	Lanier County, GA	2006	NA	3974	3821	153	3.9
CN1317500000000	13	175	Laurens County, GA	2006	NA	22587	21404	1183	5.2
CN1317700000000	13	177	Lee County, GA	2006	NA	17251	16621	630	3.7
CN1317900000000	13	179	Liberty County, GA	2006	NA	23976	22585	1391	5.8
CN1318100000000	13	181	Lincoln County, GA	2006	NA	3805	3572	233	6.1
CN1318300000000	13	183	Long County, GA	2006	NA	5717	5491	226	4
CN1318500000000	13	185	Lowndes County, GA	2006	NA	52048	50030	2018	3.9
CN1318700000000	13	187	Lumpkin County, GA	2006	NA	12752	12224	528	4.1
CN1318900000000	13	189	McDuffie County, GA	2006	NA	10649	9986	663	6.2
CN1319100000000	13	191	McIntosh County, GA	2006	NA	5283	5054	229	4.3
CN1319300000000	13	193	Macon County, GA	2006	NA	5282	4874	408	7.7
CN1319500000000	13	195	Madison County, GA	2006	NA	15399	14826	573	3.7
CN1319700000000	13	197	Marion County, GA	2006	NA	3385	3232	153	4.5
CN1319900000000	13	199	Meriwether County, GA	2006	NA	9644	9025	619	6.4
CN1320100000000	13	201	Miller County, GA	2006	NA	3705	3571	134	3.6
CN1320500000000	13	205	Mitchell County, GA	2006	NA	10465	9950	515	4.9
CN1320700000000	13	207	Monroe County, GA	2006	NA	13069	12481	588	4.5
CN1320900000000	13	209	Montgomery County, GA	2006	NA	4508	4275	233	5.2
CN1321100000000	13	211	Morgan County, GA	2006	NA	9397	8989	408	4.3
CN1321300000000	13	213	Murray County, GA	2006	NA	21441	20512	929	4.3
CN1321500000000	13	215	Muscogee County, GA	2006	NA	85344	80659	4685	5.5
CN1321700000000	13	217	Newton County, GA	2006	NA	44063	41716	2347	5.3
CN1321900000000	13	219	Oconee County, GA	2006	NA	17395	16843	552	3.2
CN1322100000000	13	221	Oglethorpe County, GA	2006	NA	7575	7292	283	3.7
CN1322300000000	13	223	Paulding County, GA	2006	NA	62499	59899	2600	4.2
CN1322500000000	13	225	Peach County, GA	2006	NA	11513	10842	671	5.8
CN1322700000000	13	227	Pickens County, GA	2006	NA	14657	14115	542	3.7
CN1322900000000	13	229	Pierce County, GA	2006	NA	8356	8006	350	4.2
CN1323100000000	13	231	Pike County, GA	2006	NA	7879	7521	358	4.5
CN1323300000000	13	233	Polk County, GA	2006	NA	20715	19805	910	4.4
CN1323500000000	13	235	Pulaski County, GA	2006	NA	4630	4421	209	4.5
CN1323700000000	13	237	Putnam County, GA	2006	NA	10374	9903	471	4.5
CN1323900000000	13	239	Quitman County, GA	2006	NA	1000	949	51	5.1
CN1324100000000	13	241	Rabun County, GA	2006	NA	7521	7105	416	5.5
CN1324300000000	13	243	Randolph County, GA	2006	NA	2873	2688	185	6.4
CN1324500000000	13	245	Richmond County, GA	2006	NA	88769	83164	5605	6.3
CN1324700000000	13	247	Rockdale County, GA	2006	NA	39376	37383	1993	5.1
CN1324900000000	13	249	Schley County, GA	2006	NA	1864	1759	105	5.6
CN1325100000000	13	251	Screven County, GA	2006	NA	7190	6842	348	4.8
CN1325300000000	13	253	Seminole County, GA	2006	NA	4005	3799	206	5.1
CN1325500000000	13	255	Spalding County, GA	2006	NA	28067	26286	1781	6.3
CN1325700000000	13	257	Stephens County, GA	2006	NA	13379	12714	665	5
CN1325900000000	13	259	Stewart County, GA	2006	NA	1979	1848	131	6.6
CN1326100000000	13	261	Sumter County, GA	2006	NA	14752	13844	908	6.2
CN1326300000000	13	263	Talbot County, GA	2006	NA	3078	2885	193	6.3
CN1326500000000	13	265	Taliaferro County, GA	2006	NA	783	728	55	7
CN1326700000000	13	267	Tattnall County, GA	2006	NA	9075	8592	483	5.3
CN1326900000000	13	269	Taylor County, GA	2006	NA	3337	3127	210	6.3
CN1327100000000	13	271	Telfair County, GA	2006	NA	5041	4658	383	7.6
CN1327300000000	13	273	Terrell County, GA	2006	NA	4554	4292	262	5.8
CN1327500000000	13	275	Thomas County, GA	2006	NA	23513	22549	964	4.1
CN1327700000000	13	277	Tift County, GA	2006	NA	19957	18946	1011	5.1
CN1327900000000	13	279	Toombs County, GA	2006	NA	13478	12774	704	5.2
CN1328100000000	13	281	Towns County, GA	2006	NA	5930	5728	202	3.4
CN1328300000000	13	283	Treutlen County, GA	2006	NA	2690	2525	165	6.1
CN1328500000000	13	285	Troup County, GA	2006	NA	30352	28574	1778	5.9
CN1328700000000	13	287	Turner County, GA	2006	NA	5096	4803	293	5.7
CN1328900000000	13	289	Twiggs County, GA	2006	NA	4578	4313	265	5.8
CN1329100000000	13	291	Union County, GA	2006	NA	10744	10346	398	3.7
CN1329300000000	13	293	Upson County, GA	2006	NA	11794	11052	742	6.3
CN1329500000000	13	295	Walker County, GA	2006	NA	33701	32197	1504	4.5
CN1329700000000	13	297	Walton County, GA	2006	NA	39051	37273	1778	4.6
CN1329900000000	13	299	Ware County, GA	2006	NA	15072	14321	751	5
CN1330100000000	13	301	Warren County, GA	2006	NA	2466	2262	204	8.3
CN1330300000000	13	303	Washington County, GA	2006	NA	8430	7935	495	5.9
CN1330500000000	13	305	Wayne County, GA	2006	NA	11845	11170	675	5.7
CN1330700000000	13	307	Webster County, GA	2006	NA	1187	1134	53	4.5
CN1330900000000	13	309	Wheeler County, GA	2006	NA	3080	2909	171	5.6
CN1331100000000	13	311	White County, GA	2006	NA	12449	11981	468	3.8
CN1331300000000	13	313	Whitfield County, GA	2006	NA	46862	44793	2069	4.4
CN1331500000000	13	315	Wilcox County, GA	2006	NA	3284	3088	196	6
CN1331700000000	13	317	Wilkes County, GA	2006	NA	4710	4421	289	6.1
CN1331900000000	13	319	Wilkinson County, GA	2006	NA	4570	4308	262	5.7
CN1332100000000	13	321	Worth County, GA	2006	NA	10384	9856	528	5.1
CN1500100000000	15	001	Hawaii County, HI	2006	NA	83833	81216	2617	3.1
CN1500300000000	15	003	Honolulu County/city, HI	2006	NA	444788	433478	11310	2.5
CN1500700000000	15	007	Kauai County, HI	2006	NA	32471	31637	834	2.6
CN1500900000000	15	009	Maui County, HI	2006	NA	77170	75243	1927	2.5
CN1600100000000	16	001	Ada County, ID	2006	NA	193828	188617	5211	2.7
CN1600300000000	16	003	Adams County, ID	2006	NA	2159	2013	146	6.8
CN1600500000000	16	005	Bannock County, ID	2006	NA	40451	39057	1394	3.4
CN1600700000000	16	007	Bear Lake County, ID	2006	NA	3050	2961	89	2.9
CN1600900000000	16	009	Benewah County, ID	2006	NA	3957	3648	309	7.8
CN1601100000000	16	011	Bingham County, ID	2006	NA	21109	20328	781	3.7
CN1601300000000	16	013	Blaine County, ID	2006	NA	14167	13785	382	2.7
CN1601500000000	16	015	Boise County, ID	2006	NA	3708	3571	137	3.7
CN1601700000000	16	017	Bonner County, ID	2006	NA	20547	19581	966	4.7
CN1601900000000	16	019	Bonneville County, ID	2006	NA	49797	48466	1331	2.7
CN1602100000000	16	021	Boundary County, ID	2006	NA	4234	3911	323	7.6
CN1602300000000	16	023	Butte County, ID	2006	NA	1430	1383	47	3.3
CN1602500000000	16	025	Camas County, ID	2006	NA	637	615	22	3.5
CN1602700000000	16	027	Canyon County, ID	2006	NA	82571	79351	3220	3.9
CN1602900000000	16	029	Caribou County, ID	2006	NA	3344	3209	135	4
CN1603100000000	16	031	Cassia County, ID	2006	NA	10449	10019	430	4.1
CN1603300000000	16	033	Clark County, ID	2006	NA	527	506	21	4
CN1603500000000	16	035	Clearwater County, ID	2006	NA	3318	3040	278	8.4
CN1603700000000	16	037	Custer County, ID	2006	NA	2537	2430	107	4.2
CN1603900000000	16	039	Elmore County, ID	2006	NA	10931	10476	455	4.2
CN1604100000000	16	041	Franklin County, ID	2006	NA	6258	6104	154	2.5
CN1604300000000	16	043	Fremont County, ID	2006	NA	6029	5802	227	3.8
CN1604500000000	16	045	Gem County, ID	2006	NA	7334	7018	316	4.3
CN1604700000000	16	047	Gooding County, ID	2006	NA	8524	8280	244	2.9
CN1604900000000	16	049	Idaho County, ID	2006	NA	7122	6678	444	6.2
CN1605100000000	16	051	Jefferson County, ID	2006	NA	11006	10671	335	3
CN1605300000000	16	053	Jerome County, ID	2006	NA	10203	9867	336	3.3
CN1605500000000	16	055	Kootenai County, ID	2006	NA	68675	66048	2627	3.8
CN1605700000000	16	057	Latah County, ID	2006	NA	17598	17063	535	3
CN1605900000000	16	059	Lemhi County, ID	2006	NA	4006	3795	211	5.3
CN1606100000000	16	061	Lewis County, ID	2006	NA	1732	1684	48	2.8
CN1606300000000	16	063	Lincoln County, ID	2006	NA	2577	2460	117	4.5
CN1606500000000	16	065	Madison County, ID	2006	NA	14877	14484	393	2.6
CN1606700000000	16	067	Minidoka County, ID	2006	NA	9809	9315	494	5
CN1606900000000	16	069	Nez Perce County, ID	2006	NA	19025	18347	678	3.6
CN1607100000000	16	071	Oneida County, ID	2006	NA	2231	2188	43	1.9
CN1607300000000	16	073	Owyhee County, ID	2006	NA	4720	4621	99	2.1
CN1607500000000	16	075	Payette County, ID	2006	NA	10391	9869	522	5
CN1607700000000	16	077	Power County, ID	2006	NA	3873	3685	188	4.9
CN1607900000000	16	079	Shoshone County, ID	2006	NA	5630	5224	406	7.2
CN1608100000000	16	081	Teton County, ID	2006	NA	4737	4641	96	2
CN1608300000000	16	083	Twin Falls County, ID	2006	NA	38341	37045	1296	3.4
CN1608500000000	16	085	Valley County, ID	2006	NA	4978	4761	217	4.4
CN1608700000000	16	087	Washington County, ID	2006	NA	4952	4729	223	4.5
CN1700100000000	17	001	Adams County, IL	2006	NA	39326	38001	1325	3.4
CN1700300000000	17	003	Alexander County, IL	2006	NA	3297	3033	264	8
CN1700500000000	17	005	Bond County, IL	2006	NA	8639	8221	418	4.8
CN1700700000000	17	007	Boone County, IL	2006	NA	25735	24314	1421	5.5
CN1700900000000	17	009	Brown County, IL	2006	NA	3372	3272	100	3
CN1701100000000	17	011	Bureau County, IL	2006	NA	19043	18215	828	4.3
CN1701300000000	17	013	Calhoun County, IL	2006	NA	2622	2465	157	6
CN1701500000000	17	015	Carroll County, IL	2006	NA	8586	8176	410	4.8
CN1701700000000	17	017	Cass County, IL	2006	NA	7644	7333	311	4.1
CN1701900000000	17	019	Champaign County, IL	2006	NA	102819	99078	3741	3.6
CN1702100000000	17	021	Christian County, IL	2006	NA	17576	16752	824	4.7
CN1702300000000	17	023	Clark County, IL	2006	NA	8913	8485	428	4.8
CN1702500000000	17	025	Clay County, IL	2006	NA	6977	6631	346	5
CN1702700000000	17	027	Clinton County, IL	2006	NA	19220	18378	842	4.4
CN1702900000000	17	029	Coles County, IL	2006	NA	27241	26130	1111	4.1
CN1703100000000	17	031	Cook County, IL	2006	NA	2566657	2441887	124770	4.9
CN1703300000000	17	033	Crawford County, IL	2006	NA	9624	9136	488	5.1
CN1703500000000	17	035	Cumberland County, IL	2006	NA	5721	5470	251	4.4
CN1703700000000	17	037	DeKalb County, IL	2006	NA	55695	53663	2032	3.6
CN1703900000000	17	039	De Witt County, IL	2006	NA	8364	8007	357	4.3
CN1704100000000	17	041	Douglas County, IL	2006	NA	10302	9886	416	4
CN1704300000000	17	043	DuPage County, IL	2006	NA	521776	503616	18160	3.5
CN1704500000000	17	045	Edgar County, IL	2006	NA	10515	10021	494	4.7
CN1704700000000	17	047	Edwards County, IL	2006	NA	3435	3291	144	4.2
CN1704900000000	17	049	Effingham County, IL	2006	NA	18355	17615	740	4
CN1705100000000	17	051	Fayette County, IL	2006	NA	10202	9632	570	5.6
CN1705300000000	17	053	Ford County, IL	2006	NA	7381	7063	318	4.3
CN1705500000000	17	055	Franklin County, IL	2006	NA	17923	16747	1176	6.6
CN1705700000000	17	057	Fulton County, IL	2006	NA	17820	16918	902	5.1
CN1705900000000	17	059	Gallatin County, IL	2006	NA	2662	2515	147	5.5
CN1706100000000	17	061	Greene County, IL	2006	NA	7424	7090	334	4.5
CN1706300000000	17	063	Grundy County, IL	2006	NA	24510	23243	1267	5.2
CN1706500000000	17	065	Hamilton County, IL	2006	NA	4255	4028	227	5.3
CN1706700000000	17	067	Hancock County, IL	2006	NA	9888	9431	457	4.6
CN1706900000000	17	069	Hardin County, IL	2006	NA	1756	1628	128	7.3
CN1707100000000	17	071	Henderson County, IL	2006	NA	4090	3876	214	5.2
CN1707300000000	17	073	Henry County, IL	2006	NA	27646	26507	1139	4.1
CN1707500000000	17	075	Iroquois County, IL	2006	NA	16452	15723	729	4.4
CN1707700000000	17	077	Jackson County, IL	2006	NA	32813	31515	1298	4
CN1707900000000	17	079	Jasper County, IL	2006	NA	5077	4830	247	4.9
CN1708100000000	17	081	Jefferson County, IL	2006	NA	21036	20069	967	4.6
CN1708300000000	17	083	Jersey County, IL	2006	NA	11774	11216	558	4.7
CN1708500000000	17	085	Jo Daviess County, IL	2006	NA	13514	13005	509	3.8
CN1708700000000	17	087	Johnson County, IL	2006	NA	5249	4977	272	5.2
CN1708900000000	17	089	Kane County, IL	2006	NA	259217	248918	10299	4
CN1709100000000	17	091	Kankakee County, IL	2006	NA	54299	51295	3004	5.5
CN1709300000000	17	093	Kendall County, IL	2006	NA	49722	47797	1925	3.9
CN1709500000000	17	095	Knox County, IL	2006	NA	25580	24253	1327	5.2
CN1709700000000	17	097	Lake County, IL	2006	NA	365625	350304	15321	4.2
CN1709900000000	17	099	LaSalle County, IL	2006	NA	57613	54572	3041	5.3
CN1710100000000	17	101	Lawrence County, IL	2006	NA	8421	8021	400	4.8
CN1710300000000	17	103	Lee County, IL	2006	NA	18524	17717	807	4.4
CN1710500000000	17	105	Livingston County, IL	2006	NA	18872	18098	774	4.1
CN1710700000000	17	107	Logan County, IL	2006	NA	13372	12762	610	4.6
CN1710900000000	17	109	McDonough County, IL	2006	NA	17275	16584	691	4
CN1711100000000	17	111	McHenry County, IL	2006	NA	173192	166580	6612	3.8
CN1711300000000	17	113	McLean County, IL	2006	NA	88820	85830	2990	3.4
CN1711500000000	17	115	Macon County, IL	2006	NA	53750	50935	2815	5.2
CN1711700000000	17	117	Macoupin County, IL	2006	NA	24718	23447	1271	5.1
CN1711900000000	17	119	Madison County, IL	2006	NA	138025	131298	6727	4.9
CN1712100000000	17	121	Marion County, IL	2006	NA	18557	17496	1061	5.7
CN1712300000000	17	123	Marshall County, IL	2006	NA	7243	6966	277	3.8
CN1712500000000	17	125	Mason County, IL	2006	NA	7466	7039	427	5.7
CN1712700000000	17	127	Massac County, IL	2006	NA	7460	7066	394	5.3
CN1712900000000	17	129	Menard County, IL	2006	NA	6969	6695	274	3.9
CN1713100000000	17	131	Mercer County, IL	2006	NA	9020	8544	476	5.3
CN1713300000000	17	133	Monroe County, IL	2006	NA	18091	17400	691	3.8
CN1713500000000	17	135	Montgomery County, IL	2006	NA	13594	12773	821	6
CN1713700000000	17	137	Morgan County, IL	2006	NA	17737	16895	842	4.7
CN1713900000000	17	139	Moultrie County, IL	2006	NA	8174	7893	281	3.4
CN1714100000000	17	141	Ogle County, IL	2006	NA	27336	25991	1345	4.9
CN1714300000000	17	143	Peoria County, IL	2006	NA	95139	91183	3956	4.2
CN1714500000000	17	145	Perry County, IL	2006	NA	10247	9565	682	6.7
CN1714700000000	17	147	Piatt County, IL	2006	NA	9249	8915	334	3.6
CN1714900000000	17	149	Pike County, IL	2006	NA	8731	8361	370	4.2
CN1715100000000	17	151	Pope County, IL	2006	NA	1953	1831	122	6.2
CN1715300000000	17	153	Pulaski County, IL	2006	NA	2928	2733	195	6.7
CN1715500000000	17	155	Putnam County, IL	2006	NA	3125	2970	155	5
CN1715700000000	17	157	Randolph County, IL	2006	NA	15409	14696	713	4.6
CN1715900000000	17	159	Richland County, IL	2006	NA	7662	7315	347	4.5
CN1716100000000	17	161	Rock Island County, IL	2006	NA	79227	75841	3386	4.3
CN1716300000000	17	163	St. Clair County, IL	2006	NA	123965	116861	7104	5.7
CN1716500000000	17	165	Saline County, IL	2006	NA	12446	11784	662	5.3
CN1716700000000	17	167	Sangamon County, IL	2006	NA	106674	102268	4406	4.1
CN1716900000000	17	169	Schuyler County, IL	2006	NA	4447	4271	176	4
CN1717100000000	17	171	Scott County, IL	2006	NA	2789	2645	144	5.2
CN1717300000000	17	173	Shelby County, IL	2006	NA	11163	10651	512	4.6
CN1717500000000	17	175	Stark County, IL	2006	NA	2947	2812	135	4.6
CN1717700000000	17	177	Stephenson County, IL	2006	NA	25422	24226	1196	4.7
CN1717900000000	17	179	Tazewell County, IL	2006	NA	71492	68815	2677	3.7
CN1718100000000	17	181	Union County, IL	2006	NA	8485	7990	495	5.8
CN1718300000000	17	183	Vermilion County, IL	2006	NA	37720	35619	2101	5.6
CN1718500000000	17	185	Wabash County, IL	2006	NA	6678	6373	305	4.6
CN1718700000000	17	187	Warren County, IL	2006	NA	9047	8642	405	4.5
CN1718900000000	17	189	Washington County, IL	2006	NA	8495	8174	321	3.8
CN1719100000000	17	191	Wayne County, IL	2006	NA	8221	7875	346	4.2
CN1719300000000	17	193	White County, IL	2006	NA	8001	7632	369	4.6
CN1719500000000	17	195	Whiteside County, IL	2006	NA	30395	28843	1552	5.1
CN1719700000000	17	197	Will County, IL	2006	NA	351244	336149	15095	4.3
CN1719900000000	17	199	Williamson County, IL	2006	NA	35563	33916	1647	4.6
CN1720100000000	17	201	Winnebago County, IL	2006	NA	144868	137319	7549	5.2
CN1720300000000	17	203	Woodford County, IL	2006	NA	20953	20312	641	3.1
CN1800100000000	18	001	Adams County, IN	2006	NA	16223	15512	711	4.4
CN1800300000000	18	003	Allen County, IN	2006	NA	182227	173072	9155	5
CN1800500000000	18	005	Bartholomew County, IN	2006	NA	38176	36566	1610	4.2
CN1800700000000	18	007	Benton County, IN	2006	NA	4612	4383	229	5
CN1800900000000	18	009	Blackford County, IN	2006	NA	6717	6277	440	6.6
CN1801100000000	18	011	Boone County, IN	2006	NA	28042	26994	1048	3.7
CN1801300000000	18	013	Brown County, IN	2006	NA	7957	7565	392	4.9
CN1801500000000	18	015	Carroll County, IN	2006	NA	10559	10063	496	4.7
CN1801700000000	18	017	Cass County, IN	2006	NA	18917	17888	1029	5.4
CN1801900000000	18	019	Clark County, IN	2006	NA	54998	52255	2743	5
CN1802100000000	18	021	Clay County, IN	2006	NA	13167	12419	748	5.7
CN1802300000000	18	023	Clinton County, IN	2006	NA	16998	16139	859	5.1
CN1802500000000	18	025	Crawford County, IN	2006	NA	5307	4928	379	7.1
CN1802700000000	18	027	Daviess County, IN	2006	NA	15096	14549	547	3.6
CN1802900000000	18	029	Dearborn County, IN	2006	NA	26478	25053	1425	5.4
CN1803100000000	18	031	Decatur County, IN	2006	NA	12505	11959	546	4.4
CN1803300000000	18	033	DeKalb County, IN	2006	NA	21504	20190	1314	6.1
CN1803500000000	18	035	Delaware County, IN	2006	NA	56847	53442	3405	6
CN1803700000000	18	037	Dubois County, IN	2006	NA	22377	21567	810	3.6
CN1803900000000	18	039	Elkhart County, IN	2006	NA	104165	99257	4908	4.7
CN1804100000000	18	041	Fayette County, IN	2006	NA	10829	9961	868	8
CN1804300000000	18	043	Floyd County, IN	2006	NA	38179	36298	1881	4.9
CN1804500000000	18	045	Fountain County, IN	2006	NA	8750	8326	424	4.8
CN1804700000000	18	047	Franklin County, IN	2006	NA	12051	11347	704	5.8
CN1804900000000	18	049	Fulton County, IN	2006	NA	10467	9906	561	5.4
CN1805100000000	18	051	Gibson County, IN	2006	NA	17282	16501	781	4.5
CN1805300000000	18	053	Grant County, IN	2006	NA	32880	30550	2330	7.1
CN1805500000000	18	055	Greene County, IN	2006	NA	16639	15692	947	5.7
CN1805700000000	18	057	Hamilton County, IN	2006	NA	137011	132532	4479	3.3
CN1805900000000	18	059	Hancock County, IN	2006	NA	35660	34202	1458	4.1
CN1806100000000	18	061	Harrison County, IN	2006	NA	19789	18716	1073	5.4
CN1806300000000	18	063	Hendricks County, IN	2006	NA	71703	69080	2623	3.7
CN1806500000000	18	065	Henry County, IN	2006	NA	22774	21443	1331	5.8
CN1806700000000	18	067	Howard County, IN	2006	NA	38857	36295	2562	6.6
CN1806900000000	18	069	Huntington County, IN	2006	NA	20601	19511	1090	5.3
CN1807100000000	18	071	Jackson County, IN	2006	NA	22152	21178	974	4.4
CN1807300000000	18	073	Jasper County, IN	2006	NA	15485	14696	789	5.1
CN1807500000000	18	075	Jay County, IN	2006	NA	11759	11226	533	4.5
CN1807700000000	18	077	Jefferson County, IN	2006	NA	17371	16521	850	4.9
CN1807900000000	18	079	Jennings County, IN	2006	NA	13828	13020	808	5.8
CN1808100000000	18	081	Johnson County, IN	2006	NA	72913	70068	2845	3.9
CN1808300000000	18	083	Knox County, IN	2006	NA	19427	18502	925	4.8
CN1808500000000	18	085	Kosciusko County, IN	2006	NA	41891	39840	2051	4.9
CN1808700000000	18	087	LaGrange County, IN	2006	NA	17512	16604	908	5.2
CN1808900000000	18	089	Lake County, IN	2006	NA	227320	214057	13263	5.8
CN1809100000000	18	091	LaPorte County, IN	2006	NA	53223	50165	3058	5.7
CN1809300000000	18	093	Lawrence County, IN	2006	NA	22817	21225	1592	7
CN1809500000000	18	095	Madison County, IN	2006	NA	62274	58472	3802	6.1
CN1809700000000	18	097	Marion County, IN	2006	NA	461468	438492	22976	5
CN1809900000000	18	099	Marshall County, IN	2006	NA	23038	21800	1238	5.4
CN1810100000000	18	101	Martin County, IN	2006	NA	5301	5041	260	4.9
CN1810300000000	18	103	Miami County, IN	2006	NA	17090	16025	1065	6.2
CN1810500000000	18	105	Monroe County, IN	2006	NA	67510	64605	2905	4.3
CN1810700000000	18	107	Montgomery County, IN	2006	NA	19721	18894	827	4.2
CN1810900000000	18	109	Morgan County, IN	2006	NA	37596	35886	1710	4.5
CN1811100000000	18	111	Newton County, IN	2006	NA	7046	6693	353	5
CN1811300000000	18	113	Noble County, IN	2006	NA	23628	22180	1448	6.1
CN1811500000000	18	115	Ohio County, IN	2006	NA	3107	2941	166	5.3
CN1811700000000	18	117	Orange County, IN	2006	NA	9591	8898	693	7.2
CN1811900000000	18	119	Owen County, IN	2006	NA	11701	11076	625	5.3
CN1812100000000	18	121	Parke County, IN	2006	NA	7939	7499	440	5.5
CN1812300000000	18	123	Perry County, IN	2006	NA	9757	9255	502	5.1
CN1812500000000	18	125	Pike County, IN	2006	NA	6174	5891	283	4.6
CN1812700000000	18	127	Porter County, IN	2006	NA	82837	79186	3651	4.4
CN1812900000000	18	129	Posey County, IN	2006	NA	13805	13196	609	4.4
CN1813100000000	18	131	Pulaski County, IN	2006	NA	6865	6548	317	4.6
CN1813300000000	18	133	Putnam County, IN	2006	NA	17716	16754	962	5.4
CN1813500000000	18	135	Randolph County, IN	2006	NA	12897	12009	888	6.9
CN1813700000000	18	137	Ripley County, IN	2006	NA	14405	13710	695	4.8
CN1813900000000	18	139	Rush County, IN	2006	NA	9502	9072	430	4.5
CN1814100000000	18	141	St. Joseph County, IN	2006	NA	134792	127805	6987	5.2
CN1814300000000	18	143	Scott County, IN	2006	NA	11393	10652	741	6.5
CN1814500000000	18	145	Shelby County, IN	2006	NA	23906	22841	1065	4.5
CN1814700000000	18	147	Spencer County, IN	2006	NA	10632	10101	531	5
CN1814900000000	18	149	Starke County, IN	2006	NA	10586	9887	699	6.6
CN1815100000000	18	151	Steuben County, IN	2006	NA	16623	15562	1061	6.4
CN1815300000000	18	153	Sullivan County, IN	2006	NA	9131	8577	554	6.1
CN1815500000000	18	155	Switzerland County, IN	2006	NA	5678	5445	233	4.1
CN1815700000000	18	157	Tippecanoe County, IN	2006	NA	80461	77005	3456	4.3
CN1815900000000	18	159	Tipton County, IN	2006	NA	8025	7587	438	5.5
CN1816100000000	18	161	Union County, IN	2006	NA	3903	3687	216	5.5
CN1816300000000	18	163	Vanderburgh County, IN	2006	NA	91457	87051	4406	4.8
CN1816500000000	18	165	Vermillion County, IN	2006	NA	8157	7623	534	6.5
CN1816700000000	18	167	Vigo County, IN	2006	NA	50269	47050	3219	6.4
CN1816900000000	18	169	Wabash County, IN	2006	NA	17729	16743	986	5.6
CN1817100000000	18	171	Warren County, IN	2006	NA	4791	4597	194	4
CN1817300000000	18	173	Warrick County, IN	2006	NA	30960	29655	1305	4.2
CN1817500000000	18	175	Washington County, IN	2006	NA	14296	13407	889	6.2
CN1817700000000	18	177	Wayne County, IN	2006	NA	34186	32174	2012	5.9
CN1817900000000	18	179	Wells County, IN	2006	NA	15024	14368	656	4.4
CN1818100000000	18	181	White County, IN	2006	NA	12155	11544	611	5
CN1818300000000	18	183	Whitley County, IN	2006	NA	17956	17094	862	4.8
CN1900100000000	19	001	Adair County, IA	2006	NA	4431	4289	142	3.2
CN1900300000000	19	003	Adams County, IA	2006	NA	2060	1966	94	4.6
CN1900500000000	19	005	Allamakee County, IA	2006	NA	8182	7806	376	4.6
CN1900700000000	19	007	Appanoose County, IA	2006	NA	6351	6008	343	5.4
CN1900900000000	19	009	Audubon County, IA	2006	NA	3282	3151	131	4
CN1901100000000	19	011	Benton County, IA	2006	NA	14556	13978	578	4
CN1901300000000	19	013	Black Hawk County, IA	2006	NA	72210	69434	2776	3.8
CN1901500000000	19	015	Boone County, IA	2006	NA	15528	15073	455	2.9
CN1901700000000	19	017	Bremer County, IA	2006	NA	13942	13496	446	3.2
CN1901900000000	19	019	Buchanan County, IA	2006	NA	11264	10784	480	4.3
CN1902100000000	19	021	Buena Vista County, IA	2006	NA	10509	10165	344	3.3
CN1902300000000	19	023	Butler County, IA	2006	NA	8258	7920	338	4.1
CN1902500000000	19	025	Calhoun County, IA	2006	NA	5267	5089	178	3.4
CN1902700000000	19	027	Carroll County, IA	2006	NA	12422	12098	324	2.6
CN1902900000000	19	029	Cass County, IA	2006	NA	7650	7325	325	4.2
CN1903100000000	19	031	Cedar County, IA	2006	NA	10788	10439	349	3.2
CN1903300000000	19	033	Cerro Gordo County, IA	2006	NA	26133	25111	1022	3.9
CN1903500000000	19	035	Cherokee County, IA	2006	NA	6561	6288	273	4.2
CN1903700000000	19	037	Chickasaw County, IA	2006	NA	6461	6170	291	4.5
CN1903900000000	19	039	Clarke County, IA	2006	NA	4746	4552	194	4.1
CN1904100000000	19	041	Clay County, IA	2006	NA	9760	9436	324	3.3
CN1904300000000	19	043	Clayton County, IA	2006	NA	9689	9200	489	5
CN1904500000000	19	045	Clinton County, IA	2006	NA	27173	26108	1065	3.9
CN1904700000000	19	047	Crawford County, IA	2006	NA	9364	9077	287	3.1
CN1904900000000	19	049	Dallas County, IA	2006	NA	31214	30328	886	2.8
CN1905100000000	19	051	Davis County, IA	2006	NA	4141	3947	194	4.7
CN1905300000000	19	053	Decatur County, IA	2006	NA	4233	4062	171	4
CN1905500000000	19	055	Delaware County, IA	2006	NA	10732	10337	395	3.7
CN1905700000000	19	057	Des Moines County, IA	2006	NA	21068	20070	998	4.7
CN1905900000000	19	059	Dickinson County, IA	2006	NA	9979	9572	407	4.1
CN1906100000000	19	061	Dubuque County, IA	2006	NA	51906	49998	1908	3.7
CN1906300000000	19	063	Emmet County, IA	2006	NA	6043	5798	245	4.1
CN1906500000000	19	065	Fayette County, IA	2006	NA	11064	10561	503	4.5
CN1906700000000	19	067	Floyd County, IA	2006	NA	8801	8387	414	4.7
CN1906900000000	19	069	Franklin County, IA	2006	NA	5842	5617	225	3.9
CN1907100000000	19	071	Fremont County, IA	2006	NA	3963	3814	149	3.8
CN1907300000000	19	073	Greene County, IA	2006	NA	5060	4863	197	3.9
CN1907500000000	19	075	Grundy County, IA	2006	NA	6912	6701	211	3.1
CN1907700000000	19	077	Guthrie County, IA	2006	NA	6051	5828	223	3.7
CN1907900000000	19	079	Hamilton County, IA	2006	NA	8806	8492	314	3.6
CN1908100000000	19	081	Hancock County, IA	2006	NA	6130	5909	221	3.6
CN1908300000000	19	083	Hardin County, IA	2006	NA	9149	8807	342	3.7
CN1908500000000	19	085	Harrison County, IA	2006	NA	8063	7717	346	4.3
CN1908700000000	19	087	Henry County, IA	2006	NA	10599	10040	559	5.3
CN1908900000000	19	089	Howard County, IA	2006	NA	5322	5131	191	3.6
CN1909100000000	19	091	Humboldt County, IA	2006	NA	5185	5014	171	3.3
CN1909300000000	19	093	Ida County, IA	2006	NA	3968	3832	136	3.4
CN1909500000000	19	095	Iowa County, IA	2006	NA	8837	8514	323	3.7
CN1909700000000	19	097	Jackson County, IA	2006	NA	11256	10717	539	4.8
CN1909900000000	19	099	Jasper County, IA	2006	NA	18315	17376	939	5.1
CN1910100000000	19	101	Jefferson County, IA	2006	NA	8308	7958	350	4.2
CN1910300000000	19	103	Johnson County, IA	2006	NA	75601	73630	1971	2.6
CN1910500000000	19	105	Jones County, IA	2006	NA	10513	10107	406	3.9
CN1910700000000	19	107	Keokuk County, IA	2006	NA	5820	5585	235	4
CN1910900000000	19	109	Kossuth County, IA	2006	NA	9047	8752	295	3.3
CN1911100000000	19	111	Lee County, IA	2006	NA	17491	16406	1085	6.2
CN1911300000000	19	113	Linn County, IA	2006	NA	116249	112017	4232	3.6
CN1911500000000	19	115	Louisa County, IA	2006	NA	6432	6188	244	3.8
CN1911700000000	19	117	Lucas County, IA	2006	NA	4945	4741	204	4.1
CN1911900000000	19	119	Lyon County, IA	2006	NA	6666	6513	153	2.3
CN1912100000000	19	121	Madison County, IA	2006	NA	8400	8068	332	4
CN1912300000000	19	123	Mahaska County, IA	2006	NA	11829	11396	433	3.7
CN1912500000000	19	125	Marion County, IA	2006	NA	17894	17272	622	3.5
CN1912700000000	19	127	Marshall County, IA	2006	NA	20816	20041	775	3.7
CN1912900000000	19	129	Mills County, IA	2006	NA	8421	8104	317	3.8
CN1913100000000	19	131	Mitchell County, IA	2006	NA	5447	5263	184	3.4
CN1913300000000	19	133	Monona County, IA	2006	NA	4665	4411	254	5.4
CN1913500000000	19	135	Monroe County, IA	2006	NA	4212	4044	168	4
CN1913700000000	19	137	Montgomery County, IA	2006	NA	5838	5514	324	5.5
CN1913900000000	19	139	Muscatine County, IA	2006	NA	24051	23280	771	3.2
CN1914100000000	19	141	O'Brien County, IA	2006	NA	7730	7496	234	3
CN1914300000000	19	143	Osceola County, IA	2006	NA	3418	3300	118	3.5
CN1914500000000	19	145	Page County, IA	2006	NA	8361	8038	323	3.9
CN1914700000000	19	147	Palo Alto County, IA	2006	NA	5361	5188	173	3.2
CN1914900000000	19	149	Plymouth County, IA	2006	NA	14410	13958	452	3.1
CN1915100000000	19	151	Pocahontas County, IA	2006	NA	4101	3976	125	3
CN1915300000000	19	153	Polk County, IA	2006	NA	233878	225888	7990	3.4
CN1915500000000	19	155	Pottawattamie County, IA	2006	NA	49273	47098	2175	4.4
CN1915700000000	19	157	Poweshiek County, IA	2006	NA	10627	10221	406	3.8
CN1915900000000	19	159	Ringgold County, IA	2006	NA	2472	2373	99	4
CN1916100000000	19	161	Sac County, IA	2006	NA	5883	5687	196	3.3
CN1916300000000	19	163	Scott County, IA	2006	NA	88926	85553	3373	3.8
CN1916500000000	19	165	Shelby County, IA	2006	NA	7417	7183	234	3.2
CN1916700000000	19	167	Sioux County, IA	2006	NA	19336	18863	473	2.4
CN1916900000000	19	169	Story County, IA	2006	NA	47827	46579	1248	2.6
CN1917100000000	19	171	Tama County, IA	2006	NA	8966	8590	376	4.2
CN1917300000000	19	173	Taylor County, IA	2006	NA	3397	3265	132	3.9
CN1917500000000	19	175	Union County, IA	2006	NA	6477	6214	263	4.1
CN1917700000000	19	177	Van Buren County, IA	2006	NA	3925	3757	168	4.3
CN1917900000000	19	179	Wapello County, IA	2006	NA	18807	17961	846	4.5
CN1918100000000	19	181	Warren County, IA	2006	NA	25327	24514	813	3.2
CN1918300000000	19	183	Washington County, IA	2006	NA	12455	12084	371	3
CN1918500000000	19	185	Wayne County, IA	2006	NA	3211	3083	128	4
CN1918700000000	19	187	Webster County, IA	2006	NA	19822	19048	774	3.9
CN1918900000000	19	189	Winnebago County, IA	2006	NA	5814	5608	206	3.5
CN1919100000000	19	191	Winneshiek County, IA	2006	NA	12556	12106	450	3.6
CN1919300000000	19	193	Woodbury County, IA	2006	NA	54183	51888	2295	4.2
CN1919500000000	19	195	Worth County, IA	2006	NA	4582	4409	173	3.8
CN1919700000000	19	197	Wright County, IA	2006	NA	7175	6917	258	3.6
CN2000100000000	20	001	Allen County, KS	2006	NA	7535	7221	314	4.2
CN2000300000000	20	003	Anderson County, KS	2006	NA	4165	3963	202	4.8
CN2000500000000	20	005	Atchison County, KS	2006	NA	8723	8309	414	4.7
CN2000700000000	20	007	Barber County, KS	2006	NA	2598	2514	84	3.2
CN2000900000000	20	009	Barton County, KS	2006	NA	15405	14871	534	3.5
CN2001100000000	20	011	Bourbon County, KS	2006	NA	9149	8793	356	3.9
CN2001300000000	20	013	Brown County, KS	2006	NA	5678	5458	220	3.9
CN2001500000000	20	015	Butler County, KS	2006	NA	32135	30658	1477	4.6
CN2001700000000	20	017	Chase County, KS	2006	NA	1691	1624	67	4
CN2001900000000	20	019	Chautauqua County, KS	2006	NA	1889	1793	96	5.1
CN2002100000000	20	021	Cherokee County, KS	2006	NA	10691	10142	549	5.1
CN2002300000000	20	023	Cheyenne County, KS	2006	NA	1476	1425	51	3.5
CN2002500000000	20	025	Clark County, KS	2006	NA	1197	1159	38	3.2
CN2002700000000	20	027	Clay County, KS	2006	NA	4958	4789	169	3.4
CN2002900000000	20	029	Cloud County, KS	2006	NA	5885	5686	199	3.4
CN2003100000000	20	031	Coffey County, KS	2006	NA	5314	5055	259	4.9
CN2003300000000	20	033	Comanche County, KS	2006	NA	1088	1057	31	2.8
CN2003500000000	20	035	Cowley County, KS	2006	NA	18154	17367	787	4.3
CN2003700000000	20	037	Crawford County, KS	2006	NA	19331	18343	988	5.1
CN2003900000000	20	039	Decatur County, KS	2006	NA	1679	1623	56	3.3
CN2004100000000	20	041	Dickinson County, KS	2006	NA	10566	10145	421	4
CN2004300000000	20	043	Doniphan County, KS	2006	NA	4496	4273	223	5
CN2004500000000	20	045	Douglas County, KS	2006	NA	62560	60180	2380	3.8
CN2004700000000	20	047	Edwards County, KS	2006	NA	1715	1663	52	3
CN2004900000000	20	049	Elk County, KS	2006	NA	1465	1394	71	4.8
CN2005100000000	20	051	Ellis County, KS	2006	NA	17198	16724	474	2.8
CN2005300000000	20	053	Ellsworth County, KS	2006	NA	3660	3539	121	3.3
CN2005500000000	20	055	Finney County, KS	2006	NA	18113	17485	628	3.5
CN2005700000000	20	057	Ford County, KS	2006	NA	17080	16536	544	3.2
CN2005900000000	20	059	Franklin County, KS	2006	NA	13771	13060	711	5.2
CN2006100000000	20	061	Geary County, KS	2006	NA	11288	10695	593	5.3
CN2006300000000	20	063	Gove County, KS	2006	NA	1522	1480	42	2.8
CN2006500000000	20	065	Graham County, KS	2006	NA	1449	1402	47	3.2
CN2006700000000	20	067	Grant County, KS	2006	NA	3914	3800	114	2.9
CN2006900000000	20	069	Gray County, KS	2006	NA	3186	3095	91	2.9
CN2007100000000	20	071	Greeley County, KS	2006	NA	734	711	23	3.1
CN2007300000000	20	073	Greenwood County, KS	2006	NA	3529	3366	163	4.6
CN2007500000000	20	075	Hamilton County, KS	2006	NA	1261	1220	41	3.3
CN2007700000000	20	077	Harper County, KS	2006	NA	3435	3324	111	3.2
CN2007900000000	20	079	Harvey County, KS	2006	NA	17907	17117	790	4.4
CN2008100000000	20	081	Haskell County, KS	2006	NA	2099	2039	60	2.9
CN2008300000000	20	083	Hodgeman County, KS	2006	NA	963	929	34	3.5
CN2008500000000	20	085	Jackson County, KS	2006	NA	6916	6546	370	5.3
CN2008700000000	20	087	Jefferson County, KS	2006	NA	9700	9238	462	4.8
CN2008900000000	20	089	Jewell County, KS	2006	NA	1900	1841	59	3.1
CN2009100000000	20	091	Johnson County, KS	2006	NA	292027	279977	12050	4.1
CN2009300000000	20	093	Kearny County, KS	2006	NA	2023	1947	76	3.8
CN2009500000000	20	095	Kingman County, KS	2006	NA	4377	4217	160	3.7
CN2009700000000	20	097	Kiowa County, KS	2006	NA	1636	1588	48	2.9
CN2009900000000	20	099	Labette County, KS	2006	NA	10775	10203	572	5.3
CN2010100000000	20	101	Lane County, KS	2006	NA	1064	1027	37	3.5
CN2010300000000	20	103	Leavenworth County, KS	2006	NA	32764	30926	1838	5.6
CN2010500000000	20	105	Lincoln County, KS	2006	NA	1848	1783	65	3.5
CN2010700000000	20	107	Linn County, KS	2006	NA	4809	4510	299	6.2
CN2010900000000	20	109	Logan County, KS	2006	NA	1493	1446	47	3.1
CN2011100000000	20	111	Lyon County, KS	2006	NA	19435	18623	812	4.2
CN2011300000000	20	113	McPherson County, KS	2006	NA	17229	16648	581	3.4
CN2011500000000	20	115	Marion County, KS	2006	NA	6781	6514	267	3.9
CN2011700000000	20	117	Marshall County, KS	2006	NA	5786	5583	203	3.5
CN2011900000000	20	119	Meade County, KS	2006	NA	2192	2124	68	3.1
CN2012100000000	20	121	Miami County, KS	2006	NA	16270	15523	747	4.6
CN2012300000000	20	123	Mitchell County, KS	2006	NA	3419	3301	118	3.5
CN2012500000000	20	125	Montgomery County, KS	2006	NA	17711	16900	811	4.6
CN2012700000000	20	127	Morris County, KS	2006	NA	2907	2781	126	4.3
CN2012900000000	20	129	Morton County, KS	2006	NA	1725	1677	48	2.8
CN2013100000000	20	131	Nemaha County, KS	2006	NA	5449	5268	181	3.3
CN2013300000000	20	133	Neosho County, KS	2006	NA	9231	8869	362	3.9
CN2013500000000	20	135	Ness County, KS	2006	NA	1695	1647	48	2.8
CN2013700000000	20	137	Norton County, KS	2006	NA	2701	2612	89	3.3
CN2013900000000	20	139	Osage County, KS	2006	NA	8712	8235	477	5.5
CN2014100000000	20	141	Osborne County, KS	2006	NA	2251	2172	79	3.5
CN2014300000000	20	143	Ottawa County, KS	2006	NA	3374	3256	118	3.5
CN2014500000000	20	145	Pawnee County, KS	2006	NA	3983	3851	132	3.3
CN2014700000000	20	147	Phillips County, KS	2006	NA	3092	2996	96	3.1
CN2014900000000	20	149	Pottawatomie County, KS	2006	NA	11186	10814	372	3.3
CN2015100000000	20	151	Pratt County, KS	2006	NA	5607	5440	167	3
CN2015300000000	20	153	Rawlins County, KS	2006	NA	1313	1270	43	3.3
CN2015500000000	20	155	Reno County, KS	2006	NA	32984	31505	1479	4.5
CN2015700000000	20	157	Republic County, KS	2006	NA	2728	2630	98	3.6
CN2015900000000	20	159	Rice County, KS	2006	NA	5616	5387	229	4.1
CN2016100000000	20	161	Riley County, KS	2006	NA	34957	33789	1168	3.3
CN2016300000000	20	163	Rooks County, KS	2006	NA	2710	2610	100	3.7
CN2016500000000	20	165	Rush County, KS	2006	NA	1698	1637	61	3.6
CN2016700000000	20	167	Russell County, KS	2006	NA	3471	3339	132	3.8
CN2016900000000	20	169	Saline County, KS	2006	NA	30460	29310	1150	3.8
CN2017100000000	20	171	Scott County, KS	2006	NA	2777	2698	79	2.8
CN2017300000000	20	173	Sedgwick County, KS	2006	NA	245201	233957	11244	4.6
CN2017500000000	20	175	Seward County, KS	2006	NA	10567	10214	353	3.3
CN2017700000000	20	177	Shawnee County, KS	2006	NA	90352	86036	4316	4.8
CN2017900000000	20	179	Sheridan County, KS	2006	NA	1507	1464	43	2.9
CN2018100000000	20	181	Sherman County, KS	2006	NA	3671	3564	107	2.9
CN2018300000000	20	183	Smith County, KS	2006	NA	2236	2162	74	3.3
CN2018500000000	20	185	Stafford County, KS	2006	NA	2237	2158	79	3.5
CN2018700000000	20	187	Stanton County, KS	2006	NA	1158	1127	31	2.7
CN2018900000000	20	189	Stevens County, KS	2006	NA	2330	2250	80	3.4
CN2019100000000	20	191	Sumner County, KS	2006	NA	11947	11383	564	4.7
CN2019300000000	20	193	Thomas County, KS	2006	NA	4525	4394	131	2.9
CN2019500000000	20	195	Trego County, KS	2006	NA	1744	1691	53	3
CN2019700000000	20	197	Wabaunsee County, KS	2006	NA	3631	3495	136	3.7
CN2019900000000	20	199	Wallace County, KS	2006	NA	896	868	28	3.1
CN2020100000000	20	201	Washington County, KS	2006	NA	3359	3243	116	3.5
CN2020300000000	20	203	Wichita County, KS	2006	NA	1251	1213	38	3
CN2020500000000	20	205	Wilson County, KS	2006	NA	5609	5403	206	3.7
CN2020700000000	20	207	Woodson County, KS	2006	NA	1667	1584	83	5
CN2020900000000	20	209	Wyandotte County, KS	2006	NA	71776	66313	5463	7.6
CN2100100000000	21	001	Adair County, KY	2006	NA	8891	8388	503	5.7
CN2100300000000	21	003	Allen County, KY	2006	NA	8463	7916	547	6.5
CN2100500000000	21	005	Anderson County, KY	2006	NA	11028	10457	571	5.2
CN2100700000000	21	007	Ballard County, KY	2006	NA	4169	3914	255	6.1
CN2100900000000	21	009	Barren County, KY	2006	NA	19583	18481	1102	5.6
CN2101100000000	21	011	Bath County, KY	2006	NA	5126	4730	396	7.7
CN2101300000000	21	013	Bell County, KY	2006	NA	9610	8864	746	7.8
CN2101500000000	21	015	Boone County, KY	2006	NA	61369	58483	2886	4.7
CN2101700000000	21	017	Bourbon County, KY	2006	NA	9831	9344	487	5
CN2101900000000	21	019	Boyd County, KY	2006	NA	23096	21830	1266	5.5
CN2102100000000	21	021	Boyle County, KY	2006	NA	12835	11975	860	6.7
CN2102300000000	21	023	Bracken County, KY	2006	NA	4341	4094	247	5.7
CN2102500000000	21	025	Breathitt County, KY	2006	NA	5667	5251	416	7.3
CN2102700000000	21	027	Breckinridge County, KY	2006	NA	9082	8480	602	6.6
CN2102900000000	21	029	Bullitt County, KY	2006	NA	38622	36352	2270	5.9
CN2103100000000	21	031	Butler County, KY	2006	NA	5780	5326	454	7.9
CN2103300000000	21	033	Caldwell County, KY	2006	NA	6653	6305	348	5.2
CN2103500000000	21	035	Calloway County, KY	2006	NA	18003	16983	1020	5.7
CN2103700000000	21	037	Campbell County, KY	2006	NA	45162	42854	2308	5.1
CN2103900000000	21	039	Carlisle County, KY	2006	NA	2318	2178	140	6
CN2104100000000	21	041	Carroll County, KY	2006	NA	5768	5452	316	5.5
CN2104300000000	21	043	Carter County, KY	2006	NA	13713	12675	1038	7.6
CN2104500000000	21	045	Casey County, KY	2006	NA	7486	6979	507	6.8
CN2104700000000	21	047	Christian County, KY	2006	NA	26223	24499	1724	6.6
CN2104900000000	21	049	Clark County, KY	2006	NA	17370	16426	944	5.4
CN2105100000000	21	051	Clay County, KY	2006	NA	7067	6363	704	10
CN2105300000000	21	053	Clinton County, KY	2006	NA	4506	4238	268	5.9
CN2105500000000	21	055	Crittenden County, KY	2006	NA	4035	3789	246	6.1
CN2105700000000	21	057	Cumberland County, KY	2006	NA	3019	2798	221	7.3
CN2105900000000	21	059	Daviess County, KY	2006	NA	47260	44748	2512	5.3
CN2106100000000	21	061	Edmonson County, KY	2006	NA	5417	5046	371	6.8
CN2106300000000	21	063	Elliott County, KY	2006	NA	3096	2837	259	8.4
CN2106500000000	21	065	Estill County, KY	2006	NA	6123	5725	398	6.5
CN2106700000000	21	067	Fayette County, KY	2006	NA	148691	142257	6434	4.3
CN2106900000000	21	069	Fleming County, KY	2006	NA	6637	6207	430	6.5
CN2107100000000	21	071	Floyd County, KY	2006	NA	15212	14236	976	6.4
CN2107300000000	21	073	Franklin County, KY	2006	NA	25354	24176	1178	4.6
CN2107500000000	21	075	Fulton County, KY	2006	NA	2800	2588	212	7.6
CN2107700000000	21	077	Gallatin County, KY	2006	NA	3975	3785	190	4.8
CN2107900000000	21	079	Garrard County, KY	2006	NA	7624	7176	448	5.9
CN2108100000000	21	081	Grant County, KY	2006	NA	12532	11861	671	5.4
CN2108300000000	21	083	Graves County, KY	2006	NA	15829	14700	1129	7.1
CN2108500000000	21	085	Grayson County, KY	2006	NA	11617	10653	964	8.3
CN2108700000000	21	087	Green County, KY	2006	NA	5615	5303	312	5.6
CN2108900000000	21	089	Greenup County, KY	2006	NA	17418	16410	1008	5.8
CN2109100000000	21	091	Hancock County, KY	2006	NA	4231	3981	250	5.9
CN2109300000000	21	093	Hardin County, KY	2006	NA	47757	45197	2560	5.4
CN2109500000000	21	095	Harlan County, KY	2006	NA	10179	9366	813	8
CN2109700000000	21	097	Harrison County, KY	2006	NA	9022	8533	489	5.4
CN2109900000000	21	099	Hart County, KY	2006	NA	7964	7462	502	6.3
CN2110100000000	21	101	Henderson County, KY	2006	NA	23148	21972	1176	5.1
CN2110300000000	21	103	Henry County, KY	2006	NA	8041	7584	457	5.7
CN2110500000000	21	105	Hickman County, KY	2006	NA	2065	1929	136	6.6
CN2110700000000	21	107	Hopkins County, KY	2006	NA	23260	21922	1338	5.8
CN2110900000000	21	109	Jackson County, KY	2006	NA	4654	4191	463	9.9
CN2111100000000	21	111	Jefferson County, KY	2006	NA	355094	334975	20119	5.7
CN2111300000000	21	113	Jessamine County, KY	2006	NA	22720	21652	1068	4.7
CN2111500000000	21	115	Johnson County, KY	2006	NA	9651	9028	623	6.5
CN2111700000000	21	117	Kenton County, KY	2006	NA	83788	79636	4152	5
CN2111900000000	21	119	Knott County, KY	2006	NA	6495	6041	454	7
CN2112100000000	21	121	Knox County, KY	2006	NA	12232	11401	831	6.8
CN2112300000000	21	123	Larue County, KY	2006	NA	7130	6735	395	5.5
CN2112500000000	21	125	Laurel County, KY	2006	NA	25868	24367	1501	5.8
CN2112700000000	21	127	Lawrence County, KY	2006	NA	5818	5337	481	8.3
CN2112900000000	21	129	Lee County, KY	2006	NA	2737	2536	201	7.3
CN2113100000000	21	131	Leslie County, KY	2006	NA	3699	3376	323	8.7
CN2113300000000	21	133	Letcher County, KY	2006	NA	9120	8435	685	7.5
CN2113500000000	21	135	Lewis County, KY	2006	NA	5557	5105	452	8.1
CN2113700000000	21	137	Lincoln County, KY	2006	NA	10844	10075	769	7.1
CN2113900000000	21	139	Livingston County, KY	2006	NA	4908	4611	297	6.1
CN2114100000000	21	141	Logan County, KY	2006	NA	12487	11767	720	5.8
CN2114300000000	21	143	Lyon County, KY	2006	NA	3306	3086	220	6.7
CN2114500000000	21	145	McCracken County, KY	2006	NA	31431	29750	1681	5.3
CN2114700000000	21	147	McCreary County, KY	2006	NA	5977	5371	606	10.1
CN2114900000000	21	149	McLean County, KY	2006	NA	4707	4354	353	7.5
CN2115100000000	21	151	Madison County, KY	2006	NA	42742	40699	2043	4.8
CN2115300000000	21	153	Magoffin County, KY	2006	NA	4326	3886	440	10.2
CN2115500000000	21	155	Marion County, KY	2006	NA	10172	9644	528	5.2
CN2115700000000	21	157	Marshall County, KY	2006	NA	14736	13842	894	6.1
CN2115900000000	21	159	Martin County, KY	2006	NA	3600	3334	266	7.4
CN2116100000000	21	161	Mason County, KY	2006	NA	8706	8250	456	5.2
CN2116300000000	21	163	Meade County, KY	2006	NA	12019	11255	764	6.4
CN2116500000000	21	165	Menifee County, KY	2006	NA	2654	2428	226	8.5
CN2116700000000	21	167	Mercer County, KY	2006	NA	10588	9975	613	5.8
CN2116900000000	21	169	Metcalfe County, KY	2006	NA	4494	4249	245	5.5
CN2117100000000	21	171	Monroe County, KY	2006	NA	5033	4719	314	6.2
CN2117300000000	21	173	Montgomery County, KY	2006	NA	12139	11412	727	6
CN2117500000000	21	175	Morgan County, KY	2006	NA	5001	4565	436	8.7
CN2117700000000	21	177	Muhlenberg County, KY	2006	NA	13012	11827	1185	9.1
CN2117900000000	21	179	Nelson County, KY	2006	NA	21189	19953	1236	5.8
CN2118100000000	21	181	Nicholas County, KY	2006	NA	2987	2786	201	6.7
CN2118300000000	21	183	Ohio County, KY	2006	NA	11813	11104	709	6
CN2118500000000	21	185	Oldham County, KY	2006	NA	27396	26048	1348	4.9
CN2118700000000	21	187	Owen County, KY	2006	NA	5220	4933	287	5.5
CN2118900000000	21	189	Owsley County, KY	2006	NA	1534	1408	126	8.2
CN2119100000000	21	191	Pendleton County, KY	2006	NA	7514	7095	419	5.6
CN2119300000000	21	193	Perry County, KY	2006	NA	11487	10700	787	6.9
CN2119500000000	21	195	Pike County, KY	2006	NA	25085	23599	1486	5.9
CN2119700000000	21	197	Powell County, KY	2006	NA	5607	5201	406	7.2
CN2119900000000	21	199	Pulaski County, KY	2006	NA	27255	25491	1764	6.5
CN2120100000000	21	201	Robertson County, KY	2006	NA	1051	995	56	5.3
CN2120300000000	21	203	Rockcastle County, KY	2006	NA	7539	7026	513	6.8
CN2120500000000	21	205	Rowan County, KY	2006	NA	12199	11500	699	5.7
CN2120700000000	21	207	Russell County, KY	2006	NA	8185	7650	535	6.5
CN2120900000000	21	209	Scott County, KY	2006	NA	21915	20888	1027	4.7
CN2121100000000	21	211	Shelby County, KY	2006	NA	21058	19972	1086	5.2
CN2121300000000	21	213	Simpson County, KY	2006	NA	8998	8481	517	5.7
CN2121500000000	21	215	Spencer County, KY	2006	NA	8763	8241	522	6
CN2121700000000	21	217	Taylor County, KY	2006	NA	13357	12726	631	4.7
CN2121900000000	21	219	Todd County, KY	2006	NA	5133	4643	490	9.5
CN2122100000000	21	221	Trigg County, KY	2006	NA	6707	6322	385	5.7
CN2122300000000	21	223	Trimble County, KY	2006	NA	4440	4143	297	6.7
CN2122500000000	21	225	Union County, KY	2006	NA	7179	6756	423	5.9
CN2122700000000	21	227	Warren County, KY	2006	NA	56606	53891	2715	4.8
CN2122900000000	21	229	Washington County, KY	2006	NA	5360	5051	309	5.8
CN2123100000000	21	231	Wayne County, KY	2006	NA	8684	8102	582	6.7
CN2123300000000	21	233	Webster County, KY	2006	NA	6643	6304	339	5.1
CN2123500000000	21	235	Whitley County, KY	2006	NA	15401	14459	942	6.1
CN2123700000000	21	237	Wolfe County, KY	2006	NA	2327	2108	219	9.4
CN2123900000000	21	239	Woodford County, KY	2006	NA	13479	12911	568	4.2
CN2200100000000	22	001	Acadia Parish, LA	2006	NA	25931	24985	946	3.6
CN2200300000000	22	003	Allen Parish, LA	2006	NA	8710	8253	457	5.2
CN2200500000000	22	005	Ascension Parish, LA	2006	NA	47386	45441	1945	4.1
CN2200700000000	22	007	Assumption Parish, LA	2006	NA	10204	9645	559	5.5
CN2200900000000	22	009	Avoyelles Parish, LA	2006	NA	15986	15177	809	5.1
CN2201100000000	22	011	Beauregard Parish, LA	2006	NA	14464	13817	647	4.5
CN2201300000000	22	013	Bienville Parish, LA	2006	NA	6322	6005	317	5
CN2201500000000	22	015	Bossier Parish, LA	2006	NA	52081	50119	1962	3.8
CN2201700000000	22	017	Caddo Parish, LA	2006	NA	117931	112544	5387	4.6
CN2201900000000	22	019	Calcasieu Parish, LA	2006	NA	89953	86466	3487	3.9
CN2202100000000	22	021	Caldwell Parish, LA	2006	NA	4411	4220	191	4.3
CN2202300000000	22	023	Cameron Parish, LA	2006	NA	3669	3535	134	3.7
CN2202500000000	22	025	Catahoula Parish, LA	2006	NA	4152	3916	236	5.7
CN2202700000000	22	027	Claiborne Parish, LA	2006	NA	6883	6554	329	4.8
CN2202900000000	22	029	Concordia Parish, LA	2006	NA	7309	6833	476	6.5
CN2203100000000	22	031	De Soto Parish, LA	2006	NA	11326	10765	561	5
CN2203300000000	22	033	East Baton Rouge Parish, LA	2006	NA	213196	203836	9360	4.4
CN2203500000000	22	035	East Carroll Parish, LA	2006	NA	3130	2864	266	8.5
CN2203700000000	22	037	East Feliciana Parish, LA	2006	NA	7964	7577	387	4.9
CN2203900000000	22	039	Evangeline Parish, LA	2006	NA	12128	11563	565	4.7
CN2204100000000	22	041	Franklin Parish, LA	2006	NA	7799	7295	504	6.5
CN2204300000000	22	043	Grant Parish, LA	2006	NA	8667	8301	366	4.2
CN2204500000000	22	045	Iberia Parish, LA	2006	NA	34260	32954	1306	3.8
CN2204700000000	22	047	Iberville Parish, LA	2006	NA	12295	11525	770	6.3
CN2204900000000	22	049	Jackson Parish, LA	2006	NA	6512	6230	282	4.3
CN2205100000000	22	051	Jefferson Parish, LA	2006	1	222481.6666666667	213541	8940.666666666668	4.033333333333333
CN2205300000000	22	053	Jefferson Davis Parish, LA	2006	NA	14419	13935	484	3.4
CN2205500000000	22	055	Lafayette Parish, LA	2006	NA	107716	104316	3400	3.2
CN2205700000000	22	057	Lafourche Parish, LA	2006	NA	46934	45416	1518	3.2
CN2205900000000	22	059	LaSalle Parish, LA	2006	NA	6133	5914	219	3.6
CN2206100000000	22	061	Lincoln Parish, LA	2006	NA	18616	17731	885	4.8
CN2206300000000	22	063	Livingston Parish, LA	2006	NA	54234	52035	2199	4.1
CN2206500000000	22	065	Madison Parish, LA	2006	NA	4570	4282	288	6.3
CN2206700000000	22	067	Morehouse Parish, LA	2006	NA	11526	10750	776	6.7
CN2206900000000	22	069	Natchitoches Parish, LA	2006	NA	17839	17016	823	4.6
CN2207100000000	22	071	Orleans Parish, LA	2006	1	137141.6666666667	129618	7523.666666666668	5.366666666666667
CN2207300000000	22	073	Ouachita Parish, LA	2006	NA	71899	68849	3050	4.2
CN2207500000000	22	075	Plaquemines Parish, LA	2006	1	9857	9409.666666666668	447.3333333333333	4.433333333333334
CN2207700000000	22	077	Pointe Coupee Parish, LA	2006	NA	9501	9023	478	5
CN2207900000000	22	079	Rapides Parish, LA	2006	NA	59660	57225	2435	4.1
CN2208100000000	22	081	Red River Parish, LA	2006	NA	3252	3047	205	6.3
CN2208300000000	22	083	Richland Parish, LA	2006	NA	8588	8136	452	5.3
CN2208500000000	22	085	Sabine Parish, LA	2006	NA	9579	9201	378	3.9
CN2208700000000	22	087	St. Bernard Parish, LA	2006	1	16698.666666666664	15867	831.6666666666665	4.666666666666666
CN2208900000000	22	089	St. Charles Parish, LA	2006	1	25503.333333333336	24419	1084.3333333333335	4.266666666666667
CN2209100000000	22	091	St. Helena Parish, LA	2006	NA	4221	3886	335	7.9
CN2209300000000	22	093	St. James Parish, LA	2006	NA	8412	7846	566	6.7
CN2209500000000	22	095	St. John the Baptist Parish, LA	2006	1	21843.333333333336	20622.666666666664	1220.6666666666665	5.633333333333333
CN2209700000000	22	097	St. Landry Parish, LA	2006	NA	37534	35842	1692	4.5
CN2209900000000	22	099	St. Martin Parish, LA	2006	NA	23191	22304	887	3.8
CN2210100000000	22	101	St. Mary Parish, LA	2006	NA	23157	22071	1086	4.7
CN2210300000000	22	103	St. Tammany Parish, LA	2006	1	112277.66666666666	108288.33333333334	3989.3333333333335	3.5666666666666664
CN2210500000000	22	105	Tangipahoa Parish, LA	2006	NA	50843	48237	2606	5.1
CN2210700000000	22	107	Tensas Parish, LA	2006	NA	2328	2143	185	7.9
CN2210900000000	22	109	Terrebonne Parish, LA	2006	NA	52669	50862	1807	3.4
CN2211100000000	22	111	Union Parish, LA	2006	NA	10347	9888	459	4.4
CN2211300000000	22	113	Vermilion Parish, LA	2006	NA	23969	23036	933	3.9
CN2211500000000	22	115	Vernon Parish, LA	2006	NA	21538	20671	867	4
CN2211700000000	22	117	Washington Parish, LA	2006	NA	15527	14614	913	5.9
CN2211900000000	22	119	Webster Parish, LA	2006	NA	19677	18808	869	4.4
CN2212100000000	22	121	West Baton Rouge Parish, LA	2006	NA	10410	9956	454	4.4
CN2212300000000	22	123	West Carroll Parish, LA	2006	NA	5055	4712	343	6.8
CN2212500000000	22	125	West Feliciana Parish, LA	2006	NA	4830	4572	258	5.3
CN2212700000000	22	127	Winn Parish, LA	2006	NA	6349	6062	287	4.5
CN2300100000000	23	001	Androscoggin County, ME	2006	NA	57735	55073	2662	4.6
CN2300300000000	23	003	Aroostook County, ME	2006	NA	35544	33233	2311	6.5
CN2300500000000	23	005	Cumberland County, ME	2006	NA	156163	150916	5247	3.4
CN2300700000000	23	007	Franklin County, ME	2006	NA	14398	13574	824	5.7
CN2300900000000	23	009	Hancock County, ME	2006	NA	29801	28224	1577	5.3
CN2301100000000	23	011	Kennebec County, ME	2006	NA	63015	60232	2783	4.4
CN2301300000000	23	013	Knox County, ME	2006	NA	21421	20521	900	4.2
CN2301500000000	23	015	Lincoln County, ME	2006	NA	18493	17715	778	4.2
CN2301700000000	23	017	Oxford County, ME	2006	NA	28503	26889	1614	5.7
CN2301900000000	23	019	Penobscot County, ME	2006	NA	77596	73751	3845	5
CN2302100000000	23	021	Piscataquis County, ME	2006	NA	7537	7035	502	6.7
CN2302300000000	23	023	Sagadahoc County, ME	2006	NA	18721	17977	744	4
CN2302500000000	23	025	Somerset County, ME	2006	NA	25193	23489	1704	6.8
CN2302700000000	23	027	Waldo County, ME	2006	NA	19537	18528	1009	5.2
CN2302900000000	23	029	Washington County, ME	2006	NA	15182	14040	1142	7.5
CN2303100000000	23	031	York County, ME	2006	NA	112709	108346	4363	3.9
CN2400100000000	24	001	Allegany County, MD	2006	NA	35178	33192	1986	5.6
CN2400300000000	24	003	Anne Arundel County, MD	2006	NA	277964	268698	9266	3.3
CN2400500000000	24	005	Baltimore County, MD	2006	NA	425938	409160	16778	3.9
CN2400900000000	24	009	Calvert County, MD	2006	NA	47040	45559	1481	3.1
CN2401100000000	24	011	Caroline County, MD	2006	NA	16060	15359	701	4.4
CN2401300000000	24	013	Carroll County, MD	2006	NA	94352	91368	2984	3.2
CN2401500000000	24	015	Cecil County, MD	2006	NA	50626	48411	2215	4.4
CN2401700000000	24	017	Charles County, MD	2006	NA	74435	72087	2348	3.2
CN2401900000000	24	019	Dorchester County, MD	2006	NA	16762	15802	960	5.7
CN2402100000000	24	021	Frederick County, MD	2006	NA	122779	118916	3863	3.1
CN2402300000000	24	023	Garrett County, MD	2006	NA	16763	15950	813	4.8
CN2402500000000	24	025	Harford County, MD	2006	NA	132228	127445	4783	3.6
CN2402700000000	24	027	Howard County, MD	2006	NA	158285	153768	4517	2.9
CN2402900000000	24	029	Kent County, MD	2006	NA	11004	10576	428	3.9
CN2403100000000	24	031	Montgomery County, MD	2006	NA	510593	495926	14667	2.9
CN2403300000000	24	033	Prince George's County, MD	2006	NA	444907	426421	18486	4.2
CN2403500000000	24	035	Queen Anne's County, MD	2006	NA	25798	24931	867	3.4
CN2403700000000	24	037	St. Mary's County, MD	2006	NA	50472	48769	1703	3.4
CN2403900000000	24	039	Somerset County, MD	2006	NA	11270	10647	623	5.5
CN2404100000000	24	041	Talbot County, MD	2006	NA	18944	18264	680	3.6
CN2404300000000	24	043	Washington County, MD	2006	NA	68305	65252	3053	4.5
CN2404500000000	24	045	Wicomico County, MD	2006	NA	52187	50060	2127	4.1
CN2404700000000	24	047	Worcester County, MD	2006	NA	28224	26524	1700	6
CN2451000000000	24	510	Baltimore city, MD	2006	NA	273753	256270	17483	6.4
CN2500100000000	25	001	Barnstable County, MA	2006	NA	122283	116033	6250	5.1
CN2500300000000	25	003	Berkshire County, MA	2006	NA	73357	70095	3262	4.4
CN2500500000000	25	005	Bristol County, MA	2006	NA	290313	272487	17826	6.1
CN2500700000000	25	007	Dukes County, MA	2006	NA	11053	10611	442	4
CN2500900000000	25	009	Essex County, MA	2006	NA	373881	354214	19667	5.3
CN2501100000000	25	011	Franklin County, MA	2006	NA	39639	37879	1760	4.4
CN2501300000000	25	013	Hampden County, MA	2006	NA	225031	211464	13567	6
CN2501500000000	25	015	Hampshire County, MA	2006	NA	88355	84769	3586	4.1
CN2501700000000	25	017	Middlesex County, MA	2006	NA	811087	778141	32946	4.1
CN2501900000000	25	019	Nantucket County/town, MA	2006	NA	8396	8197	199	2.4
CN2502100000000	25	021	Norfolk County, MA	2006	NA	351993	336899	15094	4.3
CN2502300000000	25	023	Plymouth County, MA	2006	NA	258422	245440	12982	5
CN2502500000000	25	025	Suffolk County, MA	2006	NA	357971	339648	18323	5.1
CN2502700000000	25	027	Worcester County, MA	2006	NA	401558	380437	21121	5.3
CN2600100000000	26	001	Alcona County, MI	2006	NA	4461	3977	484	10.8
CN2600300000000	26	003	Alger County, MI	2006	NA	4477	4113	364	8.1
CN2600500000000	26	005	Allegan County, MI	2006	NA	56445	52889	3556	6.3
CN2600700000000	26	007	Alpena County, MI	2006	NA	14977	13796	1181	7.9
CN2600900000000	26	009	Antrim County, MI	2006	NA	11992	11028	964	8
CN2601100000000	26	011	Arenac County, MI	2006	NA	7902	7093	809	10.2
CN2601300000000	26	013	Baraga County, MI	2006	NA	4258	3770	488	11.5
CN2601500000000	26	015	Barry County, MI	2006	NA	31110	29434	1676	5.4
CN2601700000000	26	017	Bay County, MI	2006	NA	55765	51761	4004	7.2
CN2601900000000	26	019	Benzie County, MI	2006	NA	9174	8445	729	7.9
CN2602100000000	26	021	Berrien County, MI	2006	NA	78916	73194	5722	7.3
CN2602300000000	26	023	Branch County, MI	2006	NA	22658	20926	1732	7.6
CN2602500000000	26	025	Calhoun County, MI	2006	NA	70774	65679	5095	7.2
CN2602700000000	26	027	Cass County, MI	2006	NA	27464	25943	1521	5.5
CN2602900000000	26	029	Charlevoix County, MI	2006	NA	14301	13163	1138	8
CN2603100000000	26	031	Cheboygan County, MI	2006	NA	12887	11580	1307	10.1
CN2603300000000	26	033	Chippewa County, MI	2006	NA	17648	16091	1557	8.8
CN2603500000000	26	035	Clare County, MI	2006	NA	13364	11932	1432	10.7
CN2603700000000	26	037	Clinton County, MI	2006	NA	38029	35971	2058	5.4
CN2603900000000	26	039	Crawford County, MI	2006	NA	6811	6274	537	7.9
CN2604100000000	26	041	Delta County, MI	2006	NA	20541	19014	1527	7.4
CN2604300000000	26	043	Dickinson County, MI	2006	NA	14494	13636	858	5.9
CN2604500000000	26	045	Eaton County, MI	2006	NA	59180	55957	3223	5.4
CN2604700000000	26	047	Emmet County, MI	2006	NA	20001	18238	1763	8.8
CN2604900000000	26	049	Genesee County, MI	2006	NA	212294	194333	17961	8.5
CN2605100000000	26	051	Gladwin County, MI	2006	NA	10958	9850	1108	10.1
CN2605300000000	26	053	Gogebic County, MI	2006	NA	7782	7179	603	7.7
CN2605500000000	26	055	Grand Traverse County, MI	2006	NA	49164	46110	3054	6.2
CN2605700000000	26	057	Gratiot County, MI	2006	NA	20342	18541	1801	8.9
CN2605900000000	26	059	Hillsdale County, MI	2006	NA	22385	20589	1796	8
CN2606100000000	26	061	Houghton County, MI	2006	NA	17820	16555	1265	7.1
CN2606300000000	26	063	Huron County, MI	2006	NA	17332	15882	1450	8.4
CN2606500000000	26	065	Ingham County, MI	2006	NA	153139	143147	9992	6.5
CN2606700000000	26	067	Ionia County, MI	2006	NA	31552	28883	2669	8.5
CN2606900000000	26	069	Iosco County, MI	2006	NA	11184	10135	1049	9.4
CN2607100000000	26	071	Iron County, MI	2006	NA	6008	5560	448	7.5
CN2607300000000	26	073	Isabella County, MI	2006	NA	38165	36125	2040	5.3
CN2607500000000	26	075	Jackson County, MI	2006	NA	78168	72349	5819	7.4
CN2607700000000	26	077	Kalamazoo County, MI	2006	NA	133847	126658	7189	5.4
CN2607900000000	26	079	Kalkaska County, MI	2006	NA	8886	8173	713	8
CN2608100000000	26	081	Kent County, MI	2006	NA	324689	305699	18990	5.8
CN2608300000000	26	083	Keweenaw County, MI	2006	NA	1075	964	111	10.3
CN2608500000000	26	085	Lake County, MI	2006	NA	4222	3768	454	10.8
CN2608700000000	26	087	Lapeer County, MI	2006	NA	45400	41920	3480	7.7
CN2608900000000	26	089	Leelanau County, MI	2006	NA	11588	10982	606	5.2
CN2609100000000	26	091	Lenawee County, MI	2006	NA	50177	46363	3814	7.6
CN2609300000000	26	093	Livingston County, MI	2006	NA	96337	91350	4987	5.2
CN2609500000000	26	095	Luce County, MI	2006	NA	2859	2635	224	7.8
CN2609700000000	26	097	Mackinac County, MI	2006	NA	6546	5898	648	9.9
CN2609900000000	26	099	Macomb County, MI	2006	NA	425611	395735	29876	7
CN2610100000000	26	101	Manistee County, MI	2006	NA	12299	11230	1069	8.7
CN2610300000000	26	103	Marquette County, MI	2006	NA	35952	33704	2248	6.3
CN2610500000000	26	105	Mason County, MI	2006	NA	15089	13854	1235	8.2
CN2610700000000	26	107	Mecosta County, MI	2006	NA	20391	18827	1564	7.7
CN2610900000000	26	109	Menominee County, MI	2006	NA	13142	12276	866	6.6
CN2611100000000	26	111	Midland County, MI	2006	NA	42326	39865	2461	5.8
CN2611300000000	26	113	Missaukee County, MI	2006	NA	6715	6180	535	8
CN2611500000000	26	115	Monroe County, MI	2006	NA	78710	73405	5305	6.7
CN2611700000000	26	117	Montcalm County, MI	2006	NA	28428	24656	3772	13.3
CN2611900000000	26	119	Montmorency County, MI	2006	NA	4353	3817	536	12.3
CN2612100000000	26	121	Muskegon County, MI	2006	NA	90509	84055	6454	7.1
CN2612300000000	26	123	Newaygo County, MI	2006	NA	23429	21688	1741	7.4
CN2612500000000	26	125	Oakland County, MI	2006	NA	634540	598658	35882	5.7
CN2612700000000	26	127	Oceana County, MI	2006	NA	14760	13470	1290	8.7
CN2612900000000	26	129	Ogemaw County, MI	2006	NA	9842	9012	830	8.4
CN2613100000000	26	131	Ontonagon County, MI	2006	NA	3531	3243	288	8.2
CN2613300000000	26	133	Osceola County, MI	2006	NA	10243	9468	775	7.6
CN2613500000000	26	135	Oscoda County, MI	2006	NA	4085	3643	442	10.8
CN2613700000000	26	137	Otsego County, MI	2006	NA	12625	11549	1076	8.5
CN2613900000000	26	139	Ottawa County, MI	2006	NA	137253	129698	7555	5.5
CN2614100000000	26	141	Presque Isle County, MI	2006	NA	6233	5459	774	12.4
CN2614300000000	26	143	Roscommon County, MI	2006	NA	10950	9907	1043	9.5
CN2614500000000	26	145	Saginaw County, MI	2006	NA	98712	91076	7636	7.7
CN2614700000000	26	147	St. Clair County, MI	2006	NA	84801	78121	6680	7.9
CN2614900000000	26	149	St. Joseph County, MI	2006	NA	31549	29424	2125	6.7
CN2615100000000	26	151	Sanilac County, MI	2006	NA	22618	20623	1995	8.8
CN2615300000000	26	153	Schoolcraft County, MI	2006	NA	4076	3633	443	10.9
CN2615500000000	26	155	Shiawassee County, MI	2006	NA	36785	33700	3085	8.4
CN2615700000000	26	157	Tuscola County, MI	2006	NA	29306	26738	2568	8.8
CN2615900000000	26	159	Van Buren County, MI	2006	NA	41245	38381	2864	6.9
CN2616100000000	26	161	Washtenaw County, MI	2006	NA	190167	181037	9130	4.8
CN2616300000000	26	163	Wayne County, MI	2006	NA	901905	827726	74179	8.2
CN2616500000000	26	165	Wexford County, MI	2006	NA	14939	13684	1255	8.4
CN2700100000000	27	001	Aitkin County, MN	2006	NA	7755	7297	458	5.9
CN2700300000000	27	003	Anoka County, MN	2006	NA	190346	182942	7404	3.9
CN2700500000000	27	005	Becker County, MN	2006	NA	16807	15951	856	5.1
CN2700700000000	27	007	Beltrami County, MN	2006	NA	21093	20001	1092	5.2
CN2700900000000	27	009	Benton County, MN	2006	NA	22332	21341	991	4.4
CN2701100000000	27	011	Big Stone County, MN	2006	NA	2808	2686	122	4.3
CN2701300000000	27	013	Blue Earth County, MN	2006	NA	35989	34813	1176	3.3
CN2701500000000	27	015	Brown County, MN	2006	NA	14874	14223	651	4.4
CN2701700000000	27	017	Carlton County, MN	2006	NA	17143	16248	895	5.2
CN2701900000000	27	019	Carver County, MN	2006	NA	49222	47605	1617	3.3
CN2702100000000	27	021	Cass County, MN	2006	NA	14365	13454	911	6.3
CN2702300000000	27	023	Chippewa County, MN	2006	NA	7136	6864	272	3.8
CN2702500000000	27	025	Chisago County, MN	2006	NA	27408	26085	1323	4.8
CN2702700000000	27	027	Clay County, MN	2006	NA	31273	30273	1000	3.2
CN2702900000000	27	029	Clearwater County, MN	2006	NA	3794	3424	370	9.8
CN2703100000000	27	031	Cook County, MN	2006	NA	3171	3031	140	4.4
CN2703300000000	27	033	Cottonwood County, MN	2006	NA	6402	6119	283	4.4
CN2703500000000	27	035	Crow Wing County, MN	2006	NA	32307	30720	1587	4.9
CN2703700000000	27	037	Dakota County, MN	2006	NA	228974	220905	8069	3.5
CN2703900000000	27	039	Dodge County, MN	2006	NA	11106	10695	411	3.7
CN2704100000000	27	041	Douglas County, MN	2006	NA	20004	19237	767	3.8
CN2704300000000	27	043	Faribault County, MN	2006	NA	7842	7493	349	4.5
CN2704500000000	27	045	Fillmore County, MN	2006	NA	11207	10746	461	4.1
CN2704700000000	27	047	Freeborn County, MN	2006	NA	16310	15591	719	4.4
CN2704900000000	27	049	Goodhue County, MN	2006	NA	24806	23750	1056	4.3
CN2705100000000	27	051	Grant County, MN	2006	NA	3039	2880	159	5.2
CN2705300000000	27	053	Hennepin County, MN	2006	NA	649356	626223	23133	3.6
CN2705500000000	27	055	Houston County, MN	2006	NA	11233	10754	479	4.3
CN2705700000000	27	057	Hubbard County, MN	2006	NA	9552	9024	528	5.5
CN2705900000000	27	059	Isanti County, MN	2006	NA	21431	20387	1044	4.9
CN2706100000000	27	061	Itasca County, MN	2006	NA	22224	20887	1337	6
CN2706300000000	27	063	Jackson County, MN	2006	NA	6663	6405	258	3.9
CN2706500000000	27	065	Kanabec County, MN	2006	NA	7779	7238	541	7
CN2706700000000	27	067	Kandiyohi County, MN	2006	NA	23206	22302	904	3.9
CN2706900000000	27	069	Kittson County, MN	2006	NA	2582	2442	140	5.4
CN2707100000000	27	071	Koochiching County, MN	2006	NA	6648	6210	438	6.6
CN2707300000000	27	073	Lac qui Parle County, MN	2006	NA	4092	3939	153	3.7
CN2707500000000	27	075	Lake County, MN	2006	NA	6078	5829	249	4.1
CN2707700000000	27	077	Lake of the Woods County, MN	2006	NA	2390	2280	110	4.6
CN2707900000000	27	079	Le Sueur County, MN	2006	NA	14165	13403	762	5.4
CN2708100000000	27	081	Lincoln County, MN	2006	NA	3315	3195	120	3.6
CN2708300000000	27	083	Lyon County, MN	2006	NA	14598	14119	479	3.3
CN2708500000000	27	085	McLeod County, MN	2006	NA	20469	19648	821	4
CN2708700000000	27	087	Mahnomen County, MN	2006	NA	2493	2355	138	5.5
CN2708900000000	27	089	Marshall County, MN	2006	NA	5296	4934	362	6.8
CN2709100000000	27	091	Martin County, MN	2006	NA	11196	10723	473	4.2
CN2709300000000	27	093	Meeker County, MN	2006	NA	12388	11762	626	5.1
CN2709500000000	27	095	Mille Lacs County, MN	2006	NA	12117	11301	816	6.7
CN2709700000000	27	097	Morrison County, MN	2006	NA	17246	16295	951	5.5
CN2709900000000	27	099	Mower County, MN	2006	NA	20159	19390	769	3.8
CN2710100000000	27	101	Murray County, MN	2006	NA	5465	5252	213	3.9
CN2710300000000	27	103	Nicollet County, MN	2006	NA	19331	18725	606	3.1
CN2710500000000	27	105	Nobles County, MN	2006	NA	11194	10846	348	3.1
CN2710700000000	27	107	Norman County, MN	2006	NA	3601	3422	179	5
CN2710900000000	27	109	Olmsted County, MN	2006	NA	78568	75882	2686	3.4
CN2711100000000	27	111	Otter Tail County, MN	2006	NA	29160	27742	1418	4.9
CN2711300000000	27	113	Pennington County, MN	2006	NA	8358	7897	461	5.5
CN2711500000000	27	115	Pine County, MN	2006	NA	13593	12711	882	6.5
CN2711700000000	27	117	Pipestone County, MN	2006	NA	5097	4927	170	3.3
CN2711900000000	27	119	Polk County, MN	2006	NA	17063	16271	792	4.6
CN2712100000000	27	121	Pope County, MN	2006	NA	6180	5940	240	3.9
CN2712300000000	27	123	Ramsey County, MN	2006	NA	268666	258249	10417	3.9
CN2712500000000	27	125	Red Lake County, MN	2006	NA	2223	2074	149	6.7
CN2712700000000	27	127	Redwood County, MN	2006	NA	8088	7760	328	4.1
CN2712900000000	27	129	Renville County, MN	2006	NA	8284	7882	402	4.9
CN2713100000000	27	131	Rice County, MN	2006	NA	31709	30340	1369	4.3
CN2713300000000	27	133	Rock County, MN	2006	NA	4964	4825	139	2.8
CN2713500000000	27	135	Roseau County, MN	2006	NA	10127	9487	640	6.3
CN2713700000000	27	137	St. Louis County, MN	2006	NA	101848	96738	5110	5
CN2713900000000	27	139	Scott County, MN	2006	NA	71811	69311	2500	3.5
CN2714100000000	27	141	Sherburne County, MN	2006	NA	48064	45991	2073	4.3
CN2714300000000	27	143	Sibley County, MN	2006	NA	8731	8365	366	4.2
CN2714500000000	27	145	Stearns County, MN	2006	NA	81617	78355	3262	4
CN2714700000000	27	147	Steele County, MN	2006	NA	20014	19222	792	4
CN2714900000000	27	149	Stevens County, MN	2006	NA	5665	5473	192	3.4
CN2715100000000	27	151	Swift County, MN	2006	NA	5298	5068	230	4.3
CN2715300000000	27	153	Todd County, MN	2006	NA	12351	11713	638	5.2
CN2715500000000	27	155	Traverse County, MN	2006	NA	1900	1819	81	4.3
CN2715700000000	27	157	Wabasha County, MN	2006	NA	12469	11967	502	4
CN2715900000000	27	159	Wadena County, MN	2006	NA	6293	5865	428	6.8
CN2716100000000	27	161	Waseca County, MN	2006	NA	10501	10073	428	4.1
CN2716300000000	27	163	Washington County, MN	2006	NA	127484	122962	4522	3.5
CN2716500000000	27	165	Watonwan County, MN	2006	NA	5632	5386	246	4.4
CN2716700000000	27	167	Wilkin County, MN	2006	NA	3558	3425	133	3.7
CN2716900000000	27	169	Winona County, MN	2006	NA	28500	27488	1012	3.6
CN2717100000000	27	171	Wright County, MN	2006	NA	64671	61904	2767	4.3
CN2717300000000	27	173	Yellow Medicine County, MN	2006	NA	5572	5344	228	4.1
CN2800100000000	28	001	Adams County, MS	2006	NA	13227	12329	898	6.8
CN2800300000000	28	003	Alcorn County, MS	2006	NA	15434	14319	1115	7.2
CN2800500000000	28	005	Amite County, MS	2006	NA	5152	4840	312	6.1
CN2800700000000	28	007	Attala County, MS	2006	NA	7452	6880	572	7.7
CN2800900000000	28	009	Benton County, MS	2006	NA	2936	2675	261	8.9
CN2801100000000	28	011	Bolivar County, MS	2006	NA	15642	14362	1280	8.2
CN2801300000000	28	013	Calhoun County, MS	2006	NA	6216	5744	472	7.6
CN2801500000000	28	015	Carroll County, MS	2006	NA	4846	4565	281	5.8
CN2801700000000	28	017	Chickasaw County, MS	2006	NA	7629	6965	664	8.7
CN2801900000000	28	019	Choctaw County, MS	2006	NA	3462	3205	257	7.4
CN2802100000000	28	021	Claiborne County, MS	2006	NA	3564	3183	381	10.7
CN2802300000000	28	023	Clarke County, MS	2006	NA	7068	6638	430	6.1
CN2802500000000	28	025	Clay County, MS	2006	NA	8180	7306	874	10.7
CN2802700000000	28	027	Coahoma County, MS	2006	NA	10678	9687	991	9.3
CN2802900000000	28	029	Copiah County, MS	2006	NA	12102	11274	828	6.8
CN2803100000000	28	031	Covington County, MS	2006	NA	8591	8106	485	5.6
CN2803300000000	28	033	DeSoto County, MS	2006	NA	73926	70983	2943	4
CN2803500000000	28	035	Forrest County, MS	2006	NA	36412	34542	1870	5.1
CN2803700000000	28	037	Franklin County, MS	2006	NA	3153	2944	209	6.6
CN2803900000000	28	039	George County, MS	2006	NA	8817	8020	797	9
CN2804100000000	28	041	Greene County, MS	2006	NA	4924	4560	364	7.4
CN2804300000000	28	043	Grenada County, MS	2006	NA	9803	9185	618	6.3
CN2804500000000	28	045	Hancock County, MS	2006	NA	18207	16455	1752	9.6
CN2804700000000	28	047	Harrison County, MS	2006	NA	82643	74359	8284	10
CN2804900000000	28	049	Hinds County, MS	2006	NA	118328	111647	6681	5.6
CN2805100000000	28	051	Holmes County, MS	2006	NA	7157	6424	733	10.2
CN2805300000000	28	053	Humphreys County, MS	2006	NA	4249	3869	380	8.9
CN2805500000000	28	055	Issaquena County, MS	2006	NA	729	659	70	9.6
CN2805700000000	28	057	Itawamba County, MS	2006	NA	10220	9580	640	6.3
CN2805900000000	28	059	Jackson County, MS	2006	NA	58419	53890	4529	7.8
CN2806100000000	28	061	Jasper County, MS	2006	NA	7518	7079	439	5.8
CN2806300000000	28	063	Jefferson County, MS	2006	NA	2723	2387	336	12.3
CN2806500000000	28	065	Jefferson Davis County, MS	2006	NA	5226	4840	386	7.4
CN2806700000000	28	067	Jones County, MS	2006	NA	30999	29561	1438	4.6
CN2806900000000	28	069	Kemper County, MS	2006	NA	4120	3784	336	8.2
CN2807100000000	28	071	Lafayette County, MS	2006	NA	21677	20692	985	4.5
CN2807300000000	28	073	Lamar County, MS	2006	NA	23222	22264	958	4.1
CN2807500000000	28	075	Lauderdale County, MS	2006	NA	33025	30971	2054	6.2
CN2807700000000	28	077	Lawrence County, MS	2006	NA	5071	4696	375	7.4
CN2807900000000	28	079	Leake County, MS	2006	NA	8220	7670	550	6.7
CN2808100000000	28	081	Lee County, MS	2006	NA	37754	35542	2212	5.9
CN2808300000000	28	083	Leflore County, MS	2006	NA	13792	12627	1165	8.4
CN2808500000000	28	085	Lincoln County, MS	2006	NA	14311	13465	846	5.9
CN2808700000000	28	087	Lowndes County, MS	2006	NA	25572	23877	1695	6.6
CN2808900000000	28	089	Madison County, MS	2006	NA	44449	42430	2019	4.5
CN2809100000000	28	091	Marion County, MS	2006	NA	10318	9666	652	6.3
CN2809300000000	28	093	Marshall County, MS	2006	NA	14986	13842	1144	7.6
CN2809500000000	28	095	Monroe County, MS	2006	NA	16639	15213	1426	8.6
CN2809700000000	28	097	Montgomery County, MS	2006	NA	4560	4155	405	8.9
CN2809900000000	28	099	Neshoba County, MS	2006	NA	14348	13652	696	4.9
CN2810100000000	28	101	Newton County, MS	2006	NA	9571	9033	538	5.6
CN2810300000000	28	103	Noxubee County, MS	2006	NA	4091	3628	463	11.3
CN2810500000000	28	105	Oktibbeha County, MS	2006	NA	19758	18653	1105	5.6
CN2810700000000	28	107	Panola County, MS	2006	NA	14852	13730	1122	7.6
CN2810900000000	28	109	Pearl River County, MS	2006	NA	20482	19139	1343	6.6
CN2811100000000	28	111	Perry County, MS	2006	NA	5114	4777	337	6.6
CN2811300000000	28	113	Pike County, MS	2006	NA	15458	14456	1002	6.5
CN2811500000000	28	115	Pontotoc County, MS	2006	NA	13289	12520	769	5.8
CN2811700000000	28	117	Prentiss County, MS	2006	NA	11159	10375	784	7
CN2811900000000	28	119	Quitman County, MS	2006	NA	3870	3551	319	8.2
CN2812100000000	28	121	Rankin County, MS	2006	NA	71927	69036	2891	4
CN2812300000000	28	123	Scott County, MS	2006	NA	13262	12566	696	5.2
CN2812500000000	28	125	Sharkey County, MS	2006	NA	2537	2303	234	9.2
CN2812700000000	28	127	Simpson County, MS	2006	NA	11658	11021	637	5.5
CN2812900000000	28	129	Smith County, MS	2006	NA	6772	6408	364	5.4
CN2813100000000	28	131	Stone County, MS	2006	NA	7252	6716	536	7.4
CN2813300000000	28	133	Sunflower County, MS	2006	NA	11172	10158	1014	9.1
CN2813500000000	28	135	Tallahatchie County, MS	2006	NA	6157	5699	458	7.4
CN2813700000000	28	137	Tate County, MS	2006	NA	11742	10974	768	6.5
CN2813900000000	28	139	Tippah County, MS	2006	NA	9311	8684	627	6.7
CN2814100000000	28	141	Tishomingo County, MS	2006	NA	8107	7529	578	7.1
CN2814300000000	28	143	Tunica County, MS	2006	NA	4357	4005	352	8.1
CN2814500000000	28	145	Union County, MS	2006	NA	11572	10892	680	5.9
CN2814700000000	28	147	Walthall County, MS	2006	NA	5824	5449	375	6.4
CN2814900000000	28	149	Warren County, MS	2006	NA	22385	21094	1291	5.8
CN2815100000000	28	151	Washington County, MS	2006	NA	22139	20065	2074	9.4
CN2815300000000	28	153	Wayne County, MS	2006	NA	8522	8008	514	6
CN2815500000000	28	155	Webster County, MS	2006	NA	3412	3140	272	8
CN2815700000000	28	157	Wilkinson County, MS	2006	NA	3505	3228	277	7.9
CN2815900000000	28	159	Winston County, MS	2006	NA	7927	7396	531	6.7
CN2816100000000	28	161	Yalobusha County, MS	2006	NA	5272	4876	396	7.5
CN2816300000000	28	163	Yazoo County, MS	2006	NA	10023	9188	835	8.3
CN2900100000000	29	001	Adair County, MO	2006	NA	13728	13136	592	4.3
CN2900300000000	29	003	Andrew County, MO	2006	NA	10194	9781	413	4.1
CN2900500000000	29	005	Atchison County, MO	2006	NA	3157	3033	124	3.9
CN2900700000000	29	007	Audrain County, MO	2006	NA	12098	11563	535	4.4
CN2900900000000	29	009	Barry County, MO	2006	NA	17790	17066	724	4.1
CN2901100000000	29	011	Barton County, MO	2006	NA	6083	5769	314	5.2
CN2901300000000	29	013	Bates County, MO	2006	NA	7941	7490	451	5.7
CN2901500000000	29	015	Benton County, MO	2006	NA	8525	8060	465	5.5
CN2901700000000	29	017	Bollinger County, MO	2006	NA	5862	5541	321	5.5
CN2901900000000	29	019	Boone County, MO	2006	NA	86737	83884	2853	3.3
CN2902100000000	29	021	Buchanan County, MO	2006	NA	46535	44413	2122	4.6
CN2902300000000	29	023	Butler County, MO	2006	NA	21826	20664	1162	5.3
CN2902500000000	29	025	Caldwell County, MO	2006	NA	4390	4157	233	5.3
CN2902700000000	29	027	Callaway County, MO	2006	NA	22599	21613	986	4.4
CN2902900000000	29	029	Camden County, MO	2006	NA	22324	21267	1057	4.7
CN2903100000000	29	031	Cape Girardeau County, MO	2006	NA	38626	37034	1592	4.1
CN2903300000000	29	033	Carroll County, MO	2006	NA	5284	5042	242	4.6
CN2903500000000	29	035	Carter County, MO	2006	NA	2964	2789	175	5.9
CN2903700000000	29	037	Cass County, MO	2006	NA	49374	47112	2262	4.6
CN2903900000000	29	039	Cedar County, MO	2006	NA	6371	6045	326	5.1
CN2904100000000	29	041	Chariton County, MO	2006	NA	4061	3857	204	5
CN2904300000000	29	043	Christian County, MO	2006	NA	39127	37659	1468	3.8
CN2904500000000	29	045	Clark County, MO	2006	NA	3575	3396	179	5
CN2904700000000	29	047	Clay County, MO	2006	NA	113806	108913	4893	4.3
CN2904900000000	29	049	Clinton County, MO	2006	NA	10278	9771	507	4.9
CN2905100000000	29	051	Cole County, MO	2006	NA	39989	38468	1521	3.8
CN2905300000000	29	053	Cooper County, MO	2006	NA	9111	8720	391	4.3
CN2905500000000	29	055	Crawford County, MO	2006	NA	12076	11379	697	5.8
CN2905700000000	29	057	Dade County, MO	2006	NA	3880	3699	181	4.7
CN2905900000000	29	059	Dallas County, MO	2006	NA	7579	7191	388	5.1
CN2906100000000	29	061	Daviess County, MO	2006	NA	4097	3916	181	4.4
CN2906300000000	29	063	DeKalb County, MO	2006	NA	5196	4918	278	5.4
CN2906500000000	29	065	Dent County, MO	2006	NA	6660	6269	391	5.9
CN2906700000000	29	067	Douglas County, MO	2006	NA	6006	5685	321	5.3
CN2906900000000	29	069	Dunklin County, MO	2006	NA	14572	13545	1027	7
CN2907100000000	29	071	Franklin County, MO	2006	NA	52801	50008	2793	5.3
CN2907300000000	29	073	Gasconade County, MO	2006	NA	8174	7731	443	5.4
CN2907500000000	29	075	Gentry County, MO	2006	NA	3395	3258	137	4
CN2907700000000	29	077	Greene County, MO	2006	NA	139277	134046	5231	3.8
CN2907900000000	29	079	Grundy County, MO	2006	NA	4854	4633	221	4.6
CN2908100000000	29	081	Harrison County, MO	2006	NA	4584	4372	212	4.6
CN2908300000000	29	083	Henry County, MO	2006	NA	10870	10314	556	5.1
CN2908500000000	29	085	Hickory County, MO	2006	NA	3410	3174	236	6.9
CN2908700000000	29	087	Holt County, MO	2006	NA	2706	2598	108	4
CN2908900000000	29	089	Howard County, MO	2006	NA	5379	5140	239	4.4
CN2909100000000	29	091	Howell County, MO	2006	NA	20009	19170	839	4.2
CN2909300000000	29	093	Iron County, MO	2006	NA	5014	4741	273	5.4
CN2909500000000	29	095	Jackson County, MO	2006	NA	335295	316140	19155	5.7
CN2909700000000	29	097	Jasper County, MO	2006	NA	55703	53329	2374	4.3
CN2909900000000	29	099	Jefferson County, MO	2006	NA	116819	111115	5704	4.9
CN2910100000000	29	101	Johnson County, MO	2006	NA	26577	25517	1060	4
CN2910300000000	29	103	Knox County, MO	2006	NA	2357	2265	92	3.9
CN2910500000000	29	105	Laclede County, MO	2006	NA	17611	16780	831	4.7
CN2910700000000	29	107	Lafayette County, MO	2006	NA	16673	15873	800	4.8
CN2910900000000	29	109	Lawrence County, MO	2006	NA	19294	18545	749	3.9
CN2911100000000	29	111	Lewis County, MO	2006	NA	5802	5586	216	3.7
CN2911300000000	29	113	Lincoln County, MO	2006	NA	25735	24382	1353	5.3
CN2911500000000	29	115	Linn County, MO	2006	NA	6598	6170	428	6.5
CN2911700000000	29	117	Livingston County, MO	2006	NA	7100	6797	303	4.3
CN2911900000000	29	119	McDonald County, MO	2006	NA	11914	11453	461	3.9
CN2912100000000	29	121	Macon County, MO	2006	NA	8288	7889	399	4.8
CN2912300000000	29	123	Madison County, MO	2006	NA	6024	5702	322	5.3
CN2912500000000	29	125	Maries County, MO	2006	NA	4868	4650	218	4.5
CN2912700000000	29	127	Marion County, MO	2006	NA	14478	13769	709	4.9
CN2912900000000	29	129	Mercer County, MO	2006	NA	1850	1771	79	4.3
CN2913100000000	29	131	Miller County, MO	2006	NA	13562	12859	703	5.2
CN2913300000000	29	133	Mississippi County, MO	2006	NA	5924	5545	379	6.4
CN2913500000000	29	135	Moniteau County, MO	2006	NA	7472	7125	347	4.6
CN2913700000000	29	137	Monroe County, MO	2006	NA	4409	4171	238	5.4
CN2913900000000	29	139	Montgomery County, MO	2006	NA	6292	5950	342	5.4
CN2914100000000	29	141	Morgan County, MO	2006	NA	9554	8922	632	6.6
CN2914300000000	29	143	New Madrid County, MO	2006	NA	8736	8176	560	6.4
CN2914500000000	29	145	Newton County, MO	2006	NA	28111	26842	1269	4.5
CN2914700000000	29	147	Nodaway County, MO	2006	NA	12618	12193	425	3.4
CN2914900000000	29	149	Oregon County, MO	2006	NA	4371	4158	213	4.9
CN2915100000000	29	151	Osage County, MO	2006	NA	7438	7097	341	4.6
CN2915300000000	29	153	Ozark County, MO	2006	NA	4461	4253	208	4.7
CN2915500000000	29	155	Pemiscot County, MO	2006	NA	8164	7625	539	6.6
CN2915700000000	29	157	Perry County, MO	2006	NA	10506	10140	366	3.5
CN2915900000000	29	159	Pettis County, MO	2006	NA	20699	19653	1046	5.1
CN2916100000000	29	161	Phelps County, MO	2006	NA	22495	21522	973	4.3
CN2916300000000	29	163	Pike County, MO	2006	NA	8969	8509	460	5.1
CN2916500000000	29	165	Platte County, MO	2006	NA	47736	45849	1887	4
CN2916700000000	29	167	Polk County, MO	2006	NA	14309	13677	632	4.4
CN2916900000000	29	169	Pulaski County, MO	2006	NA	18565	17674	891	4.8
CN2917100000000	29	171	Putnam County, MO	2006	NA	2557	2431	126	4.9
CN2917300000000	29	173	Ralls County, MO	2006	NA	5636	5360	276	4.9
CN2917500000000	29	175	Randolph County, MO	2006	NA	13189	12543	646	4.9
CN2917700000000	29	177	Ray County, MO	2006	NA	11737	11127	610	5.2
CN2917900000000	29	179	Reynolds County, MO	2006	NA	2552	2379	173	6.8
CN2918100000000	29	181	Ripley County, MO	2006	NA	6654	6274	380	5.7
CN2918300000000	29	183	St. Charles County, MO	2006	NA	190749	183305	7444	3.9
CN2918500000000	29	185	St. Clair County, MO	2006	NA	4373	4127	246	5.6
CN2918600000000	29	186	Ste. Genevieve County, MO	2006	NA	9860	9407	453	4.6
CN2918700000000	29	187	St. Francois County, MO	2006	NA	28365	26702	1663	5.9
CN2918900000000	29	189	St. Louis County, MO	2006	NA	531639	506604	25035	4.7
CN2919500000000	29	195	Saline County, MO	2006	NA	11984	11439	545	4.5
CN2919700000000	29	197	Schuyler County, MO	2006	NA	2308	2188	120	5.2
CN2919900000000	29	199	Scotland County, MO	2006	NA	2481	2375	106	4.3
CN2920100000000	29	201	Scott County, MO	2006	NA	20503	19422	1081	5.3
CN2920300000000	29	203	Shannon County, MO	2006	NA	3765	3519	246	6.5
CN2920500000000	29	205	Shelby County, MO	2006	NA	3236	3068	168	5.2
CN2920700000000	29	207	Stoddard County, MO	2006	NA	15893	15000	893	5.6
CN2920900000000	29	209	Stone County, MO	2006	NA	16373	15281	1092	6.7
CN2921100000000	29	211	Sullivan County, MO	2006	NA	3372	3188	184	5.5
CN2921300000000	29	213	Taney County, MO	2006	NA	26325	24500	1825	6.9
CN2921500000000	29	215	Texas County, MO	2006	NA	10723	10145	578	5.4
CN2921700000000	29	217	Vernon County, MO	2006	NA	10176	9730	446	4.4
CN2921900000000	29	219	Warren County, MO	2006	NA	15848	15004	844	5.3
CN2922100000000	29	221	Washington County, MO	2006	NA	10004	9201	803	8
CN2922300000000	29	223	Wayne County, MO	2006	NA	5745	5382	363	6.3
CN2922500000000	29	225	Webster County, MO	2006	NA	17078	16353	725	4.2
CN2922700000000	29	227	Worth County, MO	2006	NA	1165	1120	45	3.9
CN2922900000000	29	229	Wright County, MO	2006	NA	8209	7790	419	5.1
CN2951000000000	29	510	St. Louis city, MO	2006	NA	156927	146090	10837	6.9
CN3000100000000	30	001	Beaverhead County, MT	2006	NA	5053	4900	153	3
CN3000300000000	30	003	Big Horn County, MT	2006	NA	4999	4655	344	6.9
CN3000500000000	30	005	Blaine County, MT	2006	NA	2812	2716	96	3.4
CN3000700000000	30	007	Broadwater County, MT	2006	NA	2297	2222	75	3.3
CN3000900000000	30	009	Carbon County, MT	2006	NA	5390	5227	163	3
CN3001100000000	30	011	Carter County, MT	2006	NA	667	643	24	3.6
CN3001300000000	30	013	Cascade County, MT	2006	NA	39435	38102	1333	3.4
CN3001500000000	30	015	Chouteau County, MT	2006	NA	2578	2505	73	2.8
CN3001700000000	30	017	Custer County, MT	2006	NA	5693	5508	185	3.2
CN3001900000000	30	019	Daniels County, MT	2006	NA	758	734	24	3.2
CN3002100000000	30	021	Dawson County, MT	2006	NA	4156	4034	122	2.9
CN3002300000000	30	023	Deer Lodge County, MT	2006	NA	3893	3701	192	4.9
CN3002500000000	30	025	Fallon County, MT	2006	NA	1767	1732	35	2
CN3002700000000	30	027	Fergus County, MT	2006	NA	5745	5505	240	4.2
CN3002900000000	30	029	Flathead County, MT	2006	NA	44224	42504	1720	3.9
CN3003100000000	30	031	Gallatin County, MT	2006	NA	49210	48009	1201	2.4
CN3003300000000	30	033	Garfield County, MT	2006	NA	638	615	23	3.6
CN3003500000000	30	035	Glacier County, MT	2006	NA	5981	5575	406	6.8
CN3003700000000	30	037	Golden Valley County, MT	2006	NA	529	509	20	3.8
CN3003900000000	30	039	Granite County, MT	2006	NA	1246	1190	56	4.5
CN3004100000000	30	041	Hill County, MT	2006	NA	7904	7597	307	3.9
CN3004300000000	30	043	Jefferson County, MT	2006	NA	5739	5531	208	3.6
CN3004500000000	30	045	Judith Basin County, MT	2006	NA	1042	1006	36	3.5
CN3004700000000	30	047	Lake County, MT	2006	NA	11509	10947	562	4.9
CN3004900000000	30	049	Lewis and Clark County, MT	2006	NA	31787	30763	1024	3.2
CN3005100000000	30	051	Liberty County, MT	2006	NA	824	798	26	3.2
CN3005300000000	30	053	Lincoln County, MT	2006	NA	7722	7193	529	6.9
CN3005500000000	30	055	McCone County, MT	2006	NA	994	968	26	2.6
CN3005700000000	30	057	Madison County, MT	2006	NA	4089	3962	127	3.1
CN3005900000000	30	059	Meagher County, MT	2006	NA	904	864	40	4.4
CN3006100000000	30	061	Mineral County, MT	2006	NA	1956	1859	97	5
CN3006300000000	30	063	Missoula County, MT	2006	NA	58662	56793	1869	3.2
CN3006500000000	30	065	Musselshell County, MT	2006	NA	2076	1992	84	4
CN3006700000000	30	067	Park County, MT	2006	NA	9235	8930	305	3.3
CN3006900000000	30	069	Petroleum County, MT	2006	NA	225	215	10	4.4
CN3007100000000	30	071	Phillips County, MT	2006	NA	2068	1989	79	3.8
CN3007300000000	30	073	Pondera County, MT	2006	NA	2738	2628	110	4
CN3007500000000	30	075	Powder River County, MT	2006	NA	896	867	29	3.2
CN3007700000000	30	077	Powell County, MT	2006	NA	2662	2527	135	5.1
CN3007900000000	30	079	Prairie County, MT	2006	NA	549	527	22	4
CN3008100000000	30	081	Ravalli County, MT	2006	NA	18645	17855	790	4.2
CN3008300000000	30	083	Richland County, MT	2006	NA	5107	4968	139	2.7
CN3008500000000	30	085	Roosevelt County, MT	2006	NA	3891	3655	236	6.1
CN3008700000000	30	087	Rosebud County, MT	2006	NA	3864	3648	216	5.6
CN3008900000000	30	089	Sanders County, MT	2006	NA	4659	4413	246	5.3
CN3009100000000	30	091	Sheridan County, MT	2006	NA	1714	1662	52	3
CN3009300000000	30	093	Silver Bow County, MT	2006	NA	17291	16641	650	3.8
CN3009500000000	30	095	Stillwater County, MT	2006	NA	4435	4309	126	2.8
CN3009700000000	30	097	Sweet Grass County, MT	2006	NA	2816	2767	49	1.7
CN3009900000000	30	099	Teton County, MT	2006	NA	3024	2929	95	3.1
CN3010100000000	30	101	Toole County, MT	2006	NA	2479	2410	69	2.8
CN3010300000000	30	103	Treasure County, MT	2006	NA	396	383	13	3.3
CN3010500000000	30	105	Valley County, MT	2006	NA	3577	3459	118	3.3
CN3010700000000	30	107	Wheatland County, MT	2006	NA	1009	979	30	3
CN3010900000000	30	109	Wibaux County, MT	2006	NA	497	483	14	2.8
CN3011100000000	30	111	Yellowstone County, MT	2006	NA	79565	77278	2287	2.9
CN3100100000000	31	001	Adams County, NE	2006	NA	16764	16274	490	2.9
CN3100300000000	31	003	Antelope County, NE	2006	NA	3759	3652	107	2.8
CN3100500000000	31	005	Arthur County, NE	2006	NA	254	245	9	3.5
CN3100700000000	31	007	Banner County, NE	2006	NA	418	408	10	2.4
CN3100900000000	31	009	Blaine County, NE	2006	NA	270	262	8	3
CN3101100000000	31	011	Boone County, NE	2006	NA	3164	3083	81	2.6
CN3101300000000	31	013	Box Butte County, NE	2006	NA	5527	5358	169	3.1
CN3101500000000	31	015	Boyd County, NE	2006	NA	1118	1082	36	3.2
CN3101700000000	31	017	Brown County, NE	2006	NA	1903	1848	55	2.9
CN3101900000000	31	019	Buffalo County, NE	2006	NA	27455	26831	624	2.3
CN3102100000000	31	021	Burt County, NE	2006	NA	3894	3734	160	4.1
CN3102300000000	31	023	Butler County, NE	2006	NA	4730	4601	129	2.7
CN3102500000000	31	025	Cass County, NE	2006	NA	13988	13516	472	3.4
CN3102700000000	31	027	Cedar County, NE	2006	NA	4908	4794	114	2.3
CN3102900000000	31	029	Chase County, NE	2006	NA	2099	2048	51	2.4
CN3103100000000	31	031	Cherry County, NE	2006	NA	3620	3539	81	2.2
CN3103300000000	31	033	Cheyenne County, NE	2006	NA	5204	5080	124	2.4
CN3103500000000	31	035	Clay County, NE	2006	NA	3095	3001	94	3
CN3103700000000	31	037	Colfax County, NE	2006	NA	5699	5566	133	2.3
CN3103900000000	31	039	Cuming County, NE	2006	NA	5059	4904	155	3.1
CN3104100000000	31	041	Custer County, NE	2006	NA	6131	5984	147	2.4
CN3104300000000	31	043	Dakota County, NE	2006	NA	10609	10179	430	4.1
CN3104500000000	31	045	Dawes County, NE	2006	NA	4661	4528	133	2.9
CN3104700000000	31	047	Dawson County, NE	2006	NA	12401	12005	396	3.2
CN3104900000000	31	049	Deuel County, NE	2006	NA	1069	1040	29	2.7
CN3105100000000	31	051	Dixon County, NE	2006	NA	3134	3036	98	3.1
CN3105300000000	31	053	Dodge County, NE	2006	NA	19648	18963	685	3.5
CN3105500000000	31	055	Douglas County, NE	2006	NA	265341	256013	9328	3.5
CN3105700000000	31	057	Dundy County, NE	2006	NA	1034	1001	33	3.2
CN3105900000000	31	059	Fillmore County, NE	2006	NA	3303	3214	89	2.7
CN3106100000000	31	061	Franklin County, NE	2006	NA	1852	1794	58	3.1
CN3106300000000	31	063	Frontier County, NE	2006	NA	1768	1729	39	2.2
CN3106500000000	31	065	Furnas County, NE	2006	NA	2476	2402	74	3
CN3106700000000	31	067	Gage County, NE	2006	NA	12666	12191	475	3.8
CN3106900000000	31	069	Garden County, NE	2006	NA	1015	985	30	3
CN3107100000000	31	071	Garfield County, NE	2006	NA	1050	1023	27	2.6
CN3107300000000	31	073	Gosper County, NE	2006	NA	1036	1006	30	2.9
CN3107500000000	31	075	Grant County, NE	2006	NA	411	402	9	2.2
CN3107700000000	31	077	Greeley County, NE	2006	NA	1339	1299	40	3
CN3107900000000	31	079	Hall County, NE	2006	NA	30397	29451	946	3.1
CN3108100000000	31	081	Hamilton County, NE	2006	NA	5421	5299	122	2.3
CN3108300000000	31	083	Harlan County, NE	2006	NA	1790	1744	46	2.6
CN3108500000000	31	085	Hayes County, NE	2006	NA	496	480	16	3.2
CN3108700000000	31	087	Hitchcock County, NE	2006	NA	1484	1432	52	3.5
CN3108900000000	31	089	Holt County, NE	2006	NA	6157	5989	168	2.7
CN3109100000000	31	091	Hooker County, NE	2006	NA	500	486	14	2.8
CN3109300000000	31	093	Howard County, NE	2006	NA	3707	3601	106	2.9
CN3109500000000	31	095	Jefferson County, NE	2006	NA	4375	4233	142	3.2
CN3109700000000	31	097	Johnson County, NE	2006	NA	3214	3115	99	3.1
CN3109900000000	31	099	Kearney County, NE	2006	NA	3875	3785	90	2.3
CN3110100000000	31	101	Keith County, NE	2006	NA	4740	4617	123	2.6
CN3110300000000	31	103	Keya Paha County, NE	2006	NA	427	414	13	3
CN3110500000000	31	105	Kimball County, NE	2006	NA	2020	1965	55	2.7
CN3110700000000	31	107	Knox County, NE	2006	NA	4804	4658	146	3
CN3110900000000	31	109	Lancaster County, NE	2006	NA	155780	151362	4418	2.8
CN3111100000000	31	111	Lincoln County, NE	2006	NA	21171	20575	596	2.8
CN3111300000000	31	113	Logan County, NE	2006	NA	452	442	10	2.2
CN3111500000000	31	115	Loup County, NE	2006	NA	354	341	13	3.7
CN3111700000000	31	117	McPherson County, NE	2006	NA	287	281	6	2.1
CN3111900000000	31	119	Madison County, NE	2006	NA	19289	18569	720	3.7
CN3112100000000	31	121	Merrick County, NE	2006	NA	4262	4109	153	3.6
CN3112300000000	31	123	Morrill County, NE	2006	NA	2797	2724	73	2.6
CN3112500000000	31	125	Nance County, NE	2006	NA	2010	1952	58	2.9
CN3112700000000	31	127	Nemaha County, NE	2006	NA	3551	3407	144	4.1
CN3112900000000	31	129	Nuckolls County, NE	2006	NA	2338	2274	64	2.7
CN3113100000000	31	131	Otoe County, NE	2006	NA	8728	8444	284	3.3
CN3113300000000	31	133	Pawnee County, NE	2006	NA	1622	1572	50	3.1
CN3113500000000	31	135	Perkins County, NE	2006	NA	1582	1547	35	2.2
CN3113700000000	31	137	Phelps County, NE	2006	NA	5175	5057	118	2.3
CN3113900000000	31	139	Pierce County, NE	2006	NA	4047	3928	119	2.9
CN3114100000000	31	141	Platte County, NE	2006	NA	17596	17103	493	2.8
CN3114300000000	31	143	Polk County, NE	2006	NA	3045	2961	84	2.8
CN3114500000000	31	145	Red Willow County, NE	2006	NA	5949	5788	161	2.7
CN3114700000000	31	147	Richardson County, NE	2006	NA	4361	4182	179	4.1
CN3114900000000	31	149	Rock County, NE	2006	NA	950	928	22	2.3
CN3115100000000	31	151	Saline County, NE	2006	NA	8176	7952	224	2.7
CN3115300000000	31	153	Sarpy County, NE	2006	NA	74097	71915	2182	2.9
CN3115500000000	31	155	Saunders County, NE	2006	NA	10958	10622	336	3.1
CN3115700000000	31	157	Scotts Bluff County, NE	2006	NA	19026	18389	637	3.3
CN3115900000000	31	159	Seward County, NE	2006	NA	9234	8983	251	2.7
CN3116100000000	31	161	Sheridan County, NE	2006	NA	3238	3152	86	2.7
CN3116300000000	31	163	Sherman County, NE	2006	NA	1878	1825	53	2.8
CN3116500000000	31	165	Sioux County, NE	2006	NA	746	725	21	2.8
CN3116700000000	31	167	Stanton County, NE	2006	NA	3605	3494	111	3.1
CN3116900000000	31	169	Thayer County, NE	2006	NA	2899	2825	74	2.6
CN3117100000000	31	171	Thomas County, NE	2006	NA	393	380	13	3.3
CN3117300000000	31	173	Thurston County, NE	2006	NA	3006	2800	206	6.9
CN3117500000000	31	175	Valley County, NE	2006	NA	2564	2500	64	2.5
CN3117700000000	31	177	Washington County, NE	2006	NA	11233	10911	322	2.9
CN3117900000000	31	179	Wayne County, NE	2006	NA	5451	5312	139	2.5
CN3118100000000	31	181	Webster County, NE	2006	NA	1990	1939	51	2.6
CN3118300000000	31	183	Wheeler County, NE	2006	NA	452	441	11	2.4
CN3118500000000	31	185	York County, NE	2006	NA	8489	8281	208	2.5
CN3200100000000	32	001	Churchill County, NV	2006	NA	12789	12255	534	4.2
CN3200300000000	32	003	Clark County, NV	2006	NA	917900	881109	36791	4
CN3200500000000	32	005	Douglas County, NV	2006	NA	22270	21256	1014	4.6
CN3200700000000	32	007	Elko County, NV	2006	NA	24686	23840	846	3.4
CN3200900000000	32	009	Esmeralda County, NV	2006	NA	468	449	19	4.1
CN3201100000000	32	011	Eureka County, NV	2006	NA	710	684	26	3.7
CN3201300000000	32	013	Humboldt County, NV	2006	NA	8074	7782	292	3.6
CN3201500000000	32	015	Lander County, NV	2006	NA	2771	2664	107	3.9
CN3201700000000	32	017	Lincoln County, NV	2006	NA	1610	1537	73	4.5
CN3201900000000	32	019	Lyon County, NV	2006	NA	21234	19971	1263	5.9
CN3202100000000	32	021	Mineral County, NV	2006	NA	2056	1918	138	6.7
CN3202300000000	32	023	Nye County, NV	2006	NA	17175	16228	947	5.5
CN3202700000000	32	027	Pershing County, NV	2006	NA	2442	2322	120	4.9
CN3202900000000	32	029	Storey County, NV	2006	NA	2349	2251	98	4.2
CN3203100000000	32	031	Washoe County, NV	2006	NA	216723	208382	8341	3.8
CN3203300000000	32	033	White Pine County, NV	2006	NA	4473	4309	164	3.7
CN3251000000000	32	510	Carson City, NV	2006	NA	27589	26331	1258	4.6
CN3300100000000	33	001	Belknap County, NH	2006	NA	32515	31439	1076	3.3
CN3300300000000	33	003	Carroll County, NH	2006	NA	25329	24507	822	3.2
CN3300500000000	33	005	Cheshire County, NH	2006	NA	42483	41112	1371	3.2
CN3300700000000	33	007	Coos County, NH	2006	NA	16820	16122	698	4.1
CN3300900000000	33	009	Grafton County, NH	2006	NA	47854	46483	1371	2.9
CN3301100000000	33	011	Hillsborough County, NH	2006	NA	226541	218494	8047	3.6
CN3301300000000	33	013	Merrimack County, NH	2006	NA	79556	77069	2487	3.1
CN3301500000000	33	015	Rockingham County, NH	2006	NA	171538	165095	6443	3.8
CN3301700000000	33	017	Strafford County, NH	2006	NA	66852	64741	2111	3.2
CN3301900000000	33	019	Sullivan County, NH	2006	NA	22371	21717	654	2.9
CN3400100000000	34	001	Atlantic County, NJ	2006	NA	138555	130556	7999	5.8
CN3400300000000	34	003	Bergen County, NJ	2006	NA	471181	452733	18448	3.9
CN3400500000000	34	005	Burlington County, NJ	2006	NA	240366	230329	10037	4.2
CN3400700000000	34	007	Camden County, NJ	2006	NA	265339	251306	14033	5.3
CN3400900000000	34	009	Cape May County, NJ	2006	NA	57588	53574	4014	7
CN3401100000000	34	011	Cumberland County, NJ	2006	NA	69235	64368	4867	7
CN3401300000000	34	013	Essex County, NJ	2006	NA	362670	341287	21383	5.9
CN3401500000000	34	015	Gloucester County, NJ	2006	NA	152501	145254	7247	4.8
CN3401700000000	34	017	Hudson County, NJ	2006	NA	288996	272886	16110	5.6
CN3401900000000	34	019	Hunterdon County, NJ	2006	NA	72102	69670	2432	3.4
CN3402100000000	34	021	Mercer County, NJ	2006	NA	195577	187145	8432	4.3
CN3402300000000	34	023	Middlesex County, NJ	2006	NA	420036	401589	18447	4.4
CN3402500000000	34	025	Monmouth County, NJ	2006	NA	327654	314026	13628	4.2
CN3402700000000	34	027	Morris County, NJ	2006	NA	271011	261872	9139	3.4
CN3402900000000	34	029	Ocean County, NJ	2006	NA	255188	242397	12791	5
CN3403100000000	34	031	Passaic County, NJ	2006	NA	236210	222817	13393	5.7
CN3403300000000	34	033	Salem County, NJ	2006	NA	31536	29932	1604	5.1
CN3403500000000	34	035	Somerset County, NJ	2006	NA	179540	173281	6259	3.5
CN3403700000000	34	037	Sussex County, NJ	2006	NA	84041	80543	3498	4.2
CN3403900000000	34	039	Union County, NJ	2006	NA	267378	254202	13176	4.9
CN3404100000000	34	041	Warren County, NJ	2006	NA	59176	56718	2458	4.2
CN3500100000000	35	001	Bernalillo County, NM	2006	NA	310792	298859	11933	3.8
CN3500300000000	35	003	Catron County, NM	2006	NA	1449	1371	78	5.4
CN3500500000000	35	005	Chaves County, NM	2006	NA	26640	25468	1172	4.4
CN3500600000000	35	006	Cibola County, NM	2006	NA	12093	11542	551	4.6
CN3500700000000	35	007	Colfax County, NM	2006	NA	6535	6250	285	4.4
CN3500900000000	35	009	Curry County, NM	2006	NA	20954	20234	720	3.4
CN3501100000000	35	011	De Baca County, NM	2006	NA	808	774	34	4.2
CN3501300000000	35	013	Dona Ana County, NM	2006	NA	85792	81800	3992	4.7
CN3501500000000	35	015	Eddy County, NM	2006	NA	25144	24252	892	3.5
CN3501700000000	35	017	Grant County, NM	2006	NA	12231	11709	522	4.3
CN3501900000000	35	019	Guadalupe County, NM	2006	NA	1866	1767	99	5.3
CN3502100000000	35	021	Harding County, NM	2006	NA	364	349	15	4.1
CN3502300000000	35	023	Hidalgo County, NM	2006	NA	2436	2349	87	3.6
CN3502500000000	35	025	Lea County, NM	2006	NA	26605	25780	825	3.1
CN3502700000000	35	027	Lincoln County, NM	2006	NA	10506	10097	409	3.9
CN3502800000000	35	028	Los Alamos County, NM	2006	NA	11107	10839	268	2.4
CN3502900000000	35	029	Luna County, NM	2006	NA	12323	10991	1332	10.8
CN3503100000000	35	031	McKinley County, NM	2006	NA	26616	25136	1480	5.6
CN3503300000000	35	033	Mora County, NM	2006	NA	2005	1830	175	8.7
CN3503500000000	35	035	Otero County, NM	2006	NA	26045	24947	1098	4.2
CN3503700000000	35	037	Quay County, NM	2006	NA	3942	3760	182	4.6
CN3503900000000	35	039	Rio Arriba County, NM	2006	NA	20700	19670	1030	5
CN3504100000000	35	041	Roosevelt County, NM	2006	NA	9334	9044	290	3.1
CN3504300000000	35	043	Sandoval County, NM	2006	NA	52932	50664	2268	4.3
CN3504500000000	35	045	San Juan County, NM	2006	NA	55362	52987	2375	4.3
CN3504700000000	35	047	San Miguel County, NM	2006	NA	13382	12742	640	4.8
CN3504900000000	35	049	Santa Fe County, NM	2006	NA	77340	74708	2632	3.4
CN3505100000000	35	051	Sierra County, NM	2006	NA	5417	5178	239	4.4
CN3505300000000	35	053	Socorro County, NM	2006	NA	9286	8944	342	3.7
CN3505500000000	35	055	Taos County, NM	2006	NA	17618	16650	968	5.5
CN3505700000000	35	057	Torrance County, NM	2006	NA	7584	7255	329	4.3
CN3505900000000	35	059	Union County, NM	2006	NA	1899	1842	57	3
CN3506100000000	35	061	Valencia County, NM	2006	NA	30991	29661	1330	4.3
CN3600100000000	36	001	Albany County, NY	2006	NA	159472	153385	6087	3.8
CN3600300000000	36	003	Allegany County, NY	2006	NA	23521	22306	1215	5.2
CN3600500000000	36	005	Bronx County, NY	2006	NA	505378	471748	33630	6.7
CN3600700000000	36	007	Broome County, NY	2006	NA	96998	92545	4453	4.6
CN3600900000000	36	009	Cattaraugus County, NY	2006	NA	41925	39788	2137	5.1
CN3601100000000	36	011	Cayuga County, NY	2006	NA	41499	39566	1933	4.7
CN3601300000000	36	013	Chautauqua County, NY	2006	NA	67135	64126	3009	4.5
CN3601500000000	36	015	Chemung County, NY	2006	NA	40851	38879	1972	4.8
CN3601700000000	36	017	Chenango County, NY	2006	NA	24712	23514	1198	4.8
CN3601900000000	36	019	Clinton County, NY	2006	NA	40064	37932	2132	5.3
CN3602100000000	36	021	Columbia County, NY	2006	NA	32320	31135	1185	3.7
CN3602300000000	36	023	Cortland County, NY	2006	NA	23774	22524	1250	5.3
CN3602500000000	36	025	Delaware County, NY	2006	NA	23509	22509	1000	4.3
CN3602700000000	36	027	Dutchess County, NY	2006	NA	147568	141973	5595	3.8
CN3602900000000	36	029	Erie County, NY	2006	NA	471116	448117	22999	4.9
CN3603100000000	36	031	Essex County, NY	2006	NA	18738	17703	1035	5.5
CN3603300000000	36	033	Franklin County, NY	2006	NA	22657	21424	1233	5.4
CN3603500000000	36	035	Fulton County, NY	2006	NA	27426	25995	1431	5.2
CN3603700000000	36	037	Genesee County, NY	2006	NA	33119	31613	1506	4.5
CN3603900000000	36	039	Greene County, NY	2006	NA	24099	22967	1132	4.7
CN3604100000000	36	041	Hamilton County, NY	2006	NA	3119	2964	155	5
CN3604300000000	36	043	Herkimer County, NY	2006	NA	31400	29856	1544	4.9
CN3604500000000	36	045	Jefferson County, NY	2006	NA	48402	45771	2631	5.4
CN3604700000000	36	047	Kings County, NY	2006	NA	1073743	1016247	57496	5.4
CN3604900000000	36	049	Lewis County, NY	2006	NA	13042	12338	704	5.4
CN3605100000000	36	051	Livingston County, NY	2006	NA	32877	31306	1571	4.8
CN3605300000000	36	053	Madison County, NY	2006	NA	36087	34444	1643	4.6
CN3605500000000	36	055	Monroe County, NY	2006	NA	375168	358950	16218	4.3
CN3605700000000	36	057	Montgomery County, NY	2006	NA	24963	23542	1421	5.7
CN3605900000000	36	059	Nassau County, NY	2006	NA	696480	670604	25876	3.7
CN3606100000000	36	061	New York County, NY	2006	NA	909103	869930	39173	4.3
CN3606300000000	36	063	Niagara County, NY	2006	NA	112203	106228	5975	5.3
CN3606500000000	36	065	Oneida County, NY	2006	NA	110879	106093	4786	4.3
CN3606700000000	36	067	Onondaga County, NY	2006	NA	234218	224259	9959	4.3
CN3606900000000	36	069	Ontario County, NY	2006	NA	56820	54357	2463	4.3
CN3607100000000	36	071	Orange County, NY	2006	NA	179908	172387	7521	4.2
CN3607300000000	36	073	Orleans County, NY	2006	NA	19927	18811	1116	5.6
CN3607500000000	36	075	Oswego County, NY	2006	NA	60265	56799	3466	5.8
CN3607700000000	36	077	Otsego County, NY	2006	NA	31984	30585	1399	4.4
CN3607900000000	36	079	Putnam County, NY	2006	NA	56183	54225	1958	3.5
CN3608100000000	36	081	Queens County, NY	2006	NA	1091546	1042607	48939	4.5
CN3608300000000	36	083	Rensselaer County, NY	2006	NA	83873	80475	3398	4.1
CN3608500000000	36	085	Richmond County, NY	2006	NA	236624	226076	10548	4.5
CN3608700000000	36	087	Rockland County, NY	2006	NA	152379	146739	5640	3.7
CN3608900000000	36	089	St. Lawrence County, NY	2006	NA	49620	46793	2827	5.7
CN3609100000000	36	091	Saratoga County, NY	2006	NA	120351	116140	4211	3.5
CN3609300000000	36	093	Schenectady County, NY	2006	NA	76133	73050	3083	4
CN3609500000000	36	095	Schoharie County, NY	2006	NA	15849	15045	804	5.1
CN3609700000000	36	097	Schuyler County, NY	2006	NA	9969	9470	499	5
CN3609900000000	36	099	Seneca County, NY	2006	NA	17336	16563	773	4.5
CN3610100000000	36	101	Steuben County, NY	2006	NA	44698	42367	2331	5.2
CN3610300000000	36	103	Suffolk County, NY	2006	NA	787066	756494	30572	3.9
CN3610500000000	36	105	Sullivan County, NY	2006	NA	35383	33611	1772	5
CN3610700000000	36	107	Tioga County, NY	2006	NA	26454	25325	1129	4.3
CN3610900000000	36	109	Tompkins County, NY	2006	NA	55378	53506	1872	3.4
CN3611100000000	36	111	Ulster County, NY	2006	NA	92551	88744	3807	4.1
CN3611300000000	36	113	Warren County, NY	2006	NA	36502	34876	1626	4.5
CN3611500000000	36	115	Washington County, NY	2006	NA	32887	31550	1337	4.1
CN3611700000000	36	117	Wayne County, NY	2006	NA	48603	46348	2255	4.6
CN3611900000000	36	119	Westchester County, NY	2006	NA	487426	469034	18392	3.8
CN3612100000000	36	121	Wyoming County, NY	2006	NA	21824	20767	1057	4.8
CN3612300000000	36	123	Yates County, NY	2006	NA	13056	12509	547	4.2
CN3700100000000	37	001	Alamance County, NC	2006	NA	69615	65815	3800	5.5
CN3700300000000	37	003	Alexander County, NC	2006	NA	18500	17610	890	4.8
CN3700500000000	37	005	Alleghany County, NC	2006	NA	4950	4704	246	5
CN3700700000000	37	007	Anson County, NC	2006	NA	10670	9866	804	7.5
CN3700900000000	37	009	Ashe County, NC	2006	NA	12816	12097	719	5.6
CN3701100000000	37	011	Avery County, NC	2006	NA	8018	7628	390	4.9
CN3701300000000	37	013	Beaufort County, NC	2006	NA	20572	19398	1174	5.7
CN3701500000000	37	015	Bertie County, NC	2006	NA	8731	8165	566	6.5
CN3701700000000	37	017	Bladen County, NC	2006	NA	15232	14262	970	6.4
CN3701900000000	37	019	Brunswick County, NC	2006	NA	46535	44463	2072	4.5
CN3702100000000	37	021	Buncombe County, NC	2006	NA	118775	114342	4433	3.7
CN3702300000000	37	023	Burke County, NC	2006	NA	41543	39165	2378	5.7
CN3702500000000	37	025	Cabarrus County, NC	2006	NA	80713	77389	3324	4.1
CN3702700000000	37	027	Caldwell County, NC	2006	NA	39817	36849	2968	7.5
CN3702900000000	37	029	Camden County, NC	2006	NA	4519	4327	192	4.2
CN3703100000000	37	031	Carteret County, NC	2006	NA	32918	31562	1356	4.1
CN3703300000000	37	033	Caswell County, NC	2006	NA	10715	9953	762	7.1
CN3703500000000	37	035	Catawba County, NC	2006	NA	77385	73255	4130	5.3
CN3703700000000	37	037	Chatham County, NC	2006	NA	32468	31221	1247	3.8
CN3703900000000	37	039	Cherokee County, NC	2006	NA	10546	9981	565	5.4
CN3704100000000	37	041	Chowan County, NC	2006	NA	7015	6667	348	5
CN3704300000000	37	043	Clay County, NC	2006	NA	4686	4505	181	3.9
CN3704500000000	37	045	Cleveland County, NC	2006	NA	47884	44856	3028	6.3
CN3704700000000	37	047	Columbus County, NC	2006	NA	23665	22347	1318	5.6
CN3704900000000	37	049	Craven County, NC	2006	NA	41958	40121	1837	4.4
CN3705100000000	37	051	Cumberland County, NC	2006	NA	129015	122062	6953	5.4
CN3705300000000	37	053	Currituck County, NC	2006	NA	12644	12221	423	3.3
CN3705500000000	37	055	Dare County, NC	2006	NA	22416	21416	1000	4.5
CN3705700000000	37	057	Davidson County, NC	2006	NA	79638	74990	4648	5.8
CN3705900000000	37	059	Davie County, NC	2006	NA	20548	19695	853	4.2
CN3706100000000	37	061	Duplin County, NC	2006	NA	23444	22235	1209	5.2
CN3706300000000	37	063	Durham County, NC	2006	NA	134474	129229	5245	3.9
CN3706500000000	37	065	Edgecombe County, NC	2006	NA	24278	22329	1949	8
CN3706700000000	37	067	Forsyth County, NC	2006	NA	173023	165618	7405	4.3
CN3706900000000	37	069	Franklin County, NC	2006	NA	26831	25705	1126	4.2
CN3707100000000	37	071	Gaston County, NC	2006	NA	98059	92664	5395	5.5
CN3707300000000	37	073	Gates County, NC	2006	NA	4958	4762	196	4
CN3707500000000	37	075	Graham County, NC	2006	NA	4099	3838	261	6.4
CN3707700000000	37	077	Granville County, NC	2006	NA	24261	23000	1261	5.2
CN3707900000000	37	079	Greene County, NC	2006	NA	9110	8615	495	5.4
CN3708100000000	37	081	Guilford County, NC	2006	NA	246620	235196	11424	4.6
CN3708300000000	37	083	Halifax County, NC	2006	NA	23925	22374	1551	6.5
CN3708500000000	37	085	Harnett County, NC	2006	NA	46730	44436	2294	4.9
CN3708700000000	37	087	Haywood County, NC	2006	NA	27603	26491	1112	4
CN3708900000000	37	089	Henderson County, NC	2006	NA	47901	46192	1709	3.6
CN3709100000000	37	091	Hertford County, NC	2006	NA	9718	9180	538	5.5
CN3709300000000	37	093	Hoke County, NC	2006	NA	19520	18479	1041	5.3
CN3709500000000	37	095	Hyde County, NC	2006	NA	2680	2538	142	5.3
CN3709700000000	37	097	Iredell County, NC	2006	NA	76658	73303	3355	4.4
CN3709900000000	37	099	Jackson County, NC	2006	NA	21525	20748	777	3.6
CN3710100000000	37	101	Johnston County, NC	2006	NA	74090	71163	2927	4
CN3710300000000	37	103	Jones County, NC	2006	NA	4807	4588	219	4.6
CN3710500000000	37	105	Lee County, NC	2006	NA	26237	24822	1415	5.4
CN3710700000000	37	107	Lenoir County, NC	2006	NA	27443	25911	1532	5.6
CN3710900000000	37	109	Lincoln County, NC	2006	NA	37828	35936	1892	5
CN3711100000000	37	111	McDowell County, NC	2006	NA	21072	19787	1285	6.1
CN3711300000000	37	113	Macon County, NC	2006	NA	16119	15412	707	4.4
CN3711500000000	37	115	Madison County, NC	2006	NA	9935	9523	412	4.1
CN3711700000000	37	117	Martin County, NC	2006	NA	11923	11271	652	5.5
CN3711900000000	37	119	Mecklenburg County, NC	2006	NA	445356	425476	19880	4.5
CN3712100000000	37	121	Mitchell County, NC	2006	NA	7565	7096	469	6.2
CN3712300000000	37	123	Montgomery County, NC	2006	NA	12187	11368	819	6.7
CN3712500000000	37	125	Moore County, NC	2006	NA	36356	34626	1730	4.8
CN3712700000000	37	127	Nash County, NC	2006	NA	44817	42356	2461	5.5
CN3712900000000	37	129	New Hanover County, NC	2006	NA	101711	97961	3750	3.7
CN3713100000000	37	131	Northampton County, NC	2006	NA	8995	8481	514	5.7
CN3713300000000	37	133	Onslow County, NC	2006	NA	58206	55620	2586	4.4
CN3713500000000	37	135	Orange County, NC	2006	NA	67112	64893	2219	3.3
CN3713700000000	37	137	Pamlico County, NC	2006	NA	5645	5387	258	4.6
CN3713900000000	37	139	Pasquotank County, NC	2006	NA	17834	16943	891	5
CN3714100000000	37	141	Pender County, NC	2006	NA	23402	22427	975	4.2
CN3714300000000	37	143	Perquimans County, NC	2006	NA	5264	4988	276	5.2
CN3714500000000	37	145	Person County, NC	2006	NA	19162	17973	1189	6.2
CN3714700000000	37	147	Pitt County, NC	2006	NA	76178	72195	3983	5.2
CN3714900000000	37	149	Polk County, NC	2006	NA	9390	9062	328	3.5
CN3715100000000	37	151	Randolph County, NC	2006	NA	76469	72952	3517	4.6
CN3715300000000	37	153	Richmond County, NC	2006	NA	20216	18691	1525	7.5
CN3715500000000	37	155	Robeson County, NC	2006	NA	53884	50559	3325	6.2
CN3715700000000	37	157	Rockingham County, NC	2006	NA	46067	43339	2728	5.9
CN3715900000000	37	159	Rowan County, NC	2006	NA	69324	65876	3448	5
CN3716100000000	37	161	Rutherford County, NC	2006	NA	29746	27442	2304	7.7
CN3716300000000	37	163	Sampson County, NC	2006	NA	31237	29815	1422	4.6
CN3716500000000	37	165	Scotland County, NC	2006	NA	14801	13491	1310	8.9
CN3716700000000	37	167	Stanly County, NC	2006	NA	30040	28513	1527	5.1
CN3716900000000	37	169	Stokes County, NC	2006	NA	24265	23221	1044	4.3
CN3717100000000	37	171	Surry County, NC	2006	NA	34969	33179	1790	5.1
CN3717300000000	37	173	Swain County, NC	2006	NA	7255	6849	406	5.6
CN3717500000000	37	175	Transylvania County, NC	2006	NA	12627	12096	531	4.2
CN3717700000000	37	177	Tyrrell County, NC	2006	NA	2121	1999	122	5.8
CN3717900000000	37	179	Union County, NC	2006	NA	88957	85447	3510	3.9
CN3718100000000	37	181	Vance County, NC	2006	NA	18773	17369	1404	7.5
CN3718300000000	37	183	Wake County, NC	2006	NA	427016	411511	15505	3.6
CN3718500000000	37	185	Warren County, NC	2006	NA	7886	7386	500	6.3
CN3718700000000	37	187	Washington County, NC	2006	NA	6117	5710	407	6.7
CN3718900000000	37	189	Watauga County, NC	2006	NA	23843	22959	884	3.7
CN3719100000000	37	191	Wayne County, NC	2006	NA	52107	49666	2441	4.7
CN3719300000000	37	193	Wilkes County, NC	2006	NA	31410	29715	1695	5.4
CN3719500000000	37	195	Wilson County, NC	2006	NA	39775	36952	2823	7.1
CN3719700000000	37	197	Yadkin County, NC	2006	NA	19560	18725	835	4.3
CN3719900000000	37	199	Yancey County, NC	2006	NA	7946	7503	443	5.6
CN3800100000000	38	001	Adams County, ND	2006	NA	1307	1268	39	3
CN3800300000000	38	003	Barnes County, ND	2006	NA	5954	5738	216	3.6
CN3800500000000	38	005	Benson County, ND	2006	NA	2747	2583	164	6
CN3800700000000	38	007	Billings County, ND	2006	NA	523	510	13	2.5
CN3800900000000	38	009	Bottineau County, ND	2006	NA	3450	3322	128	3.7
CN3801100000000	38	011	Bowman County, ND	2006	NA	1771	1732	39	2.2
CN3801300000000	38	013	Burke County, ND	2006	NA	1018	992	26	2.6
CN3801500000000	38	015	Burleigh County, ND	2006	NA	45843	44622	1221	2.7
CN3801700000000	38	017	Cass County, ND	2006	NA	84220	82058	2162	2.6
CN3801900000000	38	019	Cavalier County, ND	2006	NA	2140	2068	72	3.4
CN3802100000000	38	021	Dickey County, ND	2006	NA	3019	2936	83	2.7
CN3802300000000	38	023	Divide County, ND	2006	NA	957	921	36	3.8
CN3802500000000	38	025	Dunn County, ND	2006	NA	1733	1675	58	3.3
CN3802700000000	38	027	Eddy County, ND	2006	NA	1319	1252	67	5.1
CN3802900000000	38	029	Emmons County, ND	2006	NA	1823	1734	89	4.9
CN3803100000000	38	031	Foster County, ND	2006	NA	1722	1664	58	3.4
CN3803300000000	38	033	Golden Valley County, ND	2006	NA	850	823	27	3.2
CN3803500000000	38	035	Grand Forks County, ND	2006	NA	38454	37297	1157	3
CN3803700000000	38	037	Grant County, ND	2006	NA	1244	1199	45	3.6
CN3803900000000	38	039	Griggs County, ND	2006	NA	1321	1280	41	3.1
CN3804100000000	38	041	Hettinger County, ND	2006	NA	1198	1156	42	3.5
CN3804300000000	38	043	Kidder County, ND	2006	NA	1268	1208	60	4.7
CN3804500000000	38	045	LaMoure County, ND	2006	NA	2269	2197	72	3.2
CN3804700000000	38	047	Logan County, ND	2006	NA	956	925	31	3.2
CN3804900000000	38	049	McHenry County, ND	2006	NA	2798	2659	139	5
CN3805100000000	38	051	McIntosh County, ND	2006	NA	1463	1422	41	2.8
CN3805300000000	38	053	McKenzie County, ND	2006	NA	2813	2722	91	3.2
CN3805500000000	38	055	McLean County, ND	2006	NA	4661	4450	211	4.5
CN3805700000000	38	057	Mercer County, ND	2006	NA	4771	4591	180	3.8
CN3805900000000	38	059	Morton County, ND	2006	NA	14840	14352	488	3.3
CN3806100000000	38	061	Mountrail County, ND	2006	NA	2907	2733	174	6
CN3806300000000	38	063	Nelson County, ND	2006	NA	1686	1615	71	4.2
CN3806500000000	38	065	Oliver County, ND	2006	NA	1099	1055	44	4
CN3806700000000	38	067	Pembina County, ND	2006	NA	4101	3849	252	6.1
CN3806900000000	38	069	Pierce County, ND	2006	NA	1922	1837	85	4.4
CN3807100000000	38	071	Ramsey County, ND	2006	NA	5967	5726	241	4
CN3807300000000	38	073	Ransom County, ND	2006	NA	3184	3059	125	3.9
CN3807500000000	38	075	Renville County, ND	2006	NA	1338	1297	41	3.1
CN3807700000000	38	077	Richland County, ND	2006	NA	9005	8692	313	3.5
CN3807900000000	38	079	Rolette County, ND	2006	NA	5116	4648	468	9.1
CN3808100000000	38	081	Sargent County, ND	2006	NA	2540	2442	98	3.9
CN3808300000000	38	083	Sheridan County, ND	2006	NA	702	664	38	5.4
CN3808500000000	38	085	Sioux County, ND	2006	NA	1333	1240	93	7
CN3808700000000	38	087	Slope County, ND	2006	NA	528	516	12	2.3
CN3808900000000	38	089	Stark County, ND	2006	NA	13717	13359	358	2.6
CN3809100000000	38	091	Steele County, ND	2006	NA	1132	1104	28	2.5
CN3809300000000	38	093	Stutsman County, ND	2006	NA	11922	11561	361	3
CN3809500000000	38	095	Towner County, ND	2006	NA	1199	1137	62	5.2
CN3809700000000	38	097	Traill County, ND	2006	NA	4243	4090	153	3.6
CN3809900000000	38	099	Walsh County, ND	2006	NA	5834	5564	270	4.6
CN3810100000000	38	101	Ward County, ND	2006	NA	28690	27794	896	3.1
CN3810300000000	38	103	Wells County, ND	2006	NA	2195	2093	102	4.6
CN3810500000000	38	105	Williams County, ND	2006	NA	12652	12392	260	2.1
CN3900100000000	39	001	Adams County, OH	2006	NA	13263	12255	1008	7.6
CN3900300000000	39	003	Allen County, OH	2006	NA	52786	49569	3217	6.1
CN3900500000000	39	005	Ashland County, OH	2006	NA	27299	25791	1508	5.5
CN3900700000000	39	007	Ashtabula County, OH	2006	NA	49941	46599	3342	6.7
CN3900900000000	39	009	Athens County, OH	2006	NA	30450	28644	1806	5.9
CN3901100000000	39	011	Auglaize County, OH	2006	NA	27122	25987	1135	4.2
CN3901300000000	39	013	Belmont County, OH	2006	NA	32755	30842	1913	5.8
CN3901500000000	39	015	Brown County, OH	2006	NA	22075	20555	1520	6.9
CN3901700000000	39	017	Butler County, OH	2006	NA	189822	179024	10798	5.7
CN3901900000000	39	019	Carroll County, OH	2006	NA	14035	13182	853	6.1
CN3902100000000	39	021	Champaign County, OH	2006	NA	20811	19749	1062	5.1
CN3902300000000	39	023	Clark County, OH	2006	NA	70943	66960	3983	5.6
CN3902500000000	39	025	Clermont County, OH	2006	NA	105489	100086	5403	5.1
CN3902700000000	39	027	Clinton County, OH	2006	NA	24232	23061	1171	4.8
CN3902900000000	39	029	Columbiana County, OH	2006	NA	53486	50021	3465	6.5
CN3903100000000	39	031	Coshocton County, OH	2006	NA	17633	16404	1229	7
CN3903300000000	39	033	Crawford County, OH	2006	NA	22663	21195	1468	6.5
CN3903500000000	39	035	Cuyahoga County, OH	2006	NA	652395	619269	33126	5.1
CN3903700000000	39	037	Darke County, OH	2006	NA	28034	26449	1585	5.7
CN3903900000000	39	039	Defiance County, OH	2006	NA	20665	19509	1156	5.6
CN3904100000000	39	041	Delaware County, OH	2006	NA	87929	84491	3438	3.9
CN3904300000000	39	043	Erie County, OH	2006	NA	43005	40484	2521	5.9
CN3904500000000	39	045	Fairfield County, OH	2006	NA	74892	71278	3614	4.8
CN3904700000000	39	047	Fayette County, OH	2006	NA	16416	15604	812	4.9
CN3904900000000	39	049	Franklin County, OH	2006	NA	609068	580184	28884	4.7
CN3905100000000	39	051	Fulton County, OH	2006	NA	23518	22120	1398	5.9
CN3905300000000	39	053	Gallia County, OH	2006	NA	14731	13827	904	6.1
CN3905500000000	39	055	Geauga County, OH	2006	NA	51232	49176	2056	4
CN3905700000000	39	057	Greene County, OH	2006	NA	78300	74308	3992	5.1
CN3905900000000	39	059	Guernsey County, OH	2006	NA	19852	18556	1296	6.5
CN3906100000000	39	061	Hamilton County, OH	2006	NA	426496	404843	21653	5.1
CN3906300000000	39	063	Hancock County, OH	2006	NA	41276	39446	1830	4.4
CN3906500000000	39	065	Hardin County, OH	2006	NA	15951	15056	895	5.6
CN3906700000000	39	067	Harrison County, OH	2006	NA	7455	7007	448	6
CN3906900000000	39	069	Henry County, OH	2006	NA	16149	15170	979	6.1
CN3907100000000	39	071	Highland County, OH	2006	NA	21544	20336	1208	5.6
CN3907300000000	39	073	Hocking County, OH	2006	NA	14086	13211	875	6.2
CN3907500000000	39	075	Holmes County, OH	2006	NA	19446	18702	744	3.8
CN3907700000000	39	077	Huron County, OH	2006	NA	30156	27926	2230	7.4
CN3907900000000	39	079	Jackson County, OH	2006	NA	16042	14845	1197	7.5
CN3908100000000	39	081	Jefferson County, OH	2006	NA	31741	29538	2203	6.9
CN3908300000000	39	083	Knox County, OH	2006	NA	30667	29114	1553	5.1
CN3908500000000	39	085	Lake County, OH	2006	NA	131566	125854	5712	4.3
CN3908700000000	39	087	Lawrence County, OH	2006	NA	29158	27616	1542	5.3
CN3908900000000	39	089	Licking County, OH	2006	NA	83022	78759	4263	5.1
CN3909100000000	39	091	Logan County, OH	2006	NA	24971	23804	1167	4.7
CN3909300000000	39	093	Lorain County, OH	2006	NA	157117	148919	8198	5.2
CN3909500000000	39	095	Lucas County, OH	2006	NA	226280	211928	14352	6.3
CN3909700000000	39	097	Madison County, OH	2006	NA	20078	19019	1059	5.3
CN3909900000000	39	099	Mahoning County, OH	2006	NA	120024	112304	7720	6.4
CN3910100000000	39	101	Marion County, OH	2006	NA	32431	30675	1756	5.4
CN3910300000000	39	103	Medina County, OH	2006	NA	94369	90314	4055	4.3
CN3910500000000	39	105	Meigs County, OH	2006	NA	9189	8418	771	8.4
CN3910700000000	39	107	Mercer County, OH	2006	NA	24198	23290	908	3.8
CN3910900000000	39	109	Miami County, OH	2006	NA	55727	52706	3021	5.4
CN3911100000000	39	111	Monroe County, OH	2006	NA	5169	4592	577	11.2
CN3911300000000	39	113	Montgomery County, OH	2006	NA	272814	256344	16470	6
CN3911500000000	39	115	Morgan County, OH	2006	NA	5754	5228	526	9.1
CN3911700000000	39	117	Morrow County, OH	2006	NA	17968	16946	1022	5.7
CN3911900000000	39	119	Muskingum County, OH	2006	NA	39321	36499	2822	7.2
CN3912100000000	39	121	Noble County, OH	2006	NA	5886	5462	424	7.2
CN3912300000000	39	123	Ottawa County, OH	2006	NA	21956	20427	1529	7
CN3912500000000	39	125	Paulding County, OH	2006	NA	10626	10105	521	4.9
CN3912700000000	39	127	Perry County, OH	2006	NA	16613	15384	1229	7.4
CN3912900000000	39	129	Pickaway County, OH	2006	NA	24347	22932	1415	5.8
CN3913100000000	39	131	Pike County, OH	2006	NA	10776	9820	956	8.9
CN3913300000000	39	133	Portage County, OH	2006	NA	90460	85793	4667	5.2
CN3913500000000	39	135	Preble County, OH	2006	NA	22117	20794	1323	6
CN3913700000000	39	137	Putnam County, OH	2006	NA	17922	17078	844	4.7
CN3913900000000	39	139	Richland County, OH	2006	NA	62722	58914	3808	6.1
CN3914100000000	39	141	Ross County, OH	2006	NA	34901	32720	2181	6.2
CN3914300000000	39	143	Sandusky County, OH	2006	NA	33456	31527	1929	5.8
CN3914500000000	39	145	Scioto County, OH	2006	NA	31395	29007	2388	7.6
CN3914700000000	39	147	Seneca County, OH	2006	NA	31487	29827	1660	5.3
CN3914900000000	39	149	Shelby County, OH	2006	NA	28333	27126	1207	4.3
CN3915100000000	39	151	Stark County, OH	2006	NA	190175	179113	11062	5.8
CN3915300000000	39	153	Summit County, OH	2006	NA	295022	279340	15682	5.3
CN3915500000000	39	155	Trumbull County, OH	2006	NA	106095	99440	6655	6.3
CN3915700000000	39	157	Tuscarawas County, OH	2006	NA	48135	45693	2442	5.1
CN3915900000000	39	159	Union County, OH	2006	NA	25219	24070	1149	4.6
CN3916100000000	39	161	Van Wert County, OH	2006	NA	15614	14852	762	4.9
CN3916300000000	39	163	Vinton County, OH	2006	NA	5727	5273	454	7.9
CN3916500000000	39	165	Warren County, OH	2006	NA	106991	101704	5287	4.9
CN3916700000000	39	167	Washington County, OH	2006	NA	33047	31308	1739	5.3
CN3916900000000	39	169	Wayne County, OH	2006	NA	60193	57394	2799	4.7
CN3917100000000	39	171	Williams County, OH	2006	NA	19881	18696	1185	6
CN3917300000000	39	173	Wood County, OH	2006	NA	69042	65433	3609	5.2
CN3917500000000	39	175	Wyandot County, OH	2006	NA	12359	11626	733	5.9
CN4000100000000	40	001	Adair County, OK	2006	NA	10400	9944	456	4.4
CN4000300000000	40	003	Alfalfa County, OK	2006	NA	2277	2181	96	4.2
CN4000500000000	40	005	Atoka County, OK	2006	NA	5692	5418	274	4.8
CN4000700000000	40	007	Beaver County, OK	2006	NA	2941	2863	78	2.7
CN4000900000000	40	009	Beckham County, OK	2006	NA	10405	10129	276	2.7
CN4001100000000	40	011	Blaine County, OK	2006	NA	4840	4640	200	4.1
CN4001300000000	40	013	Bryan County, OK	2006	NA	20169	19459	710	3.5
CN4001500000000	40	015	Caddo County, OK	2006	NA	11734	11088	646	5.5
CN4001700000000	40	017	Canadian County, OK	2006	NA	51392	49638	1754	3.4
CN4001900000000	40	019	Carter County, OK	2006	NA	24135	23223	912	3.8
CN4002100000000	40	021	Cherokee County, OK	2006	NA	21461	20569	892	4.2
CN4002300000000	40	023	Choctaw County, OK	2006	NA	6712	6382	330	4.9
CN4002500000000	40	025	Cimarron County, OK	2006	NA	1271	1229	42	3.3
CN4002700000000	40	027	Cleveland County, OK	2006	NA	117495	113419	4076	3.5
CN4002900000000	40	029	Coal County, OK	2006	NA	2361	2224	137	5.8
CN4003100000000	40	031	Comanche County, OK	2006	NA	45351	43492	1859	4.1
CN4003300000000	40	033	Cotton County, OK	2006	NA	3327	3220	107	3.2
CN4003500000000	40	035	Craig County, OK	2006	NA	6804	6517	287	4.2
CN4003700000000	40	037	Creek County, OK	2006	NA	31601	30279	1322	4.2
CN4003900000000	40	039	Custer County, OK	2006	NA	13761	13349	412	3
CN4004100000000	40	041	Delaware County, OK	2006	NA	17385	16605	780	4.5
CN4004300000000	40	043	Dewey County, OK	2006	NA	2401	2328	73	3
CN4004500000000	40	045	Ellis County, OK	2006	NA	2212	2153	59	2.7
CN4004700000000	40	047	Garfield County, OK	2006	NA	29311	28423	888	3
CN4004900000000	40	049	Garvin County, OK	2006	NA	13600	13113	487	3.6
CN4005100000000	40	051	Grady County, OK	2006	NA	23596	22448	1148	4.9
CN4005300000000	40	053	Grant County, OK	2006	NA	2382	2295	87	3.7
CN4005500000000	40	055	Greer County, OK	2006	NA	2071	1971	100	4.8
CN4005700000000	40	057	Harmon County, OK	2006	NA	1430	1380	50	3.5
CN4005900000000	40	059	Harper County, OK	2006	NA	1835	1779	56	3.1
CN4006100000000	40	061	Haskell County, OK	2006	NA	5436	5209	227	4.2
CN4006300000000	40	063	Hughes County, OK	2006	NA	5071	4764	307	6.1
CN4006500000000	40	065	Jackson County, OK	2006	NA	12465	12051	414	3.3
CN4006700000000	40	067	Jefferson County, OK	2006	NA	2345	2243	102	4.3
CN4006900000000	40	069	Johnston County, OK	2006	NA	4973	4761	212	4.3
CN4007100000000	40	071	Kay County, OK	2006	NA	21891	20845	1046	4.8
CN4007300000000	40	073	Kingfisher County, OK	2006	NA	7975	7756	219	2.7
CN4007500000000	40	075	Kiowa County, OK	2006	NA	3919	3736	183	4.7
CN4007700000000	40	077	Latimer County, OK	2006	NA	4116	3911	205	5
CN4007900000000	40	079	Le Flore County, OK	2006	NA	21697	20595	1102	5.1
CN4008100000000	40	081	Lincoln County, OK	2006	NA	14530	13933	597	4.1
CN4008300000000	40	083	Logan County, OK	2006	NA	17795	17137	658	3.7
CN4008500000000	40	085	Love County, OK	2006	NA	4840	4672	168	3.5
CN4008700000000	40	087	McClain County, OK	2006	NA	14820	14278	542	3.7
CN4008900000000	40	089	McCurtain County, OK	2006	NA	13970	13113	857	6.1
CN4009100000000	40	091	McIntosh County, OK	2006	NA	8247	7824	423	5.1
CN4009300000000	40	093	Major County, OK	2006	NA	3834	3727	107	2.8
CN4009500000000	40	095	Marshall County, OK	2006	NA	6288	6030	258	4.1
CN4009700000000	40	097	Mayes County, OK	2006	NA	17274	16541	733	4.2
CN4009900000000	40	099	Murray County, OK	2006	NA	7750	7517	233	3
CN4010100000000	40	101	Muskogee County, OK	2006	NA	29279	27783	1496	5.1
CN4010300000000	40	103	Noble County, OK	2006	NA	5654	5457	197	3.5
CN4010500000000	40	105	Nowata County, OK	2006	NA	4786	4568	218	4.6
CN4010700000000	40	107	Okfuskee County, OK	2006	NA	4479	4234	245	5.5
CN4010900000000	40	109	Oklahoma County, OK	2006	NA	328518	314706	13812	4.2
CN4011100000000	40	111	Okmulgee County, OK	2006	NA	16548	15642	906	5.5
CN4011300000000	40	113	Osage County, OK	2006	NA	20576	19727	849	4.1
CN4011500000000	40	115	Ottawa County, OK	2006	NA	16504	15737	767	4.6
CN4011700000000	40	117	Pawnee County, OK	2006	NA	7681	7364	317	4.1
CN4011900000000	40	119	Payne County, OK	2006	NA	35561	34276	1285	3.6
CN4012100000000	40	121	Pittsburg County, OK	2006	NA	21424	20556	868	4.1
CN4012300000000	40	123	Pontotoc County, OK	2006	NA	20081	19367	714	3.6
CN4012500000000	40	125	Pottawatomie County, OK	2006	NA	31979	30567	1412	4.4
CN4012700000000	40	127	Pushmataha County, OK	2006	NA	5512	5277	235	4.3
CN4012900000000	40	129	Roger Mills County, OK	2006	NA	1791	1744	47	2.6
CN4013100000000	40	131	Rogers County, OK	2006	NA	40320	38843	1477	3.7
CN4013300000000	40	133	Seminole County, OK	2006	NA	10296	9712	584	5.7
CN4013500000000	40	135	Sequoyah County, OK	2006	NA	18381	17385	996	5.4
CN4013700000000	40	137	Stephens County, OK	2006	NA	20861	20137	724	3.5
CN4013900000000	40	139	Texas County, OK	2006	NA	9095	8792	303	3.3
CN4014100000000	40	141	Tillman County, OK	2006	NA	3485	3336	149	4.3
CN4014300000000	40	143	Tulsa County, OK	2006	NA	293841	282712	11129	3.8
CN4014500000000	40	145	Wagoner County, OK	2006	NA	32728	31542	1186	3.6
CN4014700000000	40	147	Washington County, OK	2006	NA	25571	24692	879	3.4
CN4014900000000	40	149	Washita County, OK	2006	NA	5795	5607	188	3.2
CN4015100000000	40	151	Woods County, OK	2006	NA	4276	4042	234	5.5
CN4015300000000	40	153	Woodward County, OK	2006	NA	11190	10893	297	2.7
CN4100100000000	41	001	Baker County, OR	2006	NA	7215	6757	458	6.3
CN4100300000000	41	003	Benton County, OR	2006	NA	42034	40070	1964	4.7
CN4100500000000	41	005	Clackamas County, OR	2006	NA	194473	185211	9262	4.8
CN4100700000000	41	007	Clatsop County, OR	2006	NA	19151	18195	956	5
CN4100900000000	41	009	Columbia County, OR	2006	NA	23671	22321	1350	5.7
CN4101100000000	41	011	Coos County, OR	2006	NA	28615	26692	1923	6.7
CN4101300000000	41	013	Crook County, OR	2006	NA	9676	9107	569	5.9
CN4101500000000	41	015	Curry County, OR	2006	NA	9547	8897	650	6.8
CN4101700000000	41	017	Deschutes County, OR	2006	NA	79324	75654	3670	4.6
CN4101900000000	41	019	Douglas County, OR	2006	NA	47253	43740	3513	7.4
CN4102100000000	41	021	Gilliam County, OR	2006	NA	994	946	48	4.8
CN4102300000000	41	023	Grant County, OR	2006	NA	3513	3223	290	8.3
CN4102500000000	41	025	Harney County, OR	2006	NA	3334	3067	267	8
CN4102700000000	41	027	Hood River County, OR	2006	NA	12560	11876	684	5.4
CN4102900000000	41	029	Jackson County, OR	2006	NA	99946	94267	5679	5.7
CN4103100000000	41	031	Jefferson County, OR	2006	NA	9198	8684	514	5.6
CN4103300000000	41	033	Josephine County, OR	2006	NA	35050	32744	2306	6.6
CN4103500000000	41	035	Klamath County, OR	2006	NA	30352	28334	2018	6.6
CN4103700000000	41	037	Lake County, OR	2006	NA	3682	3407	275	7.5
CN4103900000000	41	039	Lane County, OR	2006	NA	177402	167795	9607	5.4
CN4104100000000	41	041	Lincoln County, OR	2006	NA	22073	20756	1317	6
CN4104300000000	41	043	Linn County, OR	2006	NA	52770	49321	3449	6.5
CN4104500000000	41	045	Malheur County, OR	2006	NA	12510	11717	793	6.3
CN4104700000000	41	047	Marion County, OR	2006	NA	149931	141466	8465	5.6
CN4104900000000	41	049	Morrow County, OR	2006	NA	5539	5179	360	6.5
CN4105100000000	41	051	Multnomah County, OR	2006	NA	366637	347849	18788	5.1
CN4105300000000	41	053	Polk County, OR	2006	NA	36936	35112	1824	4.9
CN4105500000000	41	055	Sherman County, OR	2006	NA	885	833	52	5.9
CN4105700000000	41	057	Tillamook County, OR	2006	NA	12419	11737	682	5.5
CN4105900000000	41	059	Umatilla County, OR	2006	NA	35967	33567	2400	6.7
CN4106100000000	41	061	Union County, OR	2006	NA	11977	11276	701	5.9
CN4106300000000	41	063	Wallowa County, OR	2006	NA	3622	3386	236	6.5
CN4106500000000	41	065	Wasco County, OR	2006	NA	13154	12439	715	5.4
CN4106700000000	41	067	Washington County, OR	2006	NA	277908	265718	12190	4.4
CN4106900000000	41	069	Wheeler County, OR	2006	NA	635	594	41	6.5
CN4107100000000	41	071	Yamhill County, OR	2006	NA	45428	43104	2324	5.1
CN4200100000000	42	001	Adams County, PA	2006	NA	55265	53390	1875	3.4
CN4200300000000	42	003	Allegheny County, PA	2006	NA	627923	599910	28013	4.5
CN4200500000000	42	005	Armstrong County, PA	2006	NA	32891	31160	1731	5.3
CN4200700000000	42	007	Beaver County, PA	2006	NA	89104	84849	4255	4.8
CN4200900000000	42	009	Bedford County, PA	2006	NA	23130	21803	1327	5.7
CN4201100000000	42	011	Berks County, PA	2006	NA	201350	192567	8783	4.4
CN4201300000000	42	013	Blair County, PA	2006	NA	64548	61653	2895	4.5
CN4201500000000	42	015	Bradford County, PA	2006	NA	30684	29241	1443	4.7
CN4201700000000	42	017	Bucks County, PA	2006	NA	346039	332632	13407	3.9
CN4201900000000	42	019	Butler County, PA	2006	NA	96207	92073	4134	4.3
CN4202100000000	42	021	Cambria County, PA	2006	NA	67882	64258	3624	5.3
CN4202300000000	42	023	Cameron County, PA	2006	NA	2607	2447	160	6.1
CN4202500000000	42	025	Carbon County, PA	2006	NA	30726	28939	1787	5.8
CN4202700000000	42	027	Centre County, PA	2006	NA	72814	70098	2716	3.7
CN4202900000000	42	029	Chester County, PA	2006	NA	263375	254609	8766	3.3
CN4203100000000	42	031	Clarion County, PA	2006	NA	20668	19652	1016	4.9
CN4203300000000	42	033	Clearfield County, PA	2006	NA	40968	38765	2203	5.4
CN4203500000000	42	035	Clinton County, PA	2006	NA	18851	17812	1039	5.5
CN4203700000000	42	037	Columbia County, PA	2006	NA	34631	32737	1894	5.5
CN4203900000000	42	039	Crawford County, PA	2006	NA	42623	40411	2212	5.2
CN4204100000000	42	041	Cumberland County, PA	2006	NA	122144	118044	4100	3.4
CN4204300000000	42	043	Dauphin County, PA	2006	NA	134968	129584	5384	4
CN4204500000000	42	045	Delaware County, PA	2006	NA	282338	270261	12077	4.3
CN4204700000000	42	047	Elk County, PA	2006	NA	17540	16723	817	4.7
CN4204900000000	42	049	Erie County, PA	2006	NA	140301	133215	7086	5.1
CN4205100000000	42	051	Fayette County, PA	2006	NA	65601	61448	4153	6.3
CN4205300000000	42	053	Forest County, PA	2006	NA	2226	2067	159	7.1
CN4205500000000	42	055	Franklin County, PA	2006	NA	78825	76240	2585	3.3
CN4205700000000	42	057	Fulton County, PA	2006	NA	8265	7899	366	4.4
CN4205900000000	42	059	Greene County, PA	2006	NA	17478	16474	1004	5.7
CN4206100000000	42	061	Huntingdon County, PA	2006	NA	22045	20902	1143	5.2
CN4206300000000	42	063	Indiana County, PA	2006	NA	45443	43120	2323	5.1
CN4206500000000	42	065	Jefferson County, PA	2006	NA	22755	21650	1105	4.9
CN4206700000000	42	067	Juniata County, PA	2006	NA	12633	12101	532	4.2
CN4206900000000	42	069	Lackawanna County, PA	2006	NA	105955	100766	5189	4.9
CN4207100000000	42	071	Lancaster County, PA	2006	NA	267104	257754	9350	3.5
CN4207300000000	42	073	Lawrence County, PA	2006	NA	43827	41469	2358	5.4
CN4207500000000	42	075	Lebanon County, PA	2006	NA	71166	68764	2402	3.4
CN4207700000000	42	077	Lehigh County, PA	2006	NA	174194	166251	7943	4.6
CN4207900000000	42	079	Luzerne County, PA	2006	NA	158249	149736	8513	5.4
CN4208100000000	42	081	Lycoming County, PA	2006	NA	58982	55914	3068	5.2
CN4208300000000	42	083	McKean County, PA	2006	NA	21725	20575	1150	5.3
CN4208500000000	42	085	Mercer County, PA	2006	NA	55367	52319	3048	5.5
CN4208700000000	42	087	Mifflin County, PA	2006	NA	22468	21345	1123	5
CN4208900000000	42	089	Monroe County, PA	2006	NA	80137	75991	4146	5.2
CN4209100000000	42	091	Montgomery County, PA	2006	NA	426868	411623	15245	3.6
CN4209300000000	42	093	Montour County, PA	2006	NA	9057	8694	363	4
CN4209500000000	42	095	Northampton County, PA	2006	NA	150123	143309	6814	4.5
CN4209700000000	42	097	Northumberland County, PA	2006	NA	47148	44685	2463	5.2
CN4209900000000	42	099	Perry County, PA	2006	NA	24439	23499	940	3.8
CN4210100000000	42	101	Philadelphia County/city, PA	2006	NA	615906	577682	38224	6.2
CN4210300000000	42	103	Pike County, PA	2006	NA	27006	25473	1533	5.7
CN4210500000000	42	105	Potter County, PA	2006	NA	8252	7764	488	5.9
CN4210700000000	42	107	Schuylkill County, PA	2006	NA	71572	67700	3872	5.4
CN4210900000000	42	109	Snyder County, PA	2006	NA	20038	19221	817	4.1
CN4211100000000	42	111	Somerset County, PA	2006	NA	38958	36821	2137	5.5
CN4211300000000	42	113	Sullivan County, PA	2006	NA	3020	2861	159	5.3
CN4211500000000	42	115	Susquehanna County, PA	2006	NA	21357	20335	1022	4.8
CN4211700000000	42	117	Tioga County, PA	2006	NA	20220	19119	1101	5.4
CN4211900000000	42	119	Union County, PA	2006	NA	17852	16943	909	5.1
CN4212100000000	42	121	Venango County, PA	2006	NA	26588	25209	1379	5.2
CN4212300000000	42	123	Warren County, PA	2006	NA	21066	20009	1057	5
CN4212500000000	42	125	Washington County, PA	2006	NA	103239	98156	5083	4.9
CN4212700000000	42	127	Wayne County, PA	2006	NA	25287	24237	1050	4.2
CN4212900000000	42	129	Westmoreland County, PA	2006	NA	185706	176512	9194	5
CN4213100000000	42	131	Wyoming County, PA	2006	NA	14353	13616	737	5.1
CN4213300000000	42	133	York County, PA	2006	NA	222435	213549	8886	4
CN4400100000000	44	001	Bristol County, RI	2006	NA	28585	27360	1225	4.3
CN4400300000000	44	003	Kent County, RI	2006	NA	97525	92982	4543	4.7
CN4400500000000	44	005	Newport County, RI	2006	NA	44686	42666	2020	4.5
CN4400700000000	44	007	Providence County, RI	2006	NA	327711	310272	17439	5.3
CN4400900000000	44	009	Washington County, RI	2006	NA	74096	71077	3019	4.1
CN4500100000000	45	001	Abbeville County, SC	2006	NA	12032	10972	1060	8.8
CN4500300000000	45	003	Aiken County, SC	2006	NA	75160	70350	4810	6.4
CN4500500000000	45	005	Allendale County, SC	2006	NA	3869	3477	392	10.1
CN4500700000000	45	007	Anderson County, SC	2006	NA	84455	78709	5746	6.8
CN4500900000000	45	009	Bamberg County, SC	2006	NA	6490	5850	640	9.9
CN4501100000000	45	011	Barnwell County, SC	2006	NA	9252	8327	925	10
CN4501300000000	45	013	Beaufort County, SC	2006	NA	62868	59859	3009	4.8
CN4501500000000	45	015	Berkeley County, SC	2006	NA	73123	69063	4060	5.6
CN4501700000000	45	017	Calhoun County, SC	2006	NA	7080	6574	506	7.1
CN4501900000000	45	019	Charleston County, SC	2006	NA	169758	161234	8524	5
CN4502100000000	45	021	Cherokee County, SC	2006	NA	25102	23177	1925	7.7
CN4502300000000	45	023	Chester County, SC	2006	NA	16159	14511	1648	10.2
CN4502500000000	45	025	Chesterfield County, SC	2006	NA	18642	16872	1770	9.5
CN4502700000000	45	027	Clarendon County, SC	2006	NA	12929	11738	1191	9.2
CN4502900000000	45	029	Colleton County, SC	2006	NA	16889	15792	1097	6.5
CN4503100000000	45	031	Darlington County, SC	2006	NA	31020	28639	2381	7.7
CN4503300000000	45	033	Dillon County, SC	2006	NA	13398	12154	1244	9.3
CN4503500000000	45	035	Dorchester County, SC	2006	NA	60523	57459	3064	5.1
CN4503700000000	45	037	Edgefield County, SC	2006	NA	11067	10213	854	7.7
CN4503900000000	45	039	Fairfield County, SC	2006	NA	11410	10384	1026	9
CN4504100000000	45	041	Florence County, SC	2006	NA	62165	57651	4514	7.3
CN4504300000000	45	043	Georgetown County, SC	2006	NA	29367	27277	2090	7.1
CN4504500000000	45	045	Greenville County, SC	2006	NA	215684	204101	11583	5.4
CN4504700000000	45	047	Greenwood County, SC	2006	NA	31665	29145	2520	8
CN4504900000000	45	049	Hampton County, SC	2006	NA	7971	7399	572	7.2
CN4505100000000	45	051	Horry County, SC	2006	NA	128200	121128	7072	5.5
CN4505300000000	45	053	Jasper County, SC	2006	NA	10185	9690	495	4.9
CN4505500000000	45	055	Kershaw County, SC	2006	NA	29598	27723	1875	6.3
CN4505700000000	45	057	Lancaster County, SC	2006	NA	30538	27787	2751	9
CN4505900000000	45	059	Laurens County, SC	2006	NA	33495	31178	2317	6.9
CN4506100000000	45	061	Lee County, SC	2006	NA	8372	7571	801	9.6
CN4506300000000	45	063	Lexington County, SC	2006	NA	130643	124541	6102	4.7
CN4506500000000	45	065	McCormick County, SC	2006	NA	3593	3198	395	11
CN4506700000000	45	067	Marion County, SC	2006	NA	13391	11781	1610	12
CN4506900000000	45	069	Marlboro County, SC	2006	NA	12647	11233	1414	11.2
CN4507100000000	45	071	Newberry County, SC	2006	NA	17950	16793	1157	6.4
CN4507300000000	45	073	Oconee County, SC	2006	NA	30834	28085	2749	8.9
CN4507500000000	45	075	Orangeburg County, SC	2006	NA	40028	36342	3686	9.2
CN4507700000000	45	077	Pickens County, SC	2006	NA	57789	54196	3593	6.2
CN4507900000000	45	079	Richland County, SC	2006	NA	175827	165594	10233	5.8
CN4508100000000	45	081	Saluda County, SC	2006	NA	9361	8776	585	6.2
CN4508300000000	45	083	Spartanburg County, SC	2006	NA	133837	124936	8901	6.7
CN4508500000000	45	085	Sumter County, SC	2006	NA	45815	42252	3563	7.8
CN4508700000000	45	087	Union County, SC	2006	NA	12286	10947	1339	10.9
CN4508900000000	45	089	Williamsburg County, SC	2006	NA	15671	14119	1552	9.9
CN4509100000000	45	091	York County, SC	2006	NA	100969	94544	6425	6.4
CN4600300000000	46	003	Aurora County, SD	2006	NA	1363	1316	47	3.4
CN4600500000000	46	005	Beadle County, SD	2006	NA	9033	8765	268	3
CN4600700000000	46	007	Bennett County, SD	2006	NA	1485	1415	70	4.7
CN4600900000000	46	009	Bon Homme County, SD	2006	NA	3222	3089	133	4.1
CN4601100000000	46	011	Brookings County, SD	2006	NA	18946	18489	457	2.4
CN4601300000000	46	013	Brown County, SD	2006	NA	20808	20263	545	2.6
CN4601500000000	46	015	Brule County, SD	2006	NA	2744	2663	81	3
CN4601700000000	46	017	Buffalo County, SD	2006	NA	549	471	78	14.2
CN4601900000000	46	019	Butte County, SD	2006	NA	5403	5258	145	2.7
CN4602100000000	46	021	Campbell County, SD	2006	NA	883	857	26	2.9
CN4602300000000	46	023	Charles Mix County, SD	2006	NA	4116	3969	147	3.6
CN4602500000000	46	025	Clark County, SD	2006	NA	1872	1800	72	3.8
CN4602700000000	46	027	Clay County, SD	2006	NA	7473	7255	218	2.9
CN4602900000000	46	029	Codington County, SD	2006	NA	16386	15909	477	2.9
CN4603100000000	46	031	Corson County, SD	2006	NA	1443	1357	86	6
CN4603300000000	46	033	Custer County, SD	2006	NA	4811	4666	145	3
CN4603500000000	46	035	Davison County, SD	2006	NA	10864	10539	325	3
CN4603700000000	46	037	Day County, SD	2006	NA	2936	2788	148	5
CN4603900000000	46	039	Deuel County, SD	2006	NA	2711	2615	96	3.5
CN4604100000000	46	041	Dewey County, SD	2006	NA	2716	2463	253	9.3
CN4604300000000	46	043	Douglas County, SD	2006	NA	1709	1663	46	2.7
CN4604500000000	46	045	Edmunds County, SD	2006	NA	2073	2015	58	2.8
CN4604700000000	46	047	Fall River County, SD	2006	NA	3794	3661	133	3.5
CN4604900000000	46	049	Faulk County, SD	2006	NA	1144	1109	35	3.1
CN4605100000000	46	051	Grant County, SD	2006	NA	4233	4085	148	3.5
CN4605300000000	46	053	Gregory County, SD	2006	NA	2368	2286	82	3.5
CN4605500000000	46	055	Haakon County, SD	2006	NA	1169	1138	31	2.7
CN4605700000000	46	057	Hamlin County, SD	2006	NA	2934	2841	93	3.2
CN4605900000000	46	059	Hand County, SD	2006	NA	1892	1839	53	2.8
CN4606100000000	46	061	Hanson County, SD	2006	NA	1927	1870	57	3
CN4606300000000	46	063	Harding County, SD	2006	NA	763	741	22	2.9
CN4606500000000	46	065	Hughes County, SD	2006	NA	10471	10212	259	2.5
CN4606700000000	46	067	Hutchinson County, SD	2006	NA	3671	3541	130	3.5
CN4606900000000	46	069	Hyde County, SD	2006	NA	771	744	27	3.5
CN4607100000000	46	071	Jackson County, SD	2006	NA	1287	1215	72	5.6
CN4607300000000	46	073	Jerauld County, SD	2006	NA	1343	1305	38	2.8
CN4607500000000	46	075	Jones County, SD	2006	NA	738	720	18	2.4
CN4607700000000	46	077	Kingsbury County, SD	2006	NA	2963	2865	98	3.3
CN4607900000000	46	079	Lake County, SD	2006	NA	6728	6521	207	3.1
CN4608100000000	46	081	Lawrence County, SD	2006	NA	12952	12582	370	2.9
CN4608300000000	46	083	Lincoln County, SD	2006	NA	20344	19846	498	2.4
CN4608500000000	46	085	Lyman County, SD	2006	NA	2025	1936	89	4.4
CN4608700000000	46	087	McCook County, SD	2006	NA	2922	2832	90	3.1
CN4608900000000	46	089	McPherson County, SD	2006	NA	1198	1148	50	4.2
CN4609100000000	46	091	Marshall County, SD	2006	NA	2153	2062	91	4.2
CN4609300000000	46	093	Meade County, SD	2006	NA	12630	12227	403	3.2
CN4609500000000	46	095	Mellette County, SD	2006	NA	953	910	43	4.5
CN4609700000000	46	097	Miner County, SD	2006	NA	1177	1132	45	3.8
CN4609900000000	46	099	Minnehaha County, SD	2006	NA	95307	92676	2631	2.8
CN4610100000000	46	101	Moody County, SD	2006	NA	4084	3921	163	4
CN4610200000000	46	102	Oglala Lakota County, SD	2006	NA	4036	3705	331	8.2
CN4610300000000	46	103	Pennington County, SD	2006	NA	52940	51377	1563	3
CN4610500000000	46	105	Perkins County, SD	2006	NA	1735	1683	52	3
CN4610700000000	46	107	Potter County, SD	2006	NA	1342	1301	41	3.1
CN4610900000000	46	109	Roberts County, SD	2006	NA	4896	4685	211	4.3
CN4611100000000	46	111	Sanborn County, SD	2006	NA	1510	1466	44	2.9
CN4611500000000	46	115	Spink County, SD	2006	NA	3556	3444	112	3.1
CN4611700000000	46	117	Stanley County, SD	2006	NA	1982	1936	46	2.3
CN4611900000000	46	119	Sully County, SD	2006	NA	1018	994	24	2.4
CN4612100000000	46	121	Todd County, SD	2006	NA	3624	3426	198	5.5
CN4612300000000	46	123	Tripp County, SD	2006	NA	3046	2947	99	3.3
CN4612500000000	46	125	Turner County, SD	2006	NA	4509	4370	139	3.1
CN4612700000000	46	127	Union County, SD	2006	NA	7732	7479	253	3.3
CN4612900000000	46	129	Walworth County, SD	2006	NA	2732	2621	111	4.1
CN4613500000000	46	135	Yankton County, SD	2006	NA	11932	11577	355	3
CN4613700000000	46	137	Ziebach County, SD	2006	NA	942	887	55	5.8
CN4700100000000	47	001	Anderson County, TN	2006	NA	36060	34352	1708	4.7
CN4700300000000	47	003	Bedford County, TN	2006	NA	22353	21180	1173	5.2
CN4700500000000	47	005	Benton County, TN	2006	NA	7007	6506	501	7.1
CN4700700000000	47	007	Bledsoe County, TN	2006	NA	4908	4589	319	6.5
CN4700900000000	47	009	Blount County, TN	2006	NA	62168	59474	2694	4.3
CN4701100000000	47	011	Bradley County, TN	2006	NA	48448	46019	2429	5
CN4701300000000	47	013	Campbell County, TN	2006	NA	17017	15977	1040	6.1
CN4701500000000	47	015	Cannon County, TN	2006	NA	6622	6287	335	5.1
CN4701700000000	47	017	Carroll County, TN	2006	NA	14083	13191	892	6.3
CN4701900000000	47	019	Carter County, TN	2006	NA	29617	28125	1492	5
CN4702100000000	47	021	Cheatham County, TN	2006	NA	21032	20177	855	4.1
CN4702300000000	47	023	Chester County, TN	2006	NA	7805	7382	423	5.4
CN4702500000000	47	025	Claiborne County, TN	2006	NA	13489	12757	732	5.4
CN4702700000000	47	027	Clay County, TN	2006	NA	3655	3255	400	10.9
CN4702900000000	47	029	Cocke County, TN	2006	NA	16387	15193	1194	7.3
CN4703100000000	47	031	Coffee County, TN	2006	NA	25939	24518	1421	5.5
CN4703300000000	47	033	Crockett County, TN	2006	NA	6560	6109	451	6.9
CN4703500000000	47	035	Cumberland County, TN	2006	NA	23393	21944	1449	6.2
CN4703700000000	47	037	Davidson County, TN	2006	NA	312437	299241	13196	4.2
CN4703900000000	47	039	Decatur County, TN	2006	NA	5580	5217	363	6.5
CN4704100000000	47	041	DeKalb County, TN	2006	NA	10350	9790	560	5.4
CN4704300000000	47	043	Dickson County, TN	2006	NA	23660	22566	1094	4.6
CN4704500000000	47	045	Dyer County, TN	2006	NA	17807	16782	1025	5.8
CN4704700000000	47	047	Fayette County, TN	2006	NA	17274	16198	1076	6.2
CN4704900000000	47	049	Fentress County, TN	2006	NA	7689	7181	508	6.6
CN4705100000000	47	051	Franklin County, TN	2006	NA	20309	19146	1163	5.7
CN4705300000000	47	053	Gibson County, TN	2006	NA	21262	19623	1639	7.7
CN4705500000000	47	055	Giles County, TN	2006	NA	13567	12597	970	7.1
CN4705700000000	47	057	Grainger County, TN	2006	NA	10363	9749	614	5.9
CN4705900000000	47	059	Greene County, TN	2006	NA	32963	30359	2604	7.9
CN4706100000000	47	061	Grundy County, TN	2006	NA	5941	5465	476	8
CN4706300000000	47	063	Hamblen County, TN	2006	NA	30674	28904	1770	5.8
CN4706500000000	47	065	Hamilton County, TN	2006	NA	163857	156599	7258	4.4
CN4706700000000	47	067	Hancock County, TN	2006	NA	2503	2329	174	7
CN4706900000000	47	069	Hardeman County, TN	2006	NA	11502	10673	829	7.2
CN4707100000000	47	071	Hardin County, TN	2006	NA	11823	11090	733	6.2
CN4707300000000	47	073	Hawkins County, TN	2006	NA	26623	25091	1532	5.8
CN4707500000000	47	075	Haywood County, TN	2006	NA	9788	9044	744	7.6
CN4707700000000	47	077	Henderson County, TN	2006	NA	12448	11611	837	6.7
CN4707900000000	47	079	Henry County, TN	2006	NA	14345	13320	1025	7.1
CN4708100000000	47	081	Hickman County, TN	2006	NA	10368	9805	563	5.4
CN4708300000000	47	083	Houston County, TN	2006	NA	3927	3637	290	7.4
CN4708500000000	47	085	Humphreys County, TN	2006	NA	9106	8529	577	6.3
CN4708700000000	47	087	Jackson County, TN	2006	NA	5092	4744	348	6.8
CN4708900000000	47	089	Jefferson County, TN	2006	NA	24518	23118	1400	5.7
CN4709100000000	47	091	Johnson County, TN	2006	NA	7338	6855	483	6.6
CN4709300000000	47	093	Knox County, TN	2006	NA	224145	215313	8832	3.9
CN4709500000000	47	095	Lake County, TN	2006	NA	2705	2518	187	6.9
CN4709700000000	47	097	Lauderdale County, TN	2006	NA	10074	9266	808	8
CN4709900000000	47	099	Lawrence County, TN	2006	NA	17168	15234	1934	11.3
CN4710100000000	47	101	Lewis County, TN	2006	NA	5311	4929	382	7.2
CN4710300000000	47	103	Lincoln County, TN	2006	NA	17290	16564	726	4.2
CN4710500000000	47	105	Loudon County, TN	2006	NA	22932	21918	1014	4.4
CN4710700000000	47	107	McMinn County, TN	2006	NA	25008	23585	1423	5.7
CN4710900000000	47	109	McNairy County, TN	2006	NA	12434	11671	763	6.1
CN4711100000000	47	111	Macon County, TN	2006	NA	11008	10254	754	6.8
CN4711300000000	47	113	Madison County, TN	2006	NA	48455	45843	2612	5.4
CN4711500000000	47	115	Marion County, TN	2006	NA	13289	12529	760	5.7
CN4711700000000	47	117	Marshall County, TN	2006	NA	12828	12016	812	6.3
CN4711900000000	47	119	Maury County, TN	2006	NA	36975	34952	2023	5.5
CN4712100000000	47	121	Meigs County, TN	2006	NA	4929	4593	336	6.8
CN4712300000000	47	123	Monroe County, TN	2006	NA	19723	18588	1135	5.8
CN4712500000000	47	125	Montgomery County, TN	2006	NA	69568	66296	3272	4.7
CN4712700000000	47	127	Moore County, TN	2006	NA	3158	3009	149	4.7
CN4712900000000	47	129	Morgan County, TN	2006	NA	8412	7850	562	6.7
CN4713100000000	47	131	Obion County, TN	2006	NA	15911	15025	886	5.6
CN4713300000000	47	133	Overton County, TN	2006	NA	10102	9427	675	6.7
CN4713500000000	47	135	Perry County, TN	2006	NA	3318	3096	222	6.7
CN4713700000000	47	137	Pickett County, TN	2006	NA	1905	1745	160	8.4
CN4713900000000	47	139	Polk County, TN	2006	NA	7439	7021	418	5.6
CN4714100000000	47	141	Putnam County, TN	2006	NA	35566	33532	2034	5.7
CN4714300000000	47	143	Rhea County, TN	2006	NA	13399	12559	840	6.3
CN4714500000000	47	145	Roane County, TN	2006	NA	26998	25542	1456	5.4
CN4714700000000	47	147	Robertson County, TN	2006	NA	33306	31824	1482	4.4
CN4714900000000	47	149	Rutherford County, TN	2006	NA	127182	122056	5126	4
CN4715100000000	47	151	Scott County, TN	2006	NA	8825	8232	593	6.7
CN4715300000000	47	153	Sequatchie County, TN	2006	NA	6112	5835	277	4.5
CN4715500000000	47	155	Sevier County, TN	2006	NA	47576	44988	2588	5.4
CN4715700000000	47	157	Shelby County, TN	2006	NA	444671	419148	25523	5.7
CN4715900000000	47	159	Smith County, TN	2006	NA	9363	8822	541	5.8
CN4716100000000	47	161	Stewart County, TN	2006	NA	6313	5831	482	7.6
CN4716300000000	47	163	Sullivan County, TN	2006	NA	74291	70919	3372	4.5
CN4716500000000	47	165	Sumner County, TN	2006	NA	79721	76393	3328	4.2
CN4716700000000	47	167	Tipton County, TN	2006	NA	27896	26341	1555	5.6
CN4716900000000	47	169	Trousdale County, TN	2006	NA	3831	3599	232	6.1
CN4717100000000	47	171	Unicoi County, TN	2006	NA	8456	7932	524	6.2
CN4717300000000	47	173	Union County, TN	2006	NA	8947	8512	435	4.9
CN4717500000000	47	175	Van Buren County, TN	2006	NA	2526	2326	200	7.9
CN4717700000000	47	177	Warren County, TN	2006	NA	18443	16792	1651	9
CN4717900000000	47	179	Washington County, TN	2006	NA	60380	57650	2730	4.5
CN4718100000000	47	181	Wayne County, TN	2006	NA	6667	5976	691	10.4
CN4718300000000	47	183	Weakley County, TN	2006	NA	15801	14722	1079	6.8
CN4718500000000	47	185	White County, TN	2006	NA	10908	9920	988	9.1
CN4718700000000	47	187	Williamson County, TN	2006	NA	87280	84211	3069	3.5
CN4718900000000	47	189	Wilson County, TN	2006	NA	57827	55252	2575	4.5
CN4800100000000	48	001	Anderson County, TX	2006	NA	20220	19040	1180	5.8
CN4800300000000	48	003	Andrews County, TX	2006	NA	6786	6551	235	3.5
CN4800500000000	48	005	Angelina County, TX	2006	NA	39965	38111	1854	4.6
CN4800700000000	48	007	Aransas County, TX	2006	NA	11014	10500	514	4.7
CN4800900000000	48	009	Archer County, TX	2006	NA	5449	5266	183	3.4
CN4801100000000	48	011	Armstrong County, TX	2006	NA	1103	1064	39	3.5
CN4801300000000	48	013	Atascosa County, TX	2006	NA	19177	18289	888	4.6
CN4801500000000	48	015	Austin County, TX	2006	NA	12695	12148	547	4.3
CN4801700000000	48	017	Bailey County, TX	2006	NA	3157	3001	156	4.9
CN4801900000000	48	019	Bandera County, TX	2006	NA	9742	9331	411	4.2
CN4802100000000	48	021	Bastrop County, TX	2006	NA	34124	32555	1569	4.6
CN4802300000000	48	023	Baylor County, TX	2006	NA	1922	1843	79	4.1
CN4802500000000	48	025	Bee County, TX	2006	NA	11415	10697	718	6.3
CN4802700000000	48	027	Bell County, TX	2006	NA	115516	109785	5731	5
CN4802900000000	48	029	Bexar County, TX	2006	NA	728361	694464	33897	4.7
CN4803100000000	48	031	Blanco County, TX	2006	NA	4657	4478	179	3.8
CN4803300000000	48	033	Borden County, TX	2006	NA	406	388	18	4.4
CN4803500000000	48	035	Bosque County, TX	2006	NA	8190	7790	400	4.9
CN4803700000000	48	037	Bowie County, TX	2006	NA	42705	40438	2267	5.3
CN4803900000000	48	039	Brazoria County, TX	2006	NA	134697	128003	6694	5
CN4804100000000	48	041	Brazos County, TX	2006	NA	86883	83395	3488	4
CN4804300000000	48	043	Brewster County, TX	2006	NA	5413	5229	184	3.4
CN4804500000000	48	045	Briscoe County, TX	2006	NA	693	661	32	4.6
CN4804700000000	48	047	Brooks County, TX	2006	NA	3029	2841	188	6.2
CN4804900000000	48	049	Brown County, TX	2006	NA	19020	18178	842	4.4
CN4805100000000	48	051	Burleson County, TX	2006	NA	8343	8006	337	4
CN4805300000000	48	053	Burnet County, TX	2006	NA	21298	20429	869	4.1
CN4805500000000	48	055	Caldwell County, TX	2006	NA	15882	15108	774	4.9
CN4805700000000	48	057	Calhoun County, TX	2006	NA	9372	8919	453	4.8
CN4805900000000	48	059	Callahan County, TX	2006	NA	7109	6835	274	3.9
CN4806100000000	48	061	Cameron County, TX	2006	NA	142935	133567	9368	6.6
CN4806300000000	48	063	Camp County, TX	2006	NA	5494	5218	276	5
CN4806500000000	48	065	Carson County, TX	2006	NA	3518	3395	123	3.5
CN4806700000000	48	067	Cass County, TX	2006	NA	13030	12269	761	5.8
CN4806900000000	48	069	Castro County, TX	2006	NA	3230	3080	150	4.6
CN4807100000000	48	071	Chambers County, TX	2006	NA	13788	13076	712	5.2
CN4807300000000	48	073	Cherokee County, TX	2006	NA	20227	19153	1074	5.3
CN4807500000000	48	075	Childress County, TX	2006	NA	3033	2865	168	5.5
CN4807700000000	48	077	Clay County, TX	2006	NA	6449	6206	243	3.8
CN4807900000000	48	079	Cochran County, TX	2006	NA	1457	1370	87	6
CN4808100000000	48	081	Coke County, TX	2006	NA	1349	1275	74	5.5
CN4808300000000	48	083	Coleman County, TX	2006	NA	4273	4091	182	4.3
CN4808500000000	48	085	Collin County, TX	2006	NA	384587	368310	16277	4.2
CN4808700000000	48	087	Collingsworth County, TX	2006	NA	1553	1486	67	4.3
CN4808900000000	48	089	Colorado County, TX	2006	NA	10676	10221	455	4.3
CN4809100000000	48	091	Comal County, TX	2006	NA	51236	49150	2086	4.1
CN4809300000000	48	093	Comanche County, TX	2006	NA	6349	6066	283	4.5
CN4809500000000	48	095	Concho County, TX	2006	NA	1323	1252	71	5.4
CN4809700000000	48	097	Cooke County, TX	2006	NA	20758	19977	781	3.8
CN4809900000000	48	099	Coryell County, TX	2006	NA	24516	22935	1581	6.4
CN4810100000000	48	101	Cottle County, TX	2006	NA	789	750	39	4.9
CN4810300000000	48	103	Crane County, TX	2006	NA	1722	1647	75	4.4
CN4810500000000	48	105	Crockett County, TX	2006	NA	2027	1958	69	3.4
CN4810700000000	48	107	Crosby County, TX	2006	NA	2844	2690	154	5.4
CN4810900000000	48	109	Culberson County, TX	2006	NA	1636	1585	51	3.1
CN4811100000000	48	111	Dallam County, TX	2006	NA	3021	2920	101	3.3
CN4811300000000	48	113	Dallas County, TX	2006	NA	1146694	1088046	58648	5.1
CN4811500000000	48	115	Dawson County, TX	2006	NA	5080	4748	332	6.5
CN4811700000000	48	117	Deaf Smith County, TX	2006	NA	8209	7861	348	4.2
CN4811900000000	48	119	Delta County, TX	2006	NA	2419	2294	125	5.2
CN4812100000000	48	121	Denton County, TX	2006	NA	326923	313184	13739	4.2
CN4812300000000	48	123	DeWitt County, TX	2006	NA	9208	8803	405	4.4
CN4812500000000	48	125	Dickens County, TX	2006	NA	1199	1148	51	4.3
CN4812700000000	48	127	Dimmit County, TX	2006	NA	3827	3538	289	7.6
CN4812900000000	48	129	Donley County, TX	2006	NA	1813	1728	85	4.7
CN4813100000000	48	131	Duval County, TX	2006	NA	5234	4952	282	5.4
CN4813300000000	48	133	Eastland County, TX	2006	NA	8323	7923	400	4.8
CN4813500000000	48	135	Ector County, TX	2006	NA	65211	62705	2506	3.8
CN4813700000000	48	137	Edwards County, TX	2006	NA	960	919	41	4.3
CN4813900000000	48	139	Ellis County, TX	2006	NA	68403	64983	3420	5
CN4814100000000	48	141	El Paso County, TX	2006	NA	291023	271630	19393	6.7
CN4814300000000	48	143	Erath County, TX	2006	NA	17741	17041	700	3.9
CN4814500000000	48	145	Falls County, TX	2006	NA	7063	6626	437	6.2
CN4814700000000	48	147	Fannin County, TX	2006	NA	13455	12652	803	6
CN4814900000000	48	149	Fayette County, TX	2006	NA	11981	11543	438	3.7
CN4815100000000	48	151	Fisher County, TX	2006	NA	1953	1874	79	4
CN4815300000000	48	153	Floyd County, TX	2006	NA	3127	2943	184	5.9
CN4815500000000	48	155	Foard County, TX	2006	NA	665	636	29	4.4
CN4815700000000	48	157	Fort Bend County, TX	2006	NA	244549	233014	11535	4.7
CN4815900000000	48	159	Franklin County, TX	2006	NA	5478	5251	227	4.1
CN4816100000000	48	161	Freestone County, TX	2006	NA	10099	9703	396	3.9
CN4816300000000	48	163	Frio County, TX	2006	NA	6459	6110	349	5.4
CN4816500000000	48	165	Gaines County, TX	2006	NA	6040	5764	276	4.6
CN4816700000000	48	167	Galveston County, TX	2006	NA	137491	130476	7015	5.1
CN4816900000000	48	169	Garza County, TX	2006	NA	2548	2451	97	3.8
CN4817100000000	48	171	Gillespie County, TX	2006	NA	12815	12398	417	3.3
CN4817300000000	48	173	Glasscock County, TX	2006	NA	579	553	26	4.5
CN4817500000000	48	175	Goliad County, TX	2006	NA	3439	3301	138	4
CN4817700000000	48	177	Gonzales County, TX	2006	NA	9727	9338	389	4
CN4817900000000	48	179	Gray County, TX	2006	NA	10871	10449	422	3.9
CN4818100000000	48	181	Grayson County, TX	2006	NA	56189	53472	2717	4.8
CN4818300000000	48	183	Gregg County, TX	2006	NA	61403	58640	2763	4.5
CN4818500000000	48	185	Grimes County, TX	2006	NA	10454	9896	558	5.3
CN4818700000000	48	187	Guadalupe County, TX	2006	NA	54238	51905	2333	4.3
CN4818900000000	48	189	Hale County, TX	2006	NA	16548	15692	856	5.2
CN4819100000000	48	191	Hall County, TX	2006	NA	1456	1367	89	6.1
CN4819300000000	48	193	Hamilton County, TX	2006	NA	3999	3832	167	4.2
CN4819500000000	48	195	Hansford County, TX	2006	NA	2387	2302	85	3.6
CN4819700000000	48	197	Hardeman County, TX	2006	NA	2332	2239	93	4
CN4819900000000	48	199	Hardin County, TX	2006	NA	25415	24094	1321	5.2
CN4820100000000	48	201	Harris County, TX	2006	NA	1874936	1780465	94471	5
CN4820300000000	48	203	Harrison County, TX	2006	NA	31445	29855	1590	5.1
CN4820500000000	48	205	Hartley County, TX	2006	NA	2198	2111	87	4
CN4820700000000	48	207	Haskell County, TX	2006	NA	2943	2828	115	3.9
CN4820900000000	48	209	Hays County, TX	2006	NA	69521	66632	2889	4.2
CN4821100000000	48	211	Hemphill County, TX	2006	NA	2313	2251	62	2.7
CN4821300000000	48	213	Henderson County, TX	2006	NA	34446	32682	1764	5.1
CN4821500000000	48	215	Hidalgo County, TX	2006	NA	265667	246227	19440	7.3
CN4821700000000	48	217	Hill County, TX	2006	NA	15118	14281	837	5.5
CN4821900000000	48	219	Hockley County, TX	2006	NA	11344	10875	469	4.1
CN4822100000000	48	221	Hood County, TX	2006	NA	22995	21877	1118	4.9
CN4822300000000	48	223	Hopkins County, TX	2006	NA	17341	16617	724	4.2
CN4822500000000	48	225	Houston County, TX	2006	NA	8048	7558	490	6.1
CN4822700000000	48	227	Howard County, TX	2006	NA	13660	13001	659	4.8
CN4822900000000	48	229	Hudspeth County, TX	2006	NA	1424	1326	98	6.9
CN4823100000000	48	231	Hunt County, TX	2006	NA	38463	36470	1993	5.2
CN4823300000000	48	233	Hutchinson County, TX	2006	NA	10997	10518	479	4.4
CN4823500000000	48	235	Irion County, TX	2006	NA	993	958	35	3.5
CN4823700000000	48	237	Jack County, TX	2006	NA	4360	4180	180	4.1
CN4823900000000	48	239	Jackson County, TX	2006	NA	6400	6108	292	4.6
CN4824100000000	48	241	Jasper County, TX	2006	NA	15573	14602	971	6.2
CN4824300000000	48	243	Jeff Davis County, TX	2006	NA	1197	1149	48	4
CN4824500000000	48	245	Jefferson County, TX	2006	NA	111888	105151	6737	6
CN4824700000000	48	247	Jim Hogg County, TX	2006	NA	2690	2575	115	4.3
CN4824900000000	48	249	Jim Wells County, TX	2006	NA	20439	19492	947	4.6
CN4825100000000	48	251	Johnson County, TX	2006	NA	72573	69244	3329	4.6
CN4825300000000	48	253	Jones County, TX	2006	NA	7985	7567	418	5.2
CN4825500000000	48	255	Karnes County, TX	2006	NA	5321	4997	324	6.1
CN4825700000000	48	257	Kaufman County, TX	2006	NA	44396	42182	2214	5
CN4825900000000	48	259	Kendall County, TX	2006	NA	15059	14477	582	3.9
CN4826100000000	48	261	Kenedy County, TX	2006	NA	244	237	7	2.9
CN4826300000000	48	263	Kent County, TX	2006	NA	404	388	16	4
CN4826500000000	48	265	Kerr County, TX	2006	NA	22493	21585	908	4
CN4826700000000	48	267	Kimble County, TX	2006	NA	2223	2139	84	3.8
CN4826900000000	48	269	King County, TX	2006	NA	160	153	7	4.4
CN4827100000000	48	271	Kinney County, TX	2006	NA	1332	1255	77	5.8
CN4827300000000	48	273	Kleberg County, TX	2006	NA	16195	15464	731	4.5
CN4827500000000	48	275	Knox County, TX	2006	NA	1757	1684	73	4.2
CN4827700000000	48	277	Lamar County, TX	2006	NA	23642	22376	1266	5.4
CN4827900000000	48	279	Lamb County, TX	2006	NA	7033	6710	323	4.6
CN4828100000000	48	281	Lampasas County, TX	2006	NA	10492	10075	417	4
CN4828300000000	48	283	La Salle County, TX	2006	NA	2738	2601	137	5
CN4828500000000	48	285	Lavaca County, TX	2006	NA	10226	9856	370	3.6
CN4828700000000	48	287	Lee County, TX	2006	NA	8792	8445	347	3.9
CN4828900000000	48	289	Leon County, TX	2006	NA	7616	7237	379	5
CN4829100000000	48	291	Liberty County, TX	2006	NA	30646	28892	1754	5.7
CN4829300000000	48	293	Limestone County, TX	2006	NA	10231	9750	481	4.7
CN4829500000000	48	295	Lipscomb County, TX	2006	NA	1734	1677	57	3.3
CN4829700000000	48	297	Live Oak County, TX	2006	NA	5051	4824	227	4.5
CN4829900000000	48	299	Llano County, TX	2006	NA	8133	7755	378	4.6
CN4830100000000	48	301	Loving County, TX	2006	NA	38	34	4	10.5
CN4830300000000	48	303	Lubbock County, TX	2006	NA	137550	132153	5397	3.9
CN4830500000000	48	305	Lynn County, TX	2006	NA	2741	2589	152	5.5
CN4830700000000	48	307	McCulloch County, TX	2006	NA	3708	3541	167	4.5
CN4830900000000	48	309	McLennan County, TX	2006	NA	111630	106324	5306	4.8
CN4831100000000	48	311	McMullen County, TX	2006	NA	341	321	20	5.9
CN4831300000000	48	313	Madison County, TX	2006	NA	4944	4686	258	5.2
CN4831500000000	48	315	Marion County, TX	2006	NA	4999	4735	264	5.3
CN4831700000000	48	317	Martin County, TX	2006	NA	2127	2039	88	4.1
CN4831900000000	48	319	Mason County, TX	2006	NA	2428	2356	72	3
CN4832100000000	48	321	Matagorda County, TX	2006	NA	15965	14847	1118	7
CN4832300000000	48	323	Maverick County, TX	2006	NA	19535	17030	2505	12.8
CN4832500000000	48	325	Medina County, TX	2006	NA	19749	18850	899	4.6
CN4832700000000	48	327	Menard County, TX	2006	NA	1067	1023	44	4.1
CN4832900000000	48	329	Midland County, TX	2006	NA	69629	67308	2321	3.3
CN4833100000000	48	331	Milam County, TX	2006	NA	12106	11557	549	4.5
CN4833300000000	48	333	Mills County, TX	2006	NA	2401	2305	96	4
CN4833500000000	48	335	Mitchell County, TX	2006	NA	3360	3163	197	5.9
CN4833700000000	48	337	Montague County, TX	2006	NA	9980	9577	403	4
CN4833900000000	48	339	Montgomery County, TX	2006	NA	195209	186669	8540	4.4
CN4834100000000	48	341	Moore County, TX	2006	NA	10371	10021	350	3.4
CN4834300000000	48	343	Morris County, TX	2006	NA	6155	5824	331	5.4
CN4834500000000	48	345	Motley County, TX	2006	NA	630	605	25	4
CN4834700000000	48	347	Nacogdoches County, TX	2006	NA	30710	29265	1445	4.7
CN4834900000000	48	349	Navarro County, TX	2006	NA	21095	19931	1164	5.5
CN4835100000000	48	351	Newton County, TX	2006	NA	5658	5254	404	7.1
CN4835300000000	48	353	Nolan County, TX	2006	NA	7580	7255	325	4.3
CN4835500000000	48	355	Nueces County, TX	2006	NA	157316	149713	7603	4.8
CN4835700000000	48	357	Ochiltree County, TX	2006	NA	5086	4933	153	3
CN4835900000000	48	359	Oldham County, TX	2006	NA	1017	976	41	4
CN4836100000000	48	361	Orange County, TX	2006	NA	40968	38592	2376	5.8
CN4836300000000	48	363	Palo Pinto County, TX	2006	NA	14387	13775	612	4.3
CN4836500000000	48	365	Panola County, TX	2006	NA	11995	11479	516	4.3
CN4836700000000	48	367	Parker County, TX	2006	NA	51851	49486	2365	4.6
CN4836900000000	48	369	Parmer County, TX	2006	NA	4369	4204	165	3.8
CN4837100000000	48	371	Pecos County, TX	2006	NA	6713	6403	310	4.6
CN4837300000000	48	373	Polk County, TX	2006	NA	16914	15894	1020	6
CN4837500000000	48	375	Potter County, TX	2006	NA	57651	55232	2419	4.2
CN4837700000000	48	377	Presidio County, TX	2006	NA	3214	2876	338	10.5
CN4837900000000	48	379	Rains County, TX	2006	NA	5120	4874	246	4.8
CN4838100000000	48	381	Randall County, TX	2006	NA	66827	64646	2181	3.3
CN4838300000000	48	383	Reagan County, TX	2006	NA	2286	2230	56	2.4
CN4838500000000	48	385	Real County, TX	2006	NA	1344	1279	65	4.8
CN4838700000000	48	387	Red River County, TX	2006	NA	6228	5887	341	5.5
CN4838900000000	48	389	Reeves County, TX	2006	NA	4122	3870	252	6.1
CN4839100000000	48	391	Refugio County, TX	2006	NA	3807	3634	173	4.5
CN4839300000000	48	393	Roberts County, TX	2006	NA	554	537	17	3.1
CN4839500000000	48	395	Robertson County, TX	2006	NA	7459	7100	359	4.8
CN4839700000000	48	397	Rockwall County, TX	2006	NA	35178	33628	1550	4.4
CN4839900000000	48	399	Runnels County, TX	2006	NA	4395	4161	234	5.3
CN4840100000000	48	401	Rusk County, TX	2006	NA	22891	21834	1057	4.6
CN4840300000000	48	403	Sabine County, TX	2006	NA	3416	3120	296	8.7
CN4840500000000	48	405	San Augustine County, TX	2006	NA	3545	3324	221	6.2
CN4840700000000	48	407	San Jacinto County, TX	2006	NA	9939	9360	579	5.8
CN4840900000000	48	409	San Patricio County, TX	2006	NA	29405	27805	1600	5.4
CN4841100000000	48	411	San Saba County, TX	2006	NA	2555	2430	125	4.9
CN4841300000000	48	413	Schleicher County, TX	2006	NA	1356	1305	51	3.8
CN4841500000000	48	415	Scurry County, TX	2006	NA	7111	6779	332	4.7
CN4841700000000	48	417	Shackelford County, TX	2006	NA	2011	1950	61	3
CN4841900000000	48	419	Shelby County, TX	2006	NA	11942	11355	587	4.9
CN4842100000000	48	421	Sherman County, TX	2006	NA	1312	1260	52	4
CN4842300000000	48	423	Smith County, TX	2006	NA	96249	91791	4458	4.6
CN4842500000000	48	425	Somervell County, TX	2006	NA	3746	3567	179	4.8
CN4842700000000	48	427	Starr County, TX	2006	NA	21432	18955	2477	11.6
CN4842900000000	48	429	Stephens County, TX	2006	NA	4419	4240	179	4.1
CN4843100000000	48	431	Sterling County, TX	2006	NA	870	843	27	3.1
CN4843300000000	48	433	Stonewall County, TX	2006	NA	874	845	29	3.3
CN4843500000000	48	435	Sutton County, TX	2006	NA	2832	2757	75	2.6
CN4843700000000	48	437	Swisher County, TX	2006	NA	3500	3346	154	4.4
CN4843900000000	48	439	Tarrant County, TX	2006	NA	859737	819239	40498	4.7
CN4844100000000	48	441	Taylor County, TX	2006	NA	66352	63802	2550	3.8
CN4844300000000	48	443	Terrell County, TX	2006	NA	386	365	21	5.4
CN4844500000000	48	445	Terry County, TX	2006	NA	5619	5330	289	5.1
CN4844700000000	48	447	Throckmorton County, TX	2006	NA	971	937	34	3.5
CN4844900000000	48	449	Titus County, TX	2006	NA	14488	13868	620	4.3
CN4845100000000	48	451	Tom Green County, TX	2006	NA	52123	49975	2148	4.1
CN4845300000000	48	453	Travis County, TX	2006	NA	515190	494371	20819	4
CN4845500000000	48	455	Trinity County, TX	2006	NA	5751	5420	331	5.8
CN4845700000000	48	457	Tyler County, TX	2006	NA	8194	7682	512	6.2
CN4845900000000	48	459	Upshur County, TX	2006	NA	18822	17962	860	4.6
CN4846100000000	48	461	Upton County, TX	2006	NA	1604	1544	60	3.7
CN4846300000000	48	463	Uvalde County, TX	2006	NA	11350	10678	672	5.9
CN4846500000000	48	465	Val Verde County, TX	2006	NA	20210	19009	1201	5.9
CN4846700000000	48	467	Van Zandt County, TX	2006	NA	25197	24056	1141	4.5
CN4846900000000	48	469	Victoria County, TX	2006	NA	44317	42524	1793	4
CN4847100000000	48	471	Walker County, TX	2006	NA	26213	24817	1396	5.3
CN4847300000000	48	473	Waller County, TX	2006	NA	15701	14872	829	5.3
CN4847500000000	48	475	Ward County, TX	2006	NA	4718	4501	217	4.6
CN4847700000000	48	477	Washington County, TX	2006	NA	16031	15358	673	4.2
CN4847900000000	48	479	Webb County, TX	2006	NA	87892	83168	4724	5.4
CN4848100000000	48	481	Wharton County, TX	2006	NA	20548	19572	976	4.7
CN4848300000000	48	483	Wheeler County, TX	2006	NA	2803	2711	92	3.3
CN4848500000000	48	485	Wichita County, TX	2006	NA	62656	59938	2718	4.3
CN4848700000000	48	487	Wilbarger County, TX	2006	NA	7870	7589	281	3.6
CN4848900000000	48	489	Willacy County, TX	2006	NA	7619	6930	689	9
CN4849100000000	48	491	Williamson County, TX	2006	NA	188614	180737	7877	4.2
CN4849300000000	48	493	Wilson County, TX	2006	NA	18229	17428	801	4.4
CN4849500000000	48	495	Winkler County, TX	2006	NA	3213	3088	125	3.9
CN4849700000000	48	497	Wise County, TX	2006	NA	27861	26648	1213	4.4
CN4849900000000	48	499	Wood County, TX	2006	NA	17846	16942	904	5.1
CN4850100000000	48	501	Yoakum County, TX	2006	NA	3579	3438	141	3.9
CN4850300000000	48	503	Young County, TX	2006	NA	9655	9289	366	3.8
CN4850500000000	48	505	Zapata County, TX	2006	NA	4916	4617	299	6.1
CN4850700000000	48	507	Zavala County, TX	2006	NA	3749	3311	438	11.7
CN4900100000000	49	001	Beaver County, UT	2006	NA	3119	3024	95	3
CN4900300000000	49	003	Box Elder County, UT	2006	NA	22846	22115	731	3.2
CN4900500000000	49	005	Cache County, UT	2006	NA	58285	56941	1344	2.3
CN4900700000000	49	007	Carbon County, UT	2006	NA	9883	9540	343	3.5
CN4900900000000	49	009	Daggett County, UT	2006	NA	506	482	24	4.7
CN4901100000000	49	011	Davis County, UT	2006	NA	140621	136545	4076	2.9
CN4901300000000	49	013	Duchesne County, UT	2006	NA	8494	8252	242	2.8
CN4901500000000	49	015	Emery County, UT	2006	NA	5235	5052	183	3.5
CN4901700000000	49	017	Garfield County, UT	2006	NA	2677	2543	134	5
CN4901900000000	49	019	Grand County, UT	2006	NA	5030	4786	244	4.9
CN4902100000000	49	021	Iron County, UT	2006	NA	20944	20335	609	2.9
CN4902300000000	49	023	Juab County, UT	2006	NA	4036	3887	149	3.7
CN4902500000000	49	025	Kane County, UT	2006	NA	3438	3315	123	3.6
CN4902700000000	49	027	Millard County, UT	2006	NA	6188	6006	182	2.9
CN4902900000000	49	029	Morgan County, UT	2006	NA	3942	3823	119	3
CN4903100000000	49	031	Piute County, UT	2006	NA	891	864	27	3
CN4903300000000	49	033	Rich County, UT	2006	NA	1407	1375	32	2.3
CN4903500000000	49	035	Salt Lake County, UT	2006	NA	534687	519133	15554	2.9
CN4903700000000	49	037	San Juan County, UT	2006	NA	4885	4586	299	6.1
CN4903900000000	49	039	Sanpete County, UT	2006	NA	10662	10262	400	3.8
CN4904100000000	49	041	Sevier County, UT	2006	NA	9390	9089	301	3.2
CN4904300000000	49	043	Summit County, UT	2006	NA	21768	21143	625	2.9
CN4904500000000	49	045	Tooele County, UT	2006	NA	26296	25437	859	3.3
CN4904700000000	49	047	Uintah County, UT	2006	NA	16300	15902	398	2.4
CN4904900000000	49	049	Utah County, UT	2006	NA	214250	208141	6109	2.9
CN4905100000000	49	051	Wasatch County, UT	2006	NA	10137	9816	321	3.2
CN4905300000000	49	053	Washington County, UT	2006	NA	61333	59487	1846	3
CN4905500000000	49	055	Wayne County, UT	2006	NA	1386	1326	60	4.3
CN4905700000000	49	057	Weber County, UT	2006	NA	109819	106125	3694	3.4
CN5000100000000	50	001	Addison County, VT	2006	NA	21898	21176	722	3.3
CN5000300000000	50	003	Bennington County, VT	2006	NA	20675	19925	750	3.6
CN5000500000000	50	005	Caledonia County, VT	2006	NA	16945	16249	696	4.1
CN5000700000000	50	007	Chittenden County, VT	2006	NA	88480	85605	2875	3.2
CN5000900000000	50	009	Essex County, VT	2006	NA	3290	3161	129	3.9
CN5001100000000	50	011	Franklin County, VT	2006	NA	26432	25334	1098	4.2
CN5001300000000	50	013	Grand Isle County, VT	2006	NA	4326	4101	225	5.2
CN5001500000000	50	015	Lamoille County, VT	2006	NA	15152	14524	628	4.1
CN5001700000000	50	017	Orange County, VT	2006	NA	16673	16115	558	3.3
CN5001900000000	50	019	Orleans County, VT	2006	NA	14568	13788	780	5.4
CN5002100000000	50	021	Rutland County, VT	2006	NA	36110	34684	1426	3.9
CN5002300000000	50	023	Washington County, VT	2006	NA	34540	33218	1322	3.8
CN5002500000000	50	025	Windham County, VT	2006	NA	24887	23953	934	3.8
CN5002700000000	50	027	Windsor County, VT	2006	NA	33021	32032	989	3
CN5100100000000	51	001	Accomack County, VA	2006	NA	18569	17774	795	4.3
CN5100300000000	51	003	Albemarle County, VA	2006	NA	49842	48619	1223	2.5
CN5100500000000	51	005	Alleghany County, VA	2006	NA	7342	6985	357	4.9
CN5100700000000	51	007	Amelia County, VA	2006	NA	6481	6284	197	3
CN5100900000000	51	009	Amherst County, VA	2006	NA	15529	15023	506	3.3
CN5101100000000	51	011	Appomattox County, VA	2006	NA	6961	6704	257	3.7
CN5101300000000	51	013	Arlington County, VA	2006	NA	127332	124804	2528	2
CN5101500000000	51	015	Augusta County, VA	2006	NA	36838	35860	978	2.7
CN5101700000000	51	017	Bath County, VA	2006	NA	2893	2798	95	3.3
CN5101900000000	51	019	Bedford County, VA	2006	NA	37654	36524	1130	3
CN5102100000000	51	021	Bland County, VA	2006	NA	3222	3100	122	3.8
CN5102300000000	51	023	Botetourt County, VA	2006	NA	17430	16976	454	2.6
CN5102500000000	51	025	Brunswick County, VA	2006	NA	6832	6499	333	4.9
CN5102700000000	51	027	Buchanan County, VA	2006	NA	8419	7997	422	5
CN5102900000000	51	029	Buckingham County, VA	2006	NA	6836	6589	247	3.6
CN5103100000000	51	031	Campbell County, VA	2006	NA	27168	26281	887	3.3
CN5103300000000	51	033	Caroline County, VA	2006	NA	13560	13095	465	3.4
CN5103500000000	51	035	Carroll County, VA	2006	NA	13826	13097	729	5.3
CN5103600000000	51	036	Charles City County, VA	2006	NA	3837	3684	153	4
CN5103700000000	51	037	Charlotte County, VA	2006	NA	5257	4904	353	6.7
CN5104100000000	51	041	Chesterfield County, VA	2006	NA	164168	159569	4599	2.8
CN5104300000000	51	043	Clarke County, VA	2006	NA	8054	7855	199	2.5
CN5104500000000	51	045	Craig County, VA	2006	NA	2556	2467	89	3.5
CN5104700000000	51	047	Culpeper County, VA	2006	NA	20066	19410	656	3.3
CN5104900000000	51	049	Cumberland County, VA	2006	NA	4523	4366	157	3.5
CN5105100000000	51	051	Dickenson County, VA	2006	NA	5660	5369	291	5.1
CN5105300000000	51	053	Dinwiddie County, VA	2006	NA	12770	12362	408	3.2
CN5105700000000	51	057	Essex County, VA	2006	NA	5432	5217	215	4
CN5105900000000	51	059	Fairfax County, VA	2006	NA	577489	564587	12902	2.2
CN5106100000000	51	061	Fauquier County, VA	2006	NA	36551	35651	900	2.5
CN5106300000000	51	063	Floyd County, VA	2006	NA	6998	6768	230	3.3
CN5106500000000	51	065	Fluvanna County, VA	2006	NA	13385	13065	320	2.4
CN5106700000000	51	067	Franklin County, VA	2006	NA	26011	25178	833	3.2
CN5106900000000	51	069	Frederick County, VA	2006	NA	40563	39480	1083	2.7
CN5107100000000	51	071	Giles County, VA	2006	NA	8481	8162	319	3.8
CN5107300000000	51	073	Gloucester County, VA	2006	NA	20348	19807	541	2.7
CN5107500000000	51	075	Goochland County, VA	2006	NA	10821	10552	269	2.5
CN5107700000000	51	077	Grayson County, VA	2006	NA	7104	6711	393	5.5
CN5107900000000	51	079	Greene County, VA	2006	NA	10152	9915	237	2.3
CN5108100000000	51	081	Greensville County, VA	2006	NA	3933	3765	168	4.3
CN5108300000000	51	083	Halifax County, VA	2006	NA	15763	14834	929	5.9
CN5108500000000	51	085	Hanover County, VA	2006	NA	54752	53357	1395	2.5
CN5108700000000	51	087	Henrico County, VA	2006	NA	159613	154985	4628	2.9
CN5108900000000	51	089	Henry County, VA	2006	NA	25107	23903	1204	4.8
CN5109100000000	51	091	Highland County, VA	2006	NA	1130	1094	36	3.2
CN5109300000000	51	093	Isle of Wight County, VA	2006	NA	18275	17708	567	3.1
CN5109500000000	51	095	James City County, VA	2006	NA	30328	29515	813	2.7
CN5109700000000	51	097	King and Queen County, VA	2006	NA	3334	3221	113	3.4
CN5109900000000	51	099	King George County, VA	2006	NA	9484	9162	322	3.4
CN5110100000000	51	101	King William County, VA	2006	NA	8290	8062	228	2.8
CN5110300000000	51	103	Lancaster County, VA	2006	NA	5184	4954	230	4.4
CN5110500000000	51	105	Lee County, VA	2006	NA	9277	8873	404	4.4
CN5110700000000	51	107	Loudoun County, VA	2006	NA	156992	153601	3391	2.2
CN5110900000000	51	109	Louisa County, VA	2006	NA	15800	15308	492	3.1
CN5111100000000	51	111	Lunenburg County, VA	2006	NA	5572	5324	248	4.5
CN5111300000000	51	113	Madison County, VA	2006	NA	7274	7080	194	2.7
CN5111500000000	51	115	Mathews County, VA	2006	NA	4454	4337	117	2.6
CN5111700000000	51	117	Mecklenburg County, VA	2006	NA	13121	12424	697	5.3
CN5111900000000	51	119	Middlesex County, VA	2006	NA	5059	4897	162	3.2
CN5112100000000	51	121	Montgomery County, VA	2006	NA	43558	42200	1358	3.1
CN5112500000000	51	125	Nelson County, VA	2006	NA	7715	7500	215	2.8
CN5112700000000	51	127	New Kent County, VA	2006	NA	9267	9009	258	2.8
CN5113100000000	51	131	Northampton County, VA	2006	NA	5865	5604	261	4.5
CN5113300000000	51	133	Northumberland County, VA	2006	NA	5971	5719	252	4.2
CN5113500000000	51	135	Nottoway County, VA	2006	NA	6427	6160	267	4.2
CN5113700000000	51	137	Orange County, VA	2006	NA	15043	14582	461	3.1
CN5113900000000	51	139	Page County, VA	2006	NA	11178	10651	527	4.7
CN5114100000000	51	141	Patrick County, VA	2006	NA	8808	8397	411	4.7
CN5114300000000	51	143	Pittsylvania County, VA	2006	NA	31044	29335	1709	5.5
CN5114500000000	51	145	Powhatan County, VA	2006	NA	14216	13845	371	2.6
CN5114700000000	51	147	Prince Edward County, VA	2006	NA	8892	8462	430	4.8
CN5114900000000	51	149	Prince George County, VA	2006	NA	14854	14349	505	3.4
CN5115300000000	51	153	Prince William County, VA	2006	NA	197085	192301	4784	2.4
CN5115500000000	51	155	Pulaski County, VA	2006	NA	18087	17377	710	3.9
CN5115700000000	51	157	Rappahannock County, VA	2006	NA	4265	4164	101	2.4
CN5115900000000	51	159	Richmond County, VA	2006	NA	3496	3326	170	4.9
CN5116100000000	51	161	Roanoke County, VA	2006	NA	48751	47481	1270	2.6
CN5116300000000	51	163	Rockbridge County, VA	2006	NA	11238	10928	310	2.8
CN5116500000000	51	165	Rockingham County, VA	2006	NA	42116	41097	1019	2.4
CN5116700000000	51	167	Russell County, VA	2006	NA	11812	11099	713	6
CN5116900000000	51	169	Scott County, VA	2006	NA	9924	9434	490	4.9
CN5117100000000	51	171	Shenandoah County, VA	2006	NA	19786	19188	598	3
CN5117300000000	51	173	Smyth County, VA	2006	NA	15339	14620	719	4.7
CN5117500000000	51	175	Southampton County, VA	2006	NA	7588	7308	280	3.7
CN5117700000000	51	177	Spotsylvania County, VA	2006	NA	64312	62735	1577	2.5
CN5117900000000	51	179	Stafford County, VA	2006	NA	63634	62051	1583	2.5
CN5118100000000	51	181	Surry County, VA	2006	NA	3707	3580	127	3.4
CN5118300000000	51	183	Sussex County, VA	2006	NA	4476	4273	203	4.5
CN5118500000000	51	185	Tazewell County, VA	2006	NA	19985	19186	799	4
CN5118700000000	51	187	Warren County, VA	2006	NA	19146	18604	542	2.8
CN5119100000000	51	191	Washington County, VA	2006	NA	26377	25278	1099	4.2
CN5119300000000	51	193	Westmoreland County, VA	2006	NA	8259	7933	326	3.9
CN5119500000000	51	195	Wise County, VA	2006	NA	17279	16497	782	4.5
CN5119700000000	51	197	Wythe County, VA	2006	NA	14984	14366	618	4.1
CN5119900000000	51	199	York County, VA	2006	NA	31071	30232	839	2.7
CN5151000000000	51	510	Alexandria city, VA	2006	NA	86832	84891	1941	2.2
CN5152000000000	51	520	Bristol city, VA	2006	NA	7937	7550	387	4.9
CN5153000000000	51	530	Buena Vista city, VA	2006	NA	3389	3273	116	3.4
CN5154000000000	51	540	Charlottesville city, VA	2006	NA	20407	19744	663	3.2
CN5155000000000	51	550	Chesapeake city, VA	2006	NA	114199	110468	3731	3.3
CN5157000000000	51	570	Colonial Heights city, VA	2006	NA	9134	8838	296	3.2
CN5158000000000	51	580	Covington city, VA	2006	NA	2790	2589	201	7.2
CN5159000000000	51	590	Danville city, VA	2006	NA	20172	18405	1767	8.8
CN5159500000000	51	595	Emporia city, VA	2006	NA	2503	2364	139	5.6
CN5160000000000	51	600	Fairfax city, VA	2006	NA	13230	12903	327	2.5
CN5161000000000	51	610	Falls Church city, VA	2006	NA	6509	6320	189	2.9
CN5162000000000	51	620	Franklin city, VA	2006	NA	3798	3617	181	4.8
CN5163000000000	51	630	Fredericksburg city, VA	2006	NA	11645	11180	465	4
CN5164000000000	51	640	Galax city, VA	2006	NA	3035	2849	186	6.1
CN5165000000000	51	650	Hampton city, VA	2006	NA	67151	64648	2503	3.7
CN5166000000000	51	660	Harrisonburg city, VA	2006	NA	21715	21062	653	3
CN5167000000000	51	670	Hopewell city, VA	2006	NA	10294	9811	483	4.7
CN5167800000000	51	678	Lexington city, VA	2006	NA	2291	2183	108	4.7
CN5168000000000	51	680	Lynchburg city, VA	2006	NA	31925	30750	1175	3.7
CN5168300000000	51	683	Manassas city, VA	2006	NA	20267	19732	535	2.6
CN5168500000000	51	685	Manassas Park city, VA	2006	NA	6622	6467	155	2.3
CN5169000000000	51	690	Martinsville city, VA	2006	NA	5838	5410	428	7.3
CN5170000000000	51	700	Newport News city, VA	2006	NA	86219	83110	3109	3.6
CN5171000000000	51	710	Norfolk city, VA	2006	NA	95709	91598	4111	4.3
CN5172000000000	51	720	Norton city, VA	2006	NA	1514	1435	79	5.2
CN5173000000000	51	730	Petersburg city, VA	2006	NA	13888	13012	876	6.3
CN5173500000000	51	735	Poquoson city, VA	2006	NA	6299	6150	149	2.4
CN5174000000000	51	740	Portsmouth city, VA	2006	NA	45779	43744	2035	4.4
CN5175000000000	51	750	Radford city, VA	2006	NA	7239	6961	278	3.8
CN5176000000000	51	760	Richmond city, VA	2006	NA	95448	90997	4451	4.7
CN5177000000000	51	770	Roanoke city, VA	2006	NA	45481	43761	1720	3.8
CN5177500000000	51	775	Salem city, VA	2006	NA	13073	12680	393	3
CN5179000000000	51	790	Staunton city, VA	2006	NA	11241	10893	348	3.1
CN5180000000000	51	800	Suffolk city, VA	2006	NA	39342	37958	1384	3.5
CN5181000000000	51	810	Virginia Beach city, VA	2006	NA	221582	215051	6531	2.9
CN5182000000000	51	820	Waynesboro city, VA	2006	NA	9877	9559	318	3.2
CN5183000000000	51	830	Williamsburg city, VA	2006	NA	4811	4525	286	5.9
CN5184000000000	51	840	Winchester city, VA	2006	NA	14212	13793	419	2.9
CN5300100000000	53	001	Adams County, WA	2006	NA	8063	7512	551	6.8
CN5300300000000	53	003	Asotin County, WA	2006	NA	10232	9758	474	4.6
CN5300500000000	53	005	Benton County, WA	2006	NA	83218	78060	5158	6.2
CN5300700000000	53	007	Chelan County, WA	2006	NA	39463	37252	2211	5.6
CN5300900000000	53	009	Clallam County, WA	2006	NA	29619	27739	1880	6.3
CN5301100000000	53	011	Clark County, WA	2006	NA	205896	192980	12916	6.3
CN5301300000000	53	013	Columbia County, WA	2006	NA	1506	1366	140	9.3
CN5301500000000	53	015	Cowlitz County, WA	2006	NA	42952	39906	3046	7.1
CN5301700000000	53	017	Douglas County, WA	2006	NA	20129	19037	1092	5.4
CN5301900000000	53	019	Ferry County, WA	2006	NA	2946	2650	296	10
CN5302100000000	53	021	Franklin County, WA	2006	NA	30005	27719	2286	7.6
CN5302300000000	53	023	Garfield County, WA	2006	NA	1043	983	60	5.8
CN5302500000000	53	025	Grant County, WA	2006	NA	38924	36151	2773	7.1
CN5302700000000	53	027	Grays Harbor County, WA	2006	NA	31044	28686	2358	7.6
CN5302900000000	53	029	Island County, WA	2006	NA	32363	30548	1815	5.6
CN5303100000000	53	031	Jefferson County, WA	2006	NA	13603	12861	742	5.5
CN5303300000000	53	033	King County, WA	2006	NA	1043636	1004810	38826	3.7
CN5303500000000	53	035	Kitsap County, WA	2006	NA	121958	115759	6199	5.1
CN5303700000000	53	037	Kittitas County, WA	2006	NA	19466	18357	1109	5.7
CN5303900000000	53	039	Klickitat County, WA	2006	NA	9517	8785	732	7.7
CN5304100000000	53	041	Lewis County, WA	2006	NA	31197	28853	2344	7.5
CN5304300000000	53	043	Lincoln County, WA	2006	NA	4663	4377	286	6.1
CN5304500000000	53	045	Mason County, WA	2006	NA	24647	23085	1562	6.3
CN5304700000000	53	047	Okanogan County, WA	2006	NA	20654	19173	1481	7.2
CN5304900000000	53	049	Pacific County, WA	2006	NA	9161	8515	646	7.1
CN5305100000000	53	051	Pend Oreille County, WA	2006	NA	5115	4705	410	8
CN5305300000000	53	053	Pierce County, WA	2006	NA	373684	352910	20774	5.6
CN5305500000000	53	055	San Juan County, WA	2006	NA	8222	7884	338	4.1
CN5305700000000	53	057	Skagit County, WA	2006	NA	56494	53316	3178	5.6
CN5305900000000	53	059	Skamania County, WA	2006	NA	5086	4696	390	7.7
CN5306100000000	53	061	Snohomish County, WA	2006	NA	358027	343319	14708	4.1
CN5306300000000	53	063	Spokane County, WA	2006	NA	227128	214779	12349	5.4
CN5306500000000	53	065	Stevens County, WA	2006	NA	18169	16778	1391	7.7
CN5306700000000	53	067	Thurston County, WA	2006	NA	123916	117699	6217	5
CN5306900000000	53	069	Wahkiakum County, WA	2006	NA	1623	1506	117	7.2
CN5307100000000	53	071	Walla Walla County, WA	2006	NA	28717	27028	1689	5.9
CN5307300000000	53	073	Whatcom County, WA	2006	NA	102885	97820	5065	4.9
CN5307500000000	53	075	Whitman County, WA	2006	NA	20338	19456	882	4.3
CN5307700000000	53	077	Yakima County, WA	2006	NA	118626	109807	8819	7.4
CN5400100000000	54	001	Barbour County, WV	2006	NA	6740	6353	387	5.7
CN5400300000000	54	003	Berkeley County, WV	2006	NA	45306	43394	1912	4.2
CN5400500000000	54	005	Boone County, WV	2006	NA	9422	8976	446	4.7
CN5400700000000	54	007	Braxton County, WV	2006	NA	5954	5625	329	5.5
CN5400900000000	54	009	Brooke County, WV	2006	NA	10974	10162	812	7.4
CN5401100000000	54	011	Cabell County, WV	2006	NA	44611	42568	2043	4.6
CN5401300000000	54	013	Calhoun County, WV	2006	NA	2718	2521	197	7.2
CN5401500000000	54	015	Clay County, WV	2006	NA	3487	3247	240	6.9
CN5401700000000	54	017	Doddridge County, WV	2006	NA	2882	2731	151	5.2
CN5401900000000	54	019	Fayette County, WV	2006	NA	18034	17016	1018	5.6
CN5402100000000	54	021	Gilmer County, WV	2006	NA	3107	2961	146	4.7
CN5402300000000	54	023	Grant County, WV	2006	NA	5131	4822	309	6
CN5402500000000	54	025	Greenbrier County, WV	2006	NA	15628	14663	965	6.2
CN5402700000000	54	027	Hampshire County, WV	2006	NA	9817	9427	390	4
CN5402900000000	54	029	Hancock County, WV	2006	NA	14572	13462	1110	7.6
CN5403100000000	54	031	Hardy County, WV	2006	NA	7266	6980	286	3.9
CN5403300000000	54	033	Harrison County, WV	2006	NA	30786	29338	1448	4.7
CN5403500000000	54	035	Jackson County, WV	2006	NA	11824	11204	620	5.2
CN5403700000000	54	037	Jefferson County, WV	2006	NA	24802	23959	843	3.4
CN5403900000000	54	039	Kanawha County, WV	2006	NA	91497	87484	4013	4.4
CN5404100000000	54	041	Lewis County, WV	2006	NA	7362	6983	379	5.1
CN5404300000000	54	043	Lincoln County, WV	2006	NA	7961	7475	486	6.1
CN5404500000000	54	045	Logan County, WV	2006	NA	12894	12265	629	4.9
CN5404700000000	54	047	McDowell County, WV	2006	NA	6948	6413	535	7.7
CN5404900000000	54	049	Marion County, WV	2006	NA	26160	24990	1170	4.5
CN5405100000000	54	051	Marshall County, WV	2006	NA	15014	14155	859	5.7
CN5405300000000	54	053	Mason County, WV	2006	NA	10478	9747	731	7
CN5405500000000	54	055	Mercer County, WV	2006	NA	24324	23122	1202	4.9
CN5405700000000	54	057	Mineral County, WV	2006	NA	13448	12767	681	5.1
CN5405900000000	54	059	Mingo County, WV	2006	NA	8590	8118	472	5.5
CN5406100000000	54	061	Monongalia County, WV	2006	NA	45922	44330	1592	3.5
CN5406300000000	54	063	Monroe County, WV	2006	NA	5944	5617	327	5.5
CN5406500000000	54	065	Morgan County, WV	2006	NA	7122	6786	336	4.7
CN5406700000000	54	067	Nicholas County, WV	2006	NA	10662	10091	571	5.4
CN5406900000000	54	069	Ohio County, WV	2006	NA	20981	19976	1005	4.8
CN5407100000000	54	071	Pendleton County, WV	2006	NA	3850	3687	163	4.2
CN5407300000000	54	073	Pleasants County, WV	2006	NA	3177	2999	178	5.6
CN5407500000000	54	075	Pocahontas County, WV	2006	NA	3818	3522	296	7.8
CN5407700000000	54	077	Preston County, WV	2006	NA	14906	14230	676	4.5
CN5407900000000	54	079	Putnam County, WV	2006	NA	27138	26023	1115	4.1
CN5408100000000	54	081	Raleigh County, WV	2006	NA	32787	31297	1490	4.5
CN5408300000000	54	083	Randolph County, WV	2006	NA	13132	12463	669	5.1
CN5408500000000	54	085	Ritchie County, WV	2006	NA	4745	4507	238	5
CN5408700000000	54	087	Roane County, WV	2006	NA	5529	5182	347	6.3
CN5408900000000	54	089	Summers County, WV	2006	NA	4739	4440	299	6.3
CN5409100000000	54	091	Taylor County, WV	2006	NA	6987	6617	370	5.3
CN5409300000000	54	093	Tucker County, WV	2006	NA	3060	2871	189	6.2
CN5409500000000	54	095	Tyler County, WV	2006	NA	3663	3401	262	7.2
CN5409700000000	54	097	Upshur County, WV	2006	NA	10793	10282	511	4.7
CN5409900000000	54	099	Wayne County, WV	2006	NA	17666	16706	960	5.4
CN5410100000000	54	101	Webster County, WV	2006	NA	3425	3228	197	5.8
CN5410300000000	54	103	Wetzel County, WV	2006	NA	6346	5827	519	8.2
CN5410500000000	54	105	Wirt County, WV	2006	NA	2545	2391	154	6.1
CN5410700000000	54	107	Wood County, WV	2006	NA	41183	39152	2031	4.9
CN5410900000000	54	109	Wyoming County, WV	2006	NA	8314	7850	464	5.6
CN5500100000000	55	001	Adams County, WI	2006	NA	9904	9244	660	6.7
CN5500300000000	55	003	Ashland County, WI	2006	NA	9251	8689	562	6.1
CN5500500000000	55	005	Barron County, WI	2006	NA	25551	24139	1412	5.5
CN5500700000000	55	007	Bayfield County, WI	2006	NA	8268	7738	530	6.4
CN5500900000000	55	009	Brown County, WI	2006	NA	136965	130739	6226	4.5
CN5501100000000	55	011	Buffalo County, WI	2006	NA	8522	8182	340	4
CN5501300000000	55	013	Burnett County, WI	2006	NA	8468	7973	495	5.8
CN5501500000000	55	015	Calumet County, WI	2006	NA	25350	24314	1036	4.1
CN5501700000000	55	017	Chippewa County, WI	2006	NA	33610	31875	1735	5.2
CN5501900000000	55	019	Clark County, WI	2006	NA	17805	16840	965	5.4
CN5502100000000	55	021	Columbia County, WI	2006	NA	31622	30135	1487	4.7
CN5502300000000	55	023	Crawford County, WI	2006	NA	9666	9191	475	4.9
CN5502500000000	55	025	Dane County, WI	2006	NA	288708	279286	9422	3.3
CN5502700000000	55	027	Dodge County, WI	2006	NA	47161	44807	2354	5
CN5502900000000	55	029	Door County, WI	2006	NA	16660	15760	900	5.4
CN5503100000000	55	031	Douglas County, WI	2006	NA	23067	21906	1161	5
CN5503300000000	55	033	Dunn County, WI	2006	NA	23885	22792	1093	4.6
CN5503500000000	55	035	Eau Claire County, WI	2006	NA	55494	53286	2208	4
CN5503700000000	55	037	Florence County, WI	2006	NA	2584	2412	172	6.7
CN5503900000000	55	039	Fond du Lac County, WI	2006	NA	56461	53797	2664	4.7
CN5504100000000	55	041	Forest County, WI	2006	NA	5010	4678	332	6.6
CN5504300000000	55	043	Grant County, WI	2006	NA	27172	25956	1216	4.5
CN5504500000000	55	045	Green County, WI	2006	NA	20274	19383	891	4.4
CN5504700000000	55	047	Green Lake County, WI	2006	NA	10444	9866	578	5.5
CN5504900000000	55	049	Iowa County, WI	2006	NA	14358	13735	623	4.3
CN5505100000000	55	051	Iron County, WI	2006	NA	3185	2924	261	8.2
CN5505300000000	55	053	Jackson County, WI	2006	NA	9985	9434	551	5.5
CN5505500000000	55	055	Jefferson County, WI	2006	NA	42827	40875	1952	4.6
CN5505700000000	55	057	Juneau County, WI	2006	NA	13475	12698	777	5.8
CN5505900000000	55	059	Kenosha County, WI	2006	NA	82761	78297	4464	5.4
CN5506100000000	55	061	Kewaunee County, WI	2006	NA	11837	11310	527	4.5
CN5506300000000	55	063	La Crosse County, WI	2006	NA	63667	61260	2407	3.8
CN5506500000000	55	065	Lafayette County, WI	2006	NA	9163	8787	376	4.1
CN5506700000000	55	067	Langlade County, WI	2006	NA	10857	10204	653	6
CN5506900000000	55	069	Lincoln County, WI	2006	NA	15900	15018	882	5.5
CN5507100000000	55	071	Manitowoc County, WI	2006	NA	45407	43161	2246	4.9
CN5507300000000	55	073	Marathon County, WI	2006	NA	75171	71944	3227	4.3
CN5507500000000	55	075	Marinette County, WI	2006	NA	22012	20592	1420	6.5
CN5507700000000	55	077	Marquette County, WI	2006	NA	7833	7364	469	6
CN5507800000000	55	078	Menominee County, WI	2006	NA	1669	1483	186	11.1
CN5507900000000	55	079	Milwaukee County, WI	2006	NA	454893	429034	25859	5.7
CN5508100000000	55	081	Monroe County, WI	2006	NA	23910	22884	1026	4.3
CN5508300000000	55	083	Oconto County, WI	2006	NA	20538	19286	1252	6.1
CN5508500000000	55	085	Oneida County, WI	2006	NA	20069	18897	1172	5.8
CN5508700000000	55	087	Outagamie County, WI	2006	NA	95965	91517	4448	4.6
CN5508900000000	55	089	Ozaukee County, WI	2006	NA	48514	46768	1746	3.6
CN5509100000000	55	091	Pepin County, WI	2006	NA	4087	3893	194	4.7
CN5509300000000	55	093	Pierce County, WI	2006	NA	23684	22678	1006	4.2
CN5509500000000	55	095	Polk County, WI	2006	NA	24182	22786	1396	5.8
CN5509700000000	55	097	Portage County, WI	2006	NA	40883	39040	1843	4.5
CN5509900000000	55	099	Price County, WI	2006	NA	8671	8191	480	5.5
CN5510100000000	55	101	Racine County, WI	2006	NA	99399	93764	5635	5.7
CN5510300000000	55	103	Richland County, WI	2006	NA	9942	9477	465	4.7
CN5510500000000	55	105	Rock County, WI	2006	NA	84165	79907	4258	5.1
CN5510700000000	55	107	Rusk County, WI	2006	NA	7888	7363	525	6.7
CN5510900000000	55	109	St. Croix County, WI	2006	NA	46753	44441	2312	4.9
CN5511100000000	55	111	Sauk County, WI	2006	NA	34783	33211	1572	4.5
CN5511300000000	55	113	Sawyer County, WI	2006	NA	9344	8742	602	6.4
CN5511500000000	55	115	Shawano County, WI	2006	NA	22485	21340	1145	5.1
CN5511700000000	55	117	Sheboygan County, WI	2006	NA	65296	62707	2589	4
CN5511900000000	55	119	Taylor County, WI	2006	NA	10954	10404	550	5
CN5512100000000	55	121	Trempealeau County, WI	2006	NA	16183	15484	699	4.3
CN5512300000000	55	123	Vernon County, WI	2006	NA	14399	13703	696	4.8
CN5512500000000	55	125	Vilas County, WI	2006	NA	11765	11050	715	6.1
CN5512700000000	55	127	Walworth County, WI	2006	NA	56073	53651	2422	4.3
CN5512900000000	55	129	Washburn County, WI	2006	NA	8093	7560	533	6.6
CN5513100000000	55	131	Washington County, WI	2006	NA	73930	70867	3063	4.1
CN5513300000000	55	133	Waukesha County, WI	2006	NA	216291	208079	8212	3.8
CN5513500000000	55	135	Waupaca County, WI	2006	NA	28487	27060	1427	5
CN5513700000000	55	137	Waushara County, WI	2006	NA	12842	12117	725	5.6
CN5513900000000	55	139	Winnebago County, WI	2006	NA	92363	88220	4143	4.5
CN5514100000000	55	141	Wood County, WI	2006	NA	40100	37957	2143	5.3
CN5600100000000	56	001	Albany County, WY	2006	NA	18612	18125	487	2.6
CN5600300000000	56	003	Big Horn County, WY	2006	NA	5291	5071	220	4.2
CN5600500000000	56	005	Campbell County, WY	2006	NA	24864	24332	532	2.1
CN5600700000000	56	007	Carbon County, WY	2006	NA	7813	7552	261	3.3
CN5600900000000	56	009	Converse County, WY	2006	NA	6807	6574	233	3.4
CN5601100000000	56	011	Crook County, WY	2006	NA	3354	3260	94	2.8
CN5601300000000	56	013	Fremont County, WY	2006	NA	17585	16826	759	4.3
CN5601500000000	56	015	Goshen County, WY	2006	NA	5856	5630	226	3.9
CN5601700000000	56	017	Hot Springs County, WY	2006	NA	2310	2226	84	3.6
CN5601900000000	56	019	Johnson County, WY	2006	NA	3815	3696	119	3.1
CN5602100000000	56	021	Laramie County, WY	2006	NA	41432	39830	1602	3.9
CN5602300000000	56	023	Lincoln County, WY	2006	NA	8143	7860	283	3.5
CN5602500000000	56	025	Natrona County, WY	2006	NA	39770	38585	1185	3
CN5602700000000	56	027	Niobrara County, WY	2006	NA	1129	1092	37	3.3
CN5602900000000	56	029	Park County, WY	2006	NA	14123	13618	505	3.6
CN5603100000000	56	031	Platte County, WY	2006	NA	3963	3788	175	4.4
CN5603300000000	56	033	Sheridan County, WY	2006	NA	15353	14868	485	3.2
CN5603500000000	56	035	Sublette County, WY	2006	NA	5640	5538	102	1.8
CN5603700000000	56	037	Sweetwater County, WY	2006	NA	23299	22719	580	2.5
CN5603900000000	56	039	Teton County, WY	2006	NA	13931	13577	354	2.5
CN5604100000000	56	041	Uinta County, WY	2006	NA	10950	10620	330	3
CN5604300000000	56	043	Washakie County, WY	2006	NA	4156	4005	151	3.6
CN5604500000000	56	045	Weston County, WY	2006	NA	3054	2947	107	3.5
CN7200100000000	72	001	Adjuntas Municipio, PR	2006	NA	5651	4880	771	13.6
CN7200300000000	72	003	Aguada Municipio, PR	2006	NA	16423	14431	1992	12.1
CN7200500000000	72	005	Aguadilla Municipio, PR	2006	NA	22975	20101	2874	12.5
CN7200700000000	72	007	Aguas Buenas Municipio, PR	2006	NA	9925	8787	1138	11.5
CN7200900000000	72	009	Aibonito Municipio, PR	2006	NA	8284	7235	1049	12.7
CN7201100000000	72	011	Anasco Municipio, PR	2006	NA	11280	9885	1395	12.4
CN7201300000000	72	013	Arecibo Municipio, PR	2006	NA	34977	30897	4080	11.7
CN7201500000000	72	015	Arroyo Municipio, PR	2006	NA	5926	4960	966	16.3
CN7201700000000	72	017	Barceloneta Municipio, PR	2006	NA	7691	6588	1103	14.3
CN7201900000000	72	019	Barranquitas Municipio, PR	2006	NA	8077	7116	961	11.9
CN7202100000000	72	021	Bayamon Municipio, PR	2006	NA	86474	79620	6854	7.9
CN7202300000000	72	023	Cabo Rojo Municipio, PR	2006	NA	21550	19530	2020	9.4
CN7202500000000	72	025	Caguas Municipio, PR	2006	NA	56670	50864	5806	10.2
CN7202700000000	72	027	Camuy Municipio, PR	2006	NA	13495	12033	1462	10.8
CN7202900000000	72	029	Canovanas Municipio, PR	2006	NA	15089	13210	1879	12.5
CN7203100000000	72	031	Carolina Municipio, PR	2006	NA	80945	74493	6452	8
CN7203300000000	72	033	Catano Municipio, PR	2006	NA	8379	7496	883	10.5
CN7203500000000	72	035	Cayey Municipio, PR	2006	NA	16545	14514	2031	12.3
CN7203700000000	72	037	Ceiba Municipio, PR	2006	NA	6148	5449	699	11.4
CN7203900000000	72	039	Ciales Municipio, PR	2006	NA	5455	4610	845	15.5
CN7204100000000	72	041	Cidra Municipio, PR	2006	NA	16276	14396	1880	11.6
CN7204300000000	72	043	Coamo Municipio, PR	2006	NA	11694	10018	1676	14.3
CN7204500000000	72	045	Comerio Municipio, PR	2006	NA	5034	4334	700	13.9
CN7204700000000	72	047	Corozal Municipio, PR	2006	NA	10974	9765	1209	11
CN7204900000000	72	049	Culebra Municipio, PR	2006	NA	903	821	82	9.1
CN7205100000000	72	051	Dorado Municipio, PR	2006	NA	13375	12138	1237	9.2
CN7205300000000	72	053	Fajardo Municipio, PR	2006	NA	15741	13723	2018	12.8
CN7205400000000	72	054	Florida Municipio, PR	2006	NA	4457	3783	674	15.1
CN7205500000000	72	055	Guanica Municipio, PR	2006	NA	6625	5646	979	14.8
CN7205700000000	72	057	Guayama Municipio, PR	2006	NA	15250	13056	2194	14.4
CN7205900000000	72	059	Guayanilla Municipio, PR	2006	NA	7142	6031	1111	15.6
CN7206100000000	72	061	Guaynabo Municipio, PR	2006	NA	46508	43811	2697	5.8
CN7206300000000	72	063	Gurabo Municipio, PR	2006	NA	16101	14527	1574	9.8
CN7206500000000	72	065	Hatillo Municipio, PR	2006	NA	13469	11846	1623	12
CN7206700000000	72	067	Hormigueros Municipio, PR	2006	NA	6908	6165	743	10.8
CN7206900000000	72	069	Humacao Municipio, PR	2006	NA	21890	18772	3118	14.2
CN7207100000000	72	071	Isabela Municipio, PR	2006	NA	16721	14402	2319	13.9
CN7207300000000	72	073	Jayuya Municipio, PR	2006	NA	4855	4073	782	16.1
CN7207500000000	72	075	Juana Diaz Municipio, PR	2006	NA	18005	15943	2062	11.5
CN7207700000000	72	077	Juncos Municipio, PR	2006	NA	13569	11974	1595	11.8
CN7207900000000	72	079	Lajas Municipio, PR	2006	NA	9288	8166	1122	12.1
CN7208100000000	72	081	Lares Municipio, PR	2006	NA	12159	10764	1395	11.5
CN7208300000000	72	083	Las Marias Municipio, PR	2006	NA	3761	3289	472	12.5
CN7208500000000	72	085	Las Piedras Municipio, PR	2006	NA	13393	11644	1749	13.1
CN7208700000000	72	087	Loiza Municipio, PR	2006	NA	9177	8002	1175	12.8
CN7208900000000	72	089	Luquillo Municipio, PR	2006	NA	7380	6331	1049	14.2
CN7209100000000	72	091	Manati Municipio, PR	2006	NA	15368	13362	2006	13.1
CN7209300000000	72	093	Maricao Municipio, PR	2006	NA	2026	1780	246	12.1
CN7209500000000	72	095	Maunabo Municipio, PR	2006	NA	3759	3131	628	16.7
CN7209700000000	72	097	Mayaguez Municipio, PR	2006	NA	31545	27669	3876	12.3
CN7209900000000	72	099	Moca Municipio, PR	2006	NA	15795	13874	1921	12.2
CN7210100000000	72	101	Morovis Municipio, PR	2006	NA	9618	8264	1354	14.1
CN7210300000000	72	103	Naguabo Municipio, PR	2006	NA	7802	6683	1119	14.3
CN7210500000000	72	105	Naranjito Municipio, PR	2006	NA	8957	7985	972	10.9
CN7210700000000	72	107	Orocovis Municipio, PR	2006	NA	5719	4839	880	15.4
CN7210900000000	72	109	Patillas Municipio, PR	2006	NA	6228	5253	975	15.7
CN7211100000000	72	111	Penuelas Municipio, PR	2006	NA	9094	7855	1239	13.6
CN7211300000000	72	113	Ponce Municipio, PR	2006	NA	67401	60367	7034	10.4
CN7211500000000	72	115	Quebradillas Municipio, PR	2006	NA	9001	8002	999	11.1
CN7211700000000	72	117	Rincon Municipio, PR	2006	NA	5775	5080	695	12
CN7211900000000	72	119	Rio Grande Municipio, PR	2006	NA	18631	16661	1970	10.6
CN7212100000000	72	121	Sabana Grande Municipio, PR	2006	NA	9831	8606	1225	12.5
CN7212300000000	72	123	Salinas Municipio, PR	2006	NA	9597	8270	1327	13.8
CN7212500000000	72	125	San German Municipio, PR	2006	NA	13628	11963	1665	12.2
CN7212700000000	72	127	San Juan Municipio, PR	2006	NA	178108	165033	13075	7.3
CN7212900000000	72	129	San Lorenzo Municipio, PR	2006	NA	14915	13249	1666	11.2
CN7213100000000	72	131	San Sebastian Municipio, PR	2006	NA	16098	14086	2012	12.5
CN7213300000000	72	133	Santa Isabel Municipio, PR	2006	NA	9197	7984	1213	13.2
CN7213500000000	72	135	Toa Alta Municipio, PR	2006	NA	30279	28062	2217	7.3
CN7213700000000	72	137	Toa Baja Municipio, PR	2006	NA	37089	34154	2935	7.9
CN7213900000000	72	139	Trujillo Alto Municipio, PR	2006	NA	36170	33660	2510	6.9
CN7214100000000	72	141	Utuado Municipio, PR	2006	NA	9741	8329	1412	14.5
CN7214300000000	72	143	Vega Alta Municipio, PR	2006	NA	12952	11594	1358	10.5
CN7214500000000	72	145	Vega Baja Municipio, PR	2006	NA	21654	19071	2583	11.9
CN7214700000000	72	147	Vieques Municipio, PR	2006	NA	3300	2992	308	9.3
CN7214900000000	72	149	Villalba Municipio, PR	2006	NA	9681	8417	1264	13.1
CN7215100000000	72	151	Yabucoa Municipio, PR	2006	NA	11562	9647	1915	16.6
CN7215300000000	72	153	Yauco Municipio, PR	2006	NA	16747	14658	2089	12.5
NA	NA	NA	NA	NA	NA	NA	NA	NA	NA
SOURCE:  BLS, LAUS	NA	NA	NA	NA	NA	NA	NA	NA	NA
March 18, 2016	NA	NA	NA	NA	NA	NA	NA	NA	NA
