LAUS_CODE	STATE_FIPS	COUNTY_FIPS	COUNTY	YEAR	ESTIMATED	LABOR_FORCE	EMPLOYED	UNEMPLOYED_LEVEL	UNEMPLOYED_RATE
CN0100100000000	01	001	Autauga County, AL	2015	NA	25652	24321	1331	5.2
CN0100300000000	01	003	Baldwin County, AL	2015	NA	87872	83010	4862	5.5
CN0100500000000	01	005	Barbour County, AL	2015	NA	8625	7860	765	8.9
CN0100700000000	01	007	Bibb County, AL	2015	NA	8589	8021	568	6.6
CN0100900000000	01	009	Blount County, AL	2015	NA	24521	23198	1323	5.4
CN0101100000000	01	011	Bullock County, AL	2015	NA	4785	4406	379	7.9
CN0101300000000	01	013	Butler County, AL	2015	NA	9151	8457	694	7.6
CN0101500000000	01	015	Calhoun County, AL	2015	NA	45995	42764	3231	7
CN0101700000000	01	017	Chambers County, AL	2015	NA	15002	14097	905	6
CN0101900000000	01	019	Cherokee County, AL	2015	NA	11179	10570	609	5.4
CN0102100000000	01	021	Chilton County, AL	2015	NA	19171	18090	1081	5.6
CN0102300000000	01	023	Choctaw County, AL	2015	NA	4386	3988	398	9.1
CN0102500000000	01	025	Clarke County, AL	2015	NA	8006	7068	938	11.7
CN0102700000000	01	027	Clay County, AL	2015	NA	5559	5219	340	6.1
CN0102900000000	01	029	Cleburne County, AL	2015	NA	5688	5346	342	6
CN0103100000000	01	031	Coffee County, AL	2015	NA	20309	19100	1209	6
CN0103300000000	01	033	Colbert County, AL	2015	NA	23647	21776	1871	7.9
CN0103500000000	01	035	Conecuh County, AL	2015	NA	4690	4258	432	9.2
CN0103700000000	01	037	Coosa County, AL	2015	NA	4434	4138	296	6.7
CN0103900000000	01	039	Covington County, AL	2015	NA	15487	14382	1105	7.1
CN0104100000000	01	041	Crenshaw County, AL	2015	NA	6367	5986	381	6
CN0104300000000	01	043	Cullman County, AL	2015	NA	36456	34541	1915	5.3
CN0104500000000	01	045	Dale County, AL	2015	NA	19875	18612	1263	6.4
CN0104700000000	01	047	Dallas County, AL	2015	NA	15617	14122	1495	9.6
CN0104900000000	01	049	DeKalb County, AL	2015	NA	28822	27076	1746	6.1
CN0105100000000	01	051	Elmore County, AL	2015	NA	36814	34967	1847	5
CN0105300000000	01	053	Escambia County, AL	2015	NA	14624	13598	1026	7
CN0105500000000	01	055	Etowah County, AL	2015	NA	42767	40126	2641	6.2
CN0105700000000	01	057	Fayette County, AL	2015	NA	6434	5983	451	7
CN0105900000000	01	059	Franklin County, AL	2015	NA	13687	12807	880	6.4
CN0106100000000	01	061	Geneva County, AL	2015	NA	10807	10168	639	5.9
CN0106300000000	01	063	Greene County, AL	2015	NA	2883	2564	319	11.1
CN0106500000000	01	065	Hale County, AL	2015	NA	6058	5588	470	7.8
CN0106700000000	01	067	Henry County, AL	2015	NA	6729	6272	457	6.8
CN0106900000000	01	069	Houston County, AL	2015	NA	44627	41850	2777	6.2
CN0107100000000	01	071	Jackson County, AL	2015	NA	23506	21944	1562	6.6
CN0107300000000	01	073	Jefferson County, AL	2015	NA	311481	293544	17937	5.8
CN0107500000000	01	075	Lamar County, AL	2015	NA	5626	5271	355	6.3
CN0107700000000	01	077	Lauderdale County, AL	2015	NA	42725	39766	2959	6.9
CN0107900000000	01	079	Lawrence County, AL	2015	NA	13698	12641	1057	7.7
CN0108100000000	01	081	Lee County, AL	2015	NA	70996	67274	3722	5.2
CN0108300000000	01	083	Limestone County, AL	2015	NA	40022	37833	2189	5.5
CN0108500000000	01	085	Lowndes County, AL	2015	NA	3834	3392	442	11.5
CN0108700000000	01	087	Macon County, AL	2015	NA	7983	7341	642	8
CN0108900000000	01	089	Madison County, AL	2015	NA	171217	161839	9378	5.5
CN0109100000000	01	091	Marengo County, AL	2015	NA	7419	6853	566	7.6
CN0109300000000	01	093	Marion County, AL	2015	NA	12506	11638	868	6.9
CN0109500000000	01	095	Marshall County, AL	2015	NA	40466	38126	2340	5.8
CN0109700000000	01	097	Mobile County, AL	2015	NA	187264	174405	12859	6.9
CN0109900000000	01	099	Monroe County, AL	2015	NA	7353	6614	739	10.1
CN0110100000000	01	101	Montgomery County, AL	2015	NA	105246	98841	6405	6.1
CN0110300000000	01	103	Morgan County, AL	2015	NA	55016	51781	3235	5.9
CN0110500000000	01	105	Perry County, AL	2015	NA	3491	3143	348	10
CN0110700000000	01	107	Pickens County, AL	2015	NA	8022	7480	542	6.8
CN0110900000000	01	109	Pike County, AL	2015	NA	14967	13984	983	6.6
CN0111100000000	01	111	Randolph County, AL	2015	NA	9451	8894	557	5.9
CN0111300000000	01	113	Russell County, AL	2015	NA	24152	22720	1432	5.9
CN0111500000000	01	115	St. Clair County, AL	2015	NA	38638	36625	2013	5.2
CN0111700000000	01	117	Shelby County, AL	2015	NA	108408	103851	4557	4.2
CN0111900000000	01	119	Sumter County, AL	2015	NA	5117	4709	408	8
CN0112100000000	01	121	Talladega County, AL	2015	NA	35198	32890	2308	6.6
CN0112300000000	01	123	Tallapoosa County, AL	2015	NA	18776	17633	1143	6.1
CN0112500000000	01	125	Tuscaloosa County, AL	2015	NA	99051	93669	5382	5.4
CN0112700000000	01	127	Walker County, AL	2015	NA	25610	23762	1848	7.2
CN0112900000000	01	129	Washington County, AL	2015	NA	6711	6114	597	8.9
CN0113100000000	01	131	Wilcox County, AL	2015	NA	2829	2415	414	14.6
CN0113300000000	01	133	Winston County, AL	2015	NA	9393	8686	707	7.5
CN0201300000000	02	013	Aleutians East Borough, AK	2015	NA	2475	2396	79	3.2
CN0201600000000	02	016	Aleutians West Census Area, AK	2015	NA	4065	3908	157	3.9
CN0202000000000	02	020	Anchorage Borough/municipality, AK	2015	NA	156755	148856	7899	5
CN0205000000000	02	050	Bethel Census Area, AK	2015	NA	7363	6304	1059	14.4
CN0206000000000	02	060	Bristol Bay Borough, AK	2015	NA	382	346	36	9.4
CN0206800000000	02	068	Denali Borough, AK	2015	NA	1071	977	94	8.8
CN0207000000000	02	070	Dillingham Census Area, AK	2015	NA	2040	1843	197	9.7
CN0209000000000	02	090	Fairbanks North Star Borough, AK	2015	NA	46396	43863	2533	5.5
CN0210000000000	02	100	Haines Borough, AK	2015	NA	1087	980	107	9.8
CN0210500000000	02	105	Hoonah-Angoon Census Area, AK	2015	NA	1134	962	172	15.2
CN0211000000000	02	110	Juneau Borough/city, AK	2015	NA	17090	16284	806	4.7
CN0212200000000	02	122	Kenai Peninsula Borough, AK	2015	NA	27633	25472	2161	7.8
CN0213000000000	02	130	Ketchikan Gateway Borough, AK	2015	NA	6964	6484	480	6.9
CN0215000000000	02	150	Kodiak Island Borough, AK	2015	NA	6620	6301	319	4.8
CN0215800000000	02	158	Kusilvak Census Area, AK	2015	NA	2809	2160	649	23.1
CN0216400000000	02	164	Lake and Peninsula Borough, AK	2015	NA	646	565	81	12.5
CN0217000000000	02	170	Matanuska-Susitna Borough, AK	2015	NA	46183	42634	3549	7.7
CN0218000000000	02	180	Nome Census Area, AK	2015	NA	4083	3596	487	11.9
CN0218500000000	02	185	North Slope Borough, AK	2015	NA	4305	4059	246	5.7
CN0218800000000	02	188	Northwest Arctic Borough, AK	2015	NA	2910	2444	466	16
CN0219500000000	02	195	Petersburg Borough, AK	2015	NA	1494	1361	133	8.9
CN0219800000000	02	198	Prince of Wales-Hyder Census Area, AK	2015	NA	2763	2415	348	12.6
CN0222000000000	02	220	Sitka Borough/city, AK	2015	NA	4601	4389	212	4.6
CN0223000000000	02	230	Skagway Municipality, AK	2015	NA	812	718	94	11.6
CN0224000000000	02	240	Southeast Fairbanks Census Area, AK	2015	NA	3009	2688	321	10.7
CN0226100000000	02	261	Valdez-Cordova Census Area, AK	2015	NA	4881	4458	423	8.7
CN0227500000000	02	275	Wrangell Borough/city, AK	2015	NA	1031	950	81	7.9
CN0228200000000	02	282	Yakutat Borough/city, AK	2015	NA	259	237	22	8.5
CN0229000000000	02	290	Yukon-Koyukuk Census Area, AK	2015	NA	2411	1968	443	18.4
CN0400100000000	04	001	Apache County, AZ	2015	NA	20589	17854	2735	13.3
CN0400300000000	04	003	Cochise County, AZ	2015	NA	50257	46600	3657	7.3
CN0400500000000	04	005	Coconino County, AZ	2015	NA	73189	68434	4755	6.5
CN0400700000000	04	007	Gila County, AZ	2015	NA	21181	19512	1669	7.9
CN0400900000000	04	009	Graham County, AZ	2015	NA	14496	13432	1064	7.3
CN0401100000000	04	011	Greenlee County, AZ	2015	NA	4042	3722	320	7.9
CN0401200000000	04	012	La Paz County, AZ	2015	NA	8163	7555	608	7.4
CN0401300000000	04	013	Maricopa County, AZ	2015	NA	2020413	1916900	103513	5.1
CN0401500000000	04	015	Mohave County, AZ	2015	NA	79480	73176	6304	7.9
CN0401700000000	04	017	Navajo County, AZ	2015	NA	40659	36734	3925	9.7
CN0401900000000	04	019	Pima County, AZ	2015	NA	464811	439360	25451	5.5
CN0402100000000	04	021	Pinal County, AZ	2015	NA	157022	147161	9861	6.3
CN0402300000000	04	023	Santa Cruz County, AZ	2015	NA	19852	17578	2274	11.5
CN0402500000000	04	025	Yavapai County, AZ	2015	NA	96111	90721	5390	5.6
CN0402700000000	04	027	Yuma County, AZ	2015	NA	93568	73279	20289	21.7
CN0500100000000	05	001	Arkansas County, AR	2015	NA	9477	9082	395	4.2
CN0500300000000	05	003	Ashley County, AR	2015	NA	8350	7720	630	7.5
CN0500500000000	05	005	Baxter County, AR	2015	NA	16192	15306	886	5.5
CN0500700000000	05	007	Benton County, AR	2015	NA	121607	117035	4572	3.8
CN0500900000000	05	009	Boone County, AR	2015	NA	15814	15046	768	4.9
CN0501100000000	05	011	Bradley County, AR	2015	NA	4551	4286	265	5.8
CN0501300000000	05	013	Calhoun County, AR	2015	NA	2415	2285	130	5.4
CN0501500000000	05	015	Carroll County, AR	2015	NA	12635	12059	576	4.6
CN0501700000000	05	017	Chicot County, AR	2015	NA	3722	3385	337	9.1
CN0501900000000	05	019	Clark County, AR	2015	NA	9606	9084	522	5.4
CN0502100000000	05	021	Clay County, AR	2015	NA	6286	5872	414	6.6
CN0502300000000	05	023	Cleburne County, AR	2015	NA	9601	8937	664	6.9
CN0502500000000	05	025	Cleveland County, AR	2015	NA	3352	3163	189	5.6
CN0502700000000	05	027	Columbia County, AR	2015	NA	9543	8922	621	6.5
CN0502900000000	05	029	Conway County, AR	2015	NA	8631	8107	524	6.1
CN0503100000000	05	031	Craighead County, AR	2015	NA	50907	48657	2250	4.4
CN0503300000000	05	033	Crawford County, AR	2015	NA	26802	25414	1388	5.2
CN0503500000000	05	035	Crittenden County, AR	2015	NA	21379	20066	1313	6.1
CN0503700000000	05	037	Cross County, AR	2015	NA	8088	7651	437	5.4
CN0503900000000	05	039	Dallas County, AR	2015	NA	2969	2763	206	6.9
CN0504100000000	05	041	Desha County, AR	2015	NA	5547	5144	403	7.3
CN0504300000000	05	043	Drew County, AR	2015	NA	8069	7518	551	6.8
CN0504500000000	05	045	Faulkner County, AR	2015	NA	59799	57020	2779	4.6
CN0504700000000	05	047	Franklin County, AR	2015	NA	7399	7034	365	4.9
CN0504900000000	05	049	Fulton County, AR	2015	NA	4751	4504	247	5.2
CN0505100000000	05	051	Garland County, AR	2015	NA	39876	37701	2175	5.5
CN0505300000000	05	053	Grant County, AR	2015	NA	8243	7869	374	4.5
CN0505500000000	05	055	Greene County, AR	2015	NA	19917	18887	1030	5.2
CN0505700000000	05	057	Hempstead County, AR	2015	NA	9907	9421	486	4.9
CN0505900000000	05	059	Hot Spring County, AR	2015	NA	14175	13463	712	5
CN0506100000000	05	061	Howard County, AR	2015	NA	6072	5817	255	4.2
CN0506300000000	05	063	Independence County, AR	2015	NA	15644	14635	1009	6.4
CN0506500000000	05	065	Izard County, AR	2015	NA	4971	4643	328	6.6
CN0506700000000	05	067	Jackson County, AR	2015	NA	6177	5713	464	7.5
CN0506900000000	05	069	Jefferson County, AR	2015	NA	28718	26696	2022	7
CN0507100000000	05	071	Johnson County, AR	2015	NA	10385	9790	595	5.7
CN0507300000000	05	073	Lafayette County, AR	2015	NA	2644	2445	199	7.5
CN0507500000000	05	075	Lawrence County, AR	2015	NA	7034	6612	422	6
CN0507700000000	05	077	Lee County, AR	2015	NA	3175	2964	211	6.6
CN0507900000000	05	079	Lincoln County, AR	2015	NA	4119	3866	253	6.1
CN0508100000000	05	081	Little River County, AR	2015	NA	5584	5280	304	5.4
CN0508300000000	05	083	Logan County, AR	2015	NA	9150	8625	525	5.7
CN0508500000000	05	085	Lonoke County, AR	2015	NA	32939	31561	1378	4.2
CN0508700000000	05	087	Madison County, AR	2015	NA	7070	6798	272	3.8
CN0508900000000	05	089	Marion County, AR	2015	NA	6513	6176	337	5.2
CN0509100000000	05	091	Miller County, AR	2015	NA	19874	18882	992	5
CN0509300000000	05	093	Mississippi County, AR	2015	NA	18310	16663	1647	9
CN0509500000000	05	095	Monroe County, AR	2015	NA	2969	2790	179	6
CN0509700000000	05	097	Montgomery County, AR	2015	NA	3253	3034	219	6.7
CN0509900000000	05	099	Nevada County, AR	2015	NA	3653	3472	181	5
CN0510100000000	05	101	Newton County, AR	2015	NA	3388	3224	164	4.8
CN0510300000000	05	103	Ouachita County, AR	2015	NA	9921	9296	625	6.3
CN0510500000000	05	105	Perry County, AR	2015	NA	4194	3937	257	6.1
CN0510700000000	05	107	Phillips County, AR	2015	NA	6983	6455	528	7.6
CN0510900000000	05	109	Pike County, AR	2015	NA	4207	3961	246	5.8
CN0511100000000	05	111	Poinsett County, AR	2015	NA	10046	9485	561	5.6
CN0511300000000	05	113	Polk County, AR	2015	NA	8313	7834	479	5.8
CN0511500000000	05	115	Pope County, AR	2015	NA	29710	28147	1563	5.3
CN0511700000000	05	117	Prairie County, AR	2015	NA	3722	3548	174	4.7
CN0511900000000	05	119	Pulaski County, AR	2015	NA	185721	177247	8474	4.6
CN0512100000000	05	121	Randolph County, AR	2015	NA	6175	5734	441	7.1
CN0512300000000	05	123	St. Francis County, AR	2015	NA	8940	8296	644	7.2
CN0512500000000	05	125	Saline County, AR	2015	NA	55892	53618	2274	4.1
CN0512700000000	05	127	Scott County, AR	2015	NA	4519	4304	215	4.8
CN0512900000000	05	129	Searcy County, AR	2015	NA	3021	2851	170	5.6
CN0513100000000	05	131	Sebastian County, AR	2015	NA	57625	54862	2763	4.8
CN0513300000000	05	133	Sevier County, AR	2015	NA	5655	5313	342	6
CN0513500000000	05	135	Sharp County, AR	2015	NA	5994	5581	413	6.9
CN0513700000000	05	137	Stone County, AR	2015	NA	4696	4403	293	6.2
CN0513900000000	05	139	Union County, AR	2015	NA	16901	15869	1032	6.1
CN0514100000000	05	141	Van Buren County, AR	2015	NA	6416	5986	430	6.7
CN0514300000000	05	143	Washington County, AR	2015	NA	115028	110974	4054	3.5
CN0514500000000	05	145	White County, AR	2015	NA	34483	32344	2139	6.2
CN0514700000000	05	147	Woodruff County, AR	2015	NA	3025	2832	193	6.4
CN0514900000000	05	149	Yell County, AR	2015	NA	8948	8495	453	5.1
CN0600100000000	06	001	Alameda County, CA	2015	NA	818947	780110	38837	4.7
CN0600300000000	06	003	Alpine County, CA	2015	NA	548	508	40	7.3
CN0600500000000	06	005	Amador County, CA	2015	NA	14315	13370	945	6.6
CN0600700000000	06	007	Butte County, CA	2015	NA	101046	93792	7254	7.2
CN0600900000000	06	009	Calaveras County, CA	2015	NA	20546	19236	1310	6.4
CN0601100000000	06	011	Colusa County, CA	2015	NA	11042	9344	1698	15.4
CN0601300000000	06	013	Contra Costa County, CA	2015	NA	544572	517190	27382	5
CN0601500000000	06	015	Del Norte County, CA	2015	NA	9852	9011	841	8.5
CN0601700000000	06	017	El Dorado County, CA	2015	NA	87880	82863	5017	5.7
CN0601900000000	06	019	Fresno County, CA	2015	NA	440126	395282	44844	10.2
CN0602100000000	06	021	Glenn County, CA	2015	NA	12959	11830	1129	8.7
CN0602300000000	06	023	Humboldt County, CA	2015	NA	62280	58798	3482	5.6
CN0602500000000	06	025	Imperial County, CA	2015	NA	76651	57880	18771	24.5
CN0602700000000	06	027	Inyo County, CA	2015	NA	9080	8554	526	5.8
CN0602900000000	06	029	Kern County, CA	2015	NA	389978	350147	39831	10.2
CN0603100000000	06	031	Kings County, CA	2015	NA	57703	51642	6061	10.5
CN0603300000000	06	033	Lake County, CA	2015	NA	29000	26798	2202	7.6
CN0603500000000	06	035	Lassen County, CA	2015	NA	10758	9981	777	7.2
CN0603700000000	06	037	Los Angeles County, CA	2015	NA	4980324	4650739	329585	6.6
CN0603900000000	06	039	Madera County, CA	2015	NA	59781	53495	6286	10.5
CN0604100000000	06	041	Marin County, CA	2015	NA	138683	133755	4928	3.6
CN0604300000000	06	043	Mariposa County, CA	2015	NA	8009	7438	571	7.1
CN0604500000000	06	045	Mendocino County, CA	2015	NA	39826	37510	2316	5.8
CN0604700000000	06	047	Merced County, CA	2015	NA	114003	101058	12945	11.4
CN0604900000000	06	049	Modoc County, CA	2015	NA	3302	3020	282	8.5
CN0605100000000	06	051	Mono County, CA	2015	NA	8238	7734	504	6.1
CN0605300000000	06	053	Monterey County, CA	2015	NA	218201	200504	17697	8.1
CN0605500000000	06	055	Napa County, CA	2015	NA	73715	70309	3406	4.6
CN0605700000000	06	057	Nevada County, CA	2015	NA	48002	45400	2602	5.4
CN0605900000000	06	059	Orange County, CA	2015	NA	1584258	1513475	70783	4.5
CN0606100000000	06	061	Placer County, CA	2015	NA	176321	167413	8908	5.1
CN0606300000000	06	063	Plumas County, CA	2015	NA	7888	7078	810	10.3
CN0606500000000	06	065	Riverside County, CA	2015	NA	1033286	964088	69198	6.7
CN0606700000000	06	067	Sacramento County, CA	2015	NA	684493	643471	41022	6
CN0606900000000	06	069	San Benito County, CA	2015	NA	29752	27503	2249	7.6
CN0607100000000	06	071	San Bernardino County, CA	2015	NA	919166	859967	59199	6.4
CN0607300000000	06	073	San Diego County, CA	2015	NA	1548611	1468089	80522	5.2
CN0607500000000	06	075	San Francisco County/city, CA	2015	NA	541430	521710	19720	3.6
CN0607700000000	06	077	San Joaquin County, CA	2015	NA	314300	286358	27942	8.9
CN0607900000000	06	079	San Luis Obispo County, CA	2015	NA	138909	132340	6569	4.7
CN0608100000000	06	081	San Mateo County, CA	2015	NA	434254	419424	14830	3.4
CN0608300000000	06	083	Santa Barbara County, CA	2015	NA	217139	205647	11492	5.3
CN0608500000000	06	085	Santa Clara County, CA	2015	NA	1012212	970215	41997	4.1
CN0608700000000	06	087	Santa Cruz County, CA	2015	NA	143192	132470	10722	7.5
CN0608900000000	06	089	Shasta County, CA	2015	NA	74104	68344	5760	7.8
CN0609100000000	06	091	Sierra County, CA	2015	NA	1361	1242	119	8.7
CN0609300000000	06	093	Siskiyou County, CA	2015	NA	17877	16203	1674	9.4
CN0609500000000	06	095	Solano County, CA	2015	NA	204832	192289	12543	6.1
CN0609700000000	06	097	Sonoma County, CA	2015	NA	257647	246095	11552	4.5
CN0609900000000	06	099	Stanislaus County, CA	2015	NA	240897	218031	22866	9.5
CN0610100000000	06	101	Sutter County, CA	2015	NA	44714	39936	4778	10.7
CN0610300000000	06	103	Tehama County, CA	2015	NA	25014	23036	1978	7.9
CN0610500000000	06	105	Trinity County, CA	2015	NA	5139	4740	399	7.8
CN0610700000000	06	107	Tulare County, CA	2015	NA	202026	178541	23485	11.6
CN0610900000000	06	109	Tuolumne County, CA	2015	NA	21528	20011	1517	7
CN0611100000000	06	111	Ventura County, CA	2015	NA	427196	403089	24107	5.6
CN0611300000000	06	113	Yolo County, CA	2015	NA	104138	97411	6727	6.5
CN0611500000000	06	115	Yuba County, CA	2015	NA	27716	25142	2574	9.3
CN0800100000000	08	001	Adams County, CO	2015	NA	247734	236920	10814	4.4
CN0800300000000	08	003	Alamosa County, CO	2015	NA	7651	7254	397	5.2
CN0800500000000	08	005	Arapahoe County, CO	2015	NA	334282	321765	12517	3.7
CN0800700000000	08	007	Archuleta County, CO	2015	NA	6010	5766	244	4.1
CN0800900000000	08	009	Baca County, CO	2015	NA	1969	1929	40	2
CN0801100000000	08	011	Bent County, CO	2015	NA	1732	1663	69	4
CN0801300000000	08	013	Boulder County, CO	2015	NA	176721	171087	5634	3.2
CN0801400000000	08	014	Broomfield County/city, CO	2015	NA	35530	34350	1180	3.3
CN0801500000000	08	015	Chaffee County, CO	2015	NA	8491	8200	291	3.4
CN0801700000000	08	017	Cheyenne County, CO	2015	NA	1010	983	27	2.7
CN0801900000000	08	019	Clear Creek County, CO	2015	NA	5543	5339	204	3.7
CN0802100000000	08	021	Conejos County, CO	2015	NA	3598	3392	206	5.7
CN0802300000000	08	023	Costilla County, CO	2015	NA	1622	1518	104	6.4
CN0802500000000	08	025	Crowley County, CO	2015	NA	1352	1292	60	4.4
CN0802700000000	08	027	Custer County, CO	2015	NA	1987	1917	70	3.5
CN0802900000000	08	029	Delta County, CO	2015	NA	13441	12669	772	5.7
CN0803100000000	08	031	Denver County/city, CO	2015	NA	375501	361560	13941	3.7
CN0803300000000	08	033	Dolores County, CO	2015	NA	1323	1281	42	3.2
CN0803500000000	08	035	Douglas County, CO	2015	NA	172105	166747	5358	3.1
CN0803700000000	08	037	Eagle County, CO	2015	NA	32737	31705	1032	3.2
CN0803900000000	08	039	Elbert County, CO	2015	NA	13257	12838	419	3.2
CN0804100000000	08	041	El Paso County, CO	2015	NA	307619	293427	14192	4.6
CN0804300000000	08	043	Fremont County, CO	2015	NA	14500	13601	899	6.2
CN0804500000000	08	045	Garfield County, CO	2015	NA	30462	29192	1270	4.2
CN0804700000000	08	047	Gilpin County, CO	2015	NA	3397	3291	106	3.1
CN0804900000000	08	049	Grand County, CO	2015	NA	9052	8759	293	3.2
CN0805100000000	08	051	Gunnison County, CO	2015	NA	9788	9498	290	3
CN0805300000000	08	053	Hinsdale County, CO	2015	NA	440	426	14	3.2
CN0805500000000	08	055	Huerfano County, CO	2015	NA	2370	2186	184	7.8
CN0805700000000	08	057	Jackson County, CO	2015	NA	834	803	31	3.7
CN0805900000000	08	059	Jefferson County, CO	2015	NA	308779	297832	10947	3.5
CN0806100000000	08	061	Kiowa County, CO	2015	NA	790	769	21	2.7
CN0806300000000	08	063	Kit Carson County, CO	2015	NA	4318	4214	104	2.4
CN0806500000000	08	065	Lake County, CO	2015	NA	4567	4389	178	3.9
CN0806700000000	08	067	La Plata County, CO	2015	NA	29850	28816	1034	3.5
CN0806900000000	08	069	Larimer County, CO	2015	NA	180535	174533	6002	3.3
CN0807100000000	08	071	Las Animas County, CO	2015	NA	6127	5782	345	5.6
CN0807300000000	08	073	Lincoln County, CO	2015	NA	2168	2094	74	3.4
CN0807500000000	08	075	Logan County, CO	2015	NA	10929	10594	335	3.1
CN0807700000000	08	077	Mesa County, CO	2015	NA	71795	67800	3995	5.6
CN0807900000000	08	079	Mineral County, CO	2015	NA	445	429	16	3.6
CN0808100000000	08	081	Moffat County, CO	2015	NA	7104	6780	324	4.6
CN0808300000000	08	083	Montezuma County, CO	2015	NA	12337	11633	704	5.7
CN0808500000000	08	085	Montrose County, CO	2015	NA	19324	18344	980	5.1
CN0808700000000	08	087	Morgan County, CO	2015	NA	14665	14105	560	3.8
CN0808900000000	08	089	Otero County, CO	2015	NA	7882	7423	459	5.8
CN0809100000000	08	091	Ouray County, CO	2015	NA	2153	2060	93	4.3
CN0809300000000	08	093	Park County, CO	2015	NA	9366	9042	324	3.5
CN0809500000000	08	095	Phillips County, CO	2015	NA	2356	2300	56	2.4
CN0809700000000	08	097	Pitkin County, CO	2015	NA	10735	10318	417	3.9
CN0809900000000	08	099	Prowers County, CO	2015	NA	5811	5575	236	4.1
CN0810100000000	08	101	Pueblo County, CO	2015	NA	71695	67626	4069	5.7
CN0810300000000	08	103	Rio Blanco County, CO	2015	NA	2807	2658	149	5.3
CN0810500000000	08	105	Rio Grande County, CO	2015	NA	4865	4557	308	6.3
CN0810700000000	08	107	Routt County, CO	2015	NA	14275	13809	466	3.3
CN0810900000000	08	109	Saguache County, CO	2015	NA	3078	2888	190	6.2
CN0811100000000	08	111	San Juan County, CO	2015	NA	470	450	20	4.3
CN0811300000000	08	113	San Miguel County, CO	2015	NA	5072	4879	193	3.8
CN0811500000000	08	115	Sedgwick County, CO	2015	NA	1146	1107	39	3.4
CN0811700000000	08	117	Summit County, CO	2015	NA	20554	20032	522	2.5
CN0811900000000	08	119	Teller County, CO	2015	NA	11402	10891	511	4.5
CN0812100000000	08	121	Washington County, CO	2015	NA	2784	2712	72	2.6
CN0812300000000	08	123	Weld County, CO	2015	NA	147740	142027	5713	3.9
CN0812500000000	08	125	Yuma County, CO	2015	NA	5130	4995	135	2.6
CN0900100000000	09	001	Fairfield County, CT	2015	NA	478829	453172	25657	5.4
CN0900300000000	09	003	Hartford County, CT	2015	NA	474171	446356	27815	5.9
CN0900500000000	09	005	Litchfield County, CT	2015	NA	105193	99752	5441	5.2
CN0900700000000	09	007	Middlesex County, CT	2015	NA	92122	87571	4551	4.9
CN0900900000000	09	009	New Haven County, CT	2015	NA	454890	426557	28333	6.2
CN0901100000000	09	011	New London County, CT	2015	NA	136120	128030	8090	5.9
CN0901300000000	09	013	Tolland County, CT	2015	NA	85088	80865	4223	5
CN0901500000000	09	015	Windham County, CT	2015	NA	62583	58612	3971	6.3
CN1000100000000	10	001	Kent County, DE	2015	NA	76253	72145	4108	5.4
CN1000300000000	10	003	New Castle County, DE	2015	NA	291188	277487	13701	4.7
CN1000500000000	10	005	Sussex County, DE	2015	NA	98047	93224	4823	4.9
CN1100100000000	11	001	District of Columbia	2015	NA	389101	362304	26797	6.9
CN1200100000000	12	001	Alachua County, FL	2015	NA	129266	123302	5964	4.6
CN1200300000000	12	003	Baker County, FL	2015	NA	11152	10530	622	5.6
CN1200500000000	12	005	Bay County, FL	2015	NA	87379	82599	4780	5.5
CN1200700000000	12	007	Bradford County, FL	2015	NA	10725	10207	518	4.8
CN1200900000000	12	009	Brevard County, FL	2015	NA	255977	240638	15339	6
CN1201100000000	12	011	Broward County, FL	2015	NA	986384	935820	50564	5.1
CN1201300000000	12	013	Calhoun County, FL	2015	NA	4932	4630	302	6.1
CN1201500000000	12	015	Charlotte County, FL	2015	NA	67537	63481	4056	6
CN1201700000000	12	017	Citrus County, FL	2015	NA	47723	44135	3588	7.5
CN1201900000000	12	019	Clay County, FL	2015	NA	98277	93321	4956	5
CN1202100000000	12	021	Collier County, FL	2015	NA	163394	154808	8586	5.3
CN1202300000000	12	023	Columbia County, FL	2015	NA	28924	27332	1592	5.5
CN1202700000000	12	027	DeSoto County, FL	2015	NA	13354	12578	776	5.8
CN1202900000000	12	029	Dixie County, FL	2015	NA	5576	5229	347	6.2
CN1203100000000	12	031	Duval County, FL	2015	NA	459730	433044	26686	5.8
CN1203300000000	12	033	Escambia County, FL	2015	NA	137865	130169	7696	5.6
CN1203500000000	12	035	Flagler County, FL	2015	NA	43593	40852	2741	6.3
CN1203700000000	12	037	Franklin County, FL	2015	NA	4764	4540	224	4.7
CN1203900000000	12	039	Gadsden County, FL	2015	NA	18178	16870	1308	7.2
CN1204100000000	12	041	Gilchrist County, FL	2015	NA	6487	6119	368	5.7
CN1204300000000	12	043	Glades County, FL	2015	NA	4702	4366	336	7.1
CN1204500000000	12	045	Gulf County, FL	2015	NA	5984	5669	315	5.3
CN1204700000000	12	047	Hamilton County, FL	2015	NA	4514	4221	293	6.5
CN1204900000000	12	049	Hardee County, FL	2015	NA	10072	9368	704	7
CN1205100000000	12	051	Hendry County, FL	2015	NA	15069	13466	1603	10.6
CN1205300000000	12	053	Hernando County, FL	2015	NA	65979	61388	4591	7
CN1205500000000	12	055	Highlands County, FL	2015	NA	35276	32631	2645	7.5
CN1205700000000	12	057	Hillsborough County, FL	2015	NA	688082	653305	34777	5.1
CN1205900000000	12	059	Holmes County, FL	2015	NA	6680	6269	411	6.2
CN1206100000000	12	061	Indian River County, FL	2015	NA	61105	56918	4187	6.9
CN1206300000000	12	063	Jackson County, FL	2015	NA	17280	16261	1019	5.9
CN1206500000000	12	065	Jefferson County, FL	2015	NA	5365	5045	320	6
CN1206700000000	12	067	Lafayette County, FL	2015	NA	3199	3052	147	4.6
CN1206900000000	12	069	Lake County, FL	2015	NA	140535	132786	7749	5.5
CN1207100000000	12	071	Lee County, FL	2015	NA	318777	302326	16451	5.2
CN1207300000000	12	073	Leon County, FL	2015	NA	147291	139884	7407	5
CN1207500000000	12	075	Levy County, FL	2015	NA	16416	15467	949	5.8
CN1207700000000	12	077	Liberty County, FL	2015	NA	2634	2479	155	5.9
CN1207900000000	12	079	Madison County, FL	2015	NA	7461	7003	458	6.1
CN1208100000000	12	081	Manatee County, FL	2015	NA	164586	156243	8343	5.1
CN1208300000000	12	083	Marion County, FL	2015	NA	129944	121503	8441	6.5
CN1208500000000	12	085	Martin County, FL	2015	NA	69371	65647	3724	5.4
CN1208600000000	12	086	Miami-Dade County, FL	2015	NA	1297545	1220715	76830	5.9
CN1208700000000	12	087	Monroe County, FL	2015	NA	45697	44105	1592	3.5
CN1208900000000	12	089	Nassau County, FL	2015	NA	36493	34618	1875	5.1
CN1209100000000	12	091	Okaloosa County, FL	2015	NA	91566	87418	4148	4.5
CN1209300000000	12	093	Okeechobee County, FL	2015	NA	17217	16132	1085	6.3
CN1209500000000	12	095	Orange County, FL	2015	NA	684810	650412	34398	5
CN1209700000000	12	097	Osceola County, FL	2015	NA	156990	147922	9068	5.8
CN1209900000000	12	099	Palm Beach County, FL	2015	NA	689637	654384	35253	5.1
CN1210100000000	12	101	Pasco County, FL	2015	NA	214981	202354	12627	5.9
CN1210300000000	12	103	Pinellas County, FL	2015	NA	469790	446528	23262	5
CN1210500000000	12	105	Polk County, FL	2015	NA	279437	261765	17672	6.3
CN1210700000000	12	107	Putnam County, FL	2015	NA	27214	25136	2078	7.6
CN1210900000000	12	109	St. Johns County, FL	2015	NA	113170	108708	4462	3.9
CN1211100000000	12	111	St. Lucie County, FL	2015	NA	131063	122711	8352	6.4
CN1211300000000	12	113	Santa Rosa County, FL	2015	NA	73829	70258	3571	4.8
CN1211500000000	12	115	Sarasota County, FL	2015	NA	177492	168491	9001	5.1
CN1211700000000	12	117	Seminole County, FL	2015	NA	236207	224575	11632	4.9
CN1211900000000	12	119	Sumter County, FL	2015	NA	28580	26381	2199	7.7
CN1212100000000	12	121	Suwannee County, FL	2015	NA	17903	16926	977	5.5
CN1212300000000	12	123	Taylor County, FL	2015	NA	8963	8361	602	6.7
CN1212500000000	12	125	Union County, FL	2015	NA	4727	4497	230	4.9
CN1212700000000	12	127	Volusia County, FL	2015	NA	238220	224287	13933	5.8
CN1212900000000	12	129	Wakulla County, FL	2015	NA	13934	13284	650	4.7
CN1213100000000	12	131	Walton County, FL	2015	NA	27791	26485	1306	4.7
CN1213300000000	12	133	Washington County, FL	2015	NA	9592	9021	571	6
CN1300100000000	13	001	Appling County, GA	2015	NA	8638	8004	634	7.3
CN1300300000000	13	003	Atkinson County, GA	2015	NA	3849	3627	222	5.8
CN1300500000000	13	005	Bacon County, GA	2015	NA	4875	4594	281	5.8
CN1300700000000	13	007	Baker County, GA	2015	NA	1120	1038	82	7.3
CN1300900000000	13	009	Baldwin County, GA	2015	NA	17678	16318	1360	7.7
CN1301100000000	13	011	Banks County, GA	2015	NA	8187	7729	458	5.6
CN1301300000000	13	013	Barrow County, GA	2015	NA	35970	34070	1900	5.3
CN1301500000000	13	015	Bartow County, GA	2015	NA	46662	43905	2757	5.9
CN1301700000000	13	017	Ben Hill County, GA	2015	NA	5456	4962	494	9.1
CN1301900000000	13	019	Berrien County, GA	2015	NA	7018	6511	507	7.2
CN1302100000000	13	021	Bibb County, GA	2015	NA	67649	63128	4521	6.7
CN1302300000000	13	023	Bleckley County, GA	2015	NA	4354	3981	373	8.6
CN1302500000000	13	025	Brantley County, GA	2015	NA	6877	6362	515	7.5
CN1302700000000	13	027	Brooks County, GA	2015	NA	6857	6438	419	6.1
CN1302900000000	13	029	Bryan County, GA	2015	NA	16080	15232	848	5.3
CN1303100000000	13	031	Bulloch County, GA	2015	NA	34596	32490	2106	6.1
CN1303300000000	13	033	Burke County, GA	2015	NA	9095	8353	742	8.2
CN1303500000000	13	035	Butts County, GA	2015	NA	10084	9411	673	6.7
CN1303700000000	13	037	Calhoun County, GA	2015	NA	2120	1988	132	6.2
CN1303900000000	13	039	Camden County, GA	2015	NA	22210	20973	1237	5.6
CN1304300000000	13	043	Candler County, GA	2015	NA	4946	4664	282	5.7
CN1304500000000	13	045	Carroll County, GA	2015	NA	51578	48097	3481	6.7
CN1304700000000	13	047	Catoosa County, GA	2015	NA	31243	29604	1639	5.2
CN1304900000000	13	049	Charlton County, GA	2015	NA	4748	4443	305	6.4
CN1305100000000	13	051	Chatham County, GA	2015	NA	132710	124919	7791	5.9
CN1305300000000	13	053	Chattahoochee County, GA	2015	NA	2101	1916	185	8.8
CN1305500000000	13	055	Chattooga County, GA	2015	NA	10508	9857	651	6.2
CN1305700000000	13	057	Cherokee County, GA	2015	NA	119849	114221	5628	4.7
CN1305900000000	13	059	Clarke County, GA	2015	NA	56900	53422	3478	6.1
CN1306100000000	13	061	Clay County, GA	2015	NA	856	755	101	11.8
CN1306300000000	13	063	Clayton County, GA	2015	NA	125877	116241	9636	7.7
CN1306500000000	13	065	Clinch County, GA	2015	NA	2762	2567	195	7.1
CN1306700000000	13	067	Cobb County, GA	2015	NA	396618	376441	20177	5.1
CN1306900000000	13	069	Coffee County, GA	2015	NA	17220	16057	1163	6.8
CN1307100000000	13	071	Colquitt County, GA	2015	NA	19969	18688	1281	6.4
CN1307300000000	13	073	Columbia County, GA	2015	NA	68356	64916	3440	5
CN1307500000000	13	075	Cook County, GA	2015	NA	7257	6770	487	6.7
CN1307700000000	13	077	Coweta County, GA	2015	NA	67571	63968	3603	5.3
CN1307900000000	13	079	Crawford County, GA	2015	NA	5553	5202	351	6.3
CN1308100000000	13	081	Crisp County, GA	2015	NA	9387	8742	645	6.9
CN1308300000000	13	083	Dade County, GA	2015	NA	7819	7389	430	5.5
CN1308500000000	13	085	Dawson County, GA	2015	NA	10899	10340	559	5.1
CN1308700000000	13	087	Decatur County, GA	2015	NA	11346	10572	774	6.8
CN1308900000000	13	089	DeKalb County, GA	2015	NA	371561	349045	22516	6.1
CN1309100000000	13	091	Dodge County, GA	2015	NA	6929	6346	583	8.4
CN1309300000000	13	093	Dooly County, GA	2015	NA	4739	4380	359	7.6
CN1309500000000	13	095	Dougherty County, GA	2015	NA	37725	34801	2924	7.8
CN1309700000000	13	097	Douglas County, GA	2015	NA	68056	63726	4330	6.4
CN1309900000000	13	099	Early County, GA	2015	NA	4340	4038	302	7
CN1310100000000	13	101	Echols County, GA	2015	NA	1858	1771	87	4.7
CN1310300000000	13	103	Effingham County, GA	2015	NA	27055	25667	1388	5.1
CN1310500000000	13	105	Elbert County, GA	2015	NA	7583	7017	566	7.5
CN1310700000000	13	107	Emanuel County, GA	2015	NA	8284	7556	728	8.8
CN1310900000000	13	109	Evans County, GA	2015	NA	4645	4384	261	5.6
CN1311100000000	13	111	Fannin County, GA	2015	NA	10072	9446	626	6.2
CN1311300000000	13	113	Fayette County, GA	2015	NA	53937	51128	2809	5.2
CN1311500000000	13	115	Floyd County, GA	2015	NA	42805	39935	2870	6.7
CN1311700000000	13	117	Forsyth County, GA	2015	NA	103977	99241	4736	4.6
CN1311900000000	13	119	Franklin County, GA	2015	NA	9248	8665	583	6.3
CN1312100000000	13	121	Fulton County, GA	2015	NA	512558	481798	30760	6
CN1312300000000	13	123	Gilmer County, GA	2015	NA	11674	10966	708	6.1
CN1312500000000	13	125	Glascock County, GA	2015	NA	1228	1146	82	6.7
CN1312700000000	13	127	Glynn County, GA	2015	NA	37537	35248	2289	6.1
CN1312900000000	13	129	Gordon County, GA	2015	NA	26044	24500	1544	5.9
CN1313100000000	13	131	Grady County, GA	2015	NA	10379	9752	627	6
CN1313300000000	13	133	Greene County, GA	2015	NA	6800	6347	453	6.7
CN1313500000000	13	135	Gwinnett County, GA	2015	NA	450568	427100	23468	5.2
CN1313700000000	13	137	Habersham County, GA	2015	NA	18739	17663	1076	5.7
CN1313900000000	13	139	Hall County, GA	2015	NA	92394	87887	4507	4.9
CN1314100000000	13	141	Hancock County, GA	2015	NA	2478	2234	244	9.8
CN1314300000000	13	143	Haralson County, GA	2015	NA	11820	11044	776	6.6
CN1314500000000	13	145	Harris County, GA	2015	NA	15635	14812	823	5.3
CN1314700000000	13	147	Hart County, GA	2015	NA	10359	9714	645	6.2
CN1314900000000	13	149	Heard County, GA	2015	NA	4891	4576	315	6.4
CN1315100000000	13	151	Henry County, GA	2015	NA	104603	98130	6473	6.2
CN1315300000000	13	153	Houston County, GA	2015	NA	65413	61586	3827	5.9
CN1315500000000	13	155	Irwin County, GA	2015	NA	3121	2859	262	8.4
CN1315700000000	13	157	Jackson County, GA	2015	NA	30617	29129	1488	4.9
CN1315900000000	13	159	Jasper County, GA	2015	NA	6414	6059	355	5.5
CN1316100000000	13	161	Jeff Davis County, GA	2015	NA	6318	5895	423	6.7
CN1316300000000	13	163	Jefferson County, GA	2015	NA	6341	5766	575	9.1
CN1316500000000	13	165	Jenkins County, GA	2015	NA	3093	2834	259	8.4
CN1316700000000	13	167	Johnson County, GA	2015	NA	3856	3585	271	7
CN1316900000000	13	169	Jones County, GA	2015	NA	13421	12677	744	5.5
CN1317100000000	13	171	Lamar County, GA	2015	NA	7651	7060	591	7.7
CN1317300000000	13	173	Lanier County, GA	2015	NA	3766	3514	252	6.7
CN1317500000000	13	175	Laurens County, GA	2015	NA	18566	17158	1408	7.6
CN1317700000000	13	177	Lee County, GA	2015	NA	14070	13319	751	5.3
CN1317900000000	13	179	Liberty County, GA	2015	NA	24869	23291	1578	6.3
CN1318100000000	13	181	Lincoln County, GA	2015	NA	3351	3124	227	6.8
CN1318300000000	13	183	Long County, GA	2015	NA	7056	6640	416	5.9
CN1318500000000	13	185	Lowndes County, GA	2015	NA	50156	47179	2977	5.9
CN1318700000000	13	187	Lumpkin County, GA	2015	NA	15257	14429	828	5.4
CN1318900000000	13	189	McDuffie County, GA	2015	NA	8750	8019	731	8.4
CN1319100000000	13	191	McIntosh County, GA	2015	NA	5795	5417	378	6.5
CN1319300000000	13	193	Macon County, GA	2015	NA	4598	4174	424	9.2
CN1319500000000	13	195	Madison County, GA	2015	NA	12574	11873	701	5.6
CN1319700000000	13	197	Marion County, GA	2015	NA	3432	3141	291	8.5
CN1319900000000	13	199	Meriwether County, GA	2015	NA	8636	7941	695	8
CN1320100000000	13	201	Miller County, GA	2015	NA	2660	2515	145	5.5
CN1320500000000	13	205	Mitchell County, GA	2015	NA	8682	8095	587	6.8
CN1320700000000	13	207	Monroe County, GA	2015	NA	12618	11881	737	5.8
CN1320900000000	13	209	Montgomery County, GA	2015	NA	3696	3374	322	8.7
CN1321100000000	13	211	Morgan County, GA	2015	NA	8388	7925	463	5.5
CN1321300000000	13	213	Murray County, GA	2015	NA	16004	14820	1184	7.4
CN1321500000000	13	215	Muscogee County, GA	2015	NA	78576	72687	5889	7.5
CN1321700000000	13	217	Newton County, GA	2015	NA	48236	44962	3274	6.8
CN1321900000000	13	219	Oconee County, GA	2015	NA	17517	16738	779	4.4
CN1322100000000	13	221	Oglethorpe County, GA	2015	NA	6699	6326	373	5.6
CN1322300000000	13	223	Paulding County, GA	2015	NA	76015	72045	3970	5.2
CN1322500000000	13	225	Peach County, GA	2015	NA	11242	10347	895	8
CN1322700000000	13	227	Pickens County, GA	2015	NA	13817	13079	738	5.3
CN1322900000000	13	229	Pierce County, GA	2015	NA	8012	7510	502	6.3
CN1323100000000	13	231	Pike County, GA	2015	NA	8194	7723	471	5.7
CN1323300000000	13	233	Polk County, GA	2015	NA	18074	16872	1202	6.7
CN1323500000000	13	235	Pulaski County, GA	2015	NA	3996	3732	264	6.6
CN1323700000000	13	237	Putnam County, GA	2015	NA	7770	7140	630	8.1
CN1323900000000	13	239	Quitman County, GA	2015	NA	813	757	56	6.9
CN1324100000000	13	241	Rabun County, GA	2015	NA	6476	6040	436	6.7
CN1324300000000	13	243	Randolph County, GA	2015	NA	2416	2195	221	9.1
CN1324500000000	13	245	Richmond County, GA	2015	NA	83946	77701	6245	7.4
CN1324700000000	13	247	Rockdale County, GA	2015	NA	42097	39339	2758	6.6
CN1324900000000	13	249	Schley County, GA	2015	NA	2101	1961	140	6.7
CN1325100000000	13	251	Screven County, GA	2015	NA	5020	4601	419	8.3
CN1325300000000	13	253	Seminole County, GA	2015	NA	3077	2827	250	8.1
CN1325500000000	13	255	Spalding County, GA	2015	NA	27004	24822	2182	8.1
CN1325700000000	13	257	Stephens County, GA	2015	NA	10818	10108	710	6.6
CN1325900000000	13	259	Stewart County, GA	2015	NA	2106	1960	146	6.9
CN1326100000000	13	261	Sumter County, GA	2015	NA	12781	11713	1068	8.4
CN1326300000000	13	263	Talbot County, GA	2015	NA	2685	2477	208	7.7
CN1326500000000	13	265	Taliaferro County, GA	2015	NA	590	544	46	7.8
CN1326700000000	13	267	Tattnall County, GA	2015	NA	9238	8666	572	6.2
CN1326900000000	13	269	Taylor County, GA	2015	NA	2762	2507	255	9.2
CN1327100000000	13	271	Telfair County, GA	2015	NA	4805	4385	420	8.7
CN1327300000000	13	273	Terrell County, GA	2015	NA	3617	3346	271	7.5
CN1327500000000	13	275	Thomas County, GA	2015	NA	16746	15530	1216	7.3
CN1327700000000	13	277	Tift County, GA	2015	NA	18271	17150	1121	6.1
CN1327900000000	13	279	Toombs County, GA	2015	NA	11816	10780	1036	8.8
CN1328100000000	13	281	Towns County, GA	2015	NA	3900	3591	309	7.9
CN1328300000000	13	283	Treutlen County, GA	2015	NA	2689	2460	229	8.5
CN1328500000000	13	285	Troup County, GA	2015	NA	35450	33286	2164	6.1
CN1328700000000	13	287	Turner County, GA	2015	NA	3179	2963	216	6.8
CN1328900000000	13	289	Twiggs County, GA	2015	NA	2953	2683	270	9.1
CN1329100000000	13	291	Union County, GA	2015	NA	9790	9265	525	5.4
CN1329300000000	13	293	Upson County, GA	2015	NA	11085	10278	807	7.3
CN1329500000000	13	295	Walker County, GA	2015	NA	29277	27521	1756	6
CN1329700000000	13	297	Walton County, GA	2015	NA	41501	39247	2254	5.4
CN1329900000000	13	299	Ware County, GA	2015	NA	14428	13485	943	6.5
CN1330100000000	13	301	Warren County, GA	2015	NA	2629	2423	206	7.8
CN1330300000000	13	303	Washington County, GA	2015	NA	7168	6665	503	7
CN1330500000000	13	305	Wayne County, GA	2015	NA	11521	10683	838	7.3
CN1330700000000	13	307	Webster County, GA	2015	NA	965	874	91	9.4
CN1330900000000	13	309	Wheeler County, GA	2015	NA	1687	1503	184	10.9
CN1331100000000	13	311	White County, GA	2015	NA	13726	13012	714	5.2
CN1331300000000	13	313	Whitfield County, GA	2015	NA	45411	42498	2913	6.4
CN1331500000000	13	315	Wilcox County, GA	2015	NA	2732	2517	215	7.9
CN1331700000000	13	317	Wilkes County, GA	2015	NA	3874	3593	281	7.3
CN1331900000000	13	319	Wilkinson County, GA	2015	NA	3589	3325	264	7.4
CN1332100000000	13	321	Worth County, GA	2015	NA	8808	8235	573	6.5
CN1500100000000	15	001	Hawaii County, HI	2015	NA	89882	85982	3900	4.3
CN1500300000000	15	003	Honolulu County/city, HI	2015	NA	462771	447183	15588	3.4
CN1500700000000	15	007	Kauai County, HI	2015	NA	36014	34602	1412	3.9
CN1500900000000	15	009	Maui County, HI	2015	NA	85146	82040	3106	3.6
CN1600100000000	16	001	Ada County, ID	2015	NA	217294	209558	7736	3.6
CN1600300000000	16	003	Adams County, ID	2015	NA	1715	1587	128	7.5
CN1600500000000	16	005	Bannock County, ID	2015	NA	41904	40263	1641	3.9
CN1600700000000	16	007	Bear Lake County, ID	2015	NA	2830	2706	124	4.4
CN1600900000000	16	009	Benewah County, ID	2015	NA	4036	3776	260	6.4
CN1601100000000	16	011	Bingham County, ID	2015	NA	22061	21177	884	4
CN1601300000000	16	013	Blaine County, ID	2015	NA	11830	11418	412	3.5
CN1601500000000	16	015	Boise County, ID	2015	NA	3051	2862	189	6.2
CN1601700000000	16	017	Bonner County, ID	2015	NA	18529	17446	1083	5.8
CN1601900000000	16	019	Bonneville County, ID	2015	NA	51022	49281	1741	3.4
CN1602100000000	16	021	Boundary County, ID	2015	NA	5091	4816	275	5.4
CN1602300000000	16	023	Butte County, ID	2015	NA	1277	1220	57	4.5
CN1602500000000	16	025	Camas County, ID	2015	NA	648	626	22	3.4
CN1602700000000	16	027	Canyon County, ID	2015	NA	90998	86548	4450	4.9
CN1602900000000	16	029	Caribou County, ID	2015	NA	3766	3614	152	4
CN1603100000000	16	031	Cassia County, ID	2015	NA	11466	11090	376	3.3
CN1603300000000	16	033	Clark County, ID	2015	NA	395	381	14	3.5
CN1603500000000	16	035	Clearwater County, ID	2015	NA	3084	2841	243	7.9
CN1603700000000	16	037	Custer County, ID	2015	NA	2130	1991	139	6.5
CN1603900000000	16	039	Elmore County, ID	2015	NA	10742	10246	496	4.6
CN1604100000000	16	041	Franklin County, ID	2015	NA	6456	6258	198	3.1
CN1604300000000	16	043	Fremont County, ID	2015	NA	7180	6924	256	3.6
CN1604500000000	16	045	Gem County, ID	2015	NA	7534	7145	389	5.2
CN1604700000000	16	047	Gooding County, ID	2015	NA	7982	7710	272	3.4
CN1604900000000	16	049	Idaho County, ID	2015	NA	6397	6007	390	6.1
CN1605100000000	16	051	Jefferson County, ID	2015	NA	12474	12056	418	3.4
CN1605300000000	16	053	Jerome County, ID	2015	NA	11336	10969	367	3.2
CN1605500000000	16	055	Kootenai County, ID	2015	NA	71608	68042	3566	5
CN1605700000000	16	057	Latah County, ID	2015	NA	19483	18824	659	3.4
CN1605900000000	16	059	Lemhi County, ID	2015	NA	3377	3145	232	6.9
CN1606100000000	16	061	Lewis County, ID	2015	NA	1592	1502	90	5.7
CN1606300000000	16	063	Lincoln County, ID	2015	NA	2641	2524	117	4.4
CN1606500000000	16	065	Madison County, ID	2015	NA	19783	19263	520	2.6
CN1606700000000	16	067	Minidoka County, ID	2015	NA	10689	10305	384	3.6
CN1606900000000	16	069	Nez Perce County, ID	2015	NA	20628	19878	750	3.6
CN1607100000000	16	071	Oneida County, ID	2015	NA	2127	2053	74	3.5
CN1607300000000	16	073	Owyhee County, ID	2015	NA	5215	4970	245	4.7
CN1607500000000	16	075	Payette County, ID	2015	NA	11101	10561	540	4.9
CN1607700000000	16	077	Power County, ID	2015	NA	3877	3700	177	4.6
CN1607900000000	16	079	Shoshone County, ID	2015	NA	5124	4733	391	7.6
CN1608100000000	16	081	Teton County, ID	2015	NA	5826	5629	197	3.4
CN1608300000000	16	083	Twin Falls County, ID	2015	NA	39033	37618	1415	3.6
CN1608500000000	16	085	Valley County, ID	2015	NA	4792	4502	290	6.1
CN1608700000000	16	087	Washington County, ID	2015	NA	4566	4305	261	5.7
CN1700100000000	17	001	Adams County, IL	2015	NA	32540	30931	1609	4.9
CN1700300000000	17	003	Alexander County, IL	2015	NA	2293	2084	209	9.1
CN1700500000000	17	005	Bond County, IL	2015	NA	7785	7375	410	5.3
CN1700700000000	17	007	Boone County, IL	2015	NA	26308	24600	1708	6.5
CN1700900000000	17	009	Brown County, IL	2015	NA	2779	2681	98	3.5
CN1701100000000	17	011	Bureau County, IL	2015	NA	17118	16024	1094	6.4
CN1701300000000	17	013	Calhoun County, IL	2015	NA	2342	2185	157	6.7
CN1701500000000	17	015	Carroll County, IL	2015	NA	7940	7509	431	5.4
CN1701700000000	17	017	Cass County, IL	2015	NA	6430	6068	362	5.6
CN1701900000000	17	019	Champaign County, IL	2015	NA	107281	101892	5389	5
CN1702100000000	17	021	Christian County, IL	2015	NA	15407	14394	1013	6.6
CN1702300000000	17	023	Clark County, IL	2015	NA	8085	7585	500	6.2
CN1702500000000	17	025	Clay County, IL	2015	NA	6621	6155	466	7
CN1702700000000	17	027	Clinton County, IL	2015	NA	20090	19190	900	4.5
CN1702900000000	17	029	Coles County, IL	2015	NA	24099	22648	1451	6
CN1703100000000	17	031	Cook County, IL	2015	NA	2646181	2481097	165084	6.2
CN1703300000000	17	033	Crawford County, IL	2015	NA	9636	9069	567	5.9
CN1703500000000	17	035	Cumberland County, IL	2015	NA	5910	5600	310	5.2
CN1703700000000	17	037	DeKalb County, IL	2015	NA	54770	51734	3036	5.5
CN1703900000000	17	039	De Witt County, IL	2015	NA	7969	7529	440	5.5
CN1704100000000	17	041	Douglas County, IL	2015	NA	10158	9665	493	4.9
CN1704300000000	17	043	DuPage County, IL	2015	NA	511538	487123	24415	4.8
CN1704500000000	17	045	Edgar County, IL	2015	NA	9435	8849	586	6.2
CN1704700000000	17	047	Edwards County, IL	2015	NA	2946	2771	175	5.9
CN1704900000000	17	049	Effingham County, IL	2015	NA	18425	17547	878	4.8
CN1705100000000	17	051	Fayette County, IL	2015	NA	9704	9071	633	6.5
CN1705300000000	17	053	Ford County, IL	2015	NA	6654	6304	350	5.3
CN1705500000000	17	055	Franklin County, IL	2015	NA	16494	15168	1326	8
CN1705700000000	17	057	Fulton County, IL	2015	NA	15792	14595	1197	7.6
CN1705900000000	17	059	Gallatin County, IL	2015	NA	2467	2303	164	6.6
CN1706100000000	17	061	Greene County, IL	2015	NA	6050	5681	369	6.1
CN1706300000000	17	063	Grundy County, IL	2015	NA	25461	23689	1772	7
CN1706500000000	17	065	Hamilton County, IL	2015	NA	4379	4140	239	5.5
CN1706700000000	17	067	Hancock County, IL	2015	NA	8917	8369	548	6.1
CN1706900000000	17	069	Hardin County, IL	2015	NA	1529	1400	129	8.4
CN1707100000000	17	071	Henderson County, IL	2015	NA	3751	3527	224	6
CN1707300000000	17	073	Henry County, IL	2015	NA	25203	23669	1534	6.1
CN1707500000000	17	075	Iroquois County, IL	2015	NA	14758	13925	833	5.6
CN1707700000000	17	077	Jackson County, IL	2015	NA	28644	27060	1584	5.5
CN1707900000000	17	079	Jasper County, IL	2015	NA	4642	4354	288	6.2
CN1708100000000	17	081	Jefferson County, IL	2015	NA	17180	16027	1153	6.7
CN1708300000000	17	083	Jersey County, IL	2015	NA	11082	10384	698	6.3
CN1708500000000	17	085	Jo Daviess County, IL	2015	NA	11456	10833	623	5.4
CN1708700000000	17	087	Johnson County, IL	2015	NA	4135	3784	351	8.5
CN1708900000000	17	089	Kane County, IL	2015	NA	268299	252962	15337	5.7
CN1709100000000	17	091	Kankakee County, IL	2015	NA	54269	50568	3701	6.8
CN1709300000000	17	093	Kendall County, IL	2015	NA	66208	62761	3447	5.2
CN1709500000000	17	095	Knox County, IL	2015	NA	23216	21810	1406	6.1
CN1709700000000	17	097	Lake County, IL	2015	NA	366809	347139	19670	5.4
CN1709900000000	17	099	LaSalle County, IL	2015	NA	57429	53449	3980	6.9
CN1710100000000	17	101	Lawrence County, IL	2015	NA	6146	5712	434	7.1
CN1710300000000	17	103	Lee County, IL	2015	NA	17855	16907	948	5.3
CN1710500000000	17	105	Livingston County, IL	2015	NA	17266	16342	924	5.4
CN1710700000000	17	107	Logan County, IL	2015	NA	12991	12291	700	5.4
CN1710900000000	17	109	McDonough County, IL	2015	NA	14077	13225	852	6.1
CN1711100000000	17	111	McHenry County, IL	2015	NA	165762	156757	9005	5.4
CN1711300000000	17	113	McLean County, IL	2015	NA	91296	86960	4336	4.7
CN1711500000000	17	115	Macon County, IL	2015	NA	50862	47341	3521	6.9
CN1711700000000	17	117	Macoupin County, IL	2015	NA	23062	21612	1450	6.3
CN1711900000000	17	119	Madison County, IL	2015	NA	133073	125128	7945	6
CN1712100000000	17	121	Marion County, IL	2015	NA	18100	16884	1216	6.7
CN1712300000000	17	123	Marshall County, IL	2015	NA	5708	5332	376	6.6
CN1712500000000	17	125	Mason County, IL	2015	NA	6611	6142	469	7.1
CN1712700000000	17	127	Massac County, IL	2015	NA	6081	5640	441	7.3
CN1712900000000	17	129	Menard County, IL	2015	NA	6616	6301	315	4.8
CN1713100000000	17	131	Mercer County, IL	2015	NA	8233	7722	511	6.2
CN1713300000000	17	133	Monroe County, IL	2015	NA	18106	17318	788	4.4
CN1713500000000	17	135	Montgomery County, IL	2015	NA	12020	11114	906	7.5
CN1713700000000	17	137	Morgan County, IL	2015	NA	16938	16093	845	5
CN1713900000000	17	139	Moultrie County, IL	2015	NA	7377	7058	319	4.3
CN1714100000000	17	141	Ogle County, IL	2015	NA	25913	24325	1588	6.1
CN1714300000000	17	143	Peoria County, IL	2015	NA	89959	83822	6137	6.8
CN1714500000000	17	145	Perry County, IL	2015	NA	8860	8232	628	7.1
CN1714700000000	17	147	Piatt County, IL	2015	NA	8546	8128	418	4.9
CN1714900000000	17	149	Pike County, IL	2015	NA	7618	7226	392	5.1
CN1715100000000	17	151	Pope County, IL	2015	NA	1766	1643	123	7
CN1715300000000	17	153	Pulaski County, IL	2015	NA	2090	1906	184	8.8
CN1715500000000	17	155	Putnam County, IL	2015	NA	3042	2856	186	6.1
CN1715700000000	17	157	Randolph County, IL	2015	NA	14311	13539	772	5.4
CN1715900000000	17	159	Richland County, IL	2015	NA	7467	7032	435	5.8
CN1716100000000	17	161	Rock Island County, IL	2015	NA	72613	68011	4602	6.3
CN1716300000000	17	163	St. Clair County, IL	2015	NA	126230	117968	8262	6.5
CN1716500000000	17	165	Saline County, IL	2015	NA	10352	9555	797	7.7
CN1716700000000	17	167	Sangamon County, IL	2015	NA	103431	97990	5441	5.3
CN1716900000000	17	169	Schuyler County, IL	2015	NA	3483	3281	202	5.8
CN1717100000000	17	171	Scott County, IL	2015	NA	2553	2403	150	5.9
CN1717300000000	17	173	Shelby County, IL	2015	NA	10247	9648	599	5.8
CN1717500000000	17	175	Stark County, IL	2015	NA	2763	2580	183	6.6
CN1717700000000	17	177	Stephenson County, IL	2015	NA	21547	20132	1415	6.6
CN1717900000000	17	179	Tazewell County, IL	2015	NA	66829	62661	4168	6.2
CN1718100000000	17	181	Union County, IL	2015	NA	7357	6795	562	7.6
CN1718300000000	17	183	Vermilion County, IL	2015	NA	35349	32854	2495	7.1
CN1718500000000	17	185	Wabash County, IL	2015	NA	5625	5309	316	5.6
CN1718700000000	17	187	Warren County, IL	2015	NA	8569	8125	444	5.2
CN1718900000000	17	189	Washington County, IL	2015	NA	9360	9008	352	3.8
CN1719100000000	17	191	Wayne County, IL	2015	NA	7504	6990	514	6.8
CN1719300000000	17	193	White County, IL	2015	NA	6932	6537	395	5.7
CN1719500000000	17	195	Whiteside County, IL	2015	NA	28529	26774	1755	6.2
CN1719700000000	17	197	Will County, IL	2015	NA	356715	334626	22089	6.2
CN1719900000000	17	199	Williamson County, IL	2015	NA	31940	29977	1963	6.1
CN1720100000000	17	201	Winnebago County, IL	2015	NA	142004	132098	9906	7
CN1720300000000	17	203	Woodford County, IL	2015	NA	19570	18583	987	5
CN1800100000000	18	001	Adams County, IN	2015	NA	16898	16252	646	3.8
CN1800300000000	18	003	Allen County, IN	2015	NA	178014	169803	8211	4.6
CN1800500000000	18	005	Bartholomew County, IN	2015	NA	43578	41999	1579	3.6
CN1800700000000	18	007	Benton County, IN	2015	NA	4577	4372	205	4.5
CN1800900000000	18	009	Blackford County, IN	2015	NA	5243	4926	317	6
CN1801100000000	18	011	Boone County, IN	2015	NA	33491	32253	1238	3.7
CN1801300000000	18	013	Brown County, IN	2015	NA	7443	7086	357	4.8
CN1801500000000	18	015	Carroll County, IN	2015	NA	10021	9586	435	4.3
CN1801700000000	18	017	Cass County, IN	2015	NA	17759	16941	818	4.6
CN1801900000000	18	019	Clark County, IN	2015	NA	58780	56127	2653	4.5
CN1802100000000	18	021	Clay County, IN	2015	NA	12367	11711	656	5.3
CN1802300000000	18	023	Clinton County, IN	2015	NA	16918	16236	682	4
CN1802500000000	18	025	Crawford County, IN	2015	NA	4915	4617	298	6.1
CN1802700000000	18	027	Daviess County, IN	2015	NA	15694	15099	595	3.8
CN1802900000000	18	029	Dearborn County, IN	2015	NA	25213	23917	1296	5.1
CN1803100000000	18	031	Decatur County, IN	2015	NA	14291	13709	582	4.1
CN1803300000000	18	033	DeKalb County, IN	2015	NA	21782	20884	898	4.1
CN1803500000000	18	035	Delaware County, IN	2015	NA	54440	51332	3108	5.7
CN1803700000000	18	037	Dubois County, IN	2015	NA	22673	21903	770	3.4
CN1803900000000	18	039	Elkhart County, IN	2015	NA	104707	100631	4076	3.9
CN1804100000000	18	041	Fayette County, IN	2015	NA	8989	8398	591	6.6
CN1804300000000	18	043	Floyd County, IN	2015	NA	39858	38143	1715	4.3
CN1804500000000	18	045	Fountain County, IN	2015	NA	8042	7563	479	6
CN1804700000000	18	047	Franklin County, IN	2015	NA	11387	10808	579	5.1
CN1804900000000	18	049	Fulton County, IN	2015	NA	9861	9388	473	4.8
CN1805100000000	18	051	Gibson County, IN	2015	NA	18859	18141	718	3.8
CN1805300000000	18	053	Grant County, IN	2015	NA	32523	30756	1767	5.4
CN1805500000000	18	055	Greene County, IN	2015	NA	13754	12807	947	6.9
CN1805700000000	18	057	Hamilton County, IN	2015	NA	167222	161556	5666	3.4
CN1805900000000	18	059	Hancock County, IN	2015	NA	37368	35787	1581	4.2
CN1806100000000	18	061	Harrison County, IN	2015	NA	19380	18489	891	4.6
CN1806300000000	18	063	Hendricks County, IN	2015	NA	82855	79677	3178	3.8
CN1806500000000	18	065	Henry County, IN	2015	NA	21664	20509	1155	5.3
CN1806700000000	18	067	Howard County, IN	2015	NA	36986	35136	1850	5
CN1806900000000	18	069	Huntington County, IN	2015	NA	18639	17822	817	4.4
CN1807100000000	18	071	Jackson County, IN	2015	NA	21784	20915	869	4
CN1807300000000	18	073	Jasper County, IN	2015	NA	16360	15406	954	5.8
CN1807500000000	18	075	Jay County, IN	2015	NA	9946	9448	498	5
CN1807700000000	18	077	Jefferson County, IN	2015	NA	15325	14581	744	4.9
CN1807900000000	18	079	Jennings County, IN	2015	NA	13167	12490	677	5.1
CN1808100000000	18	081	Johnson County, IN	2015	NA	77582	74412	3170	4.1
CN1808300000000	18	083	Knox County, IN	2015	NA	19026	18152	874	4.6
CN1808500000000	18	085	Kosciusko County, IN	2015	NA	40660	39003	1657	4.1
CN1808700000000	18	087	LaGrange County, IN	2015	NA	18900	18207	693	3.7
CN1808900000000	18	089	Lake County, IN	2015	NA	229721	214026	15695	6.8
CN1809100000000	18	091	LaPorte County, IN	2015	NA	48520	45471	3049	6.3
CN1809300000000	18	093	Lawrence County, IN	2015	NA	20277	18946	1331	6.6
CN1809500000000	18	095	Madison County, IN	2015	NA	58221	54909	3312	5.7
CN1809700000000	18	097	Marion County, IN	2015	NA	472330	448309	24021	5.1
CN1809900000000	18	099	Marshall County, IN	2015	NA	24007	23003	1004	4.2
CN1810100000000	18	101	Martin County, IN	2015	NA	5047	4834	213	4.2
CN1810300000000	18	103	Miami County, IN	2015	NA	15750	14929	821	5.2
CN1810500000000	18	105	Monroe County, IN	2015	NA	67368	64048	3320	4.9
CN1810700000000	18	107	Montgomery County, IN	2015	NA	19265	18494	771	4
CN1810900000000	18	109	Morgan County, IN	2015	NA	35367	33698	1669	4.7
CN1811100000000	18	111	Newton County, IN	2015	NA	6961	6556	405	5.8
CN1811300000000	18	113	Noble County, IN	2015	NA	23650	22639	1011	4.3
CN1811500000000	18	115	Ohio County, IN	2015	NA	3178	3002	176	5.5
CN1811700000000	18	117	Orange County, IN	2015	NA	8726	8204	522	6
CN1811900000000	18	119	Owen County, IN	2015	NA	9285	8699	586	6.3
CN1812100000000	18	121	Parke County, IN	2015	NA	7052	6653	399	5.7
CN1812300000000	18	123	Perry County, IN	2015	NA	9231	8795	436	4.7
CN1812500000000	18	125	Pike County, IN	2015	NA	6188	5918	270	4.4
CN1812700000000	18	127	Porter County, IN	2015	NA	84702	80147	4555	5.4
CN1812900000000	18	129	Posey County, IN	2015	NA	13299	12770	529	4
CN1813100000000	18	131	Pulaski County, IN	2015	NA	6273	5989	284	4.5
CN1813300000000	18	133	Putnam County, IN	2015	NA	16400	15560	840	5.1
CN1813500000000	18	135	Randolph County, IN	2015	NA	12686	12055	631	5
CN1813700000000	18	137	Ripley County, IN	2015	NA	13633	12901	732	5.4
CN1813900000000	18	139	Rush County, IN	2015	NA	8839	8455	384	4.3
CN1814100000000	18	141	St. Joseph County, IN	2015	NA	130398	123826	6572	5
CN1814300000000	18	143	Scott County, IN	2015	NA	10266	9705	561	5.5
CN1814500000000	18	145	Shelby County, IN	2015	NA	22624	21616	1008	4.5
CN1814700000000	18	147	Spencer County, IN	2015	NA	10973	10518	455	4.1
CN1814900000000	18	149	Starke County, IN	2015	NA	10547	9919	628	6
CN1815100000000	18	151	Steuben County, IN	2015	NA	19978	19196	782	3.9
CN1815300000000	18	153	Sullivan County, IN	2015	NA	8658	8117	541	6.2
CN1815500000000	18	155	Switzerland County, IN	2015	NA	4854	4613	241	5
CN1815700000000	18	157	Tippecanoe County, IN	2015	NA	93112	89153	3959	4.3
CN1815900000000	18	159	Tipton County, IN	2015	NA	8381	8045	336	4
CN1816100000000	18	161	Union County, IN	2015	NA	3561	3401	160	4.5
CN1816300000000	18	163	Vanderburgh County, IN	2015	NA	92233	88290	3943	4.3
CN1816500000000	18	165	Vermillion County, IN	2015	NA	7227	6711	516	7.1
CN1816700000000	18	167	Vigo County, IN	2015	NA	48989	45975	3014	6.2
CN1816900000000	18	169	Wabash County, IN	2015	NA	15386	14648	738	4.8
CN1817100000000	18	171	Warren County, IN	2015	NA	4098	3894	204	5
CN1817300000000	18	173	Warrick County, IN	2015	NA	31751	30458	1293	4.1
CN1817500000000	18	175	Washington County, IN	2015	NA	13504	12800	704	5.2
CN1817700000000	18	177	Wayne County, IN	2015	NA	30644	29012	1632	5.3
CN1817900000000	18	179	Wells County, IN	2015	NA	14037	13485	552	3.9
CN1818100000000	18	181	White County, IN	2015	NA	13609	13055	554	4.1
CN1818300000000	18	183	Whitley County, IN	2015	NA	17017	16316	701	4.1
CN1900100000000	19	001	Adair County, IA	2015	NA	4218	4081	137	3.2
CN1900300000000	19	003	Adams County, IA	2015	NA	2286	2222	64	2.8
CN1900500000000	19	005	Allamakee County, IA	2015	NA	7686	7310	376	4.9
CN1900700000000	19	007	Appanoose County, IA	2015	NA	6213	5908	305	4.9
CN1900900000000	19	009	Audubon County, IA	2015	NA	3232	3104	128	4
CN1901100000000	19	011	Benton County, IA	2015	NA	13750	13213	537	3.9
CN1901300000000	19	013	Black Hawk County, IA	2015	NA	70387	67159	3228	4.6
CN1901500000000	19	015	Boone County, IA	2015	NA	15290	14826	464	3
CN1901700000000	19	017	Bremer County, IA	2015	NA	13948	13456	492	3.5
CN1901900000000	19	019	Buchanan County, IA	2015	NA	11297	10815	482	4.3
CN1902100000000	19	021	Buena Vista County, IA	2015	NA	11566	11141	425	3.7
CN1902300000000	19	023	Butler County, IA	2015	NA	8267	7904	363	4.4
CN1902500000000	19	025	Calhoun County, IA	2015	NA	4449	4256	193	4.3
CN1902700000000	19	027	Carroll County, IA	2015	NA	11286	10990	296	2.6
CN1902900000000	19	029	Cass County, IA	2015	NA	7446	7175	271	3.6
CN1903100000000	19	031	Cedar County, IA	2015	NA	10969	10591	378	3.4
CN1903300000000	19	033	Cerro Gordo County, IA	2015	NA	22974	22063	911	4
CN1903500000000	19	035	Cherokee County, IA	2015	NA	6333	6004	329	5.2
CN1903700000000	19	037	Chickasaw County, IA	2015	NA	6446	6155	291	4.5
CN1903900000000	19	039	Clarke County, IA	2015	NA	4762	4566	196	4.1
CN1904100000000	19	041	Clay County, IA	2015	NA	8837	8516	321	3.6
CN1904300000000	19	043	Clayton County, IA	2015	NA	10276	9849	427	4.2
CN1904500000000	19	045	Clinton County, IA	2015	NA	24397	23173	1224	5
CN1904700000000	19	047	Crawford County, IA	2015	NA	8736	8369	367	4.2
CN1904900000000	19	049	Dallas County, IA	2015	NA	43614	42360	1254	2.9
CN1905100000000	19	051	Davis County, IA	2015	NA	4170	3984	186	4.5
CN1905300000000	19	053	Decatur County, IA	2015	NA	4422	4277	145	3.3
CN1905500000000	19	055	Delaware County, IA	2015	NA	10669	10307	362	3.4
CN1905700000000	19	057	Des Moines County, IA	2015	NA	20488	19517	971	4.7
CN1905900000000	19	059	Dickinson County, IA	2015	NA	10194	9797	397	3.9
CN1906100000000	19	061	Dubuque County, IA	2015	NA	55638	53593	2045	3.7
CN1906300000000	19	063	Emmet County, IA	2015	NA	5655	5444	211	3.7
CN1906500000000	19	065	Fayette County, IA	2015	NA	10797	10306	491	4.5
CN1906700000000	19	067	Floyd County, IA	2015	NA	8689	8359	330	3.8
CN1906900000000	19	069	Franklin County, IA	2015	NA	5950	5749	201	3.4
CN1907100000000	19	071	Fremont County, IA	2015	NA	4142	4005	137	3.3
CN1907300000000	19	073	Greene County, IA	2015	NA	5561	5365	196	3.5
CN1907500000000	19	075	Grundy County, IA	2015	NA	6722	6466	256	3.8
CN1907700000000	19	077	Guthrie County, IA	2015	NA	5613	5401	212	3.8
CN1907900000000	19	079	Hamilton County, IA	2015	NA	7219	6911	308	4.3
CN1908100000000	19	081	Hancock County, IA	2015	NA	6357	6184	173	2.7
CN1908300000000	19	083	Hardin County, IA	2015	NA	8802	8453	349	4
CN1908500000000	19	085	Harrison County, IA	2015	NA	7527	7271	256	3.4
CN1908700000000	19	087	Henry County, IA	2015	NA	9583	9207	376	3.9
CN1908900000000	19	089	Howard County, IA	2015	NA	5368	5175	193	3.6
CN1909100000000	19	091	Humboldt County, IA	2015	NA	5334	5156	178	3.3
CN1909300000000	19	093	Ida County, IA	2015	NA	3954	3831	123	3.1
CN1909500000000	19	095	Iowa County, IA	2015	NA	10368	10003	365	3.5
CN1909700000000	19	097	Jackson County, IA	2015	NA	11149	10679	470	4.2
CN1909900000000	19	099	Jasper County, IA	2015	NA	19077	18334	743	3.9
CN1910100000000	19	101	Jefferson County, IA	2015	NA	9138	8786	352	3.9
CN1910300000000	19	103	Johnson County, IA	2015	NA	83764	81523	2241	2.7
CN1910500000000	19	105	Jones County, IA	2015	NA	10766	10315	451	4.2
CN1910700000000	19	107	Keokuk County, IA	2015	NA	5416	5185	231	4.3
CN1910900000000	19	109	Kossuth County, IA	2015	NA	8821	8568	253	2.9
CN1911100000000	19	111	Lee County, IA	2015	NA	18243	17259	984	5.4
CN1911300000000	19	113	Linn County, IA	2015	NA	120022	115459	4563	3.8
CN1911500000000	19	115	Louisa County, IA	2015	NA	6017	5788	229	3.8
CN1911700000000	19	117	Lucas County, IA	2015	NA	4395	4239	156	3.5
CN1911900000000	19	119	Lyon County, IA	2015	NA	7053	6911	142	2
CN1912100000000	19	121	Madison County, IA	2015	NA	8223	7900	323	3.9
CN1912300000000	19	123	Mahaska County, IA	2015	NA	11819	11349	470	4
CN1912500000000	19	125	Marion County, IA	2015	NA	17409	16837	572	3.3
CN1912700000000	19	127	Marshall County, IA	2015	NA	19409	18422	987	5.1
CN1912900000000	19	129	Mills County, IA	2015	NA	7415	7111	304	4.1
CN1913100000000	19	131	Mitchell County, IA	2015	NA	5587	5429	158	2.8
CN1913300000000	19	133	Monona County, IA	2015	NA	4756	4546	210	4.4
CN1913500000000	19	135	Monroe County, IA	2015	NA	4032	3853	179	4.4
CN1913700000000	19	137	Montgomery County, IA	2015	NA	5163	4979	184	3.6
CN1913900000000	19	139	Muscatine County, IA	2015	NA	22183	21322	861	3.9
CN1914100000000	19	141	O'Brien County, IA	2015	NA	8419	8180	239	2.8
CN1914300000000	19	143	Osceola County, IA	2015	NA	3539	3438	101	2.9
CN1914500000000	19	145	Page County, IA	2015	NA	6562	6289	273	4.2
CN1914700000000	19	147	Palo Alto County, IA	2015	NA	4857	4707	150	3.1
CN1914900000000	19	149	Plymouth County, IA	2015	NA	14770	14352	418	2.8
CN1915100000000	19	151	Pocahontas County, IA	2015	NA	4304	4173	131	3
CN1915300000000	19	153	Polk County, IA	2015	NA	255296	245868	9428	3.7
CN1915500000000	19	155	Pottawattamie County, IA	2015	NA	48930	47134	1796	3.7
CN1915700000000	19	157	Poweshiek County, IA	2015	NA	10495	10114	381	3.6
CN1915900000000	19	159	Ringgold County, IA	2015	NA	2563	2477	86	3.4
CN1916100000000	19	161	Sac County, IA	2015	NA	5634	5446	188	3.3
CN1916300000000	19	163	Scott County, IA	2015	NA	87792	83677	4115	4.7
CN1916500000000	19	165	Shelby County, IA	2015	NA	7009	6808	201	2.9
CN1916700000000	19	167	Sioux County, IA	2015	NA	20729	20218	511	2.5
CN1916900000000	19	169	Story County, IA	2015	NA	57348	55909	1439	2.5
CN1917100000000	19	171	Tama County, IA	2015	NA	9654	9232	422	4.4
CN1917300000000	19	173	Taylor County, IA	2015	NA	3235	3132	103	3.2
CN1917500000000	19	175	Union County, IA	2015	NA	6566	6291	275	4.2
CN1917700000000	19	177	Van Buren County, IA	2015	NA	3836	3680	156	4.1
CN1917900000000	19	179	Wapello County, IA	2015	NA	17986	17057	929	5.2
CN1918100000000	19	181	Warren County, IA	2015	NA	26671	25754	917	3.4
CN1918300000000	19	183	Washington County, IA	2015	NA	12374	11986	388	3.1
CN1918500000000	19	185	Wayne County, IA	2015	NA	2846	2734	112	3.9
CN1918700000000	19	187	Webster County, IA	2015	NA	20325	19445	880	4.3
CN1918900000000	19	189	Winnebago County, IA	2015	NA	5163	4957	206	4
CN1919100000000	19	191	Winneshiek County, IA	2015	NA	12210	11762	448	3.7
CN1919300000000	19	193	Woodbury County, IA	2015	NA	56119	53993	2126	3.8
CN1919500000000	19	195	Worth County, IA	2015	NA	4222	4053	169	4
CN1919700000000	19	197	Wright County, IA	2015	NA	6897	6627	270	3.9
CN2000100000000	20	001	Allen County, KS	2015	NA	6605	6266	339	5.1
CN2000300000000	20	003	Anderson County, KS	2015	NA	4134	3934	200	4.8
CN2000500000000	20	005	Atchison County, KS	2015	NA	7470	7011	459	6.1
CN2000700000000	20	007	Barber County, KS	2015	NA	2662	2549	113	4.2
CN2000900000000	20	009	Barton County, KS	2015	NA	14588	13972	616	4.2
CN2001100000000	20	011	Bourbon County, KS	2015	NA	7117	6776	341	4.8
CN2001300000000	20	013	Brown County, KS	2015	NA	5354	5141	213	4
CN2001500000000	20	015	Butler County, KS	2015	NA	32029	30662	1367	4.3
CN2001700000000	20	017	Chase County, KS	2015	NA	1252	1207	45	3.6
CN2001900000000	20	019	Chautauqua County, KS	2015	NA	1551	1463	88	5.7
CN2002100000000	20	021	Cherokee County, KS	2015	NA	10412	9949	463	4.4
CN2002300000000	20	023	Cheyenne County, KS	2015	NA	1357	1320	37	2.7
CN2002500000000	20	025	Clark County, KS	2015	NA	1159	1131	28	2.4
CN2002700000000	20	027	Clay County, KS	2015	NA	4116	3939	177	4.3
CN2002900000000	20	029	Cloud County, KS	2015	NA	4311	4147	164	3.8
CN2003100000000	20	031	Coffey County, KS	2015	NA	4739	4468	271	5.7
CN2003300000000	20	033	Comanche County, KS	2015	NA	991	958	33	3.3
CN2003500000000	20	035	Cowley County, KS	2015	NA	17039	16259	780	4.6
CN2003700000000	20	037	Crawford County, KS	2015	NA	18924	17959	965	5.1
CN2003900000000	20	039	Decatur County, KS	2015	NA	1350	1301	49	3.6
CN2004100000000	20	041	Dickinson County, KS	2015	NA	9519	9026	493	5.2
CN2004300000000	20	043	Doniphan County, KS	2015	NA	4318	4131	187	4.3
CN2004500000000	20	045	Douglas County, KS	2015	NA	64751	62358	2393	3.7
CN2004700000000	20	047	Edwards County, KS	2015	NA	1749	1696	53	3
CN2004900000000	20	049	Elk County, KS	2015	NA	1279	1218	61	4.8
CN2005100000000	20	051	Ellis County, KS	2015	NA	17518	16994	524	3
CN2005300000000	20	053	Ellsworth County, KS	2015	NA	2938	2830	108	3.7
CN2005500000000	20	055	Finney County, KS	2015	NA	20126	19415	711	3.5
CN2005700000000	20	057	Ford County, KS	2015	NA	18058	17444	614	3.4
CN2005900000000	20	059	Franklin County, KS	2015	NA	14099	13453	646	4.6
CN2006100000000	20	061	Geary County, KS	2015	NA	12109	11358	751	6.2
CN2006300000000	20	063	Gove County, KS	2015	NA	1486	1449	37	2.5
CN2006500000000	20	065	Graham County, KS	2015	NA	1272	1222	50	3.9
CN2006700000000	20	067	Grant County, KS	2015	NA	3902	3762	140	3.6
CN2006900000000	20	069	Gray County, KS	2015	NA	3600	3517	83	2.3
CN2007100000000	20	071	Greeley County, KS	2015	NA	934	914	20	2.1
CN2007300000000	20	073	Greenwood County, KS	2015	NA	3289	3138	151	4.6
CN2007500000000	20	075	Hamilton County, KS	2015	NA	1652	1619	33	2
CN2007700000000	20	077	Harper County, KS	2015	NA	2855	2744	111	3.9
CN2007900000000	20	079	Harvey County, KS	2015	NA	17206	16534	672	3.9
CN2008100000000	20	081	Haskell County, KS	2015	NA	2358	2299	59	2.5
CN2008300000000	20	083	Hodgeman County, KS	2015	NA	1027	995	32	3.1
CN2008500000000	20	085	Jackson County, KS	2015	NA	7239	6970	269	3.7
CN2008700000000	20	087	Jefferson County, KS	2015	NA	10185	9758	427	4.2
CN2008900000000	20	089	Jewell County, KS	2015	NA	1374	1314	60	4.4
CN2009100000000	20	091	Johnson County, KS	2015	NA	324639	313637	11002	3.4
CN2009300000000	20	093	Kearny County, KS	2015	NA	2147	2080	67	3.1
CN2009500000000	20	095	Kingman County, KS	2015	NA	3648	3490	158	4.3
CN2009700000000	20	097	Kiowa County, KS	2015	NA	1448	1405	43	3
CN2009900000000	20	099	Labette County, KS	2015	NA	10753	10135	618	5.7
CN2010100000000	20	101	Lane County, KS	2015	NA	878	849	29	3.3
CN2010300000000	20	103	Leavenworth County, KS	2015	NA	35267	33677	1590	4.5
CN2010500000000	20	105	Lincoln County, KS	2015	NA	1797	1735	62	3.5
CN2010700000000	20	107	Linn County, KS	2015	NA	4328	4050	278	6.4
CN2010900000000	20	109	Logan County, KS	2015	NA	1755	1712	43	2.5
CN2011100000000	20	111	Lyon County, KS	2015	NA	16633	15919	714	4.3
CN2011300000000	20	113	McPherson County, KS	2015	NA	17179	16665	514	3
CN2011500000000	20	115	Marion County, KS	2015	NA	6161	5928	233	3.8
CN2011700000000	20	117	Marshall County, KS	2015	NA	5734	5567	167	2.9
CN2011900000000	20	119	Meade County, KS	2015	NA	2418	2346	72	3
CN2012100000000	20	121	Miami County, KS	2015	NA	16755	16028	727	4.3
CN2012300000000	20	123	Mitchell County, KS	2015	NA	3774	3649	125	3.3
CN2012500000000	20	125	Montgomery County, KS	2015	NA	16575	15503	1072	6.5
CN2012700000000	20	127	Morris County, KS	2015	NA	3104	2971	133	4.3
CN2012900000000	20	129	Morton County, KS	2015	NA	1435	1375	60	4.2
CN2013100000000	20	131	Nemaha County, KS	2015	NA	5937	5785	152	2.6
CN2013300000000	20	133	Neosho County, KS	2015	NA	6268	5801	467	7.5
CN2013500000000	20	135	Ness County, KS	2015	NA	1537	1486	51	3.3
CN2013700000000	20	137	Norton County, KS	2015	NA	2949	2876	73	2.5
CN2013900000000	20	139	Osage County, KS	2015	NA	8056	7654	402	5
CN2014100000000	20	141	Osborne County, KS	2015	NA	2090	2017	73	3.5
CN2014300000000	20	143	Ottawa County, KS	2015	NA	3229	3107	122	3.8
CN2014500000000	20	145	Pawnee County, KS	2015	NA	3306	3183	123	3.7
CN2014700000000	20	147	Phillips County, KS	2015	NA	2954	2859	95	3.2
CN2014900000000	20	149	Pottawatomie County, KS	2015	NA	11952	11516	436	3.6
CN2015100000000	20	151	Pratt County, KS	2015	NA	5290	5076	214	4
CN2015300000000	20	153	Rawlins County, KS	2015	NA	1535	1500	35	2.3
CN2015500000000	20	155	Reno County, KS	2015	NA	30837	29507	1330	4.3
CN2015700000000	20	157	Republic County, KS	2015	NA	2589	2518	71	2.7
CN2015900000000	20	159	Rice County, KS	2015	NA	5477	5270	207	3.8
CN2016100000000	20	161	Riley County, KS	2015	NA	35625	34406	1219	3.4
CN2016300000000	20	163	Rooks County, KS	2015	NA	2809	2680	129	4.6
CN2016500000000	20	165	Rush County, KS	2015	NA	1794	1731	63	3.5
CN2016700000000	20	167	Russell County, KS	2015	NA	3732	3593	139	3.7
CN2016900000000	20	169	Saline County, KS	2015	NA	30867	29704	1163	3.8
CN2017100000000	20	171	Scott County, KS	2015	NA	2885	2805	80	2.8
CN2017300000000	20	173	Sedgwick County, KS	2015	NA	246743	234963	11780	4.8
CN2017500000000	20	175	Seward County, KS	2015	NA	10621	10163	458	4.3
CN2017700000000	20	177	Shawnee County, KS	2015	NA	91219	87347	3872	4.2
CN2017900000000	20	179	Sheridan County, KS	2015	NA	1482	1449	33	2.2
CN2018100000000	20	181	Sherman County, KS	2015	NA	3090	3000	90	2.9
CN2018300000000	20	183	Smith County, KS	2015	NA	2093	2012	81	3.9
CN2018500000000	20	185	Stafford County, KS	2015	NA	2182	2095	87	4
CN2018700000000	20	187	Stanton County, KS	2015	NA	1061	1029	32	3
CN2018900000000	20	189	Stevens County, KS	2015	NA	3178	3059	119	3.7
CN2019100000000	20	191	Sumner County, KS	2015	NA	11077	10584	493	4.5
CN2019300000000	20	193	Thomas County, KS	2015	NA	4415	4298	117	2.7
CN2019500000000	20	195	Trego County, KS	2015	NA	1508	1455	53	3.5
CN2019700000000	20	197	Wabaunsee County, KS	2015	NA	3732	3588	144	3.9
CN2019900000000	20	199	Wallace County, KS	2015	NA	877	853	24	2.7
CN2020100000000	20	201	Washington County, KS	2015	NA	3128	3030	98	3.1
CN2020300000000	20	203	Wichita County, KS	2015	NA	1255	1218	37	2.9
CN2020500000000	20	205	Wilson County, KS	2015	NA	4007	3744	263	6.6
CN2020700000000	20	207	Woodson County, KS	2015	NA	1611	1530	81	5
CN2020900000000	20	209	Wyandotte County, KS	2015	NA	76144	71563	4581	6
CN2100100000000	21	001	Adair County, KY	2015	NA	7227	6709	518	7.2
CN2100300000000	21	003	Allen County, KY	2015	NA	8674	8252	422	4.9
CN2100500000000	21	005	Anderson County, KY	2015	NA	11346	10879	467	4.1
CN2100700000000	21	007	Ballard County, KY	2015	NA	3604	3356	248	6.9
CN2100900000000	21	009	Barren County, KY	2015	NA	18446	17491	955	5.2
CN2101100000000	21	011	Bath County, KY	2015	NA	4689	4328	361	7.7
CN2101300000000	21	013	Bell County, KY	2015	NA	8730	7981	749	8.6
CN2101500000000	21	015	Boone County, KY	2015	NA	65668	62999	2669	4.1
CN2101700000000	21	017	Bourbon County, KY	2015	NA	9750	9290	460	4.7
CN2101900000000	21	019	Boyd County, KY	2015	NA	18320	17063	1257	6.9
CN2102100000000	21	021	Boyle County, KY	2015	NA	12027	11362	665	5.5
CN2102300000000	21	023	Bracken County, KY	2015	NA	3727	3493	234	6.3
CN2102500000000	21	025	Breathitt County, KY	2015	NA	3819	3444	375	9.8
CN2102700000000	21	027	Breckinridge County, KY	2015	NA	7660	7187	473	6.2
CN2102900000000	21	029	Bullitt County, KY	2015	NA	39451	37662	1789	4.5
CN2103100000000	21	031	Butler County, KY	2015	NA	5096	4796	300	5.9
CN2103300000000	21	033	Caldwell County, KY	2015	NA	5302	5007	295	5.6
CN2103500000000	21	035	Calloway County, KY	2015	NA	18561	17698	863	4.6
CN2103700000000	21	037	Campbell County, KY	2015	NA	47828	45852	1976	4.1
CN2103900000000	21	039	Carlisle County, KY	2015	NA	2228	2097	131	5.9
CN2104100000000	21	041	Carroll County, KY	2015	NA	5011	4734	277	5.5
CN2104300000000	21	043	Carter County, KY	2015	NA	9944	8940	1004	10.1
CN2104500000000	21	045	Casey County, KY	2015	NA	6510	6134	376	5.8
CN2104700000000	21	047	Christian County, KY	2015	NA	24956	23374	1582	6.3
CN2104900000000	21	049	Clark County, KY	2015	NA	16884	16006	878	5.2
CN2105100000000	21	051	Clay County, KY	2015	NA	5290	4777	513	9.7
CN2105300000000	21	053	Clinton County, KY	2015	NA	3795	3478	317	8.4
CN2105500000000	21	055	Crittenden County, KY	2015	NA	3721	3514	207	5.6
CN2105700000000	21	057	Cumberland County, KY	2015	NA	2870	2697	173	6
CN2105900000000	21	059	Daviess County, KY	2015	NA	45635	43539	2096	4.6
CN2106100000000	21	061	Edmonson County, KY	2015	NA	4685	4356	329	7
CN2106300000000	21	063	Elliott County, KY	2015	NA	2039	1829	210	10.3
CN2106500000000	21	065	Estill County, KY	2015	NA	5197	4875	322	6.2
CN2106700000000	21	067	Fayette County, KY	2015	NA	168040	161603	6437	3.8
CN2106900000000	21	069	Fleming County, KY	2015	NA	6078	5693	385	6.3
CN2107100000000	21	071	Floyd County, KY	2015	NA	11567	10471	1096	9.5
CN2107300000000	21	073	Franklin County, KY	2015	NA	24334	23300	1034	4.2
CN2107500000000	21	075	Fulton County, KY	2015	NA	2065	1906	159	7.7
CN2107700000000	21	077	Gallatin County, KY	2015	NA	3845	3647	198	5.1
CN2107900000000	21	079	Garrard County, KY	2015	NA	7498	7110	388	5.2
CN2108100000000	21	081	Grant County, KY	2015	NA	11096	10506	590	5.3
CN2108300000000	21	083	Graves County, KY	2015	NA	15129	14187	942	6.2
CN2108500000000	21	085	Grayson County, KY	2015	NA	10513	9806	707	6.7
CN2108700000000	21	087	Green County, KY	2015	NA	4968	4703	265	5.3
CN2108900000000	21	089	Greenup County, KY	2015	NA	13753	12707	1046	7.6
CN2109100000000	21	091	Hancock County, KY	2015	NA	3891	3698	193	5
CN2109300000000	21	093	Hardin County, KY	2015	NA	46631	44322	2309	5
CN2109500000000	21	095	Harlan County, KY	2015	NA	6997	6109	888	12.7
CN2109700000000	21	097	Harrison County, KY	2015	NA	8329	7941	388	4.7
CN2109900000000	21	099	Hart County, KY	2015	NA	7671	7277	394	5.1
CN2110100000000	21	101	Henderson County, KY	2015	NA	21433	20400	1033	4.8
CN2110300000000	21	103	Henry County, KY	2015	NA	7668	7311	357	4.7
CN2110500000000	21	105	Hickman County, KY	2015	NA	1928	1811	117	6.1
CN2110700000000	21	107	Hopkins County, KY	2015	NA	19132	18033	1099	5.7
CN2110900000000	21	109	Jackson County, KY	2015	NA	4194	3819	375	8.9
CN2111100000000	21	111	Jefferson County, KY	2015	NA	377768	359717	18051	4.8
CN2111300000000	21	113	Jessamine County, KY	2015	NA	25282	24224	1058	4.2
CN2111500000000	21	115	Johnson County, KY	2015	NA	7167	6533	634	8.8
CN2111700000000	21	117	Kenton County, KY	2015	NA	83326	79649	3677	4.4
CN2111900000000	21	119	Knott County, KY	2015	NA	4715	4233	482	10.2
CN2112100000000	21	121	Knox County, KY	2015	NA	9741	8942	799	8.2
CN2112300000000	21	123	Larue County, KY	2015	NA	5863	5564	299	5.1
CN2112500000000	21	125	Laurel County, KY	2015	NA	23402	21939	1463	6.3
CN2112700000000	21	127	Lawrence County, KY	2015	NA	4976	4500	476	9.6
CN2112900000000	21	129	Lee County, KY	2015	NA	1977	1805	172	8.7
CN2113100000000	21	131	Leslie County, KY	2015	NA	2872	2551	321	11.2
CN2113300000000	21	133	Letcher County, KY	2015	NA	6613	5845	768	11.6
CN2113500000000	21	135	Lewis County, KY	2015	NA	4795	4369	426	8.9
CN2113700000000	21	137	Lincoln County, KY	2015	NA	9040	8430	610	6.7
CN2113900000000	21	139	Livingston County, KY	2015	NA	3682	3417	265	7.2
CN2114100000000	21	141	Logan County, KY	2015	NA	11457	10906	551	4.8
CN2114300000000	21	143	Lyon County, KY	2015	NA	2867	2702	165	5.8
CN2114500000000	21	145	McCracken County, KY	2015	NA	28758	27109	1649	5.7
CN2114700000000	21	147	McCreary County, KY	2015	NA	4638	4244	394	8.5
CN2114900000000	21	149	McLean County, KY	2015	NA	4259	4050	209	4.9
CN2115100000000	21	151	Madison County, KY	2015	NA	45226	43279	1947	4.3
CN2115300000000	21	153	Magoffin County, KY	2015	NA	3329	2804	525	15.8
CN2115500000000	21	155	Marion County, KY	2015	NA	9126	8676	450	4.9
CN2115700000000	21	157	Marshall County, KY	2015	NA	14820	13989	831	5.6
CN2115900000000	21	159	Martin County, KY	2015	NA	3090	2780	310	10
CN2116100000000	21	161	Mason County, KY	2015	NA	7294	6844	450	6.2
CN2116300000000	21	163	Meade County, KY	2015	NA	11795	11139	656	5.6
CN2116500000000	21	165	Menifee County, KY	2015	NA	2356	2153	203	8.6
CN2116700000000	21	167	Mercer County, KY	2015	NA	9683	9194	489	5.1
CN2116900000000	21	169	Metcalfe County, KY	2015	NA	4024	3815	209	5.2
CN2117100000000	21	171	Monroe County, KY	2015	NA	4494	4296	198	4.4
CN2117300000000	21	173	Montgomery County, KY	2015	NA	11717	10946	771	6.6
CN2117500000000	21	175	Morgan County, KY	2015	NA	4411	4043	368	8.3
CN2117700000000	21	177	Muhlenberg County, KY	2015	NA	11514	10680	834	7.2
CN2117900000000	21	179	Nelson County, KY	2015	NA	21034	19968	1066	5.1
CN2118100000000	21	181	Nicholas County, KY	2015	NA	3178	2979	199	6.3
CN2118300000000	21	183	Ohio County, KY	2015	NA	9316	8722	594	6.4
CN2118500000000	21	185	Oldham County, KY	2015	NA	30960	29755	1205	3.9
CN2118700000000	21	187	Owen County, KY	2015	NA	5374	5151	223	4.1
CN2118900000000	21	189	Owsley County, KY	2015	NA	1139	1023	116	10.2
CN2119100000000	21	191	Pendleton County, KY	2015	NA	6678	6322	356	5.3
CN2119300000000	21	193	Perry County, KY	2015	NA	8810	8009	801	9.1
CN2119500000000	21	195	Pike County, KY	2015	NA	20870	18930	1940	9.3
CN2119700000000	21	197	Powell County, KY	2015	NA	4862	4517	345	7.1
CN2119900000000	21	199	Pulaski County, KY	2015	NA	25467	23962	1505	5.9
CN2120100000000	21	201	Robertson County, KY	2015	NA	781	730	51	6.5
CN2120300000000	21	203	Rockcastle County, KY	2015	NA	6879	6439	440	6.4
CN2120500000000	21	205	Rowan County, KY	2015	NA	10300	9688	612	5.9
CN2120700000000	21	207	Russell County, KY	2015	NA	6150	5427	723	11.8
CN2120900000000	21	209	Scott County, KY	2015	NA	26937	25875	1062	3.9
CN2121100000000	21	211	Shelby County, KY	2015	NA	22914	21993	921	4
CN2121300000000	21	213	Simpson County, KY	2015	NA	8329	7930	399	4.8
CN2121500000000	21	215	Spencer County, KY	2015	NA	9265	8869	396	4.3
CN2121700000000	21	217	Taylor County, KY	2015	NA	11783	11074	709	6
CN2121900000000	21	219	Todd County, KY	2015	NA	5235	4982	253	4.8
CN2122100000000	21	221	Trigg County, KY	2015	NA	5730	5402	328	5.7
CN2122300000000	21	223	Trimble County, KY	2015	NA	3844	3628	216	5.6
CN2122500000000	21	225	Union County, KY	2015	NA	6132	5717	415	6.8
CN2122700000000	21	227	Warren County, KY	2015	NA	59510	56848	2662	4.5
CN2122900000000	21	229	Washington County, KY	2015	NA	5959	5693	266	4.5
CN2123100000000	21	231	Wayne County, KY	2015	NA	7037	6463	574	8.2
CN2123300000000	21	233	Webster County, KY	2015	NA	5964	5652	312	5.2
CN2123500000000	21	235	Whitley County, KY	2015	NA	13130	12238	892	6.8
CN2123700000000	21	237	Wolfe County, KY	2015	NA	1910	1716	194	10.2
CN2123900000000	21	239	Woodford County, KY	2015	NA	14383	13879	504	3.5
CN2200100000000	22	001	Acadia Parish, LA	2015	NA	25807	24039	1768	6.9
CN2200300000000	22	003	Allen Parish, LA	2015	NA	8821	8207	614	7
CN2200500000000	22	005	Ascension Parish, LA	2015	NA	61625	58505	3120	5.1
CN2200700000000	22	007	Assumption Parish, LA	2015	NA	9799	9026	773	7.9
CN2200900000000	22	009	Avoyelles Parish, LA	2015	NA	15958	14757	1201	7.5
CN2201100000000	22	011	Beauregard Parish, LA	2015	NA	15188	14224	964	6.3
CN2201300000000	22	013	Bienville Parish, LA	2015	NA	5801	5318	483	8.3
CN2201500000000	22	015	Bossier Parish, LA	2015	NA	58158	54869	3289	5.7
CN2201700000000	22	017	Caddo Parish, LA	2015	NA	110251	102368	7883	7.2
CN2201900000000	22	019	Calcasieu Parish, LA	2015	NA	99173	93820	5353	5.4
CN2202100000000	22	021	Caldwell Parish, LA	2015	NA	4025	3691	334	8.3
CN2202300000000	22	023	Cameron Parish, LA	2015	NA	3666	3495	171	4.7
CN2202500000000	22	025	Catahoula Parish, LA	2015	NA	3613	3265	348	9.6
CN2202700000000	22	027	Claiborne Parish, LA	2015	NA	6185	5731	454	7.3
CN2202900000000	22	029	Concordia Parish, LA	2015	NA	7539	6885	654	8.7
CN2203100000000	22	031	De Soto Parish, LA	2015	NA	11075	10190	885	8
CN2203300000000	22	033	East Baton Rouge Parish, LA	2015	NA	235008	222242	12766	5.4
CN2203500000000	22	035	East Carroll Parish, LA	2015	NA	2216	1903	313	14.1
CN2203700000000	22	037	East Feliciana Parish, LA	2015	NA	8209	7720	489	6
CN2203900000000	22	039	Evangeline Parish, LA	2015	NA	12985	12005	980	7.5
CN2204100000000	22	041	Franklin Parish, LA	2015	NA	7519	6789	730	9.7
CN2204300000000	22	043	Grant Parish, LA	2015	NA	8471	7849	622	7.3
CN2204500000000	22	045	Iberia Parish, LA	2015	NA	31817	29232	2585	8.1
CN2204700000000	22	047	Iberville Parish, LA	2015	NA	14402	13348	1054	7.3
CN2204900000000	22	049	Jackson Parish, LA	2015	NA	7252	6817	435	6
CN2205100000000	22	051	Jefferson Parish, LA	2015	NA	219385	206759	12626	5.8
CN2205300000000	22	053	Jefferson Davis Parish, LA	2015	NA	13593	12750	843	6.2
CN2205500000000	22	055	Lafayette Parish, LA	2015	NA	120044	113224	6820	5.7
CN2205700000000	22	057	Lafourche Parish, LA	2015	NA	46617	44091	2526	5.4
CN2205900000000	22	059	LaSalle Parish, LA	2015	NA	6603	6147	456	6.9
CN2206100000000	22	061	Lincoln Parish, LA	2015	NA	21053	19580	1473	7
CN2206300000000	22	063	Livingston Parish, LA	2015	NA	68263	64761	3502	5.1
CN2206500000000	22	065	Madison Parish, LA	2015	NA	3902	3539	363	9.3
CN2206700000000	22	067	Morehouse Parish, LA	2015	NA	10818	9627	1191	11
CN2206900000000	22	069	Natchitoches Parish, LA	2015	NA	16565	15304	1261	7.6
CN2207100000000	22	071	Orleans Parish, LA	2015	NA	181971	170104	11867	6.5
CN2207300000000	22	073	Ouachita Parish, LA	2015	NA	72254	67444	4810	6.7
CN2207500000000	22	075	Plaquemines Parish, LA	2015	NA	10324	9745	579	5.6
CN2207700000000	22	077	Pointe Coupee Parish, LA	2015	NA	10123	9453	670	6.6
CN2207900000000	22	079	Rapides Parish, LA	2015	NA	58175	54412	3763	6.5
CN2208100000000	22	081	Red River Parish, LA	2015	NA	3915	3644	271	6.9
CN2208300000000	22	083	Richland Parish, LA	2015	NA	8663	7905	758	8.7
CN2208500000000	22	085	Sabine Parish, LA	2015	NA	9474	8797	677	7.1
CN2208700000000	22	087	St. Bernard Parish, LA	2015	NA	19716	18413	1303	6.6
CN2208900000000	22	089	St. Charles Parish, LA	2015	NA	25606	24139	1467	5.7
CN2209100000000	22	091	St. Helena Parish, LA	2015	NA	4530	4118	412	9.1
CN2209300000000	22	093	St. James Parish, LA	2015	NA	9802	8970	832	8.5
CN2209500000000	22	095	St. John the Baptist Parish, LA	2015	NA	20373	18846	1527	7.5
CN2209700000000	22	097	St. Landry Parish, LA	2015	NA	33775	31058	2717	8
CN2209900000000	22	099	St. Martin Parish, LA	2015	NA	24072	22414	1658	6.9
CN2210100000000	22	101	St. Mary Parish, LA	2015	NA	24259	22409	1850	7.6
CN2210300000000	22	103	St. Tammany Parish, LA	2015	NA	117427	111093	6334	5.4
CN2210500000000	22	105	Tangipahoa Parish, LA	2015	NA	54206	50284	3922	7.2
CN2210700000000	22	107	Tensas Parish, LA	2015	NA	1717	1549	168	9.8
CN2210900000000	22	109	Terrebonne Parish, LA	2015	NA	52997	49827	3170	6
CN2211100000000	22	111	Union Parish, LA	2015	NA	9352	8682	670	7.2
CN2211300000000	22	113	Vermilion Parish, LA	2015	NA	25831	24036	1795	6.9
CN2211500000000	22	115	Vernon Parish, LA	2015	NA	17427	16070	1357	7.8
CN2211700000000	22	117	Washington Parish, LA	2015	NA	17039	15737	1302	7.6
CN2211900000000	22	119	Webster Parish, LA	2015	NA	15578	14202	1376	8.8
CN2212100000000	22	121	West Baton Rouge Parish, LA	2015	NA	13254	12511	743	5.6
CN2212300000000	22	123	West Carroll Parish, LA	2015	NA	4122	3567	555	13.5
CN2212500000000	22	125	West Feliciana Parish, LA	2015	NA	5404	5118	286	5.3
CN2212700000000	22	127	Winn Parish, LA	2015	NA	5337	4885	452	8.5
CN2300100000000	23	001	Androscoggin County, ME	2015	NA	54797	52513	2284	4.2
CN2300300000000	23	003	Aroostook County, ME	2015	NA	31701	29826	1875	5.9
CN2300500000000	23	005	Cumberland County, ME	2015	NA	157894	152480	5414	3.4
CN2300700000000	23	007	Franklin County, ME	2015	NA	14533	13841	692	4.8
CN2300900000000	23	009	Hancock County, ME	2015	NA	29055	27438	1617	5.6
CN2301100000000	23	011	Kennebec County, ME	2015	NA	61616	59007	2609	4.2
CN2301300000000	23	013	Knox County, ME	2015	NA	20471	19633	838	4.1
CN2301500000000	23	015	Lincoln County, ME	2015	NA	16724	15982	742	4.4
CN2301700000000	23	017	Oxford County, ME	2015	NA	26526	25085	1441	5.4
CN2301900000000	23	019	Penobscot County, ME	2015	NA	76851	73218	3633	4.7
CN2302100000000	23	021	Piscataquis County, ME	2015	NA	7451	7040	411	5.5
CN2302300000000	23	023	Sagadahoc County, ME	2015	NA	18931	18266	665	3.5
CN2302500000000	23	025	Somerset County, ME	2015	NA	23629	22084	1545	6.5
CN2302700000000	23	027	Waldo County, ME	2015	NA	20613	19541	1072	5.2
CN2302900000000	23	029	Washington County, ME	2015	NA	13989	13098	891	6.4
CN2303100000000	23	031	York County, ME	2015	NA	108464	104208	4256	3.9
CN2400100000000	24	001	Allegany County, MD	2015	NA	32287	30038	2249	7
CN2400300000000	24	003	Anne Arundel County, MD	2015	NA	300913	287705	13208	4.4
CN2400500000000	24	005	Baltimore County, MD	2015	NA	444951	421458	23493	5.3
CN2400900000000	24	009	Calvert County, MD	2015	NA	47011	44856	2155	4.6
CN2401100000000	24	011	Caroline County, MD	2015	NA	17471	16519	952	5.4
CN2401300000000	24	013	Carroll County, MD	2015	NA	93045	89128	3917	4.2
CN2401500000000	24	015	Cecil County, MD	2015	NA	52582	49436	3146	6
CN2401700000000	24	017	Charles County, MD	2015	NA	80510	76509	4001	5
CN2401900000000	24	019	Dorchester County, MD	2015	NA	15805	14675	1130	7.1
CN2402100000000	24	021	Frederick County, MD	2015	NA	128523	122786	5737	4.5
CN2402300000000	24	023	Garrett County, MD	2015	NA	15639	14654	985	6.3
CN2402500000000	24	025	Harford County, MD	2015	NA	135870	129201	6669	4.9
CN2402700000000	24	027	Howard County, MD	2015	NA	176731	170009	6722	3.8
CN2402900000000	24	029	Kent County, MD	2015	NA	10574	10011	563	5.3
CN2403100000000	24	031	Montgomery County, MD	2015	NA	547383	526091	21292	3.9
CN2403300000000	24	033	Prince George's County, MD	2015	NA	486583	461112	25471	5.2
CN2403500000000	24	035	Queen Anne's County, MD	2015	NA	26622	25423	1199	4.5
CN2403700000000	24	037	St. Mary's County, MD	2015	NA	54587	51943	2644	4.8
CN2403900000000	24	039	Somerset County, MD	2015	NA	9225	8467	758	8.2
CN2404100000000	24	041	Talbot County, MD	2015	NA	19267	18323	944	4.9
CN2404300000000	24	043	Washington County, MD	2015	NA	76681	72386	4295	5.6
CN2404500000000	24	045	Wicomico County, MD	2015	NA	50226	46822	3404	6.8
CN2404700000000	24	047	Worcester County, MD	2015	NA	25464	22775	2689	10.6
CN2451000000000	24	510	Baltimore city, MD	2015	NA	293652	271532	22120	7.5
CN2500100000000	25	001	Barnstable County, MA	2015	NA	111570	104767	6803	6.1
CN2500300000000	25	003	Berkshire County, MA	2015	NA	65098	61582	3516	5.4
CN2500500000000	25	005	Bristol County, MA	2015	NA	289836	272112	17724	6.1
CN2500700000000	25	007	Dukes County, MA	2015	NA	9456	8839	617	6.5
CN2500900000000	25	009	Essex County, MA	2015	NA	407755	387402	20353	5
CN2501100000000	25	011	Franklin County, MA	2015	NA	39434	37705	1729	4.4
CN2501300000000	25	013	Hampden County, MA	2015	NA	222643	208420	14223	6.4
CN2501500000000	25	015	Hampshire County, MA	2015	NA	87345	83414	3931	4.5
CN2501700000000	25	017	Middlesex County, MA	2015	NA	863351	829555	33796	3.9
CN2501900000000	25	019	Nantucket County/town, MA	2015	NA	6967	6592	375	5.4
CN2502100000000	25	021	Norfolk County, MA	2015	NA	369156	353791	15365	4.2
CN2502300000000	25	023	Plymouth County, MA	2015	NA	268265	254727	13538	5
CN2502500000000	25	025	Suffolk County, MA	2015	NA	420905	402385	18520	4.4
CN2502700000000	25	027	Worcester County, MA	2015	NA	427532	405821	21711	5.1
CN2600100000000	26	001	Alcona County, MI	2015	NA	3805	3496	309	8.1
CN2600300000000	26	003	Alger County, MI	2015	NA	3230	2951	279	8.6
CN2600500000000	26	005	Allegan County, MI	2015	NA	60441	57906	2535	4.2
CN2600700000000	26	007	Alpena County, MI	2015	NA	13615	12754	861	6.3
CN2600900000000	26	009	Antrim County, MI	2015	NA	9988	9233	755	7.6
CN2601100000000	26	011	Arenac County, MI	2015	NA	6227	5662	565	9.1
CN2601300000000	26	013	Baraga County, MI	2015	NA	3297	2992	305	9.3
CN2601500000000	26	015	Barry County, MI	2015	NA	30202	28892	1310	4.3
CN2601700000000	26	017	Bay County, MI	2015	NA	52192	49142	3050	5.8
CN2601900000000	26	019	Benzie County, MI	2015	NA	8674	8061	613	7.1
CN2602100000000	26	021	Berrien County, MI	2015	NA	73367	69500	3867	5.3
CN2602300000000	26	023	Branch County, MI	2015	NA	19139	18149	990	5.2
CN2602500000000	26	025	Calhoun County, MI	2015	NA	64129	60821	3308	5.2
CN2602700000000	26	027	Cass County, MI	2015	NA	24008	22779	1229	5.1
CN2602900000000	26	029	Charlevoix County, MI	2015	NA	13044	12247	797	6.1
CN2603100000000	26	031	Cheboygan County, MI	2015	NA	10686	9698	988	9.2
CN2603300000000	26	033	Chippewa County, MI	2015	NA	16690	15375	1315	7.9
CN2603500000000	26	035	Clare County, MI	2015	NA	11779	10855	924	7.8
CN2603700000000	26	037	Clinton County, MI	2015	NA	39722	38146	1576	4
CN2603900000000	26	039	Crawford County, MI	2015	NA	5273	4855	418	7.9
CN2604100000000	26	041	Delta County, MI	2015	NA	17237	16052	1185	6.9
CN2604300000000	26	043	Dickinson County, MI	2015	NA	12600	11879	721	5.7
CN2604500000000	26	045	Eaton County, MI	2015	NA	55831	53330	2501	4.5
CN2604700000000	26	047	Emmet County, MI	2015	NA	17632	16344	1288	7.3
CN2604900000000	26	049	Genesee County, MI	2015	NA	181692	170490	11202	6.2
CN2605100000000	26	051	Gladwin County, MI	2015	NA	9976	9241	735	7.4
CN2605300000000	26	053	Gogebic County, MI	2015	NA	6493	6012	481	7.4
CN2605500000000	26	055	Grand Traverse County, MI	2015	NA	48427	46139	2288	4.7
CN2605700000000	26	057	Gratiot County, MI	2015	NA	18285	17235	1050	5.7
CN2605900000000	26	059	Hillsdale County, MI	2015	NA	21018	19901	1117	5.3
CN2606100000000	26	061	Houghton County, MI	2015	NA	16562	15497	1065	6.4
CN2606300000000	26	063	Huron County, MI	2015	NA	16358	15465	893	5.5
CN2606500000000	26	065	Ingham County, MI	2015	NA	145756	138866	6890	4.7
CN2606700000000	26	067	Ionia County, MI	2015	NA	29343	27986	1357	4.6
CN2606900000000	26	069	Iosco County, MI	2015	NA	10094	9324	770	7.6
CN2607100000000	26	071	Iron County, MI	2015	NA	5206	4834	372	7.1
CN2607300000000	26	073	Isabella County, MI	2015	NA	35288	33572	1716	4.9
CN2607500000000	26	075	Jackson County, MI	2015	NA	73010	69100	3910	5.4
CN2607700000000	26	077	Kalamazoo County, MI	2015	NA	129087	123401	5686	4.4
CN2607900000000	26	079	Kalkaska County, MI	2015	NA	7626	7033	593	7.8
CN2608100000000	26	081	Kent County, MI	2015	NA	342291	329249	13042	3.8
CN2608300000000	26	083	Keweenaw County, MI	2015	NA	940	852	88	9.4
CN2608500000000	26	085	Lake County, MI	2015	NA	3679	3359	320	8.7
CN2608700000000	26	087	Lapeer County, MI	2015	NA	39785	36950	2835	7.1
CN2608900000000	26	089	Leelanau County, MI	2015	NA	10578	10015	563	5.3
CN2609100000000	26	091	Lenawee County, MI	2015	NA	47453	45046	2407	5.1
CN2609300000000	26	093	Livingston County, MI	2015	NA	96610	92191	4419	4.6
CN2609500000000	26	095	Luce County, MI	2015	NA	2459	2285	174	7.1
CN2609700000000	26	097	Mackinac County, MI	2015	NA	5124	4619	505	9.9
CN2609900000000	26	099	Macomb County, MI	2015	NA	422184	398130	24054	5.7
CN2610100000000	26	101	Manistee County, MI	2015	NA	10404	9703	701	6.7
CN2610300000000	26	103	Marquette County, MI	2015	NA	33372	31344	2028	6.1
CN2610500000000	26	105	Mason County, MI	2015	NA	14410	13518	892	6.2
CN2610700000000	26	107	Mecosta County, MI	2015	NA	19135	17943	1192	6.2
CN2610900000000	26	109	Menominee County, MI	2015	NA	11523	10894	629	5.5
CN2611100000000	26	111	Midland County, MI	2015	NA	41413	39370	2043	4.9
CN2611300000000	26	113	Missaukee County, MI	2015	NA	6986	6523	463	6.6
CN2611500000000	26	115	Monroe County, MI	2015	NA	76190	72674	3516	4.6
CN2611700000000	26	117	Montcalm County, MI	2015	NA	27675	26069	1606	5.8
CN2611900000000	26	119	Montmorency County, MI	2015	NA	3067	2757	310	10.1
CN2612100000000	26	121	Muskegon County, MI	2015	NA	77281	72723	4558	5.9
CN2612300000000	26	123	Newaygo County, MI	2015	NA	23070	21793	1277	5.5
CN2612500000000	26	125	Oakland County, MI	2015	NA	633925	604308	29617	4.7
CN2612700000000	26	127	Oceana County, MI	2015	NA	12486	11475	1011	8.1
CN2612900000000	26	129	Ogemaw County, MI	2015	NA	8406	7737	669	8
CN2613100000000	26	131	Ontonagon County, MI	2015	NA	2294	2076	218	9.5
CN2613300000000	26	133	Osceola County, MI	2015	NA	10158	9488	670	6.6
CN2613500000000	26	135	Oscoda County, MI	2015	NA	2910	2655	255	8.8
CN2613700000000	26	137	Otsego County, MI	2015	NA	11404	10695	709	6.2
CN2613900000000	26	139	Ottawa County, MI	2015	NA	152319	146713	5606	3.7
CN2614100000000	26	141	Presque Isle County, MI	2015	NA	5359	4806	553	10.3
CN2614300000000	26	143	Roscommon County, MI	2015	NA	7808	7094	714	9.1
CN2614500000000	26	145	Saginaw County, MI	2015	NA	88375	83275	5100	5.8
CN2614700000000	26	147	St. Clair County, MI	2015	NA	72934	68010	4924	6.8
CN2614900000000	26	149	St. Joseph County, MI	2015	NA	29029	27704	1325	4.6
CN2615100000000	26	151	Sanilac County, MI	2015	NA	19500	18215	1285	6.6
CN2615300000000	26	153	Schoolcraft County, MI	2015	NA	3459	3080	379	11
CN2615500000000	26	155	Shiawassee County, MI	2015	NA	33068	31175	1893	5.7
CN2615700000000	26	157	Tuscola County, MI	2015	NA	24520	22856	1664	6.8
CN2615900000000	26	159	Van Buren County, MI	2015	NA	35223	32985	2238	6.4
CN2616100000000	26	161	Washtenaw County, MI	2015	NA	188324	181238	7086	3.8
CN2616300000000	26	163	Wayne County, MI	2015	NA	760134	708069	52065	6.8
CN2616500000000	26	165	Wexford County, MI	2015	NA	14572	13576	996	6.8
CN2700100000000	27	001	Aitkin County, MN	2015	NA	6877	6427	450	6.5
CN2700300000000	27	003	Anoka County, MN	2015	NA	189980	183128	6852	3.6
CN2700500000000	27	005	Becker County, MN	2015	NA	18412	17608	804	4.4
CN2700700000000	27	007	Beltrami County, MN	2015	NA	23518	22367	1151	4.9
CN2700900000000	27	009	Benton County, MN	2015	NA	21604	20646	958	4.4
CN2701100000000	27	011	Big Stone County, MN	2015	NA	2684	2565	119	4.4
CN2701300000000	27	013	Blue Earth County, MN	2015	NA	39407	38248	1159	2.9
CN2701500000000	27	015	Brown County, MN	2015	NA	14630	14033	597	4.1
CN2701700000000	27	017	Carlton County, MN	2015	NA	17583	16720	863	4.9
CN2701900000000	27	019	Carver County, MN	2015	NA	55215	53469	1746	3.2
CN2702100000000	27	021	Cass County, MN	2015	NA	14039	13103	936	6.7
CN2702300000000	27	023	Chippewa County, MN	2015	NA	6950	6646	304	4.4
CN2702500000000	27	025	Chisago County, MN	2015	NA	28753	27556	1197	4.2
CN2702700000000	27	027	Clay County, MN	2015	NA	35570	34468	1102	3.1
CN2702900000000	27	029	Clearwater County, MN	2015	NA	4631	4211	420	9.1
CN2703100000000	27	031	Cook County, MN	2015	NA	3156	3018	138	4.4
CN2703300000000	27	033	Cottonwood County, MN	2015	NA	5792	5517	275	4.7
CN2703500000000	27	035	Crow Wing County, MN	2015	NA	31518	29897	1621	5.1
CN2703700000000	27	037	Dakota County, MN	2015	NA	232437	224785	7652	3.3
CN2703900000000	27	039	Dodge County, MN	2015	NA	11461	11035	426	3.7
CN2704100000000	27	041	Douglas County, MN	2015	NA	20151	19464	687	3.4
CN2704300000000	27	043	Faribault County, MN	2015	NA	7508	7180	328	4.4
CN2704500000000	27	045	Fillmore County, MN	2015	NA	11413	10948	465	4.1
CN2704700000000	27	047	Freeborn County, MN	2015	NA	16355	15739	616	3.8
CN2704900000000	27	049	Goodhue County, MN	2015	NA	26897	25954	943	3.5
CN2705100000000	27	051	Grant County, MN	2015	NA	3349	3192	157	4.7
CN2705300000000	27	053	Hennepin County, MN	2015	NA	677303	655117	22186	3.3
CN2705500000000	27	055	Houston County, MN	2015	NA	10492	10093	399	3.8
CN2705700000000	27	057	Hubbard County, MN	2015	NA	9561	8977	584	6.1
CN2705900000000	27	059	Isanti County, MN	2015	NA	20212	19344	868	4.3
CN2706100000000	27	061	Itasca County, MN	2015	NA	22311	20869	1442	6.5
CN2706300000000	27	063	Jackson County, MN	2015	NA	6292	6039	253	4
CN2706500000000	27	065	Kanabec County, MN	2015	NA	8840	8259	581	6.6
CN2706700000000	27	067	Kandiyohi County, MN	2015	NA	24079	23181	898	3.7
CN2706900000000	27	069	Kittson County, MN	2015	NA	2474	2360	114	4.6
CN2707100000000	27	071	Koochiching County, MN	2015	NA	6258	5750	508	8.1
CN2707300000000	27	073	Lac qui Parle County, MN	2015	NA	3766	3612	154	4.1
CN2707500000000	27	075	Lake County, MN	2015	NA	5614	5346	268	4.8
CN2707700000000	27	077	Lake of the Woods County, MN	2015	NA	2423	2316	107	4.4
CN2707900000000	27	079	Le Sueur County, MN	2015	NA	15547	14799	748	4.8
CN2708100000000	27	081	Lincoln County, MN	2015	NA	3394	3275	119	3.5
CN2708300000000	27	083	Lyon County, MN	2015	NA	15296	14805	491	3.2
CN2708500000000	27	085	McLeod County, MN	2015	NA	20216	19423	793	3.9
CN2708700000000	27	087	Mahnomen County, MN	2015	NA	2407	2268	139	5.8
CN2708900000000	27	089	Marshall County, MN	2015	NA	5747	5351	396	6.9
CN2709100000000	27	091	Martin County, MN	2015	NA	10454	10030	424	4.1
CN2709300000000	27	093	Meeker County, MN	2015	NA	13349	12790	559	4.2
CN2709500000000	27	095	Mille Lacs County, MN	2015	NA	12622	11892	730	5.8
CN2709700000000	27	097	Morrison County, MN	2015	NA	17808	16848	960	5.4
CN2709900000000	27	099	Mower County, MN	2015	NA	20377	19724	653	3.2
CN2710100000000	27	101	Murray County, MN	2015	NA	5066	4842	224	4.4
CN2710300000000	27	103	Nicollet County, MN	2015	NA	20321	19786	535	2.6
CN2710500000000	27	105	Nobles County, MN	2015	NA	11534	11165	369	3.2
CN2710700000000	27	107	Norman County, MN	2015	NA	3443	3283	160	4.6
CN2710900000000	27	109	Olmsted County, MN	2015	NA	83958	81513	2445	2.9
CN2711100000000	27	111	Otter Tail County, MN	2015	NA	31139	29833	1306	4.2
CN2711300000000	27	113	Pennington County, MN	2015	NA	9084	8619	465	5.1
CN2711500000000	27	115	Pine County, MN	2015	NA	14793	13972	821	5.5
CN2711700000000	27	117	Pipestone County, MN	2015	NA	4980	4814	166	3.3
CN2711900000000	27	119	Polk County, MN	2015	NA	17176	16453	723	4.2
CN2712100000000	27	121	Pope County, MN	2015	NA	6393	6171	222	3.5
CN2712300000000	27	123	Ramsey County, MN	2015	NA	279777	269936	9841	3.5
CN2712500000000	27	125	Red Lake County, MN	2015	NA	2331	2194	137	5.9
CN2712700000000	27	127	Redwood County, MN	2015	NA	8274	7951	323	3.9
CN2712900000000	27	129	Renville County, MN	2015	NA	8598	8186	412	4.8
CN2713100000000	27	131	Rice County, MN	2015	NA	35448	34196	1252	3.5
CN2713300000000	27	133	Rock County, MN	2015	NA	5913	5788	125	2.1
CN2713500000000	27	135	Roseau County, MN	2015	NA	8608	8267	341	4
CN2713700000000	27	137	St. Louis County, MN	2015	NA	101997	96945	5052	5
CN2713900000000	27	139	Scott County, MN	2015	NA	79212	76741	2471	3.1
CN2714100000000	27	141	Sherburne County, MN	2015	NA	49504	47525	1979	4
CN2714300000000	27	143	Sibley County, MN	2015	NA	8515	8163	352	4.1
CN2714500000000	27	145	Stearns County, MN	2015	NA	88195	85015	3180	3.6
CN2714700000000	27	147	Steele County, MN	2015	NA	21216	20510	706	3.3
CN2714900000000	27	149	Stevens County, MN	2015	NA	5713	5553	160	2.8
CN2715100000000	27	151	Swift County, MN	2015	NA	5175	4864	311	6
CN2715300000000	27	153	Todd County, MN	2015	NA	13017	12448	569	4.4
CN2715500000000	27	155	Traverse County, MN	2015	NA	1837	1761	76	4.1
CN2715700000000	27	157	Wabasha County, MN	2015	NA	12000	11548	452	3.8
CN2715900000000	27	159	Wadena County, MN	2015	NA	6333	5959	374	5.9
CN2716100000000	27	161	Waseca County, MN	2015	NA	9759	9356	403	4.1
CN2716300000000	27	163	Washington County, MN	2015	NA	137250	132922	4328	3.2
CN2716500000000	27	165	Watonwan County, MN	2015	NA	6256	5964	292	4.7
CN2716700000000	27	167	Wilkin County, MN	2015	NA	3692	3570	122	3.3
CN2716900000000	27	169	Winona County, MN	2015	NA	29493	28518	975	3.3
CN2717100000000	27	171	Wright County, MN	2015	NA	72032	69391	2641	3.7
CN2717300000000	27	173	Yellow Medicine County, MN	2015	NA	5579	5375	204	3.7
CN2800100000000	28	001	Adams County, MS	2015	NA	11420	10515	905	7.9
CN2800300000000	28	003	Alcorn County, MS	2015	NA	15734	14853	881	5.6
CN2800500000000	28	005	Amite County, MS	2015	NA	4517	4177	340	7.5
CN2800700000000	28	007	Attala County, MS	2015	NA	6989	6460	529	7.6
CN2800900000000	28	009	Benton County, MS	2015	NA	2986	2749	237	7.9
CN2801100000000	28	011	Bolivar County, MS	2015	NA	13399	12352	1047	7.8
CN2801300000000	28	013	Calhoun County, MS	2015	NA	6143	5766	377	6.1
CN2801500000000	28	015	Carroll County, MS	2015	NA	3463	3181	282	8.1
CN2801700000000	28	017	Chickasaw County, MS	2015	NA	7155	6609	546	7.6
CN2801900000000	28	019	Choctaw County, MS	2015	NA	3714	3483	231	6.2
CN2802100000000	28	021	Claiborne County, MS	2015	NA	3120	2730	390	12.5
CN2802300000000	28	023	Clarke County, MS	2015	NA	6081	5606	475	7.8
CN2802500000000	28	025	Clay County, MS	2015	NA	8023	7259	764	9.5
CN2802700000000	28	027	Coahoma County, MS	2015	NA	9457	8510	947	10
CN2802900000000	28	029	Copiah County, MS	2015	NA	11268	10459	809	7.2
CN2803100000000	28	031	Covington County, MS	2015	NA	7973	7509	464	5.8
CN2803300000000	28	033	DeSoto County, MS	2015	NA	84635	80597	4038	4.8
CN2803500000000	28	035	Forrest County, MS	2015	NA	32866	30812	2054	6.2
CN2803700000000	28	037	Franklin County, MS	2015	NA	2940	2716	224	7.6
CN2803900000000	28	039	George County, MS	2015	NA	8864	8203	661	7.5
CN2804100000000	28	041	Greene County, MS	2015	NA	4333	4008	325	7.5
CN2804300000000	28	043	Grenada County, MS	2015	NA	9487	8927	560	5.9
CN2804500000000	28	045	Hancock County, MS	2015	NA	18690	17486	1204	6.4
CN2804700000000	28	047	Harrison County, MS	2015	NA	85716	80657	5059	5.9
CN2804900000000	28	049	Hinds County, MS	2015	NA	109303	102755	6548	6
CN2805100000000	28	051	Holmes County, MS	2015	NA	6119	5387	732	12
CN2805300000000	28	053	Humphreys County, MS	2015	NA	2469	2158	311	12.6
CN2805500000000	28	055	Issaquena County, MS	2015	NA	419	348	71	16.9
CN2805700000000	28	057	Itawamba County, MS	2015	NA	10218	9637	581	5.7
CN2805900000000	28	059	Jackson County, MS	2015	NA	59015	54887	4128	7
CN2806100000000	28	061	Jasper County, MS	2015	NA	6369	5873	496	7.8
CN2806300000000	28	063	Jefferson County, MS	2015	NA	2278	1940	338	14.8
CN2806500000000	28	065	Jefferson Davis County, MS	2015	NA	4131	3773	358	8.7
CN2806700000000	28	067	Jones County, MS	2015	NA	26572	24988	1584	6
CN2806900000000	28	069	Kemper County, MS	2015	NA	3579	3210	369	10.3
CN2807100000000	28	071	Lafayette County, MS	2015	NA	24466	23137	1329	5.4
CN2807300000000	28	073	Lamar County, MS	2015	NA	28925	27541	1384	4.8
CN2807500000000	28	075	Lauderdale County, MS	2015	NA	31683	29618	2065	6.5
CN2807700000000	28	077	Lawrence County, MS	2015	NA	4749	4408	341	7.2
CN2807900000000	28	079	Leake County, MS	2015	NA	7898	7414	484	6.1
CN2808100000000	28	081	Lee County, MS	2015	NA	39891	37689	2202	5.5
CN2808300000000	28	083	Leflore County, MS	2015	NA	10496	9373	1123	10.7
CN2808500000000	28	085	Lincoln County, MS	2015	NA	14237	13378	859	6
CN2808700000000	28	087	Lowndes County, MS	2015	NA	25140	23384	1756	7
CN2808900000000	28	089	Madison County, MS	2015	NA	51688	49338	2350	4.5
CN2809100000000	28	091	Marion County, MS	2015	NA	10016	9289	727	7.3
CN2809300000000	28	093	Marshall County, MS	2015	NA	14454	13418	1036	7.2
CN2809500000000	28	095	Monroe County, MS	2015	NA	15494	14358	1136	7.3
CN2809700000000	28	097	Montgomery County, MS	2015	NA	4202	3879	323	7.7
CN2809900000000	28	099	Neshoba County, MS	2015	NA	10631	9983	648	6.1
CN2810100000000	28	101	Newton County, MS	2015	NA	8726	8194	532	6.1
CN2810300000000	28	103	Noxubee County, MS	2015	NA	3956	3571	385	9.7
CN2810500000000	28	105	Oktibbeha County, MS	2015	NA	22513	21143	1370	6.1
CN2810700000000	28	107	Panola County, MS	2015	NA	13448	12285	1163	8.6
CN2810900000000	28	109	Pearl River County, MS	2015	NA	22886	21484	1402	6.1
CN2811100000000	28	111	Perry County, MS	2015	NA	4318	3976	342	7.9
CN2811300000000	28	113	Pike County, MS	2015	NA	14707	13638	1069	7.3
CN2811500000000	28	115	Pontotoc County, MS	2015	NA	13887	13117	770	5.5
CN2811700000000	28	117	Prentiss County, MS	2015	NA	11002	10340	662	6
CN2811900000000	28	119	Quitman County, MS	2015	NA	2689	2401	288	10.7
CN2812100000000	28	121	Rankin County, MS	2015	NA	73073	70061	3012	4.1
CN2812300000000	28	123	Scott County, MS	2015	NA	12994	12373	621	4.8
CN2812500000000	28	125	Sharkey County, MS	2015	NA	1728	1563	165	9.5
CN2812700000000	28	127	Simpson County, MS	2015	NA	10907	10269	638	5.8
CN2812900000000	28	129	Smith County, MS	2015	NA	6759	6399	360	5.3
CN2813100000000	28	131	Stone County, MS	2015	NA	6413	5941	472	7.4
CN2813300000000	28	133	Sunflower County, MS	2015	NA	8479	7594	885	10.4
CN2813500000000	28	135	Tallahatchie County, MS	2015	NA	5813	5377	436	7.5
CN2813700000000	28	137	Tate County, MS	2015	NA	12004	11161	843	7
CN2813900000000	28	139	Tippah County, MS	2015	NA	9447	8849	598	6.3
CN2814100000000	28	141	Tishomingo County, MS	2015	NA	8018	7511	507	6.3
CN2814300000000	28	143	Tunica County, MS	2015	NA	4659	4229	430	9.2
CN2814500000000	28	145	Union County, MS	2015	NA	13223	12553	670	5.1
CN2814700000000	28	147	Walthall County, MS	2015	NA	5153	4739	414	8
CN2814900000000	28	149	Warren County, MS	2015	NA	20899	19517	1382	6.6
CN2815100000000	28	151	Washington County, MS	2015	NA	18053	16208	1845	10.2
CN2815300000000	28	153	Wayne County, MS	2015	NA	7626	7026	600	7.9
CN2815500000000	28	155	Webster County, MS	2015	NA	3942	3661	281	7.1
CN2815700000000	28	157	Wilkinson County, MS	2015	NA	2884	2580	304	10.5
CN2815900000000	28	159	Winston County, MS	2015	NA	7088	6507	581	8.2
CN2816100000000	28	161	Yalobusha County, MS	2015	NA	4931	4580	351	7.1
CN2816300000000	28	163	Yazoo County, MS	2015	NA	9212	8463	749	8.1
CN2900100000000	29	001	Adair County, MO	2015	NA	10439	9849	590	5.7
CN2900300000000	29	003	Andrew County, MO	2015	NA	9918	9504	414	4.2
CN2900500000000	29	005	Atchison County, MO	2015	NA	2831	2704	127	4.5
CN2900700000000	29	007	Audrain County, MO	2015	NA	11307	10783	524	4.6
CN2900900000000	29	009	Barry County, MO	2015	NA	14907	14159	748	5
CN2901100000000	29	011	Barton County, MO	2015	NA	5325	5036	289	5.4
CN2901300000000	29	013	Bates County, MO	2015	NA	8148	7651	497	6.1
CN2901500000000	29	015	Benton County, MO	2015	NA	7189	6719	470	6.5
CN2901700000000	29	017	Bollinger County, MO	2015	NA	5553	5241	312	5.6
CN2901900000000	29	019	Boone County, MO	2015	NA	98827	95343	3484	3.5
CN2902100000000	29	021	Buchanan County, MO	2015	NA	46476	44336	2140	4.6
CN2902300000000	29	023	Butler County, MO	2015	NA	18970	17791	1179	6.2
CN2902500000000	29	025	Caldwell County, MO	2015	NA	4394	4193	201	4.6
CN2902700000000	29	027	Callaway County, MO	2015	NA	21666	20642	1024	4.7
CN2902900000000	29	029	Camden County, MO	2015	NA	18746	17515	1231	6.6
CN2903100000000	29	031	Cape Girardeau County, MO	2015	NA	40850	39084	1766	4.3
CN2903300000000	29	033	Carroll County, MO	2015	NA	4816	4524	292	6.1
CN2903500000000	29	035	Carter County, MO	2015	NA	2508	2322	186	7.4
CN2903700000000	29	037	Cass County, MO	2015	NA	53865	51268	2597	4.8
CN2903900000000	29	039	Cedar County, MO	2015	NA	5890	5578	312	5.3
CN2904100000000	29	041	Chariton County, MO	2015	NA	3851	3670	181	4.7
CN2904300000000	29	043	Christian County, MO	2015	NA	43037	41213	1824	4.2
CN2904500000000	29	045	Clark County, MO	2015	NA	3433	3187	246	7.2
CN2904700000000	29	047	Clay County, MO	2015	NA	132146	126125	6021	4.6
CN2904900000000	29	049	Clinton County, MO	2015	NA	10987	10452	535	4.9
CN2905100000000	29	051	Cole County, MO	2015	NA	39365	37786	1579	4
CN2905300000000	29	053	Cooper County, MO	2015	NA	7611	7170	441	5.8
CN2905500000000	29	055	Crawford County, MO	2015	NA	10905	10246	659	6
CN2905700000000	29	057	Dade County, MO	2015	NA	3568	3387	181	5.1
CN2905900000000	29	059	Dallas County, MO	2015	NA	6976	6540	436	6.3
CN2906100000000	29	061	Daviess County, MO	2015	NA	4084	3897	187	4.6
CN2906300000000	29	063	DeKalb County, MO	2015	NA	5048	4812	236	4.7
CN2906500000000	29	065	Dent County, MO	2015	NA	6297	5929	368	5.8
CN2906700000000	29	067	Douglas County, MO	2015	NA	5037	4694	343	6.8
CN2906900000000	29	069	Dunklin County, MO	2015	NA	13119	12061	1058	8.1
CN2907100000000	29	071	Franklin County, MO	2015	NA	52507	49836	2671	5.1
CN2907300000000	29	073	Gasconade County, MO	2015	NA	7679	7352	327	4.3
CN2907500000000	29	075	Gentry County, MO	2015	NA	3613	3461	152	4.2
CN2907700000000	29	077	Greene County, MO	2015	NA	149242	143020	6222	4.2
CN2907900000000	29	079	Grundy County, MO	2015	NA	4909	4705	204	4.2
CN2908100000000	29	081	Harrison County, MO	2015	NA	3984	3782	202	5.1
CN2908300000000	29	083	Henry County, MO	2015	NA	10105	9554	551	5.5
CN2908500000000	29	085	Hickory County, MO	2015	NA	3721	3473	248	6.7
CN2908700000000	29	087	Holt County, MO	2015	NA	2708	2610	98	3.6
CN2908900000000	29	089	Howard County, MO	2015	NA	5043	4796	247	4.9
CN2909100000000	29	091	Howell County, MO	2015	NA	16343	15289	1054	6.4
CN2909300000000	29	093	Iron County, MO	2015	NA	3850	3544	306	7.9
CN2909500000000	29	095	Jackson County, MO	2015	NA	362912	341432	21480	5.9
CN2909700000000	29	097	Jasper County, MO	2015	NA	58043	55550	2493	4.3
CN2909900000000	29	099	Jefferson County, MO	2015	NA	117612	111882	5730	4.9
CN2910100000000	29	101	Johnson County, MO	2015	NA	23102	21855	1247	5.4
CN2910300000000	29	103	Knox County, MO	2015	NA	1963	1886	77	3.9
CN2910500000000	29	105	Laclede County, MO	2015	NA	15929	14915	1014	6.4
CN2910700000000	29	107	Lafayette County, MO	2015	NA	17174	16339	835	4.9
CN2910900000000	29	109	Lawrence County, MO	2015	NA	17876	16997	879	4.9
CN2911100000000	29	111	Lewis County, MO	2015	NA	5210	4953	257	4.9
CN2911300000000	29	113	Lincoln County, MO	2015	NA	26945	25550	1395	5.2
CN2911500000000	29	115	Linn County, MO	2015	NA	5241	4872	369	7
CN2911700000000	29	117	Livingston County, MO	2015	NA	7302	6990	312	4.3
CN2911900000000	29	119	McDonald County, MO	2015	NA	10407	9912	495	4.8
CN2912100000000	29	121	Macon County, MO	2015	NA	7468	7069	399	5.3
CN2912300000000	29	123	Madison County, MO	2015	NA	5516	5191	325	5.9
CN2912500000000	29	125	Maries County, MO	2015	NA	3935	3726	209	5.3
CN2912700000000	29	127	Marion County, MO	2015	NA	14745	14087	658	4.5
CN2912900000000	29	129	Mercer County, MO	2015	NA	1887	1803	84	4.5
CN2913100000000	29	131	Miller County, MO	2015	NA	11648	10945	703	6
CN2913300000000	29	133	Mississippi County, MO	2015	NA	6281	5916	365	5.8
CN2913500000000	29	135	Moniteau County, MO	2015	NA	7397	7033	364	4.9
CN2913700000000	29	137	Monroe County, MO	2015	NA	4209	3989	220	5.2
CN2913900000000	29	139	Montgomery County, MO	2015	NA	5705	5421	284	5
CN2914100000000	29	141	Morgan County, MO	2015	NA	8073	7528	545	6.8
CN2914300000000	29	143	New Madrid County, MO	2015	NA	8578	8043	535	6.2
CN2914500000000	29	145	Newton County, MO	2015	NA	28429	27126	1303	4.6
CN2914700000000	29	147	Nodaway County, MO	2015	NA	11010	10467	543	4.9
CN2914900000000	29	149	Oregon County, MO	2015	NA	4161	3897	264	6.3
CN2915100000000	29	151	Osage County, MO	2015	NA	7156	6887	269	3.8
CN2915300000000	29	153	Ozark County, MO	2015	NA	3646	3355	291	8
CN2915500000000	29	155	Pemiscot County, MO	2015	NA	7040	6401	639	9.1
CN2915700000000	29	157	Perry County, MO	2015	NA	10206	9775	431	4.2
CN2915900000000	29	159	Pettis County, MO	2015	NA	20918	19814	1104	5.3
CN2916100000000	29	161	Phelps County, MO	2015	NA	19560	18517	1043	5.3
CN2916300000000	29	163	Pike County, MO	2015	NA	8106	7734	372	4.6
CN2916500000000	29	165	Platte County, MO	2015	NA	55417	53082	2335	4.2
CN2916700000000	29	167	Polk County, MO	2015	NA	14253	13499	754	5.3
CN2916900000000	29	169	Pulaski County, MO	2015	NA	14885	14013	872	5.9
CN2917100000000	29	171	Putnam County, MO	2015	NA	2499	2399	100	4
CN2917300000000	29	173	Ralls County, MO	2015	NA	5669	5428	241	4.3
CN2917500000000	29	175	Randolph County, MO	2015	NA	10502	9870	632	6
CN2917700000000	29	177	Ray County, MO	2015	NA	11160	10547	613	5.5
CN2917900000000	29	179	Reynolds County, MO	2015	NA	2712	2522	190	7
CN2918100000000	29	181	Ripley County, MO	2015	NA	5323	4899	424	8
CN2918300000000	29	183	St. Charles County, MO	2015	NA	217502	209114	8388	3.9
CN2918500000000	29	185	St. Clair County, MO	2015	NA	3976	3699	277	7
CN2918600000000	29	186	Ste. Genevieve County, MO	2015	NA	9059	8573	486	5.4
CN2918700000000	29	187	St. Francois County, MO	2015	NA	26398	24787	1611	6.1
CN2918900000000	29	189	St. Louis County, MO	2015	NA	533457	508678	24779	4.6
CN2919500000000	29	195	Saline County, MO	2015	NA	11049	10515	534	4.8
CN2919700000000	29	197	Schuyler County, MO	2015	NA	1907	1796	111	5.8
CN2919900000000	29	199	Scotland County, MO	2015	NA	2451	2339	112	4.6
CN2920100000000	29	201	Scott County, MO	2015	NA	20043	18991	1052	5.2
CN2920300000000	29	203	Shannon County, MO	2015	NA	3337	3064	273	8.2
CN2920500000000	29	205	Shelby County, MO	2015	NA	3076	2930	146	4.7
CN2920700000000	29	207	Stoddard County, MO	2015	NA	13229	12351	878	6.6
CN2920900000000	29	209	Stone County, MO	2015	NA	13367	12308	1059	7.9
CN2921100000000	29	211	Sullivan County, MO	2015	NA	2777	2612	165	5.9
CN2921300000000	29	213	Taney County, MO	2015	NA	26161	24043	2118	8.1
CN2921500000000	29	215	Texas County, MO	2015	NA	9403	8776	627	6.7
CN2921700000000	29	217	Vernon County, MO	2015	NA	9816	9316	500	5.1
CN2921900000000	29	219	Warren County, MO	2015	NA	17338	16506	832	4.8
CN2922100000000	29	221	Washington County, MO	2015	NA	10520	9812	708	6.7
CN2922300000000	29	223	Wayne County, MO	2015	NA	5716	5379	337	5.9
CN2922500000000	29	225	Webster County, MO	2015	NA	16648	15798	850	5.1
CN2922700000000	29	227	Worth County, MO	2015	NA	1217	1177	40	3.3
CN2922900000000	29	229	Wright County, MO	2015	NA	7641	7161	480	6.3
CN2951000000000	29	510	St. Louis city, MO	2015	NA	159676	149964	9712	6.1
CN3000100000000	30	001	Beaverhead County, MT	2015	NA	4980	4809	171	3.4
CN3000300000000	30	003	Big Horn County, MT	2015	NA	5551	5179	372	6.7
CN3000500000000	30	005	Blaine County, MT	2015	NA	2396	2276	120	5
CN3000700000000	30	007	Broadwater County, MT	2015	NA	2484	2358	126	5.1
CN3000900000000	30	009	Carbon County, MT	2015	NA	5425	5225	200	3.7
CN3001100000000	30	011	Carter County, MT	2015	NA	685	663	22	3.2
CN3001300000000	30	013	Cascade County, MT	2015	NA	38302	36752	1550	4
CN3001500000000	30	015	Chouteau County, MT	2015	NA	2524	2441	83	3.3
CN3001700000000	30	017	Custer County, MT	2015	NA	6389	6178	211	3.3
CN3001900000000	30	019	Daniels County, MT	2015	NA	944	920	24	2.5
CN3002100000000	30	021	Dawson County, MT	2015	NA	4821	4669	152	3.2
CN3002300000000	30	023	Deer Lodge County, MT	2015	NA	5236	5027	209	4
CN3002500000000	30	025	Fallon County, MT	2015	NA	1970	1924	46	2.3
CN3002700000000	30	027	Fergus County, MT	2015	NA	5701	5465	236	4.1
CN3002900000000	30	029	Flathead County, MT	2015	NA	44823	42257	2566	5.7
CN3003100000000	30	031	Gallatin County, MT	2015	NA	59451	57662	1789	3
CN3003300000000	30	033	Garfield County, MT	2015	NA	762	741	21	2.8
CN3003500000000	30	035	Glacier County, MT	2015	NA	5853	5327	526	9
CN3003700000000	30	037	Golden Valley County, MT	2015	NA	380	364	16	4.2
CN3003900000000	30	039	Granite County, MT	2015	NA	1560	1463	97	6.2
CN3004100000000	30	041	Hill County, MT	2015	NA	7795	7469	326	4.2
CN3004300000000	30	043	Jefferson County, MT	2015	NA	5583	5355	228	4.1
CN3004500000000	30	045	Judith Basin County, MT	2015	NA	994	960	34	3.4
CN3004700000000	30	047	Lake County, MT	2015	NA	12697	12062	635	5
CN3004900000000	30	049	Lewis and Clark County, MT	2015	NA	35007	33827	1180	3.4
CN3005100000000	30	051	Liberty County, MT	2015	NA	985	959	26	2.6
CN3005300000000	30	053	Lincoln County, MT	2015	NA	7809	7020	789	10.1
CN3005500000000	30	055	McCone County, MT	2015	NA	1062	1039	23	2.2
CN3005700000000	30	057	Madison County, MT	2015	NA	4286	4131	155	3.6
CN3005900000000	30	059	Meagher County, MT	2015	NA	936	902	34	3.6
CN3006100000000	30	061	Mineral County, MT	2015	NA	1728	1583	145	8.4
CN3006300000000	30	063	Missoula County, MT	2015	NA	60517	58139	2378	3.9
CN3006500000000	30	065	Musselshell County, MT	2015	NA	2409	2305	104	4.3
CN3006700000000	30	067	Park County, MT	2015	NA	8300	7901	399	4.8
CN3006900000000	30	069	Petroleum County, MT	2015	NA	284	269	15	5.3
CN3007100000000	30	071	Phillips County, MT	2015	NA	1977	1877	100	5.1
CN3007300000000	30	073	Pondera County, MT	2015	NA	2866	2738	128	4.5
CN3007500000000	30	075	Powder River County, MT	2015	NA	1056	1029	27	2.6
CN3007700000000	30	077	Powell County, MT	2015	NA	2960	2828	132	4.5
CN3007900000000	30	079	Prairie County, MT	2015	NA	529	507	22	4.2
CN3008100000000	30	081	Ravalli County, MT	2015	NA	19220	18217	1003	5.2
CN3008300000000	30	083	Richland County, MT	2015	NA	6879	6657	222	3.2
CN3008500000000	30	085	Roosevelt County, MT	2015	NA	4692	4446	246	5.2
CN3008700000000	30	087	Rosebud County, MT	2015	NA	4176	3952	224	5.4
CN3008900000000	30	089	Sanders County, MT	2015	NA	4703	4312	391	8.3
CN3009100000000	30	091	Sheridan County, MT	2015	NA	2075	2023	52	2.5
CN3009300000000	30	093	Silver Bow County, MT	2015	NA	17131	16395	736	4.3
CN3009500000000	30	095	Stillwater County, MT	2015	NA	4930	4745	185	3.8
CN3009700000000	30	097	Sweet Grass County, MT	2015	NA	1789	1739	50	2.8
CN3009900000000	30	099	Teton County, MT	2015	NA	2890	2779	111	3.8
CN3010100000000	30	101	Toole County, MT	2015	NA	2298	2220	78	3.4
CN3010300000000	30	103	Treasure County, MT	2015	NA	358	340	18	5
CN3010500000000	30	105	Valley County, MT	2015	NA	4391	4253	138	3.1
CN3010700000000	30	107	Wheatland County, MT	2015	NA	788	745	43	5.5
CN3010900000000	30	109	Wibaux County, MT	2015	NA	546	528	18	3.3
CN3011100000000	30	111	Yellowstone County, MT	2015	NA	80777	78096	2681	3.3
CN3100100000000	31	001	Adams County, NE	2015	NA	16601	16082	519	3.1
CN3100300000000	31	003	Antelope County, NE	2015	NA	3593	3501	92	2.6
CN3100500000000	31	005	Arthur County, NE	2015	NA	224	214	10	4.5
CN3100700000000	31	007	Banner County, NE	2015	NA	440	425	15	3.4
CN3100900000000	31	009	Blaine County, NE	2015	NA	268	256	12	4.5
CN3101100000000	31	011	Boone County, NE	2015	NA	3010	2936	74	2.5
CN3101300000000	31	013	Box Butte County, NE	2015	NA	5657	5487	170	3
CN3101500000000	31	015	Boyd County, NE	2015	NA	1088	1059	29	2.7
CN3101700000000	31	017	Brown County, NE	2015	NA	1393	1342	51	3.7
CN3101900000000	31	019	Buffalo County, NE	2015	NA	27119	26457	662	2.4
CN3102100000000	31	021	Burt County, NE	2015	NA	3608	3477	131	3.6
CN3102300000000	31	023	Butler County, NE	2015	NA	4735	4603	132	2.8
CN3102500000000	31	025	Cass County, NE	2015	NA	13062	12628	434	3.3
CN3102700000000	31	027	Cedar County, NE	2015	NA	4639	4529	110	2.4
CN3102900000000	31	029	Chase County, NE	2015	NA	2337	2292	45	1.9
CN3103100000000	31	031	Cherry County, NE	2015	NA	3447	3368	79	2.3
CN3103300000000	31	033	Cheyenne County, NE	2015	NA	5744	5619	125	2.2
CN3103500000000	31	035	Clay County, NE	2015	NA	3372	3274	98	2.9
CN3103700000000	31	037	Colfax County, NE	2015	NA	5547	5402	145	2.6
CN3103900000000	31	039	Cuming County, NE	2015	NA	4836	4708	128	2.6
CN3104100000000	31	041	Custer County, NE	2015	NA	6280	6140	140	2.2
CN3104300000000	31	043	Dakota County, NE	2015	NA	10987	10599	388	3.5
CN3104500000000	31	045	Dawes County, NE	2015	NA	5247	5111	136	2.6
CN3104700000000	31	047	Dawson County, NE	2015	NA	13055	12641	414	3.2
CN3104900000000	31	049	Deuel County, NE	2015	NA	1074	1047	27	2.5
CN3105100000000	31	051	Dixon County, NE	2015	NA	3081	2979	102	3.3
CN3105300000000	31	053	Dodge County, NE	2015	NA	19083	18461	622	3.3
CN3105500000000	31	055	Douglas County, NE	2015	NA	286569	277086	9483	3.3
CN3105700000000	31	057	Dundy County, NE	2015	NA	1196	1171	25	2.1
CN3105900000000	31	059	Fillmore County, NE	2015	NA	3207	3112	95	3
CN3106100000000	31	061	Franklin County, NE	2015	NA	1510	1474	36	2.4
CN3106300000000	31	063	Frontier County, NE	2015	NA	1531	1494	37	2.4
CN3106500000000	31	065	Furnas County, NE	2015	NA	2727	2655	72	2.6
CN3106700000000	31	067	Gage County, NE	2015	NA	11039	10639	400	3.6
CN3106900000000	31	069	Garden County, NE	2015	NA	1196	1167	29	2.4
CN3107100000000	31	071	Garfield County, NE	2015	NA	1193	1164	29	2.4
CN3107300000000	31	073	Gosper County, NE	2015	NA	1073	1047	26	2.4
CN3107500000000	31	075	Grant County, NE	2015	NA	435	425	10	2.3
CN3107700000000	31	077	Greeley County, NE	2015	NA	1248	1209	39	3.1
CN3107900000000	31	079	Hall County, NE	2015	NA	31573	30329	1244	3.9
CN3108100000000	31	081	Hamilton County, NE	2015	NA	4669	4535	134	2.9
CN3108300000000	31	083	Harlan County, NE	2015	NA	1785	1747	38	2.1
CN3108500000000	31	085	Hayes County, NE	2015	NA	615	601	14	2.3
CN3108700000000	31	087	Hitchcock County, NE	2015	NA	1320	1277	43	3.3
CN3108900000000	31	089	Holt County, NE	2015	NA	5864	5724	140	2.4
CN3109100000000	31	091	Hooker County, NE	2015	NA	405	388	17	4.2
CN3109300000000	31	093	Howard County, NE	2015	NA	3307	3186	121	3.7
CN3109500000000	31	095	Jefferson County, NE	2015	NA	4271	4155	116	2.7
CN3109700000000	31	097	Johnson County, NE	2015	NA	2123	2053	70	3.3
CN3109900000000	31	099	Kearney County, NE	2015	NA	3789	3705	84	2.2
CN3110100000000	31	101	Keith County, NE	2015	NA	4681	4556	125	2.7
CN3110300000000	31	103	Keya Paha County, NE	2015	NA	660	646	14	2.1
CN3110500000000	31	105	Kimball County, NE	2015	NA	2050	1977	73	3.6
CN3110700000000	31	107	Knox County, NE	2015	NA	4715	4564	151	3.2
CN3110900000000	31	109	Lancaster County, NE	2015	NA	167397	162978	4419	2.6
CN3111100000000	31	111	Lincoln County, NE	2015	NA	18525	17988	537	2.9
CN3111300000000	31	113	Logan County, NE	2015	NA	492	478	14	2.8
CN3111500000000	31	115	Loup County, NE	2015	NA	377	364	13	3.4
CN3111700000000	31	117	McPherson County, NE	2015	NA	460	451	9	2
CN3111900000000	31	119	Madison County, NE	2015	NA	19195	18669	526	2.7
CN3112100000000	31	121	Merrick County, NE	2015	NA	4024	3874	150	3.7
CN3112300000000	31	123	Morrill County, NE	2015	NA	2649	2573	76	2.9
CN3112500000000	31	125	Nance County, NE	2015	NA	2064	2013	51	2.5
CN3112700000000	31	127	Nemaha County, NE	2015	NA	3687	3552	135	3.7
CN3112900000000	31	129	Nuckolls County, NE	2015	NA	2380	2319	61	2.6
CN3113100000000	31	131	Otoe County, NE	2015	NA	8194	7923	271	3.3
CN3113300000000	31	133	Pawnee County, NE	2015	NA	1671	1628	43	2.6
CN3113500000000	31	135	Perkins County, NE	2015	NA	1834	1800	34	1.9
CN3113700000000	31	137	Phelps County, NE	2015	NA	4989	4870	119	2.4
CN3113900000000	31	139	Pierce County, NE	2015	NA	4164	4058	106	2.5
CN3114100000000	31	141	Platte County, NE	2015	NA	17130	16620	510	3
CN3114300000000	31	143	Polk County, NE	2015	NA	2907	2833	74	2.5
CN3114500000000	31	145	Red Willow County, NE	2015	NA	6098	5937	161	2.6
CN3114700000000	31	147	Richardson County, NE	2015	NA	4297	4159	138	3.2
CN3114900000000	31	149	Rock County, NE	2015	NA	858	835	23	2.7
CN3115100000000	31	151	Saline County, NE	2015	NA	7274	7061	213	2.9
CN3115300000000	31	153	Sarpy County, NE	2015	NA	90585	88039	2546	2.8
CN3115500000000	31	155	Saunders County, NE	2015	NA	10920	10584	336	3.1
CN3115700000000	31	157	Scotts Bluff County, NE	2015	NA	18649	18018	631	3.4
CN3115900000000	31	159	Seward County, NE	2015	NA	8690	8438	252	2.9
CN3116100000000	31	161	Sheridan County, NE	2015	NA	2729	2655	74	2.7
CN3116300000000	31	163	Sherman County, NE	2015	NA	1708	1658	50	2.9
CN3116500000000	31	165	Sioux County, NE	2015	NA	787	767	20	2.5
CN3116700000000	31	167	Stanton County, NE	2015	NA	3502	3413	89	2.5
CN3116900000000	31	169	Thayer County, NE	2015	NA	2965	2895	70	2.4
CN3117100000000	31	171	Thomas County, NE	2015	NA	435	422	13	3
CN3117300000000	31	173	Thurston County, NE	2015	NA	2969	2811	158	5.3
CN3117500000000	31	175	Valley County, NE	2015	NA	2062	2004	58	2.8
CN3117700000000	31	177	Washington County, NE	2015	NA	10929	10601	328	3
CN3117900000000	31	179	Wayne County, NE	2015	NA	5536	5395	141	2.5
CN3118100000000	31	181	Webster County, NE	2015	NA	1724	1663	61	3.5
CN3118300000000	31	183	Wheeler County, NE	2015	NA	562	549	13	2.3
CN3118500000000	31	185	York County, NE	2015	NA	7334	7122	212	2.9
CN3200100000000	32	001	Churchill County, NV	2015	NA	10355	9631	724	7
CN3200300000000	32	003	Clark County, NV	2015	NA	1035380	964853	70527	6.8
CN3200500000000	32	005	Douglas County, NV	2015	NA	22417	20916	1501	6.7
CN3200700000000	32	007	Elko County, NV	2015	NA	26692	25323	1369	5.1
CN3200900000000	32	009	Esmeralda County, NV	2015	NA	524	501	23	4.4
CN3201100000000	32	011	Eureka County, NV	2015	NA	995	937	58	5.8
CN3201300000000	32	013	Humboldt County, NV	2015	NA	8251	7763	488	5.9
CN3201500000000	32	015	Lander County, NV	2015	NA	3218	3002	216	6.7
CN3201700000000	32	017	Lincoln County, NV	2015	NA	1935	1818	117	6
CN3201900000000	32	019	Lyon County, NV	2015	NA	21444	19424	2020	9.4
CN3202100000000	32	021	Mineral County, NV	2015	NA	1625	1461	164	10.1
CN3202300000000	32	023	Nye County, NV	2015	NA	15920	14528	1392	8.7
CN3202700000000	32	027	Pershing County, NV	2015	NA	2448	2280	168	6.9
CN3202900000000	32	029	Storey County, NV	2015	NA	1867	1729	138	7.4
CN3203100000000	32	031	Washoe County, NV	2015	NA	225161	211167	13994	6.2
CN3203300000000	32	033	White Pine County, NV	2015	NA	4722	4468	254	5.4
CN3251000000000	32	510	Carson City, NV	2015	NA	24793	23013	1780	7.2
CN3300100000000	33	001	Belknap County, NH	2015	NA	31622	30571	1051	3.3
CN3300300000000	33	003	Carroll County, NH	2015	NA	23812	22988	824	3.5
CN3300500000000	33	005	Cheshire County, NH	2015	NA	41575	40263	1312	3.2
CN3300700000000	33	007	Coos County, NH	2015	NA	14827	14183	644	4.3
CN3300900000000	33	009	Grafton County, NH	2015	NA	48687	47355	1332	2.7
CN3301100000000	33	011	Hillsborough County, NH	2015	NA	229924	221738	8186	3.6
CN3301300000000	33	013	Merrimack County, NH	2015	NA	81366	78869	2497	3.1
CN3301500000000	33	015	Rockingham County, NH	2015	NA	178892	172485	6407	3.6
CN3301700000000	33	017	Strafford County, NH	2015	NA	71300	69083	2217	3.1
CN3301900000000	33	019	Sullivan County, NH	2015	NA	23697	23048	649	2.7
CN3400100000000	34	001	Atlantic County, NJ	2015	NA	126187	114085	12102	9.6
CN3400300000000	34	003	Bergen County, NJ	2015	NA	479417	456885	22532	4.7
CN3400500000000	34	005	Burlington County, NJ	2015	NA	229689	217394	12295	5.4
CN3400700000000	34	007	Camden County, NJ	2015	NA	252172	235856	16316	6.5
CN3400900000000	34	009	Cape May County, NJ	2015	NA	47967	42625	5342	11.1
CN3401100000000	34	011	Cumberland County, NJ	2015	NA	67351	61401	5950	8.8
CN3401300000000	34	013	Essex County, NJ	2015	NA	371332	345649	25683	6.9
CN3401500000000	34	015	Gloucester County, NJ	2015	NA	148033	139055	8978	6.1
CN3401700000000	34	017	Hudson County, NJ	2015	NA	358908	339603	19305	5.4
CN3401900000000	34	019	Hunterdon County, NJ	2015	NA	64880	62124	2756	4.2
CN3402100000000	34	021	Mercer County, NJ	2015	NA	197409	187578	9831	5
CN3402300000000	34	023	Middlesex County, NJ	2015	NA	434581	412158	22423	5.2
CN3402500000000	34	025	Monmouth County, NJ	2015	NA	325388	308514	16874	5.2
CN3402700000000	34	027	Morris County, NJ	2015	NA	259434	248081	11353	4.4
CN3402900000000	34	029	Ocean County, NJ	2015	NA	264781	248380	16401	6.2
CN3403100000000	34	031	Passaic County, NJ	2015	NA	246505	229054	17451	7.1
CN3403300000000	34	033	Salem County, NJ	2015	NA	30767	28505	2262	7.4
CN3403500000000	34	035	Somerset County, NJ	2015	NA	172584	164707	7877	4.6
CN3403700000000	34	037	Sussex County, NJ	2015	NA	75876	71735	4141	5.5
CN3403900000000	34	039	Union County, NJ	2015	NA	277434	260672	16762	6
CN3404100000000	34	041	Warren County, NJ	2015	NA	56614	53579	3035	5.4
CN3500100000000	35	001	Bernalillo County, NM	2015	NA	323333	304413	18920	5.9
CN3500300000000	35	003	Catron County, NM	2015	NA	1195	1096	99	8.3
CN3500500000000	35	005	Chaves County, NM	2015	NA	27803	26061	1742	6.3
CN3500600000000	35	006	Cibola County, NM	2015	NA	9297	8558	739	7.9
CN3500700000000	35	007	Colfax County, NM	2015	NA	6057	5696	361	6
CN3500900000000	35	009	Curry County, NM	2015	NA	21972	20906	1066	4.9
CN3501100000000	35	011	De Baca County, NM	2015	NA	853	810	43	5
CN3501300000000	35	013	Dona Ana County, NM	2015	NA	94623	87745	6878	7.3
CN3501500000000	35	015	Eddy County, NM	2015	NA	29911	28448	1463	4.9
CN3501700000000	35	017	Grant County, NM	2015	NA	12510	11706	804	6.4
CN3501900000000	35	019	Guadalupe County, NM	2015	NA	1639	1524	115	7
CN3502100000000	35	021	Harding County, NM	2015	NA	286	262	24	8.4
CN3502300000000	35	023	Hidalgo County, NM	2015	NA	2143	2011	132	6.2
CN3502500000000	35	025	Lea County, NM	2015	NA	30008	28160	1848	6.2
CN3502700000000	35	027	Lincoln County, NM	2015	NA	8721	8221	500	5.7
CN3502800000000	35	028	Los Alamos County, NM	2015	NA	8531	8189	342	4
CN3502900000000	35	029	Luna County, NM	2015	NA	11069	9163	1906	17.2
CN3503100000000	35	031	McKinley County, NM	2015	NA	24373	22005	2368	9.7
CN3503300000000	35	033	Mora County, NM	2015	NA	2276	2057	219	9.6
CN3503500000000	35	035	Otero County, NM	2015	NA	25083	23541	1542	6.1
CN3503700000000	35	037	Quay County, NM	2015	NA	3281	3049	232	7.1
CN3503900000000	35	039	Rio Arriba County, NM	2015	NA	16645	15318	1327	8
CN3504100000000	35	041	Roosevelt County, NM	2015	NA	8069	7635	434	5.4
CN3504300000000	35	043	Sandoval County, NM	2015	NA	62271	58163	4108	6.6
CN3504500000000	35	045	San Juan County, NM	2015	NA	55800	51979	3821	6.8
CN3504700000000	35	047	San Miguel County, NM	2015	NA	11124	10276	848	7.6
CN3504900000000	35	049	Santa Fe County, NM	2015	NA	73420	69519	3901	5.3
CN3505100000000	35	051	Sierra County, NM	2015	NA	4041	3676	365	9
CN3505300000000	35	053	Socorro County, NM	2015	NA	6558	6066	492	7.5
CN3505500000000	35	055	Taos County, NM	2015	NA	14960	13598	1362	9.1
CN3505700000000	35	057	Torrance County, NM	2015	NA	5482	4989	493	9
CN3505900000000	35	059	Union County, NM	2015	NA	1899	1817	82	4.3
CN3506100000000	35	061	Valencia County, NM	2015	NA	29750	27550	2200	7.4
CN3600100000000	36	001	Albany County, NY	2015	NA	158470	151584	6886	4.3
CN3600300000000	36	003	Allegany County, NY	2015	NA	20341	19019	1322	6.5
CN3600500000000	36	005	Bronx County, NY	2015	NA	605128	558075	47053	7.8
CN3600700000000	36	007	Broome County, NY	2015	NA	86781	81599	5182	6
CN3600900000000	36	009	Cattaraugus County, NY	2015	NA	35212	32998	2214	6.3
CN3601100000000	36	011	Cayuga County, NY	2015	NA	37066	35088	1978	5.3
CN3601300000000	36	013	Chautauqua County, NY	2015	NA	57593	54124	3469	6
CN3601500000000	36	015	Chemung County, NY	2015	NA	37466	35269	2197	5.9
CN3601700000000	36	017	Chenango County, NY	2015	NA	23086	21826	1260	5.5
CN3601900000000	36	019	Clinton County, NY	2015	NA	35918	33828	2090	5.8
CN3602100000000	36	021	Columbia County, NY	2015	NA	31407	30156	1251	4
CN3602300000000	36	023	Cortland County, NY	2015	NA	23270	21901	1369	5.9
CN3602500000000	36	025	Delaware County, NY	2015	NA	19498	18328	1170	6
CN3602700000000	36	027	Dutchess County, NY	2015	NA	143238	136810	6428	4.5
CN3602900000000	36	029	Erie County, NY	2015	NA	448642	424733	23909	5.3
CN3603100000000	36	031	Essex County, NY	2015	NA	17309	16268	1041	6
CN3603300000000	36	033	Franklin County, NY	2015	NA	19970	18671	1299	6.5
CN3603500000000	36	035	Fulton County, NY	2015	NA	23445	21937	1508	6.4
CN3603700000000	36	037	Genesee County, NY	2015	NA	30098	28608	1490	5
CN3603900000000	36	039	Greene County, NY	2015	NA	20719	19552	1167	5.6
CN3604100000000	36	041	Hamilton County, NY	2015	NA	2434	2270	164	6.7
CN3604300000000	36	043	Herkimer County, NY	2015	NA	28416	26645	1771	6.2
CN3604500000000	36	045	Jefferson County, NY	2015	NA	46520	43456	3064	6.6
CN3604700000000	36	047	Kings County, NY	2015	NA	1213264	1141678	71586	5.9
CN3604900000000	36	049	Lewis County, NY	2015	NA	11765	10952	813	6.9
CN3605100000000	36	051	Livingston County, NY	2015	NA	31246	29605	1641	5.3
CN3605300000000	36	053	Madison County, NY	2015	NA	32888	31021	1867	5.7
CN3605500000000	36	055	Monroe County, NY	2015	NA	365431	346915	18516	5.1
CN3605700000000	36	057	Montgomery County, NY	2015	NA	22270	20809	1461	6.6
CN3605900000000	36	059	Nassau County, NY	2015	NA	697587	668154	29433	4.2
CN3606100000000	36	061	New York County, NY	2015	NA	908849	864614	44235	4.9
CN3606300000000	36	063	Niagara County, NY	2015	NA	101128	94901	6227	6.2
CN3606500000000	36	065	Oneida County, NY	2015	NA	102114	96671	5443	5.3
CN3606700000000	36	067	Onondaga County, NY	2015	NA	222470	211509	10961	4.9
CN3606900000000	36	069	Ontario County, NY	2015	NA	55062	52464	2598	4.7
CN3607100000000	36	071	Orange County, NY	2015	NA	177958	169670	8288	4.7
CN3607300000000	36	073	Orleans County, NY	2015	NA	17874	16737	1137	6.4
CN3607500000000	36	075	Oswego County, NY	2015	NA	54021	50145	3876	7.2
CN3607700000000	36	077	Otsego County, NY	2015	NA	28703	27156	1547	5.4
CN3607900000000	36	079	Putnam County, NY	2015	NA	50611	48454	2157	4.3
CN3608100000000	36	081	Queens County, NY	2015	NA	1155747	1097706	58041	5
CN3608300000000	36	083	Rensselaer County, NY	2015	NA	81577	77787	3790	4.6
CN3608500000000	36	085	Richmond County, NY	2015	NA	219238	206436	12802	5.8
CN3608700000000	36	087	Rockland County, NY	2015	NA	152179	145300	6879	4.5
CN3608900000000	36	089	St. Lawrence County, NY	2015	NA	43891	40687	3204	7.3
CN3609100000000	36	091	Saratoga County, NY	2015	NA	116874	112028	4846	4.1
CN3609300000000	36	093	Schenectady County, NY	2015	NA	75747	72178	3569	4.7
CN3609500000000	36	095	Schoharie County, NY	2015	NA	14672	13821	851	5.8
CN3609700000000	36	097	Schuyler County, NY	2015	NA	8352	7800	552	6.6
CN3609900000000	36	099	Seneca County, NY	2015	NA	15724	14914	810	5.2
CN3610100000000	36	101	Steuben County, NY	2015	NA	43710	40957	2753	6.3
CN3610300000000	36	103	Suffolk County, NY	2015	NA	776167	739628	36539	4.7
CN3610500000000	36	105	Sullivan County, NY	2015	NA	33710	31891	1819	5.4
CN3610700000000	36	107	Tioga County, NY	2015	NA	23384	22088	1296	5.5
CN3610900000000	36	109	Tompkins County, NY	2015	NA	50423	48207	2216	4.4
CN3611100000000	36	111	Ulster County, NY	2015	NA	88339	84097	4242	4.8
CN3611300000000	36	113	Warren County, NY	2015	NA	32255	30471	1784	5.5
CN3611500000000	36	115	Washington County, NY	2015	NA	28653	27215	1438	5
CN3611700000000	36	117	Wayne County, NY	2015	NA	44287	41931	2356	5.3
CN3611900000000	36	119	Westchester County, NY	2015	NA	478437	456728	21709	4.5
CN3612100000000	36	121	Wyoming County, NY	2015	NA	18377	17342	1035	5.6
CN3612300000000	36	123	Yates County, NY	2015	NA	11742	11157	585	5
CN3700100000000	37	001	Alamance County, NC	2015	NA	77305	73191	4114	5.3
CN3700300000000	37	003	Alexander County, NC	2015	NA	17544	16685	859	4.9
CN3700500000000	37	005	Alleghany County, NC	2015	NA	4468	4195	273	6.1
CN3700700000000	37	007	Anson County, NC	2015	NA	10831	10128	703	6.5
CN3700900000000	37	009	Ashe County, NC	2015	NA	12313	11576	737	6
CN3701100000000	37	011	Avery County, NC	2015	NA	7533	7088	445	5.9
CN3701300000000	37	013	Beaufort County, NC	2015	NA	20121	18803	1318	6.6
CN3701500000000	37	015	Bertie County, NC	2015	NA	8605	7986	619	7.2
CN3701700000000	37	017	Bladen County, NC	2015	NA	14742	13575	1167	7.9
CN3701900000000	37	019	Brunswick County, NC	2015	NA	48546	45021	3525	7.3
CN3702100000000	37	021	Buncombe County, NC	2015	NA	130452	124788	5664	4.3
CN3702300000000	37	023	Burke County, NC	2015	NA	39337	37136	2201	5.6
CN3702500000000	37	025	Cabarrus County, NC	2015	NA	97639	92609	5030	5.2
CN3702700000000	37	027	Caldwell County, NC	2015	NA	35470	33264	2206	6.2
CN3702900000000	37	029	Camden County, NC	2015	NA	4614	4351	263	5.7
CN3703100000000	37	031	Carteret County, NC	2015	NA	31343	29497	1846	5.9
CN3703300000000	37	033	Caswell County, NC	2015	NA	9627	9023	604	6.3
CN3703500000000	37	035	Catawba County, NC	2015	NA	75172	71050	4122	5.5
CN3703700000000	37	037	Chatham County, NC	2015	NA	33397	31818	1579	4.7
CN3703900000000	37	039	Cherokee County, NC	2015	NA	11123	10409	714	6.4
CN3704100000000	37	041	Chowan County, NC	2015	NA	5641	5240	401	7.1
CN3704300000000	37	043	Clay County, NC	2015	NA	4045	3798	247	6.1
CN3704500000000	37	045	Cleveland County, NC	2015	NA	46098	43167	2931	6.4
CN3704700000000	37	047	Columbus County, NC	2015	NA	22614	20920	1694	7.5
CN3704900000000	37	049	Craven County, NC	2015	NA	41352	38861	2491	6
CN3705100000000	37	051	Cumberland County, NC	2015	NA	126281	117106	9175	7.3
CN3705300000000	37	053	Currituck County, NC	2015	NA	12852	12110	742	5.8
CN3705500000000	37	055	Dare County, NC	2015	NA	20304	18797	1507	7.4
CN3705700000000	37	057	Davidson County, NC	2015	NA	78758	74400	4358	5.5
CN3705900000000	37	059	Davie County, NC	2015	NA	19854	18860	994	5
CN3706100000000	37	061	Duplin County, NC	2015	NA	26495	24984	1511	5.7
CN3706300000000	37	063	Durham County, NC	2015	NA	156659	148846	7813	5
CN3706500000000	37	065	Edgecombe County, NC	2015	NA	22821	20647	2174	9.5
CN3706700000000	37	067	Forsyth County, NC	2015	NA	179781	169932	9849	5.5
CN3706900000000	37	069	Franklin County, NC	2015	NA	28722	27030	1692	5.9
CN3707100000000	37	071	Gaston County, NC	2015	NA	102813	96663	6150	6
CN3707300000000	37	073	Gates County, NC	2015	NA	5146	4865	281	5.5
CN3707500000000	37	075	Graham County, NC	2015	NA	3186	2806	380	11.9
CN3707700000000	37	077	Granville County, NC	2015	NA	28540	27137	1403	4.9
CN3707900000000	37	079	Greene County, NC	2015	NA	9482	8960	522	5.5
CN3708100000000	37	081	Guilford County, NC	2015	NA	256352	241375	14977	5.8
CN3708300000000	37	083	Halifax County, NC	2015	NA	20774	18952	1822	8.8
CN3708500000000	37	085	Harnett County, NC	2015	NA	50259	46907	3352	6.7
CN3708700000000	37	087	Haywood County, NC	2015	NA	27660	26213	1447	5.2
CN3708900000000	37	089	Henderson County, NC	2015	NA	50676	48281	2395	4.7
CN3709100000000	37	091	Hertford County, NC	2015	NA	9224	8576	648	7
CN3709300000000	37	093	Hoke County, NC	2015	NA	19834	18268	1566	7.9
CN3709500000000	37	095	Hyde County, NC	2015	NA	2145	1950	195	9.1
CN3709700000000	37	097	Iredell County, NC	2015	NA	82207	77713	4494	5.5
CN3709900000000	37	099	Jackson County, NC	2015	NA	18469	17350	1119	6.1
CN3710100000000	37	101	Johnston County, NC	2015	NA	88186	83599	4587	5.2
CN3710300000000	37	103	Jones County, NC	2015	NA	4549	4288	261	5.7
CN3710500000000	37	105	Lee County, NC	2015	NA	26095	24222	1873	7.2
CN3710700000000	37	107	Lenoir County, NC	2015	NA	27747	25996	1751	6.3
CN3710900000000	37	109	Lincoln County, NC	2015	NA	40624	38431	2193	5.4
CN3711100000000	37	111	McDowell County, NC	2015	NA	21266	20103	1163	5.5
CN3711300000000	37	113	Macon County, NC	2015	NA	15124	14196	928	6.1
CN3711500000000	37	115	Madison County, NC	2015	NA	9473	8936	537	5.7
CN3711700000000	37	117	Martin County, NC	2015	NA	9718	8976	742	7.6
CN3711900000000	37	119	Mecklenburg County, NC	2015	NA	565437	535313	30124	5.3
CN3712100000000	37	121	Mitchell County, NC	2015	NA	6312	5882	430	6.8
CN3712300000000	37	123	Montgomery County, NC	2015	NA	11628	10970	658	5.7
CN3712500000000	37	125	Moore County, NC	2015	NA	38300	36091	2209	5.8
CN3712700000000	37	127	Nash County, NC	2015	NA	43873	40694	3179	7.2
CN3712900000000	37	129	New Hanover County, NC	2015	NA	113423	107379	6044	5.3
CN3713100000000	37	131	Northampton County, NC	2015	NA	7868	7278	590	7.5
CN3713300000000	37	133	Onslow County, NC	2015	NA	63769	60028	3741	5.9
CN3713500000000	37	135	Orange County, NC	2015	NA	73397	70017	3380	4.6
CN3713700000000	37	137	Pamlico County, NC	2015	NA	5337	5020	317	5.9
CN3713900000000	37	139	Pasquotank County, NC	2015	NA	17454	16195	1259	7.2
CN3714100000000	37	141	Pender County, NC	2015	NA	26023	24445	1578	6.1
CN3714300000000	37	143	Perquimans County, NC	2015	NA	5157	4791	366	7.1
CN3714500000000	37	145	Person County, NC	2015	NA	17888	16680	1208	6.8
CN3714700000000	37	147	Pitt County, NC	2015	NA	87711	82426	5285	6
CN3714900000000	37	149	Polk County, NC	2015	NA	8664	8225	439	5.1
CN3715100000000	37	151	Randolph County, NC	2015	NA	66661	62877	3784	5.7
CN3715300000000	37	153	Richmond County, NC	2015	NA	16929	15596	1333	7.9
CN3715500000000	37	155	Robeson County, NC	2015	NA	51053	46751	4302	8.4
CN3715700000000	37	157	Rockingham County, NC	2015	NA	41130	38423	2707	6.6
CN3715900000000	37	159	Rowan County, NC	2015	NA	63109	59288	3821	6.1
CN3716100000000	37	161	Rutherford County, NC	2015	NA	25055	23118	1937	7.7
CN3716300000000	37	163	Sampson County, NC	2015	NA	29551	27811	1740	5.9
CN3716500000000	37	165	Scotland County, NC	2015	NA	11860	10609	1251	10.5
CN3716700000000	37	167	Stanly County, NC	2015	NA	28805	27280	1525	5.3
CN3716900000000	37	169	Stokes County, NC	2015	NA	21810	20632	1178	5.4
CN3717100000000	37	171	Surry County, NC	2015	NA	33338	31541	1797	5.4
CN3717300000000	37	173	Swain County, NC	2015	NA	6776	6259	517	7.6
CN3717500000000	37	175	Transylvania County, NC	2015	NA	13550	12817	733	5.4
CN3717700000000	37	177	Tyrrell County, NC	2015	NA	1547	1401	146	9.4
CN3717900000000	37	179	Union County, NC	2015	NA	112359	106944	5415	4.8
CN3718100000000	37	181	Vance County, NC	2015	NA	18049	16511	1538	8.5
CN3718300000000	37	183	Wake County, NC	2015	NA	539667	514376	25291	4.7
CN3718500000000	37	185	Warren County, NC	2015	NA	7213	6618	595	8.2
CN3718700000000	37	187	Washington County, NC	2015	NA	4967	4538	429	8.6
CN3718900000000	37	189	Watauga County, NC	2015	NA	27401	26080	1321	4.8
CN3719100000000	37	191	Wayne County, NC	2015	NA	53745	50503	3242	6
CN3719300000000	37	193	Wilkes County, NC	2015	NA	29636	27962	1674	5.6
CN3719500000000	37	195	Wilson County, NC	2015	NA	36753	33280	3473	9.4
CN3719700000000	37	197	Yadkin County, NC	2015	NA	17495	16623	872	5
CN3719900000000	37	199	Yancey County, NC	2015	NA	7417	6982	435	5.9
CN3800100000000	38	001	Adams County, ND	2015	NA	1107	1074	33	3
CN3800300000000	38	003	Barnes County, ND	2015	NA	5629	5448	181	3.2
CN3800500000000	38	005	Benson County, ND	2015	NA	2473	2359	114	4.6
CN3800700000000	38	007	Billings County, ND	2015	NA	467	453	14	3
CN3800900000000	38	009	Bottineau County, ND	2015	NA	3234	3092	142	4.4
CN3801100000000	38	011	Bowman County, ND	2015	NA	1858	1823	35	1.9
CN3801300000000	38	013	Burke County, ND	2015	NA	1178	1139	39	3.3
CN3801500000000	38	015	Burleigh County, ND	2015	NA	48832	47665	1167	2.4
CN3801700000000	38	017	Cass County, ND	2015	NA	95126	92985	2141	2.3
CN3801900000000	38	019	Cavalier County, ND	2015	NA	2055	1998	57	2.8
CN3802100000000	38	021	Dickey County, ND	2015	NA	2545	2498	47	1.8
CN3802300000000	38	023	Divide County, ND	2015	NA	1810	1777	33	1.8
CN3802500000000	38	025	Dunn County, ND	2015	NA	4008	3929	79	2
CN3802700000000	38	027	Eddy County, ND	2015	NA	1267	1206	61	4.8
CN3802900000000	38	029	Emmons County, ND	2015	NA	1548	1471	77	5
CN3803100000000	38	031	Foster County, ND	2015	NA	1625	1578	47	2.9
CN3803300000000	38	033	Golden Valley County, ND	2015	NA	975	953	22	2.3
CN3803500000000	38	035	Grand Forks County, ND	2015	NA	37413	36498	915	2.4
CN3803700000000	38	037	Grant County, ND	2015	NA	1316	1274	42	3.2
CN3803900000000	38	039	Griggs County, ND	2015	NA	1152	1125	27	2.3
CN3804100000000	38	041	Hettinger County, ND	2015	NA	1551	1512	39	2.5
CN3804300000000	38	043	Kidder County, ND	2015	NA	1339	1290	49	3.7
CN3804500000000	38	045	LaMoure County, ND	2015	NA	2265	2209	56	2.5
CN3804700000000	38	047	Logan County, ND	2015	NA	946	919	27	2.9
CN3804900000000	38	049	McHenry County, ND	2015	NA	3271	3133	138	4.2
CN3805100000000	38	051	McIntosh County, ND	2015	NA	1241	1202	39	3.1
CN3805300000000	38	053	McKenzie County, ND	2015	NA	9181	8952	229	2.5
CN3805500000000	38	055	McLean County, ND	2015	NA	4910	4726	184	3.7
CN3805700000000	38	057	Mercer County, ND	2015	NA	4297	4116	181	4.2
CN3805900000000	38	059	Morton County, ND	2015	NA	16223	15722	501	3.1
CN3806100000000	38	061	Mountrail County, ND	2015	NA	8122	7962	160	2
CN3806300000000	38	063	Nelson County, ND	2015	NA	1514	1457	57	3.8
CN3806500000000	38	065	Oliver County, ND	2015	NA	880	828	52	5.9
CN3806700000000	38	067	Pembina County, ND	2015	NA	3600	3407	193	5.4
CN3806900000000	38	069	Pierce County, ND	2015	NA	1834	1757	77	4.2
CN3807100000000	38	071	Ramsey County, ND	2015	NA	5675	5482	193	3.4
CN3807300000000	38	073	Ransom County, ND	2015	NA	2769	2701	68	2.5
CN3807500000000	38	075	Renville County, ND	2015	NA	1335	1290	45	3.4
CN3807700000000	38	077	Richland County, ND	2015	NA	8577	8342	235	2.7
CN3807900000000	38	079	Rolette County, ND	2015	NA	4876	4372	504	10.3
CN3808100000000	38	081	Sargent County, ND	2015	NA	2250	2209	41	1.8
CN3808300000000	38	083	Sheridan County, ND	2015	NA	724	687	37	5.1
CN3808500000000	38	085	Sioux County, ND	2015	NA	1291	1234	57	4.4
CN3808700000000	38	087	Slope County, ND	2015	NA	463	451	12	2.6
CN3808900000000	38	089	Stark County, ND	2015	NA	20236	19687	549	2.7
CN3809100000000	38	091	Steele County, ND	2015	NA	1060	1036	24	2.3
CN3809300000000	38	093	Stutsman County, ND	2015	NA	10681	10405	276	2.6
CN3809500000000	38	095	Towner County, ND	2015	NA	1239	1205	34	2.7
CN3809700000000	38	097	Traill County, ND	2015	NA	4439	4313	126	2.8
CN3809900000000	38	099	Walsh County, ND	2015	NA	5563	5330	233	4.2
CN3810100000000	38	101	Ward County, ND	2015	NA	34195	33101	1094	3.2
CN3810300000000	38	103	Wells County, ND	2015	NA	2167	2080	87	4
CN3810500000000	38	105	Williams County, ND	2015	NA	28630	27948	682	2.4
CN3900100000000	39	001	Adams County, OH	2015	NA	10671	9829	842	7.9
CN3900300000000	39	003	Allen County, OH	2015	NA	47786	45460	2326	4.9
CN3900500000000	39	005	Ashland County, OH	2015	NA	25948	24638	1310	5
CN3900700000000	39	007	Ashtabula County, OH	2015	NA	44300	41644	2656	6
CN3900900000000	39	009	Athens County, OH	2015	NA	27881	26138	1743	6.3
CN3901100000000	39	011	Auglaize County, OH	2015	NA	24423	23522	901	3.7
CN3901300000000	39	013	Belmont County, OH	2015	NA	31117	29135	1982	6.4
CN3901500000000	39	015	Brown County, OH	2015	NA	19465	18248	1217	6.3
CN3901700000000	39	017	Butler County, OH	2015	NA	187236	178609	8627	4.6
CN3901900000000	39	019	Carroll County, OH	2015	NA	13334	12536	798	6
CN3902100000000	39	021	Champaign County, OH	2015	NA	19850	18978	872	4.4
CN3902300000000	39	023	Clark County, OH	2015	NA	64005	60795	3210	5
CN3902500000000	39	025	Clermont County, OH	2015	NA	102556	97911	4645	4.5
CN3902700000000	39	027	Clinton County, OH	2015	NA	16668	15629	1039	6.2
CN3902900000000	39	029	Columbiana County, OH	2015	NA	49330	46425	2905	5.9
CN3903100000000	39	031	Coshocton County, OH	2015	NA	15834	14822	1012	6.4
CN3903300000000	39	033	Crawford County, OH	2015	NA	19055	17944	1111	5.8
CN3903500000000	39	035	Cuyahoga County, OH	2015	NA	614586	583171	31415	5.1
CN3903700000000	39	037	Darke County, OH	2015	NA	26185	25065	1120	4.3
CN3903900000000	39	039	Defiance County, OH	2015	NA	18652	17733	919	4.9
CN3904100000000	39	041	Delaware County, OH	2015	NA	102223	98599	3624	3.5
CN3904300000000	39	043	Erie County, OH	2015	NA	37316	35242	2074	5.6
CN3904500000000	39	045	Fairfield County, OH	2015	NA	74797	71525	3272	4.4
CN3904700000000	39	047	Fayette County, OH	2015	NA	14006	13312	694	5
CN3904900000000	39	049	Franklin County, OH	2015	NA	655089	628175	26914	4.1
CN3905100000000	39	051	Fulton County, OH	2015	NA	22411	21314	1097	4.9
CN3905300000000	39	053	Gallia County, OH	2015	NA	12191	11397	794	6.5
CN3905500000000	39	055	Geauga County, OH	2015	NA	49147	47121	2026	4.1
CN3905700000000	39	057	Greene County, OH	2015	NA	80288	76770	3518	4.4
CN3905900000000	39	059	Guernsey County, OH	2015	NA	19182	17987	1195	6.2
CN3906100000000	39	061	Hamilton County, OH	2015	NA	400993	382887	18106	4.5
CN3906300000000	39	063	Hancock County, OH	2015	NA	40709	39212	1497	3.7
CN3906500000000	39	065	Hardin County, OH	2015	NA	14479	13779	700	4.8
CN3906700000000	39	067	Harrison County, OH	2015	NA	7176	6723	453	6.3
CN3906900000000	39	069	Henry County, OH	2015	NA	13532	12773	759	5.6
CN3907100000000	39	071	Highland County, OH	2015	NA	16918	15837	1081	6.4
CN3907300000000	39	073	Hocking County, OH	2015	NA	12997	12268	729	5.6
CN3907500000000	39	075	Holmes County, OH	2015	NA	20601	19893	708	3.4
CN3907700000000	39	077	Huron County, OH	2015	NA	27582	25762	1820	6.6
CN3907900000000	39	079	Jackson County, OH	2015	NA	13034	12050	984	7.5
CN3908100000000	39	081	Jefferson County, OH	2015	NA	29355	27168	2187	7.5
CN3908300000000	39	083	Knox County, OH	2015	NA	31192	29740	1452	4.7
CN3908500000000	39	085	Lake County, OH	2015	NA	124675	119131	5544	4.4
CN3908700000000	39	087	Lawrence County, OH	2015	NA	24872	23407	1465	5.9
CN3908900000000	39	089	Licking County, OH	2015	NA	86836	82968	3868	4.5
CN3909100000000	39	091	Logan County, OH	2015	NA	23069	22094	975	4.2
CN3909300000000	39	093	Lorain County, OH	2015	NA	151230	142920	8310	5.5
CN3909500000000	39	095	Lucas County, OH	2015	NA	208517	197405	11112	5.3
CN3909700000000	39	097	Madison County, OH	2015	NA	20473	19644	829	4
CN3909900000000	39	099	Mahoning County, OH	2015	NA	106815	100284	6531	6.1
CN3910100000000	39	101	Marion County, OH	2015	NA	27741	26316	1425	5.1
CN3910300000000	39	103	Medina County, OH	2015	NA	95392	91501	3891	4.1
CN3910500000000	39	105	Meigs County, OH	2015	NA	9085	8334	751	8.3
CN3910700000000	39	107	Mercer County, OH	2015	NA	22976	22220	756	3.3
CN3910900000000	39	109	Miami County, OH	2015	NA	52335	50025	2310	4.4
CN3911100000000	39	111	Monroe County, OH	2015	NA	5536	4984	552	10
CN3911300000000	39	113	Montgomery County, OH	2015	NA	248791	236280	12511	5
CN3911500000000	39	115	Morgan County, OH	2015	NA	6697	6206	491	7.3
CN3911700000000	39	117	Morrow County, OH	2015	NA	16666	15823	843	5.1
CN3911900000000	39	119	Muskingum County, OH	2015	NA	38761	36345	2416	6.2
CN3912100000000	39	121	Noble County, OH	2015	NA	4968	4605	363	7.3
CN3912300000000	39	123	Ottawa County, OH	2015	NA	21001	19609	1392	6.6
CN3912500000000	39	125	Paulding County, OH	2015	NA	8894	8466	428	4.8
CN3912700000000	39	127	Perry County, OH	2015	NA	15808	14772	1036	6.6
CN3912900000000	39	129	Pickaway County, OH	2015	NA	25712	24484	1228	4.8
CN3913100000000	39	131	Pike County, OH	2015	NA	10462	9694	768	7.3
CN3913300000000	39	133	Portage County, OH	2015	NA	86721	82485	4236	4.9
CN3913500000000	39	135	Preble County, OH	2015	NA	20960	19946	1014	4.8
CN3913700000000	39	137	Putnam County, OH	2015	NA	18641	17916	725	3.9
CN3913900000000	39	139	Richland County, OH	2015	NA	53502	50505	2997	5.6
CN3914100000000	39	141	Ross County, OH	2015	NA	33675	31864	1811	5.4
CN3914300000000	39	143	Sandusky County, OH	2015	NA	31320	29806	1514	4.8
CN3914500000000	39	145	Scioto County, OH	2015	NA	29543	27274	2269	7.7
CN3914700000000	39	147	Seneca County, OH	2015	NA	27113	25797	1316	4.9
CN3914900000000	39	149	Shelby County, OH	2015	NA	24050	23012	1038	4.3
CN3915100000000	39	151	Stark County, OH	2015	NA	186328	176479	9849	5.3
CN3915300000000	39	153	Summit County, OH	2015	NA	271430	257871	13559	5
CN3915500000000	39	155	Trumbull County, OH	2015	NA	91300	85391	5909	6.5
CN3915700000000	39	157	Tuscarawas County, OH	2015	NA	45389	42941	2448	5.4
CN3915900000000	39	159	Union County, OH	2015	NA	26992	25952	1040	3.9
CN3916100000000	39	161	Van Wert County, OH	2015	NA	14310	13713	597	4.2
CN3916300000000	39	163	Vinton County, OH	2015	NA	5453	5095	358	6.6
CN3916500000000	39	165	Warren County, OH	2015	NA	112279	107597	4682	4.2
CN3916700000000	39	167	Washington County, OH	2015	NA	28025	26334	1691	6
CN3916900000000	39	169	Wayne County, OH	2015	NA	59925	57556	2369	4
CN3917100000000	39	171	Williams County, OH	2015	NA	18989	18147	842	4.4
CN3917300000000	39	173	Wood County, OH	2015	NA	69503	66522	2981	4.3
CN3917500000000	39	175	Wyandot County, OH	2015	NA	12333	11880	453	3.7
CN4000100000000	40	001	Adair County, OK	2015	NA	8173	7677	496	6.1
CN4000300000000	40	003	Alfalfa County, OK	2015	NA	3167	3073	94	3
CN4000500000000	40	005	Atoka County, OK	2015	NA	4866	4550	316	6.5
CN4000700000000	40	007	Beaver County, OK	2015	NA	3026	2944	82	2.7
CN4000900000000	40	009	Beckham County, OK	2015	NA	12222	11599	623	5.1
CN4001100000000	40	011	Blaine County, OK	2015	NA	4491	4318	173	3.9
CN4001300000000	40	013	Bryan County, OK	2015	NA	18358	17520	838	4.6
CN4001500000000	40	015	Caddo County, OK	2015	NA	11848	11237	611	5.2
CN4001700000000	40	017	Canadian County, OK	2015	NA	68358	65890	2468	3.6
CN4001900000000	40	019	Carter County, OK	2015	NA	22579	21552	1027	4.5
CN4002100000000	40	021	Cherokee County, OK	2015	NA	19286	18289	997	5.2
CN4002300000000	40	023	Choctaw County, OK	2015	NA	5921	5467	454	7.7
CN4002500000000	40	025	Cimarron County, OK	2015	NA	1377	1346	31	2.3
CN4002700000000	40	027	Cleveland County, OK	2015	NA	138284	133397	4887	3.5
CN4002900000000	40	029	Coal County, OK	2015	NA	2322	2145	177	7.6
CN4003100000000	40	031	Comanche County, OK	2015	NA	49691	47527	2164	4.4
CN4003300000000	40	033	Cotton County, OK	2015	NA	2864	2745	119	4.2
CN4003500000000	40	035	Craig County, OK	2015	NA	6267	5964	303	4.8
CN4003700000000	40	037	Creek County, OK	2015	NA	31370	29812	1558	5
CN4003900000000	40	039	Custer County, OK	2015	NA	15671	15036	635	4.1
CN4004100000000	40	041	Delaware County, OK	2015	NA	17493	16627	866	5
CN4004300000000	40	043	Dewey County, OK	2015	NA	2498	2408	90	3.6
CN4004500000000	40	045	Ellis County, OK	2015	NA	2393	2296	97	4.1
CN4004700000000	40	047	Garfield County, OK	2015	NA	30112	28925	1187	3.9
CN4004900000000	40	049	Garvin County, OK	2015	NA	12844	12240	604	4.7
CN4005100000000	40	051	Grady County, OK	2015	NA	26245	25066	1179	4.5
CN4005300000000	40	053	Grant County, OK	2015	NA	3292	3196	96	2.9
CN4005500000000	40	055	Greer County, OK	2015	NA	2171	2048	123	5.7
CN4005700000000	40	057	Harmon County, OK	2015	NA	1304	1259	45	3.5
CN4005900000000	40	059	Harper County, OK	2015	NA	1988	1928	60	3
CN4006100000000	40	061	Haskell County, OK	2015	NA	4484	4128	356	7.9
CN4006300000000	40	063	Hughes County, OK	2015	NA	5740	5310	430	7.5
CN4006500000000	40	065	Jackson County, OK	2015	NA	10884	10442	442	4.1
CN4006700000000	40	067	Jefferson County, OK	2015	NA	2682	2529	153	5.7
CN4006900000000	40	069	Johnston County, OK	2015	NA	3974	3715	259	6.5
CN4007100000000	40	071	Kay County, OK	2015	NA	19215	18122	1093	5.7
CN4007300000000	40	073	Kingfisher County, OK	2015	NA	8286	8025	261	3.1
CN4007500000000	40	075	Kiowa County, OK	2015	NA	4167	3973	194	4.7
CN4007700000000	40	077	Latimer County, OK	2015	NA	3866	3552	314	8.1
CN4007900000000	40	079	Le Flore County, OK	2015	NA	19656	18295	1361	6.9
CN4008100000000	40	081	Lincoln County, OK	2015	NA	15893	15151	742	4.7
CN4008300000000	40	083	Logan County, OK	2015	NA	21494	20676	818	3.8
CN4008500000000	40	085	Love County, OK	2015	NA	5984	5771	213	3.6
CN4008700000000	40	087	McClain County, OK	2015	NA	18774	18077	697	3.7
CN4008900000000	40	089	McCurtain County, OK	2015	NA	14753	13582	1171	7.9
CN4009100000000	40	091	McIntosh County, OK	2015	NA	7092	6479	613	8.6
CN4009300000000	40	093	Major County, OK	2015	NA	4302	4161	141	3.3
CN4009500000000	40	095	Marshall County, OK	2015	NA	6790	6419	371	5.5
CN4009700000000	40	097	Mayes County, OK	2015	NA	19422	18582	840	4.3
CN4009900000000	40	099	Murray County, OK	2015	NA	6772	6486	286	4.2
CN4010100000000	40	101	Muskogee County, OK	2015	NA	29608	28086	1522	5.1
CN4010300000000	40	103	Noble County, OK	2015	NA	5646	5445	201	3.6
CN4010500000000	40	105	Nowata County, OK	2015	NA	4803	4529	274	5.7
CN4010700000000	40	107	Okfuskee County, OK	2015	NA	4547	4280	267	5.9
CN4010900000000	40	109	Oklahoma County, OK	2015	NA	375202	360407	14795	3.9
CN4011100000000	40	111	Okmulgee County, OK	2015	NA	16237	15152	1085	6.7
CN4011300000000	40	113	Osage County, OK	2015	NA	21242	20122	1120	5.3
CN4011500000000	40	115	Ottawa County, OK	2015	NA	14386	13648	738	5.1
CN4011700000000	40	117	Pawnee County, OK	2015	NA	7480	7043	437	5.8
CN4011900000000	40	119	Payne County, OK	2015	NA	38424	37069	1355	3.5
CN4012100000000	40	121	Pittsburg County, OK	2015	NA	17451	16455	996	5.7
CN4012300000000	40	123	Pontotoc County, OK	2015	NA	18262	17534	728	4
CN4012500000000	40	125	Pottawatomie County, OK	2015	NA	32772	31296	1476	4.5
CN4012700000000	40	127	Pushmataha County, OK	2015	NA	4918	4535	383	7.8
CN4012900000000	40	129	Roger Mills County, OK	2015	NA	1840	1762	78	4.2
CN4013100000000	40	131	Rogers County, OK	2015	NA	44653	42695	1958	4.4
CN4013300000000	40	133	Seminole County, OK	2015	NA	9614	8958	656	6.8
CN4013500000000	40	135	Sequoyah County, OK	2015	NA	16794	15727	1067	6.4
CN4013700000000	40	137	Stephens County, OK	2015	NA	20297	19081	1216	6
CN4013900000000	40	139	Texas County, OK	2015	NA	9701	9389	312	3.2
CN4014100000000	40	141	Tillman County, OK	2015	NA	3361	3217	144	4.3
CN4014300000000	40	143	Tulsa County, OK	2015	NA	318160	304974	13186	4.1
CN4014500000000	40	145	Wagoner County, OK	2015	NA	36282	34755	1527	4.2
CN4014700000000	40	147	Washington County, OK	2015	NA	24478	23423	1055	4.3
CN4014900000000	40	149	Washita County, OK	2015	NA	5611	5299	312	5.6
CN4015100000000	40	151	Woods County, OK	2015	NA	5372	5224	148	2.8
CN4015300000000	40	153	Woodward County, OK	2015	NA	10312	9779	533	5.2
CN4100100000000	41	001	Baker County, OR	2015	NA	6672	6221	451	6.8
CN4100300000000	41	003	Benton County, OR	2015	NA	45429	43512	1917	4.2
CN4100500000000	41	005	Clackamas County, OR	2015	NA	205165	194653	10512	5.1
CN4100700000000	41	007	Clatsop County, OR	2015	NA	18352	17349	1003	5.5
CN4100900000000	41	009	Columbia County, OR	2015	NA	22680	21058	1622	7.2
CN4101100000000	41	011	Coos County, OR	2015	NA	25948	24019	1929	7.4
CN4101300000000	41	013	Crook County, OR	2015	NA	9023	8268	755	8.4
CN4101500000000	41	015	Curry County, OR	2015	NA	8713	7994	719	8.3
CN4101700000000	41	017	Deschutes County, OR	2015	NA	84750	79768	4982	5.9
CN4101900000000	41	019	Douglas County, OR	2015	NA	44369	41041	3328	7.5
CN4102100000000	41	021	Gilliam County, OR	2015	NA	809	757	52	6.4
CN4102300000000	41	023	Grant County, OR	2015	NA	3091	2822	269	8.7
CN4102500000000	41	025	Harney County, OR	2015	NA	3304	3067	237	7.2
CN4102700000000	41	027	Hood River County, OR	2015	NA	13526	12888	638	4.7
CN4102900000000	41	029	Jackson County, OR	2015	NA	98038	91386	6652	6.8
CN4103100000000	41	031	Jefferson County, OR	2015	NA	9644	8938	706	7.3
CN4103300000000	41	033	Josephine County, OR	2015	NA	33270	30700	2570	7.7
CN4103500000000	41	035	Klamath County, OR	2015	NA	28664	26426	2238	7.8
CN4103700000000	41	037	Lake County, OR	2015	NA	3436	3173	263	7.7
CN4103900000000	41	039	Lane County, OR	2015	NA	172524	162496	10028	5.8
CN4104100000000	41	041	Lincoln County, OR	2015	NA	20521	19156	1365	6.7
CN4104300000000	41	043	Linn County, OR	2015	NA	55189	51479	3710	6.7
CN4104500000000	41	045	Malheur County, OR	2015	NA	11955	11195	760	6.4
CN4104700000000	41	047	Marion County, OR	2015	NA	152615	143470	9145	6
CN4104900000000	41	049	Morrow County, OR	2015	NA	5542	5224	318	5.7
CN4105100000000	41	051	Multnomah County, OR	2015	NA	429636	408570	21066	4.9
CN4105300000000	41	053	Polk County, OR	2015	NA	36582	34524	2058	5.6
CN4105500000000	41	055	Sherman County, OR	2015	NA	888	834	54	6.1
CN4105700000000	41	057	Tillamook County, OR	2015	NA	11389	10748	641	5.6
CN4105900000000	41	059	Umatilla County, OR	2015	NA	35246	33005	2241	6.4
CN4106100000000	41	061	Union County, OR	2015	NA	11702	10982	720	6.2
CN4106300000000	41	063	Wallowa County, OR	2015	NA	3243	2990	253	7.8
CN4106500000000	41	065	Wasco County, OR	2015	NA	13023	12294	729	5.6
CN4106700000000	41	067	Washington County, OR	2015	NA	301627	287469	14158	4.7
CN4106900000000	41	069	Wheeler County, OR	2015	NA	692	656	36	5.2
CN4107100000000	41	071	Yamhill County, OR	2015	NA	50861	48173	2688	5.3
CN4200100000000	42	001	Adams County, PA	2015	NA	54927	52623	2304	4.2
CN4200300000000	42	003	Allegheny County, PA	2015	NA	646793	614774	32019	5
CN4200500000000	42	005	Armstrong County, PA	2015	NA	32988	30800	2188	6.6
CN4200700000000	42	007	Beaver County, PA	2015	NA	85690	80511	5179	6
CN4200900000000	42	009	Bedford County, PA	2015	NA	24096	22637	1459	6.1
CN4201100000000	42	011	Berks County, PA	2015	NA	212266	201806	10460	4.9
CN4201300000000	42	013	Blair County, PA	2015	NA	60921	57786	3135	5.1
CN4201500000000	42	015	Bradford County, PA	2015	NA	31330	29478	1852	5.9
CN4201700000000	42	017	Bucks County, PA	2015	NA	337194	321478	15716	4.7
CN4201900000000	42	019	Butler County, PA	2015	NA	97988	93370	4618	4.7
CN4202100000000	42	021	Cambria County, PA	2015	NA	62258	58182	4076	6.5
CN4202300000000	42	023	Cameron County, PA	2015	NA	2260	2099	161	7.1
CN4202500000000	42	025	Carbon County, PA	2015	NA	31420	29518	1902	6.1
CN4202700000000	42	027	Centre County, PA	2015	NA	77719	74635	3084	4
CN4202900000000	42	029	Chester County, PA	2015	NA	276759	266233	10526	3.8
CN4203100000000	42	031	Clarion County, PA	2015	NA	18248	17159	1089	6
CN4203300000000	42	033	Clearfield County, PA	2015	NA	36368	33955	2413	6.6
CN4203500000000	42	035	Clinton County, PA	2015	NA	18741	17453	1288	6.9
CN4203700000000	42	037	Columbia County, PA	2015	NA	33695	31794	1901	5.6
CN4203900000000	42	039	Crawford County, PA	2015	NA	40997	38868	2129	5.2
CN4204100000000	42	041	Cumberland County, PA	2015	NA	128248	123140	5108	4
CN4204300000000	42	043	Dauphin County, PA	2015	NA	140831	134283	6548	4.6
CN4204500000000	42	045	Delaware County, PA	2015	NA	291197	276966	14231	4.9
CN4204700000000	42	047	Elk County, PA	2015	NA	16312	15508	804	4.9
CN4204900000000	42	049	Erie County, PA	2015	NA	134589	127206	7383	5.5
CN4205100000000	42	051	Fayette County, PA	2015	NA	58296	53929	4367	7.5
CN4205300000000	42	053	Forest County, PA	2015	NA	1897	1748	149	7.9
CN4205500000000	42	055	Franklin County, PA	2015	NA	77763	73912	3851	5
CN4205700000000	42	057	Fulton County, PA	2015	NA	7432	6970	462	6.2
CN4205900000000	42	059	Greene County, PA	2015	NA	18141	17055	1086	6
CN4206100000000	42	061	Huntingdon County, PA	2015	NA	19645	18268	1377	7
CN4206300000000	42	063	Indiana County, PA	2015	NA	41705	39077	2628	6.3
CN4206500000000	42	065	Jefferson County, PA	2015	NA	20947	19670	1277	6.1
CN4206700000000	42	067	Juniata County, PA	2015	NA	11976	11384	592	4.9
CN4206900000000	42	069	Lackawanna County, PA	2015	NA	106287	100102	6185	5.8
CN4207100000000	42	071	Lancaster County, PA	2015	NA	275676	264354	11322	4.1
CN4207300000000	42	073	Lawrence County, PA	2015	NA	42067	39413	2654	6.3
CN4207500000000	42	075	Lebanon County, PA	2015	NA	69985	66821	3164	4.5
CN4207700000000	42	077	Lehigh County, PA	2015	NA	185560	175687	9873	5.3
CN4207900000000	42	079	Luzerne County, PA	2015	NA	158581	148361	10220	6.4
CN4208100000000	42	081	Lycoming County, PA	2015	NA	60835	57157	3678	6
CN4208300000000	42	083	McKean County, PA	2015	NA	18956	17806	1150	6.1
CN4208500000000	42	085	Mercer County, PA	2015	NA	52939	50056	2883	5.4
CN4208700000000	42	087	Mifflin County, PA	2015	NA	20891	19686	1205	5.8
CN4208900000000	42	089	Monroe County, PA	2015	NA	80673	75473	5200	6.4
CN4209100000000	42	091	Montgomery County, PA	2015	NA	440389	422107	18282	4.2
CN4209300000000	42	093	Montour County, PA	2015	NA	9136	8742	394	4.3
CN4209500000000	42	095	Northampton County, PA	2015	NA	156406	148188	8218	5.3
CN4209700000000	42	097	Northumberland County, PA	2015	NA	43379	40738	2641	6.1
CN4209900000000	42	099	Perry County, PA	2015	NA	24080	23006	1074	4.5
CN4210100000000	42	101	Philadelphia County/city, PA	2015	NA	694732	645414	49318	7.1
CN4210300000000	42	103	Pike County, PA	2015	NA	24936	23308	1628	6.5
CN4210500000000	42	105	Potter County, PA	2015	NA	7366	6849	517	7
CN4210700000000	42	107	Schuylkill County, PA	2015	NA	68112	63832	4280	6.3
CN4210900000000	42	109	Snyder County, PA	2015	NA	20041	19102	939	4.7
CN4211100000000	42	111	Somerset County, PA	2015	NA	34425	32077	2348	6.8
CN4211300000000	42	113	Sullivan County, PA	2015	NA	3030	2843	187	6.2
CN4211500000000	42	115	Susquehanna County, PA	2015	NA	21376	20184	1192	5.6
CN4211700000000	42	117	Tioga County, PA	2015	NA	20308	18986	1322	6.5
CN4211900000000	42	119	Union County, PA	2015	NA	19286	18424	862	4.5
CN4212100000000	42	121	Venango County, PA	2015	NA	24429	22981	1448	5.9
CN4212300000000	42	123	Warren County, PA	2015	NA	19933	18940	993	5
CN4212500000000	42	125	Washington County, PA	2015	NA	106499	100574	5925	5.6
CN4212700000000	42	127	Wayne County, PA	2015	NA	22245	20951	1294	5.8
CN4212900000000	42	129	Westmoreland County, PA	2015	NA	182701	172864	9837	5.4
CN4213100000000	42	131	Wyoming County, PA	2015	NA	14099	13240	859	6.1
CN4213300000000	42	133	York County, PA	2015	NA	232453	221422	11031	4.7
CN4400100000000	44	001	Bristol County, RI	2015	NA	26164	24781	1383	5.3
CN4400300000000	44	003	Kent County, RI	2015	NA	91024	86004	5020	5.5
CN4400500000000	44	005	Newport County, RI	2015	NA	44085	41700	2385	5.4
CN4400700000000	44	007	Providence County, RI	2015	NA	323908	303363	20545	6.3
CN4400900000000	44	009	Washington County, RI	2015	NA	69247	65362	3885	5.6
CN4500100000000	45	001	Abbeville County, SC	2015	NA	10365	9650	715	6.9
CN4500300000000	45	003	Aiken County, SC	2015	NA	74046	69671	4375	5.9
CN4500500000000	45	005	Allendale County, SC	2015	NA	2753	2441	312	11.3
CN4500700000000	45	007	Anderson County, SC	2015	NA	88613	83814	4799	5.4
CN4500900000000	45	009	Bamberg County, SC	2015	NA	5471	4895	576	10.5
CN4501100000000	45	011	Barnwell County, SC	2015	NA	8391	7635	756	9
CN4501300000000	45	013	Beaufort County, SC	2015	NA	71772	67841	3931	5.5
CN4501500000000	45	015	Berkeley County, SC	2015	NA	93640	88479	5161	5.5
CN4501700000000	45	017	Calhoun County, SC	2015	NA	6903	6410	493	7.1
CN4501900000000	45	019	Charleston County, SC	2015	NA	198504	188861	9643	4.9
CN4502100000000	45	021	Cherokee County, SC	2015	NA	23502	21823	1679	7.1
CN4502300000000	45	023	Chester County, SC	2015	NA	13477	12346	1131	8.4
CN4502500000000	45	025	Chesterfield County, SC	2015	NA	21481	20174	1307	6.1
CN4502700000000	45	027	Clarendon County, SC	2015	NA	13089	12079	1010	7.7
CN4502900000000	45	029	Colleton County, SC	2015	NA	16747	15577	1170	7
CN4503100000000	45	031	Darlington County, SC	2015	NA	30116	27889	2227	7.4
CN4503300000000	45	033	Dillon County, SC	2015	NA	12695	11599	1096	8.6
CN4503500000000	45	035	Dorchester County, SC	2015	NA	72823	68826	3997	5.5
CN4503700000000	45	037	Edgefield County, SC	2015	NA	10685	10005	680	6.4
CN4503900000000	45	039	Fairfield County, SC	2015	NA	10040	9229	811	8.1
CN4504100000000	45	041	Florence County, SC	2015	NA	65624	61322	4302	6.6
CN4504300000000	45	043	Georgetown County, SC	2015	NA	25277	23145	2132	8.4
CN4504500000000	45	045	Greenville County, SC	2015	NA	243357	231301	12056	5
CN4504700000000	45	047	Greenwood County, SC	2015	NA	31316	29329	1987	6.3
CN4504900000000	45	049	Hampton County, SC	2015	NA	8361	7658	703	8.4
CN4505100000000	45	051	Horry County, SC	2015	NA	137566	127746	9820	7.1
CN4505300000000	45	053	Jasper County, SC	2015	NA	11839	11231	608	5.1
CN4505500000000	45	055	Kershaw County, SC	2015	NA	28991	27254	1737	6
CN4505700000000	45	057	Lancaster County, SC	2015	NA	36768	34451	2317	6.3
CN4505900000000	45	059	Laurens County, SC	2015	NA	30339	28342	1997	6.6
CN4506100000000	45	061	Lee County, SC	2015	NA	6469	5923	546	8.4
CN4506300000000	45	063	Lexington County, SC	2015	NA	145615	138552	7063	4.9
CN4506500000000	45	065	McCormick County, SC	2015	NA	3446	3201	245	7.1
CN4506700000000	45	067	Marion County, SC	2015	NA	12885	11597	1288	10
CN4506900000000	45	069	Marlboro County, SC	2015	NA	9664	8690	974	10.1
CN4507100000000	45	071	Newberry County, SC	2015	NA	18929	17921	1008	5.3
CN4507300000000	45	073	Oconee County, SC	2015	NA	34545	32537	2008	5.8
CN4507500000000	45	075	Orangeburg County, SC	2015	NA	37010	32976	4034	10.9
CN4507700000000	45	077	Pickens County, SC	2015	NA	56157	52909	3248	5.8
CN4507900000000	45	079	Richland County, SC	2015	NA	199014	187733	11281	5.7
CN4508100000000	45	081	Saluda County, SC	2015	NA	8844	8380	464	5.2
CN4508300000000	45	083	Spartanburg County, SC	2015	NA	140106	132080	8026	5.7
CN4508500000000	45	085	Sumter County, SC	2015	NA	44461	41413	3048	6.9
CN4508700000000	45	087	Union County, SC	2015	NA	11575	10659	916	7.9
CN4508900000000	45	089	Williamsburg County, SC	2015	NA	12841	11654	1187	9.2
CN4509100000000	45	091	York County, SC	2015	NA	126886	119912	6974	5.5
CN4600300000000	46	003	Aurora County, SD	2015	NA	1570	1535	35	2.2
CN4600500000000	46	005	Beadle County, SD	2015	NA	9461	9212	249	2.6
CN4600700000000	46	007	Bennett County, SD	2015	NA	1130	1073	57	5
CN4600900000000	46	009	Bon Homme County, SD	2015	NA	3007	2927	80	2.7
CN4601100000000	46	011	Brookings County, SD	2015	NA	18549	18006	543	2.9
CN4601300000000	46	013	Brown County, SD	2015	NA	20973	20414	559	2.7
CN4601500000000	46	015	Brule County, SD	2015	NA	2534	2466	68	2.7
CN4601700000000	46	017	Buffalo County, SD	2015	NA	714	664	50	7
CN4601900000000	46	019	Butte County, SD	2015	NA	5088	4915	173	3.4
CN4602100000000	46	021	Campbell County, SD	2015	NA	848	823	25	2.9
CN4602300000000	46	023	Charles Mix County, SD	2015	NA	3980	3843	137	3.4
CN4602500000000	46	025	Clark County, SD	2015	NA	1963	1892	71	3.6
CN4602700000000	46	027	Clay County, SD	2015	NA	7004	6789	215	3.1
CN4602900000000	46	029	Codington County, SD	2015	NA	15307	14835	472	3.1
CN4603100000000	46	031	Corson County, SD	2015	NA	1489	1413	76	5.1
CN4603300000000	46	033	Custer County, SD	2015	NA	3959	3791	168	4.2
CN4603500000000	46	035	Davison County, SD	2015	NA	11316	11029	287	2.5
CN4603700000000	46	037	Day County, SD	2015	NA	2858	2715	143	5
CN4603900000000	46	039	Deuel County, SD	2015	NA	2307	2193	114	4.9
CN4604100000000	46	041	Dewey County, SD	2015	NA	2291	2028	263	11.5
CN4604300000000	46	043	Douglas County, SD	2015	NA	1672	1631	41	2.5
CN4604500000000	46	045	Edmunds County, SD	2015	NA	2218	2163	55	2.5
CN4604700000000	46	047	Fall River County, SD	2015	NA	2971	2839	132	4.4
CN4604900000000	46	049	Faulk County, SD	2015	NA	1119	1089	30	2.7
CN4605100000000	46	051	Grant County, SD	2015	NA	4701	4562	139	3
CN4605300000000	46	053	Gregory County, SD	2015	NA	2055	1990	65	3.2
CN4605500000000	46	055	Haakon County, SD	2015	NA	1096	1071	25	2.3
CN4605700000000	46	057	Hamlin County, SD	2015	NA	3130	3026	104	3.3
CN4605900000000	46	059	Hand County, SD	2015	NA	1872	1829	43	2.3
CN4606100000000	46	061	Hanson County, SD	2015	NA	1796	1736	60	3.3
CN4606300000000	46	063	Harding County, SD	2015	NA	779	760	19	2.4
CN4606500000000	46	065	Hughes County, SD	2015	NA	9887	9649	238	2.4
CN4606700000000	46	067	Hutchinson County, SD	2015	NA	3670	3579	91	2.5
CN4606900000000	46	069	Hyde County, SD	2015	NA	706	686	20	2.8
CN4607100000000	46	071	Jackson County, SD	2015	NA	1325	1268	57	4.3
CN4607300000000	46	073	Jerauld County, SD	2015	NA	1125	1099	26	2.3
CN4607500000000	46	075	Jones County, SD	2015	NA	584	567	17	2.9
CN4607700000000	46	077	Kingsbury County, SD	2015	NA	2751	2670	81	2.9
CN4607900000000	46	079	Lake County, SD	2015	NA	6504	6268	236	3.6
CN4608100000000	46	081	Lawrence County, SD	2015	NA	12725	12309	416	3.3
CN4608300000000	46	083	Lincoln County, SD	2015	NA	30428	29743	685	2.3
CN4608500000000	46	085	Lyman County, SD	2015	NA	1792	1708	84	4.7
CN4608700000000	46	087	McCook County, SD	2015	NA	3128	3054	74	2.4
CN4608900000000	46	089	McPherson County, SD	2015	NA	1112	1075	37	3.3
CN4609100000000	46	091	Marshall County, SD	2015	NA	2500	2404	96	3.8
CN4609300000000	46	093	Meade County, SD	2015	NA	13324	12903	421	3.2
CN4609500000000	46	095	Mellette County, SD	2015	NA	797	756	41	5.1
CN4609700000000	46	097	Miner County, SD	2015	NA	1210	1181	29	2.4
CN4609900000000	46	099	Minnehaha County, SD	2015	NA	106213	103346	2867	2.7
CN4610100000000	46	101	Moody County, SD	2015	NA	3940	3806	134	3.4
CN4610200000000	46	102	Oglala Lakota County, SD	2015	NA	3583	3172	411	11.5
CN4610300000000	46	103	Pennington County, SD	2015	NA	54315	52602	1713	3.2
CN4610500000000	46	105	Perkins County, SD	2015	NA	1574	1524	50	3.2
CN4610700000000	46	107	Potter County, SD	2015	NA	1181	1143	38	3.2
CN4610900000000	46	109	Roberts County, SD	2015	NA	4861	4650	211	4.3
CN4611100000000	46	111	Sanborn County, SD	2015	NA	1225	1194	31	2.5
CN4611500000000	46	115	Spink County, SD	2015	NA	3314	3212	102	3.1
CN4611700000000	46	117	Stanley County, SD	2015	NA	1833	1789	44	2.4
CN4611900000000	46	119	Sully County, SD	2015	NA	869	847	22	2.5
CN4612100000000	46	121	Todd County, SD	2015	NA	3047	2822	225	7.4
CN4612300000000	46	123	Tripp County, SD	2015	NA	3078	2996	82	2.7
CN4612500000000	46	125	Turner County, SD	2015	NA	4632	4508	124	2.7
CN4612700000000	46	127	Union County, SD	2015	NA	8022	7750	272	3.4
CN4612900000000	46	129	Walworth County, SD	2015	NA	2265	2143	122	5.4
CN4613500000000	46	135	Yankton County, SD	2015	NA	11588	11286	302	2.6
CN4613700000000	46	137	Ziebach County, SD	2015	NA	983	933	50	5.1
CN4700100000000	47	001	Anderson County, TN	2015	NA	33167	31233	1934	5.8
CN4700300000000	47	003	Bedford County, TN	2015	NA	19341	18093	1248	6.5
CN4700500000000	47	005	Benton County, TN	2015	NA	6743	6224	519	7.7
CN4700700000000	47	007	Bledsoe County, TN	2015	NA	4236	3899	337	8
CN4700900000000	47	009	Blount County, TN	2015	NA	59324	56249	3075	5.2
CN4701100000000	47	011	Bradley County, TN	2015	NA	49265	46687	2578	5.2
CN4701300000000	47	013	Campbell County, TN	2015	NA	14579	13423	1156	7.9
CN4701500000000	47	015	Cannon County, TN	2015	NA	5838	5499	339	5.8
CN4701700000000	47	017	Carroll County, TN	2015	NA	12143	11136	1007	8.3
CN4701900000000	47	019	Carter County, TN	2015	NA	23448	21936	1512	6.4
CN4702100000000	47	021	Cheatham County, TN	2015	NA	19798	18838	960	4.8
CN4702300000000	47	023	Chester County, TN	2015	NA	8198	7716	482	5.9
CN4702500000000	47	025	Claiborne County, TN	2015	NA	12533	11625	908	7.2
CN4702700000000	47	027	Clay County, TN	2015	NA	2989	2724	265	8.9
CN4702900000000	47	029	Cocke County, TN	2015	NA	14357	13241	1116	7.8
CN4703100000000	47	031	Coffee County, TN	2015	NA	24209	22866	1343	5.5
CN4703300000000	47	033	Crockett County, TN	2015	NA	6797	6360	437	6.4
CN4703500000000	47	035	Cumberland County, TN	2015	NA	22852	21234	1618	7.1
CN4703700000000	47	037	Davidson County, TN	2015	NA	362895	346987	15908	4.4
CN4703900000000	47	039	Decatur County, TN	2015	NA	4696	4326	370	7.9
CN4704100000000	47	041	DeKalb County, TN	2015	NA	7340	6835	505	6.9
CN4704300000000	47	043	Dickson County, TN	2015	NA	24010	22703	1307	5.4
CN4704500000000	47	045	Dyer County, TN	2015	NA	16607	15414	1193	7.2
CN4704700000000	47	047	Fayette County, TN	2015	NA	17809	16707	1102	6.2
CN4704900000000	47	049	Fentress County, TN	2015	NA	6978	6469	509	7.3
CN4705100000000	47	051	Franklin County, TN	2015	NA	19525	18511	1014	5.2
CN4705300000000	47	053	Gibson County, TN	2015	NA	20957	19410	1547	7.4
CN4705500000000	47	055	Giles County, TN	2015	NA	14502	13778	724	5
CN4705700000000	47	057	Grainger County, TN	2015	NA	9113	8507	606	6.6
CN4705900000000	47	059	Greene County, TN	2015	NA	30506	28534	1972	6.5
CN4706100000000	47	061	Grundy County, TN	2015	NA	4855	4477	378	7.8
CN4706300000000	47	063	Hamblen County, TN	2015	NA	26373	24735	1638	6.2
CN4706500000000	47	065	Hamilton County, TN	2015	NA	166750	157881	8869	5.3
CN4706700000000	47	067	Hancock County, TN	2015	NA	2057	1858	199	9.7
CN4706900000000	47	069	Hardeman County, TN	2015	NA	9258	8562	696	7.5
CN4707100000000	47	071	Hardin County, TN	2015	NA	10228	9492	736	7.2
CN4707300000000	47	073	Hawkins County, TN	2015	NA	23453	21952	1501	6.4
CN4707500000000	47	075	Haywood County, TN	2015	NA	7603	6966	637	8.4
CN4707700000000	47	077	Henderson County, TN	2015	NA	12233	11256	977	8
CN4707900000000	47	079	Henry County, TN	2015	NA	13829	12924	905	6.5
CN4708100000000	47	081	Hickman County, TN	2015	NA	10282	9697	585	5.7
CN4708300000000	47	083	Houston County, TN	2015	NA	3187	2912	275	8.6
CN4708500000000	47	085	Humphreys County, TN	2015	NA	8439	7868	571	6.8
CN4708700000000	47	087	Jackson County, TN	2015	NA	4449	4099	350	7.9
CN4708900000000	47	089	Jefferson County, TN	2015	NA	23216	21728	1488	6.4
CN4709100000000	47	091	Johnson County, TN	2015	NA	7284	6873	411	5.6
CN4709300000000	47	093	Knox County, TN	2015	NA	227624	216975	10649	4.7
CN4709500000000	47	095	Lake County, TN	2015	NA	1964	1796	168	8.6
CN4709700000000	47	097	Lauderdale County, TN	2015	NA	9564	8717	847	8.9
CN4709900000000	47	099	Lawrence County, TN	2015	NA	17660	16493	1167	6.6
CN4710100000000	47	101	Lewis County, TN	2015	NA	4788	4438	350	7.3
CN4710300000000	47	103	Lincoln County, TN	2015	NA	15090	14363	727	4.8
CN4710500000000	47	105	Loudon County, TN	2015	NA	21861	20635	1226	5.6
CN4710700000000	47	107	McMinn County, TN	2015	NA	22570	21141	1429	6.3
CN4710900000000	47	109	McNairy County, TN	2015	NA	8729	7987	742	8.5
CN4711100000000	47	111	Macon County, TN	2015	NA	9927	9400	527	5.3
CN4711300000000	47	113	Madison County, TN	2015	NA	46372	43639	2733	5.9
CN4711500000000	47	115	Marion County, TN	2015	NA	11674	10884	790	6.8
CN4711700000000	47	117	Marshall County, TN	2015	NA	14715	13890	825	5.6
CN4711900000000	47	119	Maury County, TN	2015	NA	42211	40045	2166	5.1
CN4712100000000	47	121	Meigs County, TN	2015	NA	4841	4471	370	7.6
CN4712300000000	47	123	Monroe County, TN	2015	NA	18981	17787	1194	6.3
CN4712500000000	47	125	Montgomery County, TN	2015	NA	78323	73759	4564	5.8
CN4712700000000	47	127	Moore County, TN	2015	NA	3294	3145	149	4.5
CN4712900000000	47	129	Morgan County, TN	2015	NA	7691	7115	576	7.5
CN4713100000000	47	131	Obion County, TN	2015	NA	12435	11362	1073	8.6
CN4713300000000	47	133	Overton County, TN	2015	NA	9059	8412	647	7.1
CN4713500000000	47	135	Perry County, TN	2015	NA	3109	2900	209	6.7
CN4713700000000	47	137	Pickett County, TN	2015	NA	2392	2208	184	7.7
CN4713900000000	47	139	Polk County, TN	2015	NA	7301	6819	482	6.6
CN4714100000000	47	141	Putnam County, TN	2015	NA	32336	30448	1888	5.8
CN4714300000000	47	143	Rhea County, TN	2015	NA	13047	12082	965	7.4
CN4714500000000	47	145	Roane County, TN	2015	NA	22505	21049	1456	6.5
CN4714700000000	47	147	Robertson County, TN	2015	NA	33701	32054	1647	4.9
CN4714900000000	47	149	Rutherford County, TN	2015	NA	155052	148094	6958	4.5
CN4715100000000	47	151	Scott County, TN	2015	NA	8053	7302	751	9.3
CN4715300000000	47	153	Sequatchie County, TN	2015	NA	5774	5399	375	6.5
CN4715500000000	47	155	Sevier County, TN	2015	NA	49683	46685	2998	6
CN4715700000000	47	157	Shelby County, TN	2015	NA	428547	401006	27541	6.4
CN4715900000000	47	159	Smith County, TN	2015	NA	8457	7982	475	5.6
CN4716100000000	47	161	Stewart County, TN	2015	NA	5122	4728	394	7.7
CN4716300000000	47	163	Sullivan County, TN	2015	NA	68918	64926	3992	5.8
CN4716500000000	47	165	Sumner County, TN	2015	NA	88284	84211	4073	4.6
CN4716700000000	47	167	Tipton County, TN	2015	NA	27398	25456	1942	7.1
CN4716900000000	47	169	Trousdale County, TN	2015	NA	3671	3454	217	5.9
CN4717100000000	47	171	Unicoi County, TN	2015	NA	7008	6449	559	8
CN4717300000000	47	173	Union County, TN	2015	NA	7195	6705	490	6.8
CN4717500000000	47	175	Van Buren County, TN	2015	NA	2047	1883	164	8
CN4717700000000	47	177	Warren County, TN	2015	NA	17743	16743	1000	5.6
CN4717900000000	47	179	Washington County, TN	2015	NA	57648	54437	3211	5.6
CN4718100000000	47	181	Wayne County, TN	2015	NA	6166	5709	457	7.4
CN4718300000000	47	183	Weakley County, TN	2015	NA	15541	14483	1058	6.8
CN4718500000000	47	185	White County, TN	2015	NA	11375	10685	690	6.1
CN4718700000000	47	187	Williamson County, TN	2015	NA	107210	102908	4302	4
CN4718900000000	47	189	Wilson County, TN	2015	NA	64400	61446	2954	4.6
CN4800100000000	48	001	Anderson County, TX	2015	NA	22848	21952	896	3.9
CN4800300000000	48	003	Andrews County, TX	2015	NA	9302	8979	323	3.5
CN4800500000000	48	005	Angelina County, TX	2015	NA	37400	35313	2087	5.6
CN4800700000000	48	007	Aransas County, TX	2015	NA	10061	9552	509	5.1
CN4800900000000	48	009	Archer County, TX	2015	NA	4123	3941	182	4.4
CN4801100000000	48	011	Armstrong County, TX	2015	NA	976	950	26	2.7
CN4801300000000	48	013	Atascosa County, TX	2015	NA	20539	19563	976	4.8
CN4801500000000	48	015	Austin County, TX	2015	NA	14044	13400	644	4.6
CN4801700000000	48	017	Bailey County, TX	2015	NA	2800	2680	120	4.3
CN4801900000000	48	019	Bandera County, TX	2015	NA	9180	8816	364	4
CN4802100000000	48	021	Bastrop County, TX	2015	NA	37544	36089	1455	3.9
CN4802300000000	48	023	Baylor County, TX	2015	NA	1627	1570	57	3.5
CN4802500000000	48	025	Bee County, TX	2015	NA	10381	9741	640	6.2
CN4802700000000	48	027	Bell County, TX	2015	NA	136297	129961	6336	4.6
CN4802900000000	48	029	Bexar County, TX	2015	NA	878969	845536	33433	3.8
CN4803100000000	48	031	Blanco County, TX	2015	NA	5768	5588	180	3.1
CN4803300000000	48	033	Borden County, TX	2015	NA	413	401	12	2.9
CN4803500000000	48	035	Bosque County, TX	2015	NA	8061	7700	361	4.5
CN4803700000000	48	037	Bowie County, TX	2015	NA	39158	37281	1877	4.8
CN4803900000000	48	039	Brazoria County, TX	2015	NA	167079	159444	7635	4.6
CN4804100000000	48	041	Brazos County, TX	2015	NA	108623	105030	3593	3.3
CN4804300000000	48	043	Brewster County, TX	2015	NA	3911	3757	154	3.9
CN4804500000000	48	045	Briscoe County, TX	2015	NA	595	572	23	3.9
CN4804700000000	48	047	Brooks County, TX	2015	NA	2603	2345	258	9.9
CN4804900000000	48	049	Brown County, TX	2015	NA	15895	15210	685	4.3
CN4805100000000	48	051	Burleson County, TX	2015	NA	7759	7422	337	4.3
CN4805300000000	48	053	Burnet County, TX	2015	NA	21179	20409	770	3.6
CN4805500000000	48	055	Caldwell County, TX	2015	NA	17427	16672	755	4.3
CN4805700000000	48	057	Calhoun County, TX	2015	NA	11330	10879	451	4
CN4805900000000	48	059	Callahan County, TX	2015	NA	5732	5488	244	4.3
CN4806100000000	48	061	Cameron County, TX	2015	NA	163095	151508	11587	7.1
CN4806300000000	48	063	Camp County, TX	2015	NA	5093	4781	312	6.1
CN4806500000000	48	065	Carson County, TX	2015	NA	3068	2970	98	3.2
CN4806700000000	48	067	Cass County, TX	2015	NA	12169	11344	825	6.8
CN4806900000000	48	069	Castro County, TX	2015	NA	3616	3494	122	3.4
CN4807100000000	48	071	Chambers County, TX	2015	NA	17809	16861	948	5.3
CN4807300000000	48	073	Cherokee County, TX	2015	NA	20901	19824	1077	5.2
CN4807500000000	48	075	Childress County, TX	2015	NA	2869	2780	89	3.1
CN4807700000000	48	077	Clay County, TX	2015	NA	4913	4698	215	4.4
CN4807900000000	48	079	Cochran County, TX	2015	NA	1318	1251	67	5.1
CN4808100000000	48	081	Coke County, TX	2015	NA	1399	1342	57	4.1
CN4808300000000	48	083	Coleman County, TX	2015	NA	3050	2881	169	5.5
CN4808500000000	48	085	Collin County, TX	2015	NA	488708	470996	17712	3.6
CN4808700000000	48	087	Collingsworth County, TX	2015	NA	1270	1224	46	3.6
CN4808900000000	48	089	Colorado County, TX	2015	NA	9908	9518	390	3.9
CN4809100000000	48	091	Comal County, TX	2015	NA	61901	59633	2268	3.7
CN4809300000000	48	093	Comanche County, TX	2015	NA	5359	5132	227	4.2
CN4809500000000	48	095	Concho County, TX	2015	NA	1374	1329	45	3.3
CN4809700000000	48	097	Cooke County, TX	2015	NA	19771	19043	728	3.7
CN4809900000000	48	099	Coryell County, TX	2015	NA	24508	23342	1166	4.8
CN4810100000000	48	101	Cottle County, TX	2015	NA	546	507	39	7.1
CN4810300000000	48	103	Crane County, TX	2015	NA	1837	1732	105	5.7
CN4810500000000	48	105	Crockett County, TX	2015	NA	1901	1787	114	6
CN4810700000000	48	107	Crosby County, TX	2015	NA	2648	2534	114	4.3
CN4810900000000	48	109	Culberson County, TX	2015	NA	1040	997	43	4.1
CN4811100000000	48	111	Dallam County, TX	2015	NA	4008	3921	87	2.2
CN4811300000000	48	113	Dallas County, TX	2015	NA	1262949	1209003	53946	4.3
CN4811500000000	48	115	Dawson County, TX	2015	NA	4773	4557	216	4.5
CN4811700000000	48	117	Deaf Smith County, TX	2015	NA	8797	8520	277	3.1
CN4811900000000	48	119	Delta County, TX	2015	NA	2593	2476	117	4.5
CN4812100000000	48	121	Denton County, TX	2015	NA	428582	413370	15212	3.5
CN4812300000000	48	123	DeWitt County, TX	2015	NA	10055	9655	400	4
CN4812500000000	48	125	Dickens County, TX	2015	NA	703	671	32	4.6
CN4812700000000	48	127	Dimmit County, TX	2015	NA	7162	6831	331	4.6
CN4812900000000	48	129	Donley County, TX	2015	NA	1593	1527	66	4.1
CN4813100000000	48	131	Duval County, TX	2015	NA	5239	4816	423	8.1
CN4813300000000	48	133	Eastland County, TX	2015	NA	8041	7660	381	4.7
CN4813500000000	48	135	Ector County, TX	2015	NA	79785	76087	3698	4.6
CN4813700000000	48	137	Edwards County, TX	2015	NA	865	825	40	4.6
CN4813900000000	48	139	Ellis County, TX	2015	NA	80960	77778	3182	3.9
CN4814100000000	48	141	El Paso County, TX	2015	NA	341643	324011	17632	5.2
CN4814300000000	48	143	Erath County, TX	2015	NA	20165	19375	790	3.9
CN4814500000000	48	145	Falls County, TX	2015	NA	6455	6182	273	4.2
CN4814700000000	48	147	Fannin County, TX	2015	NA	15377	14748	629	4.1
CN4814900000000	48	149	Fayette County, TX	2015	NA	12776	12353	423	3.3
CN4815100000000	48	151	Fisher County, TX	2015	NA	1800	1731	69	3.8
CN4815300000000	48	153	Floyd County, TX	2015	NA	2746	2594	152	5.5
CN4815500000000	48	155	Foard County, TX	2015	NA	551	529	22	4
CN4815700000000	48	157	Fort Bend County, TX	2015	NA	355917	340780	15137	4.3
CN4815900000000	48	159	Franklin County, TX	2015	NA	4556	4335	221	4.9
CN4816100000000	48	161	Freestone County, TX	2015	NA	7412	7011	401	5.4
CN4816300000000	48	163	Frio County, TX	2015	NA	9805	9430	375	3.8
CN4816500000000	48	165	Gaines County, TX	2015	NA	9407	9103	304	3.2
CN4816700000000	48	167	Galveston County, TX	2015	NA	157960	150103	7857	5
CN4816900000000	48	169	Garza County, TX	2015	NA	2131	2053	78	3.7
CN4817100000000	48	171	Gillespie County, TX	2015	NA	12646	12283	363	2.9
CN4817300000000	48	173	Glasscock County, TX	2015	NA	822	799	23	2.8
CN4817500000000	48	175	Goliad County, TX	2015	NA	3448	3295	153	4.4
CN4817700000000	48	177	Gonzales County, TX	2015	NA	9702	9346	356	3.7
CN4817900000000	48	179	Gray County, TX	2015	NA	9276	8756	520	5.6
CN4818100000000	48	181	Grayson County, TX	2015	NA	60005	57590	2415	4
CN4818300000000	48	183	Gregg County, TX	2015	NA	59290	56357	2933	4.9
CN4818500000000	48	185	Grimes County, TX	2015	NA	11514	10902	612	5.3
CN4818700000000	48	187	Guadalupe County, TX	2015	NA	72953	70383	2570	3.5
CN4818900000000	48	189	Hale County, TX	2015	NA	12889	12072	817	6.3
CN4819100000000	48	191	Hall County, TX	2015	NA	1204	1140	64	5.3
CN4819300000000	48	193	Hamilton County, TX	2015	NA	3484	3322	162	4.6
CN4819500000000	48	195	Hansford County, TX	2015	NA	3112	3020	92	3
CN4819700000000	48	197	Hardeman County, TX	2015	NA	1621	1542	79	4.9
CN4819900000000	48	199	Hardin County, TX	2015	NA	24994	23586	1408	5.6
CN4820100000000	48	201	Harris County, TX	2015	NA	2234702	2131167	103535	4.6
CN4820300000000	48	203	Harrison County, TX	2015	NA	31207	29581	1626	5.2
CN4820500000000	48	205	Hartley County, TX	2015	NA	3004	2940	64	2.1
CN4820700000000	48	207	Haskell County, TX	2015	NA	2583	2493	90	3.5
CN4820900000000	48	209	Hays County, TX	2015	NA	98479	95110	3369	3.4
CN4821100000000	48	211	Hemphill County, TX	2015	NA	2302	2230	72	3.1
CN4821300000000	48	213	Henderson County, TX	2015	NA	34373	32706	1667	4.8
CN4821500000000	48	215	Hidalgo County, TX	2015	NA	330912	304749	26163	7.9
CN4821700000000	48	217	Hill County, TX	2015	NA	15618	14909	709	4.5
CN4821900000000	48	219	Hockley County, TX	2015	NA	11721	11235	486	4.1
CN4822100000000	48	221	Hood County, TX	2015	NA	24538	23434	1104	4.5
CN4822300000000	48	223	Hopkins County, TX	2015	NA	17015	16301	714	4.2
CN4822500000000	48	225	Houston County, TX	2015	NA	9938	9496	442	4.4
CN4822700000000	48	227	Howard County, TX	2015	NA	13358	12744	614	4.6
CN4822900000000	48	229	Hudspeth County, TX	2015	NA	1281	1209	72	5.6
CN4823100000000	48	231	Hunt County, TX	2015	NA	38913	37077	1836	4.7
CN4823300000000	48	233	Hutchinson County, TX	2015	NA	9799	9368	431	4.4
CN4823500000000	48	235	Irion County, TX	2015	NA	799	770	29	3.6
CN4823700000000	48	237	Jack County, TX	2015	NA	4079	3907	172	4.2
CN4823900000000	48	239	Jackson County, TX	2015	NA	7369	7093	276	3.7
CN4824100000000	48	241	Jasper County, TX	2015	NA	13879	12844	1035	7.5
CN4824300000000	48	243	Jeff Davis County, TX	2015	NA	1080	1045	35	3.2
CN4824500000000	48	245	Jefferson County, TX	2015	NA	107975	100467	7508	7
CN4824700000000	48	247	Jim Hogg County, TX	2015	NA	2028	1882	146	7.2
CN4824900000000	48	249	Jim Wells County, TX	2015	NA	19221	17706	1515	7.9
CN4825100000000	48	251	Johnson County, TX	2015	NA	74300	71044	3256	4.4
CN4825300000000	48	253	Jones County, TX	2015	NA	5669	5358	311	5.5
CN4825500000000	48	255	Karnes County, TX	2015	NA	6427	6156	271	4.2
CN4825700000000	48	257	Kaufman County, TX	2015	NA	55070	52832	2238	4.1
CN4825900000000	48	259	Kendall County, TX	2015	NA	19164	18536	628	3.3
CN4826100000000	48	261	Kenedy County, TX	2015	NA	283	274	9	3.2
CN4826300000000	48	263	Kent County, TX	2015	NA	498	485	13	2.6
CN4826500000000	48	265	Kerr County, TX	2015	NA	21183	20406	777	3.7
CN4826700000000	48	267	Kimble County, TX	2015	NA	2000	1927	73	3.7
CN4826900000000	48	269	King County, TX	2015	NA	200	193	7	3.5
CN4827100000000	48	271	Kinney County, TX	2015	NA	1185	1110	75	6.3
CN4827300000000	48	273	Kleberg County, TX	2015	NA	14398	13550	848	5.9
CN4827500000000	48	275	Knox County, TX	2015	NA	1682	1619	63	3.7
CN4827700000000	48	277	Lamar County, TX	2015	NA	22186	21128	1058	4.8
CN4827900000000	48	279	Lamb County, TX	2015	NA	5509	5018	491	8.9
CN4828100000000	48	281	Lampasas County, TX	2015	NA	9057	8660	397	4.4
CN4828300000000	48	283	La Salle County, TX	2015	NA	4269	4092	177	4.1
CN4828500000000	48	285	Lavaca County, TX	2015	NA	8807	8474	333	3.8
CN4828700000000	48	287	Lee County, TX	2015	NA	9303	8973	330	3.5
CN4828900000000	48	289	Leon County, TX	2015	NA	6933	6564	369	5.3
CN4829100000000	48	291	Liberty County, TX	2015	NA	30951	28818	2133	6.9
CN4829300000000	48	293	Limestone County, TX	2015	NA	8580	8151	429	5
CN4829500000000	48	295	Lipscomb County, TX	2015	NA	1724	1657	67	3.9
CN4829700000000	48	297	Live Oak County, TX	2015	NA	5891	5655	236	4
CN4829900000000	48	299	Llano County, TX	2015	NA	8150	7805	345	4.2
CN4830100000000	48	301	Loving County, TX	2015	NA	77	73	4	5.2
CN4830300000000	48	303	Lubbock County, TX	2015	NA	149605	144524	5081	3.4
CN4830500000000	48	305	Lynn County, TX	2015	NA	2763	2652	111	4
CN4830700000000	48	307	McCulloch County, TX	2015	NA	3923	3735	188	4.8
CN4830900000000	48	309	McLennan County, TX	2015	NA	112586	108012	4574	4.1
CN4831100000000	48	311	McMullen County, TX	2015	NA	969	949	20	2.1
CN4831300000000	48	313	Madison County, TX	2015	NA	5118	4898	220	4.3
CN4831500000000	48	315	Marion County, TX	2015	NA	4414	4128	286	6.5
CN4831700000000	48	317	Martin County, TX	2015	NA	2585	2494	91	3.5
CN4831900000000	48	319	Mason County, TX	2015	NA	1804	1735	69	3.8
CN4832100000000	48	321	Matagorda County, TX	2015	NA	17179	16023	1156	6.7
CN4832300000000	48	323	Maverick County, TX	2015	NA	23643	21129	2514	10.6
CN4832500000000	48	325	Medina County, TX	2015	NA	20425	19534	891	4.4
CN4832700000000	48	327	Menard County, TX	2015	NA	857	813	44	5.1
CN4832900000000	48	329	Midland County, TX	2015	NA	88395	85342	3053	3.5
CN4833100000000	48	331	Milam County, TX	2015	NA	10122	9593	529	5.2
CN4833300000000	48	333	Mills County, TX	2015	NA	1990	1917	73	3.7
CN4833500000000	48	335	Mitchell County, TX	2015	NA	2744	2590	154	5.6
CN4833700000000	48	337	Montague County, TX	2015	NA	9706	9295	411	4.2
CN4833900000000	48	339	Montgomery County, TX	2015	NA	258253	247310	10943	4.2
CN4834100000000	48	341	Moore County, TX	2015	NA	11113	10767	346	3.1
CN4834300000000	48	343	Morris County, TX	2015	NA	5314	4848	466	8.8
CN4834500000000	48	345	Motley County, TX	2015	NA	492	475	17	3.5
CN4834700000000	48	347	Nacogdoches County, TX	2015	NA	28134	26816	1318	4.7
CN4834900000000	48	349	Navarro County, TX	2015	NA	22891	21930	961	4.2
CN4835100000000	48	351	Newton County, TX	2015	NA	5368	4965	403	7.5
CN4835300000000	48	353	Nolan County, TX	2015	NA	6914	6635	279	4
CN4835500000000	48	355	Nueces County, TX	2015	NA	165837	157657	8180	4.9
CN4835700000000	48	357	Ochiltree County, TX	2015	NA	5273	5049	224	4.2
CN4835900000000	48	359	Oldham County, TX	2015	NA	914	887	27	3
CN4836100000000	48	361	Orange County, TX	2015	NA	37188	34762	2426	6.5
CN4836300000000	48	363	Palo Pinto County, TX	2015	NA	13168	12484	684	5.2
CN4836500000000	48	365	Panola County, TX	2015	NA	11572	10968	604	5.2
CN4836700000000	48	367	Parker County, TX	2015	NA	59575	57105	2470	4.1
CN4836900000000	48	369	Parmer County, TX	2015	NA	4969	4852	117	2.4
CN4837100000000	48	371	Pecos County, TX	2015	NA	6867	6513	354	5.2
CN4837300000000	48	373	Polk County, TX	2015	NA	17042	16012	1030	6
CN4837500000000	48	375	Potter County, TX	2015	NA	56262	54392	1870	3.3
CN4837700000000	48	377	Presidio County, TX	2015	NA	3115	2784	331	10.6
CN4837900000000	48	379	Rains County, TX	2015	NA	5412	5166	246	4.5
CN4838100000000	48	381	Randall County, TX	2015	NA	69101	67104	1997	2.9
CN4838300000000	48	383	Reagan County, TX	2015	NA	1929	1842	87	4.5
CN4838500000000	48	385	Real County, TX	2015	NA	1064	1009	55	5.2
CN4838700000000	48	387	Red River County, TX	2015	NA	4910	4601	309	6.3
CN4838900000000	48	389	Reeves County, TX	2015	NA	5679	5407	272	4.8
CN4839100000000	48	391	Refugio County, TX	2015	NA	3307	3131	176	5.3
CN4839300000000	48	393	Roberts County, TX	2015	NA	456	438	18	3.9
CN4839500000000	48	395	Robertson County, TX	2015	NA	7249	6904	345	4.8
CN4839700000000	48	397	Rockwall County, TX	2015	NA	44906	43224	1682	3.7
CN4839900000000	48	399	Runnels County, TX	2015	NA	4671	4498	173	3.7
CN4840100000000	48	401	Rusk County, TX	2015	NA	22847	21762	1085	4.7
CN4840300000000	48	403	Sabine County, TX	2015	NA	3501	3176	325	9.3
CN4840500000000	48	405	San Augustine County, TX	2015	NA	2799	2546	253	9
CN4840700000000	48	407	San Jacinto County, TX	2015	NA	11292	10659	633	5.6
CN4840900000000	48	409	San Patricio County, TX	2015	NA	30235	28269	1966	6.5
CN4841100000000	48	411	San Saba County, TX	2015	NA	2246	2164	82	3.7
CN4841300000000	48	413	Schleicher County, TX	2015	NA	1501	1422	79	5.3
CN4841500000000	48	415	Scurry County, TX	2015	NA	8169	7831	338	4.1
CN4841700000000	48	417	Shackelford County, TX	2015	NA	2083	2024	59	2.8
CN4841900000000	48	419	Shelby County, TX	2015	NA	11380	10782	598	5.3
CN4842100000000	48	421	Sherman County, TX	2015	NA	1421	1382	39	2.7
CN4842300000000	48	423	Smith County, TX	2015	NA	103748	99116	4632	4.5
CN4842500000000	48	425	Somervell County, TX	2015	NA	4111	3905	206	5
CN4842700000000	48	427	Starr County, TX	2015	NA	25879	22399	3480	13.4
CN4842900000000	48	429	Stephens County, TX	2015	NA	4107	3936	171	4.2
CN4843100000000	48	431	Sterling County, TX	2015	NA	747	722	25	3.3
CN4843300000000	48	433	Stonewall County, TX	2015	NA	663	634	29	4.4
CN4843500000000	48	435	Sutton County, TX	2015	NA	1719	1615	104	6.1
CN4843700000000	48	437	Swisher County, TX	2015	NA	2733	2603	130	4.8
CN4843900000000	48	439	Tarrant County, TX	2015	NA	991642	950457	41185	4.2
CN4844100000000	48	441	Taylor County, TX	2015	NA	63362	61042	2320	3.7
CN4844300000000	48	443	Terrell County, TX	2015	NA	435	414	21	4.8
CN4844500000000	48	445	Terry County, TX	2015	NA	5403	5151	252	4.7
CN4844700000000	48	447	Throckmorton County, TX	2015	NA	781	756	25	3.2
CN4844900000000	48	449	Titus County, TX	2015	NA	12736	12004	732	5.7
CN4845100000000	48	451	Tom Green County, TX	2015	NA	54556	52322	2234	4.1
CN4845300000000	48	453	Travis County, TX	2015	NA	655804	634333	21471	3.3
CN4845500000000	48	455	Trinity County, TX	2015	NA	5482	5160	322	5.9
CN4845700000000	48	457	Tyler County, TX	2015	NA	7367	6852	515	7
CN4845900000000	48	459	Upshur County, TX	2015	NA	17978	17036	942	5.2
CN4846100000000	48	461	Upton County, TX	2015	NA	1785	1715	70	3.9
CN4846300000000	48	463	Uvalde County, TX	2015	NA	11683	11095	588	5
CN4846500000000	48	465	Val Verde County, TX	2015	NA	19573	18401	1172	6
CN4846700000000	48	467	Van Zandt County, TX	2015	NA	24214	23128	1086	4.5
CN4846900000000	48	469	Victoria County, TX	2015	NA	45340	43445	1895	4.2
CN4847100000000	48	471	Walker County, TX	2015	NA	22979	21820	1159	5
CN4847300000000	48	473	Waller County, TX	2015	NA	21664	20626	1038	4.8
CN4847500000000	48	475	Ward County, TX	2015	NA	5914	5661	253	4.3
CN4847700000000	48	477	Washington County, TX	2015	NA	15361	14631	730	4.8
CN4847900000000	48	479	Webb County, TX	2015	NA	111798	106521	5277	4.7
CN4848100000000	48	481	Wharton County, TX	2015	NA	21233	20298	935	4.4
CN4848300000000	48	483	Wheeler County, TX	2015	NA	2821	2712	109	3.9
CN4848500000000	48	485	Wichita County, TX	2015	NA	55334	52967	2367	4.3
CN4848700000000	48	487	Wilbarger County, TX	2015	NA	5110	4864	246	4.8
CN4848900000000	48	489	Willacy County, TX	2015	NA	6747	5869	878	13
CN4849100000000	48	491	Williamson County, TX	2015	NA	264046	254946	9100	3.4
CN4849300000000	48	493	Wilson County, TX	2015	NA	22977	22107	870	3.8
CN4849500000000	48	495	Winkler County, TX	2015	NA	3104	2927	177	5.7
CN4849700000000	48	497	Wise County, TX	2015	NA	28677	27350	1327	4.6
CN4849900000000	48	499	Wood County, TX	2015	NA	16764	15876	888	5.3
CN4850100000000	48	501	Yoakum County, TX	2015	NA	4047	3895	152	3.8
CN4850300000000	48	503	Young County, TX	2015	NA	8470	8110	360	4.3
CN4850500000000	48	505	Zapata County, TX	2015	NA	6191	5719	472	7.6
CN4850700000000	48	507	Zavala County, TX	2015	NA	3807	3382	425	11.2
CN4900100000000	49	001	Beaver County, UT	2015	NA	3115	2997	118	3.8
CN4900300000000	49	003	Box Elder County, UT	2015	NA	23965	23077	888	3.7
CN4900500000000	49	005	Cache County, UT	2015	NA	60008	58164	1844	3.1
CN4900700000000	49	007	Carbon County, UT	2015	NA	8706	8209	497	5.7
CN4900900000000	49	009	Daggett County, UT	2015	NA	467	445	22	4.7
CN4901100000000	49	011	Davis County, UT	2015	NA	159878	154456	5422	3.4
CN4901300000000	49	013	Duchesne County, UT	2015	NA	8805	8140	665	7.6
CN4901500000000	49	015	Emery County, UT	2015	NA	4400	4133	267	6.1
CN4901700000000	49	017	Garfield County, UT	2015	NA	2754	2508	246	8.9
CN4901900000000	49	019	Grand County, UT	2015	NA	5609	5267	342	6.1
CN4902100000000	49	021	Iron County, UT	2015	NA	20321	19415	906	4.5
CN4902300000000	49	023	Juab County, UT	2015	NA	4935	4739	196	4
CN4902500000000	49	025	Kane County, UT	2015	NA	3623	3463	160	4.4
CN4902700000000	49	027	Millard County, UT	2015	NA	6121	5906	215	3.5
CN4902900000000	49	029	Morgan County, UT	2015	NA	4925	4771	154	3.1
CN4903100000000	49	031	Piute County, UT	2015	NA	465	435	30	6.5
CN4903300000000	49	033	Rich County, UT	2015	NA	1045	1007	38	3.6
CN4903500000000	49	035	Salt Lake County, UT	2015	NA	585134	565279	19855	3.4
CN4903700000000	49	037	San Juan County, UT	2015	NA	5715	5263	452	7.9
CN4903900000000	49	039	Sanpete County, UT	2015	NA	11412	10939	473	4.1
CN4904100000000	49	041	Sevier County, UT	2015	NA	9506	9081	425	4.5
CN4904300000000	49	043	Summit County, UT	2015	NA	23057	22292	765	3.3
CN4904500000000	49	045	Tooele County, UT	2015	NA	29520	28294	1226	4.2
CN4904700000000	49	047	Uintah County, UT	2015	NA	15298	14254	1044	6.8
CN4904900000000	49	049	Utah County, UT	2015	NA	265907	257217	8690	3.3
CN4905100000000	49	051	Wasatch County, UT	2015	NA	13251	12784	467	3.5
CN4905300000000	49	053	Washington County, UT	2015	NA	63625	61023	2602	4.1
CN4905500000000	49	055	Wayne County, UT	2015	NA	1413	1285	128	9.1
CN4905700000000	49	057	Weber County, UT	2015	NA	117158	112346	4812	4.1
CN5000100000000	50	001	Addison County, VT	2015	NA	20693	19978	715	3.5
CN5000300000000	50	003	Bennington County, VT	2015	NA	18573	17793	780	4.2
CN5000500000000	50	005	Caledonia County, VT	2015	NA	15079	14380	699	4.6
CN5000700000000	50	007	Chittenden County, VT	2015	NA	94862	92292	2570	2.7
CN5000900000000	50	009	Essex County, VT	2015	NA	2756	2598	158	5.7
CN5001100000000	50	011	Franklin County, VT	2015	NA	27296	26326	970	3.6
CN5001300000000	50	013	Grand Isle County, VT	2015	NA	3935	3778	157	4
CN5001500000000	50	015	Lamoille County, VT	2015	NA	13776	13139	637	4.6
CN5001700000000	50	017	Orange County, VT	2015	NA	15893	15350	543	3.4
CN5001900000000	50	019	Orleans County, VT	2015	NA	13591	12837	754	5.5
CN5002100000000	50	021	Rutland County, VT	2015	NA	31271	29946	1325	4.2
CN5002300000000	50	023	Washington County, VT	2015	NA	34057	32872	1185	3.5
CN5002500000000	50	025	Windham County, VT	2015	NA	23453	22620	833	3.6
CN5002700000000	50	027	Windsor County, VT	2015	NA	29464	28521	943	3.2
CN5100100000000	51	001	Accomack County, VA	2015	NA	15877	15011	866	5.5
CN5100300000000	51	003	Albemarle County, VA	2015	NA	53910	51806	2104	3.9
CN5100500000000	51	005	Alleghany County, VA	2015	NA	7048	6691	357	5.1
CN5100700000000	51	007	Amelia County, VA	2015	NA	6190	5913	277	4.5
CN5100900000000	51	009	Amherst County, VA	2015	NA	15277	14548	729	4.8
CN5101100000000	51	011	Appomattox County, VA	2015	NA	7037	6693	344	4.9
CN5101300000000	51	013	Arlington County, VA	2015	NA	144273	140209	4064	2.8
CN5101500000000	51	015	Augusta County, VA	2015	NA	36639	35136	1503	4.1
CN5101700000000	51	017	Bath County, VA	2015	NA	2536	2433	103	4.1
CN5101900000000	51	019	Bedford County, VA	2015	NA	38224	36528	1696	4.4
CN5102100000000	51	021	Bland County, VA	2015	NA	2781	2623	158	5.7
CN5102300000000	51	023	Botetourt County, VA	2015	NA	17387	16658	729	4.2
CN5102500000000	51	025	Brunswick County, VA	2015	NA	6331	5900	431	6.8
CN5102700000000	51	027	Buchanan County, VA	2015	NA	7276	6486	790	10.9
CN5102900000000	51	029	Buckingham County, VA	2015	NA	6292	5919	373	5.9
CN5103100000000	51	031	Campbell County, VA	2015	NA	26222	24981	1241	4.7
CN5103300000000	51	033	Caroline County, VA	2015	NA	14731	13980	751	5.1
CN5103500000000	51	035	Carroll County, VA	2015	NA	13048	12350	698	5.3
CN5103600000000	51	036	Charles City County, VA	2015	NA	3716	3518	198	5.3
CN5103700000000	51	037	Charlotte County, VA	2015	NA	5250	4951	299	5.7
CN5104100000000	51	041	Chesterfield County, VA	2015	NA	177940	170275	7665	4.3
CN5104300000000	51	043	Clarke County, VA	2015	NA	7430	7134	296	4
CN5104500000000	51	045	Craig County, VA	2015	NA	2380	2249	131	5.5
CN5104700000000	51	047	Culpeper County, VA	2015	NA	23101	22097	1004	4.3
CN5104900000000	51	049	Cumberland County, VA	2015	NA	4554	4320	234	5.1
CN5105100000000	51	051	Dickenson County, VA	2015	NA	4911	4415	496	10.1
CN5105300000000	51	053	Dinwiddie County, VA	2015	NA	13309	12588	721	5.4
CN5105700000000	51	057	Essex County, VA	2015	NA	5511	5214	297	5.4
CN5105900000000	51	059	Fairfax County, VA	2015	NA	613577	591667	21910	3.6
CN5106100000000	51	061	Fauquier County, VA	2015	NA	35723	34313	1410	3.9
CN5106300000000	51	063	Floyd County, VA	2015	NA	8291	7961	330	4
CN5106500000000	51	065	Fluvanna County, VA	2015	NA	13158	12663	495	3.8
CN5106700000000	51	067	Franklin County, VA	2015	NA	26442	25207	1235	4.7
CN5106900000000	51	069	Frederick County, VA	2015	NA	44609	42838	1771	4
CN5107100000000	51	071	Giles County, VA	2015	NA	7942	7531	411	5.2
CN5107300000000	51	073	Gloucester County, VA	2015	NA	19089	18311	778	4.1
CN5107500000000	51	075	Goochland County, VA	2015	NA	10615	10171	444	4.2
CN5107700000000	51	077	Grayson County, VA	2015	NA	7045	6628	417	5.9
CN5107900000000	51	079	Greene County, VA	2015	NA	9846	9480	366	3.7
CN5108100000000	51	081	Greensville County, VA	2015	NA	4172	3947	225	5.4
CN5108300000000	51	083	Halifax County, VA	2015	NA	15197	14231	966	6.4
CN5108500000000	51	085	Hanover County, VA	2015	NA	56229	54048	2181	3.9
CN5108700000000	51	087	Henrico County, VA	2015	NA	176904	169302	7602	4.3
CN5108900000000	51	089	Henry County, VA	2015	NA	22351	20918	1433	6.4
CN5109100000000	51	091	Highland County, VA	2015	NA	1339	1292	47	3.5
CN5109300000000	51	093	Isle of Wight County, VA	2015	NA	18799	17940	859	4.6
CN5109500000000	51	095	James City County, VA	2015	NA	34289	32803	1486	4.3
CN5109700000000	51	097	King and Queen County, VA	2015	NA	3630	3455	175	4.8
CN5109900000000	51	099	King George County, VA	2015	NA	12052	11478	574	4.8
CN5110100000000	51	101	King William County, VA	2015	NA	8703	8335	368	4.2
CN5110300000000	51	103	Lancaster County, VA	2015	NA	5130	4791	339	6.6
CN5110500000000	51	105	Lee County, VA	2015	NA	8572	7952	620	7.2
CN5110700000000	51	107	Loudoun County, VA	2015	NA	200040	192906	7134	3.6
CN5110900000000	51	109	Louisa County, VA	2015	NA	18789	17992	797	4.2
CN5111100000000	51	111	Lunenburg County, VA	2015	NA	5284	5014	270	5.1
CN5111300000000	51	113	Madison County, VA	2015	NA	7223	6977	246	3.4
CN5111500000000	51	115	Mathews County, VA	2015	NA	4073	3901	172	4.2
CN5111700000000	51	117	Mecklenburg County, VA	2015	NA	12513	11747	766	6.1
CN5111900000000	51	119	Middlesex County, VA	2015	NA	4980	4769	211	4.2
CN5112100000000	51	121	Montgomery County, VA	2015	NA	49719	47570	2149	4.3
CN5112500000000	51	125	Nelson County, VA	2015	NA	7266	6970	296	4.1
CN5112700000000	51	127	New Kent County, VA	2015	NA	11212	10784	428	3.8
CN5113100000000	51	131	Northampton County, VA	2015	NA	6097	5724	373	6.1
CN5113300000000	51	133	Northumberland County, VA	2015	NA	5463	5129	334	6.1
CN5113500000000	51	135	Nottoway County, VA	2015	NA	7129	6806	323	4.5
CN5113700000000	51	137	Orange County, VA	2015	NA	16052	15314	738	4.6
CN5113900000000	51	139	Page County, VA	2015	NA	11642	10840	802	6.9
CN5114100000000	51	141	Patrick County, VA	2015	NA	7638	7224	414	5.4
CN5114300000000	51	143	Pittsylvania County, VA	2015	NA	30067	28470	1597	5.3
CN5114500000000	51	145	Powhatan County, VA	2015	NA	13387	12854	533	4
CN5114700000000	51	147	Prince Edward County, VA	2015	NA	10056	9427	629	6.3
CN5114900000000	51	149	Prince George County, VA	2015	NA	14871	14066	805	5.4
CN5115300000000	51	153	Prince William County, VA	2015	NA	231335	221769	9566	4.1
CN5115500000000	51	155	Pulaski County, VA	2015	NA	16307	15482	825	5.1
CN5115700000000	51	157	Rappahannock County, VA	2015	NA	3734	3579	155	4.2
CN5115900000000	51	159	Richmond County, VA	2015	NA	3899	3721	178	4.6
CN5116100000000	51	161	Roanoke County, VA	2015	NA	49067	47139	1928	3.9
CN5116300000000	51	163	Rockbridge County, VA	2015	NA	10321	9835	486	4.7
CN5116500000000	51	165	Rockingham County, VA	2015	NA	40106	38455	1651	4.1
CN5116700000000	51	167	Russell County, VA	2015	NA	11422	10672	750	6.6
CN5116900000000	51	169	Scott County, VA	2015	NA	9499	9009	490	5.2
CN5117100000000	51	171	Shenandoah County, VA	2015	NA	21032	20134	898	4.3
CN5117300000000	51	173	Smyth County, VA	2015	NA	13459	12581	878	6.5
CN5117500000000	51	175	Southampton County, VA	2015	NA	9196	8827	369	4
CN5117700000000	51	177	Spotsylvania County, VA	2015	NA	63796	60836	2960	4.6
CN5117900000000	51	179	Stafford County, VA	2015	NA	66644	63671	2973	4.5
CN5118100000000	51	181	Surry County, VA	2015	NA	3716	3528	188	5.1
CN5118300000000	51	183	Sussex County, VA	2015	NA	4072	3793	279	6.9
CN5118500000000	51	185	Tazewell County, VA	2015	NA	16610	15381	1229	7.4
CN5118700000000	51	187	Warren County, VA	2015	NA	19617	18683	934	4.8
CN5119100000000	51	191	Washington County, VA	2015	NA	26976	25681	1295	4.8
CN5119300000000	51	193	Westmoreland County, VA	2015	NA	8919	8438	481	5.4
CN5119500000000	51	195	Wise County, VA	2015	NA	13782	12640	1142	8.3
CN5119700000000	51	197	Wythe County, VA	2015	NA	13641	12900	741	5.4
CN5119900000000	51	199	York County, VA	2015	NA	31988	30616	1372	4.3
CN5151000000000	51	510	Alexandria city, VA	2015	NA	94147	91049	3098	3.3
CN5152000000000	51	520	Bristol city, VA	2015	NA	7512	7109	403	5.4
CN5153000000000	51	530	Buena Vista city, VA	2015	NA	3293	3126	167	5.1
CN5154000000000	51	540	Charlottesville city, VA	2015	NA	24643	23733	910	3.7
CN5155000000000	51	550	Chesapeake city, VA	2015	NA	116301	111019	5282	4.5
CN5157000000000	51	570	Colonial Heights city, VA	2015	NA	8665	8256	409	4.7
CN5158000000000	51	580	Covington city, VA	2015	NA	2418	2272	146	6
CN5159000000000	51	590	Danville city, VA	2015	NA	19114	17734	1380	7.2
CN5159500000000	51	595	Emporia city, VA	2015	NA	2244	2088	156	7
CN5160000000000	51	600	Fairfax city, VA	2015	NA	12798	12350	448	3.5
CN5161000000000	51	610	Falls Church city, VA	2015	NA	7843	7604	239	3
CN5162000000000	51	620	Franklin city, VA	2015	NA	3608	3366	242	6.7
CN5163000000000	51	630	Fredericksburg city, VA	2015	NA	13366	12652	714	5.3
CN5164000000000	51	640	Galax city, VA	2015	NA	2945	2784	161	5.5
CN5165000000000	51	650	Hampton city, VA	2015	NA	64253	60393	3860	6
CN5166000000000	51	660	Harrisonburg city, VA	2015	NA	23881	22613	1268	5.3
CN5167000000000	51	670	Hopewell city, VA	2015	NA	9619	8890	729	7.6
CN5167800000000	51	678	Lexington city, VA	2015	NA	2252	2098	154	6.8
CN5168000000000	51	680	Lynchburg city, VA	2015	NA	35625	33630	1995	5.6
CN5168300000000	51	683	Manassas city, VA	2015	NA	21592	20695	897	4.2
CN5168500000000	51	685	Manassas Park city, VA	2015	NA	8333	7984	349	4.2
CN5169000000000	51	690	Martinsville city, VA	2015	NA	5356	4885	471	8.8
CN5170000000000	51	700	Newport News city, VA	2015	NA	88801	83967	4834	5.4
CN5171000000000	51	710	Norfolk city, VA	2015	NA	110513	104340	6173	5.6
CN5172000000000	51	720	Norton city, VA	2015	NA	1732	1612	120	6.9
CN5173000000000	51	730	Petersburg city, VA	2015	NA	13501	12262	1239	9.2
CN5173500000000	51	735	Poquoson city, VA	2015	NA	6200	5960	240	3.9
CN5174000000000	51	740	Portsmouth city, VA	2015	NA	44248	41490	2758	6.2
CN5175000000000	51	750	Radford city, VA	2015	NA	8291	7822	469	5.7
CN5176000000000	51	760	Richmond city, VA	2015	NA	112693	106812	5881	5.2
CN5177000000000	51	770	Roanoke city, VA	2015	NA	48900	46506	2394	4.9
CN5177500000000	51	775	Salem city, VA	2015	NA	12764	12200	564	4.4
CN5179000000000	51	790	Staunton city, VA	2015	NA	11809	11295	514	4.4
CN5180000000000	51	800	Suffolk city, VA	2015	NA	42287	40188	2099	5
CN5181000000000	51	810	Virginia Beach city, VA	2015	NA	228751	218937	9814	4.3
CN5182000000000	51	820	Waynesboro city, VA	2015	NA	10009	9530	479	4.8
CN5183000000000	51	830	Williamsburg city, VA	2015	NA	6657	6235	422	6.3
CN5184000000000	51	840	Winchester city, VA	2015	NA	14198	13575	623	4.4
CN5300100000000	53	001	Adams County, WA	2015	NA	8604	7997	607	7.1
CN5300300000000	53	003	Asotin County, WA	2015	NA	9658	9186	472	4.9
CN5300500000000	53	005	Benton County, WA	2015	NA	91584	85356	6228	6.8
CN5300700000000	53	007	Chelan County, WA	2015	NA	42552	40136	2416	5.7
CN5300900000000	53	009	Clallam County, WA	2015	NA	26762	24553	2209	8.3
CN5301100000000	53	011	Clark County, WA	2015	NA	213981	199931	14050	6.6
CN5301300000000	53	013	Columbia County, WA	2015	NA	1690	1578	112	6.6
CN5301500000000	53	015	Cowlitz County, WA	2015	NA	44050	40584	3466	7.9
CN5301700000000	53	017	Douglas County, WA	2015	NA	19740	18452	1288	6.5
CN5301900000000	53	019	Ferry County, WA	2015	NA	2473	2217	256	10.4
CN5302100000000	53	021	Franklin County, WA	2015	NA	38914	35903	3011	7.7
CN5302300000000	53	023	Garfield County, WA	2015	NA	928	870	58	6.3
CN5302500000000	53	025	Grant County, WA	2015	NA	44630	41318	3312	7.4
CN5302700000000	53	027	Grays Harbor County, WA	2015	NA	26888	24406	2482	9.2
CN5302900000000	53	029	Island County, WA	2015	NA	31706	29732	1974	6.2
CN5303100000000	53	031	Jefferson County, WA	2015	NA	11180	10368	812	7.3
CN5303300000000	53	033	King County, WA	2015	NA	1184240	1134979	49261	4.2
CN5303500000000	53	035	Kitsap County, WA	2015	NA	115129	108612	6517	5.7
CN5303700000000	53	037	Kittitas County, WA	2015	NA	20808	19490	1318	6.3
CN5303900000000	53	039	Klickitat County, WA	2015	NA	9441	8751	690	7.3
CN5304100000000	53	041	Lewis County, WA	2015	NA	31184	28510	2674	8.6
CN5304300000000	53	043	Lincoln County, WA	2015	NA	4867	4577	290	6
CN5304500000000	53	045	Mason County, WA	2015	NA	22982	21149	1833	8
CN5304700000000	53	047	Okanogan County, WA	2015	NA	21199	19701	1498	7.1
CN5304900000000	53	049	Pacific County, WA	2015	NA	8088	7347	741	9.2
CN5305100000000	53	051	Pend Oreille County, WA	2015	NA	4596	4144	452	9.8
CN5305300000000	53	053	Pierce County, WA	2015	NA	391623	365985	25638	6.5
CN5305500000000	53	055	San Juan County, WA	2015	NA	7705	7326	379	4.9
CN5305700000000	53	057	Skagit County, WA	2015	NA	56605	52697	3908	6.9
CN5305900000000	53	059	Skamania County, WA	2015	NA	4940	4567	373	7.6
CN5306100000000	53	061	Snohomish County, WA	2015	NA	403721	385403	18318	4.5
CN5306300000000	53	063	Spokane County, WA	2015	NA	227485	212364	15121	6.6
CN5306500000000	53	065	Stevens County, WA	2015	NA	17425	15842	1583	9.1
CN5306700000000	53	067	Thurston County, WA	2015	NA	125511	117879	7632	6.1
CN5306900000000	53	069	Wahkiakum County, WA	2015	NA	1291	1173	118	9.1
CN5307100000000	53	071	Walla Walla County, WA	2015	NA	27997	26322	1675	6
CN5307300000000	53	073	Whatcom County, WA	2015	NA	104082	97766	6316	6.1
CN5307500000000	53	075	Whitman County, WA	2015	NA	22706	21581	1125	5
CN5307700000000	53	077	Yakima County, WA	2015	NA	121609	111601	10008	8.2
CN5400100000000	54	001	Barbour County, WV	2015	NA	6893	6383	510	7.4
CN5400300000000	54	003	Berkeley County, WV	2015	NA	53859	51219	2640	4.9
CN5400500000000	54	005	Boone County, WV	2015	NA	8177	7382	795	9.7
CN5400700000000	54	007	Braxton County, WV	2015	NA	5456	4969	487	8.9
CN5400900000000	54	009	Brooke County, WV	2015	NA	10077	9338	739	7.3
CN5401100000000	54	011	Cabell County, WV	2015	NA	41242	39000	2242	5.4
CN5401300000000	54	013	Calhoun County, WV	2015	NA	2759	2415	344	12.5
CN5401500000000	54	015	Clay County, WV	2015	NA	3268	2903	365	11.2
CN5401700000000	54	017	Doddridge County, WV	2015	NA	3638	3437	201	5.5
CN5401900000000	54	019	Fayette County, WV	2015	NA	16260	14865	1395	8.6
CN5402100000000	54	021	Gilmer County, WV	2015	NA	2702	2491	211	7.8
CN5402300000000	54	023	Grant County, WV	2015	NA	5758	5322	436	7.6
CN5402500000000	54	025	Greenbrier County, WV	2015	NA	15345	14339	1006	6.6
CN5402700000000	54	027	Hampshire County, WV	2015	NA	9615	9077	538	5.6
CN5402900000000	54	029	Hancock County, WV	2015	NA	12981	11970	1011	7.8
CN5403100000000	54	031	Hardy County, WV	2015	NA	5463	5055	408	7.5
CN5403300000000	54	033	Harrison County, WV	2015	NA	31813	29808	2005	6.3
CN5403500000000	54	035	Jackson County, WV	2015	NA	11898	11040	858	7.2
CN5403700000000	54	037	Jefferson County, WV	2015	NA	27724	26585	1139	4.1
CN5403900000000	54	039	Kanawha County, WV	2015	NA	86120	80958	5162	6
CN5404100000000	54	041	Lewis County, WV	2015	NA	6970	6396	574	8.2
CN5404300000000	54	043	Lincoln County, WV	2015	NA	7348	6632	716	9.7
CN5404500000000	54	045	Logan County, WV	2015	NA	11483	10195	1288	11.2
CN5404700000000	54	047	McDowell County, WV	2015	NA	5337	4657	680	12.7
CN5404900000000	54	049	Marion County, WV	2015	NA	25990	24209	1781	6.9
CN5405100000000	54	051	Marshall County, WV	2015	NA	14035	12847	1188	8.5
CN5405300000000	54	053	Mason County, WV	2015	NA	9956	9108	848	8.5
CN5405500000000	54	055	Mercer County, WV	2015	NA	21943	20351	1592	7.3
CN5405700000000	54	057	Mineral County, WV	2015	NA	11608	10757	851	7.3
CN5405900000000	54	059	Mingo County, WV	2015	NA	7221	6270	951	13.2
CN5406100000000	54	061	Monongalia County, WV	2015	NA	50405	48032	2373	4.7
CN5406300000000	54	063	Monroe County, WV	2015	NA	5743	5423	320	5.6
CN5406500000000	54	065	Morgan County, WV	2015	NA	7464	7055	409	5.5
CN5406700000000	54	067	Nicholas County, WV	2015	NA	9924	9026	898	9
CN5406900000000	54	069	Ohio County, WV	2015	NA	20636	19479	1157	5.6
CN5407100000000	54	071	Pendleton County, WV	2015	NA	3570	3404	166	4.6
CN5407300000000	54	073	Pleasants County, WV	2015	NA	2981	2728	253	8.5
CN5407500000000	54	075	Pocahontas County, WV	2015	NA	3587	3295	292	8.1
CN5407700000000	54	077	Preston County, WV	2015	NA	14621	13709	912	6.2
CN5407900000000	54	079	Putnam County, WV	2015	NA	25504	24077	1427	5.6
CN5408100000000	54	081	Raleigh County, WV	2015	NA	30309	28072	2237	7.4
CN5408300000000	54	083	Randolph County, WV	2015	NA	11885	11052	833	7
CN5408500000000	54	085	Ritchie County, WV	2015	NA	4489	4175	314	7
CN5408700000000	54	087	Roane County, WV	2015	NA	5216	4617	599	11.5
CN5408900000000	54	089	Summers County, WV	2015	NA	4515	4197	318	7
CN5409100000000	54	091	Taylor County, WV	2015	NA	7731	7268	463	6
CN5409300000000	54	093	Tucker County, WV	2015	NA	3419	3210	209	6.1
CN5409500000000	54	095	Tyler County, WV	2015	NA	3652	3310	342	9.4
CN5409700000000	54	097	Upshur County, WV	2015	NA	9650	8875	775	8
CN5409900000000	54	099	Wayne County, WV	2015	NA	15552	14446	1106	7.1
CN5410100000000	54	101	Webster County, WV	2015	NA	3468	3206	262	7.6
CN5410300000000	54	103	Wetzel County, WV	2015	NA	7153	6437	716	10
CN5410500000000	54	105	Wirt County, WV	2015	NA	2254	2021	233	10.3
CN5410700000000	54	107	Wood County, WV	2015	NA	37027	34697	2330	6.3
CN5410900000000	54	109	Wyoming County, WV	2015	NA	7738	6992	746	9.6
CN5500100000000	55	001	Adams County, WI	2015	NA	8329	7724	605	7.3
CN5500300000000	55	003	Ashland County, WI	2015	NA	7923	7428	495	6.2
CN5500500000000	55	005	Barron County, WI	2015	NA	24460	23239	1221	5
CN5500700000000	55	007	Bayfield County, WI	2015	NA	7530	6903	627	8.3
CN5500900000000	55	009	Brown County, WI	2015	NA	139228	133561	5667	4.1
CN5501100000000	55	011	Buffalo County, WI	2015	NA	6534	6214	320	4.9
CN5501300000000	55	013	Burnett County, WI	2015	NA	7273	6763	510	7
CN5501500000000	55	015	Calumet County, WI	2015	NA	27458	26479	979	3.6
CN5501700000000	55	017	Chippewa County, WI	2015	NA	33149	31586	1563	4.7
CN5501900000000	55	019	Clark County, WI	2015	NA	17427	16664	763	4.4
CN5502100000000	55	021	Columbia County, WI	2015	NA	31342	29972	1370	4.4
CN5502300000000	55	023	Crawford County, WI	2015	NA	7905	7442	463	5.9
CN5502500000000	55	025	Dane County, WI	2015	NA	310737	300846	9891	3.2
CN5502700000000	55	027	Dodge County, WI	2015	NA	47540	45447	2093	4.4
CN5502900000000	55	029	Door County, WI	2015	NA	15487	14454	1033	6.7
CN5503100000000	55	031	Douglas County, WI	2015	NA	23351	22196	1155	4.9
CN5503300000000	55	033	Dunn County, WI	2015	NA	23773	22705	1068	4.5
CN5503500000000	55	035	Eau Claire County, WI	2015	NA	58155	55941	2214	3.8
CN5503700000000	55	037	Florence County, WI	2015	NA	2213	2064	149	6.7
CN5503900000000	55	039	Fond du Lac County, WI	2015	NA	57030	54706	2324	4.1
CN5504100000000	55	041	Forest County, WI	2015	NA	3997	3698	299	7.5
CN5504300000000	55	043	Grant County, WI	2015	NA	28162	26928	1234	4.4
CN5504500000000	55	045	Green County, WI	2015	NA	21091	20287	804	3.8
CN5504700000000	55	047	Green Lake County, WI	2015	NA	9993	9452	541	5.4
CN5504900000000	55	049	Iowa County, WI	2015	NA	13692	13111	581	4.2
CN5505100000000	55	051	Iron County, WI	2015	NA	2622	2391	231	8.8
CN5505300000000	55	053	Jackson County, WI	2015	NA	10346	9853	493	4.8
CN5505500000000	55	055	Jefferson County, WI	2015	NA	45648	43717	1931	4.2
CN5505700000000	55	057	Juneau County, WI	2015	NA	13510	12816	694	5.1
CN5505900000000	55	059	Kenosha County, WI	2015	NA	87338	82888	4450	5.1
CN5506100000000	55	061	Kewaunee County, WI	2015	NA	10893	10447	446	4.1
CN5506300000000	55	063	La Crosse County, WI	2015	NA	66614	64047	2567	3.9
CN5506500000000	55	065	Lafayette County, WI	2015	NA	9746	9389	357	3.7
CN5506700000000	55	067	Langlade County, WI	2015	NA	9474	8898	576	6.1
CN5506900000000	55	069	Lincoln County, WI	2015	NA	15257	14495	762	5
CN5507100000000	55	071	Manitowoc County, WI	2015	NA	41897	39796	2101	5
CN5507300000000	55	073	Marathon County, WI	2015	NA	73453	70499	2954	4
CN5507500000000	55	075	Marinette County, WI	2015	NA	20747	19542	1205	5.8
CN5507700000000	55	077	Marquette County, WI	2015	NA	7497	7038	459	6.1
CN5507800000000	55	078	Menominee County, WI	2015	NA	1604	1449	155	9.7
CN5507900000000	55	079	Milwaukee County, WI	2015	NA	477008	449615	27393	5.7
CN5508100000000	55	081	Monroe County, WI	2015	NA	22834	21818	1016	4.4
CN5508300000000	55	083	Oconto County, WI	2015	NA	20343	19293	1050	5.2
CN5508500000000	55	085	Oneida County, WI	2015	NA	18637	17560	1077	5.8
CN5508700000000	55	087	Outagamie County, WI	2015	NA	101952	97913	4039	4
CN5508900000000	55	089	Ozaukee County, WI	2015	NA	48235	46458	1777	3.7
CN5509100000000	55	091	Pepin County, WI	2015	NA	4107	3935	172	4.2
CN5509300000000	55	093	Pierce County, WI	2015	NA	24132	23184	948	3.9
CN5509500000000	55	095	Polk County, WI	2015	NA	24606	23418	1188	4.8
CN5509700000000	55	097	Portage County, WI	2015	NA	39583	37767	1816	4.6
CN5509900000000	55	099	Price County, WI	2015	NA	6851	6546	305	4.5
CN5510100000000	55	101	Racine County, WI	2015	NA	99343	93773	5570	5.6
CN5510300000000	55	103	Richland County, WI	2015	NA	9294	8904	390	4.2
CN5510500000000	55	105	Rock County, WI	2015	NA	83339	79019	4320	5.2
CN5510700000000	55	107	Rusk County, WI	2015	NA	6997	6614	383	5.5
CN5510900000000	55	109	St. Croix County, WI	2015	NA	48808	46939	1869	3.8
CN5511100000000	55	111	Sauk County, WI	2015	NA	35302	33853	1449	4.1
CN5511300000000	55	113	Sawyer County, WI	2015	NA	7815	7197	618	7.9
CN5511500000000	55	115	Shawano County, WI	2015	NA	21285	20249	1036	4.9
CN5511700000000	55	117	Sheboygan County, WI	2015	NA	61248	58938	2310	3.8
CN5511900000000	55	119	Taylor County, WI	2015	NA	10700	10228	472	4.4
CN5512100000000	55	121	Trempealeau County, WI	2015	NA	16615	15965	650	3.9
CN5512300000000	55	123	Vernon County, WI	2015	NA	15493	14857	636	4.1
CN5512500000000	55	125	Vilas County, WI	2015	NA	10001	9300	701	7
CN5512700000000	55	127	Walworth County, WI	2015	NA	56982	54341	2641	4.6
CN5512900000000	55	129	Washburn County, WI	2015	NA	7957	7530	427	5.4
CN5513100000000	55	131	Washington County, WI	2015	NA	76060	73211	2849	3.7
CN5513300000000	55	133	Waukesha County, WI	2015	NA	221383	212983	8400	3.8
CN5513500000000	55	135	Waupaca County, WI	2015	NA	27035	25783	1252	4.6
CN5513700000000	55	137	Waushara County, WI	2015	NA	11487	10765	722	6.3
CN5513900000000	55	139	Winnebago County, WI	2015	NA	91447	87574	3873	4.2
CN5514100000000	55	141	Wood County, WI	2015	NA	34423	32526	1897	5.5
CN5600100000000	56	001	Albany County, WY	2015	NA	20635	19979	656	3.2
CN5600300000000	56	003	Big Horn County, WY	2015	NA	5558	5310	248	4.5
CN5600500000000	56	005	Campbell County, WY	2015	NA	25810	24784	1026	4
CN5600700000000	56	007	Carbon County, WY	2015	NA	8437	8120	317	3.8
CN5600900000000	56	009	Converse County, WY	2015	NA	8313	8006	307	3.7
CN5601100000000	56	011	Crook County, WY	2015	NA	3708	3577	131	3.5
CN5601300000000	56	013	Fremont County, WY	2015	NA	20247	19114	1133	5.6
CN5601500000000	56	015	Goshen County, WY	2015	NA	7079	6844	235	3.3
CN5601700000000	56	017	Hot Springs County, WY	2015	NA	2400	2299	101	4.2
CN5601900000000	56	019	Johnson County, WY	2015	NA	4202	3995	207	4.9
CN5602100000000	56	021	Laramie County, WY	2015	NA	48621	46677	1944	4
CN5602300000000	56	023	Lincoln County, WY	2015	NA	8413	8013	400	4.8
CN5602500000000	56	025	Natrona County, WY	2015	NA	42842	40723	2119	4.9
CN5602700000000	56	027	Niobrara County, WY	2015	NA	1327	1287	40	3
CN5602900000000	56	029	Park County, WY	2015	NA	15767	15083	684	4.3
CN5603100000000	56	031	Platte County, WY	2015	NA	4911	4717	194	4
CN5603300000000	56	033	Sheridan County, WY	2015	NA	15930	15249	681	4.3
CN5603500000000	56	035	Sublette County, WY	2015	NA	4571	4330	241	5.3
CN5603700000000	56	037	Sweetwater County, WY	2015	NA	22745	21664	1081	4.8
CN5603900000000	56	039	Teton County, WY	2015	NA	14694	14119	575	3.9
CN5604100000000	56	041	Uinta County, WY	2015	NA	9675	9186	489	5.1
CN5604300000000	56	043	Washakie County, WY	2015	NA	4267	4087	180	4.2
CN5604500000000	56	045	Weston County, WY	2015	NA	3961	3825	136	3.4
CN7200100000000	72	001	Adjuntas Municipio, PR	2015	NA	4385	3608	777	17.7
CN7200300000000	72	003	Aguada Municipio, PR	2015	NA	11826	10172	1654	14
CN7200500000000	72	005	Aguadilla Municipio, PR	2015	NA	14768	12694	2074	14
CN7200700000000	72	007	Aguas Buenas Municipio, PR	2015	NA	6828	5830	998	14.6
CN7200900000000	72	009	Aibonito Municipio, PR	2015	NA	6648	5678	970	14.6
CN7201100000000	72	011	Anasco Municipio, PR	2015	NA	8857	7702	1155	13
CN7201300000000	72	013	Arecibo Municipio, PR	2015	NA	23927	20600	3327	13.9
CN7201500000000	72	015	Arroyo Municipio, PR	2015	NA	5191	4213	978	18.8
CN7201700000000	72	017	Barceloneta Municipio, PR	2015	NA	5908	5010	898	15.2
CN7201900000000	72	019	Barranquitas Municipio, PR	2015	NA	7422	6439	983	13.2
CN7202100000000	72	021	Bayamon Municipio, PR	2015	NA	67355	61093	6262	9.3
CN7202300000000	72	023	Cabo Rojo Municipio, PR	2015	NA	14132	12404	1728	12.2
CN7202500000000	72	025	Caguas Municipio, PR	2015	NA	48445	43426	5019	10.4
CN7202700000000	72	027	Camuy Municipio, PR	2015	NA	9429	8217	1212	12.9
CN7202900000000	72	029	Canovanas Municipio, PR	2015	NA	16270	14358	1912	11.8
CN7203100000000	72	031	Carolina Municipio, PR	2015	NA	62770	57222	5548	8.8
CN7203300000000	72	033	Catano Municipio, PR	2015	NA	8048	7207	841	10.4
CN7203500000000	72	035	Cayey Municipio, PR	2015	NA	16237	14493	1744	10.7
CN7203700000000	72	037	Ceiba Municipio, PR	2015	NA	3866	3331	535	13.8
CN7203900000000	72	039	Ciales Municipio, PR	2015	NA	3915	3235	680	17.4
CN7204100000000	72	041	Cidra Municipio, PR	2015	NA	15546	14001	1545	9.9
CN7204300000000	72	043	Coamo Municipio, PR	2015	NA	11020	8939	2081	18.9
CN7204500000000	72	045	Comerio Municipio, PR	2015	NA	5155	4370	785	15.2
CN7204700000000	72	047	Corozal Municipio, PR	2015	NA	9419	8152	1267	13.5
CN7204900000000	72	049	Culebra Municipio, PR	2015	NA	844	813	31	3.7
CN7205100000000	72	051	Dorado Municipio, PR	2015	NA	12803	11802	1001	7.8
CN7205300000000	72	053	Fajardo Municipio, PR	2015	NA	11552	9848	1704	14.8
CN7205400000000	72	054	Florida Municipio, PR	2015	NA	3400	2892	508	14.9
CN7205500000000	72	055	Guanica Municipio, PR	2015	NA	4204	3380	824	19.6
CN7205700000000	72	057	Guayama Municipio, PR	2015	NA	12242	10123	2119	17.3
CN7205900000000	72	059	Guayanilla Municipio, PR	2015	NA	5319	4284	1035	19.5
CN7206100000000	72	061	Guaynabo Municipio, PR	2015	NA	37218	35051	2167	5.8
CN7206300000000	72	063	Gurabo Municipio, PR	2015	NA	17292	15789	1503	8.7
CN7206500000000	72	065	Hatillo Municipio, PR	2015	NA	13064	11024	2040	15.6
CN7206700000000	72	067	Hormigueros Municipio, PR	2015	NA	5583	4934	649	11.6
CN7206900000000	72	069	Humacao Municipio, PR	2015	NA	17646	15044	2602	14.7
CN7207100000000	72	071	Isabela Municipio, PR	2015	NA	12313	10760	1553	12.6
CN7207300000000	72	073	Jayuya Municipio, PR	2015	NA	4158	3543	615	14.8
CN7207500000000	72	075	Juana Diaz Municipio, PR	2015	NA	15758	13369	2389	15.2
CN7207700000000	72	077	Juncos Municipio, PR	2015	NA	12478	10743	1735	13.9
CN7207900000000	72	079	Lajas Municipio, PR	2015	NA	5609	4603	1006	17.9
CN7208100000000	72	081	Lares Municipio, PR	2015	NA	7358	5860	1498	20.4
CN7208300000000	72	083	Las Marias Municipio, PR	2015	NA	2887	2401	486	16.8
CN7208500000000	72	085	Las Piedras Municipio, PR	2015	NA	11350	9757	1593	14
CN7208700000000	72	087	Loiza Municipio, PR	2015	NA	8793	7760	1033	11.7
CN7208900000000	72	089	Luquillo Municipio, PR	2015	NA	6455	5451	1004	15.6
CN7209100000000	72	091	Manati Municipio, PR	2015	NA	11674	10291	1383	11.8
CN7209300000000	72	093	Maricao Municipio, PR	2015	NA	1855	1549	306	16.5
CN7209500000000	72	095	Maunabo Municipio, PR	2015	NA	3038	2478	560	18.4
CN7209700000000	72	097	Mayaguez Municipio, PR	2015	NA	23411	20248	3163	13.5
CN7209900000000	72	099	Moca Municipio, PR	2015	NA	10641	8981	1660	15.6
CN7210100000000	72	101	Morovis Municipio, PR	2015	NA	8137	6992	1145	14.1
CN7210300000000	72	103	Naguabo Municipio, PR	2015	NA	8088	7023	1065	13.2
CN7210500000000	72	105	Naranjito Municipio, PR	2015	NA	7307	6308	999	13.7
CN7210700000000	72	107	Orocovis Municipio, PR	2015	NA	5254	4396	858	16.3
CN7210900000000	72	109	Patillas Municipio, PR	2015	NA	4847	3837	1010	20.8
CN7211100000000	72	111	Penuelas Municipio, PR	2015	NA	6247	5155	1092	17.5
CN7211300000000	72	113	Ponce Municipio, PR	2015	NA	48408	41686	6722	13.9
CN7211500000000	72	115	Quebradillas Municipio, PR	2015	NA	6038	5025	1013	16.8
CN7211700000000	72	117	Rincon Municipio, PR	2015	NA	4639	3874	765	16.5
CN7211900000000	72	119	Rio Grande Municipio, PR	2015	NA	17061	15297	1764	10.3
CN7212100000000	72	121	Sabana Grande Municipio, PR	2015	NA	6366	5425	941	14.8
CN7212300000000	72	123	Salinas Municipio, PR	2015	NA	7897	5992	1905	24.1
CN7212500000000	72	125	San German Municipio, PR	2015	NA	10330	8872	1458	14.1
CN7212700000000	72	127	San Juan Municipio, PR	2015	NA	135762	125441	10321	7.6
CN7212900000000	72	129	San Lorenzo Municipio, PR	2015	NA	11979	10410	1569	13.1
CN7213100000000	72	131	San Sebastian Municipio, PR	2015	NA	10677	8555	2122	19.9
CN7213300000000	72	133	Santa Isabel Municipio, PR	2015	NA	9533	7791	1742	18.3
CN7213500000000	72	135	Toa Alta Municipio, PR	2015	NA	26336	24140	2196	8.3
CN7213700000000	72	137	Toa Baja Municipio, PR	2015	NA	30030	27316	2714	9
CN7213900000000	72	139	Trujillo Alto Municipio, PR	2015	NA	27212	25308	1904	7
CN7214100000000	72	141	Utuado Municipio, PR	2015	NA	6925	5817	1108	16
CN7214300000000	72	143	Vega Alta Municipio, PR	2015	NA	9872	8719	1153	11.7
CN7214500000000	72	145	Vega Baja Municipio, PR	2015	NA	13820	11921	1899	13.7
CN7214700000000	72	147	Vieques Municipio, PR	2015	NA	3194	2832	362	11.3
CN7214900000000	72	149	Villalba Municipio, PR	2015	NA	7802	6262	1540	19.7
CN7215100000000	72	151	Yabucoa Municipio, PR	2015	NA	9198	7593	1605	17.4
CN7215300000000	72	153	Yauco Municipio, PR	2015	NA	10748	8717	2031	18.9
NA	NA	NA	NA	NA	NA	NA	NA	NA	NA
SOURCE:  BLS, LAUS	NA	NA	NA	NA	NA	NA	NA	NA	NA
April 17, 2020	NA	NA	NA	NA	NA	NA	NA	NA	NA
