LAUS_CODE	STATE_FIPS	COUNTY_FIPS	COUNTY	YEAR	ESTIMATED	LABOR_FORCE	EMPLOYED	UNEMPLOYED_LEVEL	UNEMPLOYED_RATE
CN0100100000000	01	001	Autauga County, AL	2010	NA	25713	23431	2282	8.9
CN0100300000000	01	003	Baldwin County, AL	2010	NA	83459	75120	8339	10
CN0100500000000	01	005	Barbour County, AL	2010	NA	10221	8959	1262	12.3
CN0100700000000	01	007	Bibb County, AL	2010	NA	8934	7914	1020	11.4
CN0100900000000	01	009	Blount County, AL	2010	NA	24906	22460	2446	9.8
CN0101100000000	01	011	Bullock County, AL	2010	NA	4941	4356	585	11.8
CN0101300000000	01	013	Butler County, AL	2010	NA	9261	7998	1263	13.6
CN0101500000000	01	015	Calhoun County, AL	2010	NA	51559	45699	5860	11.4
CN0101700000000	01	017	Chambers County, AL	2010	NA	14754	12554	2200	14.9
CN0101900000000	01	019	Cherokee County, AL	2010	NA	11464	10245	1219	10.6
CN0102100000000	01	021	Chilton County, AL	2010	NA	19462	17464	1998	10.3
CN0102300000000	01	023	Choctaw County, AL	2010	NA	4860	4216	644	13.3
CN0102500000000	01	025	Clarke County, AL	2010	NA	9108	7300	1808	19.9
CN0102700000000	01	027	Clay County, AL	2010	NA	5851	5005	846	14.5
CN0102900000000	01	029	Cleburne County, AL	2010	NA	6033	5429	604	10
CN0103100000000	01	031	Coffee County, AL	2010	NA	21088	19271	1817	8.6
CN0103300000000	01	033	Colbert County, AL	2010	NA	24228	21453	2775	11.5
CN0103500000000	01	035	Conecuh County, AL	2010	NA	4991	4131	860	17.2
CN0103700000000	01	037	Coosa County, AL	2010	NA	4654	3937	717	15.4
CN0103900000000	01	039	Covington County, AL	2010	NA	16417	14721	1696	10.3
CN0104100000000	01	041	Crenshaw County, AL	2010	NA	6285	5646	639	10.2
CN0104300000000	01	043	Cullman County, AL	2010	NA	35959	32202	3757	10.4
CN0104500000000	01	045	Dale County, AL	2010	NA	22072	20124	1948	8.8
CN0104700000000	01	047	Dallas County, AL	2010	NA	17808	14806	3002	16.9
CN0104900000000	01	049	DeKalb County, AL	2010	NA	30942	27026	3916	12.7
CN0105100000000	01	051	Elmore County, AL	2010	NA	36683	33362	3321	9.1
CN0105300000000	01	053	Escambia County, AL	2010	NA	15007	13238	1769	11.8
CN0105500000000	01	055	Etowah County, AL	2010	NA	44000	39193	4807	10.9
CN0105700000000	01	057	Fayette County, AL	2010	NA	6831	5942	889	13
CN0105900000000	01	059	Franklin County, AL	2010	NA	14255	12724	1531	10.7
CN0106100000000	01	061	Geneva County, AL	2010	NA	11559	10362	1197	10.4
CN0106300000000	01	063	Greene County, AL	2010	NA	3306	2735	571	17.3
CN0106500000000	01	065	Hale County, AL	2010	NA	6445	5473	972	15.1
CN0106700000000	01	067	Henry County, AL	2010	NA	7259	6469	790	10.9
CN0106900000000	01	069	Houston County, AL	2010	NA	46414	42170	4244	9.1
CN0107100000000	01	071	Jackson County, AL	2010	NA	24348	21468	2880	11.8
CN0107300000000	01	073	Jefferson County, AL	2010	NA	318520	285627	32893	10.3
CN0107500000000	01	075	Lamar County, AL	2010	NA	5802	5035	767	13.2
CN0107700000000	01	077	Lauderdale County, AL	2010	NA	43596	39193	4403	10.1
CN0107900000000	01	079	Lawrence County, AL	2010	NA	14901	13024	1877	12.6
CN0108100000000	01	081	Lee County, AL	2010	NA	66764	60758	6006	9
CN0108300000000	01	083	Limestone County, AL	2010	NA	38321	34625	3696	9.6
CN0108500000000	01	085	Lowndes County, AL	2010	NA	4350	3547	803	18.5
CN0108700000000	01	087	Macon County, AL	2010	NA	8937	7618	1319	14.8
CN0108900000000	01	089	Madison County, AL	2010	NA	169833	155656	14177	8.3
CN0109100000000	01	091	Marengo County, AL	2010	NA	8136	7021	1115	13.7
CN0109300000000	01	093	Marion County, AL	2010	NA	13215	11423	1792	13.6
CN0109500000000	01	095	Marshall County, AL	2010	NA	41637	37640	3997	9.6
CN0109700000000	01	097	Mobile County, AL	2010	NA	192730	170943	21787	11.3
CN0109900000000	01	099	Monroe County, AL	2010	NA	8712	7131	1581	18.1
CN0110100000000	01	101	Montgomery County, AL	2010	NA	108753	97892	10861	10
CN0110300000000	01	103	Morgan County, AL	2010	NA	57817	51600	6217	10.8
CN0110500000000	01	105	Perry County, AL	2010	NA	3891	3236	655	16.8
CN0110700000000	01	107	Pickens County, AL	2010	NA	7699	6687	1012	13.1
CN0110900000000	01	109	Pike County, AL	2010	NA	15677	14198	1479	9.4
CN0111100000000	01	111	Randolph County, AL	2010	NA	9706	8410	1296	13.4
CN0111300000000	01	113	Russell County, AL	2010	NA	23814	21225	2589	10.9
CN0111500000000	01	115	St. Clair County, AL	2010	NA	38280	34397	3883	10.1
CN0111700000000	01	117	Shelby County, AL	2010	NA	102372	95110	7262	7.1
CN0111900000000	01	119	Sumter County, AL	2010	NA	5777	5006	771	13.3
CN0112100000000	01	121	Talladega County, AL	2010	NA	35129	30389	4740	13.5
CN0112300000000	01	123	Tallapoosa County, AL	2010	NA	19079	16579	2500	13.1
CN0112500000000	01	125	Tuscaloosa County, AL	2010	NA	93915	85273	8642	9.2
CN0112700000000	01	127	Walker County, AL	2010	NA	27279	23815	3464	12.7
CN0112900000000	01	129	Washington County, AL	2010	NA	7385	6335	1050	14.2
CN0113100000000	01	131	Wilcox County, AL	2010	NA	3066	2261	805	26.3
CN0113300000000	01	133	Winston County, AL	2010	NA	9883	8304	1579	16
CN0201300000000	02	013	Aleutians East Borough, AK	2010	NA	2031	1917	114	5.6
CN0201600000000	02	016	Aleutians West Census Area, AK	2010	NA	3955	3755	200	5.1
CN0202000000000	02	020	Anchorage Borough/municipality, AK	2010	NA	157923	147539	10384	6.6
CN0205000000000	02	050	Bethel Census Area, AK	2010	NA	7161	6114	1047	14.6
CN0206000000000	02	060	Bristol Bay Borough, AK	2010	NA	505	456	49	9.7
CN0206800000000	02	068	Denali Borough, AK	2010	NA	1011	891	120	11.9
CN0207000000000	02	070	Dillingham Census Area, AK	2010	NA	2089	1878	211	10.1
CN0209000000000	02	090	Fairbanks North Star Borough, AK	2010	NA	48285	45083	3202	6.6
CN0210000000000	02	100	Haines Borough, AK	2010	NA	1150	1028	122	10.6
CN0210500000000	02	105	Hoonah-Angoon Census Area, AK	2010	NA	1064	915	149	14
CN0211000000000	02	110	Juneau Borough/city, AK	2010	NA	17903	16848	1055	5.9
CN0212200000000	02	122	Kenai Peninsula Borough, AK	2010	NA	27001	24310	2691	10
CN0213000000000	02	130	Ketchikan Gateway Borough, AK	2010	NA	7123	6501	622	8.7
CN0215000000000	02	150	Kodiak Island Borough, AK	2010	NA	6470	5993	477	7.4
CN0215800000000	02	158	Kusilvak Census Area, AK	2010	NA	2658	2115	543	20.4
CN0216400000000	02	164	Lake and Peninsula Borough, AK	2010	NA	604	517	87	14.4
CN0217000000000	02	170	Matanuska-Susitna Borough, AK	2010	NA	42314	38319	3995	9.4
CN0218000000000	02	180	Nome Census Area, AK	2010	NA	4111	3595	516	12.6
CN0218500000000	02	185	North Slope Borough, AK	2010	NA	3968	3649	319	8
CN0218800000000	02	188	Northwest Arctic Borough, AK	2010	NA	2957	2560	397	13.4
CN0219500000000	02	195	Petersburg Borough, AK	2010	NA	1844	1698	146	7.9
CN0219800000000	02	198	Prince of Wales-Hyder Census Area, AK	2010	NA	2543	2276	267	10.5
CN0222000000000	02	220	Sitka Borough/city, AK	2010	NA	4561	4274	287	6.3
CN0223000000000	02	230	Skagway Municipality, AK	2010	NA	718	614	104	14.5
CN0224000000000	02	240	Southeast Fairbanks Census Area, AK	2010	NA	3196	2816	380	11.9
CN0226100000000	02	261	Valdez-Cordova Census Area, AK	2010	NA	4875	4419	456	9.4
CN0227500000000	02	275	Wrangell Borough/city, AK	2010	NA	1027	945	82	8
CN0228200000000	02	282	Yakutat Borough/city, AK	2010	NA	297	265	32	10.8
CN0229000000000	02	290	Yukon-Koyukuk Census Area, AK	2010	NA	2567	2125	442	17.2
CN0400100000000	04	001	Apache County, AZ	2010	NA	23438	19589	3849	16.4
CN0400300000000	04	003	Cochise County, AZ	2010	NA	57023	51694	5329	9.3
CN0400500000000	04	005	Coconino County, AZ	2010	NA	72846	65650	7196	9.9
CN0400700000000	04	007	Gila County, AZ	2010	NA	21623	18914	2709	12.5
CN0400900000000	04	009	Graham County, AZ	2010	NA	14570	12687	1883	12.9
CN0401100000000	04	011	Greenlee County, AZ	2010	NA	3439	2875	564	16.4
CN0401200000000	04	012	La Paz County, AZ	2010	NA	7868	7063	805	10.2
CN0401300000000	04	013	Maricopa County, AZ	2010	NA	1919590	1736764	182826	9.5
CN0401500000000	04	015	Mohave County, AZ	2010	NA	82726	71999	10727	13
CN0401700000000	04	017	Navajo County, AZ	2010	NA	43903	37450	6453	14.7
CN0401900000000	04	019	Pima County, AZ	2010	NA	478743	434106	44637	9.3
CN0402100000000	04	021	Pinal County, AZ	2010	NA	153707	137242	16465	10.7
CN0402300000000	04	023	Santa Cruz County, AZ	2010	NA	20881	17697	3184	15.2
CN0402500000000	04	025	Yavapai County, AZ	2010	NA	96533	86224	10309	10.7
CN0402700000000	04	027	Yuma County, AZ	2010	NA	92816	69500	23316	25.1
CN0500100000000	05	001	Arkansas County, AR	2010	NA	11325	9217	2108	18.6
CN0500300000000	05	003	Ashley County, AR	2010	NA	9896	8916	980	9.9
CN0500500000000	05	005	Baxter County, AR	2010	NA	16593	15033	1560	9.4
CN0500700000000	05	007	Benton County, AR	2010	NA	106975	99853	7122	6.7
CN0500900000000	05	009	Boone County, AR	2010	NA	16497	15204	1293	7.8
CN0501100000000	05	011	Bradley County, AR	2010	NA	5160	4620	540	10.5
CN0501300000000	05	013	Calhoun County, AR	2010	NA	2701	2465	236	8.7
CN0501500000000	05	015	Carroll County, AR	2010	NA	12593	11668	925	7.3
CN0501700000000	05	017	Chicot County, AR	2010	NA	4276	3749	527	12.3
CN0501900000000	05	019	Clark County, AR	2010	NA	10366	9491	875	8.4
CN0502100000000	05	021	Clay County, AR	2010	NA	7469	6649	820	11
CN0502300000000	05	023	Cleburne County, AR	2010	NA	10348	9456	892	8.6
CN0502500000000	05	025	Cleveland County, AR	2010	NA	3883	3557	326	8.4
CN0502700000000	05	027	Columbia County, AR	2010	NA	10518	9469	1049	10
CN0502900000000	05	029	Conway County, AR	2010	NA	9026	8153	873	9.7
CN0503100000000	05	031	Craighead County, AR	2010	NA	47731	44184	3547	7.4
CN0503300000000	05	033	Crawford County, AR	2010	NA	28284	25957	2327	8.2
CN0503500000000	05	035	Crittenden County, AR	2010	NA	22789	20403	2386	10.5
CN0503700000000	05	037	Cross County, AR	2010	NA	8607	7892	715	8.3
CN0503900000000	05	039	Dallas County, AR	2010	NA	3605	3175	430	11.9
CN0504100000000	05	041	Desha County, AR	2010	NA	5899	5244	655	11.1
CN0504300000000	05	043	Drew County, AR	2010	NA	8706	7771	935	10.7
CN0504500000000	05	045	Faulkner County, AR	2010	NA	58631	54385	4246	7.2
CN0504700000000	05	047	Franklin County, AR	2010	NA	7793	7190	603	7.7
CN0504900000000	05	049	Fulton County, AR	2010	NA	5165	4760	405	7.8
CN0505100000000	05	051	Garland County, AR	2010	NA	41507	37990	3517	8.5
CN0505300000000	05	053	Grant County, AR	2010	NA	8556	7949	607	7.1
CN0505500000000	05	055	Greene County, AR	2010	NA	19654	17739	1915	9.7
CN0505700000000	05	057	Hempstead County, AR	2010	NA	10694	9705	989	9.2
CN0505900000000	05	059	Hot Spring County, AR	2010	NA	14222	13003	1219	8.6
CN0506100000000	05	061	Howard County, AR	2010	NA	6572	6064	508	7.7
CN0506300000000	05	063	Independence County, AR	2010	NA	17039	15539	1500	8.8
CN0506500000000	05	065	Izard County, AR	2010	NA	5134	4617	517	10.1
CN0506700000000	05	067	Jackson County, AR	2010	NA	6726	5928	798	11.9
CN0506900000000	05	069	Jefferson County, AR	2010	NA	33928	30393	3535	10.4
CN0507100000000	05	071	Johnson County, AR	2010	NA	10972	10067	905	8.2
CN0507300000000	05	073	Lafayette County, AR	2010	NA	3075	2775	300	9.8
CN0507500000000	05	075	Lawrence County, AR	2010	NA	7436	6728	708	9.5
CN0507700000000	05	077	Lee County, AR	2010	NA	3700	3383	317	8.6
CN0507900000000	05	079	Lincoln County, AR	2010	NA	4693	4252	441	9.4
CN0508100000000	05	081	Little River County, AR	2010	NA	6211	5729	482	7.8
CN0508300000000	05	083	Logan County, AR	2010	NA	9797	8956	841	8.6
CN0508500000000	05	085	Lonoke County, AR	2010	NA	33242	30991	2251	6.8
CN0508700000000	05	087	Madison County, AR	2010	NA	7260	6746	514	7.1
CN0508900000000	05	089	Marion County, AR	2010	NA	6710	6029	681	10.1
CN0509100000000	05	091	Miller County, AR	2010	NA	20532	19336	1196	5.8
CN0509300000000	05	093	Mississippi County, AR	2010	NA	20403	17875	2528	12.4
CN0509500000000	05	095	Monroe County, AR	2010	NA	3411	3096	315	9.2
CN0509700000000	05	097	Montgomery County, AR	2010	NA	3930	3588	342	8.7
CN0509900000000	05	099	Nevada County, AR	2010	NA	4024	3622	402	10
CN0510100000000	05	101	Newton County, AR	2010	NA	3785	3523	262	6.9
CN0510300000000	05	103	Ouachita County, AR	2010	NA	11388	10308	1080	9.5
CN0510500000000	05	105	Perry County, AR	2010	NA	4554	4148	406	8.9
CN0510700000000	05	107	Phillips County, AR	2010	NA	8574	7670	904	10.5
CN0510900000000	05	109	Pike County, AR	2010	NA	4902	4459	443	9
CN0511100000000	05	111	Poinsett County, AR	2010	NA	10723	9722	1001	9.3
CN0511300000000	05	113	Polk County, AR	2010	NA	9007	8337	670	7.4
CN0511500000000	05	115	Pope County, AR	2010	NA	30081	27733	2348	7.8
CN0511700000000	05	117	Prairie County, AR	2010	NA	3965	3600	365	9.2
CN0511900000000	05	119	Pulaski County, AR	2010	NA	189065	175256	13809	7.3
CN0512100000000	05	121	Randolph County, AR	2010	NA	7250	6506	744	10.3
CN0512300000000	05	123	St. Francis County, AR	2010	NA	9820	8774	1046	10.7
CN0512500000000	05	125	Saline County, AR	2010	NA	53309	49751	3558	6.7
CN0512700000000	05	127	Scott County, AR	2010	NA	4753	4418	335	7
CN0512900000000	05	129	Searcy County, AR	2010	NA	3388	3076	312	9.2
CN0513100000000	05	131	Sebastian County, AR	2010	NA	59463	54680	4783	8
CN0513300000000	05	133	Sevier County, AR	2010	NA	7085	6589	496	7
CN0513500000000	05	135	Sharp County, AR	2010	NA	6304	5685	619	9.8
CN0513700000000	05	137	Stone County, AR	2010	NA	5515	5096	419	7.6
CN0513900000000	05	139	Union County, AR	2010	NA	17207	15265	1942	11.3
CN0514100000000	05	141	Van Buren County, AR	2010	NA	6471	5747	724	11.2
CN0514300000000	05	143	Washington County, AR	2010	NA	102724	96021	6703	6.5
CN0514500000000	05	145	White County, AR	2010	NA	36399	33394	3005	8.3
CN0514700000000	05	147	Woodruff County, AR	2010	NA	3625	3246	379	10.5
CN0514900000000	05	149	Yell County, AR	2010	NA	9721	8935	786	8.1
CN0600100000000	06	001	Alameda County, CA	2010	NA	782522	697112	85410	10.9
CN0600300000000	06	003	Alpine County, CA	2010	NA	542	472	70	12.9
CN0600500000000	06	005	Amador County, CA	2010	NA	15507	13326	2181	14.1
CN0600700000000	06	007	Butte County, CA	2010	NA	102568	88322	14246	13.9
CN0600900000000	06	009	Calaveras County, CA	2010	NA	21012	17977	3035	14.4
CN0601100000000	06	011	Colusa County, CA	2010	NA	11519	9118	2401	20.8
CN0601300000000	06	013	Contra Costa County, CA	2010	NA	525547	467914	57633	11
CN0601500000000	06	015	Del Norte County, CA	2010	NA	10931	9489	1442	13.2
CN0601700000000	06	017	El Dorado County, CA	2010	NA	91129	80002	11127	12.2
CN0601900000000	06	019	Fresno County, CA	2010	NA	439593	366221	73372	16.7
CN0602100000000	06	021	Glenn County, CA	2010	NA	13218	11180	2038	15.4
CN0602300000000	06	023	Humboldt County, CA	2010	NA	66061	59084	6977	10.6
CN0602500000000	06	025	Imperial County, CA	2010	NA	78665	55978	22687	28.8
CN0602700000000	06	027	Inyo County, CA	2010	NA	9753	8806	947	9.7
CN0602900000000	06	029	Kern County, CA	2010	NA	371515	313361	58154	15.7
CN0603100000000	06	031	Kings County, CA	2010	NA	59440	49857	9583	16.1
CN0603300000000	06	033	Lake County, CA	2010	NA	29847	25343	4504	15.1
CN0603500000000	06	035	Lassen County, CA	2010	NA	12100	10401	1699	14
CN0603700000000	06	037	Los Angeles County, CA	2010	NA	4917375	4302274	615101	12.5
CN0603900000000	06	039	Madera County, CA	2010	NA	61607	51366	10241	16.6
CN0604100000000	06	041	Marin County, CA	2010	NA	133012	122570	10442	7.9
CN0604300000000	06	043	Mariposa County, CA	2010	NA	8709	7582	1127	12.9
CN0604500000000	06	045	Mendocino County, CA	2010	NA	41601	36772	4829	11.6
CN0604700000000	06	047	Merced County, CA	2010	NA	113579	93191	20388	18
CN0604900000000	06	049	Modoc County, CA	2010	NA	3818	3237	581	15.2
CN0605100000000	06	051	Mono County, CA	2010	NA	8890	7984	906	10.2
CN0605300000000	06	053	Monterey County, CA	2010	NA	215788	188339	27449	12.7
CN0605500000000	06	055	Napa County, CA	2010	NA	70216	62989	7227	10.3
CN0605700000000	06	057	Nevada County, CA	2010	NA	48915	43178	5737	11.7
CN0605900000000	06	059	Orange County, CA	2010	NA	1537187	1387438	149749	9.7
CN0606100000000	06	061	Placer County, CA	2010	NA	173338	153236	20102	11.6
CN0606300000000	06	063	Plumas County, CA	2010	NA	9147	7479	1668	18.2
CN0606500000000	06	065	Riverside County, CA	2010	NA	976444	841285	135159	13.8
CN0606700000000	06	067	Sacramento County, CA	2010	NA	683127	596992	86135	12.6
CN0606900000000	06	069	San Benito County, CA	2010	NA	27906	23691	4215	15.1
CN0607100000000	06	071	San Bernardino County, CA	2010	NA	890278	769890	120388	13.5
CN0607300000000	06	073	San Diego County, CA	2010	NA	1515198	1352266	162932	10.8
CN0607500000000	06	075	San Francisco County/city, CA	2010	NA	486019	442695	43324	8.9
CN0607700000000	06	077	San Joaquin County, CA	2010	NA	311437	259995	51442	16.5
CN0607900000000	06	079	San Luis Obispo County, CA	2010	NA	133651	120209	13442	10.1
CN0608100000000	06	081	San Mateo County, CA	2010	NA	393004	360163	32841	8.4
CN0608300000000	06	083	Santa Barbara County, CA	2010	NA	212267	191680	20587	9.7
CN0608500000000	06	085	Santa Clara County, CA	2010	NA	926525	830114	96411	10.4
CN0608700000000	06	087	Santa Cruz County, CA	2010	NA	141717	122872	18845	13.3
CN0608900000000	06	089	Shasta County, CA	2010	NA	78503	65334	13169	16.8
CN0609100000000	06	091	Sierra County, CA	2010	NA	1611	1364	247	15.3
CN0609300000000	06	093	Siskiyou County, CA	2010	NA	19628	16325	3303	16.8
CN0609500000000	06	095	Solano County, CA	2010	NA	202407	176969	25438	12.6
CN0609700000000	06	097	Sonoma County, CA	2010	NA	244634	218100	26534	10.8
CN0609900000000	06	099	Stanislaus County, CA	2010	NA	243274	202182	41092	16.9
CN0610100000000	06	101	Sutter County, CA	2010	NA	45965	37528	8437	18.4
CN0610300000000	06	103	Tehama County, CA	2010	NA	25714	21754	3960	15.4
CN0610500000000	06	105	Trinity County, CA	2010	NA	5423	4501	922	17
CN0610700000000	06	107	Tulare County, CA	2010	NA	203021	168110	34911	17.2
CN0610900000000	06	109	Tuolumne County, CA	2010	NA	22617	19173	3444	15.2
CN0611100000000	06	111	Ventura County, CA	2010	NA	430010	383424	46586	10.8
CN0611300000000	06	113	Yolo County, CA	2010	NA	102188	89834	12354	12.1
CN0611500000000	06	115	Yuba County, CA	2010	NA	29064	23902	5162	17.8
CN0800100000000	08	001	Adams County, CO	2010	NA	234221	210728	23493	10
CN0800300000000	08	003	Alamosa County, CO	2010	NA	7702	7010	692	9
CN0800500000000	08	005	Arapahoe County, CO	2010	NA	316886	289715	27171	8.6
CN0800700000000	08	007	Archuleta County, CO	2010	NA	5785	5169	616	10.6
CN0800900000000	08	009	Baca County, CO	2010	NA	2084	1982	102	4.9
CN0801100000000	08	011	Bent County, CO	2010	NA	2006	1843	163	8.1
CN0801300000000	08	013	Boulder County, CO	2010	NA	170293	158308	11985	7
CN0801400000000	08	014	Broomfield County/city, CO	2010	NA	31538	29198	2340	7.4
CN0801500000000	08	015	Chaffee County, CO	2010	NA	8270	7634	636	7.7
CN0801700000000	08	017	Cheyenne County, CO	2010	NA	1047	1004	43	4.1
CN0801900000000	08	019	Clear Creek County, CO	2010	NA	5623	5167	456	8.1
CN0802100000000	08	021	Conejos County, CO	2010	NA	3753	3394	359	9.6
CN0802300000000	08	023	Costilla County, CO	2010	NA	1553	1388	165	10.6
CN0802500000000	08	025	Crowley County, CO	2010	NA	1522	1383	139	9.1
CN0802700000000	08	027	Custer County, CO	2010	NA	2078	1940	138	6.6
CN0802900000000	08	029	Delta County, CO	2010	NA	14510	12961	1549	10.7
CN0803100000000	08	031	Denver County/city, CO	2010	NA	347590	315922	31668	9.1
CN0803300000000	08	033	Dolores County, CO	2010	NA	1000	823	177	17.7
CN0803500000000	08	035	Douglas County, CO	2010	NA	157522	146562	10960	7
CN0803700000000	08	037	Eagle County, CO	2010	NA	32447	29697	2750	8.5
CN0803900000000	08	039	Elbert County, CO	2010	NA	12755	11727	1028	8.1
CN0804100000000	08	041	El Paso County, CO	2010	NA	306308	277678	28630	9.3
CN0804300000000	08	043	Fremont County, CO	2010	NA	15825	13973	1852	11.7
CN0804500000000	08	045	Garfield County, CO	2010	NA	31357	28115	3242	10.3
CN0804700000000	08	047	Gilpin County, CO	2010	NA	3327	3060	267	8
CN0804900000000	08	049	Grand County, CO	2010	NA	8950	8165	785	8.8
CN0805100000000	08	051	Gunnison County, CO	2010	NA	10087	9439	648	6.4
CN0805300000000	08	053	Hinsdale County, CO	2010	NA	470	443	27	5.7
CN0805500000000	08	055	Huerfano County, CO	2010	NA	2705	2327	378	14
CN0805700000000	08	057	Jackson County, CO	2010	NA	919	838	81	8.8
CN0805900000000	08	059	Jefferson County, CO	2010	NA	304252	278790	25462	8.4
CN0806100000000	08	061	Kiowa County, CO	2010	NA	779	729	50	6.4
CN0806300000000	08	063	Kit Carson County, CO	2010	NA	4389	4190	199	4.5
CN0806500000000	08	065	Lake County, CO	2010	NA	4372	3891	481	11
CN0806700000000	08	067	La Plata County, CO	2010	NA	29874	27744	2130	7.1
CN0806900000000	08	069	Larimer County, CO	2010	NA	170001	157025	12976	7.6
CN0807100000000	08	071	Las Animas County, CO	2010	NA	7195	6432	763	10.6
CN0807300000000	08	073	Lincoln County, CO	2010	NA	2153	2024	129	6
CN0807500000000	08	075	Logan County, CO	2010	NA	11261	10551	710	6.3
CN0807700000000	08	077	Mesa County, CO	2010	NA	76113	67776	8337	11
CN0807900000000	08	079	Mineral County, CO	2010	NA	416	387	29	7
CN0808100000000	08	081	Moffat County, CO	2010	NA	8078	7277	801	9.9
CN0808300000000	08	083	Montezuma County, CO	2010	NA	13057	11867	1190	9.1
CN0808500000000	08	085	Montrose County, CO	2010	NA	20624	18360	2264	11
CN0808700000000	08	087	Morgan County, CO	2010	NA	14436	13423	1013	7
CN0808900000000	08	089	Otero County, CO	2010	NA	8489	7710	779	9.2
CN0809100000000	08	091	Ouray County, CO	2010	NA	2151	1940	211	9.8
CN0809300000000	08	093	Park County, CO	2010	NA	9641	8856	785	8.1
CN0809500000000	08	095	Phillips County, CO	2010	NA	2197	2081	116	5.3
CN0809700000000	08	097	Pitkin County, CO	2010	NA	10879	10000	879	8.1
CN0809900000000	08	099	Prowers County, CO	2010	NA	6166	5736	430	7
CN0810100000000	08	101	Pueblo County, CO	2010	NA	74396	66667	7729	10.4
CN0810300000000	08	103	Rio Blanco County, CO	2010	NA	3146	2866	280	8.9
CN0810500000000	08	105	Rio Grande County, CO	2010	NA	5209	4655	554	10.6
CN0810700000000	08	107	Routt County, CO	2010	NA	14541	13192	1349	9.3
CN0810900000000	08	109	Saguache County, CO	2010	NA	3066	2755	311	10.1
CN0811100000000	08	111	San Juan County, CO	2010	NA	505	442	63	12.5
CN0811300000000	08	113	San Miguel County, CO	2010	NA	4892	4508	384	7.8
CN0811500000000	08	115	Sedgwick County, CO	2010	NA	1101	1019	82	7.4
CN0811700000000	08	117	Summit County, CO	2010	NA	19126	17837	1289	6.7
CN0811900000000	08	119	Teller County, CO	2010	NA	12354	11198	1156	9.4
CN0812100000000	08	121	Washington County, CO	2010	NA	2590	2437	153	5.9
CN0812300000000	08	123	Weld County, CO	2010	NA	131910	119796	12114	9.2
CN0812500000000	08	125	Yuma County, CO	2010	NA	4928	4651	277	5.6
CN0900100000000	09	001	Fairfield County, CT	2010	NA	473306	433481	39825	8.4
CN0900300000000	09	003	Hartford County, CT	2010	NA	479745	434518	45227	9.4
CN0900500000000	09	005	Litchfield County, CT	2010	NA	108391	98931	9460	8.7
CN0900700000000	09	007	Middlesex County, CT	2010	NA	93317	85965	7352	7.9
CN0900900000000	09	009	New Haven County, CT	2010	NA	461993	415831	46162	10
CN0901100000000	09	011	New London County, CT	2010	NA	143890	131039	12851	8.9
CN0901300000000	09	013	Tolland County, CT	2010	NA	86452	79710	6742	7.8
CN0901500000000	09	015	Windham County, CT	2010	NA	64616	57973	6643	10.3
CN1000100000000	10	001	Kent County, DE	2010	NA	72711	66250	6461	8.9
CN1000300000000	10	003	New Castle County, DE	2010	NA	271575	249148	22427	8.3
CN1000500000000	10	005	Sussex County, DE	2010	NA	90133	82471	7662	8.5
CN1100100000000	11	001	District of Columbia	2010	NA	346065	313508	32557	9.4
CN1200100000000	12	001	Alachua County, FL	2010	NA	128370	118072	10298	8
CN1200300000000	12	003	Baker County, FL	2010	NA	11552	10246	1306	11.3
CN1200500000000	12	005	Bay County, FL	2010	NA	86072	77054	9018	10.5
CN1200700000000	12	007	Bradford County, FL	2010	NA	11587	10444	1143	9.9
CN1200900000000	12	009	Brevard County, FL	2010	NA	265643	235757	29886	11.3
CN1201100000000	12	011	Broward County, FL	2010	NA	936563	841473	95090	10.2
CN1201300000000	12	013	Calhoun County, FL	2010	NA	5314	4777	537	10.1
CN1201500000000	12	015	Charlotte County, FL	2010	NA	66293	57846	8447	12.7
CN1201700000000	12	017	Citrus County, FL	2010	NA	52847	45594	7253	13.7
CN1201900000000	12	019	Clay County, FL	2010	NA	95867	86356	9511	9.9
CN1202100000000	12	021	Collier County, FL	2010	NA	145349	128427	16922	11.6
CN1202300000000	12	023	Columbia County, FL	2010	NA	28788	25669	3119	10.8
CN1202700000000	12	027	DeSoto County, FL	2010	NA	13081	11481	1600	12.2
CN1202900000000	12	029	Dixie County, FL	2010	NA	5749	5008	741	12.9
CN1203100000000	12	031	Duval County, FL	2010	NA	454798	403171	51627	11.4
CN1203300000000	12	033	Escambia County, FL	2010	NA	139913	125755	14158	10.1
CN1203500000000	12	035	Flagler County, FL	2010	NA	41338	36208	5130	12.4
CN1203700000000	12	037	Franklin County, FL	2010	NA	4936	4543	393	8
CN1203900000000	12	039	Gadsden County, FL	2010	NA	20080	17714	2366	11.8
CN1204100000000	12	041	Gilchrist County, FL	2010	NA	6874	6132	742	10.8
CN1204300000000	12	043	Glades County, FL	2010	NA	5544	5017	527	9.5
CN1204500000000	12	045	Gulf County, FL	2010	NA	6232	5591	641	10.3
CN1204700000000	12	047	Hamilton County, FL	2010	NA	4808	4258	550	11.4
CN1204900000000	12	049	Hardee County, FL	2010	NA	11764	10410	1354	11.5
CN1205100000000	12	051	Hendry County, FL	2010	NA	18361	15786	2575	14
CN1205300000000	12	053	Hernando County, FL	2010	NA	66470	57464	9006	13.5
CN1205500000000	12	055	Highlands County, FL	2010	NA	37247	32587	4660	12.5
CN1205700000000	12	057	Hillsborough County, FL	2010	NA	645687	576400	69287	10.7
CN1205900000000	12	059	Holmes County, FL	2010	NA	7190	6445	745	10.4
CN1206100000000	12	061	Indian River County, FL	2010	NA	61384	52848	8536	13.9
CN1206300000000	12	063	Jackson County, FL	2010	NA	18938	17214	1724	9.1
CN1206500000000	12	065	Jefferson County, FL	2010	NA	6042	5443	599	9.9
CN1206700000000	12	067	Lafayette County, FL	2010	NA	3404	3156	248	7.3
CN1206900000000	12	069	Lake County, FL	2010	NA	134021	118246	15775	11.8
CN1207100000000	12	071	Lee County, FL	2010	NA	283236	247790	35446	12.5
CN1207300000000	12	073	Leon County, FL	2010	NA	149972	138074	11898	7.9
CN1207500000000	12	075	Levy County, FL	2010	NA	17327	15262	2065	11.9
CN1207700000000	12	077	Liberty County, FL	2010	NA	2933	2676	257	8.8
CN1207900000000	12	079	Madison County, FL	2010	NA	7946	7148	798	10
CN1208100000000	12	081	Manatee County, FL	2010	NA	147572	130750	16822	11.4
CN1208300000000	12	083	Marion County, FL	2010	NA	132351	114297	18054	13.6
CN1208500000000	12	085	Martin County, FL	2010	NA	66636	59472	7164	10.8
CN1208600000000	12	086	Miami-Dade County, FL	2010	NA	1225397	1089226	136171	11.1
CN1208700000000	12	087	Monroe County, FL	2010	NA	42182	38904	3278	7.8
CN1208900000000	12	089	Nassau County, FL	2010	NA	35799	31995	3804	10.6
CN1209100000000	12	091	Okaloosa County, FL	2010	NA	89046	81547	7499	8.4
CN1209300000000	12	093	Okeechobee County, FL	2010	NA	18103	15816	2287	12.6
CN1209500000000	12	095	Orange County, FL	2010	NA	635299	566478	68821	10.8
CN1209700000000	12	097	Osceola County, FL	2010	NA	137372	120253	17119	12.5
CN1209900000000	12	099	Palm Beach County, FL	2010	NA	645737	574890	70847	11
CN1210100000000	12	101	Pasco County, FL	2010	NA	207364	182593	24771	11.9
CN1210300000000	12	103	Pinellas County, FL	2010	NA	465178	414856	50322	10.8
CN1210500000000	12	105	Polk County, FL	2010	NA	278479	244668	33811	12.1
CN1210700000000	12	107	Putnam County, FL	2010	NA	30518	26434	4084	13.4
CN1210900000000	12	109	St. Johns County, FL	2010	NA	99104	90440	8664	8.7
CN1211100000000	12	111	St. Lucie County, FL	2010	NA	128690	110976	17714	13.8
CN1211300000000	12	113	Santa Rosa County, FL	2010	NA	71333	64713	6620	9.3
CN1211500000000	12	115	Sarasota County, FL	2010	NA	167222	147825	19397	11.6
CN1211700000000	12	117	Seminole County, FL	2010	NA	230697	206168	24529	10.6
CN1211900000000	12	119	Sumter County, FL	2010	NA	25310	21955	3355	13.3
CN1212100000000	12	121	Suwannee County, FL	2010	NA	19153	17267	1886	9.8
CN1212300000000	12	123	Taylor County, FL	2010	NA	9473	8471	1002	10.6
CN1212500000000	12	125	Union County, FL	2010	NA	5479	5013	466	8.5
CN1212700000000	12	127	Volusia County, FL	2010	NA	238183	208987	29196	12.3
CN1212900000000	12	129	Wakulla County, FL	2010	NA	14589	13368	1221	8.4
CN1213100000000	12	131	Walton County, FL	2010	NA	25984	23547	2437	9.4
CN1213300000000	12	133	Washington County, FL	2010	NA	10298	9210	1088	10.6
CN1300100000000	13	001	Appling County, GA	2010	NA	8746	7710	1036	11.8
CN1300300000000	13	003	Atkinson County, GA	2010	NA	3451	2925	526	15.2
CN1300500000000	13	005	Bacon County, GA	2010	NA	4542	4059	483	10.6
CN1300700000000	13	007	Baker County, GA	2010	NA	1232	1083	149	12.1
CN1300900000000	13	009	Baldwin County, GA	2010	NA	19192	16243	2949	15.4
CN1301100000000	13	011	Banks County, GA	2010	NA	8457	7640	817	9.7
CN1301300000000	13	013	Barrow County, GA	2010	NA	34670	30939	3731	10.8
CN1301500000000	13	015	Bartow County, GA	2010	NA	47837	42007	5830	12.2
CN1301700000000	13	017	Ben Hill County, GA	2010	NA	6516	5481	1035	15.9
CN1301900000000	13	019	Berrien County, GA	2010	NA	7990	6951	1039	13
CN1302100000000	13	021	Bibb County, GA	2010	NA	70225	62053	8172	11.6
CN1302300000000	13	023	Bleckley County, GA	2010	NA	5474	4792	682	12.5
CN1302500000000	13	025	Brantley County, GA	2010	NA	7468	6516	952	12.7
CN1302700000000	13	027	Brooks County, GA	2010	NA	7309	6605	704	9.6
CN1302900000000	13	029	Bryan County, GA	2010	NA	14455	13070	1385	9.6
CN1303100000000	13	031	Bulloch County, GA	2010	NA	33132	29802	3330	10.1
CN1303300000000	13	033	Burke County, GA	2010	NA	9791	8601	1190	12.2
CN1303500000000	13	035	Butts County, GA	2010	NA	10491	9288	1203	11.5
CN1303700000000	13	037	Calhoun County, GA	2010	NA	2620	2390	230	8.8
CN1303900000000	13	039	Camden County, GA	2010	NA	20695	18643	2052	9.9
CN1304300000000	13	043	Candler County, GA	2010	NA	4917	4482	435	8.8
CN1304500000000	13	045	Carroll County, GA	2010	NA	51817	45762	6055	11.7
CN1304700000000	13	047	Catoosa County, GA	2010	NA	31351	28665	2686	8.6
CN1304900000000	13	049	Charlton County, GA	2010	NA	4797	4288	509	10.6
CN1305100000000	13	051	Chatham County, GA	2010	NA	127323	114777	12546	9.9
CN1305300000000	13	053	Chattahoochee County, GA	2010	NA	2218	1976	242	10.9
CN1305500000000	13	055	Chattooga County, GA	2010	NA	10671	9425	1246	11.7
CN1305700000000	13	057	Cherokee County, GA	2010	NA	112578	102687	9891	8.8
CN1305900000000	13	059	Clarke County, GA	2010	NA	56637	51361	5276	9.3
CN1306100000000	13	061	Clay County, GA	2010	NA	1101	973	128	11.6
CN1306300000000	13	063	Clayton County, GA	2010	NA	125156	108243	16913	13.5
CN1306500000000	13	065	Clinch County, GA	2010	NA	2900	2579	321	11.1
CN1306700000000	13	067	Cobb County, GA	2010	NA	380297	344871	35426	9.3
CN1306900000000	13	069	Coffee County, GA	2010	NA	17202	14484	2718	15.8
CN1307100000000	13	071	Colquitt County, GA	2010	NA	21316	19247	2069	9.7
CN1307300000000	13	073	Columbia County, GA	2010	NA	61522	57027	4495	7.3
CN1307500000000	13	075	Cook County, GA	2010	NA	7885	6966	919	11.7
CN1307700000000	13	077	Coweta County, GA	2010	NA	64319	58095	6224	9.7
CN1307900000000	13	079	Crawford County, GA	2010	NA	5769	5109	660	11.4
CN1308100000000	13	081	Crisp County, GA	2010	NA	9208	7901	1307	14.2
CN1308300000000	13	083	Dade County, GA	2010	NA	8348	7624	724	8.7
CN1308500000000	13	085	Dawson County, GA	2010	NA	10966	9771	1195	10.9
CN1308700000000	13	087	Decatur County, GA	2010	NA	12446	10897	1549	12.4
CN1308900000000	13	089	DeKalb County, GA	2010	NA	363001	323687	39314	10.8
CN1309100000000	13	091	Dodge County, GA	2010	NA	8361	7271	1090	13
CN1309300000000	13	093	Dooly County, GA	2010	NA	4960	4386	574	11.6
CN1309500000000	13	095	Dougherty County, GA	2010	NA	41490	36281	5209	12.6
CN1309700000000	13	097	Douglas County, GA	2010	NA	66575	59108	7467	11.2
CN1309900000000	13	099	Early County, GA	2010	NA	4478	3953	525	11.7
CN1310100000000	13	101	Echols County, GA	2010	NA	1876	1722	154	8.2
CN1310300000000	13	103	Effingham County, GA	2010	NA	25777	23310	2467	9.6
CN1310500000000	13	105	Elbert County, GA	2010	NA	8934	7605	1329	14.9
CN1310700000000	13	107	Emanuel County, GA	2010	NA	9118	7946	1172	12.9
CN1310900000000	13	109	Evans County, GA	2010	NA	4769	4336	433	9.1
CN1311100000000	13	111	Fannin County, GA	2010	NA	10271	9070	1201	11.7
CN1311300000000	13	113	Fayette County, GA	2010	NA	52927	48564	4363	8.2
CN1311500000000	13	115	Floyd County, GA	2010	NA	45087	39750	5337	11.8
CN1311700000000	13	117	Forsyth County, GA	2010	NA	88343	81251	7092	8
CN1311900000000	13	119	Franklin County, GA	2010	NA	9698	8468	1230	12.7
CN1312100000000	13	121	Fulton County, GA	2010	NA	485002	434315	50687	10.5
CN1312300000000	13	123	Gilmer County, GA	2010	NA	12811	11366	1445	11.3
CN1312500000000	13	125	Glascock County, GA	2010	NA	1324	1178	146	11
CN1312700000000	13	127	Glynn County, GA	2010	NA	38340	34508	3832	10
CN1312900000000	13	129	Gordon County, GA	2010	NA	26068	22749	3319	12.7
CN1313100000000	13	131	Grady County, GA	2010	NA	10399	9309	1090	10.5
CN1313300000000	13	133	Greene County, GA	2010	NA	6412	5567	845	13.2
CN1313500000000	13	135	Gwinnett County, GA	2010	NA	418368	379794	38574	9.2
CN1313700000000	13	137	Habersham County, GA	2010	NA	18347	16390	1957	10.7
CN1313900000000	13	139	Hall County, GA	2010	NA	86546	78205	8341	9.6
CN1314100000000	13	141	Hancock County, GA	2010	NA	3104	2393	711	22.9
CN1314300000000	13	143	Haralson County, GA	2010	NA	12385	10866	1519	12.3
CN1314500000000	13	145	Harris County, GA	2010	NA	16415	15149	1266	7.7
CN1314700000000	13	147	Hart County, GA	2010	NA	10959	9697	1262	11.5
CN1314900000000	13	149	Heard County, GA	2010	NA	5249	4615	634	12.1
CN1315100000000	13	151	Henry County, GA	2010	NA	101141	90686	10455	10.3
CN1315300000000	13	153	Houston County, GA	2010	NA	67099	61422	5677	8.5
CN1315500000000	13	155	Irwin County, GA	2010	NA	3674	3135	539	14.7
CN1315700000000	13	157	Jackson County, GA	2010	NA	28656	25660	2996	10.5
CN1315900000000	13	159	Jasper County, GA	2010	NA	6873	6069	804	11.7
CN1316100000000	13	161	Jeff Davis County, GA	2010	NA	6372	5557	815	12.8
CN1316300000000	13	163	Jefferson County, GA	2010	NA	7158	6151	1007	14.1
CN1316500000000	13	165	Jenkins County, GA	2010	NA	3229	2738	491	15.2
CN1316700000000	13	167	Johnson County, GA	2010	NA	4240	3781	459	10.8
CN1316900000000	13	169	Jones County, GA	2010	NA	13698	12366	1332	9.7
CN1317100000000	13	171	Lamar County, GA	2010	NA	8160	6998	1162	14.2
CN1317300000000	13	173	Lanier County, GA	2010	NA	3872	3464	408	10.5
CN1317500000000	13	175	Laurens County, GA	2010	NA	20599	17879	2720	13.2
CN1317700000000	13	177	Lee County, GA	2010	NA	14345	13047	1298	9
CN1317900000000	13	179	Liberty County, GA	2010	NA	26927	24493	2434	9
CN1318100000000	13	181	Lincoln County, GA	2010	NA	3679	3256	423	11.5
CN1318300000000	13	183	Long County, GA	2010	NA	6231	5706	525	8.4
CN1318500000000	13	185	Lowndes County, GA	2010	NA	51019	46120	4899	9.6
CN1318700000000	13	187	Lumpkin County, GA	2010	NA	14711	13184	1527	10.4
CN1318900000000	13	189	McDuffie County, GA	2010	NA	9447	8204	1243	13.2
CN1319100000000	13	191	McIntosh County, GA	2010	NA	6289	5625	664	10.6
CN1319300000000	13	193	Macon County, GA	2010	NA	5383	4672	711	13.2
CN1319500000000	13	195	Madison County, GA	2010	NA	13374	11984	1390	10.4
CN1319700000000	13	197	Marion County, GA	2010	NA	3723	3326	397	10.7
CN1319900000000	13	199	Meriwether County, GA	2010	NA	9336	8054	1282	13.7
CN1320100000000	13	201	Miller County, GA	2010	NA	2803	2512	291	10.4
CN1320500000000	13	205	Mitchell County, GA	2010	NA	9646	8602	1044	10.8
CN1320700000000	13	207	Monroe County, GA	2010	NA	12551	11273	1278	10.2
CN1320900000000	13	209	Montgomery County, GA	2010	NA	3876	3411	465	12
CN1321100000000	13	211	Morgan County, GA	2010	NA	8630	7729	901	10.4
CN1321300000000	13	213	Murray County, GA	2010	NA	17181	14812	2369	13.8
CN1321500000000	13	215	Muscogee County, GA	2010	NA	81718	73484	8234	10.1
CN1321700000000	13	217	Newton County, GA	2010	NA	47977	41899	6078	12.7
CN1321900000000	13	219	Oconee County, GA	2010	NA	16837	15635	1202	7.1
CN1322100000000	13	221	Oglethorpe County, GA	2010	NA	7079	6396	683	9.6
CN1322300000000	13	223	Paulding County, GA	2010	NA	73735	66352	7383	10
CN1322500000000	13	225	Peach County, GA	2010	NA	12918	11359	1559	12.1
CN1322700000000	13	227	Pickens County, GA	2010	NA	14045	12505	1540	11
CN1322900000000	13	229	Pierce County, GA	2010	NA	8245	7387	858	10.4
CN1323100000000	13	231	Pike County, GA	2010	NA	8505	7599	906	10.7
CN1323300000000	13	233	Polk County, GA	2010	NA	18690	16444	2246	12
CN1323500000000	13	235	Pulaski County, GA	2010	NA	4530	4112	418	9.2
CN1323700000000	13	237	Putnam County, GA	2010	NA	9053	7883	1170	12.9
CN1323900000000	13	239	Quitman County, GA	2010	NA	1006	905	101	10
CN1324100000000	13	241	Rabun County, GA	2010	NA	7141	6298	843	11.8
CN1324300000000	13	243	Randolph County, GA	2010	NA	2979	2616	363	12.2
CN1324500000000	13	245	Richmond County, GA	2010	NA	87887	78209	9678	11
CN1324700000000	13	247	Rockdale County, GA	2010	NA	41960	37210	4750	11.3
CN1324900000000	13	249	Schley County, GA	2010	NA	2165	1903	262	12.1
CN1325100000000	13	251	Screven County, GA	2010	NA	5804	4818	986	17
CN1325300000000	13	253	Seminole County, GA	2010	NA	3383	2959	424	12.5
CN1325500000000	13	255	Spalding County, GA	2010	NA	28669	24409	4260	14.9
CN1325700000000	13	257	Stephens County, GA	2010	NA	11892	10429	1463	12.3
CN1325900000000	13	259	Stewart County, GA	2010	NA	2402	2154	248	10.3
CN1326100000000	13	261	Sumter County, GA	2010	NA	14262	12370	1892	13.3
CN1326300000000	13	263	Talbot County, GA	2010	NA	2875	2585	290	10.1
CN1326500000000	13	265	Taliaferro County, GA	2010	NA	634	520	114	18
CN1326700000000	13	267	Tattnall County, GA	2010	NA	9678	8802	876	9.1
CN1326900000000	13	269	Taylor County, GA	2010	NA	3255	2784	471	14.5
CN1327100000000	13	271	Telfair County, GA	2010	NA	5234	4462	772	14.7
CN1327300000000	13	273	Terrell County, GA	2010	NA	3917	3439	478	12.2
CN1327500000000	13	275	Thomas County, GA	2010	NA	17884	15874	2010	11.2
CN1327700000000	13	277	Tift County, GA	2010	NA	18784	16537	2247	12
CN1327900000000	13	279	Toombs County, GA	2010	NA	12303	10792	1511	12.3
CN1328100000000	13	281	Towns County, GA	2010	NA	4341	3783	558	12.9
CN1328300000000	13	283	Treutlen County, GA	2010	NA	2945	2589	356	12.1
CN1328500000000	13	285	Troup County, GA	2010	NA	32546	28788	3758	11.5
CN1328700000000	13	287	Turner County, GA	2010	NA	3530	2944	586	16.6
CN1328900000000	13	289	Twiggs County, GA	2010	NA	3265	2760	505	15.5
CN1329100000000	13	291	Union County, GA	2010	NA	9502	8456	1046	11
CN1329300000000	13	293	Upson County, GA	2010	NA	11932	10471	1461	12.2
CN1329500000000	13	295	Walker County, GA	2010	NA	30980	27788	3192	10.3
CN1329700000000	13	297	Walton County, GA	2010	NA	41037	36667	4370	10.6
CN1329900000000	13	299	Ware County, GA	2010	NA	15561	13847	1714	11
CN1330100000000	13	301	Warren County, GA	2010	NA	2657	2200	457	17.2
CN1330300000000	13	303	Washington County, GA	2010	NA	8124	6943	1181	14.5
CN1330500000000	13	305	Wayne County, GA	2010	NA	12377	10886	1491	12
CN1330700000000	13	307	Webster County, GA	2010	NA	1043	909	134	12.8
CN1330900000000	13	309	Wheeler County, GA	2010	NA	1937	1644	293	15.1
CN1331100000000	13	311	White County, GA	2010	NA	12902	11589	1313	10.2
CN1331300000000	13	313	Whitfield County, GA	2010	NA	47639	41978	5661	11.9
CN1331500000000	13	315	Wilcox County, GA	2010	NA	2935	2570	365	12.4
CN1331700000000	13	317	Wilkes County, GA	2010	NA	4017	3486	531	13.2
CN1331900000000	13	319	Wilkinson County, GA	2010	NA	3842	3303	539	14
CN1332100000000	13	321	Worth County, GA	2010	NA	9781	8597	1184	12.1
CN1500100000000	15	001	Hawaii County, HI	2010	NA	88401	79740	8661	9.8
CN1500300000000	15	003	Honolulu County/city, HI	2010	NA	444198	417638	26560	6
CN1500700000000	15	007	Kauai County, HI	2010	NA	34885	31881	3004	8.6
CN1500900000000	15	009	Maui County, HI	2010	NA	79766	73024	6742	8.5
CN1600100000000	16	001	Ada County, ID	2010	NA	196945	180585	16360	8.3
CN1600300000000	16	003	Adams County, ID	2010	NA	1861	1516	345	18.5
CN1600500000000	16	005	Bannock County, ID	2010	NA	41095	37813	3282	8
CN1600700000000	16	007	Bear Lake County, ID	2010	NA	2884	2670	214	7.4
CN1600900000000	16	009	Benewah County, ID	2010	NA	4209	3636	573	13.6
CN1601100000000	16	011	Bingham County, ID	2010	NA	22848	21201	1647	7.2
CN1601300000000	16	013	Blaine County, ID	2010	NA	11949	10808	1141	9.5
CN1601500000000	16	015	Boise County, ID	2010	NA	3048	2726	322	10.6
CN1601700000000	16	017	Bonner County, ID	2010	NA	19497	16981	2516	12.9
CN1601900000000	16	019	Bonneville County, ID	2010	NA	49099	45683	3416	7
CN1602100000000	16	021	Boundary County, ID	2010	NA	5368	4648	720	13.4
CN1602300000000	16	023	Butte County, ID	2010	NA	1352	1254	98	7.2
CN1602500000000	16	025	Camas County, ID	2010	NA	643	561	82	12.8
CN1602700000000	16	027	Canyon County, ID	2010	NA	84738	75198	9540	11.3
CN1602900000000	16	029	Caribou County, ID	2010	NA	3841	3541	300	7.8
CN1603100000000	16	031	Cassia County, ID	2010	NA	11114	10327	787	7.1
CN1603300000000	16	033	Clark County, ID	2010	NA	537	487	50	9.3
CN1603500000000	16	035	Clearwater County, ID	2010	NA	3423	2922	501	14.6
CN1603700000000	16	037	Custer County, ID	2010	NA	2295	2107	188	8.2
CN1603900000000	16	039	Elmore County, ID	2010	NA	11395	10411	984	8.6
CN1604100000000	16	041	Franklin County, ID	2010	NA	6195	5868	327	5.3
CN1604300000000	16	043	Fremont County, ID	2010	NA	6746	6162	584	8.7
CN1604500000000	16	045	Gem County, ID	2010	NA	7681	6803	878	11.4
CN1604700000000	16	047	Gooding County, ID	2010	NA	8496	7862	634	7.5
CN1604900000000	16	049	Idaho County, ID	2010	NA	6654	5824	830	12.5
CN1605100000000	16	051	Jefferson County, ID	2010	NA	12611	11721	890	7.1
CN1605300000000	16	053	Jerome County, ID	2010	NA	11005	10119	886	8.1
CN1605500000000	16	055	Kootenai County, ID	2010	NA	68859	61345	7514	10.9
CN1605700000000	16	057	Latah County, ID	2010	NA	19282	18002	1280	6.6
CN1605900000000	16	059	Lemhi County, ID	2010	NA	3775	3390	385	10.2
CN1606100000000	16	061	Lewis County, ID	2010	NA	1571	1466	105	6.7
CN1606300000000	16	063	Lincoln County, ID	2010	NA	2709	2355	354	13.1
CN1606500000000	16	065	Madison County, ID	2010	NA	17485	16546	939	5.4
CN1606700000000	16	067	Minidoka County, ID	2010	NA	10468	9691	777	7.4
CN1606900000000	16	069	Nez Perce County, ID	2010	NA	20088	18744	1344	6.7
CN1607100000000	16	071	Oneida County, ID	2010	NA	2007	1886	121	6
CN1607300000000	16	073	Owyhee County, ID	2010	NA	5051	4839	212	4.2
CN1607500000000	16	075	Payette County, ID	2010	NA	11145	10067	1078	9.7
CN1607700000000	16	077	Power County, ID	2010	NA	3872	3515	357	9.2
CN1607900000000	16	079	Shoshone County, ID	2010	NA	5488	4615	873	15.9
CN1608100000000	16	081	Teton County, ID	2010	NA	5447	5019	428	7.9
CN1608300000000	16	083	Twin Falls County, ID	2010	NA	36865	33718	3147	8.5
CN1608500000000	16	085	Valley County, ID	2010	NA	4693	3957	736	15.7
CN1608700000000	16	087	Washington County, ID	2010	NA	4726	4238	488	10.3
CN1700100000000	17	001	Adams County, IL	2010	NA	34946	32249	2697	7.7
CN1700300000000	17	003	Alexander County, IL	2010	NA	2974	2625	349	11.7
CN1700500000000	17	005	Bond County, IL	2010	NA	8545	7688	857	10
CN1700700000000	17	007	Boone County, IL	2010	NA	27423	23634	3789	13.8
CN1700900000000	17	009	Brown County, IL	2010	NA	2590	2410	180	6.9
CN1701100000000	17	011	Bureau County, IL	2010	NA	19189	17119	2070	10.8
CN1701300000000	17	013	Calhoun County, IL	2010	NA	2501	2250	251	10
CN1701500000000	17	015	Carroll County, IL	2010	NA	8554	7664	890	10.4
CN1701700000000	17	017	Cass County, IL	2010	NA	7003	6422	581	8.3
CN1701900000000	17	019	Champaign County, IL	2010	NA	109105	100163	8942	8.2
CN1702100000000	17	021	Christian County, IL	2010	NA	17186	15444	1742	10.1
CN1702300000000	17	023	Clark County, IL	2010	NA	8331	7358	973	11.7
CN1702500000000	17	025	Clay County, IL	2010	NA	6834	6062	772	11.3
CN1702700000000	17	027	Clinton County, IL	2010	NA	20574	19075	1499	7.3
CN1702900000000	17	029	Coles County, IL	2010	NA	25701	23182	2519	9.8
CN1703100000000	17	031	Cook County, IL	2010	NA	2643831	2356470	287361	10.9
CN1703300000000	17	033	Crawford County, IL	2010	NA	10400	9512	888	8.5
CN1703500000000	17	035	Cumberland County, IL	2010	NA	6076	5519	557	9.2
CN1703700000000	17	037	DeKalb County, IL	2010	NA	56454	50525	5929	10.5
CN1703900000000	17	039	De Witt County, IL	2010	NA	8821	8054	767	8.7
CN1704100000000	17	041	Douglas County, IL	2010	NA	10351	9445	906	8.8
CN1704300000000	17	043	DuPage County, IL	2010	NA	502808	458265	44543	8.9
CN1704500000000	17	045	Edgar County, IL	2010	NA	9476	8416	1060	11.2
CN1704700000000	17	047	Edwards County, IL	2010	NA	3234	2952	282	8.7
CN1704900000000	17	049	Effingham County, IL	2010	NA	18688	17216	1472	7.9
CN1705100000000	17	051	Fayette County, IL	2010	NA	11255	10123	1132	10.1
CN1705300000000	17	053	Ford County, IL	2010	NA	7301	6612	689	9.4
CN1705500000000	17	055	Franklin County, IL	2010	NA	18024	15803	2221	12.3
CN1705700000000	17	057	Fulton County, IL	2010	NA	17609	15551	2058	11.7
CN1705900000000	17	059	Gallatin County, IL	2010	NA	2640	2387	253	9.6
CN1706100000000	17	061	Greene County, IL	2010	NA	6824	6191	633	9.3
CN1706300000000	17	063	Grundy County, IL	2010	NA	25954	22506	3448	13.3
CN1706500000000	17	065	Hamilton County, IL	2010	NA	4019	3641	378	9.4
CN1706700000000	17	067	Hancock County, IL	2010	NA	9971	8918	1053	10.6
CN1706900000000	17	069	Hardin County, IL	2010	NA	1797	1603	194	10.8
CN1707100000000	17	071	Henderson County, IL	2010	NA	3934	3568	366	9.3
CN1707300000000	17	073	Henry County, IL	2010	NA	26846	24409	2437	9.1
CN1707500000000	17	075	Iroquois County, IL	2010	NA	16010	14394	1616	10.1
CN1707700000000	17	077	Jackson County, IL	2010	NA	29896	27438	2458	8.2
CN1707900000000	17	079	Jasper County, IL	2010	NA	5106	4652	454	8.9
CN1708100000000	17	081	Jefferson County, IL	2010	NA	18255	16394	1861	10.2
CN1708300000000	17	083	Jersey County, IL	2010	NA	11626	10563	1063	9.1
CN1708500000000	17	085	Jo Daviess County, IL	2010	NA	12465	11357	1108	8.9
CN1708700000000	17	087	Johnson County, IL	2010	NA	4459	3903	556	12.5
CN1708900000000	17	089	Kane County, IL	2010	NA	267551	238083	29468	11
CN1709100000000	17	091	Kankakee County, IL	2010	NA	56471	49402	7069	12.5
CN1709300000000	17	093	Kendall County, IL	2010	NA	62410	56085	6325	10.1
CN1709500000000	17	095	Knox County, IL	2010	NA	25380	22958	2422	9.5
CN1709700000000	17	097	Lake County, IL	2010	NA	369782	333379	36403	9.8
CN1709900000000	17	099	LaSalle County, IL	2010	NA	61928	54500	7428	12
CN1710100000000	17	101	Lawrence County, IL	2010	NA	6714	5995	719	10.7
CN1710300000000	17	103	Lee County, IL	2010	NA	19260	17332	1928	10
CN1710500000000	17	105	Livingston County, IL	2010	NA	19338	17412	1926	10
CN1710700000000	17	107	Logan County, IL	2010	NA	13949	12738	1211	8.7
CN1710900000000	17	109	McDonough County, IL	2010	NA	15663	14328	1335	8.5
CN1711100000000	17	111	McHenry County, IL	2010	NA	168798	151014	17784	10.5
CN1711300000000	17	113	McLean County, IL	2010	NA	96252	89465	6787	7.1
CN1711500000000	17	115	Macon County, IL	2010	NA	55576	49414	6162	11.1
CN1711700000000	17	117	Macoupin County, IL	2010	NA	24811	22257	2554	10.3
CN1711900000000	17	119	Madison County, IL	2010	NA	138924	125294	13630	9.8
CN1712100000000	17	121	Marion County, IL	2010	NA	19417	17318	2099	10.8
CN1712300000000	17	123	Marshall County, IL	2010	NA	6432	5773	659	10.2
CN1712500000000	17	125	Mason County, IL	2010	NA	7439	6531	908	12.2
CN1712700000000	17	127	Massac County, IL	2010	NA	7080	6409	671	9.5
CN1712900000000	17	129	Menard County, IL	2010	NA	7062	6524	538	7.6
CN1713100000000	17	131	Mercer County, IL	2010	NA	8996	8103	893	9.9
CN1713300000000	17	133	Monroe County, IL	2010	NA	18029	16714	1315	7.3
CN1713500000000	17	135	Montgomery County, IL	2010	NA	13899	12191	1708	12.3
CN1713700000000	17	137	Morgan County, IL	2010	NA	18396	16845	1551	8.4
CN1713900000000	17	139	Moultrie County, IL	2010	NA	7696	7040	656	8.5
CN1714100000000	17	141	Ogle County, IL	2010	NA	28232	24726	3506	12.4
CN1714300000000	17	143	Peoria County, IL	2010	NA	96088	86003	10085	10.5
CN1714500000000	17	145	Perry County, IL	2010	NA	9604	8545	1059	11
CN1714700000000	17	147	Piatt County, IL	2010	NA	9187	8468	719	7.8
CN1714900000000	17	149	Pike County, IL	2010	NA	8136	7408	728	8.9
CN1715100000000	17	151	Pope County, IL	2010	NA	2034	1842	192	9.4
CN1715300000000	17	153	Pulaski County, IL	2010	NA	2482	2174	308	12.4
CN1715500000000	17	155	Putnam County, IL	2010	NA	3315	2917	398	12
CN1715700000000	17	157	Randolph County, IL	2010	NA	15043	13725	1318	8.8
CN1715900000000	17	159	Richland County, IL	2010	NA	8025	7310	715	8.9
CN1716100000000	17	161	Rock Island County, IL	2010	NA	76668	69390	7278	9.5
CN1716300000000	17	163	St. Clair County, IL	2010	NA	133250	119567	13683	10.3
CN1716500000000	17	165	Saline County, IL	2010	NA	11648	10463	1185	10.2
CN1716700000000	17	167	Sangamon County, IL	2010	NA	107334	98921	8413	7.8
CN1716900000000	17	169	Schuyler County, IL	2010	NA	3870	3551	319	8.2
CN1717100000000	17	171	Scott County, IL	2010	NA	2884	2633	251	8.7
CN1717300000000	17	173	Shelby County, IL	2010	NA	11233	10143	1090	9.7
CN1717500000000	17	175	Stark County, IL	2010	NA	3031	2736	295	9.7
CN1717700000000	17	177	Stephenson County, IL	2010	NA	24706	21976	2730	11
CN1717900000000	17	179	Tazewell County, IL	2010	NA	71721	64615	7106	9.9
CN1718100000000	17	181	Union County, IL	2010	NA	7980	7026	954	12
CN1718300000000	17	183	Vermilion County, IL	2010	NA	37823	33482	4341	11.5
CN1718500000000	17	185	Wabash County, IL	2010	NA	5870	5297	573	9.8
CN1718700000000	17	187	Warren County, IL	2010	NA	9309	8587	722	7.8
CN1718900000000	17	189	Washington County, IL	2010	NA	8508	7892	616	7.2
CN1719100000000	17	191	Wayne County, IL	2010	NA	8407	7659	748	8.9
CN1719300000000	17	193	White County, IL	2010	NA	7592	6948	644	8.5
CN1719500000000	17	195	Whiteside County, IL	2010	NA	29939	26855	3084	10.3
CN1719700000000	17	197	Will County, IL	2010	NA	355646	316212	39434	11.1
CN1719900000000	17	199	Williamson County, IL	2010	NA	32568	29410	3158	9.7
CN1720100000000	17	201	Winnebago County, IL	2010	NA	150002	128938	21064	14
CN1720300000000	17	203	Woodford County, IL	2010	NA	20354	18794	1560	7.7
CN1800100000000	18	001	Adams County, IN	2010	NA	16398	14744	1654	10.1
CN1800300000000	18	003	Allen County, IN	2010	NA	175942	157113	18829	10.7
CN1800500000000	18	005	Bartholomew County, IN	2010	NA	38387	34727	3660	9.5
CN1800700000000	18	007	Benton County, IN	2010	NA	4662	4232	430	9.2
CN1800900000000	18	009	Blackford County, IN	2010	NA	5847	5007	840	14.4
CN1801100000000	18	011	Boone County, IN	2010	NA	29395	27163	2232	7.6
CN1801300000000	18	013	Brown County, IN	2010	NA	7566	6781	785	10.4
CN1801500000000	18	015	Carroll County, IN	2010	NA	10254	9239	1015	9.9
CN1801700000000	18	017	Cass County, IN	2010	NA	18851	16810	2041	10.8
CN1801900000000	18	019	Clark County, IN	2010	NA	55317	50043	5274	9.5
CN1802100000000	18	021	Clay County, IN	2010	NA	13180	11712	1468	11.1
CN1802300000000	18	023	Clinton County, IN	2010	NA	16899	15185	1714	10.1
CN1802500000000	18	025	Crawford County, IN	2010	NA	4919	4283	636	12.9
CN1802700000000	18	027	Daviess County, IN	2010	NA	14747	13790	957	6.5
CN1802900000000	18	029	Dearborn County, IN	2010	NA	25524	22752	2772	10.9
CN1803100000000	18	031	Decatur County, IN	2010	NA	12919	11415	1504	11.6
CN1803300000000	18	033	DeKalb County, IN	2010	NA	20595	18138	2457	11.9
CN1803500000000	18	035	Delaware County, IN	2010	NA	54724	48402	6322	11.6
CN1803700000000	18	037	Dubois County, IN	2010	NA	21927	20285	1642	7.5
CN1803900000000	18	039	Elkhart County, IN	2010	NA	94498	81899	12599	13.3
CN1804100000000	18	041	Fayette County, IN	2010	NA	9770	8342	1428	14.6
CN1804300000000	18	043	Floyd County, IN	2010	NA	37858	34505	3353	8.9
CN1804500000000	18	045	Fountain County, IN	2010	NA	8602	7587	1015	11.8
CN1804700000000	18	047	Franklin County, IN	2010	NA	11395	10088	1307	11.5
CN1804900000000	18	049	Fulton County, IN	2010	NA	10284	9109	1175	11.4
CN1805100000000	18	051	Gibson County, IN	2010	NA	16897	15543	1354	8
CN1805300000000	18	053	Grant County, IN	2010	NA	33554	29667	3887	11.6
CN1805500000000	18	055	Greene County, IN	2010	NA	14390	12856	1534	10.7
CN1805700000000	18	057	Hamilton County, IN	2010	NA	144862	135159	9703	6.7
CN1805900000000	18	059	Hancock County, IN	2010	NA	35810	32492	3318	9.3
CN1806100000000	18	061	Harrison County, IN	2010	NA	18989	17118	1871	9.9
CN1806300000000	18	063	Hendricks County, IN	2010	NA	74718	68852	5866	7.9
CN1806500000000	18	065	Henry County, IN	2010	NA	21391	18426	2965	13.9
CN1806700000000	18	067	Howard County, IN	2010	NA	35806	31300	4506	12.6
CN1806900000000	18	069	Huntington County, IN	2010	NA	19039	16774	2265	11.9
CN1807100000000	18	071	Jackson County, IN	2010	NA	20476	18323	2153	10.5
CN1807300000000	18	073	Jasper County, IN	2010	NA	16141	14456	1685	10.4
CN1807500000000	18	075	Jay County, IN	2010	NA	10627	9494	1133	10.7
CN1807700000000	18	077	Jefferson County, IN	2010	NA	15464	13709	1755	11.3
CN1807900000000	18	079	Jennings County, IN	2010	NA	13303	11581	1722	12.9
CN1808100000000	18	081	Johnson County, IN	2010	NA	71598	65283	6315	8.8
CN1808300000000	18	083	Knox County, IN	2010	NA	18520	17006	1514	8.2
CN1808500000000	18	085	Kosciusko County, IN	2010	NA	39226	34899	4327	11
CN1808700000000	18	087	LaGrange County, IN	2010	NA	16570	14574	1996	12
CN1808900000000	18	089	Lake County, IN	2010	NA	229143	204409	24734	10.8
CN1809100000000	18	091	LaPorte County, IN	2010	NA	51336	45158	6178	12
CN1809300000000	18	093	Lawrence County, IN	2010	NA	20728	18100	2628	12.7
CN1809500000000	18	095	Madison County, IN	2010	NA	59406	52242	7164	12.1
CN1809700000000	18	097	Marion County, IN	2010	NA	452836	405071	47765	10.5
CN1809900000000	18	099	Marshall County, IN	2010	NA	23476	20823	2653	11.3
CN1810100000000	18	101	Martin County, IN	2010	NA	5262	4865	397	7.5
CN1810300000000	18	103	Miami County, IN	2010	NA	15947	13956	1991	12.5
CN1810500000000	18	105	Monroe County, IN	2010	NA	67736	62375	5361	7.9
CN1810700000000	18	107	Montgomery County, IN	2010	NA	18896	16970	1926	10.2
CN1810900000000	18	109	Morgan County, IN	2010	NA	35025	31393	3632	10.4
CN1811100000000	18	111	Newton County, IN	2010	NA	7075	6272	803	11.3
CN1811300000000	18	113	Noble County, IN	2010	NA	23011	19984	3027	13.2
CN1811500000000	18	115	Ohio County, IN	2010	NA	3263	2902	361	11.1
CN1811700000000	18	117	Orange County, IN	2010	NA	9110	7948	1162	12.8
CN1811900000000	18	119	Owen County, IN	2010	NA	10316	9126	1190	11.5
CN1812100000000	18	121	Parke County, IN	2010	NA	7332	6530	802	10.9
CN1812300000000	18	123	Perry County, IN	2010	NA	8931	7987	944	10.6
CN1812500000000	18	125	Pike County, IN	2010	NA	6199	5611	588	9.5
CN1812700000000	18	127	Porter County, IN	2010	NA	81607	73876	7731	9.5
CN1812900000000	18	129	Posey County, IN	2010	NA	13494	12440	1054	7.8
CN1813100000000	18	131	Pulaski County, IN	2010	NA	6370	5736	634	10
CN1813300000000	18	133	Putnam County, IN	2010	NA	16674	14732	1942	11.6
CN1813500000000	18	135	Randolph County, IN	2010	NA	13019	11486	1533	11.8
CN1813700000000	18	137	Ripley County, IN	2010	NA	14527	12898	1629	11.2
CN1813900000000	18	139	Rush County, IN	2010	NA	8683	7716	967	11.1
CN1814100000000	18	141	St. Joseph County, IN	2010	NA	130462	115384	15078	11.6
CN1814300000000	18	143	Scott County, IN	2010	NA	10590	9195	1395	13.2
CN1814500000000	18	145	Shelby County, IN	2010	NA	22714	20223	2491	11
CN1814700000000	18	147	Spencer County, IN	2010	NA	10996	10030	966	8.8
CN1814900000000	18	149	Starke County, IN	2010	NA	10444	9052	1392	13.3
CN1815100000000	18	151	Steuben County, IN	2010	NA	18439	16386	2053	11.1
CN1815300000000	18	153	Sullivan County, IN	2010	NA	9085	8170	915	10.1
CN1815500000000	18	155	Switzerland County, IN	2010	NA	5025	4558	467	9.3
CN1815700000000	18	157	Tippecanoe County, IN	2010	NA	86531	78864	7667	8.9
CN1815900000000	18	159	Tipton County, IN	2010	NA	8046	7221	825	10.3
CN1816100000000	18	161	Union County, IN	2010	NA	3729	3346	383	10.3
CN1816300000000	18	163	Vanderburgh County, IN	2010	NA	92127	83894	8233	8.9
CN1816500000000	18	165	Vermillion County, IN	2010	NA	7810	6799	1011	12.9
CN1816700000000	18	167	Vigo County, IN	2010	NA	51128	45401	5727	11.2
CN1816900000000	18	169	Wabash County, IN	2010	NA	15955	14133	1822	11.4
CN1817100000000	18	171	Warren County, IN	2010	NA	4201	3758	443	10.5
CN1817300000000	18	173	Warrick County, IN	2010	NA	30817	28345	2472	8
CN1817500000000	18	175	Washington County, IN	2010	NA	13806	12118	1688	12.2
CN1817700000000	18	177	Wayne County, IN	2010	NA	31330	27310	4020	12.8
CN1817900000000	18	179	Wells County, IN	2010	NA	14137	12757	1380	9.8
CN1818100000000	18	181	White County, IN	2010	NA	12975	11613	1362	10.5
CN1818300000000	18	183	Whitley County, IN	2010	NA	17603	15579	2024	11.5
CN1900100000000	19	001	Adair County, IA	2010	NA	4104	3877	227	5.5
CN1900300000000	19	003	Adams County, IA	2010	NA	2240	2132	108	4.8
CN1900500000000	19	005	Allamakee County, IA	2010	NA	7915	7295	620	7.8
CN1900700000000	19	007	Appanoose County, IA	2010	NA	6199	5748	451	7.3
CN1900900000000	19	009	Audubon County, IA	2010	NA	3477	3283	194	5.6
CN1901100000000	19	011	Benton County, IA	2010	NA	14329	13442	887	6.2
CN1901300000000	19	013	Black Hawk County, IA	2010	NA	70975	66587	4388	6.2
CN1901500000000	19	015	Boone County, IA	2010	NA	14843	13995	848	5.7
CN1901700000000	19	017	Bremer County, IA	2010	NA	13861	13182	679	4.9
CN1901900000000	19	019	Buchanan County, IA	2010	NA	11349	10670	679	6
CN1902100000000	19	021	Buena Vista County, IA	2010	NA	11420	10880	540	4.7
CN1902300000000	19	023	Butler County, IA	2010	NA	8198	7702	496	6.1
CN1902500000000	19	025	Calhoun County, IA	2010	NA	4655	4375	280	6
CN1902700000000	19	027	Carroll County, IA	2010	NA	11712	11207	505	4.3
CN1902900000000	19	029	Cass County, IA	2010	NA	7408	6944	464	6.3
CN1903100000000	19	031	Cedar County, IA	2010	NA	10986	10394	592	5.4
CN1903300000000	19	033	Cerro Gordo County, IA	2010	NA	24560	22879	1681	6.8
CN1903500000000	19	035	Cherokee County, IA	2010	NA	7087	6768	319	4.5
CN1903700000000	19	037	Chickasaw County, IA	2010	NA	6553	6068	485	7.4
CN1903900000000	19	039	Clarke County, IA	2010	NA	4784	4417	367	7.7
CN1904100000000	19	041	Clay County, IA	2010	NA	9346	8798	548	5.9
CN1904300000000	19	043	Clayton County, IA	2010	NA	10481	9736	745	7.1
CN1904500000000	19	045	Clinton County, IA	2010	NA	26449	24591	1858	7
CN1904700000000	19	047	Crawford County, IA	2010	NA	8981	8560	421	4.7
CN1904900000000	19	049	Dallas County, IA	2010	NA	37288	35588	1700	4.6
CN1905100000000	19	051	Davis County, IA	2010	NA	4252	3949	303	7.1
CN1905300000000	19	053	Decatur County, IA	2010	NA	4465	4194	271	6.1
CN1905500000000	19	055	Delaware County, IA	2010	NA	10360	9733	627	6.1
CN1905700000000	19	057	Des Moines County, IA	2010	NA	20210	18706	1504	7.4
CN1905900000000	19	059	Dickinson County, IA	2010	NA	9295	8664	631	6.8
CN1906100000000	19	061	Dubuque County, IA	2010	NA	54212	51076	3136	5.8
CN1906300000000	19	063	Emmet County, IA	2010	NA	5868	5456	412	7
CN1906500000000	19	065	Fayette County, IA	2010	NA	11013	10226	787	7.1
CN1906700000000	19	067	Floyd County, IA	2010	NA	8547	7928	619	7.2
CN1906900000000	19	069	Franklin County, IA	2010	NA	6026	5650	376	6.2
CN1907100000000	19	071	Fremont County, IA	2010	NA	3978	3743	235	5.9
CN1907300000000	19	073	Greene County, IA	2010	NA	5200	4894	306	5.9
CN1907500000000	19	075	Grundy County, IA	2010	NA	6754	6370	384	5.7
CN1907700000000	19	077	Guthrie County, IA	2010	NA	5851	5473	378	6.5
CN1907900000000	19	079	Hamilton County, IA	2010	NA	8081	7493	588	7.3
CN1908100000000	19	081	Hancock County, IA	2010	NA	6069	5666	403	6.6
CN1908300000000	19	083	Hardin County, IA	2010	NA	9131	8536	595	6.5
CN1908500000000	19	085	Harrison County, IA	2010	NA	7999	7553	446	5.6
CN1908700000000	19	087	Henry County, IA	2010	NA	9957	9131	826	8.3
CN1908900000000	19	089	Howard County, IA	2010	NA	5338	5002	336	6.3
CN1909100000000	19	091	Humboldt County, IA	2010	NA	5225	4955	270	5.2
CN1909300000000	19	093	Ida County, IA	2010	NA	3846	3650	196	5.1
CN1909500000000	19	095	Iowa County, IA	2010	NA	9659	9128	531	5.5
CN1909700000000	19	097	Jackson County, IA	2010	NA	11104	10310	794	7.2
CN1909900000000	19	099	Jasper County, IA	2010	NA	19022	17633	1389	7.3
CN1910100000000	19	101	Jefferson County, IA	2010	NA	8954	8319	635	7.1
CN1910300000000	19	103	Johnson County, IA	2010	NA	79250	75900	3350	4.2
CN1910500000000	19	105	Jones County, IA	2010	NA	11106	10400	706	6.4
CN1910700000000	19	107	Keokuk County, IA	2010	NA	5546	5184	362	6.5
CN1910900000000	19	109	Kossuth County, IA	2010	NA	8380	7954	426	5.1
CN1911100000000	19	111	Lee County, IA	2010	NA	17738	16164	1574	8.9
CN1911300000000	19	113	Linn County, IA	2010	NA	120098	112916	7182	6
CN1911500000000	19	115	Louisa County, IA	2010	NA	5962	5529	433	7.3
CN1911700000000	19	117	Lucas County, IA	2010	NA	4232	3973	259	6.1
CN1911900000000	19	119	Lyon County, IA	2010	NA	6403	6156	247	3.9
CN1912100000000	19	121	Madison County, IA	2010	NA	8459	7916	543	6.4
CN1912300000000	19	123	Mahaska County, IA	2010	NA	11912	11111	801	6.7
CN1912500000000	19	125	Marion County, IA	2010	NA	17596	16553	1043	5.9
CN1912700000000	19	127	Marshall County, IA	2010	NA	20152	18774	1378	6.8
CN1912900000000	19	129	Mills County, IA	2010	NA	7608	7209	399	5.2
CN1913100000000	19	131	Mitchell County, IA	2010	NA	5733	5436	297	5.2
CN1913300000000	19	133	Monona County, IA	2010	NA	4886	4534	352	7.2
CN1913500000000	19	135	Monroe County, IA	2010	NA	4096	3800	296	7.2
CN1913700000000	19	137	Montgomery County, IA	2010	NA	5247	4824	423	8.1
CN1913900000000	19	139	Muscatine County, IA	2010	NA	21810	20069	1741	8
CN1914100000000	19	141	O'Brien County, IA	2010	NA	8144	7765	379	4.7
CN1914300000000	19	143	Osceola County, IA	2010	NA	3669	3488	181	4.9
CN1914500000000	19	145	Page County, IA	2010	NA	7129	6646	483	6.8
CN1914700000000	19	147	Palo Alto County, IA	2010	NA	4844	4552	292	6
CN1914900000000	19	149	Plymouth County, IA	2010	NA	14565	13913	652	4.5
CN1915100000000	19	151	Pocahontas County, IA	2010	NA	4056	3849	207	5.1
CN1915300000000	19	153	Polk County, IA	2010	NA	244896	230295	14601	6
CN1915500000000	19	155	Pottawattamie County, IA	2010	NA	50334	47427	2907	5.8
CN1915700000000	19	157	Poweshiek County, IA	2010	NA	10568	9956	612	5.8
CN1915900000000	19	159	Ringgold County, IA	2010	NA	2615	2492	123	4.7
CN1916100000000	19	161	Sac County, IA	2010	NA	5715	5448	267	4.7
CN1916300000000	19	163	Scott County, IA	2010	NA	87196	81417	5779	6.6
CN1916500000000	19	165	Shelby County, IA	2010	NA	6610	6310	300	4.5
CN1916700000000	19	167	Sioux County, IA	2010	NA	19667	18896	771	3.9
CN1916900000000	19	169	Story County, IA	2010	NA	53333	51093	2240	4.2
CN1917100000000	19	171	Tama County, IA	2010	NA	9355	8753	602	6.4
CN1917300000000	19	173	Taylor County, IA	2010	NA	3188	3011	177	5.6
CN1917500000000	19	175	Union County, IA	2010	NA	7018	6622	396	5.6
CN1917700000000	19	177	Van Buren County, IA	2010	NA	3970	3681	289	7.3
CN1917900000000	19	179	Wapello County, IA	2010	NA	18504	17050	1454	7.9
CN1918100000000	19	181	Warren County, IA	2010	NA	26351	24865	1486	5.6
CN1918300000000	19	183	Washington County, IA	2010	NA	12419	11786	633	5.1
CN1918500000000	19	185	Wayne County, IA	2010	NA	2876	2699	177	6.2
CN1918700000000	19	187	Webster County, IA	2010	NA	20141	18744	1397	6.9
CN1918900000000	19	189	Winnebago County, IA	2010	NA	5819	5430	389	6.7
CN1919100000000	19	191	Winneshiek County, IA	2010	NA	12292	11613	679	5.5
CN1919300000000	19	193	Woodbury County, IA	2010	NA	55986	52302	3684	6.6
CN1919500000000	19	195	Worth County, IA	2010	NA	4341	4026	315	7.3
CN1919700000000	19	197	Wright County, IA	2010	NA	6855	6364	491	7.2
CN2000100000000	20	001	Allen County, KS	2010	NA	7010	6429	581	8.3
CN2000300000000	20	003	Anderson County, KS	2010	NA	4572	4220	352	7.7
CN2000500000000	20	005	Atchison County, KS	2010	NA	7938	7154	784	9.9
CN2000700000000	20	007	Barber County, KS	2010	NA	2769	2644	125	4.5
CN2000900000000	20	009	Barton County, KS	2010	NA	15001	14100	901	6
CN2001100000000	20	011	Bourbon County, KS	2010	NA	7223	6572	651	9
CN2001300000000	20	013	Brown County, KS	2010	NA	5266	4917	349	6.6
CN2001500000000	20	015	Butler County, KS	2010	NA	33009	30447	2562	7.8
CN2001700000000	20	017	Chase County, KS	2010	NA	1442	1361	81	5.6
CN2001900000000	20	019	Chautauqua County, KS	2010	NA	1740	1583	157	9
CN2002100000000	20	021	Cherokee County, KS	2010	NA	10798	9817	981	9.1
CN2002300000000	20	023	Cheyenne County, KS	2010	NA	1405	1348	57	4.1
CN2002500000000	20	025	Clark County, KS	2010	NA	1223	1169	54	4.4
CN2002700000000	20	027	Clay County, KS	2010	NA	4631	4374	257	5.5
CN2002900000000	20	029	Cloud County, KS	2010	NA	4654	4392	262	5.6
CN2003100000000	20	031	Coffey County, KS	2010	NA	4847	4479	368	7.6
CN2003300000000	20	033	Comanche County, KS	2010	NA	994	949	45	4.5
CN2003500000000	20	035	Cowley County, KS	2010	NA	17259	15906	1353	7.8
CN2003700000000	20	037	Crawford County, KS	2010	NA	19356	17672	1684	8.7
CN2003900000000	20	039	Decatur County, KS	2010	NA	1457	1384	73	5
CN2004100000000	20	041	Dickinson County, KS	2010	NA	10234	9557	677	6.6
CN2004300000000	20	043	Doniphan County, KS	2010	NA	4540	4139	401	8.8
CN2004500000000	20	045	Douglas County, KS	2010	NA	64379	60574	3805	5.9
CN2004700000000	20	047	Edwards County, KS	2010	NA	1683	1593	90	5.3
CN2004900000000	20	049	Elk County, KS	2010	NA	1414	1296	118	8.3
CN2005100000000	20	051	Ellis County, KS	2010	NA	17642	16946	696	3.9
CN2005300000000	20	053	Ellsworth County, KS	2010	NA	3395	3235	160	4.7
CN2005500000000	20	055	Finney County, KS	2010	NA	20174	19255	919	4.6
CN2005700000000	20	057	Ford County, KS	2010	NA	18114	17361	753	4.2
CN2005900000000	20	059	Franklin County, KS	2010	NA	14363	13070	1293	9
CN2006100000000	20	061	Geary County, KS	2010	NA	13359	12136	1223	9.2
CN2006300000000	20	063	Gove County, KS	2010	NA	1505	1454	51	3.4
CN2006500000000	20	065	Graham County, KS	2010	NA	1389	1323	66	4.8
CN2006700000000	20	067	Grant County, KS	2010	NA	4202	4021	181	4.3
CN2006900000000	20	069	Gray County, KS	2010	NA	3489	3376	113	3.2
CN2007100000000	20	071	Greeley County, KS	2010	NA	827	799	28	3.4
CN2007300000000	20	073	Greenwood County, KS	2010	NA	3441	3181	260	7.6
CN2007500000000	20	075	Hamilton County, KS	2010	NA	1825	1768	57	3.1
CN2007700000000	20	077	Harper County, KS	2010	NA	2937	2753	184	6.3
CN2007900000000	20	079	Harvey County, KS	2010	NA	17774	16497	1277	7.2
CN2008100000000	20	081	Haskell County, KS	2010	NA	2445	2357	88	3.6
CN2008300000000	20	083	Hodgeman County, KS	2010	NA	1085	1045	40	3.7
CN2008500000000	20	085	Jackson County, KS	2010	NA	7509	7046	463	6.2
CN2008700000000	20	087	Jefferson County, KS	2010	NA	10671	9871	800	7.5
CN2008900000000	20	089	Jewell County, KS	2010	NA	1558	1473	85	5.5
CN2009100000000	20	091	Johnson County, KS	2010	NA	307190	288469	18721	6.1
CN2009300000000	20	093	Kearny County, KS	2010	NA	2155	2058	97	4.5
CN2009500000000	20	095	Kingman County, KS	2010	NA	3862	3594	268	6.9
CN2009700000000	20	097	Kiowa County, KS	2010	NA	1398	1325	73	5.2
CN2009900000000	20	099	Labette County, KS	2010	NA	11277	10203	1074	9.5
CN2010100000000	20	101	Lane County, KS	2010	NA	985	944	41	4.2
CN2010300000000	20	103	Leavenworth County, KS	2010	NA	34342	31735	2607	7.6
CN2010500000000	20	105	Lincoln County, KS	2010	NA	1882	1770	112	6
CN2010700000000	20	107	Linn County, KS	2010	NA	4534	4028	506	11.2
CN2010900000000	20	109	Logan County, KS	2010	NA	1737	1676	61	3.5
CN2011100000000	20	111	Lyon County, KS	2010	NA	17481	16316	1165	6.7
CN2011300000000	20	113	McPherson County, KS	2010	NA	16477	15627	850	5.2
CN2011500000000	20	115	Marion County, KS	2010	NA	6742	6342	400	5.9
CN2011700000000	20	117	Marshall County, KS	2010	NA	5908	5608	300	5.1
CN2011900000000	20	119	Meade County, KS	2010	NA	2567	2458	109	4.2
CN2012100000000	20	121	Miami County, KS	2010	NA	17111	15815	1296	7.6
CN2012300000000	20	123	Mitchell County, KS	2010	NA	3874	3689	185	4.8
CN2012500000000	20	125	Montgomery County, KS	2010	NA	18083	16158	1925	10.6
CN2012700000000	20	127	Morris County, KS	2010	NA	3311	3085	226	6.8
CN2012900000000	20	129	Morton County, KS	2010	NA	1756	1680	76	4.3
CN2013100000000	20	131	Nemaha County, KS	2010	NA	5820	5570	250	4.3
CN2013300000000	20	133	Neosho County, KS	2010	NA	7410	6651	759	10.2
CN2013500000000	20	135	Ness County, KS	2010	NA	1618	1554	64	4
CN2013700000000	20	137	Norton County, KS	2010	NA	3098	2980	118	3.8
CN2013900000000	20	139	Osage County, KS	2010	NA	8618	7906	712	8.3
CN2014100000000	20	141	Osborne County, KS	2010	NA	2224	2116	108	4.9
CN2014300000000	20	143	Ottawa County, KS	2010	NA	3286	3090	196	6
CN2014500000000	20	145	Pawnee County, KS	2010	NA	3608	3439	169	4.7
CN2014700000000	20	147	Phillips County, KS	2010	NA	3037	2881	156	5.1
CN2014900000000	20	149	Pottawatomie County, KS	2010	NA	11890	11268	622	5.2
CN2015100000000	20	151	Pratt County, KS	2010	NA	5289	4993	296	5.6
CN2015300000000	20	153	Rawlins County, KS	2010	NA	1511	1458	53	3.5
CN2015500000000	20	155	Reno County, KS	2010	NA	32894	30800	2094	6.4
CN2015700000000	20	157	Republic County, KS	2010	NA	2732	2614	118	4.3
CN2015900000000	20	159	Rice County, KS	2010	NA	5306	5018	288	5.4
CN2016100000000	20	161	Riley County, KS	2010	NA	36091	34289	1802	5
CN2016300000000	20	163	Rooks County, KS	2010	NA	2767	2593	174	6.3
CN2016500000000	20	165	Rush County, KS	2010	NA	1793	1697	96	5.4
CN2016700000000	20	167	Russell County, KS	2010	NA	3741	3550	191	5.1
CN2016900000000	20	169	Saline County, KS	2010	NA	30934	29027	1907	6.2
CN2017100000000	20	171	Scott County, KS	2010	NA	2767	2661	106	3.8
CN2017300000000	20	173	Sedgwick County, KS	2010	NA	252713	230497	22216	8.8
CN2017500000000	20	175	Seward County, KS	2010	NA	10794	10261	533	4.9
CN2017700000000	20	177	Shawnee County, KS	2010	NA	93584	87047	6537	7
CN2017900000000	20	179	Sheridan County, KS	2010	NA	1514	1463	51	3.4
CN2018100000000	20	181	Sherman County, KS	2010	NA	3154	3004	150	4.8
CN2018300000000	20	183	Smith County, KS	2010	NA	2333	2232	101	4.3
CN2018500000000	20	185	Stafford County, KS	2010	NA	2366	2246	120	5.1
CN2018700000000	20	187	Stanton County, KS	2010	NA	1093	1048	45	4.1
CN2018900000000	20	189	Stevens County, KS	2010	NA	2870	2749	121	4.2
CN2019100000000	20	191	Sumner County, KS	2010	NA	11958	10896	1062	8.9
CN2019300000000	20	193	Thomas County, KS	2010	NA	4543	4363	180	4
CN2019500000000	20	195	Trego County, KS	2010	NA	1509	1438	71	4.7
CN2019700000000	20	197	Wabaunsee County, KS	2010	NA	3887	3633	254	6.5
CN2019900000000	20	199	Wallace County, KS	2010	NA	893	840	53	5.9
CN2020100000000	20	201	Washington County, KS	2010	NA	3346	3184	162	4.8
CN2020300000000	20	203	Wichita County, KS	2010	NA	1336	1290	46	3.4
CN2020500000000	20	205	Wilson County, KS	2010	NA	4500	3962	538	12
CN2020700000000	20	207	Woodson County, KS	2010	NA	1736	1599	137	7.9
CN2020900000000	20	209	Wyandotte County, KS	2010	NA	74994	67433	7561	10.1
CN2100100000000	21	001	Adair County, KY	2010	NA	7810	6839	971	12.4
CN2100300000000	21	003	Allen County, KY	2010	NA	9126	8056	1070	11.7
CN2100500000000	21	005	Anderson County, KY	2010	NA	11579	10466	1113	9.6
CN2100700000000	21	007	Ballard County, KY	2010	NA	3839	3445	394	10.3
CN2100900000000	21	009	Barren County, KY	2010	NA	19749	17540	2209	11.2
CN2101100000000	21	011	Bath County, KY	2010	NA	4887	4172	715	14.6
CN2101300000000	21	013	Bell County, KY	2010	NA	10197	8959	1238	12.1
CN2101500000000	21	015	Boone County, KY	2010	NA	63271	57662	5609	8.9
CN2101700000000	21	017	Bourbon County, KY	2010	NA	10064	9151	913	9.1
CN2101900000000	21	019	Boyd County, KY	2010	NA	20421	18342	2079	10.2
CN2102100000000	21	021	Boyle County, KY	2010	NA	13342	11853	1489	11.2
CN2102300000000	21	023	Bracken County, KY	2010	NA	3982	3529	453	11.4
CN2102500000000	21	025	Breathitt County, KY	2010	NA	4528	3916	612	13.5
CN2102700000000	21	027	Breckinridge County, KY	2010	NA	8273	7202	1071	12.9
CN2102900000000	21	029	Bullitt County, KY	2010	NA	38803	34671	4132	10.6
CN2103100000000	21	031	Butler County, KY	2010	NA	5457	4802	655	12
CN2103300000000	21	033	Caldwell County, KY	2010	NA	5916	5293	623	10.5
CN2103500000000	21	035	Calloway County, KY	2010	NA	18915	17391	1524	8.1
CN2103700000000	21	037	Campbell County, KY	2010	NA	48713	44284	4429	9.1
CN2103900000000	21	039	Carlisle County, KY	2010	NA	2251	2047	204	9.1
CN2104100000000	21	041	Carroll County, KY	2010	NA	4999	4274	725	14.5
CN2104300000000	21	043	Carter County, KY	2010	NA	11925	10244	1681	14.1
CN2104500000000	21	045	Casey County, KY	2010	NA	6914	6155	759	11
CN2104700000000	21	047	Christian County, KY	2010	NA	27294	24107	3187	11.7
CN2104900000000	21	049	Clark County, KY	2010	NA	17775	15862	1913	10.8
CN2105100000000	21	051	Clay County, KY	2010	NA	6030	5153	877	14.5
CN2105300000000	21	053	Clinton County, KY	2010	NA	4273	3803	470	11
CN2105500000000	21	055	Crittenden County, KY	2010	NA	4064	3660	404	9.9
CN2105700000000	21	057	Cumberland County, KY	2010	NA	3174	2800	374	11.8
CN2105900000000	21	059	Daviess County, KY	2010	NA	46881	42523	4358	9.3
CN2106100000000	21	061	Edmonson County, KY	2010	NA	5122	4440	682	13.3
CN2106300000000	21	063	Elliott County, KY	2010	NA	2399	2019	380	15.8
CN2106500000000	21	065	Estill County, KY	2010	NA	5694	4923	771	13.5
CN2106700000000	21	067	Fayette County, KY	2010	NA	163286	151190	12096	7.4
CN2106900000000	21	069	Fleming County, KY	2010	NA	6713	5940	773	11.5
CN2107100000000	21	071	Floyd County, KY	2010	NA	13940	12064	1876	13.5
CN2107300000000	21	073	Franklin County, KY	2010	NA	24625	22481	2144	8.7
CN2107500000000	21	075	Fulton County, KY	2010	NA	2729	2415	314	11.5
CN2107700000000	21	077	Gallatin County, KY	2010	NA	4076	3573	503	12.3
CN2107900000000	21	079	Garrard County, KY	2010	NA	7935	7051	884	11.1
CN2108100000000	21	081	Grant County, KY	2010	NA	11684	10308	1376	11.8
CN2108300000000	21	083	Graves County, KY	2010	NA	16827	15231	1596	9.5
CN2108500000000	21	085	Grayson County, KY	2010	NA	11549	9904	1645	14.2
CN2108700000000	21	087	Green County, KY	2010	NA	5596	4938	658	11.8
CN2108900000000	21	089	Greenup County, KY	2010	NA	15351	13579	1772	11.5
CN2109100000000	21	091	Hancock County, KY	2010	NA	4060	3643	417	10.3
CN2109300000000	21	093	Hardin County, KY	2010	NA	46901	42359	4542	9.7
CN2109500000000	21	095	Harlan County, KY	2010	NA	10193	8979	1214	11.9
CN2109700000000	21	097	Harrison County, KY	2010	NA	9016	8013	1003	11.1
CN2109900000000	21	099	Hart County, KY	2010	NA	8110	7264	846	10.4
CN2110100000000	21	101	Henderson County, KY	2010	NA	22850	20503	2347	10.3
CN2110300000000	21	103	Henry County, KY	2010	NA	7834	7060	774	9.9
CN2110500000000	21	105	Hickman County, KY	2010	NA	2300	2112	188	8.2
CN2110700000000	21	107	Hopkins County, KY	2010	NA	21211	19157	2054	9.7
CN2110900000000	21	109	Jackson County, KY	2010	NA	5142	4419	723	14.1
CN2111100000000	21	111	Jefferson County, KY	2010	NA	378722	340806	37916	10
CN2111300000000	21	113	Jessamine County, KY	2010	NA	24710	22615	2095	8.5
CN2111500000000	21	115	Johnson County, KY	2010	NA	8925	7804	1121	12.6
CN2111700000000	21	117	Kenton County, KY	2010	NA	83798	75611	8187	9.8
CN2111900000000	21	119	Knott County, KY	2010	NA	5924	5126	798	13.5
CN2112100000000	21	121	Knox County, KY	2010	NA	10648	9209	1439	13.5
CN2112300000000	21	123	Larue County, KY	2010	NA	6062	5378	684	11.3
CN2112500000000	21	125	Laurel County, KY	2010	NA	24952	22105	2847	11.4
CN2112700000000	21	127	Lawrence County, KY	2010	NA	5767	4983	784	13.6
CN2112900000000	21	129	Lee County, KY	2010	NA	2590	2263	327	12.6
CN2113100000000	21	131	Leslie County, KY	2010	NA	3607	3141	466	12.9
CN2113300000000	21	133	Letcher County, KY	2010	NA	8659	7669	990	11.4
CN2113500000000	21	135	Lewis County, KY	2010	NA	5589	4818	771	13.8
CN2113700000000	21	137	Lincoln County, KY	2010	NA	10625	9261	1364	12.8
CN2113900000000	21	139	Livingston County, KY	2010	NA	4035	3549	486	12
CN2114100000000	21	141	Logan County, KY	2010	NA	12612	11362	1250	9.9
CN2114300000000	21	143	Lyon County, KY	2010	NA	2982	2636	346	11.6
CN2114500000000	21	145	McCracken County, KY	2010	NA	30650	27876	2774	9.1
CN2114700000000	21	147	McCreary County, KY	2010	NA	5723	4896	827	14.5
CN2114900000000	21	149	McLean County, KY	2010	NA	4524	4062	462	10.2
CN2115100000000	21	151	Madison County, KY	2010	NA	43050	39386	3664	8.5
CN2115300000000	21	153	Magoffin County, KY	2010	NA	4290	3411	879	20.5
CN2115500000000	21	155	Marion County, KY	2010	NA	9110	7961	1149	12.6
CN2115700000000	21	157	Marshall County, KY	2010	NA	15404	13783	1621	10.5
CN2115900000000	21	159	Martin County, KY	2010	NA	3998	3586	412	10.3
CN2116100000000	21	161	Mason County, KY	2010	NA	7892	7004	888	11.3
CN2116300000000	21	163	Meade County, KY	2010	NA	12338	10882	1456	11.8
CN2116500000000	21	165	Menifee County, KY	2010	NA	2560	2163	397	15.5
CN2116700000000	21	167	Mercer County, KY	2010	NA	10532	9353	1179	11.2
CN2116900000000	21	169	Metcalfe County, KY	2010	NA	4674	4051	623	13.3
CN2117100000000	21	171	Monroe County, KY	2010	NA	4850	4331	519	10.7
CN2117300000000	21	173	Montgomery County, KY	2010	NA	12077	10603	1474	12.2
CN2117500000000	21	175	Morgan County, KY	2010	NA	5114	4447	667	13
CN2117700000000	21	177	Muhlenberg County, KY	2010	NA	13040	11615	1425	10.9
CN2117900000000	21	179	Nelson County, KY	2010	NA	21971	19514	2457	11.2
CN2118100000000	21	181	Nicholas County, KY	2010	NA	3631	3264	367	10.1
CN2118300000000	21	183	Ohio County, KY	2010	NA	10316	9159	1157	11.2
CN2118500000000	21	185	Oldham County, KY	2010	NA	29248	27042	2206	7.5
CN2118700000000	21	187	Owen County, KY	2010	NA	5915	5418	497	8.4
CN2118900000000	21	189	Owsley County, KY	2010	NA	1362	1181	181	13.3
CN2119100000000	21	191	Pendleton County, KY	2010	NA	7387	6480	907	12.3
CN2119300000000	21	193	Perry County, KY	2010	NA	11065	9766	1299	11.7
CN2119500000000	21	195	Pike County, KY	2010	NA	24504	21948	2556	10.4
CN2119700000000	21	197	Powell County, KY	2010	NA	5290	4468	822	15.5
CN2119900000000	21	199	Pulaski County, KY	2010	NA	27776	24831	2945	10.6
CN2120100000000	21	201	Robertson County, KY	2010	NA	869	768	101	11.6
CN2120300000000	21	203	Rockcastle County, KY	2010	NA	7028	6240	788	11.2
CN2120500000000	21	205	Rowan County, KY	2010	NA	10912	9807	1105	10.1
CN2120700000000	21	207	Russell County, KY	2010	NA	7297	6361	936	12.8
CN2120900000000	21	209	Scott County, KY	2010	NA	25429	23216	2213	8.7
CN2121100000000	21	211	Shelby County, KY	2010	NA	21851	19900	1951	8.9
CN2121300000000	21	213	Simpson County, KY	2010	NA	8642	7521	1121	13
CN2121500000000	21	215	Spencer County, KY	2010	NA	9205	8291	914	9.9
CN2121700000000	21	217	Taylor County, KY	2010	NA	11802	10355	1447	12.3
CN2121900000000	21	219	Todd County, KY	2010	NA	5676	5106	570	10
CN2122100000000	21	221	Trigg County, KY	2010	NA	6440	5531	909	14.1
CN2122300000000	21	223	Trimble County, KY	2010	NA	4088	3561	527	12.9
CN2122500000000	21	225	Union County, KY	2010	NA	7687	6941	746	9.7
CN2122700000000	21	227	Warren County, KY	2010	NA	58221	52861	5360	9.2
CN2122900000000	21	229	Washington County, KY	2010	NA	6089	5471	618	10.1
CN2123100000000	21	231	Wayne County, KY	2010	NA	8213	7059	1154	14.1
CN2123300000000	21	233	Webster County, KY	2010	NA	6121	5542	579	9.5
CN2123500000000	21	235	Whitley County, KY	2010	NA	14127	12346	1781	12.6
CN2123700000000	21	237	Wolfe County, KY	2010	NA	2152	1800	352	16.4
CN2123900000000	21	239	Woodford County, KY	2010	NA	14441	13394	1047	7.3
CN2200100000000	22	001	Acadia Parish, LA	2010	NA	26130	24233	1897	7.3
CN2200300000000	22	003	Allen Parish, LA	2010	NA	9395	8471	924	9.8
CN2200500000000	22	005	Ascension Parish, LA	2010	NA	53392	49414	3978	7.5
CN2200700000000	22	007	Assumption Parish, LA	2010	NA	10067	8902	1165	11.6
CN2200900000000	22	009	Avoyelles Parish, LA	2010	NA	16867	15453	1414	8.4
CN2201100000000	22	011	Beauregard Parish, LA	2010	NA	14585	13429	1156	7.9
CN2201300000000	22	013	Bienville Parish, LA	2010	NA	5918	5324	594	10
CN2201500000000	22	015	Bossier Parish, LA	2010	NA	56576	53152	3424	6.1
CN2201700000000	22	017	Caddo Parish, LA	2010	NA	116799	107285	9514	8.1
CN2201900000000	22	019	Calcasieu Parish, LA	2010	NA	87896	80851	7045	8
CN2202100000000	22	021	Caldwell Parish, LA	2010	NA	4179	3726	453	10.8
CN2202300000000	22	023	Cameron Parish, LA	2010	NA	3299	3092	207	6.3
CN2202500000000	22	025	Catahoula Parish, LA	2010	NA	4229	3792	437	10.3
CN2202700000000	22	027	Claiborne Parish, LA	2010	NA	6892	6289	603	8.7
CN2202900000000	22	029	Concordia Parish, LA	2010	NA	7875	7093	782	9.9
CN2203100000000	22	031	De Soto Parish, LA	2010	NA	11394	10392	1002	8.8
CN2203300000000	22	033	East Baton Rouge Parish, LA	2010	NA	221984	205112	16872	7.6
CN2203500000000	22	035	East Carroll Parish, LA	2010	NA	2477	2038	439	17.7
CN2203700000000	22	037	East Feliciana Parish, LA	2010	NA	8103	7427	676	8.3
CN2203900000000	22	039	Evangeline Parish, LA	2010	NA	13141	12015	1126	8.6
CN2204100000000	22	041	Franklin Parish, LA	2010	NA	8333	7409	924	11.1
CN2204300000000	22	043	Grant Parish, LA	2010	NA	8590	7864	726	8.5
CN2204500000000	22	045	Iberia Parish, LA	2010	NA	32240	29464	2776	8.6
CN2204700000000	22	047	Iberville Parish, LA	2010	NA	14031	12622	1409	10
CN2204900000000	22	049	Jackson Parish, LA	2010	NA	7085	6568	517	7.3
CN2205100000000	22	051	Jefferson Parish, LA	2010	NA	216258	200303	15955	7.4
CN2205300000000	22	053	Jefferson Davis Parish, LA	2010	NA	13113	12124	989	7.5
CN2205500000000	22	055	Lafayette Parish, LA	2010	NA	113571	106487	7084	6.2
CN2205700000000	22	057	Lafourche Parish, LA	2010	NA	45070	42305	2765	6.1
CN2205900000000	22	059	LaSalle Parish, LA	2010	NA	6444	6024	420	6.5
CN2206100000000	22	061	Lincoln Parish, LA	2010	NA	20309	18533	1776	8.7
CN2206300000000	22	063	Livingston Parish, LA	2010	NA	61281	56675	4606	7.5
CN2206500000000	22	065	Madison Parish, LA	2010	NA	4170	3668	502	12
CN2206700000000	22	067	Morehouse Parish, LA	2010	NA	11097	9385	1712	15.4
CN2206900000000	22	069	Natchitoches Parish, LA	2010	NA	16590	15101	1489	9
CN2207100000000	22	071	Orleans Parish, LA	2010	NA	162592	148465	14127	8.7
CN2207300000000	22	073	Ouachita Parish, LA	2010	NA	70729	64888	5841	8.3
CN2207500000000	22	075	Plaquemines Parish, LA	2010	NA	10028	9420	608	6.1
CN2207700000000	22	077	Pointe Coupee Parish, LA	2010	NA	10001	9134	867	8.7
CN2207900000000	22	079	Rapides Parish, LA	2010	NA	58820	54349	4471	7.6
CN2208100000000	22	081	Red River Parish, LA	2010	NA	4020	3680	340	8.5
CN2208300000000	22	083	Richland Parish, LA	2010	NA	8802	7834	968	11
CN2208500000000	22	085	Sabine Parish, LA	2010	NA	9673	8970	703	7.3
CN2208700000000	22	087	St. Bernard Parish, LA	2010	NA	15951	14621	1330	8.3
CN2208900000000	22	089	St. Charles Parish, LA	2010	NA	25481	23594	1887	7.4
CN2209100000000	22	091	St. Helena Parish, LA	2010	NA	4716	4097	619	13.1
CN2209300000000	22	093	St. James Parish, LA	2010	NA	10130	8949	1181	11.7
CN2209500000000	22	095	St. John the Baptist Parish, LA	2010	NA	21535	19252	2283	10.6
CN2209700000000	22	097	St. Landry Parish, LA	2010	NA	34308	31015	3293	9.6
CN2209900000000	22	099	St. Martin Parish, LA	2010	NA	24050	22137	1913	8
CN2210100000000	22	101	St. Mary Parish, LA	2010	NA	25185	22815	2370	9.4
CN2210300000000	22	103	St. Tammany Parish, LA	2010	NA	108755	101906	6849	6.3
CN2210500000000	22	105	Tangipahoa Parish, LA	2010	NA	53664	48451	5213	9.7
CN2210700000000	22	107	Tensas Parish, LA	2010	NA	2121	1828	293	13.8
CN2210900000000	22	109	Terrebonne Parish, LA	2010	NA	50910	47617	3293	6.5
CN2211100000000	22	111	Union Parish, LA	2010	NA	9674	8667	1007	10.4
CN2211300000000	22	113	Vermilion Parish, LA	2010	NA	25637	23770	1867	7.3
CN2211500000000	22	115	Vernon Parish, LA	2010	NA	18553	16958	1595	8.6
CN2211700000000	22	117	Washington Parish, LA	2010	NA	17114	15469	1645	9.6
CN2211900000000	22	119	Webster Parish, LA	2010	NA	16831	15083	1748	10.4
CN2212100000000	22	121	West Baton Rouge Parish, LA	2010	NA	11924	10986	938	7.9
CN2212300000000	22	123	West Carroll Parish, LA	2010	NA	4452	3727	725	16.3
CN2212500000000	22	125	West Feliciana Parish, LA	2010	NA	5237	4885	352	6.7
CN2212700000000	22	127	Winn Parish, LA	2010	NA	5813	5270	543	9.3
CN2300100000000	23	001	Androscoggin County, ME	2010	NA	55909	51116	4793	8.6
CN2300300000000	23	003	Aroostook County, ME	2010	NA	34717	31344	3373	9.7
CN2300500000000	23	005	Cumberland County, ME	2010	NA	156017	145846	10171	6.5
CN2300700000000	23	007	Franklin County, ME	2010	NA	15502	14071	1431	9.2
CN2300900000000	23	009	Hancock County, ME	2010	NA	29815	27185	2630	8.8
CN2301100000000	23	011	Kennebec County, ME	2010	NA	62924	58135	4789	7.6
CN2301300000000	23	013	Knox County, ME	2010	NA	20391	18883	1508	7.4
CN2301500000000	23	015	Lincoln County, ME	2010	NA	17122	15824	1298	7.6
CN2301700000000	23	017	Oxford County, ME	2010	NA	27923	24935	2988	10.7
CN2301900000000	23	019	Penobscot County, ME	2010	NA	79017	72321	6696	8.5
CN2302100000000	23	021	Piscataquis County, ME	2010	NA	7962	7110	852	10.7
CN2302300000000	23	023	Sagadahoc County, ME	2010	NA	19219	17940	1279	6.7
CN2302500000000	23	025	Somerset County, ME	2010	NA	24679	21939	2740	11.1
CN2302700000000	23	027	Waldo County, ME	2010	NA	20407	18675	1732	8.5
CN2302900000000	23	029	Washington County, ME	2010	NA	14945	13332	1613	10.8
CN2303100000000	23	031	York County, ME	2010	NA	108635	99974	8661	8
CN2400100000000	24	001	Allegany County, MD	2010	NA	34419	31206	3213	9.3
CN2400300000000	24	003	Anne Arundel County, MD	2010	NA	286070	266359	19711	6.9
CN2400500000000	24	005	Baltimore County, MD	2010	NA	431530	395920	35610	8.3
CN2400900000000	24	009	Calvert County, MD	2010	NA	47831	44547	3284	6.9
CN2401100000000	24	011	Caroline County, MD	2010	NA	17421	15811	1610	9.2
CN2401300000000	24	013	Carroll County, MD	2010	NA	92598	86283	6315	6.8
CN2401500000000	24	015	Cecil County, MD	2010	NA	51981	47031	4950	9.5
CN2401700000000	24	017	Charles County, MD	2010	NA	78222	72815	5407	6.9
CN2401900000000	24	019	Dorchester County, MD	2010	NA	16549	14665	1884	11.4
CN2402100000000	24	021	Frederick County, MD	2010	NA	127913	119084	8829	6.9
CN2402300000000	24	023	Garrett County, MD	2010	NA	15807	14405	1402	8.9
CN2402500000000	24	025	Harford County, MD	2010	NA	132791	122453	10338	7.8
CN2402700000000	24	027	Howard County, MD	2010	NA	160638	151618	9020	5.6
CN2402900000000	24	029	Kent County, MD	2010	NA	10631	9694	937	8.8
CN2403100000000	24	031	Montgomery County, MD	2010	NA	532572	502733	29839	5.6
CN2403300000000	24	033	Prince George's County, MD	2010	NA	479626	443655	35971	7.5
CN2403500000000	24	035	Queen Anne's County, MD	2010	NA	26142	24233	1909	7.3
CN2403700000000	24	037	St. Mary's County, MD	2010	NA	53619	50116	3503	6.5
CN2403900000000	24	039	Somerset County, MD	2010	NA	9931	8749	1182	11.9
CN2404100000000	24	041	Talbot County, MD	2010	NA	19402	17858	1544	8
CN2404300000000	24	043	Washington County, MD	2010	NA	75805	68531	7274	9.6
CN2404500000000	24	045	Wicomico County, MD	2010	NA	50381	45464	4917	9.8
CN2404700000000	24	047	Worcester County, MD	2010	NA	26437	22906	3531	13.4
CN2451000000000	24	510	Baltimore city, MD	2010	NA	295516	262359	33157	11.2
CN2500100000000	25	001	Barnstable County, MA	2010	NA	111110	100080	11030	9.9
CN2500300000000	25	003	Berkshire County, MA	2010	NA	67602	61686	5916	8.8
CN2500500000000	25	005	Bristol County, MA	2010	NA	286871	256530	30341	10.6
CN2500700000000	25	007	Dukes County, MA	2010	NA	9104	8215	889	9.8
CN2500900000000	25	009	Essex County, MA	2010	NA	392165	358049	34116	8.7
CN2501100000000	25	011	Franklin County, MA	2010	NA	39978	36932	3046	7.6
CN2501300000000	25	013	Hampden County, MA	2010	NA	220962	198254	22708	10.3
CN2501500000000	25	015	Hampshire County, MA	2010	NA	85539	79543	5996	7
CN2501700000000	25	017	Middlesex County, MA	2010	NA	825821	768619	57202	6.9
CN2501900000000	25	019	Nantucket County/town, MA	2010	NA	6168	5574	594	9.6
CN2502100000000	25	021	Norfolk County, MA	2010	NA	358250	331572	26678	7.4
CN2502300000000	25	023	Plymouth County, MA	2010	NA	262195	238739	23456	8.9
CN2502500000000	25	025	Suffolk County, MA	2010	NA	393933	363832	30101	7.6
CN2502700000000	25	027	Worcester County, MA	2010	NA	420385	383190	37195	8.8
CN2600100000000	26	001	Alcona County, MI	2010	NA	3880	3188	692	17.8
CN2600300000000	26	003	Alger County, MI	2010	NA	3593	3085	508	14.1
CN2600500000000	26	005	Allegan County, MI	2010	NA	57023	50551	6472	11.3
CN2600700000000	26	007	Alpena County, MI	2010	NA	14273	12397	1876	13.1
CN2600900000000	26	009	Antrim County, MI	2010	NA	10563	8875	1688	16
CN2601100000000	26	011	Arenac County, MI	2010	NA	6958	5810	1148	16.5
CN2601300000000	26	013	Baraga County, MI	2010	NA	3906	3150	756	19.4
CN2601500000000	26	015	Barry County, MI	2010	NA	29360	26318	3042	10.4
CN2601700000000	26	017	Bay County, MI	2010	NA	54666	48347	6319	11.6
CN2601900000000	26	019	Benzie County, MI	2010	NA	8961	7755	1206	13.5
CN2602100000000	26	021	Berrien County, MI	2010	NA	76628	67415	9213	12
CN2602300000000	26	023	Branch County, MI	2010	NA	20042	17507	2535	12.6
CN2602500000000	26	025	Calhoun County, MI	2010	NA	64996	57389	7607	11.7
CN2602700000000	26	027	Cass County, MI	2010	NA	24583	21792	2791	11.4
CN2602900000000	26	029	Charlevoix County, MI	2010	NA	13357	11483	1874	14
CN2603100000000	26	031	Cheboygan County, MI	2010	NA	11358	9772	1586	14
CN2603300000000	26	033	Chippewa County, MI	2010	NA	17806	15682	2124	11.9
CN2603500000000	26	035	Clare County, MI	2010	NA	12542	10592	1950	15.5
CN2603700000000	26	037	Clinton County, MI	2010	NA	39637	36310	3327	8.4
CN2603900000000	26	039	Crawford County, MI	2010	NA	5631	4832	799	14.2
CN2604100000000	26	041	Delta County, MI	2010	NA	18177	15898	2279	12.5
CN2604300000000	26	043	Dickinson County, MI	2010	NA	13213	11692	1521	11.5
CN2604500000000	26	045	Eaton County, MI	2010	NA	57180	51676	5504	9.6
CN2604700000000	26	047	Emmet County, MI	2010	NA	18512	15839	2673	14.4
CN2604900000000	26	049	Genesee County, MI	2010	NA	188190	161918	26272	14
CN2605100000000	26	051	Gladwin County, MI	2010	NA	10413	8869	1544	14.8
CN2605300000000	26	053	Gogebic County, MI	2010	NA	7226	6281	945	13.1
CN2605500000000	26	055	Grand Traverse County, MI	2010	NA	47553	42015	5538	11.6
CN2605700000000	26	057	Gratiot County, MI	2010	NA	19544	17233	2311	11.8
CN2605900000000	26	059	Hillsdale County, MI	2010	NA	21487	18577	2910	13.5
CN2606100000000	26	061	Houghton County, MI	2010	NA	17939	16010	1929	10.8
CN2606300000000	26	063	Huron County, MI	2010	NA	16642	14567	2075	12.5
CN2606500000000	26	065	Ingham County, MI	2010	NA	148442	133197	15245	10.3
CN2606700000000	26	067	Ionia County, MI	2010	NA	29931	26363	3568	11.9
CN2606900000000	26	069	Iosco County, MI	2010	NA	10377	8737	1640	15.8
CN2607100000000	26	071	Iron County, MI	2010	NA	5296	4661	635	12
CN2607300000000	26	073	Isabella County, MI	2010	NA	35522	32046	3476	9.8
CN2607500000000	26	075	Jackson County, MI	2010	NA	74673	65564	9109	12.2
CN2607700000000	26	077	Kalamazoo County, MI	2010	NA	129632	116657	12975	10
CN2607900000000	26	079	Kalkaska County, MI	2010	NA	7918	6680	1238	15.6
CN2608100000000	26	081	Kent County, MI	2010	NA	316233	284168	32065	10.1
CN2608300000000	26	083	Keweenaw County, MI	2010	NA	1015	862	153	15.1
CN2608500000000	26	085	Lake County, MI	2010	NA	3890	3258	632	16.2
CN2608700000000	26	087	Lapeer County, MI	2010	NA	41335	34587	6748	16.3
CN2608900000000	26	089	Leelanau County, MI	2010	NA	10588	9490	1098	10.4
CN2609100000000	26	091	Lenawee County, MI	2010	NA	49811	43318	6493	13
CN2609300000000	26	093	Livingston County, MI	2010	NA	94112	83600	10512	11.2
CN2609500000000	26	095	Luce County, MI	2010	NA	2498	2163	335	13.4
CN2609700000000	26	097	Mackinac County, MI	2010	NA	5560	4746	814	14.6
CN2609900000000	26	099	Macomb County, MI	2010	NA	420803	362380	58423	13.9
CN2610100000000	26	101	Manistee County, MI	2010	NA	11051	9605	1446	13.1
CN2610300000000	26	103	Marquette County, MI	2010	NA	34937	31502	3435	9.8
CN2610500000000	26	105	Mason County, MI	2010	NA	14567	12733	1834	12.6
CN2610700000000	26	107	Mecosta County, MI	2010	NA	19304	16872	2432	12.6
CN2610900000000	26	109	Menominee County, MI	2010	NA	11958	10566	1392	11.6
CN2611100000000	26	111	Midland County, MI	2010	NA	41219	37196	4023	9.8
CN2611300000000	26	113	Missaukee County, MI	2010	NA	7146	6241	905	12.7
CN2611500000000	26	115	Monroe County, MI	2010	NA	75640	66771	8869	11.7
CN2611700000000	26	117	Montcalm County, MI	2010	NA	27809	23888	3921	14.1
CN2611900000000	26	119	Montmorency County, MI	2010	NA	3552	2836	716	20.2
CN2612100000000	26	121	Muskegon County, MI	2010	NA	77712	66420	11292	14.5
CN2612300000000	26	123	Newaygo County, MI	2010	NA	22988	20078	2910	12.7
CN2612500000000	26	125	Oakland County, MI	2010	NA	621876	548699	73177	11.8
CN2612700000000	26	127	Oceana County, MI	2010	NA	13380	11217	2163	16.2
CN2612900000000	26	129	Ogemaw County, MI	2010	NA	9082	7767	1315	14.5
CN2613100000000	26	131	Ontonagon County, MI	2010	NA	3075	2560	515	16.7
CN2613300000000	26	133	Osceola County, MI	2010	NA	10383	8970	1413	13.6
CN2613500000000	26	135	Oscoda County, MI	2010	NA	3316	2667	649	19.6
CN2613700000000	26	137	Otsego County, MI	2010	NA	11870	10180	1690	14.2
CN2613900000000	26	139	Ottawa County, MI	2010	NA	140585	126112	14473	10.3
CN2614100000000	26	141	Presque Isle County, MI	2010	NA	5755	4751	1004	17.4
CN2614300000000	26	143	Roscommon County, MI	2010	NA	8652	7212	1440	16.6
CN2614500000000	26	145	Saginaw County, MI	2010	NA	90722	79625	11097	12.2
CN2614700000000	26	147	St. Clair County, MI	2010	NA	77675	64934	12741	16.4
CN2614900000000	26	149	St. Joseph County, MI	2010	NA	28110	24585	3525	12.5
CN2615100000000	26	151	Sanilac County, MI	2010	NA	20006	16923	3083	15.4
CN2615300000000	26	153	Schoolcraft County, MI	2010	NA	3798	3280	518	13.6
CN2615500000000	26	155	Shiawassee County, MI	2010	NA	34707	30234	4473	12.9
CN2615700000000	26	157	Tuscola County, MI	2010	NA	26057	22214	3843	14.7
CN2615900000000	26	159	Van Buren County, MI	2010	NA	37784	32687	5097	13.5
CN2616100000000	26	161	Washtenaw County, MI	2010	NA	182801	167969	14832	8.1
CN2616300000000	26	163	Wayne County, MI	2010	NA	802754	678426	124328	15.5
CN2616500000000	26	165	Wexford County, MI	2010	NA	15218	13023	2195	14.4
CN2700100000000	27	001	Aitkin County, MN	2010	NA	7310	6550	760	10.4
CN2700300000000	27	003	Anoka County, MN	2010	NA	187355	172342	15013	8
CN2700500000000	27	005	Becker County, MN	2010	NA	17602	16210	1392	7.9
CN2700700000000	27	007	Beltrami County, MN	2010	NA	22591	20737	1854	8.2
CN2700900000000	27	009	Benton County, MN	2010	NA	21100	19263	1837	8.7
CN2701100000000	27	011	Big Stone County, MN	2010	NA	2911	2722	189	6.5
CN2701300000000	27	013	Blue Earth County, MN	2010	NA	38114	35687	2427	6.4
CN2701500000000	27	015	Brown County, MN	2010	NA	15102	14064	1038	6.9
CN2701700000000	27	017	Carlton County, MN	2010	NA	17794	16304	1490	8.4
CN2701900000000	27	019	Carver County, MN	2010	NA	51621	48148	3473	6.7
CN2702100000000	27	021	Cass County, MN	2010	NA	14383	12864	1519	10.6
CN2702300000000	27	023	Chippewa County, MN	2010	NA	7153	6628	525	7.3
CN2702500000000	27	025	Chisago County, MN	2010	NA	29314	26707	2607	8.9
CN2702700000000	27	027	Clay County, MN	2010	NA	33883	32009	1874	5.5
CN2702900000000	27	029	Clearwater County, MN	2010	NA	4589	3988	601	13.1
CN2703100000000	27	031	Cook County, MN	2010	NA	3056	2837	219	7.2
CN2703300000000	27	033	Cottonwood County, MN	2010	NA	6227	5822	405	6.5
CN2703500000000	27	035	Crow Wing County, MN	2010	NA	32033	28983	3050	9.5
CN2703700000000	27	037	Dakota County, MN	2010	NA	227259	211414	15845	7
CN2703900000000	27	039	Dodge County, MN	2010	NA	11307	10525	782	6.9
CN2704100000000	27	041	Douglas County, MN	2010	NA	19817	18471	1346	6.8
CN2704300000000	27	043	Faribault County, MN	2010	NA	7831	7207	624	8
CN2704500000000	27	045	Fillmore County, MN	2010	NA	11246	10402	844	7.5
CN2704700000000	27	047	Freeborn County, MN	2010	NA	17087	15767	1320	7.7
CN2704900000000	27	049	Goodhue County, MN	2010	NA	26734	24853	1881	7
CN2705100000000	27	051	Grant County, MN	2010	NA	3399	3129	270	7.9
CN2705300000000	27	053	Hennepin County, MN	2010	NA	650891	605294	45597	7
CN2705500000000	27	055	Houston County, MN	2010	NA	10830	9999	831	7.7
CN2705700000000	27	057	Hubbard County, MN	2010	NA	9751	8784	967	9.9
CN2705900000000	27	059	Isanti County, MN	2010	NA	20561	18583	1978	9.6
CN2706100000000	27	061	Itasca County, MN	2010	NA	22499	20214	2285	10.2
CN2706300000000	27	063	Jackson County, MN	2010	NA	6026	5674	352	5.8
CN2706500000000	27	065	Kanabec County, MN	2010	NA	8784	7800	984	11.2
CN2706700000000	27	067	Kandiyohi County, MN	2010	NA	23568	21997	1571	6.7
CN2706900000000	27	069	Kittson County, MN	2010	NA	2576	2382	194	7.5
CN2707100000000	27	071	Koochiching County, MN	2010	NA	6938	6336	602	8.7
CN2707300000000	27	073	Lac qui Parle County, MN	2010	NA	4082	3810	272	6.7
CN2707500000000	27	075	Lake County, MN	2010	NA	5798	5316	482	8.3
CN2707700000000	27	077	Lake of the Woods County, MN	2010	NA	2282	2134	148	6.5
CN2707900000000	27	079	Le Sueur County, MN	2010	NA	15715	14324	1391	8.9
CN2708100000000	27	081	Lincoln County, MN	2010	NA	3445	3255	190	5.5
CN2708300000000	27	083	Lyon County, MN	2010	NA	15226	14375	851	5.6
CN2708500000000	27	085	McLeod County, MN	2010	NA	20307	18487	1820	9
CN2708700000000	27	087	Mahnomen County, MN	2010	NA	2503	2296	207	8.3
CN2708900000000	27	089	Marshall County, MN	2010	NA	5698	5170	528	9.3
CN2709100000000	27	091	Martin County, MN	2010	NA	11506	10664	842	7.3
CN2709300000000	27	093	Meeker County, MN	2010	NA	12811	11684	1127	8.8
CN2709500000000	27	095	Mille Lacs County, MN	2010	NA	13152	11695	1457	11.1
CN2709700000000	27	097	Morrison County, MN	2010	NA	18617	16849	1768	9.5
CN2709900000000	27	099	Mower County, MN	2010	NA	20908	19634	1274	6.1
CN2710100000000	27	101	Murray County, MN	2010	NA	5022	4678	344	6.8
CN2710300000000	27	103	Nicollet County, MN	2010	NA	19782	18575	1207	6.1
CN2710500000000	27	105	Nobles County, MN	2010	NA	11522	10876	646	5.6
CN2710700000000	27	107	Norman County, MN	2010	NA	3603	3355	248	6.9
CN2710900000000	27	109	Olmsted County, MN	2010	NA	81197	76368	4829	5.9
CN2711100000000	27	111	Otter Tail County, MN	2010	NA	30869	28657	2212	7.2
CN2711300000000	27	113	Pennington County, MN	2010	NA	8398	7639	759	9
CN2711500000000	27	115	Pine County, MN	2010	NA	15355	13848	1507	9.8
CN2711700000000	27	117	Pipestone County, MN	2010	NA	5148	4809	339	6.6
CN2711900000000	27	119	Polk County, MN	2010	NA	17156	16019	1137	6.6
CN2712100000000	27	121	Pope County, MN	2010	NA	5880	5461	419	7.1
CN2712300000000	27	123	Ramsey County, MN	2010	NA	270063	249935	20128	7.5
CN2712500000000	27	125	Red Lake County, MN	2010	NA	2419	2187	232	9.6
CN2712700000000	27	127	Redwood County, MN	2010	NA	8580	8002	578	6.7
CN2712900000000	27	129	Renville County, MN	2010	NA	8993	8269	724	8.1
CN2713100000000	27	131	Rice County, MN	2010	NA	34985	32264	2721	7.8
CN2713300000000	27	133	Rock County, MN	2010	NA	5377	5105	272	5.1
CN2713500000000	27	135	Roseau County, MN	2010	NA	8685	8130	555	6.4
CN2713700000000	27	137	St. Louis County, MN	2010	NA	103374	94990	8384	8.1
CN2713900000000	27	139	Scott County, MN	2010	NA	74150	69064	5086	6.9
CN2714100000000	27	141	Sherburne County, MN	2010	NA	48989	44866	4123	8.4
CN2714300000000	27	143	Sibley County, MN	2010	NA	8506	7836	670	7.9
CN2714500000000	27	145	Stearns County, MN	2010	NA	85674	79494	6180	7.2
CN2714700000000	27	147	Steele County, MN	2010	NA	21063	19426	1637	7.8
CN2714900000000	27	149	Stevens County, MN	2010	NA	5547	5238	309	5.6
CN2715100000000	27	151	Swift County, MN	2010	NA	5239	4815	424	8.1
CN2715300000000	27	153	Todd County, MN	2010	NA	13519	12471	1048	7.8
CN2715500000000	27	155	Traverse County, MN	2010	NA	1881	1764	117	6.2
CN2715700000000	27	157	Wabasha County, MN	2010	NA	12107	11242	865	7.1
CN2715900000000	27	159	Wadena County, MN	2010	NA	6483	5822	661	10.2
CN2716100000000	27	161	Waseca County, MN	2010	NA	10577	9786	791	7.5
CN2716300000000	27	163	Washington County, MN	2010	NA	132046	123188	8858	6.7
CN2716500000000	27	165	Watonwan County, MN	2010	NA	6311	5850	461	7.3
CN2716700000000	27	167	Wilkin County, MN	2010	NA	3822	3613	209	5.5
CN2716900000000	27	169	Winona County, MN	2010	NA	29217	27196	2021	6.9
CN2717100000000	27	171	Wright County, MN	2010	NA	70095	64461	5634	8
CN2717300000000	27	173	Yellow Medicine County, MN	2010	NA	5878	5508	370	6.3
CN2800100000000	28	001	Adams County, MS	2010	NA	12608	11162	1446	11.5
CN2800300000000	28	003	Alcorn County, MS	2010	NA	15721	13906	1815	11.5
CN2800500000000	28	005	Amite County, MS	2010	NA	4979	4385	594	11.9
CN2800700000000	28	007	Attala County, MS	2010	NA	7955	6957	998	12.5
CN2800900000000	28	009	Benton County, MS	2010	NA	3273	2865	408	12.5
CN2801100000000	28	011	Bolivar County, MS	2010	NA	14909	13212	1697	11.4
CN2801300000000	28	013	Calhoun County, MS	2010	NA	7025	6376	649	9.2
CN2801500000000	28	015	Carroll County, MS	2010	NA	3834	3330	504	13.1
CN2801700000000	28	017	Chickasaw County, MS	2010	NA	7944	6989	955	12
CN2801900000000	28	019	Choctaw County, MS	2010	NA	3766	3322	444	11.8
CN2802100000000	28	021	Claiborne County, MS	2010	NA	3580	2982	598	16.7
CN2802300000000	28	023	Clarke County, MS	2010	NA	6606	5776	830	12.6
CN2802500000000	28	025	Clay County, MS	2010	NA	8682	7257	1425	16.4
CN2802700000000	28	027	Coahoma County, MS	2010	NA	10480	9044	1436	13.7
CN2802900000000	28	029	Copiah County, MS	2010	NA	11991	10622	1369	11.4
CN2803100000000	28	031	Covington County, MS	2010	NA	8235	7402	833	10.1
CN2803300000000	28	033	DeSoto County, MS	2010	NA	79619	73681	5938	7.5
CN2803500000000	28	035	Forrest County, MS	2010	NA	34083	30756	3327	9.8
CN2803700000000	28	037	Franklin County, MS	2010	NA	3234	2866	368	11.4
CN2803900000000	28	039	George County, MS	2010	NA	8759	7753	1006	11.5
CN2804100000000	28	041	Greene County, MS	2010	NA	4580	4034	546	11.9
CN2804300000000	28	043	Grenada County, MS	2010	NA	9433	8342	1091	11.6
CN2804500000000	28	045	Hancock County, MS	2010	NA	19653	17887	1766	9
CN2804700000000	28	047	Harrison County, MS	2010	NA	88745	80951	7794	8.8
CN2804900000000	28	049	Hinds County, MS	2010	NA	113892	102705	11187	9.8
CN2805100000000	28	051	Holmes County, MS	2010	NA	6848	5506	1342	19.6
CN2805300000000	28	053	Humphreys County, MS	2010	NA	3482	2882	600	17.2
CN2805500000000	28	055	Issaquena County, MS	2010	NA	525	440	85	16.2
CN2805700000000	28	057	Itawamba County, MS	2010	NA	10355	9188	1167	11.3
CN2805900000000	28	059	Jackson County, MS	2010	NA	64425	58293	6132	9.5
CN2806100000000	28	061	Jasper County, MS	2010	NA	7013	6154	859	12.2
CN2806300000000	28	063	Jefferson County, MS	2010	NA	2472	2007	465	18.8
CN2806500000000	28	065	Jefferson Davis County, MS	2010	NA	4609	3961	648	14.1
CN2806700000000	28	067	Jones County, MS	2010	NA	27932	25384	2548	9.1
CN2806900000000	28	069	Kemper County, MS	2010	NA	3906	3330	576	14.7
CN2807100000000	28	071	Lafayette County, MS	2010	NA	21649	19630	2019	9.3
CN2807300000000	28	073	Lamar County, MS	2010	NA	27659	25673	1986	7.2
CN2807500000000	28	075	Lauderdale County, MS	2010	NA	33063	29541	3522	10.7
CN2807700000000	28	077	Lawrence County, MS	2010	NA	5147	4534	613	11.9
CN2807900000000	28	079	Leake County, MS	2010	NA	9177	8289	888	9.7
CN2808100000000	28	081	Lee County, MS	2010	NA	39180	35112	4068	10.4
CN2808300000000	28	083	Leflore County, MS	2010	NA	11604	9825	1779	15.3
CN2808500000000	28	085	Lincoln County, MS	2010	NA	14459	12940	1519	10.5
CN2808700000000	28	087	Lowndes County, MS	2010	NA	26144	23046	3098	11.8
CN2808900000000	28	089	Madison County, MS	2010	NA	48712	45114	3598	7.4
CN2809100000000	28	091	Marion County, MS	2010	NA	10544	9259	1285	12.2
CN2809300000000	28	093	Marshall County, MS	2010	NA	15497	13626	1871	12.1
CN2809500000000	28	095	Monroe County, MS	2010	NA	16300	14157	2143	13.1
CN2809700000000	28	097	Montgomery County, MS	2010	NA	4675	4031	644	13.8
CN2809900000000	28	099	Neshoba County, MS	2010	NA	11806	10579	1227	10.4
CN2810100000000	28	101	Newton County, MS	2010	NA	9201	8274	927	10.1
CN2810300000000	28	103	Noxubee County, MS	2010	NA	4430	3731	699	15.8
CN2810500000000	28	105	Oktibbeha County, MS	2010	NA	21697	19478	2219	10.2
CN2810700000000	28	107	Panola County, MS	2010	NA	14409	12457	1952	13.5
CN2810900000000	28	109	Pearl River County, MS	2010	NA	23423	21198	2225	9.5
CN2811100000000	28	111	Perry County, MS	2010	NA	4636	4004	632	13.6
CN2811300000000	28	113	Pike County, MS	2010	NA	15611	13799	1812	11.6
CN2811500000000	28	115	Pontotoc County, MS	2010	NA	13672	12280	1392	10.2
CN2811700000000	28	117	Prentiss County, MS	2010	NA	11604	10235	1369	11.8
CN2811900000000	28	119	Quitman County, MS	2010	NA	3197	2721	476	14.9
CN2812100000000	28	121	Rankin County, MS	2010	NA	70858	66002	4856	6.9
CN2812300000000	28	123	Scott County, MS	2010	NA	13551	12469	1082	8
CN2812500000000	28	125	Sharkey County, MS	2010	NA	2059	1760	299	14.5
CN2812700000000	28	127	Simpson County, MS	2010	NA	11372	10304	1068	9.4
CN2812900000000	28	129	Smith County, MS	2010	NA	7314	6650	664	9.1
CN2813100000000	28	131	Stone County, MS	2010	NA	6843	6117	726	10.6
CN2813300000000	28	133	Sunflower County, MS	2010	NA	9869	8348	1521	15.4
CN2813500000000	28	135	Tallahatchie County, MS	2010	NA	5885	5166	719	12.2
CN2813700000000	28	137	Tate County, MS	2010	NA	12631	11271	1360	10.8
CN2813900000000	28	139	Tippah County, MS	2010	NA	8991	7777	1214	13.5
CN2814100000000	28	141	Tishomingo County, MS	2010	NA	7813	6817	996	12.7
CN2814300000000	28	143	Tunica County, MS	2010	NA	5027	4339	688	13.7
CN2814500000000	28	145	Union County, MS	2010	NA	12138	10814	1324	10.9
CN2814700000000	28	147	Walthall County, MS	2010	NA	5813	5060	753	13
CN2814900000000	28	149	Warren County, MS	2010	NA	23335	20888	2447	10.5
CN2815100000000	28	151	Washington County, MS	2010	NA	20950	17637	3313	15.8
CN2815300000000	28	153	Wayne County, MS	2010	NA	8631	7589	1042	12.1
CN2815500000000	28	155	Webster County, MS	2010	NA	4372	3868	504	11.5
CN2815700000000	28	157	Wilkinson County, MS	2010	NA	3444	2968	476	13.8
CN2815900000000	28	159	Winston County, MS	2010	NA	7945	6597	1348	17
CN2816100000000	28	161	Yalobusha County, MS	2010	NA	5205	4499	706	13.6
CN2816300000000	28	163	Yazoo County, MS	2010	NA	9913	8701	1212	12.2
CN2900100000000	29	001	Adair County, MO	2010	NA	11083	10124	959	8.7
CN2900300000000	29	003	Andrew County, MO	2010	NA	9898	9078	820	8.3
CN2900500000000	29	005	Atchison County, MO	2010	NA	2999	2741	258	8.6
CN2900700000000	29	007	Audrain County, MO	2010	NA	11136	10068	1068	9.6
CN2900900000000	29	009	Barry County, MO	2010	NA	15616	14109	1507	9.7
CN2901100000000	29	011	Barton County, MO	2010	NA	5757	5164	593	10.3
CN2901300000000	29	013	Bates County, MO	2010	NA	8397	7474	923	11
CN2901500000000	29	015	Benton County, MO	2010	NA	7290	6406	884	12.1
CN2901700000000	29	017	Bollinger County, MO	2010	NA	5842	5254	588	10.1
CN2901900000000	29	019	Boone County, MO	2010	NA	92559	86588	5971	6.5
CN2902100000000	29	021	Buchanan County, MO	2010	NA	46660	42383	4277	9.2
CN2902300000000	29	023	Butler County, MO	2010	NA	18765	16969	1796	9.6
CN2902500000000	29	025	Caldwell County, MO	2010	NA	4560	4124	436	9.6
CN2902700000000	29	027	Callaway County, MO	2010	NA	22377	20524	1853	8.3
CN2902900000000	29	029	Camden County, MO	2010	NA	19459	17129	2330	12
CN2903100000000	29	031	Cape Girardeau County, MO	2010	NA	41030	38022	3008	7.3
CN2903300000000	29	033	Carroll County, MO	2010	NA	4796	4246	550	11.5
CN2903500000000	29	035	Carter County, MO	2010	NA	2666	2359	307	11.5
CN2903700000000	29	037	Cass County, MO	2010	NA	53355	48217	5138	9.6
CN2903900000000	29	039	Cedar County, MO	2010	NA	6113	5530	583	9.5
CN2904100000000	29	041	Chariton County, MO	2010	NA	4128	3736	392	9.5
CN2904300000000	29	043	Christian County, MO	2010	NA	40860	37419	3441	8.4
CN2904500000000	29	045	Clark County, MO	2010	NA	3462	3032	430	12.4
CN2904700000000	29	047	Clay County, MO	2010	NA	125000	114531	10469	8.4
CN2904900000000	29	049	Clinton County, MO	2010	NA	11071	10002	1069	9.7
CN2905100000000	29	051	Cole County, MO	2010	NA	40684	37893	2791	6.9
CN2905300000000	29	053	Cooper County, MO	2010	NA	7961	7184	777	9.8
CN2905500000000	29	055	Crawford County, MO	2010	NA	10811	9439	1372	12.7
CN2905700000000	29	057	Dade County, MO	2010	NA	3402	3071	331	9.7
CN2905900000000	29	059	Dallas County, MO	2010	NA	7285	6369	916	12.6
CN2906100000000	29	061	Daviess County, MO	2010	NA	4010	3616	394	9.8
CN2906300000000	29	063	DeKalb County, MO	2010	NA	5025	4581	444	8.8
CN2906500000000	29	065	Dent County, MO	2010	NA	6512	5838	674	10.4
CN2906700000000	29	067	Douglas County, MO	2010	NA	5249	4612	637	12.1
CN2906900000000	29	069	Dunklin County, MO	2010	NA	12289	10632	1657	13.5
CN2907100000000	29	071	Franklin County, MO	2010	NA	53456	47397	6059	11.3
CN2907300000000	29	073	Gasconade County, MO	2010	NA	7752	6943	809	10.4
CN2907500000000	29	075	Gentry County, MO	2010	NA	3523	3245	278	7.9
CN2907700000000	29	077	Greene County, MO	2010	NA	144733	132664	12069	8.3
CN2907900000000	29	079	Grundy County, MO	2010	NA	4837	4450	387	8
CN2908100000000	29	081	Harrison County, MO	2010	NA	4062	3676	386	9.5
CN2908300000000	29	083	Henry County, MO	2010	NA	10139	9045	1094	10.8
CN2908500000000	29	085	Hickory County, MO	2010	NA	3677	3213	464	12.6
CN2908700000000	29	087	Holt County, MO	2010	NA	2693	2479	214	7.9
CN2908900000000	29	089	Howard County, MO	2010	NA	5002	4565	437	8.7
CN2909100000000	29	091	Howell County, MO	2010	NA	17064	15218	1846	10.8
CN2909300000000	29	093	Iron County, MO	2010	NA	3574	2977	597	16.7
CN2909500000000	29	095	Jackson County, MO	2010	NA	361016	322487	38529	10.7
CN2909700000000	29	097	Jasper County, MO	2010	NA	59026	54018	5008	8.5
CN2909900000000	29	099	Jefferson County, MO	2010	NA	117543	105348	12195	10.4
CN2910100000000	29	101	Johnson County, MO	2010	NA	23492	21158	2334	9.9
CN2910300000000	29	103	Knox County, MO	2010	NA	2007	1851	156	7.8
CN2910500000000	29	105	Laclede County, MO	2010	NA	15918	13942	1976	12.4
CN2910700000000	29	107	Lafayette County, MO	2010	NA	17549	15830	1719	9.8
CN2910900000000	29	109	Lawrence County, MO	2010	NA	17558	15925	1633	9.3
CN2911100000000	29	111	Lewis County, MO	2010	NA	5203	4759	444	8.5
CN2911300000000	29	113	Lincoln County, MO	2010	NA	26706	23558	3148	11.8
CN2911500000000	29	115	Linn County, MO	2010	NA	5450	4766	684	12.6
CN2911700000000	29	117	Livingston County, MO	2010	NA	7146	6563	583	8.2
CN2911900000000	29	119	McDonald County, MO	2010	NA	10360	9411	949	9.2
CN2912100000000	29	121	Macon County, MO	2010	NA	7482	6789	693	9.3
CN2912300000000	29	123	Madison County, MO	2010	NA	5457	4793	664	12.2
CN2912500000000	29	125	Maries County, MO	2010	NA	4256	3853	403	9.5
CN2912700000000	29	127	Marion County, MO	2010	NA	14770	13427	1343	9.1
CN2912900000000	29	129	Mercer County, MO	2010	NA	1796	1646	150	8.4
CN2913100000000	29	131	Miller County, MO	2010	NA	11858	10331	1527	12.9
CN2913300000000	29	133	Mississippi County, MO	2010	NA	6108	5518	590	9.7
CN2913500000000	29	135	Moniteau County, MO	2010	NA	7397	6772	625	8.4
CN2913700000000	29	137	Monroe County, MO	2010	NA	4118	3613	505	12.3
CN2913900000000	29	139	Montgomery County, MO	2010	NA	6047	5374	673	11.1
CN2914100000000	29	141	Morgan County, MO	2010	NA	7984	6824	1160	14.5
CN2914300000000	29	143	New Madrid County, MO	2010	NA	8225	7406	819	10
CN2914500000000	29	145	Newton County, MO	2010	NA	28759	26175	2584	9
CN2914700000000	29	147	Nodaway County, MO	2010	NA	11758	10909	849	7.2
CN2914900000000	29	149	Oregon County, MO	2010	NA	4107	3651	456	11.1
CN2915100000000	29	151	Osage County, MO	2010	NA	7467	6951	516	6.9
CN2915300000000	29	153	Ozark County, MO	2010	NA	3602	3179	423	11.7
CN2915500000000	29	155	Pemiscot County, MO	2010	NA	7221	6322	899	12.4
CN2915700000000	29	157	Perry County, MO	2010	NA	9835	9122	713	7.2
CN2915900000000	29	159	Pettis County, MO	2010	NA	20079	18218	1861	9.3
CN2916100000000	29	161	Phelps County, MO	2010	NA	19813	18028	1785	9
CN2916300000000	29	163	Pike County, MO	2010	NA	8241	7433	808	9.8
CN2916500000000	29	165	Platte County, MO	2010	NA	51579	47590	3989	7.7
CN2916700000000	29	167	Polk County, MO	2010	NA	14405	12924	1481	10.3
CN2916900000000	29	169	Pulaski County, MO	2010	NA	16706	15239	1467	8.8
CN2917100000000	29	171	Putnam County, MO	2010	NA	2387	2195	192	8
CN2917300000000	29	173	Ralls County, MO	2010	NA	5635	5140	495	8.8
CN2917500000000	29	175	Randolph County, MO	2010	NA	10792	9547	1245	11.5
CN2917700000000	29	177	Ray County, MO	2010	NA	11572	10383	1189	10.3
CN2917900000000	29	179	Reynolds County, MO	2010	NA	2383	2023	360	15.1
CN2918100000000	29	181	Ripley County, MO	2010	NA	5395	4700	695	12.9
CN2918300000000	29	183	St. Charles County, MO	2010	NA	205227	188397	16830	8.2
CN2918500000000	29	185	St. Clair County, MO	2010	NA	4136	3672	464	11.2
CN2918600000000	29	186	Ste. Genevieve County, MO	2010	NA	9404	8436	968	10.3
CN2918700000000	29	187	St. Francois County, MO	2010	NA	27272	23931	3341	12.3
CN2918900000000	29	189	St. Louis County, MO	2010	NA	535127	487369	47758	8.9
CN2919500000000	29	195	Saline County, MO	2010	NA	10980	10004	976	8.9
CN2919700000000	29	197	Schuyler County, MO	2010	NA	1960	1757	203	10.4
CN2919900000000	29	199	Scotland County, MO	2010	NA	2306	2120	186	8.1
CN2920100000000	29	201	Scott County, MO	2010	NA	19006	17161	1845	9.7
CN2920300000000	29	203	Shannon County, MO	2010	NA	3243	2762	481	14.8
CN2920500000000	29	205	Shelby County, MO	2010	NA	3241	2962	279	8.6
CN2920700000000	29	207	Stoddard County, MO	2010	NA	13607	12186	1421	10.4
CN2920900000000	29	209	Stone County, MO	2010	NA	14493	12491	2002	13.8
CN2921100000000	29	211	Sullivan County, MO	2010	NA	2937	2678	259	8.8
CN2921300000000	29	213	Taney County, MO	2010	NA	26075	22447	3628	13.9
CN2921500000000	29	215	Texas County, MO	2010	NA	9841	8758	1083	11
CN2921700000000	29	217	Vernon County, MO	2010	NA	9572	8781	791	8.3
CN2921900000000	29	219	Warren County, MO	2010	NA	17262	15364	1898	11
CN2922100000000	29	221	Washington County, MO	2010	NA	10256	8787	1469	14.3
CN2922300000000	29	223	Wayne County, MO	2010	NA	5565	4965	600	10.8
CN2922500000000	29	225	Webster County, MO	2010	NA	16382	14659	1723	10.5
CN2922700000000	29	227	Worth County, MO	2010	NA	1249	1164	85	6.8
CN2922900000000	29	229	Wright County, MO	2010	NA	7612	6707	905	11.9
CN2951000000000	29	510	St. Louis city, MO	2010	NA	164914	145958	18956	11.5
CN3000100000000	30	001	Beaverhead County, MT	2010	NA	5010	4713	297	5.9
CN3000300000000	30	003	Big Horn County, MT	2010	NA	5525	4920	605	11
CN3000500000000	30	005	Blaine County, MT	2010	NA	2522	2354	168	6.7
CN3000700000000	30	007	Broadwater County, MT	2010	NA	2508	2322	186	7.4
CN3000900000000	30	009	Carbon County, MT	2010	NA	5330	4988	342	6.4
CN3001100000000	30	011	Carter County, MT	2010	NA	725	697	28	3.9
CN3001300000000	30	013	Cascade County, MT	2010	NA	38447	35996	2451	6.4
CN3001500000000	30	015	Chouteau County, MT	2010	NA	2738	2618	120	4.4
CN3001700000000	30	017	Custer County, MT	2010	NA	6400	6110	290	4.5
CN3001900000000	30	019	Daniels County, MT	2010	NA	946	913	33	3.5
CN3002100000000	30	021	Dawson County, MT	2010	NA	4513	4323	190	4.2
CN3002300000000	30	023	Deer Lodge County, MT	2010	NA	5181	4864	317	6.1
CN3002500000000	30	025	Fallon County, MT	2010	NA	1898	1840	58	3.1
CN3002700000000	30	027	Fergus County, MT	2010	NA	6017	5631	386	6.4
CN3002900000000	30	029	Flathead County, MT	2010	NA	43786	38512	5274	12
CN3003100000000	30	031	Gallatin County, MT	2010	NA	50768	47316	3452	6.8
CN3003300000000	30	033	Garfield County, MT	2010	NA	763	736	27	3.5
CN3003500000000	30	035	Glacier County, MT	2010	NA	6260	5648	612	9.8
CN3003700000000	30	037	Golden Valley County, MT	2010	NA	418	390	28	6.7
CN3003900000000	30	039	Granite County, MT	2010	NA	1458	1323	135	9.3
CN3004100000000	30	041	Hill County, MT	2010	NA	7982	7518	464	5.8
CN3004300000000	30	043	Jefferson County, MT	2010	NA	5628	5274	354	6.3
CN3004500000000	30	045	Judith Basin County, MT	2010	NA	1009	944	65	6.4
CN3004700000000	30	047	Lake County, MT	2010	NA	12644	11512	1132	9
CN3004900000000	30	049	Lewis and Clark County, MT	2010	NA	34314	32427	1887	5.5
CN3005100000000	30	051	Liberty County, MT	2010	NA	1033	988	45	4.4
CN3005300000000	30	053	Lincoln County, MT	2010	NA	8429	7167	1262	15
CN3005500000000	30	055	McCone County, MT	2010	NA	1131	1098	33	2.9
CN3005700000000	30	057	Madison County, MT	2010	NA	4155	3840	315	7.6
CN3005900000000	30	059	Meagher County, MT	2010	NA	935	860	75	8
CN3006100000000	30	061	Mineral County, MT	2010	NA	1789	1566	223	12.5
CN3006300000000	30	063	Missoula County, MT	2010	NA	58536	54244	4292	7.3
CN3006500000000	30	065	Musselshell County, MT	2010	NA	2381	2217	164	6.9
CN3006700000000	30	067	Park County, MT	2010	NA	7890	7199	691	8.8
CN3006900000000	30	069	Petroleum County, MT	2010	NA	299	283	16	5.4
CN3007100000000	30	071	Phillips County, MT	2010	NA	2208	2058	150	6.8
CN3007300000000	30	073	Pondera County, MT	2010	NA	2953	2780	173	5.9
CN3007500000000	30	075	Powder River County, MT	2010	NA	1044	1005	39	3.7
CN3007700000000	30	077	Powell County, MT	2010	NA	2959	2735	224	7.6
CN3007900000000	30	079	Prairie County, MT	2010	NA	567	538	29	5.1
CN3008100000000	30	081	Ravalli County, MT	2010	NA	18864	17095	1769	9.4
CN3008300000000	30	083	Richland County, MT	2010	NA	5763	5545	218	3.8
CN3008500000000	30	085	Roosevelt County, MT	2010	NA	4583	4268	315	6.9
CN3008700000000	30	087	Rosebud County, MT	2010	NA	4358	4054	304	7
CN3008900000000	30	089	Sanders County, MT	2010	NA	5000	4345	655	13.1
CN3009100000000	30	091	Sheridan County, MT	2010	NA	1819	1752	67	3.7
CN3009300000000	30	093	Silver Bow County, MT	2010	NA	16952	15846	1106	6.5
CN3009500000000	30	095	Stillwater County, MT	2010	NA	4762	4484	278	5.8
CN3009700000000	30	097	Sweet Grass County, MT	2010	NA	1738	1643	95	5.5
CN3009900000000	30	099	Teton County, MT	2010	NA	3030	2849	181	6
CN3010100000000	30	101	Toole County, MT	2010	NA	2448	2336	112	4.6
CN3010300000000	30	103	Treasure County, MT	2010	NA	398	377	21	5.3
CN3010500000000	30	105	Valley County, MT	2010	NA	3910	3719	191	4.9
CN3010700000000	30	107	Wheatland County, MT	2010	NA	861	793	68	7.9
CN3010900000000	30	109	Wibaux County, MT	2010	NA	529	507	22	4.2
CN3011100000000	30	111	Yellowstone County, MT	2010	NA	76415	71920	4495	5.9
CN3100100000000	31	001	Adams County, NE	2010	NA	16494	15713	781	4.7
CN3100300000000	31	003	Antelope County, NE	2010	NA	3526	3400	126	3.6
CN3100500000000	31	005	Arthur County, NE	2010	NA	226	208	18	8
CN3100700000000	31	007	Banner County, NE	2010	NA	413	395	18	4.4
CN3100900000000	31	009	Blaine County, NE	2010	NA	258	245	13	5
CN3101100000000	31	011	Boone County, NE	2010	NA	2959	2855	104	3.5
CN3101300000000	31	013	Box Butte County, NE	2010	NA	5852	5561	291	5
CN3101500000000	31	015	Boyd County, NE	2010	NA	1107	1064	43	3.9
CN3101700000000	31	017	Brown County, NE	2010	NA	1461	1393	68	4.7
CN3101900000000	31	019	Buffalo County, NE	2010	NA	26386	25429	957	3.6
CN3102100000000	31	021	Burt County, NE	2010	NA	3641	3425	216	5.9
CN3102300000000	31	023	Butler County, NE	2010	NA	4651	4469	182	3.9
CN3102500000000	31	025	Cass County, NE	2010	NA	13404	12649	755	5.6
CN3102700000000	31	027	Cedar County, NE	2010	NA	4627	4462	165	3.6
CN3102900000000	31	029	Chase County, NE	2010	NA	2293	2229	64	2.8
CN3103100000000	31	031	Cherry County, NE	2010	NA	3385	3285	100	3
CN3103300000000	31	033	Cheyenne County, NE	2010	NA	5558	5356	202	3.6
CN3103500000000	31	035	Clay County, NE	2010	NA	3433	3286	147	4.3
CN3103700000000	31	037	Colfax County, NE	2010	NA	5659	5436	223	3.9
CN3103900000000	31	039	Cuming County, NE	2010	NA	4863	4685	178	3.7
CN3104100000000	31	041	Custer County, NE	2010	NA	5986	5766	220	3.7
CN3104300000000	31	043	Dakota County, NE	2010	NA	11299	10470	829	7.3
CN3104500000000	31	045	Dawes County, NE	2010	NA	5499	5281	218	4
CN3104700000000	31	047	Dawson County, NE	2010	NA	13210	12559	651	4.9
CN3104900000000	31	049	Deuel County, NE	2010	NA	1031	991	40	3.9
CN3105100000000	31	051	Dixon County, NE	2010	NA	3115	2966	149	4.8
CN3105300000000	31	053	Dodge County, NE	2010	NA	18851	17855	996	5.3
CN3105500000000	31	055	Douglas County, NE	2010	NA	279280	264986	14294	5.1
CN3105700000000	31	057	Dundy County, NE	2010	NA	1216	1178	38	3.1
CN3105900000000	31	059	Fillmore County, NE	2010	NA	3240	3119	121	3.7
CN3106100000000	31	061	Franklin County, NE	2010	NA	1634	1563	71	4.3
CN3106300000000	31	063	Frontier County, NE	2010	NA	1596	1536	60	3.8
CN3106500000000	31	065	Furnas County, NE	2010	NA	2661	2571	90	3.4
CN3106700000000	31	067	Gage County, NE	2010	NA	11408	10752	656	5.8
CN3106900000000	31	069	Garden County, NE	2010	NA	1266	1214	52	4.1
CN3107100000000	31	071	Garfield County, NE	2010	NA	1202	1165	37	3.1
CN3107300000000	31	073	Gosper County, NE	2010	NA	1147	1106	41	3.6
CN3107500000000	31	075	Grant County, NE	2010	NA	421	405	16	3.8
CN3107700000000	31	077	Greeley County, NE	2010	NA	1360	1311	49	3.6
CN3107900000000	31	079	Hall County, NE	2010	NA	31519	30054	1465	4.6
CN3108100000000	31	081	Hamilton County, NE	2010	NA	4806	4625	181	3.8
CN3108300000000	31	083	Harlan County, NE	2010	NA	1893	1832	61	3.2
CN3108500000000	31	085	Hayes County, NE	2010	NA	640	618	22	3.4
CN3108700000000	31	087	Hitchcock County, NE	2010	NA	1400	1328	72	5.1
CN3108900000000	31	089	Holt County, NE	2010	NA	5832	5621	211	3.6
CN3109100000000	31	091	Hooker County, NE	2010	NA	410	389	21	5.1
CN3109300000000	31	093	Howard County, NE	2010	NA	3346	3198	148	4.4
CN3109500000000	31	095	Jefferson County, NE	2010	NA	4251	4050	201	4.7
CN3109700000000	31	097	Johnson County, NE	2010	NA	2343	2234	109	4.7
CN3109900000000	31	099	Kearney County, NE	2010	NA	3796	3663	133	3.5
CN3110100000000	31	101	Keith County, NE	2010	NA	4585	4390	195	4.3
CN3110300000000	31	103	Keya Paha County, NE	2010	NA	568	548	20	3.5
CN3110500000000	31	105	Kimball County, NE	2010	NA	2124	2024	100	4.7
CN3110700000000	31	107	Knox County, NE	2010	NA	4751	4554	197	4.1
CN3110900000000	31	109	Lancaster County, NE	2010	NA	162567	155716	6851	4.2
CN3111100000000	31	111	Lincoln County, NE	2010	NA	19401	18524	877	4.5
CN3111300000000	31	113	Logan County, NE	2010	NA	492	470	22	4.5
CN3111500000000	31	115	Loup County, NE	2010	NA	368	347	21	5.7
CN3111700000000	31	117	McPherson County, NE	2010	NA	353	343	10	2.8
CN3111900000000	31	119	Madison County, NE	2010	NA	18950	18151	799	4.2
CN3112100000000	31	121	Merrick County, NE	2010	NA	4199	4010	189	4.5
CN3112300000000	31	123	Morrill County, NE	2010	NA	2650	2542	108	4.1
CN3112500000000	31	125	Nance County, NE	2010	NA	1980	1903	77	3.9
CN3112700000000	31	127	Nemaha County, NE	2010	NA	3851	3646	205	5.3
CN3112900000000	31	129	Nuckolls County, NE	2010	NA	2441	2341	100	4.1
CN3113100000000	31	131	Otoe County, NE	2010	NA	8476	8048	428	5
CN3113300000000	31	133	Pawnee County, NE	2010	NA	1586	1523	63	4
CN3113500000000	31	135	Perkins County, NE	2010	NA	1769	1710	59	3.3
CN3113700000000	31	137	Phelps County, NE	2010	NA	4958	4781	177	3.6
CN3113900000000	31	139	Pierce County, NE	2010	NA	4175	4022	153	3.7
CN3114100000000	31	141	Platte County, NE	2010	NA	17655	16910	745	4.2
CN3114300000000	31	143	Polk County, NE	2010	NA	2958	2839	119	4
CN3114500000000	31	145	Red Willow County, NE	2010	NA	6216	5989	227	3.7
CN3114700000000	31	147	Richardson County, NE	2010	NA	4328	4058	270	6.2
CN3114900000000	31	149	Rock County, NE	2010	NA	891	866	25	2.8
CN3115100000000	31	151	Saline County, NE	2010	NA	7287	6946	341	4.7
CN3115300000000	31	153	Sarpy County, NE	2010	NA	84923	81145	3778	4.4
CN3115500000000	31	155	Saunders County, NE	2010	NA	11179	10643	536	4.8
CN3115700000000	31	157	Scotts Bluff County, NE	2010	NA	19200	18144	1056	5.5
CN3115900000000	31	159	Seward County, NE	2010	NA	8765	8414	351	4
CN3116100000000	31	161	Sheridan County, NE	2010	NA	2821	2721	100	3.5
CN3116300000000	31	163	Sherman County, NE	2010	NA	1730	1660	70	4
CN3116500000000	31	165	Sioux County, NE	2010	NA	835	804	31	3.7
CN3116700000000	31	167	Stanton County, NE	2010	NA	3584	3438	146	4.1
CN3116900000000	31	169	Thayer County, NE	2010	NA	2803	2697	106	3.8
CN3117100000000	31	171	Thomas County, NE	2010	NA	396	377	19	4.8
CN3117300000000	31	173	Thurston County, NE	2010	NA	3054	2762	292	9.6
CN3117500000000	31	175	Valley County, NE	2010	NA	2143	2048	95	4.4
CN3117700000000	31	177	Washington County, NE	2010	NA	11232	10716	516	4.6
CN3117900000000	31	179	Wayne County, NE	2010	NA	5671	5456	215	3.8
CN3118100000000	31	181	Webster County, NE	2010	NA	1705	1623	82	4.8
CN3118300000000	31	183	Wheeler County, NE	2010	NA	515	495	20	3.9
CN3118500000000	31	185	York County, NE	2010	NA	7411	7067	344	4.6
CN3200100000000	32	001	Churchill County, NV	2010	NA	11227	9842	1385	12.3
CN3200300000000	32	003	Clark County, NV	2010	NA	984373	848942	135431	13.8
CN3200500000000	32	005	Douglas County, NV	2010	NA	23118	19941	3177	13.7
CN3200700000000	32	007	Elko County, NV	2010	NA	26566	24496	2070	7.8
CN3200900000000	32	009	Esmeralda County, NV	2010	NA	384	346	38	9.9
CN3201100000000	32	011	Eureka County, NV	2010	NA	1019	939	80	7.9
CN3201300000000	32	013	Humboldt County, NV	2010	NA	8401	7677	724	8.6
CN3201500000000	32	015	Lander County, NV	2010	NA	3042	2749	293	9.6
CN3201700000000	32	017	Lincoln County, NV	2010	NA	2002	1789	213	10.6
CN3201900000000	32	019	Lyon County, NV	2010	NA	22927	18905	4022	17.5
CN3202100000000	32	021	Mineral County, NV	2010	NA	2206	1871	335	15.2
CN3202300000000	32	023	Nye County, NV	2010	NA	16728	13839	2889	17.3
CN3202700000000	32	027	Pershing County, NV	2010	NA	2323	2069	254	10.9
CN3202900000000	32	029	Storey County, NV	2010	NA	2014	1677	337	16.7
CN3203100000000	32	031	Washoe County, NV	2010	NA	220898	192362	28536	12.9
CN3203300000000	32	033	White Pine County, NV	2010	NA	4639	4218	421	9.1
CN3251000000000	32	510	Carson City, NV	2010	NA	26713	23113	3600	13.5
CN3300100000000	33	001	Belknap County, NH	2010	NA	32261	30206	2055	6.4
CN3300300000000	33	003	Carroll County, NH	2010	NA	24941	23527	1414	5.7
CN3300500000000	33	005	Cheshire County, NH	2010	NA	42624	40263	2361	5.5
CN3300700000000	33	007	Coos County, NH	2010	NA	16588	15368	1220	7.4
CN3300900000000	33	009	Grafton County, NH	2010	NA	48324	46005	2319	4.8
CN3301100000000	33	011	Hillsborough County, NH	2010	NA	226152	212241	13911	6.2
CN3301300000000	33	013	Merrimack County, NH	2010	NA	81401	77049	4352	5.3
CN3301500000000	33	015	Rockingham County, NH	2010	NA	172358	162057	10301	6
CN3301700000000	33	017	Strafford County, NH	2010	NA	69571	65628	3943	5.7
CN3301900000000	33	019	Sullivan County, NH	2010	NA	24038	22792	1246	5.2
CN3400100000000	34	001	Atlantic County, NJ	2010	NA	140598	123330	17268	12.3
CN3400300000000	34	003	Bergen County, NJ	2010	NA	478945	440499	38446	8
CN3400500000000	34	005	Burlington County, NJ	2010	NA	237144	215841	21303	9
CN3400700000000	34	007	Camden County, NJ	2010	NA	264826	235862	28964	10.9
CN3400900000000	34	009	Cape May County, NJ	2010	NA	50213	43187	7026	14
CN3401100000000	34	011	Cumberland County, NJ	2010	NA	72664	63233	9431	13
CN3401300000000	34	013	Essex County, NJ	2010	NA	382021	340577	41444	10.8
CN3401500000000	34	015	Gloucester County, NJ	2010	NA	152605	136957	15648	10.3
CN3401700000000	34	017	Hudson County, NJ	2010	NA	352903	319151	33752	9.6
CN3401900000000	34	019	Hunterdon County, NJ	2010	NA	68281	63232	5049	7.4
CN3402100000000	34	021	Mercer County, NJ	2010	NA	192673	176570	16103	8.4
CN3402300000000	34	023	Middlesex County, NJ	2010	NA	424100	386139	37961	9
CN3402500000000	34	025	Monmouth County, NJ	2010	NA	330154	301281	28873	8.7
CN3402700000000	34	027	Morris County, NJ	2010	NA	264785	245153	19632	7.4
CN3402900000000	34	029	Ocean County, NJ	2010	NA	264400	237254	27146	10.3
CN3403100000000	34	031	Passaic County, NJ	2010	NA	253373	224610	28763	11.4
CN3403300000000	34	033	Salem County, NJ	2010	NA	32172	28427	3745	11.6
CN3403500000000	34	035	Somerset County, NJ	2010	NA	173443	160265	13178	7.6
CN3403700000000	34	037	Sussex County, NJ	2010	NA	82239	74482	7757	9.4
CN3403900000000	34	039	Union County, NJ	2010	NA	279122	252505	26617	9.5
CN3404100000000	34	041	Warren County, NJ	2010	NA	58671	52900	5771	9.8
CN3500100000000	35	001	Bernalillo County, NM	2010	NA	326594	301358	25236	7.7
CN3500300000000	35	003	Catron County, NM	2010	NA	1216	1070	146	12
CN3500500000000	35	005	Chaves County, NM	2010	NA	28042	25927	2115	7.5
CN3500600000000	35	006	Cibola County, NM	2010	NA	9327	8431	896	9.6
CN3500700000000	35	007	Colfax County, NM	2010	NA	6363	5830	533	8.4
CN3500900000000	35	009	Curry County, NM	2010	NA	21586	20428	1158	5.4
CN3501100000000	35	011	De Baca County, NM	2010	NA	833	783	50	6
CN3501300000000	35	013	Dona Ana County, NM	2010	NA	93597	86337	7260	7.8
CN3501500000000	35	015	Eddy County, NM	2010	NA	25658	24015	1643	6.4
CN3501700000000	35	017	Grant County, NM	2010	NA	12349	11156	1193	9.7
CN3501900000000	35	019	Guadalupe County, NM	2010	NA	1652	1485	167	10.1
CN3502100000000	35	021	Harding County, NM	2010	NA	295	277	18	6.1
CN3502300000000	35	023	Hidalgo County, NM	2010	NA	2300	2105	195	8.5
CN3502500000000	35	025	Lea County, NM	2010	NA	26301	24223	2078	7.9
CN3502700000000	35	027	Lincoln County, NM	2010	NA	9386	8682	704	7.5
CN3502800000000	35	028	Los Alamos County, NM	2010	NA	9460	9113	347	3.7
CN3502900000000	35	029	Luna County, NM	2010	NA	11677	9327	2350	20.1
CN3503100000000	35	031	McKinley County, NM	2010	NA	25440	22929	2511	9.9
CN3503300000000	35	033	Mora County, NM	2010	NA	2434	2134	300	12.3
CN3503500000000	35	035	Otero County, NM	2010	NA	24984	23170	1814	7.3
CN3503700000000	35	037	Quay County, NM	2010	NA	3501	3171	330	9.4
CN3503900000000	35	039	Rio Arriba County, NM	2010	NA	18005	16358	1647	9.1
CN3504100000000	35	041	Roosevelt County, NM	2010	NA	8409	7883	526	6.3
CN3504300000000	35	043	Sandoval County, NM	2010	NA	60901	55793	5108	8.4
CN3504500000000	35	045	San Juan County, NM	2010	NA	54860	49713	5147	9.4
CN3504700000000	35	047	San Miguel County, NM	2010	NA	11204	10131	1073	9.6
CN3504900000000	35	049	Santa Fe County, NM	2010	NA	74289	69245	5044	6.8
CN3505100000000	35	051	Sierra County, NM	2010	NA	4026	3656	370	9.2
CN3505300000000	35	053	Socorro County, NM	2010	NA	6876	6340	536	7.8
CN3505500000000	35	055	Taos County, NM	2010	NA	15398	13757	1641	10.7
CN3505700000000	35	057	Torrance County, NM	2010	NA	6028	5331	697	11.6
CN3505900000000	35	059	Union County, NM	2010	NA	1930	1809	121	6.3
CN3506100000000	35	061	Valencia County, NM	2010	NA	31167	28187	2980	9.6
CN3600100000000	36	001	Albany County, NY	2010	NA	161511	150264	11247	7
CN3600300000000	36	003	Allegany County, NY	2010	NA	24240	22022	2218	9.2
CN3600500000000	36	005	Bronx County, NY	2010	NA	582287	512477	69810	12
CN3600700000000	36	007	Broome County, NY	2010	NA	97844	89316	8528	8.7
CN3600900000000	36	009	Cattaraugus County, NY	2010	NA	39654	35881	3773	9.5
CN3601100000000	36	011	Cayuga County, NY	2010	NA	39885	36480	3405	8.5
CN3601300000000	36	013	Chautauqua County, NY	2010	NA	63922	58262	5660	8.9
CN3601500000000	36	015	Chemung County, NY	2010	NA	41594	38105	3489	8.4
CN3601700000000	36	017	Chenango County, NY	2010	NA	23691	21509	2182	9.2
CN3601900000000	36	019	Clinton County, NY	2010	NA	39701	35809	3892	9.8
CN3602100000000	36	021	Columbia County, NY	2010	NA	32137	29789	2348	7.3
CN3602300000000	36	023	Cortland County, NY	2010	NA	24475	22304	2171	8.9
CN3602500000000	36	025	Delaware County, NY	2010	NA	22431	20465	1966	8.8
CN3602700000000	36	027	Dutchess County, NY	2010	NA	149196	137679	11517	7.7
CN3602900000000	36	029	Erie County, NY	2010	NA	465675	426962	38713	8.3
CN3603100000000	36	031	Essex County, NY	2010	NA	18736	17021	1715	9.2
CN3603300000000	36	033	Franklin County, NY	2010	NA	22245	20249	1996	9
CN3603500000000	36	035	Fulton County, NY	2010	NA	26105	23337	2768	10.6
CN3603700000000	36	037	Genesee County, NY	2010	NA	31730	29189	2541	8
CN3603900000000	36	039	Greene County, NY	2010	NA	22101	20097	2004	9.1
CN3604100000000	36	041	Hamilton County, NY	2010	NA	2502	2256	246	9.8
CN3604300000000	36	043	Herkimer County, NY	2010	NA	31552	28841	2711	8.6
CN3604500000000	36	045	Jefferson County, NY	2010	NA	50310	45638	4672	9.3
CN3604700000000	36	047	Kings County, NY	2010	NA	1163502	1047981	115521	9.9
CN3604900000000	36	049	Lewis County, NY	2010	NA	12756	11592	1164	9.1
CN3605100000000	36	051	Livingston County, NY	2010	NA	32754	30104	2650	8.1
CN3605300000000	36	053	Madison County, NY	2010	NA	35586	32631	2955	8.3
CN3605500000000	36	055	Monroe County, NY	2010	NA	378251	347846	30405	8
CN3605700000000	36	057	Montgomery County, NY	2010	NA	23919	21507	2412	10.1
CN3605900000000	36	059	Nassau County, NY	2010	NA	691435	642118	49317	7.1
CN3606100000000	36	061	New York County, NY	2010	NA	881204	805555	75649	8.6
CN3606300000000	36	063	Niagara County, NY	2010	NA	107847	97467	10380	9.6
CN3606500000000	36	065	Oneida County, NY	2010	NA	112248	103684	8564	7.6
CN3606700000000	36	067	Onondaga County, NY	2010	NA	236994	217970	19024	8
CN3606900000000	36	069	Ontario County, NY	2010	NA	56368	52176	4192	7.4
CN3607100000000	36	071	Orange County, NY	2010	NA	181295	166830	14465	8
CN3607300000000	36	073	Orleans County, NY	2010	NA	19149	17314	1835	9.6
CN3607500000000	36	075	Oswego County, NY	2010	NA	58886	52618	6268	10.6
CN3607700000000	36	077	Otsego County, NY	2010	NA	31880	29469	2411	7.6
CN3607900000000	36	079	Putnam County, NY	2010	NA	52594	48807	3787	7.2
CN3608100000000	36	081	Queens County, NY	2010	NA	1106461	1011049	95412	8.6
CN3608300000000	36	083	Rensselaer County, NY	2010	NA	84603	78045	6558	7.8
CN3608500000000	36	085	Richmond County, NY	2010	NA	216950	196490	20460	9.4
CN3608700000000	36	087	Rockland County, NY	2010	NA	149978	138804	11174	7.5
CN3608900000000	36	089	St. Lawrence County, NY	2010	NA	49964	44802	5162	10.3
CN3609100000000	36	091	Saratoga County, NY	2010	NA	118048	109910	8138	6.9
CN3609300000000	36	093	Schenectady County, NY	2010	NA	79016	72974	6042	7.6
CN3609500000000	36	095	Schoharie County, NY	2010	NA	15924	14504	1420	8.9
CN3609700000000	36	097	Schuyler County, NY	2010	NA	9042	8220	822	9.1
CN3609900000000	36	099	Seneca County, NY	2010	NA	16423	15078	1345	8.2
CN3610100000000	36	101	Steuben County, NY	2010	NA	47303	42780	4523	9.6
CN3610300000000	36	103	Suffolk County, NY	2010	NA	777863	717598	60265	7.7
CN3610500000000	36	105	Sullivan County, NY	2010	NA	36475	33226	3249	8.9
CN3610700000000	36	107	Tioga County, NY	2010	NA	26568	24448	2120	8
CN3610900000000	36	109	Tompkins County, NY	2010	NA	54767	51397	3370	6.2
CN3611100000000	36	111	Ulster County, NY	2010	NA	93606	86310	7296	7.8
CN3611300000000	36	113	Warren County, NY	2010	NA	34154	31082	3072	9
CN3611500000000	36	115	Washington County, NY	2010	NA	30233	27741	2492	8.2
CN3611700000000	36	117	Wayne County, NY	2010	NA	47429	43227	4202	8.9
CN3611900000000	36	119	Westchester County, NY	2010	NA	478676	443476	35200	7.4
CN3612100000000	36	121	Wyoming County, NY	2010	NA	19457	17616	1841	9.5
CN3612300000000	36	123	Yates County, NY	2010	NA	12230	11327	903	7.4
CN3700100000000	37	001	Alamance County, NC	2010	NA	76806	68451	8355	10.9
CN3700300000000	37	003	Alexander County, NC	2010	NA	18260	15877	2383	13.1
CN3700500000000	37	005	Alleghany County, NC	2010	NA	4748	4179	569	12
CN3700700000000	37	007	Anson County, NC	2010	NA	11180	9602	1578	14.1
CN3700900000000	37	009	Ashe County, NC	2010	NA	13722	12100	1622	11.8
CN3701100000000	37	011	Avery County, NC	2010	NA	7945	7089	856	10.8
CN3701300000000	37	013	Beaufort County, NC	2010	NA	21171	18692	2479	11.7
CN3701500000000	37	015	Bertie County, NC	2010	NA	9191	8108	1083	11.8
CN3701700000000	37	017	Bladen County, NC	2010	NA	15194	13169	2025	13.3
CN3701900000000	37	019	Brunswick County, NC	2010	NA	46529	40701	5828	12.5
CN3702100000000	37	021	Buncombe County, NC	2010	NA	123680	113096	10584	8.6
CN3702300000000	37	023	Burke County, NC	2010	NA	41687	36305	5382	12.9
CN3702500000000	37	025	Cabarrus County, NC	2010	NA	89049	78773	10276	11.5
CN3702700000000	37	027	Caldwell County, NC	2010	NA	38213	32542	5671	14.8
CN3702900000000	37	029	Camden County, NC	2010	NA	4594	4209	385	8.4
CN3703100000000	37	031	Carteret County, NC	2010	NA	31379	28373	3006	9.6
CN3703300000000	37	033	Caswell County, NC	2010	NA	10069	8737	1332	13.2
CN3703500000000	37	035	Catawba County, NC	2010	NA	77898	67726	10172	13.1
CN3703700000000	37	037	Chatham County, NC	2010	NA	30661	28039	2622	8.6
CN3703900000000	37	039	Cherokee County, NC	2010	NA	11654	10150	1504	12.9
CN3704100000000	37	041	Chowan County, NC	2010	NA	6151	5413	738	12
CN3704300000000	37	043	Clay County, NC	2010	NA	4243	3712	531	12.5
CN3704500000000	37	045	Cleveland County, NC	2010	NA	45633	38893	6740	14.8
CN3704700000000	37	047	Columbus County, NC	2010	NA	24184	20943	3241	13.4
CN3704900000000	37	049	Craven County, NC	2010	NA	42279	37743	4536	10.7
CN3705100000000	37	051	Cumberland County, NC	2010	NA	131096	117827	13269	10.1
CN3705300000000	37	053	Currituck County, NC	2010	NA	12189	11104	1085	8.9
CN3705500000000	37	055	Dare County, NC	2010	NA	19686	17300	2386	12.1
CN3705700000000	37	057	Davidson County, NC	2010	NA	80622	70703	9919	12.3
CN3705900000000	37	059	Davie County, NC	2010	NA	20258	17878	2380	11.7
CN3706100000000	37	061	Duplin County, NC	2010	NA	25810	23416	2394	9.3
CN3706300000000	37	063	Durham County, NC	2010	NA	143411	131592	11819	8.2
CN3706500000000	37	065	Edgecombe County, NC	2010	NA	25501	21486	4015	15.7
CN3706700000000	37	067	Forsyth County, NC	2010	NA	173002	155453	17549	10.1
CN3706900000000	37	069	Franklin County, NC	2010	NA	27954	24907	3047	10.9
CN3707100000000	37	071	Gaston County, NC	2010	NA	101249	87571	13678	13.5
CN3707300000000	37	073	Gates County, NC	2010	NA	5460	5025	435	8
CN3707500000000	37	075	Graham County, NC	2010	NA	3702	3052	650	17.6
CN3707700000000	37	077	Granville County, NC	2010	NA	27384	24716	2668	9.7
CN3707900000000	37	079	Greene County, NC	2010	NA	9428	8474	954	10.1
CN3708100000000	37	081	Guilford County, NC	2010	NA	252010	224039	27971	11.1
CN3708300000000	37	083	Halifax County, NC	2010	NA	22791	19435	3356	14.7
CN3708500000000	37	085	Harnett County, NC	2010	NA	48774	43251	5523	11.3
CN3708700000000	37	087	Haywood County, NC	2010	NA	27600	24762	2838	10.3
CN3708900000000	37	089	Henderson County, NC	2010	NA	48301	43901	4400	9.1
CN3709100000000	37	091	Hertford County, NC	2010	NA	9830	8787	1043	10.6
CN3709300000000	37	093	Hoke County, NC	2010	NA	18577	16695	1882	10.1
CN3709500000000	37	095	Hyde County, NC	2010	NA	2235	1987	248	11.1
CN3709700000000	37	097	Iredell County, NC	2010	NA	78671	68532	10139	12.9
CN3709900000000	37	099	Jackson County, NC	2010	NA	18434	16422	2012	10.9
CN3710100000000	37	101	Johnston County, NC	2010	NA	81701	73591	8110	9.9
CN3710300000000	37	103	Jones County, NC	2010	NA	4598	4083	515	11.2
CN3710500000000	37	105	Lee County, NC	2010	NA	27095	23633	3462	12.8
CN3710700000000	37	107	Lenoir County, NC	2010	NA	26874	23686	3188	11.9
CN3710900000000	37	109	Lincoln County, NC	2010	NA	39984	34893	5091	12.7
CN3711100000000	37	111	McDowell County, NC	2010	NA	20610	17864	2746	13.3
CN3711300000000	37	113	Macon County, NC	2010	NA	15461	13679	1782	11.5
CN3711500000000	37	115	Madison County, NC	2010	NA	9389	8415	974	10.4
CN3711700000000	37	117	Martin County, NC	2010	NA	10479	9144	1335	12.7
CN3711900000000	37	119	Mecklenburg County, NC	2010	NA	502428	448844	53584	10.7
CN3712100000000	37	121	Mitchell County, NC	2010	NA	6807	5964	843	12.4
CN3712300000000	37	123	Montgomery County, NC	2010	NA	11443	10032	1411	12.3
CN3712500000000	37	125	Moore County, NC	2010	NA	36325	32650	3675	10.1
CN3712700000000	37	127	Nash County, NC	2010	NA	47453	41495	5958	12.6
CN3712900000000	37	129	New Hanover County, NC	2010	NA	107583	97140	10443	9.7
CN3713100000000	37	131	Northampton County, NC	2010	NA	8703	7690	1013	11.6
CN3713300000000	37	133	Onslow County, NC	2010	NA	63342	58102	5240	8.3
CN3713500000000	37	135	Orange County, NC	2010	NA	69962	65345	4617	6.6
CN3713700000000	37	137	Pamlico County, NC	2010	NA	5502	4941	561	10.2
CN3713900000000	37	139	Pasquotank County, NC	2010	NA	18498	16657	1841	10
CN3714100000000	37	141	Pender County, NC	2010	NA	24446	21650	2796	11.4
CN3714300000000	37	143	Perquimans County, NC	2010	NA	5334	4766	568	10.6
CN3714500000000	37	145	Person County, NC	2010	NA	18704	16386	2318	12.4
CN3714700000000	37	147	Pitt County, NC	2010	NA	85917	77174	8743	10.2
CN3714900000000	37	149	Polk County, NC	2010	NA	8561	7692	869	10.2
CN3715100000000	37	151	Randolph County, NC	2010	NA	69399	61084	8315	12
CN3715300000000	37	153	Richmond County, NC	2010	NA	18927	16113	2814	14.9
CN3715500000000	37	155	Robeson County, NC	2010	NA	53853	46478	7375	13.7
CN3715700000000	37	157	Rockingham County, NC	2010	NA	44210	38369	5841	13.2
CN3715900000000	37	159	Rowan County, NC	2010	NA	64328	55278	9050	14.1
CN3716100000000	37	161	Rutherford County, NC	2010	NA	26979	22464	4515	16.7
CN3716300000000	37	163	Sampson County, NC	2010	NA	29558	26703	2855	9.7
CN3716500000000	37	165	Scotland County, NC	2010	NA	13098	10789	2309	17.6
CN3716700000000	37	167	Stanly County, NC	2010	NA	29064	25232	3832	13.2
CN3716900000000	37	169	Stokes County, NC	2010	NA	22847	20244	2603	11.4
CN3717100000000	37	171	Surry County, NC	2010	NA	34423	30290	4133	12
CN3717300000000	37	173	Swain County, NC	2010	NA	6269	5345	924	14.7
CN3717500000000	37	175	Transylvania County, NC	2010	NA	13805	12456	1349	9.8
CN3717700000000	37	177	Tyrrell County, NC	2010	NA	1659	1414	245	14.8
CN3717900000000	37	179	Union County, NC	2010	NA	101154	91016	10138	10
CN3718100000000	37	181	Vance County, NC	2010	NA	19018	16332	2686	14.1
CN3718300000000	37	183	Wake County, NC	2010	NA	480565	440710	39855	8.3
CN3718500000000	37	185	Warren County, NC	2010	NA	7550	6514	1036	13.7
CN3718700000000	37	187	Washington County, NC	2010	NA	5692	4880	812	14.3
CN3718900000000	37	189	Watauga County, NC	2010	NA	26883	24773	2110	7.8
CN3719100000000	37	191	Wayne County, NC	2010	NA	54808	49787	5021	9.2
CN3719300000000	37	193	Wilkes County, NC	2010	NA	31081	26905	4176	13.4
CN3719500000000	37	195	Wilson County, NC	2010	NA	38233	32918	5315	13.9
CN3719700000000	37	197	Yadkin County, NC	2010	NA	18198	16203	1995	11
CN3719900000000	37	199	Yancey County, NC	2010	NA	7810	6884	926	11.9
CN3800100000000	38	001	Adams County, ND	2010	NA	1202	1167	35	2.9
CN3800300000000	38	003	Barnes County, ND	2010	NA	6187	5911	276	4.5
CN3800500000000	38	005	Benson County, ND	2010	NA	2915	2757	158	5.4
CN3800700000000	38	007	Billings County, ND	2010	NA	426	412	14	3.3
CN3800900000000	38	009	Bottineau County, ND	2010	NA	3397	3262	135	4
CN3801100000000	38	011	Bowman County, ND	2010	NA	1772	1726	46	2.6
CN3801300000000	38	013	Burke County, ND	2010	NA	1130	1099	31	2.7
CN3801500000000	38	015	Burleigh County, ND	2010	NA	46337	44662	1675	3.6
CN3801700000000	38	017	Cass County, ND	2010	NA	88824	85680	3144	3.5
CN3801900000000	38	019	Cavalier County, ND	2010	NA	2260	2191	69	3.1
CN3802100000000	38	021	Dickey County, ND	2010	NA	2856	2764	92	3.2
CN3802300000000	38	023	Divide County, ND	2010	NA	1383	1354	29	2.1
CN3802500000000	38	025	Dunn County, ND	2010	NA	2301	2227	74	3.2
CN3802700000000	38	027	Eddy County, ND	2010	NA	1297	1235	62	4.8
CN3802900000000	38	029	Emmons County, ND	2010	NA	1826	1700	126	6.9
CN3803100000000	38	031	Foster County, ND	2010	NA	1802	1740	62	3.4
CN3803300000000	38	033	Golden Valley County, ND	2010	NA	982	956	26	2.6
CN3803500000000	38	035	Grand Forks County, ND	2010	NA	37866	36549	1317	3.5
CN3803700000000	38	037	Grant County, ND	2010	NA	1423	1370	53	3.7
CN3803900000000	38	039	Griggs County, ND	2010	NA	1320	1281	39	3
CN3804100000000	38	041	Hettinger County, ND	2010	NA	1479	1434	45	3
CN3804300000000	38	043	Kidder County, ND	2010	NA	1408	1333	75	5.3
CN3804500000000	38	045	LaMoure County, ND	2010	NA	2481	2393	88	3.5
CN3804700000000	38	047	Logan County, ND	2010	NA	1001	965	36	3.6
CN3804900000000	38	049	McHenry County, ND	2010	NA	3283	3125	158	4.8
CN3805100000000	38	051	McIntosh County, ND	2010	NA	1342	1283	59	4.4
CN3805300000000	38	053	McKenzie County, ND	2010	NA	3586	3508	78	2.2
CN3805500000000	38	055	McLean County, ND	2010	NA	5101	4844	257	5
CN3805700000000	38	057	Mercer County, ND	2010	NA	4325	4098	227	5.2
CN3805900000000	38	059	Morton County, ND	2010	NA	15993	15263	730	4.6
CN3806100000000	38	061	Mountrail County, ND	2010	NA	5510	5366	144	2.6
CN3806300000000	38	063	Nelson County, ND	2010	NA	1691	1623	68	4
CN3806500000000	38	065	Oliver County, ND	2010	NA	927	874	53	5.7
CN3806700000000	38	067	Pembina County, ND	2010	NA	4024	3768	256	6.4
CN3806900000000	38	069	Pierce County, ND	2010	NA	1997	1891	106	5.3
CN3807100000000	38	071	Ramsey County, ND	2010	NA	6042	5812	230	3.8
CN3807300000000	38	073	Ransom County, ND	2010	NA	2856	2725	131	4.6
CN3807500000000	38	075	Renville County, ND	2010	NA	1459	1418	41	2.8
CN3807700000000	38	077	Richland County, ND	2010	NA	9060	8712	348	3.8
CN3807900000000	38	079	Rolette County, ND	2010	NA	5291	4715	576	10.9
CN3808100000000	38	081	Sargent County, ND	2010	NA	2045	1957	88	4.3
CN3808300000000	38	083	Sheridan County, ND	2010	NA	811	779	32	3.9
CN3808500000000	38	085	Sioux County, ND	2010	NA	1308	1241	67	5.1
CN3808700000000	38	087	Slope County, ND	2010	NA	470	459	11	2.3
CN3808900000000	38	089	Stark County, ND	2010	NA	14546	14142	404	2.8
CN3809100000000	38	091	Steele County, ND	2010	NA	1100	1070	30	2.7
CN3809300000000	38	093	Stutsman County, ND	2010	NA	11264	10797	467	4.1
CN3809500000000	38	095	Towner County, ND	2010	NA	1396	1358	38	2.7
CN3809700000000	38	097	Traill County, ND	2010	NA	4562	4393	169	3.7
CN3809900000000	38	099	Walsh County, ND	2010	NA	6222	5905	317	5.1
CN3810100000000	38	101	Ward County, ND	2010	NA	31526	30436	1090	3.5
CN3810300000000	38	103	Wells County, ND	2010	NA	2328	2235	93	4
CN3810500000000	38	105	Williams County, ND	2010	NA	14407	14091	316	2.2
CN3900100000000	39	001	Adams County, OH	2010	NA	11881	9986	1895	15.9
CN3900300000000	39	003	Allen County, OH	2010	NA	52009	46442	5567	10.7
CN3900500000000	39	005	Ashland County, OH	2010	NA	26628	23460	3168	11.9
CN3900700000000	39	007	Ashtabula County, OH	2010	NA	48407	42139	6268	12.9
CN3900900000000	39	009	Athens County, OH	2010	NA	28627	25591	3036	10.6
CN3901100000000	39	011	Auglaize County, OH	2010	NA	24560	22099	2461	10
CN3901300000000	39	013	Belmont County, OH	2010	NA	33462	29682	3780	11.3
CN3901500000000	39	015	Brown County, OH	2010	NA	21125	18315	2810	13.3
CN3901700000000	39	017	Butler County, OH	2010	NA	190738	171600	19138	10
CN3901900000000	39	019	Carroll County, OH	2010	NA	14373	12504	1869	13
CN3902100000000	39	021	Champaign County, OH	2010	NA	19979	17673	2306	11.5
CN3902300000000	39	023	Clark County, OH	2010	NA	68266	60736	7530	11
CN3902500000000	39	025	Clermont County, OH	2010	NA	104819	93967	10852	10.4
CN3902700000000	39	027	Clinton County, OH	2010	NA	19250	15973	3277	17
CN3902900000000	39	029	Columbiana County, OH	2010	NA	52880	46218	6662	12.6
CN3903100000000	39	031	Coshocton County, OH	2010	NA	17471	15259	2212	12.7
CN3903300000000	39	033	Crawford County, OH	2010	NA	20960	18266	2694	12.9
CN3903500000000	39	035	Cuyahoga County, OH	2010	NA	631675	577866	53809	8.5
CN3903700000000	39	037	Darke County, OH	2010	NA	27050	24008	3042	11.2
CN3903900000000	39	039	Defiance County, OH	2010	NA	19971	17539	2432	12.2
CN3904100000000	39	041	Delaware County, OH	2010	NA	94233	87407	6826	7.2
CN3904300000000	39	043	Erie County, OH	2010	NA	40163	35632	4531	11.3
CN3904500000000	39	045	Fairfield County, OH	2010	NA	74265	67429	6836	9.2
CN3904700000000	39	047	Fayette County, OH	2010	NA	14903	12951	1952	13.1
CN3904900000000	39	049	Franklin County, OH	2010	NA	626837	571204	55633	8.9
CN3905100000000	39	051	Fulton County, OH	2010	NA	23144	20405	2739	11.8
CN3905300000000	39	053	Gallia County, OH	2010	NA	13585	11981	1604	11.8
CN3905500000000	39	055	Geauga County, OH	2010	NA	48975	45609	3366	6.9
CN3905700000000	39	057	Greene County, OH	2010	NA	82080	74255	7825	9.5
CN3905900000000	39	059	Guernsey County, OH	2010	NA	18856	16452	2404	12.7
CN3906100000000	39	061	Hamilton County, OH	2010	NA	413738	372982	40756	9.9
CN3906300000000	39	063	Hancock County, OH	2010	NA	40457	36778	3679	9.1
CN3906500000000	39	065	Hardin County, OH	2010	NA	15479	13745	1734	11.2
CN3906700000000	39	067	Harrison County, OH	2010	NA	7241	6337	904	12.5
CN3906900000000	39	069	Henry County, OH	2010	NA	14635	12725	1910	13.1
CN3907100000000	39	071	Highland County, OH	2010	NA	19185	15869	3316	17.3
CN3907300000000	39	073	Hocking County, OH	2010	NA	14036	12399	1637	11.7
CN3907500000000	39	075	Holmes County, OH	2010	NA	19295	17819	1476	7.6
CN3907700000000	39	077	Huron County, OH	2010	NA	30287	26289	3998	13.2
CN3907900000000	39	079	Jackson County, OH	2010	NA	14300	12513	1787	12.5
CN3908100000000	39	081	Jefferson County, OH	2010	NA	33335	28517	4818	14.5
CN3908300000000	39	083	Knox County, OH	2010	NA	30913	27924	2989	9.7
CN3908500000000	39	085	Lake County, OH	2010	NA	126272	116301	9971	7.9
CN3908700000000	39	087	Lawrence County, OH	2010	NA	27703	24854	2849	10.3
CN3908900000000	39	089	Licking County, OH	2010	NA	87551	79133	8418	9.6
CN3909100000000	39	091	Logan County, OH	2010	NA	23346	20589	2757	11.8
CN3909300000000	39	093	Lorain County, OH	2010	NA	151082	137293	13789	9.1
CN3909500000000	39	095	Lucas County, OH	2010	NA	217424	192330	25094	11.5
CN3909700000000	39	097	Madison County, OH	2010	NA	20665	18800	1865	9
CN3909900000000	39	099	Mahoning County, OH	2010	NA	115100	101612	13488	11.7
CN3910100000000	39	101	Marion County, OH	2010	NA	30255	26938	3317	11
CN3910300000000	39	103	Medina County, OH	2010	NA	94041	87055	6986	7.4
CN3910500000000	39	105	Meigs County, OH	2010	NA	10050	8580	1470	14.6
CN3910700000000	39	107	Mercer County, OH	2010	NA	22324	20435	1889	8.5
CN3910900000000	39	109	Miami County, OH	2010	NA	54400	48365	6035	11.1
CN3911100000000	39	111	Monroe County, OH	2010	NA	6675	5858	817	12.2
CN3911300000000	39	113	Montgomery County, OH	2010	NA	265355	235205	30150	11.4
CN3911500000000	39	115	Morgan County, OH	2010	NA	6865	5949	916	13.3
CN3911700000000	39	117	Morrow County, OH	2010	NA	17309	15334	1975	11.4
CN3911900000000	39	119	Muskingum County, OH	2010	NA	41656	36417	5239	12.6
CN3912100000000	39	121	Noble County, OH	2010	NA	5223	4387	836	16
CN3912300000000	39	123	Ottawa County, OH	2010	NA	22678	19881	2797	12.3
CN3912500000000	39	125	Paulding County, OH	2010	NA	9696	8477	1219	12.6
CN3912700000000	39	127	Perry County, OH	2010	NA	16646	14414	2232	13.4
CN3912900000000	39	129	Pickaway County, OH	2010	NA	26100	23338	2762	10.6
CN3913100000000	39	131	Pike County, OH	2010	NA	11586	9868	1718	14.8
CN3913300000000	39	133	Portage County, OH	2010	NA	90710	81357	9353	10.3
CN3913500000000	39	135	Preble County, OH	2010	NA	22383	19917	2466	11
CN3913700000000	39	137	Putnam County, OH	2010	NA	19332	17531	1801	9.3
CN3913900000000	39	139	Richland County, OH	2010	NA	59079	51908	7171	12.1
CN3914100000000	39	141	Ross County, OH	2010	NA	34084	30016	4068	11.9
CN3914300000000	39	143	Sandusky County, OH	2010	NA	33204	29627	3577	10.8
CN3914500000000	39	145	Scioto County, OH	2010	NA	32608	28260	4348	13.3
CN3914700000000	39	147	Seneca County, OH	2010	NA	29460	25942	3518	11.9
CN3914900000000	39	149	Shelby County, OH	2010	NA	24971	21866	3105	12.4
CN3915100000000	39	151	Stark County, OH	2010	NA	191869	170218	21651	11.3
CN3915300000000	39	153	Summit County, OH	2010	NA	281497	251683	29814	10.6
CN3915500000000	39	155	Trumbull County, OH	2010	NA	99834	86624	13210	13.2
CN3915700000000	39	157	Tuscarawas County, OH	2010	NA	46070	40889	5181	11.2
CN3915900000000	39	159	Union County, OH	2010	NA	26657	24421	2236	8.4
CN3916100000000	39	161	Van Wert County, OH	2010	NA	14954	13147	1807	12.1
CN3916300000000	39	163	Vinton County, OH	2010	NA	5797	5015	782	13.5
CN3916500000000	39	165	Warren County, OH	2010	NA	110115	100188	9927	9
CN3916700000000	39	167	Washington County, OH	2010	NA	29799	26397	3402	11.4
CN3916900000000	39	169	Wayne County, OH	2010	NA	60131	54546	5585	9.3
CN3917100000000	39	171	Williams County, OH	2010	NA	19538	16967	2571	13.2
CN3917300000000	39	173	Wood County, OH	2010	NA	68548	61753	6795	9.9
CN3917500000000	39	175	Wyandot County, OH	2010	NA	12178	10824	1354	11.1
CN4000100000000	40	001	Adair County, OK	2010	NA	8906	7969	937	10.5
CN4000300000000	40	003	Alfalfa County, OK	2010	NA	2497	2375	122	4.9
CN4000500000000	40	005	Atoka County, OK	2010	NA	5113	4601	512	10
CN4000700000000	40	007	Beaver County, OK	2010	NA	2889	2774	115	4
CN4000900000000	40	009	Beckham County, OK	2010	NA	10339	9743	596	5.8
CN4001100000000	40	011	Blaine County, OK	2010	NA	4473	4186	287	6.4
CN4001300000000	40	013	Bryan County, OK	2010	NA	18504	17362	1142	6.2
CN4001500000000	40	015	Caddo County, OK	2010	NA	11833	11011	822	6.9
CN4001700000000	40	017	Canadian County, OK	2010	NA	60083	56985	3098	5.2
CN4001900000000	40	019	Carter County, OK	2010	NA	21187	19683	1504	7.1
CN4002100000000	40	021	Cherokee County, OK	2010	NA	19464	17975	1489	7.7
CN4002300000000	40	023	Choctaw County, OK	2010	NA	6123	5566	557	9.1
CN4002500000000	40	025	Cimarron County, OK	2010	NA	1457	1406	51	3.5
CN4002700000000	40	027	Cleveland County, OK	2010	NA	131125	124196	6929	5.3
CN4002900000000	40	029	Coal County, OK	2010	NA	2294	2085	209	9.1
CN4003100000000	40	031	Comanche County, OK	2010	NA	51497	48534	2963	5.8
CN4003300000000	40	033	Cotton County, OK	2010	NA	3009	2808	201	6.7
CN4003500000000	40	035	Craig County, OK	2010	NA	6591	6150	441	6.7
CN4003700000000	40	037	Creek County, OK	2010	NA	31807	29076	2731	8.6
CN4003900000000	40	039	Custer County, OK	2010	NA	14155	13426	729	5.2
CN4004100000000	40	041	Delaware County, OK	2010	NA	17181	15810	1371	8
CN4004300000000	40	043	Dewey County, OK	2010	NA	2310	2189	121	5.2
CN4004500000000	40	045	Ellis County, OK	2010	NA	2061	1951	110	5.3
CN4004700000000	40	047	Garfield County, OK	2010	NA	28519	26947	1572	5.5
CN4004900000000	40	049	Garvin County, OK	2010	NA	12162	11248	914	7.5
CN4005100000000	40	051	Grady County, OK	2010	NA	25401	23741	1660	6.5
CN4005300000000	40	053	Grant County, OK	2010	NA	2573	2458	115	4.5
CN4005500000000	40	055	Greer County, OK	2010	NA	2191	2023	168	7.7
CN4005700000000	40	057	Harmon County, OK	2010	NA	1314	1237	77	5.9
CN4005900000000	40	059	Harper County, OK	2010	NA	1866	1782	84	4.5
CN4006100000000	40	061	Haskell County, OK	2010	NA	4789	4321	468	9.8
CN4006300000000	40	063	Hughes County, OK	2010	NA	5572	4964	608	10.9
CN4006500000000	40	065	Jackson County, OK	2010	NA	11466	10787	679	5.9
CN4006700000000	40	067	Jefferson County, OK	2010	NA	2681	2479	202	7.5
CN4006900000000	40	069	Johnston County, OK	2010	NA	3747	3359	388	10.4
CN4007100000000	40	071	Kay County, OK	2010	NA	20938	19007	1931	9.2
CN4007300000000	40	073	Kingfisher County, OK	2010	NA	7380	7006	374	5.1
CN4007500000000	40	075	Kiowa County, OK	2010	NA	4316	4056	260	6
CN4007700000000	40	077	Latimer County, OK	2010	NA	4574	4115	459	10
CN4007900000000	40	079	Le Flore County, OK	2010	NA	20766	18804	1962	9.4
CN4008100000000	40	081	Lincoln County, OK	2010	NA	15657	14635	1022	6.5
CN4008300000000	40	083	Logan County, OK	2010	NA	19805	18684	1121	5.7
CN4008500000000	40	085	Love County, OK	2010	NA	4772	4500	272	5.7
CN4008700000000	40	087	McClain County, OK	2010	NA	17180	16223	957	5.6
CN4008900000000	40	089	McCurtain County, OK	2010	NA	14544	12882	1662	11.4
CN4009100000000	40	091	McIntosh County, OK	2010	NA	7403	6592	811	11
CN4009300000000	40	093	Major County, OK	2010	NA	3941	3743	198	5
CN4009500000000	40	095	Marshall County, OK	2010	NA	6512	6043	469	7.2
CN4009700000000	40	097	Mayes County, OK	2010	NA	18110	16516	1594	8.8
CN4009900000000	40	099	Murray County, OK	2010	NA	6319	5929	390	6.2
CN4010100000000	40	101	Muskogee County, OK	2010	NA	29871	27410	2461	8.2
CN4010300000000	40	103	Noble County, OK	2010	NA	5249	4894	355	6.8
CN4010500000000	40	105	Nowata County, OK	2010	NA	4905	4449	456	9.3
CN4010700000000	40	107	Okfuskee County, OK	2010	NA	4354	3928	426	9.8
CN4010900000000	40	109	Oklahoma County, OK	2010	NA	354254	332486	21768	6.1
CN4011100000000	40	111	Okmulgee County, OK	2010	NA	16887	15235	1652	9.8
CN4011300000000	40	113	Osage County, OK	2010	NA	21250	19601	1649	7.8
CN4011500000000	40	115	Ottawa County, OK	2010	NA	14559	13386	1173	8.1
CN4011700000000	40	117	Pawnee County, OK	2010	NA	7675	6975	700	9.1
CN4011900000000	40	119	Payne County, OK	2010	NA	36872	34758	2114	5.7
CN4012100000000	40	121	Pittsburg County, OK	2010	NA	18930	17385	1545	8.2
CN4012300000000	40	123	Pontotoc County, OK	2010	NA	17733	16637	1096	6.2
CN4012500000000	40	125	Pottawatomie County, OK	2010	NA	30998	28845	2153	6.9
CN4012700000000	40	127	Pushmataha County, OK	2010	NA	4984	4495	489	9.8
CN4012900000000	40	129	Roger Mills County, OK	2010	NA	1797	1715	82	4.6
CN4013100000000	40	131	Rogers County, OK	2010	NA	43377	40402	2975	6.9
CN4013300000000	40	133	Seminole County, OK	2010	NA	9927	8974	953	9.6
CN4013500000000	40	135	Sequoyah County, OK	2010	NA	18100	16363	1737	9.6
CN4013700000000	40	137	Stephens County, OK	2010	NA	19981	18420	1561	7.8
CN4013900000000	40	139	Texas County, OK	2010	NA	8600	8181	419	4.9
CN4014100000000	40	141	Tillman County, OK	2010	NA	3407	3195	212	6.2
CN4014300000000	40	143	Tulsa County, OK	2010	NA	306671	285120	21551	7
CN4014500000000	40	145	Wagoner County, OK	2010	NA	35268	32877	2391	6.8
CN4014700000000	40	147	Washington County, OK	2010	NA	24142	22522	1620	6.7
CN4014900000000	40	149	Washita County, OK	2010	NA	5459	5127	332	6.1
CN4015100000000	40	151	Woods County, OK	2010	NA	4289	4107	182	4.2
CN4015300000000	40	153	Woodward County, OK	2010	NA	9355	8710	645	6.9
CN4100100000000	41	001	Baker County, OR	2010	NA	7361	6606	755	10.3
CN4100300000000	41	003	Benton County, OR	2010	NA	45075	41873	3202	7.1
CN4100500000000	41	005	Clackamas County, OR	2010	NA	202654	182280	20374	10.1
CN4100700000000	41	007	Clatsop County, OR	2010	NA	19078	17174	1904	10
CN4100900000000	41	009	Columbia County, OR	2010	NA	23649	20599	3050	12.9
CN4101100000000	41	011	Coos County, OR	2010	NA	27740	24215	3525	12.7
CN4101300000000	41	013	Crook County, OR	2010	NA	9582	8055	1527	15.9
CN4101500000000	41	015	Curry County, OR	2010	NA	9395	8209	1186	12.6
CN4101700000000	41	017	Deschutes County, OR	2010	NA	81238	69995	11243	13.8
CN4101900000000	41	019	Douglas County, OR	2010	NA	47878	41184	6694	14
CN4102100000000	41	021	Gilliam County, OR	2010	NA	959	873	86	9
CN4102300000000	41	023	Grant County, OR	2010	NA	3398	2933	465	13.7
CN4102500000000	41	025	Harney County, OR	2010	NA	3836	3290	546	14.2
CN4102700000000	41	027	Hood River County, OR	2010	NA	14196	13023	1173	8.3
CN4102900000000	41	029	Jackson County, OR	2010	NA	100968	88392	12576	12.5
CN4103100000000	41	031	Jefferson County, OR	2010	NA	9629	8314	1315	13.7
CN4103300000000	41	033	Josephine County, OR	2010	NA	34491	29652	4839	14
CN4103500000000	41	035	Klamath County, OR	2010	NA	31221	27186	4035	12.9
CN4103700000000	41	037	Lake County, OR	2010	NA	3720	3219	501	13.5
CN4103900000000	41	039	Lane County, OR	2010	NA	178303	158655	19648	11
CN4104100000000	41	041	Lincoln County, OR	2010	NA	22117	19679	2438	11
CN4104300000000	41	043	Linn County, OR	2010	NA	57072	49751	7321	12.8
CN4104500000000	41	045	Malheur County, OR	2010	NA	13474	12172	1302	9.7
CN4104700000000	41	047	Marion County, OR	2010	NA	155350	138026	17324	11.2
CN4104900000000	41	049	Morrow County, OR	2010	NA	5729	5194	535	9.3
CN4105100000000	41	051	Multnomah County, OR	2010	NA	418838	378511	40327	9.6
CN4105300000000	41	053	Polk County, OR	2010	NA	36385	32848	3537	9.7
CN4105500000000	41	055	Sherman County, OR	2010	NA	905	799	106	11.7
CN4105700000000	41	057	Tillamook County, OR	2010	NA	11768	10538	1230	10.5
CN4105900000000	41	059	Umatilla County, OR	2010	NA	36689	32916	3773	10.3
CN4106100000000	41	061	Union County, OR	2010	NA	12486	11196	1290	10.3
CN4106300000000	41	063	Wallowa County, OR	2010	NA	3505	3053	452	12.9
CN4106500000000	41	065	Wasco County, OR	2010	NA	13682	12375	1307	9.6
CN4106700000000	41	067	Washington County, OR	2010	NA	289670	263707	25963	9
CN4106900000000	41	069	Wheeler County, OR	2010	NA	777	703	74	9.5
CN4107100000000	41	071	Yamhill County, OR	2010	NA	51226	45885	5341	10.4
CN4200100000000	42	001	Adams County, PA	2010	NA	54590	50375	4215	7.7
CN4200300000000	42	003	Allegheny County, PA	2010	NA	636093	587891	48202	7.6
CN4200500000000	42	005	Armstrong County, PA	2010	NA	33637	30578	3059	9.1
CN4200700000000	42	007	Beaver County, PA	2010	NA	85611	78263	7348	8.6
CN4200900000000	42	009	Bedford County, PA	2010	NA	25366	22810	2556	10.1
CN4201100000000	42	011	Berks County, PA	2010	NA	210149	191919	18230	8.7
CN4201300000000	42	013	Blair County, PA	2010	NA	61780	56832	4948	8
CN4201500000000	42	015	Bradford County, PA	2010	NA	30820	28591	2229	7.2
CN4201700000000	42	017	Bucks County, PA	2010	NA	337150	311423	25727	7.6
CN4201900000000	42	019	Butler County, PA	2010	NA	95781	88725	7056	7.4
CN4202100000000	42	021	Cambria County, PA	2010	NA	66751	60461	6290	9.4
CN4202300000000	42	023	Cameron County, PA	2010	NA	2555	2233	322	12.6
CN4202500000000	42	025	Carbon County, PA	2010	NA	31786	28421	3365	10.6
CN4202700000000	42	027	Centre County, PA	2010	NA	77338	72739	4599	5.9
CN4202900000000	42	029	Chester County, PA	2010	NA	269540	252699	16841	6.2
CN4203100000000	42	031	Clarion County, PA	2010	NA	19574	17571	2003	10.2
CN4203300000000	42	033	Clearfield County, PA	2010	NA	38077	34102	3975	10.4
CN4203500000000	42	035	Clinton County, PA	2010	NA	18749	16987	1762	9.4
CN4203700000000	42	037	Columbia County, PA	2010	NA	34737	31497	3240	9.3
CN4203900000000	42	039	Crawford County, PA	2010	NA	41697	37749	3948	9.5
CN4204100000000	42	041	Cumberland County, PA	2010	NA	124448	115940	8508	6.8
CN4204300000000	42	043	Dauphin County, PA	2010	NA	140566	129291	11275	8
CN4204500000000	42	045	Delaware County, PA	2010	NA	286187	263287	22900	8
CN4204700000000	42	047	Elk County, PA	2010	NA	16686	15075	1611	9.7
CN4204900000000	42	049	Erie County, PA	2010	NA	136361	123674	12687	9.3
CN4205100000000	42	051	Fayette County, PA	2010	NA	59533	53134	6399	10.7
CN4205300000000	42	053	Forest County, PA	2010	NA	2155	1911	244	11.3
CN4205500000000	42	055	Franklin County, PA	2010	NA	75712	69257	6455	8.5
CN4205700000000	42	057	Fulton County, PA	2010	NA	7434	6522	912	12.3
CN4205900000000	42	059	Greene County, PA	2010	NA	17411	15954	1457	8.4
CN4206100000000	42	061	Huntingdon County, PA	2010	NA	21117	18852	2265	10.7
CN4206300000000	42	063	Indiana County, PA	2010	NA	44079	40251	3828	8.7
CN4206500000000	42	065	Jefferson County, PA	2010	NA	21607	19430	2177	10.1
CN4206700000000	42	067	Juniata County, PA	2010	NA	12087	11126	961	8
CN4206900000000	42	069	Lackawanna County, PA	2010	NA	106992	97407	9585	9
CN4207100000000	42	071	Lancaster County, PA	2010	NA	268014	247925	20089	7.5
CN4207300000000	42	073	Lawrence County, PA	2010	NA	43136	39154	3982	9.2
CN4207500000000	42	075	Lebanon County, PA	2010	NA	70062	64826	5236	7.5
CN4207700000000	42	077	Lehigh County, PA	2010	NA	177159	160875	16284	9.2
CN4207900000000	42	079	Luzerne County, PA	2010	NA	159767	143867	15900	10
CN4208100000000	42	081	Lycoming County, PA	2010	NA	59485	54172	5313	8.9
CN4208300000000	42	083	McKean County, PA	2010	NA	20048	18031	2017	10.1
CN4208500000000	42	085	Mercer County, PA	2010	NA	53629	48518	5111	9.5
CN4208700000000	42	087	Mifflin County, PA	2010	NA	21266	19087	2179	10.2
CN4208900000000	42	089	Monroe County, PA	2010	NA	82713	74664	8049	9.7
CN4209100000000	42	091	Montgomery County, PA	2010	NA	430386	400493	29893	6.9
CN4209300000000	42	093	Montour County, PA	2010	NA	9079	8469	610	6.7
CN4209500000000	42	095	Northampton County, PA	2010	NA	151846	138521	13325	8.8
CN4209700000000	42	097	Northumberland County, PA	2010	NA	45372	40860	4512	9.9
CN4209900000000	42	099	Perry County, PA	2010	NA	24988	22965	2023	8.1
CN4210100000000	42	101	Philadelphia County/city, PA	2010	NA	687809	615073	72736	10.6
CN4210300000000	42	103	Pike County, PA	2010	NA	26078	23539	2539	9.7
CN4210500000000	42	105	Potter County, PA	2010	NA	7802	6991	811	10.4
CN4210700000000	42	107	Schuylkill County, PA	2010	NA	70689	63197	7492	10.6
CN4210900000000	42	109	Snyder County, PA	2010	NA	20112	18424	1688	8.4
CN4211100000000	42	111	Somerset County, PA	2010	NA	37152	33594	3558	9.6
CN4211300000000	42	113	Sullivan County, PA	2010	NA	2960	2723	237	8
CN4211500000000	42	115	Susquehanna County, PA	2010	NA	21624	19738	1886	8.7
CN4211700000000	42	117	Tioga County, PA	2010	NA	20194	18516	1678	8.3
CN4211900000000	42	119	Union County, PA	2010	NA	19192	17711	1481	7.7
CN4212100000000	42	121	Venango County, PA	2010	NA	26428	24182	2246	8.5
CN4212300000000	42	123	Warren County, PA	2010	NA	20899	19171	1728	8.3
CN4212500000000	42	125	Washington County, PA	2010	NA	105280	96765	8515	8.1
CN4212700000000	42	127	Wayne County, PA	2010	NA	23615	21698	1917	8.1
CN4212900000000	42	129	Westmoreland County, PA	2010	NA	185276	170025	15251	8.2
CN4213100000000	42	131	Wyoming County, PA	2010	NA	14335	13078	1257	8.8
CN4213300000000	42	133	York County, PA	2010	NA	230402	211058	19344	8.4
CN4400100000000	44	001	Bristol County, RI	2010	NA	26956	24338	2618	9.7
CN4400300000000	44	003	Kent County, RI	2010	NA	94262	83795	10467	11.1
CN4400500000000	44	005	Newport County, RI	2010	NA	45055	40564	4491	10
CN4400700000000	44	007	Providence County, RI	2010	NA	328917	290205	38712	11.8
CN4400900000000	44	009	Washington County, RI	2010	NA	71513	64313	7200	10.1
CN4500100000000	45	001	Abbeville County, SC	2010	NA	10925	9439	1486	13.6
CN4500300000000	45	003	Aiken County, SC	2010	NA	72368	65639	6729	9.3
CN4500500000000	45	005	Allendale County, SC	2010	NA	3318	2685	633	19.1
CN4500700000000	45	007	Anderson County, SC	2010	NA	85234	75380	9854	11.6
CN4500900000000	45	009	Bamberg County, SC	2010	NA	6509	5460	1049	16.1
CN4501100000000	45	011	Barnwell County, SC	2010	NA	9489	7913	1576	16.6
CN4501300000000	45	013	Beaufort County, SC	2010	NA	65336	59684	5652	8.7
CN4501500000000	45	015	Berkeley County, SC	2010	NA	82740	74452	8288	10
CN4501700000000	45	017	Calhoun County, SC	2010	NA	7044	6178	866	12.3
CN4501900000000	45	019	Charleston County, SC	2010	NA	178847	163111	15736	8.8
CN4502100000000	45	021	Cherokee County, SC	2010	NA	23683	19956	3727	15.7
CN4502300000000	45	023	Chester County, SC	2010	NA	14689	11860	2829	19.3
CN4502500000000	45	025	Chesterfield County, SC	2010	NA	21289	18229	3060	14.4
CN4502700000000	45	027	Clarendon County, SC	2010	NA	13881	11937	1944	14
CN4502900000000	45	029	Colleton County, SC	2010	NA	16827	14513	2314	13.8
CN4503100000000	45	031	Darlington County, SC	2010	NA	30590	26555	4035	13.2
CN4503300000000	45	033	Dillon County, SC	2010	NA	14014	11783	2231	15.9
CN4503500000000	45	035	Dorchester County, SC	2010	NA	65563	59321	6242	9.5
CN4503700000000	45	037	Edgefield County, SC	2010	NA	10986	9893	1093	9.9
CN4503900000000	45	039	Fairfield County, SC	2010	NA	10672	9113	1559	14.6
CN4504100000000	45	041	Florence County, SC	2010	NA	64173	56905	7268	11.3
CN4504300000000	45	043	Georgetown County, SC	2010	NA	26045	22271	3774	14.5
CN4504500000000	45	045	Greenville County, SC	2010	NA	220209	199005	21204	9.6
CN4504700000000	45	047	Greenwood County, SC	2010	NA	31869	28091	3778	11.9
CN4504900000000	45	049	Hampton County, SC	2010	NA	8785	7659	1126	12.8
CN4505100000000	45	051	Horry County, SC	2010	NA	130946	114859	16087	12.3
CN4505300000000	45	053	Jasper County, SC	2010	NA	10896	9823	1073	9.8
CN4505500000000	45	055	Kershaw County, SC	2010	NA	28136	24898	3238	11.5
CN4505700000000	45	057	Lancaster County, SC	2010	NA	33952	28955	4997	14.7
CN4505900000000	45	059	Laurens County, SC	2010	NA	30190	26481	3709	12.3
CN4506100000000	45	061	Lee County, SC	2010	NA	6953	5826	1127	16.2
CN4506300000000	45	063	Lexington County, SC	2010	NA	132937	122033	10904	8.2
CN4506500000000	45	065	McCormick County, SC	2010	NA	3624	3115	509	14
CN4506700000000	45	067	Marion County, SC	2010	NA	14407	11774	2633	18.3
CN4506900000000	45	069	Marlboro County, SC	2010	NA	10871	8567	2304	21.2
CN4507100000000	45	071	Newberry County, SC	2010	NA	18575	16571	2004	10.8
CN4507300000000	45	073	Oconee County, SC	2010	NA	33314	29522	3792	11.4
CN4507500000000	45	075	Orangeburg County, SC	2010	NA	40102	33722	6380	15.9
CN4507700000000	45	077	Pickens County, SC	2010	NA	54434	48509	5925	10.9
CN4507900000000	45	079	Richland County, SC	2010	NA	184934	167558	17376	9.4
CN4508100000000	45	081	Saluda County, SC	2010	NA	8684	7813	871	10
CN4508300000000	45	083	Spartanburg County, SC	2010	NA	131818	116205	15613	11.8
CN4508500000000	45	085	Sumter County, SC	2010	NA	44419	38887	5532	12.5
CN4508700000000	45	087	Union County, SC	2010	NA	12392	10202	2190	17.7
CN4508900000000	45	089	Williamsburg County, SC	2010	NA	13351	11048	2303	17.2
CN4509100000000	45	091	York County, SC	2010	NA	115647	101643	14004	12.1
CN4600300000000	46	003	Aurora County, SD	2010	NA	1677	1618	59	3.5
CN4600500000000	46	005	Beadle County, SD	2010	NA	9427	9033	394	4.2
CN4600700000000	46	007	Bennett County, SD	2010	NA	1195	1109	86	7.2
CN4600900000000	46	009	Bon Homme County, SD	2010	NA	3189	3055	134	4.2
CN4601100000000	46	011	Brookings County, SD	2010	NA	17847	17013	834	4.7
CN4601300000000	46	013	Brown County, SD	2010	NA	20882	20078	804	3.9
CN4601500000000	46	015	Brule County, SD	2010	NA	2733	2632	101	3.7
CN4601700000000	46	017	Buffalo County, SD	2010	NA	693	615	78	11.3
CN4601900000000	46	019	Butte County, SD	2010	NA	5110	4851	259	5.1
CN4602100000000	46	021	Campbell County, SD	2010	NA	907	868	39	4.3
CN4602300000000	46	023	Charles Mix County, SD	2010	NA	4144	3941	203	4.9
CN4602500000000	46	025	Clark County, SD	2010	NA	1976	1874	102	5.2
CN4602700000000	46	027	Clay County, SD	2010	NA	7387	7075	312	4.2
CN4602900000000	46	029	Codington County, SD	2010	NA	15053	14272	781	5.2
CN4603100000000	46	031	Corson County, SD	2010	NA	1542	1435	107	6.9
CN4603300000000	46	033	Custer County, SD	2010	NA	4070	3832	238	5.8
CN4603500000000	46	035	Davison County, SD	2010	NA	10922	10438	484	4.4
CN4603700000000	46	037	Day County, SD	2010	NA	3073	2868	205	6.7
CN4603900000000	46	039	Deuel County, SD	2010	NA	2478	2311	167	6.7
CN4604100000000	46	041	Dewey County, SD	2010	NA	2356	2006	350	14.9
CN4604300000000	46	043	Douglas County, SD	2010	NA	1761	1683	78	4.4
CN4604500000000	46	045	Edmunds County, SD	2010	NA	2383	2309	74	3.1
CN4604700000000	46	047	Fall River County, SD	2010	NA	3262	3059	203	6.2
CN4604900000000	46	049	Faulk County, SD	2010	NA	1174	1128	46	3.9
CN4605100000000	46	051	Grant County, SD	2010	NA	4796	4573	223	4.6
CN4605300000000	46	053	Gregory County, SD	2010	NA	2181	2086	95	4.4
CN4605500000000	46	055	Haakon County, SD	2010	NA	1123	1085	38	3.4
CN4605700000000	46	057	Hamlin County, SD	2010	NA	3133	2976	157	5
CN4605900000000	46	059	Hand County, SD	2010	NA	1903	1841	62	3.3
CN4606100000000	46	061	Hanson County, SD	2010	NA	1768	1675	93	5.3
CN4606300000000	46	063	Harding County, SD	2010	NA	796	768	28	3.5
CN4606500000000	46	065	Hughes County, SD	2010	NA	10050	9701	349	3.5
CN4606700000000	46	067	Hutchinson County, SD	2010	NA	3804	3652	152	4
CN4606900000000	46	069	Hyde County, SD	2010	NA	795	765	30	3.8
CN4607100000000	46	071	Jackson County, SD	2010	NA	1393	1298	95	6.8
CN4607300000000	46	073	Jerauld County, SD	2010	NA	1198	1154	44	3.7
CN4607500000000	46	075	Jones County, SD	2010	NA	677	657	20	3
CN4607700000000	46	077	Kingsbury County, SD	2010	NA	2868	2713	155	5.4
CN4607900000000	46	079	Lake County, SD	2010	NA	6158	5810	348	5.7
CN4608100000000	46	081	Lawrence County, SD	2010	NA	13155	12534	621	4.7
CN4608300000000	46	083	Lincoln County, SD	2010	NA	26317	25287	1030	3.9
CN4608500000000	46	085	Lyman County, SD	2010	NA	1947	1821	126	6.5
CN4608700000000	46	087	McCook County, SD	2010	NA	3241	3081	160	4.9
CN4608900000000	46	089	McPherson County, SD	2010	NA	1207	1148	59	4.9
CN4609100000000	46	091	Marshall County, SD	2010	NA	2467	2334	133	5.4
CN4609300000000	46	093	Meade County, SD	2010	NA	13148	12457	691	5.3
CN4609500000000	46	095	Mellette County, SD	2010	NA	872	817	55	6.3
CN4609700000000	46	097	Miner County, SD	2010	NA	1371	1302	69	5
CN4609900000000	46	099	Minnehaha County, SD	2010	NA	99177	94240	4937	5
CN4610100000000	46	101	Moody County, SD	2010	NA	4154	3863	291	7
CN4610200000000	46	102	Oglala Lakota County, SD	2010	NA	3715	3234	481	12.9
CN4610300000000	46	103	Pennington County, SD	2010	NA	52839	50081	2758	5.2
CN4610500000000	46	105	Perkins County, SD	2010	NA	1612	1545	67	4.2
CN4610700000000	46	107	Potter County, SD	2010	NA	1276	1214	62	4.9
CN4610900000000	46	109	Roberts County, SD	2010	NA	5050	4757	293	5.8
CN4611100000000	46	111	Sanborn County, SD	2010	NA	1345	1289	56	4.2
CN4611500000000	46	115	Spink County, SD	2010	NA	3591	3456	135	3.8
CN4611700000000	46	117	Stanley County, SD	2010	NA	1955	1881	74	3.8
CN4611900000000	46	119	Sully County, SD	2010	NA	886	854	32	3.6
CN4612100000000	46	121	Todd County, SD	2010	NA	3385	3126	259	7.7
CN4612300000000	46	123	Tripp County, SD	2010	NA	3284	3165	119	3.6
CN4612500000000	46	125	Turner County, SD	2010	NA	4850	4629	221	4.6
CN4612700000000	46	127	Union County, SD	2010	NA	7743	7295	448	5.8
CN4612900000000	46	129	Walworth County, SD	2010	NA	2393	2229	164	6.9
CN4613500000000	46	135	Yankton County, SD	2010	NA	11427	10868	559	4.9
CN4613700000000	46	137	Ziebach County, SD	2010	NA	1054	993	61	5.8
CN4700100000000	47	001	Anderson County, TN	2010	NA	34926	31675	3251	9.3
CN4700300000000	47	003	Bedford County, TN	2010	NA	21082	18436	2646	12.6
CN4700500000000	47	005	Benton County, TN	2010	NA	7200	6314	886	12.3
CN4700700000000	47	007	Bledsoe County, TN	2010	NA	4470	3879	591	13.2
CN4700900000000	47	009	Blount County, TN	2010	NA	61408	55826	5582	9.1
CN4701100000000	47	011	Bradley County, TN	2010	NA	46448	42086	4362	9.4
CN4701300000000	47	013	Campbell County, TN	2010	NA	16131	14115	2016	12.5
CN4701500000000	47	015	Cannon County, TN	2010	NA	6082	5405	677	11.1
CN4701700000000	47	017	Carroll County, TN	2010	NA	13837	11813	2024	14.6
CN4701900000000	47	019	Carter County, TN	2010	NA	26226	23359	2867	10.9
CN4702100000000	47	021	Cheatham County, TN	2010	NA	20210	18400	1810	9
CN4702300000000	47	023	Chester County, TN	2010	NA	8363	7529	834	10
CN4702500000000	47	025	Claiborne County, TN	2010	NA	13619	12149	1470	10.8
CN4702700000000	47	027	Clay County, TN	2010	NA	3312	2912	400	12.1
CN4702900000000	47	029	Cocke County, TN	2010	NA	15881	13717	2164	13.6
CN4703100000000	47	031	Coffee County, TN	2010	NA	24263	21647	2616	10.8
CN4703300000000	47	033	Crockett County, TN	2010	NA	7278	6434	844	11.6
CN4703500000000	47	035	Cumberland County, TN	2010	NA	23083	20605	2478	10.7
CN4703700000000	47	037	Davidson County, TN	2010	NA	342404	314469	27935	8.2
CN4703900000000	47	039	Decatur County, TN	2010	NA	5299	4603	696	13.1
CN4704100000000	47	041	DeKalb County, TN	2010	NA	8159	7206	953	11.7
CN4704300000000	47	043	Dickson County, TN	2010	NA	23958	21512	2446	10.2
CN4704500000000	47	045	Dyer County, TN	2010	NA	17828	15676	2152	12.1
CN4704700000000	47	047	Fayette County, TN	2010	NA	18830	16959	1871	9.9
CN4704900000000	47	049	Fentress County, TN	2010	NA	7407	6489	918	12.4
CN4705100000000	47	051	Franklin County, TN	2010	NA	19306	17357	1949	10.1
CN4705300000000	47	053	Gibson County, TN	2010	NA	23743	20890	2853	12
CN4705500000000	47	055	Giles County, TN	2010	NA	14243	12525	1718	12.1
CN4705700000000	47	057	Grainger County, TN	2010	NA	10040	8760	1280	12.7
CN4705900000000	47	059	Greene County, TN	2010	NA	30986	27011	3975	12.8
CN4706100000000	47	061	Grundy County, TN	2010	NA	5635	4923	712	12.6
CN4706300000000	47	063	Hamblen County, TN	2010	NA	28403	25120	3283	11.6
CN4706500000000	47	065	Hamilton County, TN	2010	NA	169043	154963	14080	8.3
CN4706700000000	47	067	Hancock County, TN	2010	NA	2575	2168	407	15.8
CN4706900000000	47	069	Hardeman County, TN	2010	NA	10349	8981	1368	13.2
CN4707100000000	47	071	Hardin County, TN	2010	NA	11429	10053	1376	12
CN4707300000000	47	073	Hawkins County, TN	2010	NA	25559	22782	2777	10.9
CN4707500000000	47	075	Haywood County, TN	2010	NA	8960	7561	1399	15.6
CN4707700000000	47	077	Henderson County, TN	2010	NA	12999	11146	1853	14.3
CN4707900000000	47	079	Henry County, TN	2010	NA	14467	12820	1647	11.4
CN4708100000000	47	081	Hickman County, TN	2010	NA	10980	9757	1223	11.1
CN4708300000000	47	083	Houston County, TN	2010	NA	3535	3112	423	12
CN4708500000000	47	085	Humphreys County, TN	2010	NA	8882	7890	992	11.2
CN4708700000000	47	087	Jackson County, TN	2010	NA	4788	4184	604	12.6
CN4708900000000	47	089	Jefferson County, TN	2010	NA	24414	21612	2802	11.5
CN4709100000000	47	091	Johnson County, TN	2010	NA	7446	6491	955	12.8
CN4709300000000	47	093	Knox County, TN	2010	NA	229800	212757	17043	7.4
CN4709500000000	47	095	Lake County, TN	2010	NA	2175	1934	241	11.1
CN4709700000000	47	097	Lauderdale County, TN	2010	NA	10782	9251	1531	14.2
CN4709900000000	47	099	Lawrence County, TN	2010	NA	19340	16962	2378	12.3
CN4710100000000	47	101	Lewis County, TN	2010	NA	5407	4595	812	15
CN4710300000000	47	103	Lincoln County, TN	2010	NA	15705	14581	1124	7.2
CN4710500000000	47	105	Loudon County, TN	2010	NA	22352	20280	2072	9.3
CN4710700000000	47	107	McMinn County, TN	2010	NA	22839	19978	2861	12.5
CN4710900000000	47	109	McNairy County, TN	2010	NA	10497	9149	1348	12.8
CN4711100000000	47	111	Macon County, TN	2010	NA	10245	9095	1150	11.2
CN4711300000000	47	113	Madison County, TN	2010	NA	48201	43363	4838	10
CN4711500000000	47	115	Marion County, TN	2010	NA	12542	11145	1397	11.1
CN4711700000000	47	117	Marshall County, TN	2010	NA	14400	12382	2018	14
CN4711900000000	47	119	Maury County, TN	2010	NA	41469	36374	5095	12.3
CN4712100000000	47	121	Meigs County, TN	2010	NA	4971	4320	651	13.1
CN4712300000000	47	123	Monroe County, TN	2010	NA	19493	17014	2479	12.7
CN4712500000000	47	125	Montgomery County, TN	2010	NA	75637	69181	6456	8.5
CN4712700000000	47	127	Moore County, TN	2010	NA	3257	3000	257	7.9
CN4712900000000	47	129	Morgan County, TN	2010	NA	8403	7448	955	11.4
CN4713100000000	47	131	Obion County, TN	2010	NA	15546	14050	1496	9.6
CN4713300000000	47	133	Overton County, TN	2010	NA	10246	9151	1095	10.7
CN4713500000000	47	135	Perry County, TN	2010	NA	3164	2738	426	13.5
CN4713700000000	47	137	Pickett County, TN	2010	NA	2407	2139	268	11.1
CN4713900000000	47	139	Polk County, TN	2010	NA	7336	6514	822	11.2
CN4714100000000	47	141	Putnam County, TN	2010	NA	34011	30819	3192	9.4
CN4714300000000	47	143	Rhea County, TN	2010	NA	13562	11892	1670	12.3
CN4714500000000	47	145	Roane County, TN	2010	NA	24323	22089	2234	9.2
CN4714700000000	47	147	Robertson County, TN	2010	NA	33768	30654	3114	9.2
CN4714900000000	47	149	Rutherford County, TN	2010	NA	140219	127797	12422	8.9
CN4715100000000	47	151	Scott County, TN	2010	NA	9253	7680	1573	17
CN4715300000000	47	153	Sequatchie County, TN	2010	NA	6101	5364	737	12.1
CN4715500000000	47	155	Sevier County, TN	2010	NA	49081	43961	5120	10.4
CN4715700000000	47	157	Shelby County, TN	2010	NA	448829	405047	43782	9.8
CN4715900000000	47	159	Smith County, TN	2010	NA	8934	7838	1096	12.3
CN4716100000000	47	161	Stewart County, TN	2010	NA	5669	4966	703	12.4
CN4716300000000	47	163	Sullivan County, TN	2010	NA	73637	66974	6663	9
CN4716500000000	47	165	Sumner County, TN	2010	NA	83250	75868	7382	8.9
CN4716700000000	47	167	Tipton County, TN	2010	NA	29054	25761	3293	11.3
CN4716900000000	47	169	Trousdale County, TN	2010	NA	3742	3336	406	10.8
CN4717100000000	47	171	Unicoi County, TN	2010	NA	7919	6973	946	11.9
CN4717300000000	47	173	Union County, TN	2010	NA	7763	6927	836	10.8
CN4717500000000	47	175	Van Buren County, TN	2010	NA	2342	2033	309	13.2
CN4717700000000	47	177	Warren County, TN	2010	NA	17750	15815	1935	10.9
CN4717900000000	47	179	Washington County, TN	2010	NA	60672	55393	5279	8.7
CN4718100000000	47	181	Wayne County, TN	2010	NA	6935	6144	791	11.4
CN4718300000000	47	183	Weakley County, TN	2010	NA	16934	15072	1862	11
CN4718500000000	47	185	White County, TN	2010	NA	12333	11036	1297	10.5
CN4718700000000	47	187	Williamson County, TN	2010	NA	94495	88285	6210	6.6
CN4718900000000	47	189	Wilson County, TN	2010	NA	58517	53617	4900	8.4
CN4800100000000	48	001	Anderson County, TX	2010	NA	21711	19956	1755	8.1
CN4800300000000	48	003	Andrews County, TX	2010	NA	7120	6681	439	6.2
CN4800500000000	48	005	Angelina County, TX	2010	NA	38067	34825	3242	8.5
CN4800700000000	48	007	Aransas County, TX	2010	NA	9686	8796	890	9.2
CN4800900000000	48	009	Archer County, TX	2010	NA	4601	4295	306	6.7
CN4801100000000	48	011	Armstrong County, TX	2010	NA	1012	962	50	4.9
CN4801300000000	48	013	Atascosa County, TX	2010	NA	19631	18030	1601	8.2
CN4801500000000	48	015	Austin County, TX	2010	NA	13920	12801	1119	8
CN4801700000000	48	017	Bailey County, TX	2010	NA	3258	3001	257	7.9
CN4801900000000	48	019	Bandera County, TX	2010	NA	9176	8460	716	7.8
CN4802100000000	48	021	Bastrop County, TX	2010	NA	35289	32382	2907	8.2
CN4802300000000	48	023	Baylor County, TX	2010	NA	1733	1611	122	7
CN4802500000000	48	025	Bee County, TX	2010	NA	10522	9582	940	8.9
CN4802700000000	48	027	Bell County, TX	2010	NA	131835	121669	10166	7.7
CN4802900000000	48	029	Bexar County, TX	2010	NA	812516	753313	59203	7.3
CN4803100000000	48	031	Blanco County, TX	2010	NA	5419	5096	323	6
CN4803300000000	48	033	Borden County, TX	2010	NA	357	334	23	6.4
CN4803500000000	48	035	Bosque County, TX	2010	NA	8450	7706	744	8.8
CN4803700000000	48	037	Bowie County, TX	2010	NA	42211	38648	3563	8.4
CN4803900000000	48	039	Brazoria County, TX	2010	NA	155227	142043	13184	8.5
CN4804100000000	48	041	Brazos County, TX	2010	NA	100017	93723	6294	6.3
CN4804300000000	48	043	Brewster County, TX	2010	NA	4912	4644	268	5.5
CN4804500000000	48	045	Briscoe County, TX	2010	NA	734	689	45	6.1
CN4804700000000	48	047	Brooks County, TX	2010	NA	2592	2282	310	12
CN4804900000000	48	049	Brown County, TX	2010	NA	16432	15084	1348	8.2
CN4805100000000	48	051	Burleson County, TX	2010	NA	7870	7251	619	7.9
CN4805300000000	48	053	Burnet County, TX	2010	NA	20289	18915	1374	6.8
CN4805500000000	48	055	Caldwell County, TX	2010	NA	16661	15225	1436	8.6
CN4805700000000	48	057	Calhoun County, TX	2010	NA	10182	9285	897	8.8
CN4805900000000	48	059	Callahan County, TX	2010	NA	6002	5566	436	7.3
CN4806100000000	48	061	Cameron County, TX	2010	NA	162316	144171	18145	11.2
CN4806300000000	48	063	Camp County, TX	2010	NA	5697	5181	516	9.1
CN4806500000000	48	065	Carson County, TX	2010	NA	3353	3171	182	5.4
CN4806700000000	48	067	Cass County, TX	2010	NA	13337	11844	1493	11.2
CN4806900000000	48	069	Castro County, TX	2010	NA	4138	3915	223	5.4
CN4807100000000	48	071	Chambers County, TX	2010	NA	16607	14999	1608	9.7
CN4807300000000	48	073	Cherokee County, TX	2010	NA	21893	19961	1932	8.8
CN4807500000000	48	075	Childress County, TX	2010	NA	3157	2979	178	5.6
CN4807700000000	48	077	Clay County, TX	2010	NA	5539	5124	415	7.5
CN4807900000000	48	079	Cochran County, TX	2010	NA	1524	1400	124	8.1
CN4808100000000	48	081	Coke County, TX	2010	NA	1575	1479	96	6.1
CN4808300000000	48	083	Coleman County, TX	2010	NA	3484	3168	316	9.1
CN4808500000000	48	085	Collin County, TX	2010	NA	425252	394597	30655	7.2
CN4808700000000	48	087	Collingsworth County, TX	2010	NA	1341	1266	75	5.6
CN4808900000000	48	089	Colorado County, TX	2010	NA	9596	8816	780	8.1
CN4809100000000	48	091	Comal County, TX	2010	NA	53489	49723	3766	7
CN4809300000000	48	093	Comanche County, TX	2010	NA	6025	5570	455	7.6
CN4809500000000	48	095	Concho County, TX	2010	NA	1566	1476	90	5.7
CN4809700000000	48	097	Cooke County, TX	2010	NA	19539	18119	1420	7.3
CN4809900000000	48	099	Coryell County, TX	2010	NA	25338	23441	1897	7.5
CN4810100000000	48	101	Cottle County, TX	2010	NA	669	622	47	7
CN4810300000000	48	103	Crane County, TX	2010	NA	1819	1681	138	7.6
CN4810500000000	48	105	Crockett County, TX	2010	NA	1721	1575	146	8.5
CN4810700000000	48	107	Crosby County, TX	2010	NA	2951	2716	235	8
CN4810900000000	48	109	Culberson County, TX	2010	NA	1032	959	73	7.1
CN4811100000000	48	111	Dallam County, TX	2010	NA	3880	3673	207	5.3
CN4811300000000	48	113	Dallas County, TX	2010	NA	1194015	1091493	102522	8.6
CN4811500000000	48	115	Dawson County, TX	2010	NA	5136	4741	395	7.7
CN4811700000000	48	117	Deaf Smith County, TX	2010	NA	9504	8957	547	5.8
CN4811900000000	48	119	Delta County, TX	2010	NA	2596	2391	205	7.9
CN4812100000000	48	121	Denton County, TX	2010	NA	369088	342972	26116	7.1
CN4812300000000	48	123	DeWitt County, TX	2010	NA	9076	8371	705	7.8
CN4812500000000	48	125	Dickens County, TX	2010	NA	871	773	98	11.3
CN4812700000000	48	127	Dimmit County, TX	2010	NA	3856	3450	406	10.5
CN4812900000000	48	129	Donley County, TX	2010	NA	1810	1685	125	6.9
CN4813100000000	48	131	Duval County, TX	2010	NA	5038	4453	585	11.6
CN4813300000000	48	133	Eastland County, TX	2010	NA	8113	7412	701	8.6
CN4813500000000	48	135	Ector County, TX	2010	NA	68186	62525	5661	8.3
CN4813700000000	48	137	Edwards County, TX	2010	NA	1037	963	74	7.1
CN4813900000000	48	139	Ellis County, TX	2010	NA	75674	69611	6063	8
CN4814100000000	48	141	El Paso County, TX	2010	NA	340841	309629	31212	9.2
CN4814300000000	48	143	Erath County, TX	2010	NA	20499	19179	1320	6.4
CN4814500000000	48	145	Falls County, TX	2010	NA	7242	6626	616	8.5
CN4814700000000	48	147	Fannin County, TX	2010	NA	15341	14092	1249	8.1
CN4814900000000	48	149	Fayette County, TX	2010	NA	12029	11295	734	6.1
CN4815100000000	48	151	Fisher County, TX	2010	NA	1925	1790	135	7
CN4815300000000	48	153	Floyd County, TX	2010	NA	3372	3105	267	7.9
CN4815500000000	48	155	Foard County, TX	2010	NA	662	618	44	6.6
CN4815700000000	48	157	Fort Bend County, TX	2010	NA	298162	275453	22709	7.6
CN4815900000000	48	159	Franklin County, TX	2010	NA	4811	4397	414	8.6
CN4816100000000	48	161	Freestone County, TX	2010	NA	8149	7478	671	8.2
CN4816300000000	48	163	Frio County, TX	2010	NA	7584	7031	553	7.3
CN4816500000000	48	165	Gaines County, TX	2010	NA	7935	7464	471	5.9
CN4816700000000	48	167	Galveston County, TX	2010	NA	147321	133867	13454	9.1
CN4816900000000	48	169	Garza County, TX	2010	NA	2143	2017	126	5.9
CN4817100000000	48	171	Gillespie County, TX	2010	NA	12199	11533	666	5.5
CN4817300000000	48	173	Glasscock County, TX	2010	NA	704	670	34	4.8
CN4817500000000	48	175	Goliad County, TX	2010	NA	3356	3108	248	7.4
CN4817700000000	48	177	Gonzales County, TX	2010	NA	9304	8670	634	6.8
CN4817900000000	48	179	Gray County, TX	2010	NA	9282	8485	797	8.6
CN4818100000000	48	181	Grayson County, TX	2010	NA	59489	54620	4869	8.2
CN4818300000000	48	183	Gregg County, TX	2010	NA	60363	55568	4795	7.9
CN4818500000000	48	185	Grimes County, TX	2010	NA	11320	10312	1008	8.9
CN4818700000000	48	187	Guadalupe County, TX	2010	NA	64924	60560	4364	6.7
CN4818900000000	48	189	Hale County, TX	2010	NA	16180	14982	1198	7.4
CN4819100000000	48	191	Hall County, TX	2010	NA	1421	1292	129	9.1
CN4819300000000	48	193	Hamilton County, TX	2010	NA	3939	3671	268	6.8
CN4819500000000	48	195	Hansford County, TX	2010	NA	3030	2899	131	4.3
CN4819700000000	48	197	Hardeman County, TX	2010	NA	1941	1780	161	8.3
CN4819900000000	48	199	Hardin County, TX	2010	NA	25839	23282	2557	9.9
CN4820100000000	48	201	Harris County, TX	2010	NA	2064026	1892849	171177	8.3
CN4820300000000	48	203	Harrison County, TX	2010	NA	30822	27934	2888	9.4
CN4820500000000	48	205	Hartley County, TX	2010	NA	2695	2583	112	4.2
CN4820700000000	48	207	Haskell County, TX	2010	NA	2994	2831	163	5.4
CN4820900000000	48	209	Hays County, TX	2010	NA	80387	74737	5650	7
CN4821100000000	48	211	Hemphill County, TX	2010	NA	2130	2046	84	3.9
CN4821300000000	48	213	Henderson County, TX	2010	NA	34752	31691	3061	8.8
CN4821500000000	48	215	Hidalgo County, TX	2010	NA	318302	280884	37418	11.8
CN4821700000000	48	217	Hill County, TX	2010	NA	15940	14604	1336	8.4
CN4821900000000	48	219	Hockley County, TX	2010	NA	11030	10252	778	7.1
CN4822100000000	48	221	Hood County, TX	2010	NA	23352	21363	1989	8.5
CN4822300000000	48	223	Hopkins County, TX	2010	NA	16624	15386	1238	7.4
CN4822500000000	48	225	Houston County, TX	2010	NA	10538	9730	808	7.7
CN4822700000000	48	227	Howard County, TX	2010	NA	13223	12275	948	7.2
CN4822900000000	48	229	Hudspeth County, TX	2010	NA	1413	1301	112	7.9
CN4823100000000	48	231	Hunt County, TX	2010	NA	38126	34732	3394	8.9
CN4823300000000	48	233	Hutchinson County, TX	2010	NA	9707	8887	820	8.4
CN4823500000000	48	235	Irion County, TX	2010	NA	873	827	46	5.3
CN4823700000000	48	237	Jack County, TX	2010	NA	3664	3377	287	7.8
CN4823900000000	48	239	Jackson County, TX	2010	NA	7131	6629	502	7
CN4824100000000	48	241	Jasper County, TX	2010	NA	14841	13004	1837	12.4
CN4824300000000	48	243	Jeff Davis County, TX	2010	NA	1273	1210	63	4.9
CN4824500000000	48	245	Jefferson County, TX	2010	NA	113217	100371	12846	11.3
CN4824700000000	48	247	Jim Hogg County, TX	2010	NA	2329	2089	240	10.3
CN4824900000000	48	249	Jim Wells County, TX	2010	NA	18257	16437	1820	10
CN4825100000000	48	251	Johnson County, TX	2010	NA	71940	65703	6237	8.7
CN4825300000000	48	253	Jones County, TX	2010	NA	6161	5621	540	8.8
CN4825500000000	48	255	Karnes County, TX	2010	NA	4869	4427	442	9.1
CN4825700000000	48	257	Kaufman County, TX	2010	NA	50807	46496	4311	8.5
CN4825900000000	48	259	Kendall County, TX	2010	NA	16412	15391	1021	6.2
CN4826100000000	48	261	Kenedy County, TX	2010	NA	219	204	15	6.8
CN4826300000000	48	263	Kent County, TX	2010	NA	559	532	27	4.8
CN4826500000000	48	265	Kerr County, TX	2010	NA	21919	20457	1462	6.7
CN4826700000000	48	267	Kimble County, TX	2010	NA	2276	2140	136	6
CN4826900000000	48	269	King County, TX	2010	NA	278	266	12	4.3
CN4827100000000	48	271	Kinney County, TX	2010	NA	1270	1128	142	11.2
CN4827300000000	48	273	Kleberg County, TX	2010	NA	15030	13774	1256	8.4
CN4827500000000	48	275	Knox County, TX	2010	NA	1909	1797	112	5.9
CN4827700000000	48	277	Lamar County, TX	2010	NA	23300	21135	2165	9.3
CN4827900000000	48	279	Lamb County, TX	2010	NA	6797	6283	514	7.6
CN4828100000000	48	281	Lampasas County, TX	2010	NA	9020	8379	641	7.1
CN4828300000000	48	283	La Salle County, TX	2010	NA	2722	2479	243	8.9
CN4828500000000	48	285	Lavaca County, TX	2010	NA	9703	9033	670	6.9
CN4828700000000	48	287	Lee County, TX	2010	NA	8227	7631	596	7.2
CN4828900000000	48	289	Leon County, TX	2010	NA	7263	6620	643	8.9
CN4829100000000	48	291	Liberty County, TX	2010	NA	30614	27040	3574	11.7
CN4829300000000	48	293	Limestone County, TX	2010	NA	9938	9155	783	7.9
CN4829500000000	48	295	Lipscomb County, TX	2010	NA	1665	1567	98	5.9
CN4829700000000	48	297	Live Oak County, TX	2010	NA	4631	4292	339	7.3
CN4829900000000	48	299	Llano County, TX	2010	NA	7994	7350	644	8.1
CN4830100000000	48	301	Loving County, TX	2010	NA	71	67	4	5.6
CN4830300000000	48	303	Lubbock County, TX	2010	NA	143339	134372	8967	6.3
CN4830500000000	48	305	Lynn County, TX	2010	NA	3069	2867	202	6.6
CN4830700000000	48	307	McCulloch County, TX	2010	NA	4097	3810	287	7
CN4830900000000	48	309	McLennan County, TX	2010	NA	112900	104593	8307	7.4
CN4831100000000	48	311	McMullen County, TX	2010	NA	487	466	21	4.3
CN4831300000000	48	313	Madison County, TX	2010	NA	4753	4353	400	8.4
CN4831500000000	48	315	Marion County, TX	2010	NA	4503	3972	531	11.8
CN4831700000000	48	317	Martin County, TX	2010	NA	2196	2064	132	6
CN4831900000000	48	319	Mason County, TX	2010	NA	1991	1866	125	6.3
CN4832100000000	48	321	Matagorda County, TX	2010	NA	18158	16075	2083	11.5
CN4832300000000	48	323	Maverick County, TX	2010	NA	23525	19959	3566	15.2
CN4832500000000	48	325	Medina County, TX	2010	NA	20017	18509	1508	7.5
CN4832700000000	48	327	Menard County, TX	2010	NA	1004	930	74	7.4
CN4832900000000	48	329	Midland County, TX	2010	NA	71331	67155	4176	5.9
CN4833100000000	48	331	Milam County, TX	2010	NA	10539	9362	1177	11.2
CN4833300000000	48	333	Mills County, TX	2010	NA	2190	2051	139	6.3
CN4833500000000	48	335	Mitchell County, TX	2010	NA	2971	2727	244	8.2
CN4833700000000	48	337	Montague County, TX	2010	NA	9424	8670	754	8
CN4833900000000	48	339	Montgomery County, TX	2010	NA	224426	207496	16930	7.5
CN4834100000000	48	341	Moore County, TX	2010	NA	11549	10930	619	5.4
CN4834300000000	48	343	Morris County, TX	2010	NA	5769	4975	794	13.8
CN4834500000000	48	345	Motley County, TX	2010	NA	624	585	39	6.3
CN4834700000000	48	347	Nacogdoches County, TX	2010	NA	30782	28593	2189	7.1
CN4834900000000	48	349	Navarro County, TX	2010	NA	22776	20878	1898	8.3
CN4835100000000	48	351	Newton County, TX	2010	NA	5939	5185	754	12.7
CN4835300000000	48	353	Nolan County, TX	2010	NA	7331	6781	550	7.5
CN4835500000000	48	355	Nueces County, TX	2010	NA	162502	149312	13190	8.1
CN4835700000000	48	357	Ochiltree County, TX	2010	NA	4868	4580	288	5.9
CN4835900000000	48	359	Oldham County, TX	2010	NA	961	917	44	4.6
CN4836100000000	48	361	Orange County, TX	2010	NA	38466	33983	4483	11.7
CN4836300000000	48	363	Palo Pinto County, TX	2010	NA	13254	12111	1143	8.6
CN4836500000000	48	365	Panola County, TX	2010	NA	11404	10373	1031	9
CN4836700000000	48	367	Parker County, TX	2010	NA	56408	52113	4295	7.6
CN4836900000000	48	369	Parmer County, TX	2010	NA	5353	5117	236	4.4
CN4837100000000	48	371	Pecos County, TX	2010	NA	7180	6653	527	7.3
CN4837300000000	48	373	Polk County, TX	2010	NA	17563	15861	1702	9.7
CN4837500000000	48	375	Potter County, TX	2010	NA	58038	54385	3653	6.3
CN4837700000000	48	377	Presidio County, TX	2010	NA	3743	3052	691	18.5
CN4837900000000	48	379	Rains County, TX	2010	NA	5166	4712	454	8.8
CN4838100000000	48	381	Randall County, TX	2010	NA	66245	62819	3426	5.2
CN4838300000000	48	383	Reagan County, TX	2010	NA	1912	1806	106	5.5
CN4838500000000	48	385	Real County, TX	2010	NA	1137	1033	104	9.1
CN4838700000000	48	387	Red River County, TX	2010	NA	5580	4936	644	11.5
CN4838900000000	48	389	Reeves County, TX	2010	NA	5748	5239	509	8.9
CN4839100000000	48	391	Refugio County, TX	2010	NA	3328	3037	291	8.7
CN4839300000000	48	393	Roberts County, TX	2010	NA	480	454	26	5.4
CN4839500000000	48	395	Robertson County, TX	2010	NA	7561	6865	696	9.2
CN4839700000000	48	397	Rockwall County, TX	2010	NA	39439	36524	2915	7.4
CN4839900000000	48	399	Runnels County, TX	2010	NA	5129	4702	427	8.3
CN4840100000000	48	401	Rusk County, TX	2010	NA	23961	22091	1870	7.8
CN4840300000000	48	403	Sabine County, TX	2010	NA	3654	3058	596	16.3
CN4840500000000	48	405	San Augustine County, TX	2010	NA	3193	2779	414	13
CN4840700000000	48	407	San Jacinto County, TX	2010	NA	11230	10110	1120	10
CN4840900000000	48	409	San Patricio County, TX	2010	NA	30434	27243	3191	10.5
CN4841100000000	48	411	San Saba County, TX	2010	NA	2559	2401	158	6.2
CN4841300000000	48	413	Schleicher County, TX	2010	NA	1634	1510	124	7.6
CN4841500000000	48	415	Scurry County, TX	2010	NA	7101	6619	482	6.8
CN4841700000000	48	417	Shackelford County, TX	2010	NA	1904	1798	106	5.6
CN4841900000000	48	419	Shelby County, TX	2010	NA	11839	10837	1002	8.5
CN4842100000000	48	421	Sherman County, TX	2010	NA	1555	1484	71	4.6
CN4842300000000	48	423	Smith County, TX	2010	NA	101151	93110	8041	7.9
CN4842500000000	48	425	Somervell County, TX	2010	NA	4043	3721	322	8
CN4842700000000	48	427	Starr County, TX	2010	NA	26074	21565	4509	17.3
CN4842900000000	48	429	Stephens County, TX	2010	NA	4245	3928	317	7.5
CN4843100000000	48	431	Sterling County, TX	2010	NA	675	643	32	4.7
CN4843300000000	48	433	Stonewall County, TX	2010	NA	746	703	43	5.8
CN4843500000000	48	435	Sutton County, TX	2010	NA	1990	1799	191	9.6
CN4843700000000	48	437	Swisher County, TX	2010	NA	3182	2973	209	6.6
CN4843900000000	48	439	Tarrant County, TX	2010	NA	924951	849576	75375	8.1
CN4844100000000	48	441	Taylor County, TX	2010	NA	64285	59931	4354	6.8
CN4844300000000	48	443	Terrell County, TX	2010	NA	501	467	34	6.8
CN4844500000000	48	445	Terry County, TX	2010	NA	5756	5328	428	7.4
CN4844700000000	48	447	Throckmorton County, TX	2010	NA	877	824	53	6
CN4844900000000	48	449	Titus County, TX	2010	NA	13988	12795	1193	8.5
CN4845100000000	48	451	Tom Green County, TX	2010	NA	52595	49149	3446	6.6
CN4845300000000	48	453	Travis County, TX	2010	NA	575630	536660	38970	6.8
CN4845500000000	48	455	Trinity County, TX	2010	NA	5783	5232	551	9.5
CN4845700000000	48	457	Tyler County, TX	2010	NA	7904	6973	931	11.8
CN4845900000000	48	459	Upshur County, TX	2010	NA	18283	16675	1608	8.8
CN4846100000000	48	461	Upton County, TX	2010	NA	1552	1457	95	6.1
CN4846300000000	48	463	Uvalde County, TX	2010	NA	11826	10769	1057	8.9
CN4846500000000	48	465	Val Verde County, TX	2010	NA	20619	18704	1915	9.3
CN4846700000000	48	467	Van Zandt County, TX	2010	NA	23601	21620	1981	8.4
CN4846900000000	48	469	Victoria County, TX	2010	NA	43079	39778	3301	7.7
CN4847100000000	48	471	Walker County, TX	2010	NA	23234	21436	1798	7.7
CN4847300000000	48	473	Waller County, TX	2010	NA	19960	18234	1726	8.6
CN4847500000000	48	475	Ward County, TX	2010	NA	4631	4239	392	8.5
CN4847700000000	48	477	Washington County, TX	2010	NA	15561	14439	1122	7.2
CN4847900000000	48	479	Webb County, TX	2010	NA	105016	96364	8652	8.2
CN4848100000000	48	481	Wharton County, TX	2010	NA	21279	19431	1848	8.7
CN4848300000000	48	483	Wheeler County, TX	2010	NA	2732	2565	167	6.1
CN4848500000000	48	485	Wichita County, TX	2010	NA	59280	54681	4599	7.8
CN4848700000000	48	487	Wilbarger County, TX	2010	NA	6140	5657	483	7.9
CN4848900000000	48	489	Willacy County, TX	2010	NA	7781	6656	1125	14.5
CN4849100000000	48	491	Williamson County, TX	2010	NA	222584	206458	16126	7.2
CN4849300000000	48	493	Wilson County, TX	2010	NA	21235	19785	1450	6.8
CN4849500000000	48	495	Winkler County, TX	2010	NA	2898	2632	266	9.2
CN4849700000000	48	497	Wise County, TX	2010	NA	27668	25269	2399	8.7
CN4849900000000	48	499	Wood County, TX	2010	NA	16969	15432	1537	9.1
CN4850100000000	48	501	Yoakum County, TX	2010	NA	3690	3433	257	7
CN4850300000000	48	503	Young County, TX	2010	NA	8646	7982	664	7.7
CN4850500000000	48	505	Zapata County, TX	2010	NA	5761	5162	599	10.4
CN4850700000000	48	507	Zavala County, TX	2010	NA	4557	3924	633	13.9
CN4900100000000	49	001	Beaver County, UT	2010	NA	3157	2843	314	9.9
CN4900300000000	49	003	Box Elder County, UT	2010	NA	23644	21640	2004	8.5
CN4900500000000	49	005	Cache County, UT	2010	NA	57249	53768	3481	6.1
CN4900700000000	49	007	Carbon County, UT	2010	NA	9910	9057	853	8.6
CN4900900000000	49	009	Daggett County, UT	2010	NA	495	459	36	7.3
CN4901100000000	49	011	Davis County, UT	2010	NA	146959	136698	10261	7
CN4901300000000	49	013	Duchesne County, UT	2010	NA	8166	7385	781	9.6
CN4901500000000	49	015	Emery County, UT	2010	NA	5290	4906	384	7.3
CN4901700000000	49	017	Garfield County, UT	2010	NA	3074	2760	314	10.2
CN4901900000000	49	019	Grand County, UT	2010	NA	5323	4764	559	10.5
CN4902100000000	49	021	Iron County, UT	2010	NA	20414	18457	1957	9.6
CN4902300000000	49	023	Juab County, UT	2010	NA	4612	4191	421	9.1
CN4902500000000	49	025	Kane County, UT	2010	NA	3561	3278	283	7.9
CN4902700000000	49	027	Millard County, UT	2010	NA	6421	6023	398	6.2
CN4902900000000	49	029	Morgan County, UT	2010	NA	4274	3980	294	6.9
CN4903100000000	49	031	Piute County, UT	2010	NA	572	514	58	10.1
CN4903300000000	49	033	Rich County, UT	2010	NA	1039	964	75	7.2
CN4903500000000	49	035	Salt Lake County, UT	2010	NA	548378	506309	42069	7.7
CN4903700000000	49	037	San Juan County, UT	2010	NA	6087	5424	663	10.9
CN4903900000000	49	039	Sanpete County, UT	2010	NA	11461	10426	1035	9
CN4904100000000	49	041	Sevier County, UT	2010	NA	9727	8917	810	8.3
CN4904300000000	49	043	Summit County, UT	2010	NA	20857	19313	1544	7.4
CN4904500000000	49	045	Tooele County, UT	2010	NA	27454	25163	2291	8.3
CN4904700000000	49	047	Uintah County, UT	2010	NA	15189	13896	1293	8.5
CN4904900000000	49	049	Utah County, UT	2010	NA	229820	212729	17091	7.4
CN4905100000000	49	051	Wasatch County, UT	2010	NA	11360	10405	955	8.4
CN4905300000000	49	053	Washington County, UT	2010	NA	56776	50821	5955	10.5
CN4905500000000	49	055	Wayne County, UT	2010	NA	1576	1441	135	8.6
CN4905700000000	49	057	Weber County, UT	2010	NA	113259	103288	9971	8.8
CN5000100000000	50	001	Addison County, VT	2010	NA	21242	20006	1236	5.8
CN5000300000000	50	003	Bennington County, VT	2010	NA	20334	18927	1407	6.9
CN5000500000000	50	005	Caledonia County, VT	2010	NA	16785	15649	1136	6.8
CN5000700000000	50	007	Chittenden County, VT	2010	NA	94582	90041	4541	4.8
CN5000900000000	50	009	Essex County, VT	2010	NA	3171	2855	316	10
CN5001100000000	50	011	Franklin County, VT	2010	NA	27686	26107	1579	5.7
CN5001300000000	50	013	Grand Isle County, VT	2010	NA	4134	3848	286	6.9
CN5001500000000	50	015	Lamoille County, VT	2010	NA	14497	13393	1104	7.6
CN5001700000000	50	017	Orange County, VT	2010	NA	16725	15743	982	5.9
CN5001900000000	50	019	Orleans County, VT	2010	NA	14213	12948	1265	8.9
CN5002100000000	50	021	Rutland County, VT	2010	NA	33591	31106	2485	7.4
CN5002300000000	50	023	Washington County, VT	2010	NA	35118	33050	2068	5.9
CN5002500000000	50	025	Windham County, VT	2010	NA	25436	23874	1562	6.1
CN5002700000000	50	027	Windsor County, VT	2010	NA	31889	29942	1947	6.1
CN5100100000000	51	001	Accomack County, VA	2010	NA	16805	15479	1326	7.9
CN5100300000000	51	003	Albemarle County, VA	2010	NA	50987	47937	3050	6
CN5100500000000	51	005	Alleghany County, VA	2010	NA	7951	7264	687	8.6
CN5100700000000	51	007	Amelia County, VA	2010	NA	6227	5699	528	8.5
CN5100900000000	51	009	Amherst County, VA	2010	NA	16352	15030	1322	8.1
CN5101100000000	51	011	Appomattox County, VA	2010	NA	7343	6711	632	8.6
CN5101300000000	51	013	Arlington County, VA	2010	NA	137368	131701	5667	4.1
CN5101500000000	51	015	Augusta County, VA	2010	NA	37130	34481	2649	7.1
CN5101700000000	51	017	Bath County, VA	2010	NA	2509	2320	189	7.5
CN5101900000000	51	019	Bedford County, VA	2010	NA	39053	36302	2751	7
CN5102100000000	51	021	Bland County, VA	2010	NA	2895	2646	249	8.6
CN5102300000000	51	023	Botetourt County, VA	2010	NA	17700	16559	1141	6.4
CN5102500000000	51	025	Brunswick County, VA	2010	NA	6953	6168	785	11.3
CN5102700000000	51	027	Buchanan County, VA	2010	NA	8326	7497	829	10
CN5102900000000	51	029	Buckingham County, VA	2010	NA	6568	5868	700	10.7
CN5103100000000	51	031	Campbell County, VA	2010	NA	27756	25614	2142	7.7
CN5103300000000	51	033	Caroline County, VA	2010	NA	14342	12972	1370	9.6
CN5103500000000	51	035	Carroll County, VA	2010	NA	14004	12388	1616	11.5
CN5103600000000	51	036	Charles City County, VA	2010	NA	3901	3527	374	9.6
CN5103700000000	51	037	Charlotte County, VA	2010	NA	5356	4820	536	10
CN5104100000000	51	041	Chesterfield County, VA	2010	NA	168602	156307	12295	7.3
CN5104300000000	51	043	Clarke County, VA	2010	NA	7695	7181	514	6.7
CN5104500000000	51	045	Craig County, VA	2010	NA	2441	2247	194	7.9
CN5104700000000	51	047	Culpeper County, VA	2010	NA	23263	21591	1672	7.2
CN5104900000000	51	049	Cumberland County, VA	2010	NA	4523	4141	382	8.4
CN5105100000000	51	051	Dickenson County, VA	2010	NA	5513	4934	579	10.5
CN5105300000000	51	053	Dinwiddie County, VA	2010	NA	13566	12367	1199	8.8
CN5105700000000	51	057	Essex County, VA	2010	NA	5715	5196	519	9.1
CN5105900000000	51	059	Fairfax County, VA	2010	NA	610521	579499	31022	5.1
CN5106100000000	51	061	Fauquier County, VA	2010	NA	35763	33552	2211	6.2
CN5106300000000	51	063	Floyd County, VA	2010	NA	8134	7567	567	7
CN5106500000000	51	065	Fluvanna County, VA	2010	NA	13078	12253	825	6.3
CN5106700000000	51	067	Franklin County, VA	2010	NA	27622	25216	2406	8.7
CN5106900000000	51	069	Frederick County, VA	2010	NA	41981	38832	3149	7.5
CN5107100000000	51	071	Giles County, VA	2010	NA	8302	7507	795	9.6
CN5107300000000	51	073	Gloucester County, VA	2010	NA	19553	18219	1334	6.8
CN5107500000000	51	075	Goochland County, VA	2010	NA	10483	9733	750	7.2
CN5107700000000	51	077	Grayson County, VA	2010	NA	7373	6455	918	12.5
CN5107900000000	51	079	Greene County, VA	2010	NA	9655	9007	648	6.7
CN5108100000000	51	081	Greensville County, VA	2010	NA	4562	4124	438	9.6
CN5108300000000	51	083	Halifax County, VA	2010	NA	16686	14651	2035	12.2
CN5108500000000	51	085	Hanover County, VA	2010	NA	54430	50855	3575	6.6
CN5108700000000	51	087	Henrico County, VA	2010	NA	167701	155452	12249	7.3
CN5108900000000	51	089	Henry County, VA	2010	NA	24007	20467	3540	14.7
CN5109100000000	51	091	Highland County, VA	2010	NA	1445	1355	90	6.2
CN5109300000000	51	093	Isle of Wight County, VA	2010	NA	18800	17458	1342	7.1
CN5109500000000	51	095	James City County, VA	2010	NA	32243	30205	2038	6.3
CN5109700000000	51	097	King and Queen County, VA	2010	NA	3592	3302	290	8.1
CN5109900000000	51	099	King George County, VA	2010	NA	11413	10573	840	7.4
CN5110100000000	51	101	King William County, VA	2010	NA	8656	8011	645	7.5
CN5110300000000	51	103	Lancaster County, VA	2010	NA	5570	5024	546	9.8
CN5110500000000	51	105	Lee County, VA	2010	NA	10127	9325	802	7.9
CN5110700000000	51	107	Loudoun County, VA	2010	NA	175439	166487	8952	5.1
CN5110900000000	51	109	Louisa County, VA	2010	NA	17858	16513	1345	7.5
CN5111100000000	51	111	Lunenburg County, VA	2010	NA	5547	5020	527	9.5
CN5111300000000	51	113	Madison County, VA	2010	NA	7169	6717	452	6.3
CN5111500000000	51	115	Mathews County, VA	2010	NA	4224	3956	268	6.3
CN5111700000000	51	117	Mecklenburg County, VA	2010	NA	14158	12552	1606	11.3
CN5111900000000	51	119	Middlesex County, VA	2010	NA	5160	4789	371	7.2
CN5112100000000	51	121	Montgomery County, VA	2010	NA	47497	44140	3357	7.1
CN5112500000000	51	125	Nelson County, VA	2010	NA	7574	7034	540	7.1
CN5112700000000	51	127	New Kent County, VA	2010	NA	10294	9550	744	7.2
CN5113100000000	51	131	Northampton County, VA	2010	NA	6335	5799	536	8.5
CN5113300000000	51	133	Northumberland County, VA	2010	NA	6150	5617	533	8.7
CN5113500000000	51	135	Nottoway County, VA	2010	NA	6859	6338	521	7.6
CN5113700000000	51	137	Orange County, VA	2010	NA	15456	14178	1278	8.3
CN5113900000000	51	139	Page County, VA	2010	NA	12336	10900	1436	11.6
CN5114100000000	51	141	Patrick County, VA	2010	NA	8321	7265	1056	12.7
CN5114300000000	51	143	Pittsylvania County, VA	2010	NA	30911	27543	3368	10.9
CN5114500000000	51	145	Powhatan County, VA	2010	NA	13510	12557	953	7.1
CN5114700000000	51	147	Prince Edward County, VA	2010	NA	10279	9284	995	9.7
CN5114900000000	51	149	Prince George County, VA	2010	NA	13962	12838	1124	8.1
CN5115300000000	51	153	Prince William County, VA	2010	NA	218394	205097	13297	6.1
CN5115500000000	51	155	Pulaski County, VA	2010	NA	16975	15091	1884	11.1
CN5115700000000	51	157	Rappahannock County, VA	2010	NA	4025	3771	254	6.3
CN5115900000000	51	159	Richmond County, VA	2010	NA	4366	4058	308	7.1
CN5116100000000	51	161	Roanoke County, VA	2010	NA	49258	46137	3121	6.3
CN5116300000000	51	163	Rockbridge County, VA	2010	NA	11142	10303	839	7.5
CN5116500000000	51	165	Rockingham County, VA	2010	NA	40373	37656	2717	6.7
CN5116700000000	51	167	Russell County, VA	2010	NA	12081	10844	1237	10.2
CN5116900000000	51	169	Scott County, VA	2010	NA	10072	9219	853	8.5
CN5117100000000	51	171	Shenandoah County, VA	2010	NA	20831	19117	1714	8.2
CN5117300000000	51	173	Smyth County, VA	2010	NA	13707	12046	1661	12.1
CN5117500000000	51	175	Southampton County, VA	2010	NA	9495	8679	816	8.6
CN5117700000000	51	177	Spotsylvania County, VA	2010	NA	63357	58922	4435	7
CN5117900000000	51	179	Stafford County, VA	2010	NA	63904	59748	4156	6.5
CN5118100000000	51	181	Surry County, VA	2010	NA	3694	3363	331	9
CN5118300000000	51	183	Sussex County, VA	2010	NA	4281	3792	489	11.4
CN5118500000000	51	185	Tazewell County, VA	2010	NA	18394	16779	1615	8.8
CN5118700000000	51	187	Warren County, VA	2010	NA	20103	18480	1623	8.1
CN5119100000000	51	191	Washington County, VA	2010	NA	27416	25239	2177	7.9
CN5119300000000	51	193	Westmoreland County, VA	2010	NA	9178	8436	742	8.1
CN5119500000000	51	195	Wise County, VA	2010	NA	16977	15561	1416	8.3
CN5119700000000	51	197	Wythe County, VA	2010	NA	14277	12687	1590	11.1
CN5119900000000	51	199	York County, VA	2010	NA	31289	29377	1912	6.1
CN5151000000000	51	510	Alexandria city, VA	2010	NA	90361	85915	4446	4.9
CN5152000000000	51	520	Bristol city, VA	2010	NA	7977	7274	703	8.8
CN5153000000000	51	530	Buena Vista city, VA	2010	NA	3248	2925	323	9.9
CN5154000000000	51	540	Charlottesville city, VA	2010	NA	23203	21790	1413	6.1
CN5155000000000	51	550	Chesapeake city, VA	2010	NA	113319	105173	8146	7.2
CN5157000000000	51	570	Colonial Heights city, VA	2010	NA	8533	7828	705	8.3
CN5158000000000	51	580	Covington city, VA	2010	NA	2689	2403	286	10.6
CN5159000000000	51	590	Danville city, VA	2010	NA	20099	17390	2709	13.5
CN5159500000000	51	595	Emporia city, VA	2010	NA	2570	2251	319	12.4
CN5160000000000	51	600	Fairfax city, VA	2010	NA	12663	11974	689	5.4
CN5161000000000	51	610	Falls Church city, VA	2010	NA	7382	7022	360	4.9
CN5162000000000	51	620	Franklin city, VA	2010	NA	3708	3241	467	12.6
CN5163000000000	51	630	Fredericksburg city, VA	2010	NA	12423	11304	1119	9
CN5164000000000	51	640	Galax city, VA	2010	NA	3172	2825	347	10.9
CN5165000000000	51	650	Hampton city, VA	2010	NA	66666	60687	5979	9
CN5166000000000	51	660	Harrisonburg city, VA	2010	NA	23165	21250	1915	8.3
CN5167000000000	51	670	Hopewell city, VA	2010	NA	9864	8721	1143	11.6
CN5167800000000	51	678	Lexington city, VA	2010	NA	2300	2086	214	9.3
CN5168000000000	51	680	Lynchburg city, VA	2010	NA	35841	32798	3043	8.5
CN5168300000000	51	683	Manassas city, VA	2010	NA	20972	19503	1469	7
CN5168500000000	51	685	Manassas Park city, VA	2010	NA	8066	7563	503	6.2
CN5169000000000	51	690	Martinsville city, VA	2010	NA	6136	5066	1070	17.4
CN5170000000000	51	700	Newport News city, VA	2010	NA	90664	83104	7560	8.3
CN5171000000000	51	710	Norfolk city, VA	2010	NA	112449	102606	9843	8.8
CN5172000000000	51	720	Norton city, VA	2010	NA	2079	1928	151	7.3
CN5173000000000	51	730	Petersburg city, VA	2010	NA	13877	11939	1938	14
CN5173500000000	51	735	Poquoson city, VA	2010	NA	6395	6007	388	6.1
CN5174000000000	51	740	Portsmouth city, VA	2010	NA	45461	41102	4359	9.6
CN5175000000000	51	750	Radford city, VA	2010	NA	7787	7060	727	9.3
CN5176000000000	51	760	Richmond city, VA	2010	NA	106456	96347	10109	9.5
CN5177000000000	51	770	Roanoke city, VA	2010	NA	49317	45022	4295	8.7
CN5177500000000	51	775	Salem city, VA	2010	NA	12789	11910	879	6.9
CN5179000000000	51	790	Staunton city, VA	2010	NA	11846	10920	926	7.8
CN5180000000000	51	800	Suffolk city, VA	2010	NA	41753	38581	3172	7.6
CN5181000000000	51	810	Virginia Beach city, VA	2010	NA	226894	212145	14749	6.5
CN5182000000000	51	820	Waynesboro city, VA	2010	NA	10170	9255	915	9
CN5183000000000	51	830	Williamsburg city, VA	2010	NA	6516	5856	660	10.1
CN5184000000000	51	840	Winchester city, VA	2010	NA	13688	12551	1137	8.3
CN5300100000000	53	001	Adams County, WA	2010	NA	8440	7555	885	10.5
CN5300300000000	53	003	Asotin County, WA	2010	NA	10333	9361	972	9.4
CN5300500000000	53	005	Benton County, WA	2010	NA	94253	86846	7407	7.9
CN5300700000000	53	007	Chelan County, WA	2010	NA	42102	38353	3749	8.9
CN5300900000000	53	009	Clallam County, WA	2010	NA	29621	26352	3269	11
CN5301100000000	53	011	Clark County, WA	2010	NA	216620	188628	27992	12.9
CN5301300000000	53	013	Columbia County, WA	2010	NA	1959	1774	185	9.4
CN5301500000000	53	015	Cowlitz County, WA	2010	NA	46432	40435	5997	12.9
CN5301700000000	53	017	Douglas County, WA	2010	NA	19876	17945	1931	9.7
CN5301900000000	53	019	Ferry County, WA	2010	NA	2645	2181	464	17.5
CN5302100000000	53	021	Franklin County, WA	2010	NA	38254	34884	3370	8.8
CN5302300000000	53	023	Garfield County, WA	2010	NA	1061	973	88	8.3
CN5302500000000	53	025	Grant County, WA	2010	NA	43212	38522	4690	10.9
CN5302700000000	53	027	Grays Harbor County, WA	2010	NA	31046	26723	4323	13.9
CN5302900000000	53	029	Island County, WA	2010	NA	33812	30665	3147	9.3
CN5303100000000	53	031	Jefferson County, WA	2010	NA	12750	11436	1314	10.3
CN5303300000000	53	033	King County, WA	2010	NA	1105830	1006061	99769	9
CN5303500000000	53	035	Kitsap County, WA	2010	NA	120592	110230	10362	8.6
CN5303700000000	53	037	Kittitas County, WA	2010	NA	21306	19221	2085	9.8
CN5303900000000	53	039	Klickitat County, WA	2010	NA	10328	9069	1259	12.2
CN5304100000000	53	041	Lewis County, WA	2010	NA	33962	29503	4459	13.1
CN5304300000000	53	043	Lincoln County, WA	2010	NA	5327	4880	447	8.4
CN5304500000000	53	045	Mason County, WA	2010	NA	24941	21963	2978	11.9
CN5304700000000	53	047	Okanogan County, WA	2010	NA	22347	19950	2397	10.7
CN5304900000000	53	049	Pacific County, WA	2010	NA	8789	7557	1232	14
CN5305100000000	53	051	Pend Oreille County, WA	2010	NA	5148	4359	789	15.3
CN5305300000000	53	053	Pierce County, WA	2010	NA	395844	354576	41268	10.4
CN5305500000000	53	055	San Juan County, WA	2010	NA	8449	7831	618	7.3
CN5305700000000	53	057	Skagit County, WA	2010	NA	59114	52658	6456	10.9
CN5305900000000	53	059	Skamania County, WA	2010	NA	5179	4514	665	12.8
CN5306100000000	53	061	Snohomish County, WA	2010	NA	386587	345332	41255	10.7
CN5306300000000	53	063	Spokane County, WA	2010	NA	238125	214109	24016	10.1
CN5306500000000	53	065	Stevens County, WA	2010	NA	19104	16603	2501	13.1
CN5306700000000	53	067	Thurston County, WA	2010	NA	126948	115550	11398	9
CN5306900000000	53	069	Wahkiakum County, WA	2010	NA	1472	1247	225	15.3
CN5307100000000	53	071	Walla Walla County, WA	2010	NA	30530	28085	2445	8
CN5307300000000	53	073	Whatcom County, WA	2010	NA	104359	94467	9892	9.5
CN5307500000000	53	075	Whitman County, WA	2010	NA	22489	20977	1512	6.7
CN5307700000000	53	077	Yakima County, WA	2010	NA	122140	109168	12972	10.6
CN5400100000000	54	001	Barbour County, WV	2010	NA	6870	6180	690	10
CN5400300000000	54	003	Berkeley County, WV	2010	NA	51020	46642	4378	8.6
CN5400500000000	54	005	Boone County, WV	2010	NA	8812	8035	777	8.8
CN5400700000000	54	007	Braxton County, WV	2010	NA	5686	5056	630	11.1
CN5400900000000	54	009	Brooke County, WV	2010	NA	10917	9672	1245	11.4
CN5401100000000	54	011	Cabell County, WV	2010	NA	43292	40164	3128	7.2
CN5401300000000	54	013	Calhoun County, WV	2010	NA	2906	2499	407	14
CN5401500000000	54	015	Clay County, WV	2010	NA	3647	3131	516	14.1
CN5401700000000	54	017	Doddridge County, WV	2010	NA	3315	3078	237	7.1
CN5401900000000	54	019	Fayette County, WV	2010	NA	17567	15817	1750	10
CN5402100000000	54	021	Gilmer County, WV	2010	NA	2775	2528	247	8.9
CN5402300000000	54	023	Grant County, WV	2010	NA	6124	5525	599	9.8
CN5402500000000	54	025	Greenbrier County, WV	2010	NA	15430	14080	1350	8.7
CN5402700000000	54	027	Hampshire County, WV	2010	NA	9765	8877	888	9.1
CN5402900000000	54	029	Hancock County, WV	2010	NA	14174	12456	1718	12.1
CN5403100000000	54	031	Hardy County, WV	2010	NA	5710	5048	662	11.6
CN5403300000000	54	033	Harrison County, WV	2010	NA	31254	28872	2382	7.6
CN5403500000000	54	035	Jackson County, WV	2010	NA	12313	10911	1402	11.4
CN5403700000000	54	037	Jefferson County, WV	2010	NA	26869	25077	1792	6.7
CN5403900000000	54	039	Kanawha County, WV	2010	NA	92603	85765	6838	7.4
CN5404100000000	54	041	Lewis County, WV	2010	NA	6990	6376	614	8.8
CN5404300000000	54	043	Lincoln County, WV	2010	NA	7873	6948	925	11.7
CN5404500000000	54	045	Logan County, WV	2010	NA	12687	11404	1283	10.1
CN5404700000000	54	047	McDowell County, WV	2010	NA	6362	5521	841	13.2
CN5404900000000	54	049	Marion County, WV	2010	NA	26641	24703	1938	7.3
CN5405100000000	54	051	Marshall County, WV	2010	NA	14680	13261	1419	9.7
CN5405300000000	54	053	Mason County, WV	2010	NA	11282	9980	1302	11.5
CN5405500000000	54	055	Mercer County, WV	2010	NA	24076	22035	2041	8.5
CN5405700000000	54	057	Mineral County, WV	2010	NA	12362	11208	1154	9.3
CN5405900000000	54	059	Mingo County, WV	2010	NA	9168	8266	902	9.8
CN5406100000000	54	061	Monongalia County, WV	2010	NA	48354	45653	2701	5.6
CN5406300000000	54	063	Monroe County, WV	2010	NA	5764	5303	461	8
CN5406500000000	54	065	Morgan County, WV	2010	NA	7677	6975	702	9.1
CN5406700000000	54	067	Nicholas County, WV	2010	NA	10937	9841	1096	10
CN5406900000000	54	069	Ohio County, WV	2010	NA	21826	20093	1733	7.9
CN5407100000000	54	071	Pendleton County, WV	2010	NA	3658	3343	315	8.6
CN5407300000000	54	073	Pleasants County, WV	2010	NA	2937	2627	310	10.6
CN5407500000000	54	075	Pocahontas County, WV	2010	NA	3800	3363	437	11.5
CN5407700000000	54	077	Preston County, WV	2010	NA	14935	13687	1248	8.4
CN5407900000000	54	079	Putnam County, WV	2010	NA	26390	24389	2001	7.6
CN5408100000000	54	081	Raleigh County, WV	2010	NA	32470	29824	2646	8.1
CN5408300000000	54	083	Randolph County, WV	2010	NA	12208	10927	1281	10.5
CN5408500000000	54	085	Ritchie County, WV	2010	NA	4295	3878	417	9.7
CN5408700000000	54	087	Roane County, WV	2010	NA	5510	4759	751	13.6
CN5408900000000	54	089	Summers County, WV	2010	NA	4783	4330	453	9.5
CN5409100000000	54	091	Taylor County, WV	2010	NA	7446	6872	574	7.7
CN5409300000000	54	093	Tucker County, WV	2010	NA	3301	2937	364	11
CN5409500000000	54	095	Tyler County, WV	2010	NA	3551	3145	406	11.4
CN5409700000000	54	097	Upshur County, WV	2010	NA	10369	9409	960	9.3
CN5409900000000	54	099	Wayne County, WV	2010	NA	16938	15493	1445	8.5
CN5410100000000	54	101	Webster County, WV	2010	NA	3739	3360	379	10.1
CN5410300000000	54	103	Wetzel County, WV	2010	NA	7016	6193	823	11.7
CN5410500000000	54	105	Wirt County, WV	2010	NA	2292	2005	287	12.5
CN5410700000000	54	107	Wood County, WV	2010	NA	39348	35850	3498	8.9
CN5410900000000	54	109	Wyoming County, WV	2010	NA	8414	7540	874	10.4
CN5500100000000	55	001	Adams County, WI	2010	NA	9137	8005	1132	12.4
CN5500300000000	55	003	Ashland County, WI	2010	NA	8412	7479	933	11.1
CN5500500000000	55	005	Barron County, WI	2010	NA	23792	21587	2205	9.3
CN5500700000000	55	007	Bayfield County, WI	2010	NA	7689	6837	852	11.1
CN5500900000000	55	009	Brown County, WI	2010	NA	137157	126341	10816	7.9
CN5501100000000	55	011	Buffalo County, WI	2010	NA	7198	6640	558	7.8
CN5501300000000	55	013	Burnett County, WI	2010	NA	7579	6738	841	11.1
CN5501500000000	55	015	Calumet County, WI	2010	NA	27305	25421	1884	6.9
CN5501700000000	55	017	Chippewa County, WI	2010	NA	33184	30387	2797	8.4
CN5501900000000	55	019	Clark County, WI	2010	NA	17259	15479	1780	10.3
CN5502100000000	55	021	Columbia County, WI	2010	NA	32092	29363	2729	8.5
CN5502300000000	55	023	Crawford County, WI	2010	NA	8367	7489	878	10.5
CN5502500000000	55	025	Dane County, WI	2010	NA	293240	275835	17405	5.9
CN5502700000000	55	027	Dodge County, WI	2010	NA	47352	43075	4277	9
CN5502900000000	55	029	Door County, WI	2010	NA	15759	13986	1773	11.3
CN5503100000000	55	031	Douglas County, WI	2010	NA	23739	21761	1978	8.3
CN5503300000000	55	033	Dunn County, WI	2010	NA	23244	21410	1834	7.9
CN5503500000000	55	035	Eau Claire County, WI	2010	NA	57110	53140	3970	7
CN5503700000000	55	037	Florence County, WI	2010	NA	2247	2014	233	10.4
CN5503900000000	55	039	Fond du Lac County, WI	2010	NA	56519	51718	4801	8.5
CN5504100000000	55	041	Forest County, WI	2010	NA	4253	3755	498	11.7
CN5504300000000	55	043	Grant County, WI	2010	NA	27779	25664	2115	7.6
CN5504500000000	55	045	Green County, WI	2010	NA	21275	19573	1702	8
CN5504700000000	55	047	Green Lake County, WI	2010	NA	10309	9348	961	9.3
CN5504900000000	55	049	Iowa County, WI	2010	NA	13772	12636	1136	8.2
CN5505100000000	55	051	Iron County, WI	2010	NA	2881	2554	327	11.4
CN5505300000000	55	053	Jackson County, WI	2010	NA	10124	9239	885	8.7
CN5505500000000	55	055	Jefferson County, WI	2010	NA	46474	42416	4058	8.7
CN5505700000000	55	057	Juneau County, WI	2010	NA	13698	12331	1367	10
CN5505900000000	55	059	Kenosha County, WI	2010	NA	85714	76890	8824	10.3
CN5506100000000	55	061	Kewaunee County, WI	2010	NA	11178	10262	916	8.2
CN5506300000000	55	063	La Crosse County, WI	2010	NA	65596	61240	4356	6.6
CN5506500000000	55	065	Lafayette County, WI	2010	NA	9489	8810	679	7.2
CN5506700000000	55	067	Langlade County, WI	2010	NA	10182	9063	1119	11
CN5506900000000	55	069	Lincoln County, WI	2010	NA	15662	13889	1773	11.3
CN5507100000000	55	071	Manitowoc County, WI	2010	NA	44633	40205	4428	9.9
CN5507300000000	55	073	Marathon County, WI	2010	NA	73524	66695	6829	9.3
CN5507500000000	55	075	Marinette County, WI	2010	NA	21381	19014	2367	11.1
CN5507700000000	55	077	Marquette County, WI	2010	NA	7691	6855	836	10.9
CN5507800000000	55	078	Menominee County, WI	2010	NA	1550	1279	271	17.5
CN5507900000000	55	079	Milwaukee County, WI	2010	NA	476474	428859	47615	10
CN5508100000000	55	081	Monroe County, WI	2010	NA	23124	21283	1841	8
CN5508300000000	55	083	Oconto County, WI	2010	NA	21333	19043	2290	10.7
CN5508500000000	55	085	Oneida County, WI	2010	NA	19066	17123	1943	10.2
CN5508700000000	55	087	Outagamie County, WI	2010	NA	100601	92459	8142	8.1
CN5508900000000	55	089	Ozaukee County, WI	2010	NA	47418	44059	3359	7.1
CN5509100000000	55	091	Pepin County, WI	2010	NA	4095	3790	305	7.4
CN5509300000000	55	093	Pierce County, WI	2010	NA	23985	22318	1667	7
CN5509500000000	55	095	Polk County, WI	2010	NA	24048	21655	2393	10
CN5509700000000	55	097	Portage County, WI	2010	NA	39857	36671	3186	8
CN5509900000000	55	099	Price County, WI	2010	NA	7563	6736	827	10.9
CN5510100000000	55	101	Racine County, WI	2010	NA	100319	90126	10193	10.2
CN5510300000000	55	103	Richland County, WI	2010	NA	9631	8764	867	9
CN5510500000000	55	105	Rock County, WI	2010	NA	82702	73387	9315	11.3
CN5510700000000	55	107	Rusk County, WI	2010	NA	7141	6264	877	12.3
CN5510900000000	55	109	St. Croix County, WI	2010	NA	47070	43470	3600	7.6
CN5511100000000	55	111	Sauk County, WI	2010	NA	35854	32833	3021	8.4
CN5511300000000	55	113	Sawyer County, WI	2010	NA	8394	7447	947	11.3
CN5511500000000	55	115	Shawano County, WI	2010	NA	21885	19646	2239	10.2
CN5511700000000	55	117	Sheboygan County, WI	2010	NA	62242	56460	5782	9.3
CN5511900000000	55	119	Taylor County, WI	2010	NA	11449	10273	1176	10.3
CN5512100000000	55	121	Trempealeau County, WI	2010	NA	15985	14778	1207	7.6
CN5512300000000	55	123	Vernon County, WI	2010	NA	15162	13966	1196	7.9
CN5512500000000	55	125	Vilas County, WI	2010	NA	10346	9177	1169	11.3
CN5512700000000	55	127	Walworth County, WI	2010	NA	56363	51279	5084	9
CN5512900000000	55	129	Washburn County, WI	2010	NA	8043	7262	781	9.7
CN5513100000000	55	131	Washington County, WI	2010	NA	75607	69494	6113	8.1
CN5513300000000	55	133	Waukesha County, WI	2010	NA	218021	202008	16013	7.3
CN5513500000000	55	135	Waupaca County, WI	2010	NA	27745	25124	2621	9.4
CN5513700000000	55	137	Waushara County, WI	2010	NA	12027	10732	1295	10.8
CN5513900000000	55	139	Winnebago County, WI	2010	NA	92454	85230	7224	7.8
CN5514100000000	55	141	Wood County, WI	2010	NA	39967	36257	3710	9.3
CN5600100000000	56	001	Albany County, WY	2010	NA	21381	20425	956	4.5
CN5600300000000	56	003	Big Horn County, WY	2010	NA	5631	5255	376	6.7
CN5600500000000	56	005	Campbell County, WY	2010	NA	26296	24709	1587	6
CN5600700000000	56	007	Carbon County, WY	2010	NA	8254	7698	556	6.7
CN5600900000000	56	009	Converse County, WY	2010	NA	7568	7155	413	5.5
CN5601100000000	56	011	Crook County, WY	2010	NA	3910	3715	195	5
CN5601300000000	56	013	Fremont County, WY	2010	NA	20971	19514	1457	6.9
CN5601500000000	56	015	Goshen County, WY	2010	NA	7500	7132	368	4.9
CN5601700000000	56	017	Hot Springs County, WY	2010	NA	2569	2435	134	5.2
CN5601900000000	56	019	Johnson County, WY	2010	NA	4535	4226	309	6.8
CN5602100000000	56	021	Laramie County, WY	2010	NA	46182	43092	3090	6.7
CN5602300000000	56	023	Lincoln County, WY	2010	NA	8675	7947	728	8.4
CN5602500000000	56	025	Natrona County, WY	2010	NA	39894	37110	2784	7
CN5602700000000	56	027	Niobrara County, WY	2010	NA	1387	1323	64	4.6
CN5602900000000	56	029	Park County, WY	2010	NA	15849	14876	973	6.1
CN5603100000000	56	031	Platte County, WY	2010	NA	4965	4690	275	5.5
CN5603300000000	56	033	Sheridan County, WY	2010	NA	16132	14951	1181	7.3
CN5603500000000	56	035	Sublette County, WY	2010	NA	5691	5358	333	5.9
CN5603700000000	56	037	Sweetwater County, WY	2010	NA	23134	21608	1526	6.6
CN5603900000000	56	039	Teton County, WY	2010	NA	13611	12569	1042	7.7
CN5604100000000	56	041	Uinta County, WY	2010	NA	10557	9815	742	7
CN5604300000000	56	043	Washakie County, WY	2010	NA	4589	4318	271	5.9
CN5604500000000	56	045	Weston County, WY	2010	NA	4016	3822	194	4.8
CN7200100000000	72	001	Adjuntas Municipio, PR	2010	NA	5185	4169	1016	19.6
CN7200300000000	72	003	Aguada Municipio, PR	2010	NA	13495	10869	2626	19.5
CN7200500000000	72	005	Aguadilla Municipio, PR	2010	NA	17419	13863	3556	20.4
CN7200700000000	72	007	Aguas Buenas Municipio, PR	2010	NA	7969	6202	1767	22.2
CN7200900000000	72	009	Aibonito Municipio, PR	2010	NA	7547	6080	1467	19.4
CN7201100000000	72	011	Anasco Municipio, PR	2010	NA	9997	8064	1933	19.3
CN7201300000000	72	013	Arecibo Municipio, PR	2010	NA	27909	22893	5016	18
CN7201500000000	72	015	Arroyo Municipio, PR	2010	NA	6189	4766	1423	23
CN7201700000000	72	017	Barceloneta Municipio, PR	2010	NA	6632	5007	1625	24.5
CN7201900000000	72	019	Barranquitas Municipio, PR	2010	NA	8137	6694	1443	17.7
CN7202100000000	72	021	Bayamon Municipio, PR	2010	NA	76813	66891	9922	12.9
CN7202300000000	72	023	Cabo Rojo Municipio, PR	2010	NA	15462	12898	2564	16.6
CN7202500000000	72	025	Caguas Municipio, PR	2010	NA	54812	46287	8525	15.6
CN7202700000000	72	027	Camuy Municipio, PR	2010	NA	10858	9067	1791	16.5
CN7202900000000	72	029	Canovanas Municipio, PR	2010	NA	17699	14543	3156	17.8
CN7203100000000	72	031	Carolina Municipio, PR	2010	NA	71411	62139	9272	13
CN7203300000000	72	033	Catano Municipio, PR	2010	NA	9287	7879	1408	15.2
CN7203500000000	72	035	Cayey Municipio, PR	2010	NA	18187	15305	2882	15.8
CN7203700000000	72	037	Ceiba Municipio, PR	2010	NA	4676	3706	970	20.7
CN7203900000000	72	039	Ciales Municipio, PR	2010	NA	4792	3500	1292	27
CN7204100000000	72	041	Cidra Municipio, PR	2010	NA	17487	14742	2745	15.7
CN7204300000000	72	043	Coamo Municipio, PR	2010	NA	12174	9506	2668	21.9
CN7204500000000	72	045	Comerio Municipio, PR	2010	NA	5863	4560	1303	22.2
CN7204700000000	72	047	Corozal Municipio, PR	2010	NA	10186	8424	1762	17.3
CN7204900000000	72	049	Culebra Municipio, PR	2010	NA	816	733	83	10.2
CN7205100000000	72	051	Dorado Municipio, PR	2010	NA	13550	11926	1624	12
CN7205300000000	72	053	Fajardo Municipio, PR	2010	NA	13682	10938	2744	20.1
CN7205400000000	72	054	Florida Municipio, PR	2010	NA	3851	3000	851	22.1
CN7205500000000	72	055	Guanica Municipio, PR	2010	NA	5116	3808	1308	25.6
CN7205700000000	72	057	Guayama Municipio, PR	2010	NA	15004	11483	3521	23.5
CN7205900000000	72	059	Guayanilla Municipio, PR	2010	NA	6274	4744	1530	24.4
CN7206100000000	72	061	Guaynabo Municipio, PR	2010	NA	41252	37746	3506	8.5
CN7206300000000	72	063	Gurabo Municipio, PR	2010	NA	17666	15191	2475	14
CN7206500000000	72	065	Hatillo Municipio, PR	2010	NA	14036	11738	2298	16.4
CN7206700000000	72	067	Hormigueros Municipio, PR	2010	NA	6255	5232	1023	16.4
CN7206900000000	72	069	Humacao Municipio, PR	2010	NA	20230	15958	4272	21.1
CN7207100000000	72	071	Isabela Municipio, PR	2010	NA	13404	10725	2679	20
CN7207300000000	72	073	Jayuya Municipio, PR	2010	NA	5099	4103	996	19.5
CN7207500000000	72	075	Juana Diaz Municipio, PR	2010	NA	17199	14100	3099	18
CN7207700000000	72	077	Juncos Municipio, PR	2010	NA	13390	10882	2508	18.7
CN7207900000000	72	079	Lajas Municipio, PR	2010	NA	6571	5070	1501	22.8
CN7208100000000	72	081	Lares Municipio, PR	2010	NA	8052	6446	1606	19.9
CN7208300000000	72	083	Las Marias Municipio, PR	2010	NA	3670	2997	673	18.3
CN7208500000000	72	085	Las Piedras Municipio, PR	2010	NA	12271	9883	2388	19.5
CN7208700000000	72	087	Loiza Municipio, PR	2010	NA	10240	8523	1717	16.8
CN7208900000000	72	089	Luquillo Municipio, PR	2010	NA	7256	5767	1489	20.5
CN7209100000000	72	091	Manati Municipio, PR	2010	NA	13527	10982	2545	18.8
CN7209300000000	72	093	Maricao Municipio, PR	2010	NA	2324	1898	426	18.3
CN7209500000000	72	095	Maunabo Municipio, PR	2010	NA	3546	2671	875	24.7
CN7209700000000	72	097	Mayaguez Municipio, PR	2010	NA	27839	22633	5206	18.7
CN7209900000000	72	099	Moca Municipio, PR	2010	NA	12051	9598	2453	20.4
CN7210100000000	72	101	Morovis Municipio, PR	2010	NA	9287	7168	2119	22.8
CN7210300000000	72	103	Naguabo Municipio, PR	2010	NA	9099	7152	1947	21.4
CN7210500000000	72	105	Naranjito Municipio, PR	2010	NA	8239	6570	1669	20.3
CN7210700000000	72	107	Orocovis Municipio, PR	2010	NA	6089	4728	1361	22.4
CN7210900000000	72	109	Patillas Municipio, PR	2010	NA	6024	4441	1583	26.3
CN7211100000000	72	111	Penuelas Municipio, PR	2010	NA	7505	5686	1819	24.2
CN7211300000000	72	113	Ponce Municipio, PR	2010	NA	55611	46076	9535	17.1
CN7211500000000	72	115	Quebradillas Municipio, PR	2010	NA	6840	5499	1341	19.6
CN7211700000000	72	117	Rincon Municipio, PR	2010	NA	4986	4066	920	18.5
CN7211900000000	72	119	Rio Grande Municipio, PR	2010	NA	18875	15999	2876	15.2
CN7212100000000	72	121	Sabana Grande Municipio, PR	2010	NA	7532	5908	1624	21.6
CN7212300000000	72	123	Salinas Municipio, PR	2010	NA	9174	6787	2387	26
CN7212500000000	72	125	San German Municipio, PR	2010	NA	11980	9773	2207	18.4
CN7212700000000	72	127	San Juan Municipio, PR	2010	NA	155408	139469	15939	10.3
CN7212900000000	72	129	San Lorenzo Municipio, PR	2010	NA	13327	11002	2325	17.4
CN7213100000000	72	131	San Sebastian Municipio, PR	2010	NA	11855	9218	2637	22.2
CN7213300000000	72	133	Santa Isabel Municipio, PR	2010	NA	10393	8241	2152	20.7
CN7213500000000	72	135	Toa Alta Municipio, PR	2010	NA	27302	24016	3286	12
CN7213700000000	72	137	Toa Baja Municipio, PR	2010	NA	33982	29678	4304	12.7
CN7213900000000	72	139	Trujillo Alto Municipio, PR	2010	NA	30302	27126	3176	10.5
CN7214100000000	72	141	Utuado Municipio, PR	2010	NA	8113	6422	1691	20.8
CN7214300000000	72	143	Vega Alta Municipio, PR	2010	NA	10822	8963	1859	17.2
CN7214500000000	72	145	Vega Baja Municipio, PR	2010	NA	16228	12856	3372	20.8
CN7214700000000	72	147	Vieques Municipio, PR	2010	NA	3401	2767	634	18.6
CN7214900000000	72	149	Villalba Municipio, PR	2010	NA	8841	6892	1949	22
CN7215100000000	72	151	Yabucoa Municipio, PR	2010	NA	11003	8210	2793	25.4
CN7215300000000	72	153	Yauco Municipio, PR	2010	NA	12098	9514	2584	21.4
NA	NA	NA	NA	NA	NA	NA	NA	NA	NA
SOURCE:  BLS, LAUS	NA	NA	NA	NA	NA	NA	NA	NA	NA
April 17, 2020	NA	NA	NA	NA	NA	NA	NA	NA	NA
