LAUS_CODE	STATE_FIPS	COUNTY_FIPS	COUNTY	YEAR	ESTIMATED	LABOR_FORCE	EMPLOYED	UNEMPLOYED_LEVEL	UNEMPLOYED_RATE
CN0100100000000	01	001	Autauga County, AL	1990	NA	16908	15813	1095	6.5
CN0100300000000	01	003	Baldwin County, AL	1990	NA	46824	44379	2445	5.2
CN0100500000000	01	005	Barbour County, AL	1990	NA	11490	10592	898	7.8
CN0100700000000	01	007	Bibb County, AL	1990	NA	7434	6758	676	9.1
CN0100900000000	01	009	Blount County, AL	1990	NA	19168	17955	1213	6.3
CN0101100000000	01	011	Bullock County, AL	1990	NA	4407	3859	548	12.4
CN0101300000000	01	013	Butler County, AL	1990	NA	8838	7705	1133	12.8
CN0101500000000	01	015	Calhoun County, AL	1990	NA	51519	47840	3679	7.1
CN0101700000000	01	017	Chambers County, AL	1990	NA	17705	16432	1273	7.2
CN0101900000000	01	019	Cherokee County, AL	1990	NA	9644	8693	951	9.9
CN0102100000000	01	021	Chilton County, AL	1990	NA	15187	13833	1354	8.9
CN0102300000000	01	023	Choctaw County, AL	1990	NA	6711	5867	844	12.6
CN0102500000000	01	025	Clarke County, AL	1990	NA	11711	10756	955	8.2
CN0102700000000	01	027	Clay County, AL	1990	NA	6338	5889	449	7.1
CN0102900000000	01	029	Cleburne County, AL	1990	NA	6279	5868	411	6.5
CN0103100000000	01	031	Coffee County, AL	1990	NA	18836	17647	1189	6.3
CN0103300000000	01	033	Colbert County, AL	1990	NA	24501	22526	1975	8.1
CN0103500000000	01	035	Conecuh County, AL	1990	NA	5763	5202	561	9.7
CN0103700000000	01	037	Coosa County, AL	1990	NA	4983	4663	320	6.4
CN0103900000000	01	039	Covington County, AL	1990	NA	17161	15834	1327	7.7
CN0104100000000	01	041	Crenshaw County, AL	1990	NA	6082	5629	453	7.4
CN0104300000000	01	043	Cullman County, AL	1990	NA	32848	30527	2321	7.1
CN0104500000000	01	045	Dale County, AL	1990	NA	20535	19384	1151	5.6
CN0104700000000	01	047	Dallas County, AL	1990	NA	19459	17096	2363	12.1
CN0104900000000	01	049	DeKalb County, AL	1990	NA	27386	25349	2037	7.4
CN0105100000000	01	051	Elmore County, AL	1990	NA	22533	21150	1383	6.1
CN0105300000000	01	053	Escambia County, AL	1990	NA	15003	13706	1297	8.6
CN0105500000000	01	055	Etowah County, AL	1990	NA	46628	41522	5106	11
CN0105700000000	01	057	Fayette County, AL	1990	NA	8493	7658	835	9.8
CN0105900000000	01	059	Franklin County, AL	1990	NA	13641	12098	1543	11.3
CN0106100000000	01	061	Geneva County, AL	1990	NA	11109	10584	525	4.7
CN0106300000000	01	063	Greene County, AL	1990	NA	3777	3338	439	11.6
CN0106500000000	01	065	Hale County, AL	1990	NA	6204	5725	479	7.7
CN0106700000000	01	067	Henry County, AL	1990	NA	6867	6539	328	4.8
CN0106900000000	01	069	Houston County, AL	1990	NA	40846	39065	1781	4.4
CN0107100000000	01	071	Jackson County, AL	1990	NA	23677	21518	2159	9.1
CN0107300000000	01	073	Jefferson County, AL	1990	NA	311022	295321	15701	5
CN0107500000000	01	075	Lamar County, AL	1990	NA	7689	7077	612	8
CN0107700000000	01	077	Lauderdale County, AL	1990	NA	38029	35389	2640	6.9
CN0107900000000	01	079	Lawrence County, AL	1990	NA	15140	13875	1265	8.4
CN0108100000000	01	081	Lee County, AL	1990	NA	43457	40802	2655	6.1
CN0108300000000	01	083	Limestone County, AL	1990	NA	26653	24914	1739	6.5
CN0108500000000	01	085	Lowndes County, AL	1990	NA	4826	4068	758	15.7
CN0108700000000	01	087	Macon County, AL	1990	NA	9220	8396	824	8.9
CN0108900000000	01	089	Madison County, AL	1990	NA	128780	122589	6191	4.8
CN0109100000000	01	091	Marengo County, AL	1990	NA	9836	9178	658	6.7
CN0109300000000	01	093	Marion County, AL	1990	NA	14401	12374	2027	14.1
CN0109500000000	01	095	Marshall County, AL	1990	NA	35256	32102	3154	8.9
CN0109700000000	01	097	Mobile County, AL	1990	NA	171019	159194	11825	6.9
CN0109900000000	01	099	Monroe County, AL	1990	NA	10320	9236	1084	10.5
CN0110100000000	01	101	Montgomery County, AL	1990	NA	100926	94637	6289	6.2
CN0110300000000	01	103	Morgan County, AL	1990	NA	50464	47234	3230	6.4
CN0110500000000	01	105	Perry County, AL	1990	NA	4860	4229	631	13
CN0110700000000	01	107	Pickens County, AL	1990	NA	8606	7818	788	9.2
CN0110900000000	01	109	Pike County, AL	1990	NA	12309	11564	745	6.1
CN0111100000000	01	111	Randolph County, AL	1990	NA	9278	8561	717	7.7
CN0111300000000	01	113	Russell County, AL	1990	NA	21686	19926	1760	8.1
CN0111500000000	01	115	St. Clair County, AL	1990	NA	23395	22102	1293	5.5
CN0111700000000	01	117	Shelby County, AL	1990	NA	53271	51538	1733	3.3
CN0111900000000	01	119	Sumter County, AL	1990	NA	5999	5416	583	9.7
CN0112100000000	01	121	Talladega County, AL	1990	NA	33647	30550	3097	9.2
CN0112300000000	01	123	Tallapoosa County, AL	1990	NA	19241	18006	1235	6.4
CN0112500000000	01	125	Tuscaloosa County, AL	1990	NA	70025	66816	3209	4.6
CN0112700000000	01	127	Walker County, AL	1990	NA	30210	27387	2823	9.3
CN0112900000000	01	129	Washington County, AL	1990	NA	6598	5893	705	10.7
CN0113100000000	01	131	Wilcox County, AL	1990	NA	4239	3714	525	12.4
CN0113300000000	01	133	Winston County, AL	1990	NA	10482	9241	1241	11.8
CN0201300000000	02	013	Aleutians East Borough, AK	1990	NA	1303	1298	5	0.4
CN0201600000000	02	016	Aleutians West Census Area, AK	1990	NA	3542	3525	17	0.5
CN0202000000000	02	020	Anchorage Borough/municipality, AK	1990	NA	122065	115696	6369	5.2
CN0205000000000	02	050	Bethel Census Area, AK	1990	NA	4041	3748	293	7.3
CN0206000000000	02	060	Bristol Bay Borough, AK	1990	NA	473	453	20	4.2
CN0206800000000	02	068	Denali Borough, AK	1990	NA	992	860	132	13.3
CN0207000000000	02	070	Dillingham Census Area, AK	1990	NA	1212	1131	81	6.7
CN0209000000000	02	090	Fairbanks North Star Borough, AK	1990	NA	35580	32503	3077	8.6
CN0210000000000	02	100	Haines Borough, AK	1990	NA	1084	1006	78	7.2
CN0211000000000	02	110	Juneau Borough/city, AK	1990	NA	15089	14298	791	5.2
CN0212200000000	02	122	Kenai Peninsula Borough, AK	1990	NA	18799	16546	2253	12
CN0213000000000	02	130	Ketchikan Gateway Borough, AK	1990	NA	7432	6845	587	7.9
CN0215000000000	02	150	Kodiak Island Borough, AK	1990	NA	6300	5964	336	5.3
CN0215800000000	02	158	Kusilvak Census Area, AK	1990	NA	1365	1200	165	12.1
CN0216400000000	02	164	Lake and Peninsula Borough, AK	1990	NA	441	414	27	6.1
CN0217000000000	02	170	Matanuska-Susitna Borough, AK	1990	NA	17861	15691	2170	12.1
CN0218000000000	02	180	Nome Census Area, AK	1990	NA	3157	2867	290	9.2
CN0218500000000	02	185	North Slope Borough, AK	1990	NA	2797	2696	101	3.6
CN0218800000000	02	188	Northwest Arctic Borough, AK	1990	NA	2105	1791	314	14.9
CN0220100000000	02	201	Prince of Wales-Outer Ketchikan Census Area, AK	1990	NA	2883	2563	320	11.1
CN0222000000000	02	220	Sitka Borough/city, AK	1990	NA	4463	4232	231	5.2
CN0223200000000	02	232	Skagway-Hoonah-Angoon Census Area, AK	1990	NA	2506	2247	259	10.3
CN0224000000000	02	240	Southeast Fairbanks Census Area, AK	1990	NA	2228	1944	284	12.7
CN0226100000000	02	261	Valdez-Cordova Census Area, AK	1990	NA	5170	4585	585	11.3
CN0228000000000	02	280	Wrangell-Petersburg Census Area, AK	1990	NA	3589	3274	315	8.8
CN0229000000000	02	290	Yukon-Koyukuk Census Area, AK	1990	NA	1945	1662	283	14.6
CN0400100000000	04	001	Apache County, AZ	1990	NA	17290	15029	2261	13.1
CN0400300000000	04	003	Cochise County, AZ	1990	NA	36825	34446	2379	6.5
CN0400500000000	04	005	Coconino County, AZ	1990	NA	48124	44510	3614	7.5
CN0400700000000	04	007	Gila County, AZ	1990	NA	15555	14406	1149	7.4
CN0400900000000	04	009	Graham County, AZ	1990	NA	8998	8366	632	7
CN0401100000000	04	011	Greenlee County, AZ	1990	NA	3375	3154	221	6.5
CN0401200000000	04	012	La Paz County, AZ	1990	NA	5444	5074	370	6.8
CN0401300000000	04	013	Maricopa County, AZ	1990	NA	1115127	1067092	48035	4.3
CN0401500000000	04	015	Mohave County, AZ	1990	NA	44563	42396	2167	4.9
CN0401700000000	04	017	Navajo County, AZ	1990	NA	26437	23572	2865	10.8
CN0401900000000	04	019	Pima County, AZ	1990	NA	314226	299908	14318	4.6
CN0402100000000	04	021	Pinal County, AZ	1990	NA	45487	42655	2832	6.2
CN0402300000000	04	023	Santa Cruz County, AZ	1990	NA	12810	11080	1730	13.5
CN0402500000000	04	025	Yavapai County, AZ	1990	NA	44961	42926	2035	4.5
CN0402700000000	04	027	Yuma County, AZ	1990	NA	46964	37263	9701	20.7
CN0500100000000	05	001	Arkansas County, AR	1990	NA	10236	9754	482	4.7
CN0500300000000	05	003	Ashley County, AR	1990	NA	10961	10305	656	6
CN0500500000000	05	005	Baxter County, AR	1990	NA	11933	11208	725	6.1
CN0500700000000	05	007	Benton County, AR	1990	NA	49044	47259	1785	3.6
CN0500900000000	05	009	Boone County, AR	1990	NA	13887	13099	788	5.7
CN0501100000000	05	011	Bradley County, AR	1990	NA	5202	4711	491	9.4
CN0501300000000	05	013	Calhoun County, AR	1990	NA	2641	2334	307	11.6
CN0501500000000	05	015	Carroll County, AR	1990	NA	9949	9355	594	6
CN0501700000000	05	017	Chicot County, AR	1990	NA	5992	5365	627	10.5
CN0501900000000	05	019	Clark County, AR	1990	NA	10017	9269	748	7.5
CN0502100000000	05	021	Clay County, AR	1990	NA	8146	7574	572	7
CN0502300000000	05	023	Cleburne County, AR	1990	NA	8755	8137	618	7.1
CN0502500000000	05	025	Cleveland County, AR	1990	NA	3511	3273	238	6.8
CN0502700000000	05	027	Columbia County, AR	1990	NA	11840	10958	882	7.4
CN0502900000000	05	029	Conway County, AR	1990	NA	8962	8400	562	6.3
CN0503100000000	05	031	Craighead County, AR	1990	NA	37054	34882	2172	5.9
CN0503300000000	05	033	Crawford County, AR	1990	NA	21019	19264	1755	8.3
CN0503500000000	05	035	Crittenden County, AR	1990	NA	22821	21114	1707	7.5
CN0503700000000	05	037	Cross County, AR	1990	NA	8568	7848	720	8.4
CN0503900000000	05	039	Dallas County, AR	1990	NA	4255	3897	358	8.4
CN0504100000000	05	041	Desha County, AR	1990	NA	6877	6156	721	10.5
CN0504300000000	05	043	Drew County, AR	1990	NA	8648	7883	765	8.8
CN0504500000000	05	045	Faulkner County, AR	1990	NA	32081	29731	2350	7.3
CN0504700000000	05	047	Franklin County, AR	1990	NA	7181	6594	587	8.2
CN0504900000000	05	049	Fulton County, AR	1990	NA	4048	3794	254	6.3
CN0505100000000	05	051	Garland County, AR	1990	NA	32255	30115	2140	6.6
CN0505300000000	05	053	Grant County, AR	1990	NA	6859	6506	353	5.1
CN0505500000000	05	055	Greene County, AR	1990	NA	15650	14561	1089	7
CN0505700000000	05	057	Hempstead County, AR	1990	NA	10269	9362	907	8.8
CN0505900000000	05	059	Hot Spring County, AR	1990	NA	11496	10476	1020	8.9
CN0506100000000	05	061	Howard County, AR	1990	NA	6569	6041	528	8
CN0506300000000	05	063	Independence County, AR	1990	NA	15712	14569	1143	7.3
CN0506500000000	05	065	Izard County, AR	1990	NA	4551	4317	234	5.1
CN0506700000000	05	067	Jackson County, AR	1990	NA	8438	7468	970	11.5
CN0506900000000	05	069	Jefferson County, AR	1990	NA	38254	34788	3466	9.1
CN0507100000000	05	071	Johnson County, AR	1990	NA	8227	7543	684	8.3
CN0507300000000	05	073	Lafayette County, AR	1990	NA	3713	3434	279	7.5
CN0507500000000	05	075	Lawrence County, AR	1990	NA	7789	6948	841	10.8
CN0507700000000	05	077	Lee County, AR	1990	NA	4629	4082	547	11.8
CN0507900000000	05	079	Lincoln County, AR	1990	NA	4682	4318	364	7.8
CN0508100000000	05	081	Little River County, AR	1990	NA	7186	6857	329	4.6
CN0508300000000	05	083	Logan County, AR	1990	NA	9293	8702	591	6.4
CN0508500000000	05	085	Lonoke County, AR	1990	NA	19736	18555	1181	6
CN0508700000000	05	087	Madison County, AR	1990	NA	6041	5751	290	4.8
CN0508900000000	05	089	Marion County, AR	1990	NA	4938	4595	343	6.9
CN0509100000000	05	091	Miller County, AR	1990	NA	17158	16124	1034	6
CN0509300000000	05	093	Mississippi County, AR	1990	NA	24993	22622	2371	9.5
CN0509500000000	05	095	Monroe County, AR	1990	NA	4466	4123	343	7.7
CN0509700000000	05	097	Montgomery County, AR	1990	NA	3395	3268	127	3.7
CN0509900000000	05	099	Nevada County, AR	1990	NA	4627	4145	482	10.4
CN0510100000000	05	101	Newton County, AR	1990	NA	2986	2746	240	8
CN0510300000000	05	103	Ouachita County, AR	1990	NA	14675	12637	2038	13.9
CN0510500000000	05	105	Perry County, AR	1990	NA	3789	3477	312	8.2
CN0510700000000	05	107	Phillips County, AR	1990	NA	10678	9487	1191	11.2
CN0510900000000	05	109	Pike County, AR	1990	NA	4640	4192	448	9.7
CN0511100000000	05	111	Poinsett County, AR	1990	NA	11278	10181	1097	9.7
CN0511300000000	05	113	Polk County, AR	1990	NA	7730	7366	364	4.7
CN0511500000000	05	115	Pope County, AR	1990	NA	23707	22176	1531	6.5
CN0511700000000	05	117	Prairie County, AR	1990	NA	4380	4096	284	6.5
CN0511900000000	05	119	Pulaski County, AR	1990	NA	187172	176954	10218	5.5
CN0512100000000	05	121	Randolph County, AR	1990	NA	7311	6620	691	9.5
CN0512300000000	05	123	St. Francis County, AR	1990	NA	11533	10176	1357	11.8
CN0512500000000	05	125	Saline County, AR	1990	NA	33735	31839	1896	5.6
CN0512700000000	05	127	Scott County, AR	1990	NA	4745	4417	328	6.9
CN0512900000000	05	129	Searcy County, AR	1990	NA	3195	2915	280	8.8
CN0513100000000	05	131	Sebastian County, AR	1990	NA	52748	48914	3834	7.3
CN0513300000000	05	133	Sevier County, AR	1990	NA	6465	6184	281	4.3
CN0513500000000	05	135	Sharp County, AR	1990	NA	5031	4651	380	7.6
CN0513700000000	05	137	Stone County, AR	1990	NA	4376	4069	307	7
CN0513900000000	05	139	Union County, AR	1990	NA	20893	19437	1456	7
CN0514100000000	05	141	Van Buren County, AR	1990	NA	5596	5087	509	9.1
CN0514300000000	05	143	Washington County, AR	1990	NA	61413	59077	2336	3.8
CN0514500000000	05	145	White County, AR	1990	NA	26461	23862	2599	9.8
CN0514700000000	05	147	Woodruff County, AR	1990	NA	4065	3637	428	10.5
CN0514900000000	05	149	Yell County, AR	1990	NA	8680	8204	476	5.5
CN0600100000000	06	001	Alameda County, CA	1990	NA	677363	649906	27457	4.1
CN0600300000000	06	003	Alpine County, CA	1990	NA	375	339	36	9.6
CN0600500000000	06	005	Amador County, CA	1990	NA	11454	10860	594	5.2
CN0600700000000	06	007	Butte County, CA	1990	NA	78802	72166	6636	8.4
CN0600900000000	06	009	Calaveras County, CA	1990	NA	13447	12530	917	6.8
CN0601100000000	06	011	Colusa County, CA	1990	NA	8007	6863	1144	14.3
CN0601300000000	06	013	Contra Costa County, CA	1990	NA	435286	417800	17486	4
CN0601500000000	06	015	Del Norte County, CA	1990	NA	9609	8451	1158	12.1
CN0601700000000	06	017	El Dorado County, CA	1990	NA	63836	60985	2851	4.5
CN0601900000000	06	019	Fresno County, CA	1990	NA	328726	290446	38280	11.6
CN0602100000000	06	021	Glenn County, CA	1990	NA	11251	9846	1405	12.5
CN0602300000000	06	023	Humboldt County, CA	1990	NA	56261	51806	4455	7.9
CN0602500000000	06	025	Imperial County, CA	1990	NA	47316	35250	12066	25.5
CN0602700000000	06	027	Inyo County, CA	1990	NA	7011	6510	501	7.1
CN0602900000000	06	029	Kern County, CA	1990	NA	256820	228826	27994	10.9
CN0603100000000	06	031	Kings County, CA	1990	NA	37576	33354	4222	11.2
CN0603300000000	06	033	Lake County, CA	1990	NA	19974	18201	1773	8.9
CN0603500000000	06	035	Lassen County, CA	1990	NA	9981	9000	981	9.8
CN0603700000000	06	037	Los Angeles County, CA	1990	NA	4498714	4233137	265577	5.9
CN0603900000000	06	039	Madera County, CA	1990	NA	41555	35949	5606	13.5
CN0604100000000	06	041	Marin County, CA	1990	NA	131883	128558	3325	2.5
CN0604300000000	06	043	Mariposa County, CA	1990	NA	6775	6391	384	5.7
CN0604500000000	06	045	Mendocino County, CA	1990	NA	38746	35789	2957	7.6
CN0604700000000	06	047	Merced County, CA	1990	NA	76906	67023	9883	12.9
CN0604900000000	06	049	Modoc County, CA	1990	NA	3763	3400	363	9.6
CN0605100000000	06	051	Mono County, CA	1990	NA	5719	5380	339	5.9
CN0605300000000	06	053	Monterey County, CA	1990	NA	172728	156047	16681	9.7
CN0605500000000	06	055	Napa County, CA	1990	NA	56419	54087	2332	4.1
CN0605700000000	06	057	Nevada County, CA	1990	NA	36028	34296	1732	4.8
CN0605900000000	06	059	Orange County, CA	1990	NA	1352949	1305680	47269	3.5
CN0606100000000	06	061	Placer County, CA	1990	NA	89541	85760	3781	4.2
CN0606300000000	06	063	Plumas County, CA	1990	NA	9470	8530	940	9.9
CN0606500000000	06	065	Riverside County, CA	1990	NA	536605	498129	38476	7.2
CN0606700000000	06	067	Sacramento County, CA	1990	NA	522264	498324	23940	4.6
CN0606900000000	06	069	San Benito County, CA	1990	NA	20941	18391	2550	12.2
CN0607100000000	06	071	San Bernardino County, CA	1990	NA	635154	599384	35770	5.6
CN0607300000000	06	073	San Diego County, CA	1990	NA	1215062	1158861	56201	4.6
CN0607500000000	06	075	San Francisco County/city, CA	1990	NA	409356	393929	15427	3.8
CN0607700000000	06	077	San Joaquin County, CA	1990	NA	227060	204547	22513	9.9
CN0607900000000	06	079	San Luis Obispo County, CA	1990	NA	99766	95144	4622	4.6
CN0608100000000	06	081	San Mateo County, CA	1990	NA	370206	360492	9714	2.6
CN0608300000000	06	083	Santa Barbara County, CA	1990	NA	192547	183121	9426	4.9
CN0608500000000	06	085	Santa Clara County, CA	1990	NA	852348	818551	33797	4
CN0608700000000	06	087	Santa Cruz County, CA	1990	NA	135694	125920	9774	7.2
CN0608900000000	06	089	Shasta County, CA	1990	NA	67692	61850	5842	8.6
CN0609100000000	06	091	Sierra County, CA	1990	NA	1628	1451	177	10.9
CN0609300000000	06	093	Siskiyou County, CA	1990	NA	19437	17066	2371	12.2
CN0609500000000	06	095	Solano County, CA	1990	NA	164884	156976	7908	4.8
CN0609700000000	06	097	Sonoma County, CA	1990	NA	206269	198268	8001	3.9
CN0609900000000	06	099	Stanislaus County, CA	1990	NA	180443	159054	21389	11.9
CN0610100000000	06	101	Sutter County, CA	1990	NA	33135	28457	4678	14.1
CN0610300000000	06	103	Tehama County, CA	1990	NA	19924	17930	1994	10
CN0610500000000	06	105	Trinity County, CA	1990	NA	5344	4677	667	12.5
CN0610700000000	06	107	Tulare County, CA	1990	NA	145783	127785	17998	12.3
CN0610900000000	06	109	Tuolumne County, CA	1990	NA	19871	18532	1339	6.7
CN0611100000000	06	111	Ventura County, CA	1990	NA	366564	345433	21131	5.8
CN0611300000000	06	113	Yolo County, CA	1990	NA	74016	68936	5080	6.9
CN0611500000000	06	115	Yuba County, CA	1990	NA	22146	19785	2361	10.7
CN0800100000000	08	001	Adams County, CO	1990	NA	140544	132385	8159	5.8
CN0800300000000	08	003	Alamosa County, CO	1990	NA	6736	6243	493	7.3
CN0800500000000	08	005	Arapahoe County, CO	1990	NA	224903	216329	8574	3.8
CN0800700000000	08	007	Archuleta County, CO	1990	NA	2681	2542	139	5.2
CN0800900000000	08	009	Baca County, CO	1990	NA	2024	1985	39	1.9
CN0801100000000	08	011	Bent County, CO	1990	NA	2072	2002	70	3.4
CN0801300000000	08	013	Boulder County, CO	1990	NA	124316	118199	6117	4.9
CN0801400000000	08	014	Broomfield County/city, CO	1990	NA	14229	13705	524	3.7
CN0801500000000	08	015	Chaffee County, CO	1990	NA	5838	5436	402	6.9
CN0801700000000	08	017	Cheyenne County, CO	1990	NA	1177	1162	15	1.3
CN0801900000000	08	019	Clear Creek County, CO	1990	NA	4436	4258	178	4
CN0802100000000	08	021	Conejos County, CO	1990	NA	3120	2747	373	12
CN0802300000000	08	023	Costilla County, CO	1990	NA	1409	1258	151	10.7
CN0802500000000	08	025	Crowley County, CO	1990	NA	1140	1094	46	4
CN0802700000000	08	027	Custer County, CO	1990	NA	892	851	41	4.6
CN0802900000000	08	029	Delta County, CO	1990	NA	8534	7929	605	7.1
CN0803100000000	08	031	Denver County/city, CO	1990	NA	252157	237926	14231	5.6
CN0803300000000	08	033	Dolores County, CO	1990	NA	668	636	32	4.8
CN0803500000000	08	035	Douglas County, CO	1990	NA	35396	34277	1119	3.2
CN0803700000000	08	037	Eagle County, CO	1990	NA	12519	12065	454	3.6
CN0803900000000	08	039	Elbert County, CO	1990	NA	5509	5285	224	4.1
CN0804100000000	08	041	El Paso County, CO	1990	NA	190940	177214	13726	7.2
CN0804300000000	08	043	Fremont County, CO	1990	NA	12933	12089	844	6.5
CN0804500000000	08	045	Garfield County, CO	1990	NA	16707	16016	691	4.1
CN0804700000000	08	047	Gilpin County, CO	1990	NA	2391	2332	59	2.5
CN0804900000000	08	049	Grand County, CO	1990	NA	4317	4182	135	3.1
CN0805100000000	08	051	Gunnison County, CO	1990	NA	6007	5562	445	7.4
CN0805300000000	08	053	Hinsdale County, CO	1990	NA	404	394	10	2.5
CN0805500000000	08	055	Huerfano County, CO	1990	NA	2532	2327	205	8.1
CN0805700000000	08	057	Jackson County, CO	1990	NA	886	860	26	2.9
CN0805900000000	08	059	Jefferson County, CO	1990	NA	255424	245533	9891	3.9
CN0806100000000	08	061	Kiowa County, CO	1990	NA	798	777	21	2.6
CN0806300000000	08	063	Kit Carson County, CO	1990	NA	3320	3279	41	1.2
CN0806500000000	08	065	Lake County, CO	1990	NA	2826	2651	175	6.2
CN0806700000000	08	067	La Plata County, CO	1990	NA	17396	16358	1038	6
CN0806900000000	08	069	Larimer County, CO	1990	NA	103854	98713	5141	5
CN0807100000000	08	071	Las Animas County, CO	1990	NA	5508	5050	458	8.3
CN0807300000000	08	073	Lincoln County, CO	1990	NA	2212	2152	60	2.7
CN0807500000000	08	075	Logan County, CO	1990	NA	8765	8456	309	3.5
CN0807700000000	08	077	Mesa County, CO	1990	NA	44712	42012	2700	6
CN0807900000000	08	079	Mineral County, CO	1990	NA	299	278	21	7
CN0808100000000	08	081	Moffat County, CO	1990	NA	5930	5589	341	5.8
CN0808300000000	08	083	Montezuma County, CO	1990	NA	9239	8554	685	7.4
CN0808500000000	08	085	Montrose County, CO	1990	NA	11664	10916	748	6.4
CN0808700000000	08	087	Morgan County, CO	1990	NA	10313	9845	468	4.5
CN0808900000000	08	089	Otero County, CO	1990	NA	8468	7857	611	7.2
CN0809100000000	08	091	Ouray County, CO	1990	NA	1234	1112	122	9.9
CN0809300000000	08	093	Park County, CO	1990	NA	4529	4356	173	3.8
CN0809500000000	08	095	Phillips County, CO	1990	NA	1836	1808	28	1.5
CN0809700000000	08	097	Pitkin County, CO	1990	NA	8125	7688	437	5.4
CN0809900000000	08	099	Prowers County, CO	1990	NA	6159	5816	343	5.6
CN0810100000000	08	101	Pueblo County, CO	1990	NA	52373	48542	3831	7.3
CN0810300000000	08	103	Rio Blanco County, CO	1990	NA	3175	3039	136	4.3
CN0810500000000	08	105	Rio Grande County, CO	1990	NA	5025	4518	507	10.1
CN0810700000000	08	107	Routt County, CO	1990	NA	8244	7892	352	4.3
CN0810900000000	08	109	Saguache County, CO	1990	NA	2259	1986	273	12.1
CN0811100000000	08	111	San Juan County, CO	1990	NA	465	428	37	8
CN0811300000000	08	113	San Miguel County, CO	1990	NA	2449	2323	126	5.1
CN0811500000000	08	115	Sedgwick County, CO	1990	NA	1276	1253	23	1.8
CN0811700000000	08	117	Summit County, CO	1990	NA	8110	7812	298	3.7
CN0811900000000	08	119	Teller County, CO	1990	NA	7476	7134	342	4.6
CN0812100000000	08	121	Washington County, CO	1990	NA	2209	2164	45	2
CN0812300000000	08	123	Weld County, CO	1990	NA	66589	62720	3869	5.8
CN0812500000000	08	125	Yuma County, CO	1990	NA	4011	3924	87	2.2
CN0900100000000	09	001	Fairfield County, CT	1990	NA	462016	440284	21732	4.7
CN0900300000000	09	003	Hartford County, CT	1990	NA	470096	445877	24219	5.2
CN0900500000000	09	005	Litchfield County, CT	1990	NA	102033	97195	4838	4.7
CN0900700000000	09	007	Middlesex County, CT	1990	NA	83647	80219	3428	4.1
CN0900900000000	09	009	New Haven County, CT	1990	NA	440366	415798	24568	5.6
CN0901100000000	09	011	New London County, CT	1990	NA	131330	123815	7515	5.7
CN0901300000000	09	013	Tolland County, CT	1990	NA	74678	71674	3004	4
CN0901500000000	09	015	Windham County, CT	1990	NA	55602	51615	3987	7.2
CN1000100000000	10	001	Kent County, DE	1990	NA	58471	55767	2704	4.6
CN1000300000000	10	003	New Castle County, DE	1990	NA	239994	227780	12214	5.1
CN1000500000000	10	005	Sussex County, DE	1990	NA	61759	59653	2106	3.4
CN1100100000000	11	001	District of Columbia	1990	NA	328924	308281	20643	6.3
CN1200100000000	12	001	Alachua County, FL	1990	NA	94191	90789	3402	3.6
CN1200300000000	12	003	Baker County, FL	1990	NA	8076	7485	591	7.3
CN1200500000000	12	005	Bay County, FL	1990	NA	61479	55866	5613	9.1
CN1200700000000	12	007	Bradford County, FL	1990	NA	9264	8844	420	4.5
CN1200900000000	12	009	Brevard County, FL	1990	NA	205653	194451	11202	5.4
CN1201100000000	12	011	Broward County, FL	1990	NA	668642	629862	38780	5.8
CN1201300000000	12	013	Calhoun County, FL	1990	NA	4497	4168	329	7.3
CN1201500000000	12	015	Charlotte County, FL	1990	NA	41739	39731	2008	4.8
CN1201700000000	12	017	Citrus County, FL	1990	NA	33176	30451	2725	8.2
CN1201900000000	12	019	Clay County, FL	1990	NA	54151	51788	2363	4.4
CN1202100000000	12	021	Collier County, FL	1990	NA	73480	69442	4038	5.5
CN1202300000000	12	023	Columbia County, FL	1990	NA	20309	18565	1744	8.6
CN1202700000000	12	027	DeSoto County, FL	1990	NA	9746	9044	702	7.2
CN1202900000000	12	029	Dixie County, FL	1990	NA	3802	3518	284	7.5
CN1203100000000	12	031	Duval County, FL	1990	NA	353287	334446	18841	5.3
CN1203300000000	12	033	Escambia County, FL	1990	NA	121742	114649	7093	5.8
CN1203500000000	12	035	Flagler County, FL	1990	NA	11820	11076	744	6.3
CN1203700000000	12	037	Franklin County, FL	1990	NA	3887	3675	212	5.5
CN1203900000000	12	039	Gadsden County, FL	1990	NA	18119	17204	915	5
CN1204100000000	12	041	Gilchrist County, FL	1990	NA	4034	3718	316	7.8
CN1204300000000	12	043	Glades County, FL	1990	NA	3237	2893	344	10.6
CN1204500000000	12	045	Gulf County, FL	1990	NA	5316	4962	354	6.7
CN1204700000000	12	047	Hamilton County, FL	1990	NA	4206	3869	337	8
CN1204900000000	12	049	Hardee County, FL	1990	NA	9272	8179	1093	11.8
CN1205100000000	12	051	Hendry County, FL	1990	NA	12971	11242	1729	13.3
CN1205300000000	12	053	Hernando County, FL	1990	NA	36327	33655	2672	7.4
CN1205500000000	12	055	Highlands County, FL	1990	NA	25951	23615	2336	9
CN1205700000000	12	057	Hillsborough County, FL	1990	NA	456029	433823	22206	4.9
CN1205900000000	12	059	Holmes County, FL	1990	NA	6774	6304	470	6.9
CN1206100000000	12	061	Indian River County, FL	1990	NA	41314	36566	4748	11.5
CN1206300000000	12	063	Jackson County, FL	1990	NA	18820	17699	1121	6
CN1206500000000	12	065	Jefferson County, FL	1990	NA	5299	5074	225	4.2
CN1206700000000	12	067	Lafayette County, FL	1990	NA	2334	2198	136	5.8
CN1206900000000	12	069	Lake County, FL	1990	NA	66829	61369	5460	8.2
CN1207100000000	12	071	Lee County, FL	1990	NA	155371	149321	6050	3.9
CN1207300000000	12	073	Leon County, FL	1990	NA	113420	109740	3680	3.2
CN1207500000000	12	075	Levy County, FL	1990	NA	10693	10097	596	5.6
CN1207700000000	12	077	Liberty County, FL	1990	NA	2216	2128	88	4
CN1207900000000	12	079	Madison County, FL	1990	NA	7065	6439	626	8.9
CN1208100000000	12	081	Manatee County, FL	1990	NA	95658	91843	3815	4
CN1208300000000	12	083	Marion County, FL	1990	NA	83776	78711	5065	6
CN1208500000000	12	085	Martin County, FL	1990	NA	45647	42205	3442	7.5
CN1208600000000	12	086	Miami-Dade County, FL	1990	NA	979215	906577	72638	7.4
CN1208700000000	12	087	Monroe County, FL	1990	NA	41050	39954	1096	2.7
CN1208900000000	12	089	Nassau County, FL	1990	NA	22762	21443	1319	5.8
CN1209100000000	12	091	Okaloosa County, FL	1990	NA	66194	62283	3911	5.9
CN1209300000000	12	093	Okeechobee County, FL	1990	NA	13774	12624	1150	8.3
CN1209500000000	12	095	Orange County, FL	1990	NA	393649	371771	21878	5.6
CN1209700000000	12	097	Osceola County, FL	1990	NA	59082	56163	2919	4.9
CN1209900000000	12	099	Palm Beach County, FL	1990	NA	434048	402576	31472	7.3
CN1210100000000	12	101	Pasco County, FL	1990	NA	109699	102820	6879	6.3
CN1210300000000	12	103	Pinellas County, FL	1990	NA	422736	402986	19750	4.7
CN1210500000000	12	105	Polk County, FL	1990	NA	202034	181476	20558	10.2
CN1210700000000	12	107	Putnam County, FL	1990	NA	26315	24649	1666	6.3
CN1210900000000	12	109	St. Johns County, FL	1990	NA	44284	41996	2288	5.2
CN1211100000000	12	111	St. Lucie County, FL	1990	NA	72527	63089	9438	13
CN1211300000000	12	113	Santa Rosa County, FL	1990	NA	39199	37037	2162	5.5
CN1211500000000	12	115	Sarasota County, FL	1990	NA	124304	119626	4678	3.8
CN1211700000000	12	117	Seminole County, FL	1990	NA	169768	160689	9079	5.3
CN1211900000000	12	119	Sumter County, FL	1990	NA	12298	11336	962	7.8
CN1212100000000	12	121	Suwannee County, FL	1990	NA	12065	11108	957	7.9
CN1212300000000	12	123	Taylor County, FL	1990	NA	8314	7312	1002	12.1
CN1212500000000	12	125	Union County, FL	1990	NA	3755	3564	191	5.1
CN1212700000000	12	127	Volusia County, FL	1990	NA	169196	160418	8778	5.2
CN1212900000000	12	129	Wakulla County, FL	1990	NA	7868	7564	304	3.9
CN1213100000000	12	131	Walton County, FL	1990	NA	12984	12149	835	6.4
CN1213300000000	12	133	Washington County, FL	1990	NA	7439	6924	515	6.9
CN1300100000000	13	001	Appling County, GA	1990	NA	7465	6567	898	12
CN1300300000000	13	003	Atkinson County, GA	1990	NA	2755	2548	207	7.5
CN1300500000000	13	005	Bacon County, GA	1990	NA	4395	4134	261	5.9
CN1300700000000	13	007	Baker County, GA	1990	NA	1575	1493	82	5.2
CN1300900000000	13	009	Baldwin County, GA	1990	NA	16772	16071	701	4.2
CN1301100000000	13	011	Banks County, GA	1990	NA	5564	5267	297	5.3
CN1301300000000	13	013	Barrow County, GA	1990	NA	15209	14033	1176	7.7
CN1301500000000	13	015	Bartow County, GA	1990	NA	29766	27601	2165	7.3
CN1301700000000	13	017	Ben Hill County, GA	1990	NA	7207	6752	455	6.3
CN1301900000000	13	019	Berrien County, GA	1990	NA	6929	6423	506	7.3
CN1302100000000	13	021	Bibb County, GA	1990	NA	69366	65841	3525	5.1
CN1302300000000	13	023	Bleckley County, GA	1990	NA	4889	4605	284	5.8
CN1302500000000	13	025	Brantley County, GA	1990	NA	4782	4375	407	8.5
CN1302700000000	13	027	Brooks County, GA	1990	NA	6377	6140	237	3.7
CN1302900000000	13	029	Bryan County, GA	1990	NA	7088	6773	315	4.4
CN1303100000000	13	031	Bulloch County, GA	1990	NA	19580	18549	1031	5.3
CN1303300000000	13	033	Burke County, GA	1990	NA	8649	7711	938	10.8
CN1303500000000	13	035	Butts County, GA	1990	NA	6456	6020	436	6.8
CN1303700000000	13	037	Calhoun County, GA	1990	NA	2083	1967	116	5.6
CN1303900000000	13	039	Camden County, GA	1990	NA	11549	10932	617	5.3
CN1304300000000	13	043	Candler County, GA	1990	NA	3485	3310	175	5
CN1304500000000	13	045	Carroll County, GA	1990	NA	36659	34401	2258	6.2
CN1304700000000	13	047	Catoosa County, GA	1990	NA	21247	20272	975	4.6
CN1304900000000	13	049	Charlton County, GA	1990	NA	3536	3364	172	4.9
CN1305100000000	13	051	Chatham County, GA	1990	NA	100184	95519	4665	4.7
CN1305300000000	13	053	Chattahoochee County, GA	1990	NA	2251	2017	234	10.4
CN1305500000000	13	055	Chattooga County, GA	1990	NA	10686	9893	793	7.4
CN1305700000000	13	057	Cherokee County, GA	1990	NA	50991	48867	2124	4.2
CN1305900000000	13	059	Clarke County, GA	1990	NA	43287	40755	2532	5.8
CN1306100000000	13	061	Clay County, GA	1990	NA	1320	1258	62	4.7
CN1306300000000	13	063	Clayton County, GA	1990	NA	102614	97087	5527	5.4
CN1306500000000	13	065	Clinch County, GA	1990	NA	2566	2437	129	5
CN1306700000000	13	067	Cobb County, GA	1990	NA	265592	254819	10773	4.1
CN1306900000000	13	069	Coffee County, GA	1990	NA	14339	13303	1036	7.2
CN1307100000000	13	071	Colquitt County, GA	1990	NA	16579	15709	870	5.2
CN1307300000000	13	073	Columbia County, GA	1990	NA	34576	33429	1147	3.3
CN1307500000000	13	075	Cook County, GA	1990	NA	6335	5931	404	6.4
CN1307700000000	13	077	Coweta County, GA	1990	NA	27559	25950	1609	5.8
CN1307900000000	13	079	Crawford County, GA	1990	NA	4278	3989	289	6.8
CN1308100000000	13	081	Crisp County, GA	1990	NA	8658	8056	602	7
CN1308300000000	13	083	Dade County, GA	1990	NA	6229	5859	370	5.9
CN1308500000000	13	085	Dawson County, GA	1990	NA	5225	4960	265	5.1
CN1308700000000	13	087	Decatur County, GA	1990	NA	10997	10515	482	4.4
CN1308900000000	13	089	DeKalb County, GA	1990	NA	316619	300964	15655	4.9
CN1309100000000	13	091	Dodge County, GA	1990	NA	7598	7143	455	6
CN1309300000000	13	093	Dooly County, GA	1990	NA	3963	3717	246	6.2
CN1309500000000	13	095	Dougherty County, GA	1990	NA	42489	39200	3289	7.7
CN1309700000000	13	097	Douglas County, GA	1990	NA	39551	37693	1858	4.7
CN1309900000000	13	099	Early County, GA	1990	NA	5109	4796	313	6.1
CN1310100000000	13	101	Echols County, GA	1990	NA	1036	985	51	4.9
CN1310300000000	13	103	Effingham County, GA	1990	NA	12271	11801	470	3.8
CN1310500000000	13	105	Elbert County, GA	1990	NA	8938	8200	738	8.3
CN1310700000000	13	107	Emanuel County, GA	1990	NA	8878	8056	822	9.3
CN1310900000000	13	109	Evans County, GA	1990	NA	3867	3707	160	4.1
CN1311100000000	13	111	Fannin County, GA	1990	NA	6944	6402	542	7.8
CN1311300000000	13	113	Fayette County, GA	1990	NA	33372	32275	1097	3.3
CN1311500000000	13	115	Floyd County, GA	1990	NA	42150	38895	3255	7.7
CN1311700000000	13	117	Forsyth County, GA	1990	NA	24750	23624	1126	4.5
CN1311900000000	13	119	Franklin County, GA	1990	NA	8248	7589	659	8
CN1312100000000	13	121	Fulton County, GA	1990	NA	339328	320341	18987	5.6
CN1312300000000	13	123	Gilmer County, GA	1990	NA	6625	6134	491	7.4
CN1312500000000	13	125	Glascock County, GA	1990	NA	1118	1052	66	5.9
CN1312700000000	13	127	Glynn County, GA	1990	NA	30463	29139	1324	4.3
CN1312900000000	13	129	Gordon County, GA	1990	NA	18945	17476	1469	7.8
CN1313100000000	13	131	Grady County, GA	1990	NA	9373	8907	466	5
CN1313300000000	13	133	Greene County, GA	1990	NA	5190	4836	354	6.8
CN1313500000000	13	135	Gwinnett County, GA	1990	NA	214380	205504	8876	4.1
CN1313700000000	13	137	Habersham County, GA	1990	NA	14058	13328	730	5.2
CN1313900000000	13	139	Hall County, GA	1990	NA	52512	49604	2908	5.5
CN1314100000000	13	141	Hancock County, GA	1990	NA	3616	3386	230	6.4
CN1314300000000	13	143	Haralson County, GA	1990	NA	10386	9667	719	6.9
CN1314500000000	13	145	Harris County, GA	1990	NA	8660	8214	446	5.2
CN1314700000000	13	147	Hart County, GA	1990	NA	9715	9109	606	6.2
CN1314900000000	13	149	Heard County, GA	1990	NA	3955	3750	205	5.2
CN1315100000000	13	151	Henry County, GA	1990	NA	32248	30764	1484	4.6
CN1315300000000	13	153	Houston County, GA	1990	NA	42725	41005	1720	4
CN1315500000000	13	155	Irwin County, GA	1990	NA	3880	3652	228	5.9
CN1315700000000	13	157	Jackson County, GA	1990	NA	15044	14090	954	6.3
CN1315900000000	13	159	Jasper County, GA	1990	NA	3830	3604	226	5.9
CN1316100000000	13	161	Jeff Davis County, GA	1990	NA	5845	5467	378	6.5
CN1316300000000	13	163	Jefferson County, GA	1990	NA	7468	6867	601	8
CN1316500000000	13	165	Jenkins County, GA	1990	NA	3552	3200	352	9.9
CN1316700000000	13	167	Johnson County, GA	1990	NA	3668	3422	246	6.7
CN1316900000000	13	169	Jones County, GA	1990	NA	10607	10168	439	4.1
CN1317100000000	13	171	Lamar County, GA	1990	NA	6148	5824	324	5.3
CN1317300000000	13	173	Lanier County, GA	1990	NA	2501	2383	118	4.7
CN1317500000000	13	175	Laurens County, GA	1990	NA	18468	17466	1002	5.4
CN1317700000000	13	177	Lee County, GA	1990	NA	7882	7446	436	5.5
CN1317900000000	13	179	Liberty County, GA	1990	NA	13848	12898	950	6.9
CN1318100000000	13	181	Lincoln County, GA	1990	NA	3292	3102	190	5.8
CN1318300000000	13	183	Long County, GA	1990	NA	2453	2333	120	4.9
CN1318500000000	13	185	Lowndes County, GA	1990	NA	33946	32343	1603	4.7
CN1318700000000	13	187	Lumpkin County, GA	1990	NA	7191	6824	367	5.1
CN1318900000000	13	189	McDuffie County, GA	1990	NA	9518	8984	534	5.6
CN1319100000000	13	191	McIntosh County, GA	1990	NA	3823	3539	284	7.4
CN1319300000000	13	193	Macon County, GA	1990	NA	5820	5302	518	8.9
CN1319500000000	13	195	Madison County, GA	1990	NA	11196	10413	783	7
CN1319700000000	13	197	Marion County, GA	1990	NA	2264	1974	290	12.8
CN1319900000000	13	199	Meriwether County, GA	1990	NA	9514	8801	713	7.5
CN1320100000000	13	201	Miller County, GA	1990	NA	2670	2579	91	3.4
CN1320500000000	13	205	Mitchell County, GA	1990	NA	9033	8163	870	9.6
CN1320700000000	13	207	Monroe County, GA	1990	NA	8215	7698	517	6.3
CN1320900000000	13	209	Montgomery County, GA	1990	NA	3340	3113	227	6.8
CN1321100000000	13	211	Morgan County, GA	1990	NA	6383	5926	457	7.2
CN1321300000000	13	213	Murray County, GA	1990	NA	14315	13324	991	6.9
CN1321500000000	13	215	Muscogee County, GA	1990	NA	76423	71666	4757	6.2
CN1321700000000	13	217	Newton County, GA	1990	NA	20737	19282	1455	7
CN1321900000000	13	219	Oconee County, GA	1990	NA	9439	9031	408	4.3
CN1322100000000	13	221	Oglethorpe County, GA	1990	NA	5144	4839	305	5.9
CN1322300000000	13	223	Paulding County, GA	1990	NA	22060	20938	1122	5.1
CN1322500000000	13	225	Peach County, GA	1990	NA	9459	8901	558	5.9
CN1322700000000	13	227	Pickens County, GA	1990	NA	7652	7034	618	8.1
CN1322900000000	13	229	Pierce County, GA	1990	NA	6333	5940	393	6.2
CN1323100000000	13	231	Pike County, GA	1990	NA	4991	4713	278	5.6
CN1323300000000	13	233	Polk County, GA	1990	NA	16464	14646	1818	11
CN1323500000000	13	235	Pulaski County, GA	1990	NA	3596	3389	207	5.8
CN1323700000000	13	237	Putnam County, GA	1990	NA	6826	6596	230	3.4
CN1323900000000	13	239	Quitman County, GA	1990	NA	872	813	59	6.8
CN1324100000000	13	241	Rabun County, GA	1990	NA	5759	5460	299	5.2
CN1324300000000	13	243	Randolph County, GA	1990	NA	3078	2830	248	8.1
CN1324500000000	13	245	Richmond County, GA	1990	NA	85218	80551	4667	5.5
CN1324700000000	13	247	Rockdale County, GA	1990	NA	30049	28733	1316	4.4
CN1324900000000	13	249	Schley County, GA	1990	NA	1656	1506	150	9.1
CN1325100000000	13	251	Screven County, GA	1990	NA	6045	5574	471	7.8
CN1325300000000	13	253	Seminole County, GA	1990	NA	4034	3870	164	4.1
CN1325500000000	13	255	Spalding County, GA	1990	NA	26651	25128	1523	5.7
CN1325700000000	13	257	Stephens County, GA	1990	NA	11916	11047	869	7.3
CN1325900000000	13	259	Stewart County, GA	1990	NA	2140	1958	182	8.5
CN1326100000000	13	261	Sumter County, GA	1990	NA	13681	12458	1223	8.9
CN1326300000000	13	263	Talbot County, GA	1990	NA	2867	2668	199	6.9
CN1326500000000	13	265	Taliaferro County, GA	1990	NA	752	712	40	5.3
CN1326700000000	13	267	Tattnall County, GA	1990	NA	6847	6511	336	4.9
CN1326900000000	13	269	Taylor County, GA	1990	NA	3187	2901	286	9
CN1327100000000	13	271	Telfair County, GA	1990	NA	4726	4323	403	8.5
CN1327300000000	13	273	Terrell County, GA	1990	NA	4575	4191	384	8.4
CN1327500000000	13	275	Thomas County, GA	1990	NA	18114	17209	905	5
CN1327700000000	13	277	Tift County, GA	1990	NA	17612	16324	1288	7.3
CN1327900000000	13	279	Toombs County, GA	1990	NA	10781	10080	701	6.5
CN1328100000000	13	281	Towns County, GA	1990	NA	2822	2640	182	6.4
CN1328300000000	13	283	Treutlen County, GA	1990	NA	2667	2464	203	7.6
CN1328500000000	13	285	Troup County, GA	1990	NA	26287	24678	1609	6.1
CN1328700000000	13	287	Turner County, GA	1990	NA	3533	3255	278	7.9
CN1328900000000	13	289	Twiggs County, GA	1990	NA	4023	3779	244	6.1
CN1329100000000	13	291	Union County, GA	1990	NA	5169	4934	235	4.5
CN1329300000000	13	293	Upson County, GA	1990	NA	12365	11669	696	5.6
CN1329500000000	13	295	Walker County, GA	1990	NA	28422	26617	1805	6.4
CN1329700000000	13	297	Walton County, GA	1990	NA	19504	18179	1325	6.8
CN1329900000000	13	299	Ware County, GA	1990	NA	14764	13861	903	6.1
CN1330100000000	13	301	Warren County, GA	1990	NA	2564	2346	218	8.5
CN1330300000000	13	303	Washington County, GA	1990	NA	8493	7995	498	5.9
CN1330500000000	13	305	Wayne County, GA	1990	NA	10314	9639	675	6.5
CN1330700000000	13	307	Webster County, GA	1990	NA	1064	978	86	8.1
CN1330900000000	13	309	Wheeler County, GA	1990	NA	2045	1896	149	7.3
CN1331100000000	13	311	White County, GA	1990	NA	6831	6510	321	4.7
CN1331300000000	13	313	Whitfield County, GA	1990	NA	39617	37464	2153	5.4
CN1331500000000	13	315	Wilcox County, GA	1990	NA	2861	2721	140	4.9
CN1331700000000	13	317	Wilkes County, GA	1990	NA	4837	4576	261	5.4
CN1331900000000	13	319	Wilkinson County, GA	1990	NA	4623	4439	184	4
CN1332100000000	13	321	Worth County, GA	1990	NA	8987	8437	550	6.1
CN1500100000000	15	001	Hawaii County, HI	1990	NA	58415	56163	2252	3.9
CN1500300000000	15	003	Honolulu County/city, HI	1990	NA	408983	400196	8787	2.1
CN1500700000000	15	007	Kauai County, HI	1990	NA	26142	25114	1028	3.9
CN1500900000000	15	009	Maui County, HI	1990	NA	57382	54743	2639	4.6
CN1600100000000	16	001	Ada County, ID	1990	NA	110727	106604	4123	3.7
CN1600300000000	16	003	Adams County, ID	1990	NA	1605	1413	192	12
CN1600500000000	16	005	Bannock County, ID	1990	NA	31222	29081	2141	6.9
CN1600700000000	16	007	Bear Lake County, ID	1990	NA	2371	2246	125	5.3
CN1600900000000	16	009	Benewah County, ID	1990	NA	3543	3161	382	10.8
CN1601100000000	16	011	Bingham County, ID	1990	NA	18323	17336	987	5.4
CN1601300000000	16	013	Blaine County, ID	1990	NA	8319	8073	246	3
CN1601500000000	16	015	Boise County, ID	1990	NA	1524	1435	89	5.8
CN1601700000000	16	017	Bonner County, ID	1990	NA	11993	10894	1099	9.2
CN1601900000000	16	019	Bonneville County, ID	1990	NA	38567	37162	1405	3.6
CN1602100000000	16	021	Boundary County, ID	1990	NA	3470	3166	304	8.8
CN1602300000000	16	023	Butte County, ID	1990	NA	1444	1382	62	4.3
CN1602500000000	16	025	Camas County, ID	1990	NA	462	434	28	6.1
CN1602700000000	16	027	Canyon County, ID	1990	NA	42644	39903	2741	6.4
CN1602900000000	16	029	Caribou County, ID	1990	NA	2955	2813	142	4.8
CN1603100000000	16	031	Cassia County, ID	1990	NA	8405	7804	601	7.2
CN1603300000000	16	033	Clark County, ID	1990	NA	549	534	15	2.7
CN1603500000000	16	035	Clearwater County, ID	1990	NA	3901	3391	510	13.1
CN1603700000000	16	037	Custer County, ID	1990	NA	2192	2093	99	4.5
CN1603900000000	16	039	Elmore County, ID	1990	NA	7931	7480	451	5.7
CN1604100000000	16	041	Franklin County, ID	1990	NA	3809	3679	130	3.4
CN1604300000000	16	043	Fremont County, ID	1990	NA	4970	4565	405	8.1
CN1604500000000	16	045	Gem County, ID	1990	NA	5223	4878	345	6.6
CN1604700000000	16	047	Gooding County, ID	1990	NA	5203	4999	204	3.9
CN1604900000000	16	049	Idaho County, ID	1990	NA	6079	5568	511	8.4
CN1605100000000	16	051	Jefferson County, ID	1990	NA	8053	7640	413	5.1
CN1605300000000	16	053	Jerome County, ID	1990	NA	6953	6632	321	4.6
CN1605500000000	16	055	Kootenai County, ID	1990	NA	34729	32131	2598	7.5
CN1605700000000	16	057	Latah County, ID	1990	NA	13989	13317	672	4.8
CN1605900000000	16	059	Lemhi County, ID	1990	NA	3225	2972	253	7.8
CN1606100000000	16	061	Lewis County, ID	1990	NA	1502	1385	117	7.8
CN1606300000000	16	063	Lincoln County, ID	1990	NA	2006	1934	72	3.6
CN1606500000000	16	065	Madison County, ID	1990	NA	8485	8113	372	4.4
CN1606700000000	16	067	Minidoka County, ID	1990	NA	8891	8270	621	7
CN1606900000000	16	069	Nez Perce County, ID	1990	NA	19464	18709	755	3.9
CN1607100000000	16	071	Oneida County, ID	1990	NA	1398	1353	45	3.2
CN1607300000000	16	073	Owyhee County, ID	1990	NA	3726	3546	180	4.8
CN1607500000000	16	075	Payette County, ID	1990	NA	8640	7906	734	8.5
CN1607700000000	16	077	Power County, ID	1990	NA	3300	3016	284	8.6
CN1607900000000	16	079	Shoshone County, ID	1990	NA	6088	5523	565	9.3
CN1608100000000	16	081	Teton County, ID	1990	NA	1820	1748	72	4
CN1608300000000	16	083	Twin Falls County, ID	1990	NA	25373	24228	1145	4.5
CN1608500000000	16	085	Valley County, ID	1990	NA	3253	2979	274	8.4
CN1608700000000	16	087	Washington County, ID	1990	NA	4168	3762	406	9.7
CN1700100000000	17	001	Adams County, IL	1990	NA	34115	32478	1637	4.8
CN1700300000000	17	003	Alexander County, IL	1990	NA	4118	3625	493	12
CN1700500000000	17	005	Bond County, IL	1990	NA	7689	7129	560	7.3
CN1700700000000	17	007	Boone County, IL	1990	NA	17706	16492	1214	6.9
CN1700900000000	17	009	Brown County, IL	1990	NA	2482	2330	152	6.1
CN1701100000000	17	011	Bureau County, IL	1990	NA	17653	16725	928	5.3
CN1701300000000	17	013	Calhoun County, IL	1990	NA	2252	2014	238	10.6
CN1701500000000	17	015	Carroll County, IL	1990	NA	8518	8072	446	5.2
CN1701700000000	17	017	Cass County, IL	1990	NA	6800	6237	563	8.3
CN1701900000000	17	019	Champaign County, IL	1990	NA	94613	91909	2704	2.9
CN1702100000000	17	021	Christian County, IL	1990	NA	18293	17391	902	4.9
CN1702300000000	17	023	Clark County, IL	1990	NA	8677	8068	609	7
CN1702500000000	17	025	Clay County, IL	1990	NA	6761	6128	633	9.4
CN1702700000000	17	027	Clinton County, IL	1990	NA	17027	15994	1033	6.1
CN1702900000000	17	029	Coles County, IL	1990	NA	26300	24913	1387	5.3
CN1703100000000	17	031	Cook County, IL	1990	NA	2616824	2431472	185352	7.1
CN1703300000000	17	033	Crawford County, IL	1990	NA	9055	8280	775	8.6
CN1703500000000	17	035	Cumberland County, IL	1990	NA	5301	4846	455	8.6
CN1703700000000	17	037	DeKalb County, IL	1990	NA	42616	40571	2045	4.8
CN1703900000000	17	039	De Witt County, IL	1990	NA	8426	7971	455	5.4
CN1704100000000	17	041	Douglas County, IL	1990	NA	10080	9664	416	4.1
CN1704300000000	17	043	DuPage County, IL	1990	NA	455650	437811	17839	3.9
CN1704500000000	17	045	Edgar County, IL	1990	NA	9679	8950	729	7.5
CN1704700000000	17	047	Edwards County, IL	1990	NA	3685	3453	232	6.3
CN1704900000000	17	049	Effingham County, IL	1990	NA	16631	15543	1088	6.5
CN1705100000000	17	051	Fayette County, IL	1990	NA	9661	8827	834	8.6
CN1705300000000	17	053	Ford County, IL	1990	NA	7164	6867	297	4.1
CN1705500000000	17	055	Franklin County, IL	1990	NA	17498	15160	2338	13.4
CN1705700000000	17	057	Fulton County, IL	1990	NA	15071	13878	1193	7.9
CN1705900000000	17	059	Gallatin County, IL	1990	NA	2925	2687	238	8.1
CN1706100000000	17	061	Greene County, IL	1990	NA	7216	6812	404	5.6
CN1706300000000	17	063	Grundy County, IL	1990	NA	16788	15304	1484	8.8
CN1706500000000	17	065	Hamilton County, IL	1990	NA	3608	3259	349	9.7
CN1706700000000	17	067	Hancock County, IL	1990	NA	10949	10423	526	4.8
CN1706900000000	17	069	Hardin County, IL	1990	NA	1948	1790	158	8.1
CN1707100000000	17	071	Henderson County, IL	1990	NA	4194	3951	243	5.8
CN1707300000000	17	073	Henry County, IL	1990	NA	26314	24918	1396	5.3
CN1707500000000	17	075	Iroquois County, IL	1990	NA	15311	14594	717	4.7
CN1707700000000	17	077	Jackson County, IL	1990	NA	30323	28484	1839	6.1
CN1707900000000	17	079	Jasper County, IL	1990	NA	5008	4729	279	5.6
CN1708100000000	17	081	Jefferson County, IL	1990	NA	17726	15935	1791	10.1
CN1708300000000	17	083	Jersey County, IL	1990	NA	10290	9721	569	5.5
CN1708500000000	17	085	Jo Daviess County, IL	1990	NA	11478	11008	470	4.1
CN1708700000000	17	087	Johnson County, IL	1990	NA	4304	3858	446	10.4
CN1708900000000	17	089	Kane County, IL	1990	NA	173189	163138	10051	5.8
CN1709100000000	17	091	Kankakee County, IL	1990	NA	48910	45815	3095	6.3
CN1709300000000	17	093	Kendall County, IL	1990	NA	21914	20955	959	4.4
CN1709500000000	17	095	Knox County, IL	1990	NA	29357	27525	1832	6.2
CN1709700000000	17	097	Lake County, IL	1990	NA	288664	277909	10755	3.7
CN1709900000000	17	099	LaSalle County, IL	1990	NA	51555	47488	4067	7.9
CN1710100000000	17	101	Lawrence County, IL	1990	NA	7116	6523	593	8.3
CN1710300000000	17	103	Lee County, IL	1990	NA	16734	15941	793	4.7
CN1710500000000	17	105	Livingston County, IL	1990	NA	19400	18809	591	3
CN1710700000000	17	107	Logan County, IL	1990	NA	14195	13463	732	5.2
CN1710900000000	17	109	McDonough County, IL	1990	NA	16865	16320	545	3.2
CN1711100000000	17	111	McHenry County, IL	1990	NA	102855	97430	5425	5.3
CN1711300000000	17	113	McLean County, IL	1990	NA	74590	72175	2415	3.2
CN1711500000000	17	115	Macon County, IL	1990	NA	60236	56438	3798	6.3
CN1711700000000	17	117	Macoupin County, IL	1990	NA	23460	22021	1439	6.1
CN1711900000000	17	119	Madison County, IL	1990	NA	128227	120551	7676	6
CN1712100000000	17	121	Marion County, IL	1990	NA	19778	17595	2183	11
CN1712300000000	17	123	Marshall County, IL	1990	NA	6393	6126	267	4.2
CN1712500000000	17	125	Mason County, IL	1990	NA	7696	7168	528	6.9
CN1712700000000	17	127	Massac County, IL	1990	NA	6615	6167	448	6.8
CN1712900000000	17	129	Menard County, IL	1990	NA	6089	5847	242	4
CN1713100000000	17	131	Mercer County, IL	1990	NA	8632	8108	524	6.1
CN1713300000000	17	133	Monroe County, IL	1990	NA	12341	11631	710	5.8
CN1713500000000	17	135	Montgomery County, IL	1990	NA	14170	13154	1016	7.2
CN1713700000000	17	137	Morgan County, IL	1990	NA	19173	18423	750	3.9
CN1713900000000	17	139	Moultrie County, IL	1990	NA	6875	6486	389	5.7
CN1714100000000	17	141	Ogle County, IL	1990	NA	25607	24335	1272	5
CN1714300000000	17	143	Peoria County, IL	1990	NA	92529	87834	4695	5.1
CN1714500000000	17	145	Perry County, IL	1990	NA	9505	8349	1156	12.2
CN1714700000000	17	147	Piatt County, IL	1990	NA	8529	8135	394	4.6
CN1714900000000	17	149	Pike County, IL	1990	NA	8728	8165	563	6.5
CN1715100000000	17	151	Pope County, IL	1990	NA	1620	1462	158	9.8
CN1715300000000	17	153	Pulaski County, IL	1990	NA	2892	2583	309	10.7
CN1715500000000	17	155	Putnam County, IL	1990	NA	2930	2733	197	6.7
CN1715700000000	17	157	Randolph County, IL	1990	NA	15754	14551	1203	7.6
CN1715900000000	17	159	Richland County, IL	1990	NA	8311	7751	560	6.7
CN1716100000000	17	161	Rock Island County, IL	1990	NA	74740	71055	3685	4.9
CN1716300000000	17	163	St. Clair County, IL	1990	NA	120946	112239	8707	7.2
CN1716500000000	17	165	Saline County, IL	1990	NA	10665	9653	1012	9.5
CN1716700000000	17	167	Sangamon County, IL	1990	NA	103866	100333	3533	3.4
CN1716900000000	17	169	Schuyler County, IL	1990	NA	3552	3257	295	8.3
CN1717100000000	17	171	Scott County, IL	1990	NA	2890	2726	164	5.7
CN1717300000000	17	173	Shelby County, IL	1990	NA	10764	10091	673	6.3
CN1717500000000	17	175	Stark County, IL	1990	NA	2945	2763	182	6.2
CN1717700000000	17	177	Stephenson County, IL	1990	NA	25993	24491	1502	5.8
CN1717900000000	17	179	Tazewell County, IL	1990	NA	65306	62229	3077	4.7
CN1718100000000	17	181	Union County, IL	1990	NA	8349	7484	865	10.4
CN1718300000000	17	183	Vermilion County, IL	1990	NA	42408	38755	3653	8.6
CN1718500000000	17	185	Wabash County, IL	1990	NA	6360	5908	452	7.1
CN1718700000000	17	187	Warren County, IL	1990	NA	10003	9445	558	5.6
CN1718900000000	17	189	Washington County, IL	1990	NA	7609	7112	497	6.5
CN1719100000000	17	191	Wayne County, IL	1990	NA	8376	7606	770	9.2
CN1719300000000	17	193	White County, IL	1990	NA	7319	6684	635	8.7
CN1719500000000	17	195	Whiteside County, IL	1990	NA	30964	29295	1669	5.4
CN1719700000000	17	197	Will County, IL	1990	NA	187116	175176	11940	6.4
CN1719900000000	17	199	Williamson County, IL	1990	NA	27138	24701	2437	9
CN1720100000000	17	201	Winnebago County, IL	1990	NA	142507	134961	7546	5.3
CN1720300000000	17	203	Woodford County, IL	1990	NA	17036	16521	515	3
CN1800100000000	18	001	Adams County, IN	1990	NA	15287	14289	998	6.5
CN1800300000000	18	003	Allen County, IN	1990	NA	162422	154105	8317	5.1
CN1800500000000	18	005	Bartholomew County, IN	1990	NA	33801	32169	1632	4.8
CN1800700000000	18	007	Benton County, IN	1990	NA	4643	4487	156	3.4
CN1800900000000	18	009	Blackford County, IN	1990	NA	6966	6323	643	9.2
CN1801100000000	18	011	Boone County, IN	1990	NA	20418	19935	483	2.4
CN1801300000000	18	013	Brown County, IN	1990	NA	7272	6944	328	4.5
CN1801500000000	18	015	Carroll County, IN	1990	NA	9541	9152	389	4.1
CN1801700000000	18	017	Cass County, IN	1990	NA	18833	17545	1288	6.8
CN1801900000000	18	019	Clark County, IN	1990	NA	45884	43188	2696	5.9
CN1802100000000	18	021	Clay County, IN	1990	NA	11193	10628	565	5
CN1802300000000	18	023	Clinton County, IN	1990	NA	14590	13915	675	4.6
CN1802500000000	18	025	Crawford County, IN	1990	NA	4411	3976	435	9.9
CN1802700000000	18	027	Daviess County, IN	1990	NA	12402	11905	497	4
CN1802900000000	18	029	Dearborn County, IN	1990	NA	19533	17937	1596	8.2
CN1803100000000	18	031	Decatur County, IN	1990	NA	12002	11503	499	4.2
CN1803300000000	18	033	DeKalb County, IN	1990	NA	19140	17993	1147	6
CN1803500000000	18	035	Delaware County, IN	1990	NA	58791	55518	3273	5.6
CN1803700000000	18	037	Dubois County, IN	1990	NA	20212	19571	641	3.2
CN1803900000000	18	039	Elkhart County, IN	1990	NA	85232	80539	4693	5.5
CN1804100000000	18	041	Fayette County, IN	1990	NA	13207	11476	1731	13.1
CN1804300000000	18	043	Floyd County, IN	1990	NA	32695	31057	1638	5
CN1804500000000	18	045	Fountain County, IN	1990	NA	8314	7772	542	6.5
CN1804700000000	18	047	Franklin County, IN	1990	NA	9792	8993	799	8.2
CN1804900000000	18	049	Fulton County, IN	1990	NA	9308	8848	460	4.9
CN1805100000000	18	051	Gibson County, IN	1990	NA	15891	14879	1012	6.4
CN1805300000000	18	053	Grant County, IN	1990	NA	36566	33714	2852	7.8
CN1805500000000	18	055	Greene County, IN	1990	NA	14075	12924	1151	8.2
CN1805700000000	18	057	Hamilton County, IN	1990	NA	61006	59638	1368	2.2
CN1805900000000	18	059	Hancock County, IN	1990	NA	24329	23569	760	3.1
CN1806100000000	18	061	Harrison County, IN	1990	NA	15009	14211	798	5.3
CN1806300000000	18	063	Hendricks County, IN	1990	NA	40469	39497	972	2.4
CN1806500000000	18	065	Henry County, IN	1990	NA	23865	21679	2186	9.2
CN1806700000000	18	067	Howard County, IN	1990	NA	40171	37284	2887	7.2
CN1806900000000	18	069	Huntington County, IN	1990	NA	18795	17828	967	5.1
CN1807100000000	18	071	Jackson County, IN	1990	NA	18819	17640	1179	6.3
CN1807300000000	18	073	Jasper County, IN	1990	NA	12055	11266	789	6.5
CN1807500000000	18	075	Jay County, IN	1990	NA	10786	9905	881	8.2
CN1807700000000	18	077	Jefferson County, IN	1990	NA	14903	13885	1018	6.8
CN1807900000000	18	079	Jennings County, IN	1990	NA	11645	10990	655	5.6
CN1808100000000	18	081	Johnson County, IN	1990	NA	48000	46554	1446	3
CN1808300000000	18	083	Knox County, IN	1990	NA	18611	17234	1377	7.4
CN1808500000000	18	085	Kosciusko County, IN	1990	NA	34168	32874	1294	3.8
CN1808700000000	18	087	LaGrange County, IN	1990	NA	14059	13189	870	6.2
CN1808900000000	18	089	Lake County, IN	1990	NA	222677	208343	14334	6.4
CN1809100000000	18	091	LaPorte County, IN	1990	NA	52201	49382	2819	5.4
CN1809300000000	18	093	Lawrence County, IN	1990	NA	21649	19576	2073	9.6
CN1809500000000	18	095	Madison County, IN	1990	NA	63886	60069	3817	6
CN1809700000000	18	097	Marion County, IN	1990	NA	424053	408409	15644	3.7
CN1809900000000	18	099	Marshall County, IN	1990	NA	22436	21241	1195	5.3
CN1810100000000	18	101	Martin County, IN	1990	NA	4945	4633	312	6.3
CN1810300000000	18	103	Miami County, IN	1990	NA	15956	14959	997	6.2
CN1810500000000	18	105	Monroe County, IN	1990	NA	54722	52975	1747	3.2
CN1810700000000	18	107	Montgomery County, IN	1990	NA	17404	16773	631	3.6
CN1810900000000	18	109	Morgan County, IN	1990	NA	29221	27995	1226	4.2
CN1811100000000	18	111	Newton County, IN	1990	NA	6603	6304	299	4.5
CN1811300000000	18	113	Noble County, IN	1990	NA	20114	18535	1579	7.9
CN1811500000000	18	115	Ohio County, IN	1990	NA	2629	2418	211	8
CN1811700000000	18	117	Orange County, IN	1990	NA	8754	7767	987	11.3
CN1811900000000	18	119	Owen County, IN	1990	NA	8156	7698	458	5.6
CN1812100000000	18	121	Parke County, IN	1990	NA	7211	6769	442	6.1
CN1812300000000	18	123	Perry County, IN	1990	NA	8570	7758	812	9.5
CN1812500000000	18	125	Pike County, IN	1990	NA	5941	5540	401	6.7
CN1812700000000	18	127	Porter County, IN	1990	NA	65856	63253	2603	4
CN1812900000000	18	129	Posey County, IN	1990	NA	12925	12322	603	4.7
CN1813100000000	18	131	Pulaski County, IN	1990	NA	5888	5525	363	6.2
CN1813300000000	18	133	Putnam County, IN	1990	NA	13866	13171	695	5
CN1813500000000	18	135	Randolph County, IN	1990	NA	13134	11803	1331	10.1
CN1813700000000	18	137	Ripley County, IN	1990	NA	11932	11235	697	5.8
CN1813900000000	18	139	Rush County, IN	1990	NA	8814	8229	585	6.6
CN1814100000000	18	141	St. Joseph County, IN	1990	NA	125573	118247	7326	5.8
CN1814300000000	18	143	Scott County, IN	1990	NA	9643	8820	823	8.5
CN1814500000000	18	145	Shelby County, IN	1990	NA	21404	20181	1223	5.7
CN1814700000000	18	147	Spencer County, IN	1990	NA	9820	9188	632	6.4
CN1814900000000	18	149	Starke County, IN	1990	NA	10312	9557	755	7.3
CN1815100000000	18	151	Steuben County, IN	1990	NA	14814	13981	833	5.6
CN1815300000000	18	153	Sullivan County, IN	1990	NA	8565	7958	607	7.1
CN1815500000000	18	155	Switzerland County, IN	1990	NA	3598	3312	286	7.9
CN1815700000000	18	157	Tippecanoe County, IN	1990	NA	65711	63919	1792	2.7
CN1815900000000	18	159	Tipton County, IN	1990	NA	8307	7831	476	5.7
CN1816100000000	18	161	Union County, IN	1990	NA	3490	3210	280	8
CN1816300000000	18	163	Vanderburgh County, IN	1990	NA	84833	80187	4646	5.5
CN1816500000000	18	165	Vermillion County, IN	1990	NA	7513	7024	489	6.5
CN1816700000000	18	167	Vigo County, IN	1990	NA	49138	46702	2436	5
CN1816900000000	18	169	Wabash County, IN	1990	NA	18210	17054	1156	6.3
CN1817100000000	18	171	Warren County, IN	1990	NA	3781	3603	178	4.7
CN1817300000000	18	173	Warrick County, IN	1990	NA	23575	22492	1083	4.6
CN1817500000000	18	175	Washington County, IN	1990	NA	11221	10456	765	6.8
CN1817700000000	18	177	Wayne County, IN	1990	NA	35859	32744	3115	8.7
CN1817900000000	18	179	Wells County, IN	1990	NA	13680	13070	610	4.5
CN1818100000000	18	181	White County, IN	1990	NA	12154	11433	721	5.9
CN1818300000000	18	183	Whitley County, IN	1990	NA	14761	13890	871	5.9
CN1900100000000	19	001	Adair County, IA	1990	NA	4022	3920	102	2.5
CN1900300000000	19	003	Adams County, IA	1990	NA	2436	2343	93	3.8
CN1900500000000	19	005	Allamakee County, IA	1990	NA	7175	6767	408	5.7
CN1900700000000	19	007	Appanoose County, IA	1990	NA	6358	5920	438	6.9
CN1900900000000	19	009	Audubon County, IA	1990	NA	3605	3484	121	3.4
CN1901100000000	19	011	Benton County, IA	1990	NA	11433	10830	603	5.3
CN1901300000000	19	013	Black Hawk County, IA	1990	NA	62270	58623	3647	5.9
CN1901500000000	19	015	Boone County, IA	1990	NA	12631	12083	548	4.3
CN1901700000000	19	017	Bremer County, IA	1990	NA	11426	10987	439	3.8
CN1901900000000	19	019	Buchanan County, IA	1990	NA	9582	9044	538	5.6
CN1902100000000	19	021	Buena Vista County, IA	1990	NA	10016	9749	267	2.7
CN1902300000000	19	023	Butler County, IA	1990	NA	7340	6995	345	4.7
CN1902500000000	19	025	Calhoun County, IA	1990	NA	4968	4847	121	2.4
CN1902700000000	19	027	Carroll County, IA	1990	NA	10715	10261	454	4.2
CN1902900000000	19	029	Cass County, IA	1990	NA	7545	7126	419	5.6
CN1903100000000	19	031	Cedar County, IA	1990	NA	9084	8827	257	2.8
CN1903300000000	19	033	Cerro Gordo County, IA	1990	NA	25248	23885	1363	5.4
CN1903500000000	19	035	Cherokee County, IA	1990	NA	6721	6534	187	2.8
CN1903700000000	19	037	Chickasaw County, IA	1990	NA	7083	6645	438	6.2
CN1903900000000	19	039	Clarke County, IA	1990	NA	4227	4011	216	5.1
CN1904100000000	19	041	Clay County, IA	1990	NA	8977	8766	211	2.4
CN1904300000000	19	043	Clayton County, IA	1990	NA	9212	8697	515	5.6
CN1904500000000	19	045	Clinton County, IA	1990	NA	25612	24088	1524	6
CN1904700000000	19	047	Crawford County, IA	1990	NA	8529	8032	497	5.8
CN1904900000000	19	049	Dallas County, IA	1990	NA	16149	15568	581	3.6
CN1905100000000	19	051	Davis County, IA	1990	NA	3871	3726	145	3.7
CN1905300000000	19	053	Decatur County, IA	1990	NA	3800	3555	245	6.4
CN1905500000000	19	055	Delaware County, IA	1990	NA	8817	8405	412	4.7
CN1905700000000	19	057	Des Moines County, IA	1990	NA	22095	20907	1188	5.4
CN1905900000000	19	059	Dickinson County, IA	1990	NA	8051	7781	270	3.4
CN1906100000000	19	061	Dubuque County, IA	1990	NA	46139	43329	2810	6.1
CN1906300000000	19	063	Emmet County, IA	1990	NA	5556	5236	320	5.8
CN1906500000000	19	065	Fayette County, IA	1990	NA	10282	9836	446	4.3
CN1906700000000	19	067	Floyd County, IA	1990	NA	8569	8100	469	5.5
CN1906900000000	19	069	Franklin County, IA	1990	NA	5738	5504	234	4.1
CN1907100000000	19	071	Fremont County, IA	1990	NA	3738	3605	133	3.6
CN1907300000000	19	073	Greene County, IA	1990	NA	4889	4641	248	5.1
CN1907500000000	19	075	Grundy County, IA	1990	NA	5787	5636	151	2.6
CN1907700000000	19	077	Guthrie County, IA	1990	NA	5451	5239	212	3.9
CN1907900000000	19	079	Hamilton County, IA	1990	NA	8376	7969	407	4.9
CN1908100000000	19	081	Hancock County, IA	1990	NA	6240	5863	377	6
CN1908300000000	19	083	Hardin County, IA	1990	NA	9411	8958	453	4.8
CN1908500000000	19	085	Harrison County, IA	1990	NA	7116	6822	294	4.1
CN1908700000000	19	087	Henry County, IA	1990	NA	10038	9679	359	3.6
CN1908900000000	19	089	Howard County, IA	1990	NA	4607	4423	184	4
CN1909100000000	19	091	Humboldt County, IA	1990	NA	4966	4805	161	3.2
CN1909300000000	19	093	Ida County, IA	1990	NA	3886	3787	99	2.5
CN1909500000000	19	095	Iowa County, IA	1990	NA	8006	7799	207	2.6
CN1909700000000	19	097	Jackson County, IA	1990	NA	10024	9357	667	6.7
CN1909900000000	19	099	Jasper County, IA	1990	NA	17898	17247	651	3.6
CN1910100000000	19	101	Jefferson County, IA	1990	NA	8513	8146	367	4.3
CN1910300000000	19	103	Johnson County, IA	1990	NA	57658	55809	1849	3.2
CN1910500000000	19	105	Jones County, IA	1990	NA	9322	8862	460	4.9
CN1910700000000	19	107	Keokuk County, IA	1990	NA	5331	5085	246	4.6
CN1910900000000	19	109	Kossuth County, IA	1990	NA	8851	8451	400	4.5
CN1911100000000	19	111	Lee County, IA	1990	NA	18932	17682	1250	6.6
CN1911300000000	19	113	Linn County, IA	1990	NA	96912	91425	5487	5.7
CN1911500000000	19	115	Louisa County, IA	1990	NA	5917	5647	270	4.6
CN1911700000000	19	117	Lucas County, IA	1990	NA	4269	4006	263	6.2
CN1911900000000	19	119	Lyon County, IA	1990	NA	5660	5538	122	2.2
CN1912100000000	19	121	Madison County, IA	1990	NA	6375	6092	283	4.4
CN1912300000000	19	123	Mahaska County, IA	1990	NA	10556	10131	425	4
CN1912500000000	19	125	Marion County, IA	1990	NA	15768	15170	598	3.8
CN1912700000000	19	127	Marshall County, IA	1990	NA	20029	19342	687	3.4
CN1912900000000	19	129	Mills County, IA	1990	NA	6432	6200	232	3.6
CN1913100000000	19	131	Mitchell County, IA	1990	NA	5158	4953	205	4
CN1913300000000	19	133	Monona County, IA	1990	NA	4465	4303	162	3.6
CN1913500000000	19	135	Monroe County, IA	1990	NA	3741	3534	207	5.5
CN1913700000000	19	137	Montgomery County, IA	1990	NA	6127	5843	284	4.6
CN1913900000000	19	139	Muscatine County, IA	1990	NA	20887	19839	1048	5
CN1914100000000	19	141	O'Brien County, IA	1990	NA	7323	7163	160	2.2
CN1914300000000	19	143	Osceola County, IA	1990	NA	3516	3411	105	3
CN1914500000000	19	145	Page County, IA	1990	NA	8145	7744	401	4.9
CN1914700000000	19	147	Palo Alto County, IA	1990	NA	4848	4663	185	3.8
CN1914900000000	19	149	Plymouth County, IA	1990	NA	11834	11464	370	3.1
CN1915100000000	19	151	Pocahontas County, IA	1990	NA	4344	4249	95	2.2
CN1915300000000	19	153	Polk County, IA	1990	NA	189893	183553	6340	3.3
CN1915500000000	19	155	Pottawattamie County, IA	1990	NA	43659	41923	1736	4
CN1915700000000	19	157	Poweshiek County, IA	1990	NA	9994	9532	462	4.6
CN1915900000000	19	159	Ringgold County, IA	1990	NA	2560	2456	104	4.1
CN1916100000000	19	161	Sac County, IA	1990	NA	5872	5634	238	4.1
CN1916300000000	19	163	Scott County, IA	1990	NA	78812	75375	3437	4.4
CN1916500000000	19	165	Shelby County, IA	1990	NA	6553	6281	272	4.2
CN1916700000000	19	167	Sioux County, IA	1990	NA	15285	14856	429	2.8
CN1916900000000	19	169	Story County, IA	1990	NA	41850	40276	1574	3.8
CN1917100000000	19	171	Tama County, IA	1990	NA	8240	7870	370	4.5
CN1917300000000	19	173	Taylor County, IA	1990	NA	3102	2987	115	3.7
CN1917500000000	19	175	Union County, IA	1990	NA	6079	5772	307	5.1
CN1917700000000	19	177	Van Buren County, IA	1990	NA	3618	3491	127	3.5
CN1917900000000	19	179	Wapello County, IA	1990	NA	16935	15909	1026	6.1
CN1918100000000	19	181	Warren County, IA	1990	NA	20376	19809	567	2.8
CN1918300000000	19	183	Washington County, IA	1990	NA	10408	10117	291	2.8
CN1918500000000	19	185	Wayne County, IA	1990	NA	3208	3115	93	2.9
CN1918700000000	19	187	Webster County, IA	1990	NA	19515	18493	1022	5.2
CN1918900000000	19	189	Winnebago County, IA	1990	NA	6432	5920	512	8
CN1919100000000	19	191	Winneshiek County, IA	1990	NA	11310	10664	646	5.7
CN1919300000000	19	193	Woodbury County, IA	1990	NA	50262	48006	2256	4.5
CN1919500000000	19	195	Worth County, IA	1990	NA	4046	3777	269	6.6
CN1919700000000	19	197	Wright County, IA	1990	NA	7120	6865	255	3.6
CN2000100000000	20	001	Allen County, KS	1990	NA	6845	6447	398	5.8
CN2000300000000	20	003	Anderson County, KS	1990	NA	3766	3548	218	5.8
CN2000500000000	20	005	Atchison County, KS	1990	NA	8151	7645	506	6.2
CN2000700000000	20	007	Barber County, KS	1990	NA	2828	2767	61	2.2
CN2000900000000	20	009	Barton County, KS	1990	NA	15044	14542	502	3.3
CN2001100000000	20	011	Bourbon County, KS	1990	NA	6745	6375	370	5.5
CN2001300000000	20	013	Brown County, KS	1990	NA	5059	4872	187	3.7
CN2001500000000	20	015	Butler County, KS	1990	NA	26010	25137	873	3.4
CN2001700000000	20	017	Chase County, KS	1990	NA	1398	1315	83	5.9
CN2001900000000	20	019	Chautauqua County, KS	1990	NA	1757	1685	72	4.1
CN2002100000000	20	021	Cherokee County, KS	1990	NA	9694	8939	755	7.8
CN2002300000000	20	023	Cheyenne County, KS	1990	NA	1517	1503	14	0.9
CN2002500000000	20	025	Clark County, KS	1990	NA	1252	1238	14	1.1
CN2002700000000	20	027	Clay County, KS	1990	NA	4332	4181	151	3.5
CN2002900000000	20	029	Cloud County, KS	1990	NA	5416	5207	209	3.9
CN2003100000000	20	031	Coffey County, KS	1990	NA	3982	3774	208	5.2
CN2003300000000	20	033	Comanche County, KS	1990	NA	1075	1060	15	1.4
CN2003500000000	20	035	Cowley County, KS	1990	NA	17937	16811	1126	6.3
CN2003700000000	20	037	Crawford County, KS	1990	NA	16446	15397	1049	6.4
CN2003900000000	20	039	Decatur County, KS	1990	NA	1991	1946	45	2.3
CN2004100000000	20	041	Dickinson County, KS	1990	NA	9385	9041	344	3.7
CN2004300000000	20	043	Doniphan County, KS	1990	NA	3784	3521	263	7
CN2004500000000	20	045	Douglas County, KS	1990	NA	44657	42537	2120	4.7
CN2004700000000	20	047	Edwards County, KS	1990	NA	1844	1805	39	2.1
CN2004900000000	20	049	Elk County, KS	1990	NA	1449	1395	54	3.7
CN2005100000000	20	051	Ellis County, KS	1990	NA	14138	13659	479	3.4
CN2005300000000	20	053	Ellsworth County, KS	1990	NA	2899	2824	75	2.6
CN2005500000000	20	055	Finney County, KS	1990	NA	17635	17098	537	3
CN2005700000000	20	057	Ford County, KS	1990	NA	14146	13731	415	2.9
CN2005900000000	20	059	Franklin County, KS	1990	NA	11167	10510	657	5.9
CN2006100000000	20	061	Geary County, KS	1990	NA	10781	9959	822	7.6
CN2006300000000	20	063	Gove County, KS	1990	NA	1481	1460	21	1.4
CN2006500000000	20	065	Graham County, KS	1990	NA	1723	1685	38	2.2
CN2006700000000	20	067	Grant County, KS	1990	NA	3658	3579	79	2.2
CN2006900000000	20	069	Gray County, KS	1990	NA	2649	2594	55	2.1
CN2007100000000	20	071	Greeley County, KS	1990	NA	903	888	15	1.7
CN2007300000000	20	073	Greenwood County, KS	1990	NA	3588	3418	170	4.7
CN2007500000000	20	075	Hamilton County, KS	1990	NA	1259	1246	13	1
CN2007700000000	20	077	Harper County, KS	1990	NA	3298	3221	77	2.3
CN2007900000000	20	079	Harvey County, KS	1990	NA	16142	15639	503	3.1
CN2008100000000	20	081	Haskell County, KS	1990	NA	2008	1959	49	2.4
CN2008300000000	20	083	Hodgeman County, KS	1990	NA	973	959	14	1.4
CN2008500000000	20	085	Jackson County, KS	1990	NA	5660	5326	334	5.9
CN2008700000000	20	087	Jefferson County, KS	1990	NA	8148	7740	408	5
CN2008900000000	20	089	Jewell County, KS	1990	NA	2086	2042	44	2.1
CN2009100000000	20	091	Johnson County, KS	1990	NA	210902	204707	6195	2.9
CN2009300000000	20	093	Kearny County, KS	1990	NA	2032	1980	52	2.6
CN2009500000000	20	095	Kingman County, KS	1990	NA	3922	3790	132	3.4
CN2009700000000	20	097	Kiowa County, KS	1990	NA	1734	1707	27	1.6
CN2009900000000	20	099	Labette County, KS	1990	NA	11574	10765	809	7
CN2010100000000	20	101	Lane County, KS	1990	NA	1127	1109	18	1.6
CN2010300000000	20	103	Leavenworth County, KS	1990	NA	25512	24240	1272	5
CN2010500000000	20	105	Lincoln County, KS	1990	NA	1806	1735	71	3.9
CN2010700000000	20	107	Linn County, KS	1990	NA	3359	3078	281	8.4
CN2010900000000	20	109	Logan County, KS	1990	NA	1567	1540	27	1.7
CN2011100000000	20	111	Lyon County, KS	1990	NA	18310	17409	901	4.9
CN2011300000000	20	113	McPherson County, KS	1990	NA	14399	13982	417	2.9
CN2011500000000	20	115	Marion County, KS	1990	NA	6348	6171	177	2.8
CN2011700000000	20	117	Marshall County, KS	1990	NA	5343	5240	103	1.9
CN2011900000000	20	119	Meade County, KS	1990	NA	2196	2159	37	1.7
CN2012100000000	20	121	Miami County, KS	1990	NA	12149	11555	594	4.9
CN2012300000000	20	123	Mitchell County, KS	1990	NA	3487	3381	106	3
CN2012500000000	20	125	Montgomery County, KS	1990	NA	18082	16997	1085	6
CN2012700000000	20	127	Morris County, KS	1990	NA	2933	2832	101	3.4
CN2012900000000	20	129	Morton County, KS	1990	NA	1625	1595	30	1.8
CN2013100000000	20	131	Nemaha County, KS	1990	NA	5096	5018	78	1.5
CN2013300000000	20	133	Neosho County, KS	1990	NA	8354	7979	375	4.5
CN2013500000000	20	135	Ness County, KS	1990	NA	1969	1933	36	1.8
CN2013700000000	20	137	Norton County, KS	1990	NA	2897	2849	48	1.7
CN2013900000000	20	139	Osage County, KS	1990	NA	7491	6988	503	6.7
CN2014100000000	20	141	Osborne County, KS	1990	NA	2416	2377	39	1.6
CN2014300000000	20	143	Ottawa County, KS	1990	NA	2784	2648	136	4.9
CN2014500000000	20	145	Pawnee County, KS	1990	NA	3660	3583	77	2.1
CN2014700000000	20	147	Phillips County, KS	1990	NA	3135	3079	56	1.8
CN2014900000000	20	149	Pottawatomie County, KS	1990	NA	8358	7936	422	5
CN2015100000000	20	151	Pratt County, KS	1990	NA	4844	4702	142	2.9
CN2015300000000	20	153	Rawlins County, KS	1990	NA	1634	1606	28	1.7
CN2015500000000	20	155	Reno County, KS	1990	NA	31333	29955	1378	4.4
CN2015700000000	20	157	Republic County, KS	1990	NA	3204	3160	44	1.4
CN2015900000000	20	159	Rice County, KS	1990	NA	4843	4692	151	3.1
CN2016100000000	20	161	Riley County, KS	1990	NA	28237	27081	1156	4.1
CN2016300000000	20	163	Rooks County, KS	1990	NA	2748	2674	74	2.7
CN2016500000000	20	165	Rush County, KS	1990	NA	1815	1780	35	1.9
CN2016700000000	20	167	Russell County, KS	1990	NA	3744	3648	96	2.6
CN2016900000000	20	169	Saline County, KS	1990	NA	26964	25908	1056	3.9
CN2017100000000	20	171	Scott County, KS	1990	NA	2695	2644	51	1.9
CN2017300000000	20	173	Sedgwick County, KS	1990	NA	215912	206827	9085	4.2
CN2017500000000	20	175	Seward County, KS	1990	NA	9845	9446	399	4.1
CN2017700000000	20	177	Shawnee County, KS	1990	NA	86874	82713	4161	4.8
CN2017900000000	20	179	Sheridan County, KS	1990	NA	1500	1481	19	1.3
CN2018100000000	20	181	Sherman County, KS	1990	NA	3552	3455	97	2.7
CN2018300000000	20	183	Smith County, KS	1990	NA	2437	2397	40	1.6
CN2018500000000	20	185	Stafford County, KS	1990	NA	2412	2356	56	2.3
CN2018700000000	20	187	Stanton County, KS	1990	NA	1117	1098	19	1.7
CN2018900000000	20	189	Stevens County, KS	1990	NA	2459	2414	45	1.8
CN2019100000000	20	191	Sumner County, KS	1990	NA	12313	11782	531	4.3
CN2019300000000	20	193	Thomas County, KS	1990	NA	4274	4137	137	3.2
CN2019500000000	20	195	Trego County, KS	1990	NA	1810	1779	31	1.7
CN2019700000000	20	197	Wabaunsee County, KS	1990	NA	3277	3154	123	3.8
CN2019900000000	20	199	Wallace County, KS	1990	NA	880	864	16	1.8
CN2020100000000	20	201	Washington County, KS	1990	NA	3470	3395	75	2.2
CN2020300000000	20	203	Wichita County, KS	1990	NA	1288	1266	22	1.7
CN2020500000000	20	205	Wilson County, KS	1990	NA	4597	4395	202	4.4
CN2020700000000	20	207	Woodson County, KS	1990	NA	1687	1634	53	3.1
CN2020900000000	20	209	Wyandotte County, KS	1990	NA	79489	72861	6628	8.3
CN2100100000000	21	001	Adair County, KY	1990	NA	7269	6838	431	5.9
CN2100300000000	21	003	Allen County, KY	1990	NA	7279	6239	1040	14.3
CN2100500000000	21	005	Anderson County, KY	1990	NA	8151	7862	289	3.5
CN2100700000000	21	007	Ballard County, KY	1990	NA	3748	3417	331	8.8
CN2100900000000	21	009	Barren County, KY	1990	NA	16380	15503	877	5.4
CN2101100000000	21	011	Bath County, KY	1990	NA	4729	4174	555	11.7
CN2101300000000	21	013	Bell County, KY	1990	NA	10512	9469	1043	9.9
CN2101500000000	21	015	Boone County, KY	1990	NA	31797	30773	1024	3.2
CN2101700000000	21	017	Bourbon County, KY	1990	NA	9711	9155	556	5.7
CN2101900000000	21	019	Boyd County, KY	1990	NA	22528	21134	1394	6.2
CN2102100000000	21	021	Boyle County, KY	1990	NA	12609	11822	787	6.2
CN2102300000000	21	023	Bracken County, KY	1990	NA	3517	3274	243	6.9
CN2102500000000	21	025	Breathitt County, KY	1990	NA	5132	4575	557	10.9
CN2102700000000	21	027	Breckinridge County, KY	1990	NA	6961	6499	462	6.6
CN2102900000000	21	029	Bullitt County, KY	1990	NA	25407	24251	1156	4.5
CN2103100000000	21	031	Butler County, KY	1990	NA	5437	4856	581	10.7
CN2103300000000	21	033	Caldwell County, KY	1990	NA	6150	5700	450	7.3
CN2103500000000	21	035	Calloway County, KY	1990	NA	15466	14576	890	5.8
CN2103700000000	21	037	Campbell County, KY	1990	NA	43319	41831	1488	3.4
CN2103900000000	21	039	Carlisle County, KY	1990	NA	2545	2339	206	8.1
CN2104100000000	21	041	Carroll County, KY	1990	NA	4217	4031	186	4.4
CN2104300000000	21	043	Carter County, KY	1990	NA	10530	9136	1394	13.2
CN2104500000000	21	045	Casey County, KY	1990	NA	6051	5742	309	5.1
CN2104700000000	21	047	Christian County, KY	1990	NA	24301	22621	1680	6.9
CN2104900000000	21	049	Clark County, KY	1990	NA	14814	13803	1011	6.8
CN2105100000000	21	051	Clay County, KY	1990	NA	6593	6093	500	7.6
CN2105300000000	21	053	Clinton County, KY	1990	NA	4151	3748	403	9.7
CN2105500000000	21	055	Crittenden County, KY	1990	NA	3904	3563	341	8.7
CN2105700000000	21	057	Cumberland County, KY	1990	NA	2985	2767	218	7.3
CN2105900000000	21	059	Daviess County, KY	1990	NA	43795	41281	2514	5.7
CN2106100000000	21	061	Edmonson County, KY	1990	NA	4363	3963	400	9.2
CN2106300000000	21	063	Elliott County, KY	1990	NA	2243	1936	307	13.7
CN2106500000000	21	065	Estill County, KY	1990	NA	5838	5119	719	12.3
CN2106700000000	21	067	Fayette County, KY	1990	NA	127948	123313	4635	3.6
CN2106900000000	21	069	Fleming County, KY	1990	NA	5858	5553	305	5.2
CN2107100000000	21	071	Floyd County, KY	1990	NA	14654	13448	1206	8.2
CN2107300000000	21	073	Franklin County, KY	1990	NA	24569	23846	723	2.9
CN2107500000000	21	075	Fulton County, KY	1990	NA	3428	3125	303	8.8
CN2107700000000	21	077	Gallatin County, KY	1990	NA	2703	2579	124	4.6
CN2107900000000	21	079	Garrard County, KY	1990	NA	5671	5318	353	6.2
CN2108100000000	21	081	Grant County, KY	1990	NA	7717	7372	345	4.5
CN2108300000000	21	083	Graves County, KY	1990	NA	15950	14242	1708	10.7
CN2108500000000	21	085	Grayson County, KY	1990	NA	9435	8616	819	8.7
CN2108700000000	21	087	Green County, KY	1990	NA	5209	4963	246	4.7
CN2108900000000	21	089	Greenup County, KY	1990	NA	15971	14961	1010	6.3
CN2109100000000	21	091	Hancock County, KY	1990	NA	3573	3260	313	8.8
CN2109300000000	21	093	Hardin County, KY	1990	NA	34823	32665	2158	6.2
CN2109500000000	21	095	Harlan County, KY	1990	NA	11300	10248	1052	9.3
CN2109700000000	21	097	Harrison County, KY	1990	NA	7681	7313	368	4.8
CN2109900000000	21	099	Hart County, KY	1990	NA	6798	6368	430	6.3
CN2110100000000	21	101	Henderson County, KY	1990	NA	22347	21117	1230	5.5
CN2110300000000	21	103	Henry County, KY	1990	NA	6569	6335	234	3.6
CN2110500000000	21	105	Hickman County, KY	1990	NA	2536	2352	184	7.3
CN2110700000000	21	107	Hopkins County, KY	1990	NA	21114	19680	1434	6.8
CN2110900000000	21	109	Jackson County, KY	1990	NA	4334	3849	485	11.2
CN2111100000000	21	111	Jefferson County, KY	1990	NA	353239	334949	18290	5.2
CN2111300000000	21	113	Jessamine County, KY	1990	NA	16678	16022	656	3.9
CN2111500000000	21	115	Johnson County, KY	1990	NA	8740	8041	699	8
CN2111700000000	21	117	Kenton County, KY	1990	NA	75843	73365	2478	3.3
CN2111900000000	21	119	Knott County, KY	1990	NA	5488	4970	518	9.4
CN2112100000000	21	121	Knox County, KY	1990	NA	10019	9228	791	7.9
CN2112300000000	21	123	Larue County, KY	1990	NA	5449	5147	302	5.5
CN2112500000000	21	125	Laurel County, KY	1990	NA	18685	17383	1302	7
CN2112700000000	21	127	Lawrence County, KY	1990	NA	4548	4027	521	11.5
CN2112900000000	21	129	Lee County, KY	1990	NA	2466	2211	255	10.3
CN2113100000000	21	131	Leslie County, KY	1990	NA	4213	3871	342	8.1
CN2113300000000	21	133	Letcher County, KY	1990	NA	8702	7882	820	9.4
CN2113500000000	21	135	Lewis County, KY	1990	NA	5565	5034	531	9.5
CN2113700000000	21	137	Lincoln County, KY	1990	NA	9154	8512	642	7
CN2113900000000	21	139	Livingston County, KY	1990	NA	4502	4131	371	8.2
CN2114100000000	21	141	Logan County, KY	1990	NA	11915	11222	693	5.8
CN2114300000000	21	143	Lyon County, KY	1990	NA	2635	2434	201	7.6
CN2114500000000	21	145	McCracken County, KY	1990	NA	30855	29347	1508	4.9
CN2114700000000	21	147	McCreary County, KY	1990	NA	4876	4146	730	15
CN2114900000000	21	149	McLean County, KY	1990	NA	4457	4083	374	8.4
CN2115100000000	21	151	Madison County, KY	1990	NA	30317	28463	1854	6.1
CN2115300000000	21	153	Magoffin County, KY	1990	NA	4300	3641	659	15.3
CN2115500000000	21	155	Marion County, KY	1990	NA	7679	7232	447	5.8
CN2115700000000	21	157	Marshall County, KY	1990	NA	12540	11579	961	7.7
CN2115900000000	21	159	Martin County, KY	1990	NA	3609	3333	276	7.6
CN2116100000000	21	161	Mason County, KY	1990	NA	8042	7702	340	4.2
CN2116300000000	21	163	Meade County, KY	1990	NA	8913	8345	568	6.4
CN2116500000000	21	165	Menifee County, KY	1990	NA	2326	1998	328	14.1
CN2116700000000	21	167	Mercer County, KY	1990	NA	9595	9015	580	6
CN2116900000000	21	169	Metcalfe County, KY	1990	NA	4348	4118	230	5.3
CN2117100000000	21	171	Monroe County, KY	1990	NA	5295	4949	346	6.5
CN2117300000000	21	173	Montgomery County, KY	1990	NA	10343	9223	1120	10.8
CN2117500000000	21	175	Morgan County, KY	1990	NA	4034	3625	409	10.1
CN2117700000000	21	177	Muhlenberg County, KY	1990	NA	12776	11656	1120	8.8
CN2117900000000	21	179	Nelson County, KY	1990	NA	14746	13962	784	5.3
CN2118100000000	21	181	Nicholas County, KY	1990	NA	3434	3242	192	5.6
CN2118300000000	21	183	Ohio County, KY	1990	NA	8703	7972	731	8.4
CN2118500000000	21	185	Oldham County, KY	1990	NA	17438	16912	526	3
CN2118700000000	21	187	Owen County, KY	1990	NA	4287	4136	151	3.5
CN2118900000000	21	189	Owsley County, KY	1990	NA	1376	1258	118	8.6
CN2119100000000	21	191	Pendleton County, KY	1990	NA	5702	5479	223	3.9
CN2119300000000	21	193	Perry County, KY	1990	NA	10678	9785	893	8.4
CN2119500000000	21	195	Pike County, KY	1990	NA	25577	23597	1980	7.7
CN2119700000000	21	197	Powell County, KY	1990	NA	5110	4520	590	11.5
CN2119900000000	21	199	Pulaski County, KY	1990	NA	22920	20927	1993	8.7
CN2120100000000	21	201	Robertson County, KY	1990	NA	923	877	46	5
CN2120300000000	21	203	Rockcastle County, KY	1990	NA	6177	5562	615	10
CN2120500000000	21	205	Rowan County, KY	1990	NA	9396	8546	850	9
CN2120700000000	21	207	Russell County, KY	1990	NA	6907	6465	442	6.4
CN2120900000000	21	209	Scott County, KY	1990	NA	12985	12416	569	4.4
CN2121100000000	21	211	Shelby County, KY	1990	NA	13748	13358	390	2.8
CN2121300000000	21	213	Simpson County, KY	1990	NA	7960	7458	502	6.3
CN2121500000000	21	215	Spencer County, KY	1990	NA	3390	3275	115	3.4
CN2121700000000	21	217	Taylor County, KY	1990	NA	10898	10437	461	4.2
CN2121900000000	21	219	Todd County, KY	1990	NA	5144	4803	341	6.6
CN2122100000000	21	221	Trigg County, KY	1990	NA	4960	4702	258	5.2
CN2122300000000	21	223	Trimble County, KY	1990	NA	2885	2752	133	4.6
CN2122500000000	21	225	Union County, KY	1990	NA	7078	6581	497	7
CN2122700000000	21	227	Warren County, KY	1990	NA	42804	39745	3059	7.1
CN2122900000000	21	229	Washington County, KY	1990	NA	4842	4574	268	5.5
CN2123100000000	21	231	Wayne County, KY	1990	NA	7056	6428	628	8.9
CN2123300000000	21	233	Webster County, KY	1990	NA	6011	5630	381	6.3
CN2123500000000	21	235	Whitley County, KY	1990	NA	12740	11731	1009	7.9
CN2123700000000	21	237	Wolfe County, KY	1990	NA	2371	2043	328	13.8
CN2123900000000	21	239	Woodford County, KY	1990	NA	11348	10987	361	3.2
CN2200100000000	22	001	Acadia Parish, LA	1990	NA	21750	20360	1390	6.4
CN2200300000000	22	003	Allen Parish, LA	1990	NA	7538	6797	741	9.8
CN2200500000000	22	005	Ascension Parish, LA	1990	NA	27198	25442	1756	6.5
CN2200700000000	22	007	Assumption Parish, LA	1990	NA	9317	8706	611	6.6
CN2200900000000	22	009	Avoyelles Parish, LA	1990	NA	14504	13096	1408	9.7
CN2201100000000	22	011	Beauregard Parish, LA	1990	NA	11570	10850	720	6.2
CN2201300000000	22	013	Bienville Parish, LA	1990	NA	5998	5573	425	7.1
CN2201500000000	22	015	Bossier Parish, LA	1990	NA	40227	37808	2419	6
CN2201700000000	22	017	Caddo Parish, LA	1990	NA	113674	106510	7164	6.3
CN2201900000000	22	019	Calcasieu Parish, LA	1990	NA	78258	73770	4488	5.7
CN2202100000000	22	021	Caldwell Parish, LA	1990	NA	3918	3614	304	7.8
CN2202300000000	22	023	Cameron Parish, LA	1990	NA	4219	4045	174	4.1
CN2202500000000	22	025	Catahoula Parish, LA	1990	NA	4249	3913	336	7.9
CN2202700000000	22	027	Claiborne Parish, LA	1990	NA	6145	5783	362	5.9
CN2202900000000	22	029	Concordia Parish, LA	1990	NA	8440	7574	866	10.3
CN2203100000000	22	031	De Soto Parish, LA	1990	NA	9957	9119	838	8.4
CN2203300000000	22	033	East Baton Rouge Parish, LA	1990	NA	195744	186262	9482	4.8
CN2203500000000	22	035	East Carroll Parish, LA	1990	NA	3162	2740	422	13.3
CN2203700000000	22	037	East Feliciana Parish, LA	1990	NA	7214	6781	433	6
CN2203900000000	22	039	Evangeline Parish, LA	1990	NA	11419	10583	836	7.3
CN2204100000000	22	041	Franklin Parish, LA	1990	NA	8844	8131	713	8.1
CN2204300000000	22	043	Grant Parish, LA	1990	NA	7079	6618	461	6.5
CN2204500000000	22	045	Iberia Parish, LA	1990	NA	28959	27610	1349	4.7
CN2204700000000	22	047	Iberville Parish, LA	1990	NA	12729	11730	999	7.8
CN2204900000000	22	049	Jackson Parish, LA	1990	NA	6028	5735	293	4.9
CN2205100000000	22	051	Jefferson Parish, LA	1990	NA	227895	215122	12773	5.6
CN2205300000000	22	053	Jefferson Davis Parish, LA	1990	NA	11993	11186	807	6.7
CN2205500000000	22	055	Lafayette Parish, LA	1990	NA	82767	79340	3427	4.1
CN2205700000000	22	057	Lafourche Parish, LA	1990	NA	36709	35207	1502	4.1
CN2205900000000	22	059	LaSalle Parish, LA	1990	NA	5758	5497	261	4.5
CN2206100000000	22	061	Lincoln Parish, LA	1990	NA	17774	16888	886	5
CN2206300000000	22	063	Livingston Parish, LA	1990	NA	33458	31109	2349	7
CN2206500000000	22	065	Madison Parish, LA	1990	NA	4623	4106	517	11.2
CN2206700000000	22	067	Morehouse Parish, LA	1990	NA	12361	11315	1046	8.5
CN2206900000000	22	069	Natchitoches Parish, LA	1990	NA	15043	13820	1223	8.1
CN2207100000000	22	071	Orleans Parish, LA	1990	NA	206740	192133	14607	7.1
CN2207300000000	22	073	Ouachita Parish, LA	1990	NA	65848	62230	3618	5.5
CN2207500000000	22	075	Plaquemines Parish, LA	1990	NA	10156	9532	624	6.1
CN2207700000000	22	077	Pointe Coupee Parish, LA	1990	NA	9022	8173	849	9.4
CN2207900000000	22	079	Rapides Parish, LA	1990	NA	55984	52663	3321	5.9
CN2208100000000	22	081	Red River Parish, LA	1990	NA	3703	3399	304	8.2
CN2208300000000	22	083	Richland Parish, LA	1990	NA	8417	7664	753	8.9
CN2208500000000	22	085	Sabine Parish, LA	1990	NA	8465	8089	376	4.4
CN2208700000000	22	087	St. Bernard Parish, LA	1990	NA	31338	28899	2439	7.8
CN2208900000000	22	089	St. Charles Parish, LA	1990	NA	19680	18486	1194	6.1
CN2209100000000	22	091	St. Helena Parish, LA	1990	NA	3639	3400	239	6.6
CN2209300000000	22	093	St. James Parish, LA	1990	NA	8881	8182	699	7.9
CN2209500000000	22	095	St. John the Baptist Parish, LA	1990	NA	17966	16537	1429	8
CN2209700000000	22	097	St. Landry Parish, LA	1990	NA	29805	27318	2487	8.3
CN2209900000000	22	099	St. Martin Parish, LA	1990	NA	19012	17943	1069	5.6
CN2210100000000	22	101	St. Mary Parish, LA	1990	NA	24692	23141	1551	6.3
CN2210300000000	22	103	St. Tammany Parish, LA	1990	NA	68345	64307	4038	5.9
CN2210500000000	22	105	Tangipahoa Parish, LA	1990	NA	35325	32042	3283	9.3
CN2210700000000	22	107	Tensas Parish, LA	1990	NA	2657	2461	196	7.4
CN2210900000000	22	109	Terrebonne Parish, LA	1990	NA	40524	38758	1766	4.4
CN2211100000000	22	111	Union Parish, LA	1990	NA	8554	8036	518	6.1
CN2211300000000	22	113	Vermilion Parish, LA	1990	NA	20186	19082	1104	5.5
CN2211500000000	22	115	Vernon Parish, LA	1990	NA	16523	15391	1132	6.9
CN2211700000000	22	117	Washington Parish, LA	1990	NA	15933	14616	1317	8.3
CN2211900000000	22	119	Webster Parish, LA	1990	NA	17798	16262	1536	8.6
CN2212100000000	22	121	West Baton Rouge Parish, LA	1990	NA	9205	8642	563	6.1
CN2212300000000	22	123	West Carroll Parish, LA	1990	NA	5034	4440	594	11.8
CN2212500000000	22	125	West Feliciana Parish, LA	1990	NA	3740	3486	254	6.8
CN2212700000000	22	127	Winn Parish, LA	1990	NA	6166	5906	260	4.2
CN2300100000000	23	001	Androscoggin County, ME	1990	NA	56390	52567	3823	6.8
CN2300300000000	23	003	Aroostook County, ME	1990	NA	38969	36275	2694	6.9
CN2300500000000	23	005	Cumberland County, ME	1990	NA	133386	128316	5070	3.8
CN2300700000000	23	007	Franklin County, ME	1990	NA	14490	13567	923	6.4
CN2300900000000	23	009	Hancock County, ME	1990	NA	24616	23384	1232	5
CN2301100000000	23	011	Kennebec County, ME	1990	NA	61194	58451	2743	4.5
CN2301300000000	23	013	Knox County, ME	1990	NA	18127	17187	940	5.2
CN2301500000000	23	015	Lincoln County, ME	1990	NA	15361	14828	533	3.5
CN2301700000000	23	017	Oxford County, ME	1990	NA	25183	23427	1756	7
CN2301900000000	23	019	Penobscot County, ME	1990	NA	74551	70218	4333	5.8
CN2302100000000	23	021	Piscataquis County, ME	1990	NA	8688	8132	556	6.4
CN2302300000000	23	023	Sagadahoc County, ME	1990	NA	16194	15627	567	3.5
CN2302500000000	23	025	Somerset County, ME	1990	NA	24593	22897	1696	6.9
CN2302700000000	23	027	Waldo County, ME	1990	NA	16181	14998	1183	7.3
CN2302900000000	23	029	Washington County, ME	1990	NA	15539	14357	1182	7.6
CN2303100000000	23	031	York County, ME	1990	NA	89556	85251	4305	4.8
CN2400100000000	24	001	Allegany County, MD	1990	NA	32436	28861	3575	11
CN2400300000000	24	003	Anne Arundel County, MD	1990	NA	231124	223411	7713	3.3
CN2400500000000	24	005	Baltimore County, MD	1990	NA	381809	364422	17387	4.6
CN2400900000000	24	009	Calvert County, MD	1990	NA	27857	26872	985	3.5
CN2401100000000	24	011	Caroline County, MD	1990	NA	13922	13319	603	4.3
CN2401300000000	24	013	Carroll County, MD	1990	NA	68304	65813	2491	3.6
CN2401500000000	24	015	Cecil County, MD	1990	NA	36035	32460	3575	9.9
CN2401700000000	24	017	Charles County, MD	1990	NA	53937	52438	1499	2.8
CN2401900000000	24	019	Dorchester County, MD	1990	NA	15785	14640	1145	7.3
CN2402100000000	24	021	Frederick County, MD	1990	NA	83985	80644	3341	4
CN2402300000000	24	023	Garrett County, MD	1990	NA	13471	12210	1261	9.4
CN2402500000000	24	025	Harford County, MD	1990	NA	97847	93582	4265	4.4
CN2402700000000	24	027	Howard County, MD	1990	NA	113015	110229	2786	2.5
CN2402900000000	24	029	Kent County, MD	1990	NA	9379	8852	527	5.6
CN2403100000000	24	031	Montgomery County, MD	1990	NA	439402	428862	10540	2.4
CN2403300000000	24	033	Prince George's County, MD	1990	NA	425173	410389	14784	3.5
CN2403500000000	24	035	Queen Anne's County, MD	1990	NA	18045	17439	606	3.4
CN2403700000000	24	037	St. Mary's County, MD	1990	NA	38132	36543	1589	4.2
CN2403900000000	24	039	Somerset County, MD	1990	NA	11106	9452	1654	14.9
CN2404100000000	24	041	Talbot County, MD	1990	NA	16375	15899	476	2.9
CN2404300000000	24	043	Washington County, MD	1990	NA	60721	56654	4067	6.7
CN2404500000000	24	045	Wicomico County, MD	1990	NA	42199	39378	2821	6.7
CN2404700000000	24	047	Worcester County, MD	1990	NA	22293	20464	1829	8.2
CN2451000000000	24	510	Baltimore city, MD	1990	NA	337704	311677	26027	7.7
CN2500100000000	25	001	Barnstable County, MA	1990	NA	96888	89746	7142	7.4
CN2500300000000	25	003	Berkshire County, MA	1990	NA	69468	64560	4908	7.1
CN2500500000000	25	005	Bristol County, MA	1990	NA	263577	239502	24075	9.1
CN2500700000000	25	007	Dukes County, MA	1990	NA	7486	7107	379	5.1
CN2500900000000	25	009	Essex County, MA	1990	NA	347708	324575	23133	6.7
CN2501100000000	25	011	Franklin County, MA	1990	NA	36971	35063	1908	5.2
CN2501300000000	25	013	Hampden County, MA	1990	NA	221488	206780	14708	6.6
CN2501500000000	25	015	Hampshire County, MA	1990	NA	79717	75648	4069	5.1
CN2501700000000	25	017	Middlesex County, MA	1990	NA	796639	755721	40918	5.1
CN2501900000000	25	019	Nantucket County/town, MA	1990	NA	4729	4578	151	3.2
CN2502100000000	25	021	Norfolk County, MA	1990	NA	342414	324880	17534	5.1
CN2502300000000	25	023	Plymouth County, MA	1990	NA	228461	212039	16422	7.2
CN2502500000000	25	025	Suffolk County, MA	1990	NA	347860	326650	21210	6.1
CN2502700000000	25	027	Worcester County, MA	1990	NA	362977	337623	25354	7
CN2600100000000	26	001	Alcona County, MI	1990	NA	3915	3407	508	13
CN2600300000000	26	003	Alger County, MI	1990	NA	3796	3450	346	9.1
CN2600500000000	26	005	Allegan County, MI	1990	NA	45784	43022	2762	6
CN2600700000000	26	007	Alpena County, MI	1990	NA	14261	12818	1443	10.1
CN2600900000000	26	009	Antrim County, MI	1990	NA	8848	7964	884	10
CN2601100000000	26	011	Arenac County, MI	1990	NA	6149	5601	548	8.9
CN2601300000000	26	013	Baraga County, MI	1990	NA	3333	2987	346	10.4
CN2601500000000	26	015	Barry County, MI	1990	NA	25100	23552	1548	6.2
CN2601700000000	26	017	Bay County, MI	1990	NA	53591	49358	4233	7.9
CN2601900000000	26	019	Benzie County, MI	1990	NA	6042	5342	700	11.6
CN2602100000000	26	021	Berrien County, MI	1990	NA	81024	75421	5603	6.9
CN2602300000000	26	023	Branch County, MI	1990	NA	19661	18246	1415	7.2
CN2602500000000	26	025	Calhoun County, MI	1990	NA	64679	60025	4654	7.2
CN2602700000000	26	027	Cass County, MI	1990	NA	24634	22861	1773	7.2
CN2602900000000	26	029	Charlevoix County, MI	1990	NA	11243	10313	930	8.3
CN2603100000000	26	031	Cheboygan County, MI	1990	NA	10476	9228	1248	11.9
CN2603300000000	26	033	Chippewa County, MI	1990	NA	14581	12944	1637	11.2
CN2603500000000	26	035	Clare County, MI	1990	NA	9234	8256	978	10.6
CN2603700000000	26	037	Clinton County, MI	1990	NA	31298	29326	1972	6.3
CN2603900000000	26	039	Crawford County, MI	1990	NA	5353	4998	355	6.6
CN2604100000000	26	041	Delta County, MI	1990	NA	16899	15342	1557	9.2
CN2604300000000	26	043	Dickinson County, MI	1990	NA	12440	11514	926	7.4
CN2604500000000	26	045	Eaton County, MI	1990	NA	51227	48218	3009	5.9
CN2604700000000	26	047	Emmet County, MI	1990	NA	14091	12778	1313	9.3
CN2604900000000	26	049	Genesee County, MI	1990	NA	199478	180647	18831	9.4
CN2605100000000	26	051	Gladwin County, MI	1990	NA	8068	7295	773	9.6
CN2605300000000	26	053	Gogebic County, MI	1990	NA	7243	6657	586	8.1
CN2605500000000	26	055	Grand Traverse County, MI	1990	NA	35901	33483	2418	6.7
CN2605700000000	26	057	Gratiot County, MI	1990	NA	18421	16801	1620	8.8
CN2605900000000	26	059	Hillsdale County, MI	1990	NA	21008	19221	1787	8.5
CN2606100000000	26	061	Houghton County, MI	1990	NA	14542	13472	1070	7.4
CN2606300000000	26	063	Huron County, MI	1990	NA	15873	14249	1624	10.2
CN2606500000000	26	065	Ingham County, MI	1990	NA	150555	141367	9188	6.1
CN2606700000000	26	067	Ionia County, MI	1990	NA	26949	24299	2650	9.8
CN2606900000000	26	069	Iosco County, MI	1990	NA	11122	10192	930	8.4
CN2607100000000	26	071	Iron County, MI	1990	NA	5272	4809	463	8.8
CN2607300000000	26	073	Isabella County, MI	1990	NA	25846	24280	1566	6.1
CN2607500000000	26	075	Jackson County, MI	1990	NA	71169	66155	5014	7
CN2607700000000	26	077	Kalamazoo County, MI	1990	NA	119722	113536	6186	5.2
CN2607900000000	26	079	Kalkaska County, MI	1990	NA	6118	5522	596	9.7
CN2608100000000	26	081	Kent County, MI	1990	NA	269082	254097	14985	5.6
CN2608300000000	26	083	Keweenaw County, MI	1990	NA	603	514	89	14.8
CN2608500000000	26	085	Lake County, MI	1990	NA	2719	2397	322	11.8
CN2608700000000	26	087	Lapeer County, MI	1990	NA	37499	33672	3827	10.2
CN2608900000000	26	089	Leelanau County, MI	1990	NA	8741	8200	541	6.2
CN2609100000000	26	091	Lenawee County, MI	1990	NA	43690	40425	3265	7.5
CN2609300000000	26	093	Livingston County, MI	1990	NA	61739	58218	3521	5.7
CN2609500000000	26	095	Luce County, MI	1990	NA	2410	2192	218	9
CN2609700000000	26	097	Mackinac County, MI	1990	NA	6207	5327	880	14.2
CN2609900000000	26	099	Macomb County, MI	1990	NA	392960	362426	30534	7.8
CN2610100000000	26	101	Manistee County, MI	1990	NA	9354	8369	985	10.5
CN2610300000000	26	103	Marquette County, MI	1990	NA	31984	29445	2539	7.9
CN2610500000000	26	105	Mason County, MI	1990	NA	12145	11146	999	8.2
CN2610700000000	26	107	Mecosta County, MI	1990	NA	16394	15091	1303	7.9
CN2610900000000	26	109	Menominee County, MI	1990	NA	11982	11173	809	6.8
CN2611100000000	26	111	Midland County, MI	1990	NA	37628	35583	2045	5.4
CN2611300000000	26	113	Missaukee County, MI	1990	NA	5362	4803	559	10.4
CN2611500000000	26	115	Monroe County, MI	1990	NA	67443	62360	5083	7.5
CN2611700000000	26	117	Montcalm County, MI	1990	NA	23667	20292	3375	14.3
CN2611900000000	26	119	Montmorency County, MI	1990	NA	3228	2744	484	15
CN2612100000000	26	121	Muskegon County, MI	1990	NA	73125	67024	6101	8.3
CN2612300000000	26	123	Newaygo County, MI	1990	NA	17215	15571	1644	9.5
CN2612500000000	26	125	Oakland County, MI	1990	NA	604705	568400	36305	6
CN2612700000000	26	127	Oceana County, MI	1990	NA	11248	10030	1218	10.8
CN2612900000000	26	129	Ogemaw County, MI	1990	NA	7188	6487	701	9.8
CN2613100000000	26	131	Ontonagon County, MI	1990	NA	3864	3654	210	5.4
CN2613300000000	26	133	Osceola County, MI	1990	NA	8757	7777	980	11.2
CN2613500000000	26	135	Oscoda County, MI	1990	NA	2914	2679	235	8.1
CN2613700000000	26	137	Otsego County, MI	1990	NA	9329	8757	572	6.1
CN2613900000000	26	139	Ottawa County, MI	1990	NA	104454	98998	5456	5.2
CN2614100000000	26	141	Presque Isle County, MI	1990	NA	6034	5334	700	11.6
CN2614300000000	26	143	Roscommon County, MI	1990	NA	7123	6483	640	9
CN2614500000000	26	145	Saginaw County, MI	1990	NA	97106	89686	7420	7.6
CN2614700000000	26	147	St. Clair County, MI	1990	NA	72462	65611	6851	9.5
CN2614900000000	26	149	St. Joseph County, MI	1990	NA	29598	27065	2533	8.6
CN2615100000000	26	151	Sanilac County, MI	1990	NA	18949	16918	2031	10.7
CN2615300000000	26	153	Schoolcraft County, MI	1990	NA	3796	3187	609	16
CN2615500000000	26	155	Shiawassee County, MI	1990	NA	35023	31648	3375	9.6
CN2615700000000	26	157	Tuscola County, MI	1990	NA	26002	23508	2494	9.6
CN2615900000000	26	159	Van Buren County, MI	1990	NA	33643	30754	2889	8.6
CN2616100000000	26	161	Washtenaw County, MI	1990	NA	158174	150634	7540	4.8
CN2616300000000	26	163	Wayne County, MI	1990	NA	944393	857281	87112	9.2
CN2616500000000	26	165	Wexford County, MI	1990	NA	12368	10862	1506	12.2
CN2700100000000	27	001	Aitkin County, MN	1990	NA	5214	4666	548	10.5
CN2700300000000	27	003	Anoka County, MN	1990	NA	145162	138604	6558	4.5
CN2700500000000	27	005	Becker County, MN	1990	NA	12652	11712	940	7.4
CN2700700000000	27	007	Beltrami County, MN	1990	NA	15670	14495	1175	7.5
CN2700900000000	27	009	Benton County, MN	1990	NA	16926	15853	1073	6.3
CN2701100000000	27	011	Big Stone County, MN	1990	NA	2928	2804	124	4.2
CN2701300000000	27	013	Blue Earth County, MN	1990	NA	29863	28744	1119	3.7
CN2701500000000	27	015	Brown County, MN	1990	NA	14303	13699	604	4.2
CN2701700000000	27	017	Carlton County, MN	1990	NA	13364	12378	986	7.4
CN2701900000000	27	019	Carver County, MN	1990	NA	28264	27235	1029	3.6
CN2702100000000	27	021	Cass County, MN	1990	NA	9133	8243	890	9.7
CN2702300000000	27	023	Chippewa County, MN	1990	NA	6429	6115	314	4.9
CN2702500000000	27	025	Chisago County, MN	1990	NA	15663	14578	1085	6.9
CN2702700000000	27	027	Clay County, MN	1990	NA	27583	26115	1468	5.3
CN2702900000000	27	029	Clearwater County, MN	1990	NA	3530	2947	583	16.5
CN2703100000000	27	031	Cook County, MN	1990	NA	2260	2060	200	8.8
CN2703300000000	27	033	Cottonwood County, MN	1990	NA	5912	5542	370	6.3
CN2703500000000	27	035	Crow Wing County, MN	1990	NA	20999	19511	1488	7.1
CN2703700000000	27	037	Dakota County, MN	1990	NA	166461	160414	6047	3.6
CN2703900000000	27	039	Dodge County, MN	1990	NA	8033	7609	424	5.3
CN2704100000000	27	041	Douglas County, MN	1990	NA	14342	13521	821	5.7
CN2704300000000	27	043	Faribault County, MN	1990	NA	8318	7905	413	5
CN2704500000000	27	045	Fillmore County, MN	1990	NA	10359	9880	479	4.6
CN2704700000000	27	047	Freeborn County, MN	1990	NA	17375	15388	1987	11.4
CN2704900000000	27	049	Goodhue County, MN	1990	NA	20870	20119	751	3.6
CN2705100000000	27	051	Grant County, MN	1990	NA	2843	2656	187	6.6
CN2705300000000	27	053	Hennepin County, MN	1990	NA	616943	592350	24593	4
CN2705500000000	27	055	Houston County, MN	1990	NA	9765	9426	339	3.5
CN2705700000000	27	057	Hubbard County, MN	1990	NA	6711	6090	621	9.3
CN2705900000000	27	059	Isanti County, MN	1990	NA	13225	12445	780	5.9
CN2706100000000	27	061	Itasca County, MN	1990	NA	17626	15781	1845	10.5
CN2706300000000	27	063	Jackson County, MN	1990	NA	5510	5268	242	4.4
CN2706500000000	27	065	Kanabec County, MN	1990	NA	6554	5871	683	10.4
CN2706700000000	27	067	Kandiyohi County, MN	1990	NA	19207	18316	891	4.6
CN2706900000000	27	069	Kittson County, MN	1990	NA	2597	2392	205	7.9
CN2707100000000	27	071	Koochiching County, MN	1990	NA	7951	7395	556	7
CN2707300000000	27	073	Lac qui Parle County, MN	1990	NA	4049	3910	139	3.4
CN2707500000000	27	075	Lake County, MN	1990	NA	5082	4744	338	6.7
CN2707700000000	27	077	Lake of the Woods County, MN	1990	NA	2092	2025	67	3.2
CN2707900000000	27	079	Le Sueur County, MN	1990	NA	12040	11336	704	5.8
CN2708100000000	27	081	Lincoln County, MN	1990	NA	3234	3097	137	4.2
CN2708300000000	27	083	Lyon County, MN	1990	NA	13139	12570	569	4.3
CN2708500000000	27	085	McLeod County, MN	1990	NA	17976	17212	764	4.3
CN2708700000000	27	087	Mahnomen County, MN	1990	NA	1850	1637	213	11.5
CN2708900000000	27	089	Marshall County, MN	1990	NA	4968	4347	621	12.5
CN2709100000000	27	091	Martin County, MN	1990	NA	11630	11111	519	4.5
CN2709300000000	27	093	Meeker County, MN	1990	NA	10192	9530	662	6.5
CN2709500000000	27	095	Mille Lacs County, MN	1990	NA	8989	8319	670	7.5
CN2709700000000	27	097	Morrison County, MN	1990	NA	13913	12589	1324	9.5
CN2709900000000	27	099	Mower County, MN	1990	NA	17511	16757	754	4.3
CN2710100000000	27	101	Murray County, MN	1990	NA	4550	4325	225	4.9
CN2710300000000	27	103	Nicollet County, MN	1990	NA	15764	15157	607	3.9
CN2710500000000	27	105	Nobles County, MN	1990	NA	9973	9622	351	3.5
CN2710700000000	27	107	Norman County, MN	1990	NA	3515	3306	209	5.9
CN2710900000000	27	109	Olmsted County, MN	1990	NA	62072	60334	1738	2.8
CN2711100000000	27	111	Otter Tail County, MN	1990	NA	24577	23073	1504	6.1
CN2711300000000	27	113	Pennington County, MN	1990	NA	6756	6131	625	9.3
CN2711500000000	27	115	Pine County, MN	1990	NA	9231	8247	984	10.7
CN2711700000000	27	117	Pipestone County, MN	1990	NA	4866	4556	310	6.4
CN2711900000000	27	119	Polk County, MN	1990	NA	15182	14108	1074	7.1
CN2712100000000	27	121	Pope County, MN	1990	NA	4935	4660	275	5.6
CN2712300000000	27	123	Ramsey County, MN	1990	NA	271999	261185	10814	4
CN2712500000000	27	125	Red Lake County, MN	1990	NA	2079	1759	320	15.4
CN2712700000000	27	127	Redwood County, MN	1990	NA	8404	8139	265	3.2
CN2712900000000	27	129	Renville County, MN	1990	NA	8257	7751	506	6.1
CN2713100000000	27	131	Rice County, MN	1990	NA	27341	26127	1214	4.4
CN2713300000000	27	133	Rock County, MN	1990	NA	4816	4690	126	2.6
CN2713500000000	27	135	Roseau County, MN	1990	NA	8058	7686	372	4.6
CN2713700000000	27	137	St. Louis County, MN	1990	NA	93710	87687	6023	6.4
CN2713900000000	27	139	Scott County, MN	1990	NA	33552	32046	1506	4.5
CN2714100000000	27	141	Sherburne County, MN	1990	NA	22580	21330	1250	5.5
CN2714300000000	27	143	Sibley County, MN	1990	NA	6911	6563	348	5
CN2714500000000	27	145	Stearns County, MN	1990	NA	65911	62252	3659	5.6
CN2714700000000	27	147	Steele County, MN	1990	NA	16800	16206	594	3.5
CN2714900000000	27	149	Stevens County, MN	1990	NA	5252	4958	294	5.6
CN2715100000000	27	151	Swift County, MN	1990	NA	4640	4423	217	4.7
CN2715300000000	27	153	Todd County, MN	1990	NA	10340	9531	809	7.8
CN2715500000000	27	155	Traverse County, MN	1990	NA	1889	1793	96	5.1
CN2715700000000	27	157	Wabasha County, MN	1990	NA	10264	9814	450	4.4
CN2715900000000	27	159	Wadena County, MN	1990	NA	5874	5462	412	7
CN2716100000000	27	161	Waseca County, MN	1990	NA	9558	9195	363	3.8
CN2716300000000	27	163	Washington County, MN	1990	NA	83089	79983	3106	3.7
CN2716500000000	27	165	Watonwan County, MN	1990	NA	5693	5496	197	3.5
CN2716700000000	27	167	Wilkin County, MN	1990	NA	3661	3485	176	4.8
CN2716900000000	27	169	Winona County, MN	1990	NA	26694	25184	1510	5.7
CN2717100000000	27	171	Wright County, MN	1990	NA	37538	35441	2097	5.6
CN2717300000000	27	173	Yellow Medicine County, MN	1990	NA	5370	5137	233	4.3
CN2800100000000	28	001	Adams County, MS	1990	NA	15095	13887	1208	8
CN2800300000000	28	003	Alcorn County, MS	1990	NA	15629	14123	1506	9.6
CN2800500000000	28	005	Amite County, MS	1990	NA	5026	4718	308	6.1
CN2800700000000	28	007	Attala County, MS	1990	NA	8008	7185	823	10.3
CN2800900000000	28	009	Benton County, MS	1990	NA	3333	2996	337	10.1
CN2801100000000	28	011	Bolivar County, MS	1990	NA	16829	15346	1483	8.8
CN2801300000000	28	013	Calhoun County, MS	1990	NA	7213	6584	629	8.7
CN2801500000000	28	015	Carroll County, MS	1990	NA	4080	3770	310	7.6
CN2801700000000	28	017	Chickasaw County, MS	1990	NA	9608	8256	1352	14.1
CN2801900000000	28	019	Choctaw County, MS	1990	NA	3766	3417	349	9.3
CN2802100000000	28	021	Claiborne County, MS	1990	NA	4121	3495	626	15.2
CN2802300000000	28	023	Clarke County, MS	1990	NA	8232	7645	587	7.1
CN2802500000000	28	025	Clay County, MS	1990	NA	9844	8777	1067	10.8
CN2802700000000	28	027	Coahoma County, MS	1990	NA	11988	10612	1376	11.5
CN2802900000000	28	029	Copiah County, MS	1990	NA	11635	10547	1088	9.4
CN2803100000000	28	031	Covington County, MS	1990	NA	7337	6674	663	9
CN2803300000000	28	033	DeSoto County, MS	1990	NA	37384	35387	1997	5.3
CN2803500000000	28	035	Forrest County, MS	1990	NA	31900	29683	2217	6.9
CN2803700000000	28	037	Franklin County, MS	1990	NA	3048	2825	223	7.3
CN2803900000000	28	039	George County, MS	1990	NA	7239	6458	781	10.8
CN2804100000000	28	041	Greene County, MS	1990	NA	3963	3510	453	11.4
CN2804300000000	28	043	Grenada County, MS	1990	NA	10171	9092	1079	10.6
CN2804500000000	28	045	Hancock County, MS	1990	NA	12887	11960	927	7.2
CN2804700000000	28	047	Harrison County, MS	1990	NA	72257	67426	4831	6.7
CN2804900000000	28	049	Hinds County, MS	1990	NA	128614	121424	7190	5.6
CN2805100000000	28	051	Holmes County, MS	1990	NA	6871	5958	913	13.3
CN2805300000000	28	053	Humphreys County, MS	1990	NA	5165	4749	416	8.1
CN2805500000000	28	055	Issaquena County, MS	1990	NA	850	748	102	12
CN2805700000000	28	057	Itawamba County, MS	1990	NA	10685	9946	739	6.9
CN2805900000000	28	059	Jackson County, MS	1990	NA	55330	51351	3979	7.2
CN2806100000000	28	061	Jasper County, MS	1990	NA	7140	6481	659	9.2
CN2806300000000	28	063	Jefferson County, MS	1990	NA	2984	2299	685	23
CN2806500000000	28	065	Jefferson Davis County, MS	1990	NA	5674	4904	770	13.6
CN2806700000000	28	067	Jones County, MS	1990	NA	27812	26028	1784	6.4
CN2806900000000	28	069	Kemper County, MS	1990	NA	4294	3859	435	10.1
CN2807100000000	28	071	Lafayette County, MS	1990	NA	15251	14430	821	5.4
CN2807300000000	28	073	Lamar County, MS	1990	NA	14596	13866	730	5
CN2807500000000	28	075	Lauderdale County, MS	1990	NA	34741	32278	2463	7.1
CN2807700000000	28	077	Lawrence County, MS	1990	NA	5208	4734	474	9.1
CN2807900000000	28	079	Leake County, MS	1990	NA	8001	7419	582	7.3
CN2808100000000	28	081	Lee County, MS	1990	NA	35356	33033	2323	6.6
CN2808300000000	28	083	Leflore County, MS	1990	NA	15481	13895	1586	10.2
CN2808500000000	28	085	Lincoln County, MS	1990	NA	13135	12132	1003	7.6
CN2808700000000	28	087	Lowndes County, MS	1990	NA	28388	26544	1844	6.5
CN2808900000000	28	089	Madison County, MS	1990	NA	26901	25477	1424	5.3
CN2809100000000	28	091	Marion County, MS	1990	NA	10275	9283	992	9.7
CN2809300000000	28	093	Marshall County, MS	1990	NA	13638	12232	1406	10.3
CN2809500000000	28	095	Monroe County, MS	1990	NA	18094	16683	1411	7.8
CN2809700000000	28	097	Montgomery County, MS	1990	NA	5574	5076	498	8.9
CN2809900000000	28	099	Neshoba County, MS	1990	NA	11597	10832	765	6.6
CN2810100000000	28	101	Newton County, MS	1990	NA	9477	8881	596	6.3
CN2810300000000	28	103	Noxubee County, MS	1990	NA	4948	4363	585	11.8
CN2810500000000	28	105	Oktibbeha County, MS	1990	NA	18236	17053	1183	6.5
CN2810700000000	28	107	Panola County, MS	1990	NA	13049	11855	1194	9.2
CN2810900000000	28	109	Pearl River County, MS	1990	NA	16940	15468	1472	8.7
CN2811100000000	28	111	Perry County, MS	1990	NA	4280	3889	391	9.1
CN2811300000000	28	113	Pike County, MS	1990	NA	15114	13916	1198	7.9
CN2811500000000	28	115	Pontotoc County, MS	1990	NA	11786	11068	718	6.1
CN2811700000000	28	117	Prentiss County, MS	1990	NA	11864	10754	1110	9.4
CN2811900000000	28	119	Quitman County, MS	1990	NA	4141	3688	453	10.9
CN2812100000000	28	121	Rankin County, MS	1990	NA	46918	44900	2018	4.3
CN2812300000000	28	123	Scott County, MS	1990	NA	11369	10683	686	6
CN2812500000000	28	125	Sharkey County, MS	1990	NA	2974	2590	384	12.9
CN2812700000000	28	127	Simpson County, MS	1990	NA	10362	9774	588	5.7
CN2812900000000	28	129	Smith County, MS	1990	NA	6545	6174	371	5.7
CN2813100000000	28	131	Stone County, MS	1990	NA	4833	4481	352	7.3
CN2813300000000	28	133	Sunflower County, MS	1990	NA	12359	10924	1435	11.6
CN2813500000000	28	135	Tallahatchie County, MS	1990	NA	6058	5373	685	11.3
CN2813700000000	28	137	Tate County, MS	1990	NA	10459	9682	777	7.4
CN2813900000000	28	139	Tippah County, MS	1990	NA	9655	8850	805	8.3
CN2814100000000	28	141	Tishomingo County, MS	1990	NA	9091	7910	1181	13
CN2814300000000	28	143	Tunica County, MS	1990	NA	2947	2551	396	13.4
CN2814500000000	28	145	Union County, MS	1990	NA	11524	10729	795	6.9
CN2814700000000	28	147	Walthall County, MS	1990	NA	5355	4990	365	6.8
CN2814900000000	28	149	Warren County, MS	1990	NA	22463	20786	1677	7.5
CN2815100000000	28	151	Washington County, MS	1990	NA	29066	26037	3029	10.4
CN2815300000000	28	153	Wayne County, MS	1990	NA	8678	7907	771	8.9
CN2815500000000	28	155	Webster County, MS	1990	NA	4371	3998	373	8.5
CN2815700000000	28	157	Wilkinson County, MS	1990	NA	3452	3142	310	9
CN2815900000000	28	159	Winston County, MS	1990	NA	8556	7885	671	7.8
CN2816100000000	28	161	Yalobusha County, MS	1990	NA	5461	4960	501	9.2
CN2816300000000	28	163	Yazoo County, MS	1990	NA	9407	8748	659	7
CN2900100000000	29	001	Adair County, MO	1990	NA	13167	12367	800	6.1
CN2900300000000	29	003	Andrew County, MO	1990	NA	7467	7056	411	5.5
CN2900500000000	29	005	Atchison County, MO	1990	NA	3469	3365	104	3
CN2900700000000	29	007	Audrain County, MO	1990	NA	11271	10718	553	4.9
CN2900900000000	29	009	Barry County, MO	1990	NA	12692	12121	571	4.5
CN2901100000000	29	011	Barton County, MO	1990	NA	5467	5312	155	2.8
CN2901300000000	29	013	Bates County, MO	1990	NA	6567	6114	453	6.9
CN2901500000000	29	015	Benton County, MO	1990	NA	5547	5090	457	8.2
CN2901700000000	29	017	Bollinger County, MO	1990	NA	4719	4308	411	8.7
CN2901900000000	29	019	Boone County, MO	1990	NA	67732	65172	2560	3.8
CN2902100000000	29	021	Buchanan County, MO	1990	NA	40888	38077	2811	6.9
CN2902300000000	29	023	Butler County, MO	1990	NA	16964	15681	1283	7.6
CN2902500000000	29	025	Caldwell County, MO	1990	NA	3586	3367	219	6.1
CN2902700000000	29	027	Callaway County, MO	1990	NA	17166	16424	742	4.3
CN2902900000000	29	029	Camden County, MO	1990	NA	13304	12307	997	7.5
CN2903100000000	29	031	Cape Girardeau County, MO	1990	NA	32770	31012	1758	5.4
CN2903300000000	29	033	Carroll County, MO	1990	NA	4727	4385	342	7.2
CN2903500000000	29	035	Carter County, MO	1990	NA	2196	1970	226	10.3
CN2903700000000	29	037	Cass County, MO	1990	NA	33970	32352	1618	4.8
CN2903900000000	29	039	Cedar County, MO	1990	NA	5149	4858	291	5.7
CN2904100000000	29	041	Chariton County, MO	1990	NA	4324	4120	204	4.7
CN2904300000000	29	043	Christian County, MO	1990	NA	17366	16389	977	5.6
CN2904500000000	29	045	Clark County, MO	1990	NA	3481	3360	121	3.5
CN2904700000000	29	047	Clay County, MO	1990	NA	88188	84475	3713	4.2
CN2904900000000	29	049	Clinton County, MO	1990	NA	8108	7702	406	5
CN2905100000000	29	051	Cole County, MO	1990	NA	33686	32484	1202	3.6
CN2905300000000	29	053	Cooper County, MO	1990	NA	7260	6784	476	6.6
CN2905500000000	29	055	Crawford County, MO	1990	NA	8724	7948	776	8.9
CN2905700000000	29	057	Dade County, MO	1990	NA	3044	2914	130	4.3
CN2905900000000	29	059	Dallas County, MO	1990	NA	5535	5094	441	8
CN2906100000000	29	061	Daviess County, MO	1990	NA	3310	3125	185	5.6
CN2906300000000	29	063	DeKalb County, MO	1990	NA	3680	3492	188	5.1
CN2906500000000	29	065	Dent County, MO	1990	NA	5561	5157	404	7.3
CN2906700000000	29	067	Douglas County, MO	1990	NA	5321	4940	381	7.2
CN2906900000000	29	069	Dunklin County, MO	1990	NA	13319	12088	1231	9.2
CN2907100000000	29	071	Franklin County, MO	1990	NA	42830	38959	3871	9
CN2907300000000	29	073	Gasconade County, MO	1990	NA	7128	6599	529	7.4
CN2907500000000	29	075	Gentry County, MO	1990	NA	3000	2916	84	2.8
CN2907700000000	29	077	Greene County, MO	1990	NA	109432	104109	5323	4.9
CN2907900000000	29	079	Grundy County, MO	1990	NA	4692	4442	250	5.3
CN2908100000000	29	081	Harrison County, MO	1990	NA	4008	3839	169	4.2
CN2908300000000	29	083	Henry County, MO	1990	NA	9174	8464	710	7.7
CN2908500000000	29	085	Hickory County, MO	1990	NA	2559	2391	168	6.6
CN2908700000000	29	087	Holt County, MO	1990	NA	2680	2574	106	4
CN2908900000000	29	089	Howard County, MO	1990	NA	4627	4412	215	4.6
CN2909100000000	29	091	Howell County, MO	1990	NA	14176	13305	871	6.1
CN2909300000000	29	093	Iron County, MO	1990	NA	4282	3847	435	10.2
CN2909500000000	29	095	Jackson County, MO	1990	NA	336967	319303	17664	5.2
CN2909700000000	29	097	Jasper County, MO	1990	NA	45244	42819	2425	5.4
CN2909900000000	29	099	Jefferson County, MO	1990	NA	92597	85482	7115	7.7
CN2910100000000	29	101	Johnson County, MO	1990	NA	21735	20447	1288	5.9
CN2910300000000	29	103	Knox County, MO	1990	NA	2015	1927	88	4.4
CN2910500000000	29	105	Laclede County, MO	1990	NA	13349	11850	1499	11.2
CN2910700000000	29	107	Lafayette County, MO	1990	NA	15224	14288	936	6.1
CN2910900000000	29	109	Lawrence County, MO	1990	NA	14386	13652	734	5.1
CN2911100000000	29	111	Lewis County, MO	1990	NA	4887	4619	268	5.5
CN2911300000000	29	113	Lincoln County, MO	1990	NA	14542	13542	1000	6.9
CN2911500000000	29	115	Linn County, MO	1990	NA	6325	5823	502	7.9
CN2911700000000	29	117	Livingston County, MO	1990	NA	6630	6369	261	3.9
CN2911900000000	29	119	McDonald County, MO	1990	NA	7222	6816	406	5.6
CN2912100000000	29	121	Macon County, MO	1990	NA	7267	6673	594	8.2
CN2912300000000	29	123	Madison County, MO	1990	NA	4725	4281	444	9.4
CN2912500000000	29	125	Maries County, MO	1990	NA	4034	3746	288	7.1
CN2912700000000	29	127	Marion County, MO	1990	NA	13379	12671	708	5.3
CN2912900000000	29	129	Mercer County, MO	1990	NA	1498	1430	68	4.5
CN2913100000000	29	131	Miller County, MO	1990	NA	10391	9446	945	9.1
CN2913300000000	29	133	Mississippi County, MO	1990	NA	6239	5610	629	10.1
CN2913500000000	29	135	Moniteau County, MO	1990	NA	6425	5990	435	6.8
CN2913700000000	29	137	Monroe County, MO	1990	NA	4105	3905	200	4.9
CN2913900000000	29	139	Montgomery County, MO	1990	NA	5366	5011	355	6.6
CN2914100000000	29	141	Morgan County, MO	1990	NA	7222	6651	571	7.9
CN2914300000000	29	143	New Madrid County, MO	1990	NA	8732	7847	885	10.1
CN2914500000000	29	145	Newton County, MO	1990	NA	22798	21280	1518	6.7
CN2914700000000	29	147	Nodaway County, MO	1990	NA	12073	11579	494	4.1
CN2914900000000	29	149	Oregon County, MO	1990	NA	3729	3523	206	5.5
CN2915100000000	29	151	Osage County, MO	1990	NA	6465	6192	273	4.2
CN2915300000000	29	153	Ozark County, MO	1990	NA	3526	3287	239	6.8
CN2915500000000	29	155	Pemiscot County, MO	1990	NA	8210	7400	810	9.9
CN2915700000000	29	157	Perry County, MO	1990	NA	8600	8177	423	4.9
CN2915900000000	29	159	Pettis County, MO	1990	NA	17908	16635	1273	7.1
CN2916100000000	29	161	Phelps County, MO	1990	NA	17279	16237	1042	6
CN2916300000000	29	163	Pike County, MO	1990	NA	7201	6667	534	7.4
CN2916500000000	29	165	Platte County, MO	1990	NA	34555	33267	1288	3.7
CN2916700000000	29	167	Polk County, MO	1990	NA	10000	9334	666	6.7
CN2916900000000	29	169	Pulaski County, MO	1990	NA	13061	11741	1320	10.1
CN2917100000000	29	171	Putnam County, MO	1990	NA	2045	1970	75	3.7
CN2917300000000	29	173	Ralls County, MO	1990	NA	4336	4085	251	5.8
CN2917500000000	29	175	Randolph County, MO	1990	NA	10621	10058	563	5.3
CN2917700000000	29	177	Ray County, MO	1990	NA	10428	9654	774	7.4
CN2917900000000	29	179	Reynolds County, MO	1990	NA	2705	2507	198	7.3
CN2918100000000	29	181	Ripley County, MO	1990	NA	4219	3909	310	7.3
CN2918300000000	29	183	St. Charles County, MO	1990	NA	122632	116895	5737	4.7
CN2918500000000	29	185	St. Clair County, MO	1990	NA	3654	3367	287	7.9
CN2918600000000	29	186	Ste. Genevieve County, MO	1990	NA	7956	7512	444	5.6
CN2918700000000	29	187	St. Francois County, MO	1990	NA	20486	18430	2056	10
CN2918900000000	29	189	St. Louis County, MO	1990	NA	548298	524237	24061	4.4
CN2919500000000	29	195	Saline County, MO	1990	NA	11568	10709	859	7.4
CN2919700000000	29	197	Schuyler County, MO	1990	NA	2115	1995	120	5.7
CN2919900000000	29	199	Scotland County, MO	1990	NA	2157	2094	63	2.9
CN2920100000000	29	201	Scott County, MO	1990	NA	18845	17506	1339	7.1
CN2920300000000	29	203	Shannon County, MO	1990	NA	3475	3130	345	9.9
CN2920500000000	29	205	Shelby County, MO	1990	NA	3150	3017	133	4.2
CN2920700000000	29	207	Stoddard County, MO	1990	NA	13040	11889	1151	8.8
CN2920900000000	29	209	Stone County, MO	1990	NA	9398	8515	883	9.4
CN2921100000000	29	211	Sullivan County, MO	1990	NA	2774	2673	101	3.6
CN2921300000000	29	213	Taney County, MO	1990	NA	14748	13196	1552	10.5
CN2921500000000	29	215	Texas County, MO	1990	NA	9474	8601	873	9.2
CN2921700000000	29	217	Vernon County, MO	1990	NA	8745	8306	439	5
CN2921900000000	29	219	Warren County, MO	1990	NA	10039	9300	739	7.4
CN2922100000000	29	221	Washington County, MO	1990	NA	8160	7077	1083	13.3
CN2922300000000	29	223	Wayne County, MO	1990	NA	4568	4033	535	11.7
CN2922500000000	29	225	Webster County, MO	1990	NA	11195	10275	920	8.2
CN2922700000000	29	227	Worth County, MO	1990	NA	1006	960	46	4.6
CN2922900000000	29	229	Wright County, MO	1990	NA	7603	6896	707	9.3
CN2951000000000	29	510	St. Louis city, MO	1990	NA	181189	165976	15213	8.4
CN3000100000000	30	001	Beaverhead County, MT	1990	NA	4313	4104	209	4.8
CN3000300000000	30	003	Big Horn County, MT	1990	NA	4623	4000	623	13.5
CN3000500000000	30	005	Blaine County, MT	1990	NA	3056	2815	241	7.9
CN3000700000000	30	007	Broadwater County, MT	1990	NA	1671	1595	76	4.5
CN3000900000000	30	009	Carbon County, MT	1990	NA	3750	3590	160	4.3
CN3001100000000	30	011	Carter County, MT	1990	NA	897	880	17	1.9
CN3001300000000	30	013	Cascade County, MT	1990	NA	35986	34034	1952	5.4
CN3001500000000	30	015	Chouteau County, MT	1990	NA	2597	2530	67	2.6
CN3001700000000	30	017	Custer County, MT	1990	NA	5967	5671	296	5
CN3001900000000	30	019	Daniels County, MT	1990	NA	1156	1121	35	3
CN3002100000000	30	021	Dawson County, MT	1990	NA	4875	4690	185	3.8
CN3002300000000	30	023	Deer Lodge County, MT	1990	NA	4048	3657	391	9.7
CN3002500000000	30	025	Fallon County, MT	1990	NA	1577	1537	40	2.5
CN3002700000000	30	027	Fergus County, MT	1990	NA	5873	5557	316	5.4
CN3002900000000	30	029	Flathead County, MT	1990	NA	30452	28148	2304	7.6
CN3003100000000	30	031	Gallatin County, MT	1990	NA	28811	27442	1369	4.8
CN3003300000000	30	033	Garfield County, MT	1990	NA	892	875	17	1.9
CN3003500000000	30	035	Glacier County, MT	1990	NA	5340	4711	629	11.8
CN3003700000000	30	037	Golden Valley County, MT	1990	NA	471	457	14	3
CN3003900000000	30	039	Granite County, MT	1990	NA	1167	1076	91	7.8
CN3004100000000	30	041	Hill County, MT	1990	NA	8415	7959	456	5.4
CN3004300000000	30	043	Jefferson County, MT	1990	NA	4147	3943	204	4.9
CN3004500000000	30	045	Judith Basin County, MT	1990	NA	1169	1130	39	3.3
CN3004700000000	30	047	Lake County, MT	1990	NA	9700	8902	798	8.2
CN3004900000000	30	049	Lewis and Clark County, MT	1990	NA	25688	24530	1158	4.5
CN3005100000000	30	051	Liberty County, MT	1990	NA	957	940	17	1.8
CN3005300000000	30	053	Lincoln County, MT	1990	NA	8383	7355	1028	12.3
CN3005500000000	30	055	McCone County, MT	1990	NA	1151	1114	37	3.2
CN3005700000000	30	057	Madison County, MT	1990	NA	3315	3209	106	3.2
CN3005900000000	30	059	Meagher County, MT	1990	NA	915	882	33	3.6
CN3006100000000	30	061	Mineral County, MT	1990	NA	1779	1623	156	8.8
CN3006300000000	30	063	Missoula County, MT	1990	NA	42921	40383	2538	5.9
CN3006500000000	30	065	Musselshell County, MT	1990	NA	1794	1666	128	7.1
CN3006700000000	30	067	Park County, MT	1990	NA	7736	7320	416	5.4
CN3006900000000	30	069	Petroleum County, MT	1990	NA	262	256	6	2.3
CN3007100000000	30	071	Phillips County, MT	1990	NA	2611	2486	125	4.8
CN3007300000000	30	073	Pondera County, MT	1990	NA	2954	2843	111	3.8
CN3007500000000	30	075	Powder River County, MT	1990	NA	1174	1152	22	1.9
CN3007700000000	30	077	Powell County, MT	1990	NA	2658	2528	130	4.9
CN3007900000000	30	079	Prairie County, MT	1990	NA	673	648	25	3.7
CN3008100000000	30	081	Ravalli County, MT	1990	NA	11783	10795	988	8.4
CN3008300000000	30	083	Richland County, MT	1990	NA	5348	5014	334	6.2
CN3008500000000	30	085	Roosevelt County, MT	1990	NA	4532	4038	494	10.9
CN3008700000000	30	087	Rosebud County, MT	1990	NA	4909	4553	356	7.3
CN3008900000000	30	089	Sanders County, MT	1990	NA	3750	3336	414	11
CN3009100000000	30	091	Sheridan County, MT	1990	NA	2059	1998	61	3
CN3009300000000	30	093	Silver Bow County, MT	1990	NA	16103	14986	1117	6.9
CN3009500000000	30	095	Stillwater County, MT	1990	NA	3307	3178	129	3.9
CN3009700000000	30	097	Sweet Grass County, MT	1990	NA	1539	1501	38	2.5
CN3009900000000	30	099	Teton County, MT	1990	NA	2966	2878	88	3
CN3010100000000	30	101	Toole County, MT	1990	NA	2644	2563	81	3.1
CN3010300000000	30	103	Treasure County, MT	1990	NA	480	463	17	3.5
CN3010500000000	30	105	Valley County, MT	1990	NA	4169	3987	182	4.4
CN3010700000000	30	107	Wheatland County, MT	1990	NA	1129	1083	46	4.1
CN3010900000000	30	109	Wibaux County, MT	1990	NA	529	512	17	3.2
CN3011100000000	30	111	Yellowstone County, MT	1990	NA	61969	58862	3107	5
CN3100100000000	31	001	Adams County, NE	1990	NA	15024	14757	267	1.8
CN3100300000000	31	003	Antelope County, NE	1990	NA	3400	3336	64	1.9
CN3100500000000	31	005	Arthur County, NE	1990	NA	235	231	4	1.7
CN3100700000000	31	007	Banner County, NE	1990	NA	423	418	5	1.2
CN3100900000000	31	009	Blaine County, NE	1990	NA	381	374	7	1.8
CN3101100000000	31	011	Boone County, NE	1990	NA	3053	3020	33	1.1
CN3101300000000	31	013	Box Butte County, NE	1990	NA	6331	6139	192	3
CN3101500000000	31	015	Boyd County, NE	1990	NA	1201	1183	18	1.5
CN3101700000000	31	017	Brown County, NE	1990	NA	1662	1639	23	1.4
CN3101900000000	31	019	Buffalo County, NE	1990	NA	20764	20253	511	2.5
CN3102100000000	31	021	Burt County, NE	1990	NA	3542	3442	100	2.8
CN3102300000000	31	023	Butler County, NE	1990	NA	4049	3962	87	2.1
CN3102500000000	31	025	Cass County, NE	1990	NA	10610	10295	315	3
CN3102700000000	31	027	Cedar County, NE	1990	NA	4790	4719	71	1.5
CN3102900000000	31	029	Chase County, NE	1990	NA	1928	1908	20	1
CN3103100000000	31	031	Cherry County, NE	1990	NA	3150	3102	48	1.5
CN3103300000000	31	033	Cheyenne County, NE	1990	NA	4979	4892	87	1.7
CN3103500000000	31	035	Clay County, NE	1990	NA	3292	3235	57	1.7
CN3103700000000	31	037	Colfax County, NE	1990	NA	4384	4322	62	1.4
CN3103900000000	31	039	Cuming County, NE	1990	NA	5046	4993	53	1.1
CN3104100000000	31	041	Custer County, NE	1990	NA	5836	5746	90	1.5
CN3104300000000	31	043	Dakota County, NE	1990	NA	8772	8472	300	3.4
CN3104500000000	31	045	Dawes County, NE	1990	NA	4185	4030	155	3.7
CN3104700000000	31	047	Dawson County, NE	1990	NA	10625	10324	301	2.8
CN3104900000000	31	049	Deuel County, NE	1990	NA	1087	1069	18	1.7
CN3105100000000	31	051	Dixon County, NE	1990	NA	2977	2915	62	2.1
CN3105300000000	31	053	Dodge County, NE	1990	NA	17630	17099	531	3
CN3105500000000	31	055	Douglas County, NE	1990	NA	227028	221000	6028	2.7
CN3105700000000	31	057	Dundy County, NE	1990	NA	1258	1248	10	0.8
CN3105900000000	31	059	Fillmore County, NE	1990	NA	3409	3370	39	1.1
CN3106100000000	31	061	Franklin County, NE	1990	NA	1724	1704	20	1.2
CN3106300000000	31	063	Frontier County, NE	1990	NA	1573	1553	20	1.3
CN3106500000000	31	065	Furnas County, NE	1990	NA	2483	2435	48	1.9
CN3106700000000	31	067	Gage County, NE	1990	NA	11460	11244	216	1.9
CN3106900000000	31	069	Garden County, NE	1990	NA	1204	1183	21	1.7
CN3107100000000	31	071	Garfield County, NE	1990	NA	1089	1064	25	2.3
CN3107300000000	31	073	Gosper County, NE	1990	NA	1057	1041	16	1.5
CN3107500000000	31	075	Grant County, NE	1990	NA	388	386	2	0.5
CN3107700000000	31	077	Greeley County, NE	1990	NA	1491	1463	28	1.9
CN3107900000000	31	079	Hall County, NE	1990	NA	27206	26633	573	2.1
CN3108100000000	31	081	Hamilton County, NE	1990	NA	4676	4612	64	1.4
CN3108300000000	31	083	Harlan County, NE	1990	NA	1848	1821	27	1.5
CN3108500000000	31	085	Hayes County, NE	1990	NA	519	514	5	1
CN3108700000000	31	087	Hitchcock County, NE	1990	NA	1665	1632	33	2
CN3108900000000	31	089	Holt County, NE	1990	NA	6014	5923	91	1.5
CN3109100000000	31	091	Hooker County, NE	1990	NA	374	368	6	1.6
CN3109300000000	31	093	Howard County, NE	1990	NA	3009	2946	63	2.1
CN3109500000000	31	095	Jefferson County, NE	1990	NA	4280	4204	76	1.8
CN3109700000000	31	097	Johnson County, NE	1990	NA	2333	2265	68	2.9
CN3109900000000	31	099	Kearney County, NE	1990	NA	3262	3203	59	1.8
CN3110100000000	31	101	Keith County, NE	1990	NA	4661	4520	141	3
CN3110300000000	31	103	Keya Paha County, NE	1990	NA	517	510	7	1.4
CN3110500000000	31	105	Kimball County, NE	1990	NA	1991	1966	25	1.3
CN3110700000000	31	107	Knox County, NE	1990	NA	4314	4208	106	2.5
CN3110900000000	31	109	Lancaster County, NE	1990	NA	124364	121662	2702	2.2
CN3111100000000	31	111	Lincoln County, NE	1990	NA	16264	15814	450	2.8
CN3111300000000	31	113	Logan County, NE	1990	NA	419	413	6	1.4
CN3111500000000	31	115	Loup County, NE	1990	NA	349	342	7	2
CN3111700000000	31	117	McPherson County, NE	1990	NA	293	290	3	1
CN3111900000000	31	119	Madison County, NE	1990	NA	17226	16873	353	2
CN3112100000000	31	121	Merrick County, NE	1990	NA	4238	4161	77	1.8
CN3112300000000	31	123	Morrill County, NE	1990	NA	2687	2599	88	3.3
CN3112500000000	31	125	Nance County, NE	1990	NA	2009	1974	35	1.7
CN3112700000000	31	127	Nemaha County, NE	1990	NA	3564	3422	142	4
CN3112900000000	31	129	Nuckolls County, NE	1990	NA	2576	2546	30	1.2
CN3113100000000	31	131	Otoe County, NE	1990	NA	7191	7001	190	2.6
CN3113300000000	31	133	Pawnee County, NE	1990	NA	1582	1540	42	2.7
CN3113500000000	31	135	Perkins County, NE	1990	NA	1472	1455	17	1.2
CN3113700000000	31	137	Phelps County, NE	1990	NA	5092	5034	58	1.1
CN3113900000000	31	139	Pierce County, NE	1990	NA	3634	3567	67	1.8
CN3114100000000	31	141	Platte County, NE	1990	NA	15639	15356	283	1.8
CN3114300000000	31	143	Polk County, NE	1990	NA	2701	2671	30	1.1
CN3114500000000	31	145	Red Willow County, NE	1990	NA	5835	5719	116	2
CN3114700000000	31	147	Richardson County, NE	1990	NA	4450	4314	136	3.1
CN3114900000000	31	149	Rock County, NE	1990	NA	1030	1008	22	2.1
CN3115100000000	31	151	Saline County, NE	1990	NA	6395	6278	117	1.8
CN3115300000000	31	153	Sarpy County, NE	1990	NA	48939	47919	1020	2.1
CN3115500000000	31	155	Saunders County, NE	1990	NA	9267	9060	207	2.2
CN3115700000000	31	157	Scotts Bluff County, NE	1990	NA	17787	17094	693	3.9
CN3115900000000	31	159	Seward County, NE	1990	NA	8424	8243	181	2.1
CN3116100000000	31	161	Sheridan County, NE	1990	NA	3133	3076	57	1.8
CN3116300000000	31	163	Sherman County, NE	1990	NA	1710	1660	50	2.9
CN3116500000000	31	165	Sioux County, NE	1990	NA	792	784	8	1
CN3116700000000	31	167	Stanton County, NE	1990	NA	3075	3029	46	1.5
CN3116900000000	31	169	Thayer County, NE	1990	NA	3167	3135	32	1
CN3117100000000	31	171	Thomas County, NE	1990	NA	407	393	14	3.4
CN3117300000000	31	173	Thurston County, NE	1990	NA	2607	2428	179	6.9
CN3117500000000	31	175	Valley County, NE	1990	NA	2771	2719	52	1.9
CN3117700000000	31	177	Washington County, NE	1990	NA	9136	8925	211	2.3
CN3117900000000	31	179	Wayne County, NE	1990	NA	4751	4630	121	2.5
CN3118100000000	31	181	Webster County, NE	1990	NA	1808	1780	28	1.5
CN3118300000000	31	183	Wheeler County, NE	1990	NA	451	446	5	1.1
CN3118500000000	31	185	York County, NE	1990	NA	7599	7460	139	1.8
CN3200100000000	32	001	Churchill County, NV	1990	NA	7773	7281	492	6.3
CN3200300000000	32	003	Clark County, NV	1990	NA	416540	397738	18802	4.5
CN3200500000000	32	005	Douglas County, NV	1990	NA	14919	14184	735	4.9
CN3200700000000	32	007	Elko County, NV	1990	NA	17735	16885	850	4.8
CN3200900000000	32	009	Esmeralda County, NV	1990	NA	626	590	36	5.8
CN3201100000000	32	011	Eureka County, NV	1990	NA	850	804	46	5.4
CN3201300000000	32	013	Humboldt County, NV	1990	NA	6809	6453	356	5.2
CN3201500000000	32	015	Lander County, NV	1990	NA	3093	2895	198	6.4
CN3201700000000	32	017	Lincoln County, NV	1990	NA	1493	1394	99	6.6
CN3201900000000	32	019	Lyon County, NV	1990	NA	9354	8788	566	6.1
CN3202100000000	32	021	Mineral County, NV	1990	NA	2940	2769	171	5.8
CN3202300000000	32	023	Nye County, NV	1990	NA	9146	8834	312	3.4
CN3202700000000	32	027	Pershing County, NV	1990	NA	2011	1918	93	4.6
CN3202900000000	32	029	Storey County, NV	1990	NA	1432	1400	32	2.2
CN3203100000000	32	031	Washoe County, NV	1990	NA	150253	142939	7314	4.9
CN3203300000000	32	033	White Pine County, NV	1990	NA	4040	3781	259	6.4
CN3251000000000	32	510	Carson City, NV	1990	NA	20908	19691	1217	5.8
CN3300100000000	33	001	Belknap County, NH	1990	NA	26626	24998	1628	6.1
CN3300300000000	33	003	Carroll County, NH	1990	NA	19330	18361	969	5
CN3300500000000	33	005	Cheshire County, NH	1990	NA	38414	36712	1702	4.4
CN3300700000000	33	007	Coos County, NH	1990	NA	17301	16172	1129	6.5
CN3300900000000	33	009	Grafton County, NH	1990	NA	40125	37935	2190	5.5
CN3301100000000	33	011	Hillsborough County, NH	1990	NA	198174	187396	10778	5.4
CN3301300000000	33	013	Merrimack County, NH	1990	NA	60276	57132	3144	5.2
CN3301500000000	33	015	Rockingham County, NH	1990	NA	142113	133272	8841	6.2
CN3301700000000	33	017	Strafford County, NH	1990	NA	57153	53766	3387	5.9
CN3301900000000	33	019	Sullivan County, NH	1990	NA	20579	19272	1307	6.4
CN3400100000000	34	001	Atlantic County, NJ	1990	NA	122312	114769	7543	6.2
CN3400300000000	34	003	Bergen County, NJ	1990	NA	444418	427269	17149	3.9
CN3400500000000	34	005	Burlington County, NJ	1990	NA	207010	197471	9539	4.6
CN3400700000000	34	007	Camden County, NJ	1990	NA	253118	238219	14899	5.9
CN3400900000000	34	009	Cape May County, NJ	1990	NA	44418	41005	3413	7.7
CN3401100000000	34	011	Cumberland County, NJ	1990	NA	65539	60632	4907	7.5
CN3401300000000	34	013	Essex County, NJ	1990	NA	394690	369998	24692	6.3
CN3401500000000	34	015	Gloucester County, NJ	1990	NA	119312	112613	6699	5.6
CN3401700000000	34	017	Hudson County, NJ	1990	NA	286781	265946	20835	7.3
CN3401900000000	34	019	Hunterdon County, NJ	1990	NA	58978	57391	1587	2.7
CN3402100000000	34	021	Mercer County, NJ	1990	NA	170294	162754	7540	4.4
CN3402300000000	34	023	Middlesex County, NJ	1990	NA	369842	353361	16481	4.5
CN3402500000000	34	025	Monmouth County, NJ	1990	NA	285172	273412	11760	4.1
CN3402700000000	34	027	Morris County, NJ	1990	NA	246592	238693	7899	3.2
CN3402900000000	34	029	Ocean County, NJ	1990	NA	190053	180468	9585	5
CN3403100000000	34	031	Passaic County, NJ	1990	NA	235755	220815	14940	6.3
CN3403300000000	34	033	Salem County, NJ	1990	NA	31344	29697	1647	5.3
CN3403500000000	34	035	Somerset County, NJ	1990	NA	138479	134438	4041	2.9
CN3403700000000	34	037	Sussex County, NJ	1990	NA	71894	68897	2997	4.2
CN3403900000000	34	039	Union County, NJ	1990	NA	270617	256129	14488	5.4
CN3404100000000	34	041	Warren County, NJ	1990	NA	48839	46751	2088	4.3
CN3500100000000	35	001	Bernalillo County, NM	1990	NA	252509	238846	13663	5.4
CN3500300000000	35	003	Catron County, NM	1990	NA	1245	1058	187	15
CN3500500000000	35	005	Chaves County, NM	1990	NA	25793	24362	1431	5.5
CN3500600000000	35	006	Cibola County, NM	1990	NA	9195	7998	1197	13
CN3500700000000	35	007	Colfax County, NM	1990	NA	6105	5534	571	9.4
CN3500900000000	35	009	Curry County, NM	1990	NA	17811	16762	1049	5.9
CN3501100000000	35	011	De Baca County, NM	1990	NA	909	863	46	5.1
CN3501300000000	35	013	Dona Ana County, NM	1990	NA	60301	55581	4720	7.8
CN3501500000000	35	015	Eddy County, NM	1990	NA	21599	20156	1443	6.7
CN3501700000000	35	017	Grant County, NM	1990	NA	11543	10508	1035	9
CN3501900000000	35	019	Guadalupe County, NM	1990	NA	1739	1531	208	12
CN3502100000000	35	021	Harding County, NM	1990	NA	457	416	41	9
CN3502300000000	35	023	Hidalgo County, NM	1990	NA	2597	2425	172	6.6
CN3502500000000	35	025	Lea County, NM	1990	NA	23742	22617	1125	4.7
CN3502700000000	35	027	Lincoln County, NM	1990	NA	6022	5673	349	5.8
CN3502800000000	35	028	Los Alamos County, NM	1990	NA	10832	10668	164	1.5
CN3502900000000	35	029	Luna County, NM	1990	NA	7554	6583	971	12.9
CN3503100000000	35	031	McKinley County, NM	1990	NA	22719	20837	1882	8.3
CN3503300000000	35	033	Mora County, NM	1990	NA	1516	1212	304	20.1
CN3503500000000	35	035	Otero County, NM	1990	NA	20001	18575	1426	7.1
CN3503700000000	35	037	Quay County, NM	1990	NA	4937	4584	353	7.2
CN3503900000000	35	039	Rio Arriba County, NM	1990	NA	15384	13289	2095	13.6
CN3504100000000	35	041	Roosevelt County, NM	1990	NA	7181	6732	449	6.3
CN3504300000000	35	043	Sandoval County, NM	1990	NA	29719	28058	1661	5.6
CN3504500000000	35	045	San Juan County, NM	1990	NA	38996	35637	3359	8.6
CN3504700000000	35	047	San Miguel County, NM	1990	NA	10974	9830	1144	10.4
CN3504900000000	35	049	Santa Fe County, NM	1990	NA	55112	53298	1814	3.3
CN3505100000000	35	051	Sierra County, NM	1990	NA	3463	3316	147	4.2
CN3505300000000	35	053	Socorro County, NM	1990	NA	6670	6174	496	7.4
CN3505500000000	35	055	Taos County, NM	1990	NA	11172	9465	1707	15.3
CN3505700000000	35	057	Torrance County, NM	1990	NA	4286	3957	329	7.7
CN3505900000000	35	059	Union County, NM	1990	NA	1879	1792	87	4.6
CN3506100000000	35	061	Valencia County, NM	1990	NA	19830	18574	1256	6.3
CN3600100000000	36	001	Albany County, NY	1990	NA	158085	153397	4688	3
CN3600300000000	36	003	Allegany County, NY	1990	NA	22425	20941	1484	6.6
CN3600500000000	36	005	Bronx County, NY	1990	NA	459622	420747	38875	8.5
CN3600700000000	36	007	Broome County, NY	1990	NA	105259	100804	4455	4.2
CN3600900000000	36	009	Cattaraugus County, NY	1990	NA	39066	36555	2511	6.4
CN3601100000000	36	011	Cayuga County, NY	1990	NA	39207	36805	2402	6.1
CN3601300000000	36	013	Chautauqua County, NY	1990	NA	68191	64255	3936	5.8
CN3601500000000	36	015	Chemung County, NY	1990	NA	44129	41992	2137	4.8
CN3601700000000	36	017	Chenango County, NY	1990	NA	25222	23858	1364	5.4
CN3601900000000	36	019	Clinton County, NY	1990	NA	39283	36916	2367	6
CN3602100000000	36	021	Columbia County, NY	1990	NA	31321	30326	995	3.2
CN3602300000000	36	023	Cortland County, NY	1990	NA	24662	23093	1569	6.4
CN3602500000000	36	025	Delaware County, NY	1990	NA	21715	20593	1122	5.2
CN3602700000000	36	027	Dutchess County, NY	1990	NA	133795	129848	3947	3
CN3602900000000	36	029	Erie County, NY	1990	NA	478878	453807	25071	5.2
CN3603100000000	36	031	Essex County, NY	1990	NA	18111	16653	1458	8.1
CN3603300000000	36	033	Franklin County, NY	1990	NA	20644	18851	1793	8.7
CN3603500000000	36	035	Fulton County, NY	1990	NA	26747	24441	2306	8.6
CN3603700000000	36	037	Genesee County, NY	1990	NA	31331	29705	1626	5.2
CN3603900000000	36	039	Greene County, NY	1990	NA	21063	20030	1033	4.9
CN3604100000000	36	041	Hamilton County, NY	1990	NA	2755	2508	247	9
CN3604300000000	36	043	Herkimer County, NY	1990	NA	30293	28421	1872	6.2
CN3604500000000	36	045	Jefferson County, NY	1990	NA	47036	42932	4104	8.7
CN3604700000000	36	047	Kings County, NY	1990	NA	958938	883982	74956	7.8
CN3604900000000	36	049	Lewis County, NY	1990	NA	12334	11457	877	7.1
CN3605100000000	36	051	Livingston County, NY	1990	NA	32222	30821	1401	4.3
CN3605300000000	36	053	Madison County, NY	1990	NA	35346	33547	1799	5.1
CN3605500000000	36	055	Monroe County, NY	1990	NA	376743	364035	12708	3.4
CN3605700000000	36	057	Montgomery County, NY	1990	NA	24521	22800	1721	7
CN3605900000000	36	059	Nassau County, NY	1990	NA	699830	673682	26148	3.7
CN3606100000000	36	061	New York County, NY	1990	NA	779616	733003	46613	6
CN3606300000000	36	063	Niagara County, NY	1990	NA	109523	103287	6236	5.7
CN3606500000000	36	065	Oneida County, NY	1990	NA	114635	109534	5101	4.4
CN3606700000000	36	067	Onondaga County, NY	1990	NA	243773	234447	9326	3.8
CN3606900000000	36	069	Ontario County, NY	1990	NA	50781	48611	2170	4.3
CN3607100000000	36	071	Orange County, NY	1990	NA	152875	146200	6675	4.4
CN3607300000000	36	073	Orleans County, NY	1990	NA	19713	18411	1302	6.6
CN3607500000000	36	075	Oswego County, NY	1990	NA	57420	53453	3967	6.9
CN3607700000000	36	077	Otsego County, NY	1990	NA	29604	28103	1501	5.1
CN3607900000000	36	079	Putnam County, NY	1990	NA	48024	46442	1582	3.3
CN3608100000000	36	081	Queens County, NY	1990	NA	951544	894340	57204	6
CN3608300000000	36	083	Rensselaer County, NY	1990	NA	81515	78212	3303	4.1
CN3608500000000	36	085	Richmond County, NY	1990	NA	180326	169242	11084	6.1
CN3608700000000	36	087	Rockland County, NY	1990	NA	144499	139680	4819	3.3
CN3608900000000	36	089	St. Lawrence County, NY	1990	NA	49480	45547	3933	7.9
CN3609100000000	36	091	Saratoga County, NY	1990	NA	96777	93263	3514	3.6
CN3609300000000	36	093	Schenectady County, NY	1990	NA	75314	72403	2911	3.9
CN3609500000000	36	095	Schoharie County, NY	1990	NA	15152	14371	781	5.2
CN3609700000000	36	097	Schuyler County, NY	1990	NA	9169	8661	508	5.5
CN3609900000000	36	099	Seneca County, NY	1990	NA	16390	15620	770	4.7
CN3610100000000	36	101	Steuben County, NY	1990	NA	46510	44085	2425	5.2
CN3610300000000	36	103	Suffolk County, NY	1990	NA	710029	678592	31437	4.4
CN3610500000000	36	105	Sullivan County, NY	1990	NA	33349	31637	1712	5.1
CN3610700000000	36	107	Tioga County, NY	1990	NA	26362	25217	1145	4.3
CN3610900000000	36	109	Tompkins County, NY	1990	NA	48973	47143	1830	3.7
CN3611100000000	36	111	Ulster County, NY	1990	NA	84549	81448	3101	3.7
CN3611300000000	36	113	Warren County, NY	1990	NA	30895	29098	1797	5.8
CN3611500000000	36	115	Washington County, NY	1990	NA	28577	27040	1537	5.4
CN3611700000000	36	117	Wayne County, NY	1990	NA	46175	43957	2218	4.8
CN3611900000000	36	119	Westchester County, NY	1990	NA	472146	455423	16723	3.5
CN3612100000000	36	121	Wyoming County, NY	1990	NA	19788	18635	1153	5.8
CN3612300000000	36	123	Yates County, NY	1990	NA	11016	10448	568	5.2
CN3700100000000	37	001	Alamance County, NC	1990	NA	61496	59038	2458	4
CN3700300000000	37	003	Alexander County, NC	1990	NA	16045	15457	588	3.7
CN3700500000000	37	005	Alleghany County, NC	1990	NA	4852	4694	158	3.3
CN3700700000000	37	007	Anson County, NC	1990	NA	11755	11253	502	4.3
CN3700900000000	37	009	Ashe County, NC	1990	NA	11378	10731	647	5.7
CN3701100000000	37	011	Avery County, NC	1990	NA	7311	6867	444	6.1
CN3701300000000	37	013	Beaufort County, NC	1990	NA	20566	19571	995	4.8
CN3701500000000	37	015	Bertie County, NC	1990	NA	9038	8569	469	5.2
CN3701700000000	37	017	Bladen County, NC	1990	NA	13465	12557	908	6.7
CN3701900000000	37	019	Brunswick County, NC	1990	NA	24703	23201	1502	6.1
CN3702100000000	37	021	Buncombe County, NC	1990	NA	91530	88781	2749	3
CN3702300000000	37	023	Burke County, NC	1990	NA	41929	40285	1644	3.9
CN3702500000000	37	025	Cabarrus County, NC	1990	NA	55386	53386	2000	3.6
CN3702700000000	37	027	Caldwell County, NC	1990	NA	40308	38701	1607	4
CN3702900000000	37	029	Camden County, NC	1990	NA	2822	2731	91	3.2
CN3703100000000	37	031	Carteret County, NC	1990	NA	25638	24564	1074	4.2
CN3703300000000	37	033	Caswell County, NC	1990	NA	10202	9805	397	3.9
CN3703500000000	37	035	Catawba County, NC	1990	NA	71446	68455	2991	4.2
CN3703700000000	37	037	Chatham County, NC	1990	NA	22069	21445	624	2.8
CN3703900000000	37	039	Cherokee County, NC	1990	NA	9503	8636	867	9.1
CN3704100000000	37	041	Chowan County, NC	1990	NA	6206	5883	323	5.2
CN3704300000000	37	043	Clay County, NC	1990	NA	3241	3057	184	5.7
CN3704500000000	37	045	Cleveland County, NC	1990	NA	45806	43772	2034	4.4
CN3704700000000	37	047	Columbus County, NC	1990	NA	22216	20904	1312	5.9
CN3704900000000	37	049	Craven County, NC	1990	NA	33729	32182	1547	4.6
CN3705100000000	37	051	Cumberland County, NC	1990	NA	103547	98500	5047	4.9
CN3705300000000	37	053	Currituck County, NC	1990	NA	7003	6773	230	3.3
CN3705500000000	37	055	Dare County, NC	1990	NA	14153	13514	639	4.5
CN3705700000000	37	057	Davidson County, NC	1990	NA	73052	70187	2865	3.9
CN3705900000000	37	059	Davie County, NC	1990	NA	15742	15043	699	4.4
CN3706100000000	37	061	Duplin County, NC	1990	NA	19858	18767	1091	5.5
CN3706300000000	37	063	Durham County, NC	1990	NA	102027	99302	2725	2.7
CN3706500000000	37	065	Edgecombe County, NC	1990	NA	28252	26843	1409	5
CN3706700000000	37	067	Forsyth County, NC	1990	NA	145661	139864	5797	4
CN3706900000000	37	069	Franklin County, NC	1990	NA	18843	17960	883	4.7
CN3707100000000	37	071	Gaston County, NC	1990	NA	95441	91582	3859	4
CN3707300000000	37	073	Gates County, NC	1990	NA	4080	3973	107	2.6
CN3707500000000	37	075	Graham County, NC	1990	NA	3441	2923	518	15.1
CN3707700000000	37	077	Granville County, NC	1990	NA	19647	18746	901	4.6
CN3707900000000	37	079	Greene County, NC	1990	NA	7495	7186	309	4.1
CN3708100000000	37	081	Guilford County, NC	1990	NA	200622	193512	7110	3.5
CN3708300000000	37	083	Halifax County, NC	1990	NA	23886	22494	1392	5.8
CN3708500000000	37	085	Harnett County, NC	1990	NA	31620	30179	1441	4.6
CN3708700000000	37	087	Haywood County, NC	1990	NA	22993	21884	1109	4.8
CN3708900000000	37	089	Henderson County, NC	1990	NA	32415	31578	837	2.6
CN3709100000000	37	091	Hertford County, NC	1990	NA	10102	9517	585	5.8
CN3709300000000	37	093	Hoke County, NC	1990	NA	9720	9229	491	5.1
CN3709500000000	37	095	Hyde County, NC	1990	NA	2564	2364	200	7.8
CN3709700000000	37	097	Iredell County, NC	1990	NA	52398	50368	2030	3.9
CN3709900000000	37	099	Jackson County, NC	1990	NA	13596	12839	757	5.6
CN3710100000000	37	101	Johnston County, NC	1990	NA	44653	42787	1866	4.2
CN3710300000000	37	103	Jones County, NC	1990	NA	4422	4214	208	4.7
CN3710500000000	37	105	Lee County, NC	1990	NA	21232	20162	1070	5
CN3710700000000	37	107	Lenoir County, NC	1990	NA	28261	26914	1347	4.8
CN3710900000000	37	109	Lincoln County, NC	1990	NA	28147	26985	1162	4.1
CN3711100000000	37	111	McDowell County, NC	1990	NA	18991	17852	1139	6
CN3711300000000	37	113	Macon County, NC	1990	NA	11118	10725	393	3.5
CN3711500000000	37	115	Madison County, NC	1990	NA	8215	7863	352	4.3
CN3711700000000	37	117	Martin County, NC	1990	NA	12179	11534	645	5.3
CN3711900000000	37	119	Mecklenburg County, NC	1990	NA	298113	290080	8033	2.7
CN3712100000000	37	121	Mitchell County, NC	1990	NA	6936	6478	458	6.6
CN3712300000000	37	123	Montgomery County, NC	1990	NA	12071	11334	737	6.1
CN3712500000000	37	125	Moore County, NC	1990	NA	27839	26736	1103	4
CN3712700000000	37	127	Nash County, NC	1990	NA	41427	39692	1735	4.2
CN3712900000000	37	129	New Hanover County, NC	1990	NA	65544	62594	2950	4.5
CN3713100000000	37	131	Northampton County, NC	1990	NA	8656	8255	401	4.6
CN3713300000000	37	133	Onslow County, NC	1990	NA	41594	39550	2044	4.9
CN3713500000000	37	135	Orange County, NC	1990	NA	53321	52026	1295	2.4
CN3713700000000	37	137	Pamlico County, NC	1990	NA	5049	4845	204	4
CN3713900000000	37	139	Pasquotank County, NC	1990	NA	13602	13009	593	4.4
CN3714100000000	37	141	Pender County, NC	1990	NA	13730	13106	624	4.5
CN3714300000000	37	143	Perquimans County, NC	1990	NA	4493	4330	163	3.6
CN3714500000000	37	145	Person County, NC	1990	NA	16697	15653	1044	6.3
CN3714700000000	37	147	Pitt County, NC	1990	NA	57235	54937	2298	4
CN3714900000000	37	149	Polk County, NC	1990	NA	6926	6779	147	2.1
CN3715100000000	37	151	Randolph County, NC	1990	NA	63110	61171	1939	3.1
CN3715300000000	37	153	Richmond County, NC	1990	NA	22409	21108	1301	5.8
CN3715500000000	37	155	Robeson County, NC	1990	NA	49199	45469	3730	7.6
CN3715700000000	37	157	Rockingham County, NC	1990	NA	46705	44256	2449	5.2
CN3715900000000	37	159	Rowan County, NC	1990	NA	58514	56233	2281	3.9
CN3716100000000	37	161	Rutherford County, NC	1990	NA	30321	28731	1590	5.2
CN3716300000000	37	163	Sampson County, NC	1990	NA	23626	22543	1083	4.6
CN3716500000000	37	165	Scotland County, NC	1990	NA	16599	15159	1440	8.7
CN3716700000000	37	167	Stanly County, NC	1990	NA	28394	27069	1325	4.7
CN3716900000000	37	169	Stokes County, NC	1990	NA	20462	19601	861	4.2
CN3717100000000	37	171	Surry County, NC	1990	NA	33750	32218	1532	4.5
CN3717300000000	37	173	Swain County, NC	1990	NA	5807	5082	725	12.5
CN3717500000000	37	175	Transylvania County, NC	1990	NA	11721	11306	415	3.5
CN3717700000000	37	177	Tyrrell County, NC	1990	NA	1875	1684	191	10.2
CN3717900000000	37	179	Union County, NC	1990	NA	46314	45013	1301	2.8
CN3718100000000	37	181	Vance County, NC	1990	NA	20351	18701	1650	8.1
CN3718300000000	37	183	Wake County, NC	1990	NA	254508	248082	6426	2.5
CN3718500000000	37	185	Warren County, NC	1990	NA	7462	6939	523	7
CN3718700000000	37	187	Washington County, NC	1990	NA	6170	5912	258	4.2
CN3718900000000	37	189	Watauga County, NC	1990	NA	19783	18904	879	4.4
CN3719100000000	37	191	Wayne County, NC	1990	NA	47998	45806	2192	4.6
CN3719300000000	37	193	Wilkes County, NC	1990	NA	31786	30565	1221	3.8
CN3719500000000	37	195	Wilson County, NC	1990	NA	35241	32438	2803	8
CN3719700000000	37	197	Yadkin County, NC	1990	NA	16442	15702	740	4.5
CN3719900000000	37	199	Yancey County, NC	1990	NA	6717	6196	521	7.8
CN3800100000000	38	001	Adams County, ND	1990	NA	1784	1760	24	1.3
CN3800300000000	38	003	Barnes County, ND	1990	NA	6079	5888	191	3.1
CN3800500000000	38	005	Benson County, ND	1990	NA	2900	2672	228	7.9
CN3800700000000	38	007	Billings County, ND	1990	NA	554	530	24	4.3
CN3800900000000	38	009	Bottineau County, ND	1990	NA	3736	3584	152	4.1
CN3801100000000	38	011	Bowman County, ND	1990	NA	1966	1935	31	1.6
CN3801300000000	38	013	Burke County, ND	1990	NA	1251	1221	30	2.4
CN3801500000000	38	015	Burleigh County, ND	1990	NA	33086	31841	1245	3.8
CN3801700000000	38	017	Cass County, ND	1990	NA	59934	58103	1831	3.1
CN3801900000000	38	019	Cavalier County, ND	1990	NA	2714	2604	110	4.1
CN3802100000000	38	021	Dickey County, ND	1990	NA	3072	2996	76	2.5
CN3802300000000	38	023	Divide County, ND	1990	NA	1181	1161	20	1.7
CN3802500000000	38	025	Dunn County, ND	1990	NA	2554	2498	56	2.2
CN3802700000000	38	027	Eddy County, ND	1990	NA	1442	1350	92	6.4
CN3802900000000	38	029	Emmons County, ND	1990	NA	2128	2060	68	3.2
CN3803100000000	38	031	Foster County, ND	1990	NA	1933	1866	67	3.5
CN3803300000000	38	033	Golden Valley County, ND	1990	NA	926	905	21	2.3
CN3803500000000	38	035	Grand Forks County, ND	1990	NA	33108	31633	1475	4.5
CN3803700000000	38	037	Grant County, ND	1990	NA	2189	2158	31	1.4
CN3803900000000	38	039	Griggs County, ND	1990	NA	1561	1528	33	2.1
CN3804100000000	38	041	Hettinger County, ND	1990	NA	1564	1518	46	2.9
CN3804300000000	38	043	Kidder County, ND	1990	NA	1608	1522	86	5.3
CN3804500000000	38	045	LaMoure County, ND	1990	NA	2431	2376	55	2.3
CN3804700000000	38	047	Logan County, ND	1990	NA	1233	1207	26	2.1
CN3804900000000	38	049	McHenry County, ND	1990	NA	2777	2618	159	5.7
CN3805100000000	38	051	McIntosh County, ND	1990	NA	1785	1761	24	1.3
CN3805300000000	38	053	McKenzie County, ND	1990	NA	2939	2874	65	2.2
CN3805500000000	38	055	McLean County, ND	1990	NA	4611	4400	211	4.6
CN3805700000000	38	057	Mercer County, ND	1990	NA	4858	4564	294	6.1
CN3805900000000	38	059	Morton County, ND	1990	NA	12111	11535	576	4.8
CN3806100000000	38	061	Mountrail County, ND	1990	NA	3049	2887	162	5.3
CN3806300000000	38	063	Nelson County, ND	1990	NA	1736	1672	64	3.7
CN3806500000000	38	065	Oliver County, ND	1990	NA	1208	1162	46	3.8
CN3806700000000	38	067	Pembina County, ND	1990	NA	4662	4265	397	8.5
CN3806900000000	38	069	Pierce County, ND	1990	NA	2141	2081	60	2.8
CN3807100000000	38	071	Ramsey County, ND	1990	NA	6223	5997	226	3.6
CN3807300000000	38	073	Ransom County, ND	1990	NA	2704	2657	47	1.7
CN3807500000000	38	075	Renville County, ND	1990	NA	1386	1353	33	2.4
CN3807700000000	38	077	Richland County, ND	1990	NA	8590	8206	384	4.5
CN3807900000000	38	079	Rolette County, ND	1990	NA	4863	4172	691	14.2
CN3808100000000	38	081	Sargent County, ND	1990	NA	2076	2040	36	1.7
CN3808300000000	38	083	Sheridan County, ND	1990	NA	780	759	21	2.7
CN3808500000000	38	085	Sioux County, ND	1990	NA	1812	1546	266	14.7
CN3808700000000	38	087	Slope County, ND	1990	NA	586	572	14	2.4
CN3808900000000	38	089	Stark County, ND	1990	NA	12133	11687	446	3.7
CN3809100000000	38	091	Steele County, ND	1990	NA	1260	1240	20	1.6
CN3809300000000	38	093	Stutsman County, ND	1990	NA	11235	10849	386	3.4
CN3809500000000	38	095	Towner County, ND	1990	NA	1631	1585	46	2.8
CN3809700000000	38	097	Traill County, ND	1990	NA	4027	3870	157	3.9
CN3809900000000	38	099	Walsh County, ND	1990	NA	6374	6088	286	4.5
CN3810100000000	38	101	Ward County, ND	1990	NA	26353	25195	1158	4.4
CN3810300000000	38	103	Wells County, ND	1990	NA	2530	2382	148	5.8
CN3810500000000	38	105	Williams County, ND	1990	NA	9843	9505	338	3.4
CN3900100000000	39	001	Adams County, OH	1990	NA	9998	8906	1092	10.9
CN3900300000000	39	003	Allen County, OH	1990	NA	52803	48766	4037	7.6
CN3900500000000	39	005	Ashland County, OH	1990	NA	24383	23002	1381	5.7
CN3900700000000	39	007	Ashtabula County, OH	1990	NA	45880	42364	3516	7.7
CN3900900000000	39	009	Athens County, OH	1990	NA	24723	23301	1422	5.8
CN3901100000000	39	011	Auglaize County, OH	1990	NA	23295	21899	1396	6
CN3901300000000	39	013	Belmont County, OH	1990	NA	30134	28213	1921	6.4
CN3901500000000	39	015	Brown County, OH	1990	NA	16787	15729	1058	6.3
CN3901700000000	39	017	Butler County, OH	1990	NA	149975	141384	8591	5.7
CN3901900000000	39	019	Carroll County, OH	1990	NA	12225	11460	765	6.3
CN3902100000000	39	021	Champaign County, OH	1990	NA	19055	17861	1194	6.3
CN3902300000000	39	023	Clark County, OH	1990	NA	71562	67307	4255	5.9
CN3902500000000	39	025	Clermont County, OH	1990	NA	80131	76396	3735	4.7
CN3902700000000	39	027	Clinton County, OH	1990	NA	18134	17078	1056	5.8
CN3902900000000	39	029	Columbiana County, OH	1990	NA	49001	46119	2882	5.9
CN3903100000000	39	031	Coshocton County, OH	1990	NA	16391	15400	991	6
CN3903300000000	39	033	Crawford County, OH	1990	NA	23661	21357	2304	9.7
CN3903500000000	39	035	Cuyahoga County, OH	1990	NA	675615	642367	33248	4.9
CN3903700000000	39	037	Darke County, OH	1990	NA	27567	25677	1890	6.9
CN3903900000000	39	039	Defiance County, OH	1990	NA	20837	19187	1650	7.9
CN3904100000000	39	041	Delaware County, OH	1990	NA	36789	35535	1254	3.4
CN3904300000000	39	043	Erie County, OH	1990	NA	41358	38761	2597	6.3
CN3904500000000	39	045	Fairfield County, OH	1990	NA	53609	50831	2778	5.2
CN3904700000000	39	047	Fayette County, OH	1990	NA	13000	12080	920	7.1
CN3904900000000	39	049	Franklin County, OH	1990	NA	535980	518232	17748	3.3
CN3905100000000	39	051	Fulton County, OH	1990	NA	20861	19238	1623	7.8
CN3905300000000	39	053	Gallia County, OH	1990	NA	13213	12145	1068	8.1
CN3905500000000	39	055	Geauga County, OH	1990	NA	42389	40768	1621	3.8
CN3905700000000	39	057	Greene County, OH	1990	NA	68360	65205	3155	4.6
CN3905900000000	39	059	Guernsey County, OH	1990	NA	17916	16377	1539	8.6
CN3906100000000	39	061	Hamilton County, OH	1990	NA	441153	423609	17544	4
CN3906300000000	39	063	Hancock County, OH	1990	NA	34982	33395	1587	4.5
CN3906500000000	39	065	Hardin County, OH	1990	NA	14684	13600	1084	7.4
CN3906700000000	39	067	Harrison County, OH	1990	NA	6480	5938	542	8.4
CN3906900000000	39	069	Henry County, OH	1990	NA	15287	14138	1149	7.5
CN3907100000000	39	071	Highland County, OH	1990	NA	16235	15017	1218	7.5
CN3907300000000	39	073	Hocking County, OH	1990	NA	11756	10695	1061	9
CN3907500000000	39	075	Holmes County, OH	1990	NA	14814	14176	638	4.3
CN3907700000000	39	077	Huron County, OH	1990	NA	29331	26240	3091	10.5
CN3907900000000	39	079	Jackson County, OH	1990	NA	12262	11128	1134	9.2
CN3908100000000	39	081	Jefferson County, OH	1990	NA	32647	30631	2016	6.2
CN3908300000000	39	083	Knox County, OH	1990	NA	23646	22223	1423	6
CN3908500000000	39	085	Lake County, OH	1990	NA	117340	111756	5584	4.8
CN3908700000000	39	087	Lawrence County, OH	1990	NA	24980	23245	1735	6.9
CN3908900000000	39	089	Licking County, OH	1990	NA	65945	62341	3604	5.5
CN3909100000000	39	091	Logan County, OH	1990	NA	21143	19906	1237	5.9
CN3909300000000	39	093	Lorain County, OH	1990	NA	134546	125116	9430	7
CN3909500000000	39	095	Lucas County, OH	1990	NA	229705	211121	18584	8.1
CN3909700000000	39	097	Madison County, OH	1990	NA	17962	17210	752	4.2
CN3909900000000	39	099	Mahoning County, OH	1990	NA	119042	110460	8582	7.2
CN3910100000000	39	101	Marion County, OH	1990	NA	30566	28129	2437	8
CN3910300000000	39	103	Medina County, OH	1990	NA	64888	61969	2919	4.5
CN3910500000000	39	105	Meigs County, OH	1990	NA	8635	7981	654	7.6
CN3910700000000	39	107	Mercer County, OH	1990	NA	20061	18947	1114	5.6
CN3910900000000	39	109	Miami County, OH	1990	NA	49502	46593	2909	5.9
CN3911100000000	39	111	Monroe County, OH	1990	NA	6150	5616	534	8.7
CN3911300000000	39	113	Montgomery County, OH	1990	NA	289826	275172	14654	5.1
CN3911500000000	39	115	Morgan County, OH	1990	NA	5685	5154	531	9.3
CN3911700000000	39	117	Morrow County, OH	1990	NA	13925	13015	910	6.5
CN3911900000000	39	119	Muskingum County, OH	1990	NA	40319	36475	3844	9.5
CN3912100000000	39	121	Noble County, OH	1990	NA	4885	4507	378	7.7
CN3912300000000	39	123	Ottawa County, OH	1990	NA	21581	19846	1735	8
CN3912500000000	39	125	Paulding County, OH	1990	NA	9880	9207	673	6.8
CN3912700000000	39	127	Perry County, OH	1990	NA	14519	12670	1849	12.7
CN3912900000000	39	129	Pickaway County, OH	1990	NA	21691	20587	1104	5.1
CN3913100000000	39	131	Pike County, OH	1990	NA	9359	8447	912	9.7
CN3913300000000	39	133	Portage County, OH	1990	NA	75687	71732	3955	5.2
CN3913500000000	39	135	Preble County, OH	1990	NA	19860	18687	1173	5.9
CN3913700000000	39	137	Putnam County, OH	1990	NA	17296	16112	1184	6.8
CN3913900000000	39	139	Richland County, OH	1990	NA	62906	57857	5049	8
CN3914100000000	39	141	Ross County, OH	1990	NA	29825	27390	2435	8.2
CN3914300000000	39	143	Sandusky County, OH	1990	NA	31791	29288	2503	7.9
CN3914500000000	39	145	Scioto County, OH	1990	NA	29333	26594	2739	9.3
CN3914700000000	39	147	Seneca County, OH	1990	NA	29858	27476	2382	8
CN3914900000000	39	149	Shelby County, OH	1990	NA	23671	22436	1235	5.2
CN3915100000000	39	151	Stark County, OH	1990	NA	184612	173021	11591	6.3
CN3915300000000	39	153	Summit County, OH	1990	NA	259505	246178	13327	5.1
CN3915500000000	39	155	Trumbull County, OH	1990	NA	110968	102501	8467	7.6
CN3915700000000	39	157	Tuscarawas County, OH	1990	NA	40696	38031	2665	6.5
CN3915900000000	39	159	Union County, OH	1990	NA	16314	15661	653	4
CN3916100000000	39	161	Van Wert County, OH	1990	NA	15990	14945	1045	6.5
CN3916300000000	39	163	Vinton County, OH	1990	NA	4410	3978	432	9.8
CN3916500000000	39	165	Warren County, OH	1990	NA	60281	57539	2742	4.5
CN3916700000000	39	167	Washington County, OH	1990	NA	30235	28344	1891	6.3
CN3916900000000	39	169	Wayne County, OH	1990	NA	52654	50100	2554	4.9
CN3917100000000	39	171	Williams County, OH	1990	NA	20185	19014	1171	5.8
CN3917300000000	39	173	Wood County, OH	1990	NA	61044	57471	3573	5.9
CN3917500000000	39	175	Wyandot County, OH	1990	NA	11462	10683	779	6.8
CN4000100000000	40	001	Adair County, OK	1990	NA	8589	8051	538	6.3
CN4000300000000	40	003	Alfalfa County, OK	1990	NA	2852	2761	91	3.2
CN4000500000000	40	005	Atoka County, OK	1990	NA	4820	4418	402	8.3
CN4000700000000	40	007	Beaver County, OK	1990	NA	3110	3030	80	2.6
CN4000900000000	40	009	Beckham County, OK	1990	NA	8474	7992	482	5.7
CN4001100000000	40	011	Blaine County, OK	1990	NA	5196	4925	271	5.2
CN4001300000000	40	013	Bryan County, OK	1990	NA	13788	12976	812	5.9
CN4001500000000	40	015	Caddo County, OK	1990	NA	12087	11127	960	7.9
CN4001700000000	40	017	Canadian County, OK	1990	NA	39636	37895	1741	4.4
CN4001900000000	40	019	Carter County, OK	1990	NA	19782	18560	1222	6.2
CN4002100000000	40	021	Cherokee County, OK	1990	NA	15671	14434	1237	7.9
CN4002300000000	40	023	Choctaw County, OK	1990	NA	5801	5200	601	10.4
CN4002500000000	40	025	Cimarron County, OK	1990	NA	1691	1650	41	2.4
CN4002700000000	40	027	Cleveland County, OK	1990	NA	95244	91193	4051	4.3
CN4002900000000	40	029	Coal County, OK	1990	NA	2497	2190	307	12.3
CN4003100000000	40	031	Comanche County, OK	1990	NA	42532	39593	2939	6.9
CN4003300000000	40	033	Cotton County, OK	1990	NA	2861	2537	324	11.3
CN4003500000000	40	035	Craig County, OK	1990	NA	6450	6135	315	4.9
CN4003700000000	40	037	Creek County, OK	1990	NA	29585	27893	1692	5.7
CN4003900000000	40	039	Custer County, OK	1990	NA	13612	12781	831	6.1
CN4004100000000	40	041	Delaware County, OK	1990	NA	12149	11360	789	6.5
CN4004300000000	40	043	Dewey County, OK	1990	NA	2323	2225	98	4.2
CN4004500000000	40	045	Ellis County, OK	1990	NA	2198	2122	76	3.5
CN4004700000000	40	047	Garfield County, OK	1990	NA	26988	25779	1209	4.5
CN4004900000000	40	049	Garvin County, OK	1990	NA	11629	10794	835	7.2
CN4005100000000	40	051	Grady County, OK	1990	NA	19650	18337	1313	6.7
CN4005300000000	40	053	Grant County, OK	1990	NA	2570	2494	76	3
CN4005500000000	40	055	Greer County, OK	1990	NA	2437	2345	92	3.8
CN4005700000000	40	057	Harmon County, OK	1990	NA	1396	1329	67	4.8
CN4005900000000	40	059	Harper County, OK	1990	NA	2043	1976	67	3.3
CN4006100000000	40	061	Haskell County, OK	1990	NA	4392	3811	581	13.2
CN4006300000000	40	063	Hughes County, OK	1990	NA	5309	4754	555	10.5
CN4006500000000	40	065	Jackson County, OK	1990	NA	10880	9988	892	8.2
CN4006700000000	40	067	Jefferson County, OK	1990	NA	2870	2641	229	8
CN4006900000000	40	069	Johnston County, OK	1990	NA	4010	3732	278	6.9
CN4007100000000	40	071	Kay County, OK	1990	NA	23395	22125	1270	5.4
CN4007300000000	40	073	Kingfisher County, OK	1990	NA	6496	6214	282	4.3
CN4007500000000	40	075	Kiowa County, OK	1990	NA	4827	4609	218	4.5
CN4007700000000	40	077	Latimer County, OK	1990	NA	4125	3697	428	10.4
CN4007900000000	40	079	Le Flore County, OK	1990	NA	18666	16794	1872	10
CN4008100000000	40	081	Lincoln County, OK	1990	NA	13236	12363	873	6.6
CN4008300000000	40	083	Logan County, OK	1990	NA	13489	12959	530	3.9
CN4008500000000	40	085	Love County, OK	1990	NA	3677	3467	210	5.7
CN4008700000000	40	087	McClain County, OK	1990	NA	11298	10708	590	5.2
CN4008900000000	40	089	McCurtain County, OK	1990	NA	13962	12686	1276	9.1
CN4009100000000	40	091	McIntosh County, OK	1990	NA	6554	6149	405	6.2
CN4009300000000	40	093	Major County, OK	1990	NA	3715	3559	156	4.2
CN4009500000000	40	095	Marshall County, OK	1990	NA	4565	4283	282	6.2
CN4009700000000	40	097	Mayes County, OK	1990	NA	14858	13774	1084	7.3
CN4009900000000	40	099	Murray County, OK	1990	NA	5472	5016	456	8.3
CN4010100000000	40	101	Muskogee County, OK	1990	NA	29644	27787	1857	6.3
CN4010300000000	40	103	Noble County, OK	1990	NA	5398	5175	223	4.1
CN4010500000000	40	105	Nowata County, OK	1990	NA	4438	4218	220	5
CN4010700000000	40	107	Okfuskee County, OK	1990	NA	4420	4090	330	7.5
CN4010900000000	40	109	Oklahoma County, OK	1990	NA	310403	292669	17734	5.7
CN4011100000000	40	111	Okmulgee County, OK	1990	NA	15401	13977	1424	9.2
CN4011300000000	40	113	Osage County, OK	1990	NA	19133	18253	880	4.6
CN4011500000000	40	115	Ottawa County, OK	1990	NA	13617	12372	1245	9.1
CN4011700000000	40	117	Pawnee County, OK	1990	NA	7449	7000	449	6
CN4011900000000	40	119	Payne County, OK	1990	NA	30838	29237	1601	5.2
CN4012100000000	40	121	Pittsburg County, OK	1990	NA	17406	15856	1550	8.9
CN4012300000000	40	123	Pontotoc County, OK	1990	NA	15943	14885	1058	6.6
CN4012500000000	40	125	Pottawatomie County, OK	1990	NA	26737	25082	1655	6.2
CN4012700000000	40	127	Pushmataha County, OK	1990	NA	4303	3907	396	9.2
CN4012900000000	40	129	Roger Mills County, OK	1990	NA	2003	1912	91	4.5
CN4013100000000	40	131	Rogers County, OK	1990	NA	28655	26988	1667	5.8
CN4013300000000	40	133	Seminole County, OK	1990	NA	10446	9491	955	9.1
CN4013500000000	40	135	Sequoyah County, OK	1990	NA	15568	14292	1276	8.2
CN4013700000000	40	137	Stephens County, OK	1990	NA	18731	17805	926	4.9
CN4013900000000	40	139	Texas County, OK	1990	NA	8517	8155	362	4.3
CN4014100000000	40	141	Tillman County, OK	1990	NA	4320	4068	252	5.8
CN4014300000000	40	143	Tulsa County, OK	1990	NA	270249	258527	11722	4.3
CN4014500000000	40	145	Wagoner County, OK	1990	NA	24388	23280	1108	4.5
CN4014700000000	40	147	Washington County, OK	1990	NA	23161	22412	749	3.2
CN4014900000000	40	149	Washita County, OK	1990	NA	5182	4883	299	5.8
CN4015100000000	40	151	Woods County, OK	1990	NA	4354	4220	134	3.1
CN4015300000000	40	153	Woodward County, OK	1990	NA	9387	8943	444	4.7
CN4100100000000	41	001	Baker County, OR	1990	NA	7055	6532	523	7.4
CN4100300000000	41	003	Benton County, OR	1990	NA	36175	34373	1802	5
CN4100500000000	41	005	Clackamas County, OR	1990	NA	156560	151147	5413	3.5
CN4100700000000	41	007	Clatsop County, OR	1990	NA	16373	15224	1149	7
CN4100900000000	41	009	Columbia County, OR	1990	NA	18404	17233	1171	6.4
CN4101100000000	41	011	Coos County, OR	1990	NA	26775	24540	2235	8.3
CN4101300000000	41	013	Crook County, OR	1990	NA	6768	6298	470	6.9
CN4101500000000	41	015	Curry County, OR	1990	NA	8163	7641	522	6.4
CN4101700000000	41	017	Deschutes County, OR	1990	NA	41087	38845	2242	5.5
CN4101900000000	41	019	Douglas County, OR	1990	NA	43566	39987	3579	8.2
CN4102100000000	41	021	Gilliam County, OR	1990	NA	907	873	34	3.7
CN4102300000000	41	023	Grant County, OR	1990	NA	4224	3857	367	8.7
CN4102500000000	41	025	Harney County, OR	1990	NA	3703	3372	331	8.9
CN4102700000000	41	027	Hood River County, OR	1990	NA	9221	8469	752	8.2
CN4102900000000	41	029	Jackson County, OR	1990	NA	73122	68282	4840	6.6
CN4103100000000	41	031	Jefferson County, OR	1990	NA	6565	6142	423	6.4
CN4103300000000	41	033	Josephine County, OR	1990	NA	26457	24579	1878	7.1
CN4103500000000	41	035	Klamath County, OR	1990	NA	27160	24703	2457	9
CN4103700000000	41	037	Lake County, OR	1990	NA	3724	3393	331	8.9
CN4103900000000	41	039	Lane County, OR	1990	NA	146662	137559	9103	6.2
CN4104100000000	41	041	Lincoln County, OR	1990	NA	18983	17845	1138	6
CN4104300000000	41	043	Linn County, OR	1990	NA	44203	40860	3343	7.6
CN4104500000000	41	045	Malheur County, OR	1990	NA	13790	13098	692	5
CN4104700000000	41	047	Marion County, OR	1990	NA	117012	110646	6366	5.4
CN4104900000000	41	049	Morrow County, OR	1990	NA	3851	3547	304	7.9
CN4105100000000	41	051	Multnomah County, OR	1990	NA	319389	303159	16230	5.1
CN4105300000000	41	053	Polk County, OR	1990	NA	24929	23542	1387	5.6
CN4105500000000	41	055	Sherman County, OR	1990	NA	909	860	49	5.4
CN4105700000000	41	057	Tillamook County, OR	1990	NA	9560	9000	560	5.9
CN4105900000000	41	059	Umatilla County, OR	1990	NA	29801	27324	2477	8.3
CN4106100000000	41	061	Union County, OR	1990	NA	11782	10966	816	6.9
CN4106300000000	41	063	Wallowa County, OR	1990	NA	3535	3270	265	7.5
CN4106500000000	41	065	Wasco County, OR	1990	NA	10974	10208	766	7
CN4106700000000	41	067	Washington County, OR	1990	NA	186179	179960	6219	3.3
CN4106900000000	41	069	Wheeler County, OR	1990	NA	590	528	62	10.5
CN4107100000000	41	071	Yamhill County, OR	1990	NA	32560	30823	1737	5.3
CN4200100000000	42	001	Adams County, PA	1990	NA	41476	39484	1992	4.8
CN4200300000000	42	003	Allegheny County, PA	1990	NA	644783	616696	28087	4.4
CN4200500000000	42	005	Armstrong County, PA	1990	NA	30754	28430	2324	7.6
CN4200700000000	42	007	Beaver County, PA	1990	NA	82320	77488	4832	5.9
CN4200900000000	42	009	Bedford County, PA	1990	NA	21879	19924	1955	8.9
CN4201100000000	42	011	Berks County, PA	1990	NA	177303	167939	9364	5.3
CN4201300000000	42	013	Blair County, PA	1990	NA	60851	56358	4493	7.4
CN4201500000000	42	015	Bradford County, PA	1990	NA	28158	26557	1601	5.7
CN4201700000000	42	017	Bucks County, PA	1990	NA	300358	287462	12896	4.3
CN4201900000000	42	019	Butler County, PA	1990	NA	74526	70431	4095	5.5
CN4202100000000	42	021	Cambria County, PA	1990	NA	66922	61935	4987	7.5
CN4202300000000	42	023	Cameron County, PA	1990	NA	2607	2420	187	7.2
CN4202500000000	42	025	Carbon County, PA	1990	NA	26468	24478	1990	7.5
CN4202700000000	42	027	Centre County, PA	1990	NA	60985	58419	2566	4.2
CN4202900000000	42	029	Chester County, PA	1990	NA	208022	201219	6803	3.3
CN4203100000000	42	031	Clarion County, PA	1990	NA	18155	16695	1460	8
CN4203300000000	42	033	Clearfield County, PA	1990	NA	34766	31428	3338	9.6
CN4203500000000	42	035	Clinton County, PA	1990	NA	17098	15396	1702	10
CN4203700000000	42	037	Columbia County, PA	1990	NA	31489	29272	2217	7
CN4203900000000	42	039	Crawford County, PA	1990	NA	39341	36447	2894	7.4
CN4204100000000	42	041	Cumberland County, PA	1990	NA	109175	105083	4092	3.7
CN4204300000000	42	043	Dauphin County, PA	1990	NA	130472	124191	6281	4.8
CN4204500000000	42	045	Delaware County, PA	1990	NA	279722	268592	11130	4
CN4204700000000	42	047	Elk County, PA	1990	NA	16375	15371	1004	6.1
CN4204900000000	42	049	Erie County, PA	1990	NA	133603	125797	7806	5.8
CN4205100000000	42	051	Fayette County, PA	1990	NA	54889	50194	4695	8.6
CN4205300000000	42	053	Forest County, PA	1990	NA	2058	1888	170	8.3
CN4205500000000	42	055	Franklin County, PA	1990	NA	62833	59690	3143	5
CN4205700000000	42	057	Fulton County, PA	1990	NA	6610	6135	475	7.2
CN4205900000000	42	059	Greene County, PA	1990	NA	14836	13598	1238	8.3
CN4206100000000	42	061	Huntingdon County, PA	1990	NA	19292	17382	1910	9.9
CN4206300000000	42	063	Indiana County, PA	1990	NA	38740	35919	2821	7.3
CN4206500000000	42	065	Jefferson County, PA	1990	NA	20159	18713	1446	7.2
CN4206700000000	42	067	Juniata County, PA	1990	NA	10441	9479	962	9.2
CN4206900000000	42	069	Lackawanna County, PA	1990	NA	106134	98550	7584	7.1
CN4207100000000	42	071	Lancaster County, PA	1990	NA	226764	217242	9522	4.2
CN4207300000000	42	073	Lawrence County, PA	1990	NA	41092	38414	2678	6.5
CN4207500000000	42	075	Lebanon County, PA	1990	NA	61580	58584	2996	4.9
CN4207700000000	42	077	Lehigh County, PA	1990	NA	152986	145203	7783	5.1
CN4207900000000	42	079	Luzerne County, PA	1990	NA	156736	144919	11817	7.5
CN4208100000000	42	081	Lycoming County, PA	1990	NA	57597	53331	4266	7.4
CN4208300000000	42	083	McKean County, PA	1990	NA	20875	19487	1388	6.6
CN4208500000000	42	085	Mercer County, PA	1990	NA	53749	50811	2938	5.5
CN4208700000000	42	087	Mifflin County, PA	1990	NA	22493	20708	1785	7.9
CN4208900000000	42	089	Monroe County, PA	1990	NA	49696	46247	3449	6.9
CN4209100000000	42	091	Montgomery County, PA	1990	NA	377075	362587	14488	3.8
CN4209300000000	42	093	Montour County, PA	1990	NA	8806	8366	440	5
CN4209500000000	42	095	Northampton County, PA	1990	NA	125558	118814	6744	5.4
CN4209700000000	42	097	Northumberland County, PA	1990	NA	46253	42052	4201	9.1
CN4209900000000	42	099	Perry County, PA	1990	NA	22015	20768	1247	5.7
CN4210100000000	42	101	Philadelphia County/city, PA	1990	NA	700120	655800	44320	6.3
CN4210300000000	42	103	Pike County, PA	1990	NA	13752	12965	787	5.7
CN4210500000000	42	105	Potter County, PA	1990	NA	7136	6616	520	7.3
CN4210700000000	42	107	Schuylkill County, PA	1990	NA	69749	64281	5468	7.8
CN4210900000000	42	109	Snyder County, PA	1990	NA	18840	17360	1480	7.9
CN4211100000000	42	111	Somerset County, PA	1990	NA	34929	32433	2496	7.1
CN4211300000000	42	113	Sullivan County, PA	1990	NA	2645	2452	193	7.3
CN4211500000000	42	115	Susquehanna County, PA	1990	NA	18234	16988	1246	6.8
CN4211700000000	42	117	Tioga County, PA	1990	NA	18738	17295	1443	7.7
CN4211900000000	42	119	Union County, PA	1990	NA	16835	15833	1002	6
CN4212100000000	42	121	Venango County, PA	1990	NA	25714	24247	1467	5.7
CN4212300000000	42	123	Warren County, PA	1990	NA	21685	20707	978	4.5
CN4212500000000	42	125	Washington County, PA	1990	NA	90610	85360	5250	5.8
CN4212700000000	42	127	Wayne County, PA	1990	NA	19370	18065	1305	6.7
CN4212900000000	42	129	Westmoreland County, PA	1990	NA	171870	161771	10099	5.9
CN4213100000000	42	131	Wyoming County, PA	1990	NA	13842	12904	938	6.8
CN4213300000000	42	133	York County, PA	1990	NA	187523	178777	8746	4.7
CN4400100000000	44	001	Bristol County, RI	1990	NA	26458	24675	1783	6.7
CN4400300000000	44	003	Kent County, RI	1990	NA	88714	83508	5206	5.9
CN4400500000000	44	005	Newport County, RI	1990	NA	43716	41152	2564	5.9
CN4400700000000	44	007	Providence County, RI	1990	NA	307415	286340	21075	6.9
CN4400900000000	44	009	Washington County, RI	1990	NA	59060	56328	2732	4.6
CN4500100000000	45	001	Abbeville County, SC	1990	NA	11951	11161	790	6.6
CN4500300000000	45	003	Aiken County, SC	1990	NA	61218	58391	2827	4.6
CN4500500000000	45	005	Allendale County, SC	1990	NA	4397	4083	314	7.1
CN4500700000000	45	007	Anderson County, SC	1990	NA	76366	72322	4044	5.3
CN4500900000000	45	009	Bamberg County, SC	1990	NA	7371	6696	675	9.2
CN4501100000000	45	011	Barnwell County, SC	1990	NA	9842	8908	934	9.5
CN4501300000000	45	013	Beaufort County, SC	1990	NA	36525	35198	1327	3.6
CN4501500000000	45	015	Berkeley County, SC	1990	NA	56106	54488	1618	2.9
CN4501700000000	45	017	Calhoun County, SC	1990	NA	6131	5744	387	6.3
CN4501900000000	45	019	Charleston County, SC	1990	NA	141963	137791	4172	2.9
CN4502100000000	45	021	Cherokee County, SC	1990	NA	23011	21717	1294	5.6
CN4502300000000	45	023	Chester County, SC	1990	NA	16080	14462	1618	10.1
CN4502500000000	45	025	Chesterfield County, SC	1990	NA	19063	18048	1015	5.3
CN4502700000000	45	027	Clarendon County, SC	1990	NA	11949	11072	877	7.3
CN4502900000000	45	029	Colleton County, SC	1990	NA	15293	14455	838	5.5
CN4503100000000	45	031	Darlington County, SC	1990	NA	30042	28429	1613	5.4
CN4503300000000	45	033	Dillon County, SC	1990	NA	13042	12084	958	7.3
CN4503500000000	45	035	Dorchester County, SC	1990	NA	38958	37842	1116	2.9
CN4503700000000	45	037	Edgefield County, SC	1990	NA	9140	8758	382	4.2
CN4503900000000	45	039	Fairfield County, SC	1990	NA	10980	9893	1087	9.9
CN4504100000000	45	041	Florence County, SC	1990	NA	56387	53792	2595	4.6
CN4504300000000	45	043	Georgetown County, SC	1990	NA	22487	20652	1835	8.2
CN4504500000000	45	045	Greenville County, SC	1990	NA	173281	166785	6496	3.7
CN4504700000000	45	047	Greenwood County, SC	1990	NA	30623	28909	1714	5.6
CN4504900000000	45	049	Hampton County, SC	1990	NA	7710	7304	406	5.3
CN4505100000000	45	051	Horry County, SC	1990	NA	74481	69828	4653	6.2
CN4505300000000	45	053	Jasper County, SC	1990	NA	6609	6359	250	3.8
CN4505500000000	45	055	Kershaw County, SC	1990	NA	22689	21314	1375	6.1
CN4505700000000	45	057	Lancaster County, SC	1990	NA	28375	26803	1572	5.5
CN4505900000000	45	059	Laurens County, SC	1990	NA	29349	27790	1559	5.3
CN4506100000000	45	061	Lee County, SC	1990	NA	7927	7463	464	5.9
CN4506300000000	45	063	Lexington County, SC	1990	NA	96743	93331	3412	3.5
CN4506500000000	45	065	McCormick County, SC	1990	NA	3708	3363	345	9.3
CN4506700000000	45	067	Marion County, SC	1990	NA	15883	14443	1440	9.1
CN4506900000000	45	069	Marlboro County, SC	1990	NA	13414	12138	1276	9.5
CN4507100000000	45	071	Newberry County, SC	1990	NA	16554	15634	920	5.6
CN4507300000000	45	073	Oconee County, SC	1990	NA	29253	27782	1471	5
CN4507500000000	45	075	Orangeburg County, SC	1990	NA	39148	36186	2962	7.6
CN4507700000000	45	077	Pickens County, SC	1990	NA	49319	47026	2293	4.6
CN4507900000000	45	079	Richland County, SC	1990	NA	147585	142226	5359	3.6
CN4508100000000	45	081	Saluda County, SC	1990	NA	8126	7640	486	6
CN4508300000000	45	083	Spartanburg County, SC	1990	NA	119768	114510	5258	4.4
CN4508500000000	45	085	Sumter County, SC	1990	NA	40818	38648	2170	5.3
CN4508700000000	45	087	Union County, SC	1990	NA	15274	14108	1166	7.6
CN4508900000000	45	089	Williamsburg County, SC	1990	NA	16716	15133	1583	9.5
CN4509100000000	45	091	York County, SC	1990	NA	71898	69294	2604	3.6
CN4600300000000	46	003	Aurora County, SD	1990	NA	1316	1292	24	1.8
CN4600500000000	46	005	Beadle County, SD	1990	NA	9164	8773	391	4.3
CN4600700000000	46	007	Bennett County, SD	1990	NA	1166	1103	63	5.4
CN4600900000000	46	009	Bon Homme County, SD	1990	NA	3002	2966	36	1.2
CN4601100000000	46	011	Brookings County, SD	1990	NA	13971	13260	711	5.1
CN4601300000000	46	013	Brown County, SD	1990	NA	19800	18713	1087	5.5
CN4601500000000	46	015	Brule County, SD	1990	NA	2793	2730	63	2.3
CN4601700000000	46	017	Buffalo County, SD	1990	NA	596	540	56	9.4
CN4601900000000	46	019	Butte County, SD	1990	NA	3633	3506	127	3.5
CN4602100000000	46	021	Campbell County, SD	1990	NA	948	920	28	3
CN4602300000000	46	023	Charles Mix County, SD	1990	NA	3809	3661	148	3.9
CN4602500000000	46	025	Clark County, SD	1990	NA	1968	1900	68	3.5
CN4602700000000	46	027	Clay County, SD	1990	NA	6839	6525	314	4.6
CN4602900000000	46	029	Codington County, SD	1990	NA	12104	11565	539	4.5
CN4603100000000	46	031	Corson County, SD	1990	NA	1645	1312	333	20.2
CN4603300000000	46	033	Custer County, SD	1990	NA	3447	3356	91	2.6
CN4603500000000	46	035	Davison County, SD	1990	NA	8910	8667	243	2.7
CN4603700000000	46	037	Day County, SD	1990	NA	3031	2875	156	5.1
CN4603900000000	46	039	Deuel County, SD	1990	NA	2156	2068	88	4.1
CN4604100000000	46	041	Dewey County, SD	1990	NA	2064	1825	239	11.6
CN4604300000000	46	043	Douglas County, SD	1990	NA	1563	1520	43	2.8
CN4604500000000	46	045	Edmunds County, SD	1990	NA	2124	2045	79	3.7
CN4604700000000	46	047	Fall River County, SD	1990	NA	3280	3131	149	4.5
CN4604900000000	46	049	Faulk County, SD	1990	NA	1248	1225	23	1.8
CN4605100000000	46	051	Grant County, SD	1990	NA	4141	3961	180	4.3
CN4605300000000	46	053	Gregory County, SD	1990	NA	2446	2377	69	2.8
CN4605500000000	46	055	Haakon County, SD	1990	NA	1182	1150	32	2.7
CN4605700000000	46	057	Hamlin County, SD	1990	NA	2171	2086	85	3.9
CN4605900000000	46	059	Hand County, SD	1990	NA	2005	1967	38	1.9
CN4606100000000	46	061	Hanson County, SD	1990	NA	1536	1495	41	2.7
CN4606300000000	46	063	Harding County, SD	1990	NA	863	841	22	2.5
CN4606500000000	46	065	Hughes County, SD	1990	NA	8375	8156	219	2.6
CN4606700000000	46	067	Hutchinson County, SD	1990	NA	3847	3762	85	2.2
CN4606900000000	46	069	Hyde County, SD	1990	NA	811	781	30	3.7
CN4607100000000	46	071	Jackson County, SD	1990	NA	1175	1106	69	5.9
CN4607300000000	46	073	Jerauld County, SD	1990	NA	1093	1056	37	3.4
CN4607500000000	46	075	Jones County, SD	1990	NA	746	708	38	5.1
CN4607700000000	46	077	Kingsbury County, SD	1990	NA	2683	2615	68	2.5
CN4607900000000	46	079	Lake County, SD	1990	NA	5502	5243	259	4.7
CN4608100000000	46	081	Lawrence County, SD	1990	NA	11435	10932	503	4.4
CN4608300000000	46	083	Lincoln County, SD	1990	NA	8378	8171	207	2.5
CN4608500000000	46	085	Lyman County, SD	1990	NA	1844	1767	77	4.2
CN4608700000000	46	087	McCook County, SD	1990	NA	2684	2604	80	3
CN4608900000000	46	089	McPherson County, SD	1990	NA	1470	1423	47	3.2
CN4609100000000	46	091	Marshall County, SD	1990	NA	2177	2080	97	4.5
CN4609300000000	46	093	Meade County, SD	1990	NA	9555	9214	341	3.6
CN4609500000000	46	095	Mellette County, SD	1990	NA	793	743	50	6.3
CN4609700000000	46	097	Miner County, SD	1990	NA	1563	1522	41	2.6
CN4609900000000	46	099	Minnehaha County, SD	1990	NA	70679	68767	1912	2.7
CN4610100000000	46	101	Moody County, SD	1990	NA	3251	3105	146	4.5
CN4610200000000	46	102	Oglala Lakota County, SD	1990	NA	2229	1916	313	14
CN4610300000000	46	103	Pennington County, SD	1990	NA	39753	38461	1292	3.3
CN4610500000000	46	105	Perkins County, SD	1990	NA	2157	2103	54	2.5
CN4610700000000	46	107	Potter County, SD	1990	NA	1518	1477	41	2.7
CN4610900000000	46	109	Roberts County, SD	1990	NA	4572	4303	269	5.9
CN4611100000000	46	111	Sanborn County, SD	1990	NA	1253	1231	22	1.8
CN4611500000000	46	115	Spink County, SD	1990	NA	3587	3493	94	2.6
CN4611700000000	46	117	Stanley County, SD	1990	NA	1416	1354	62	4.4
CN4611900000000	46	119	Sully County, SD	1990	NA	889	868	21	2.4
CN4612100000000	46	121	Todd County, SD	1990	NA	2412	2161	251	10.4
CN4612300000000	46	123	Tripp County, SD	1990	NA	3275	3180	95	2.9
CN4612500000000	46	125	Turner County, SD	1990	NA	4228	4129	99	2.3
CN4612700000000	46	127	Union County, SD	1990	NA	3340	3088	252	7.5
CN4612900000000	46	129	Walworth County, SD	1990	NA	3014	2917	97	3.2
CN4613500000000	46	135	Yankton County, SD	1990	NA	9829	9632	197	2
CN4613700000000	46	137	Ziebach County, SD	1990	NA	726	666	60	8.3
CN4700100000000	47	001	Anderson County, TN	1990	NA	32830	31232	1598	4.9
CN4700300000000	47	003	Bedford County, TN	1990	NA	15349	14475	874	5.7
CN4700500000000	47	005	Benton County, TN	1990	NA	6706	6191	515	7.7
CN4700700000000	47	007	Bledsoe County, TN	1990	NA	3846	3605	241	6.3
CN4700900000000	47	009	Blount County, TN	1990	NA	41692	39500	2192	5.3
CN4701100000000	47	011	Bradley County, TN	1990	NA	38748	36757	1991	5.1
CN4701300000000	47	013	Campbell County, TN	1990	NA	13742	12320	1422	10.3
CN4701500000000	47	015	Cannon County, TN	1990	NA	5419	5092	327	6
CN4701700000000	47	017	Carroll County, TN	1990	NA	12865	11906	959	7.5
CN4701900000000	47	019	Carter County, TN	1990	NA	24018	22791	1227	5.1
CN4702100000000	47	021	Cheatham County, TN	1990	NA	14046	13552	494	3.5
CN4702300000000	47	023	Chester County, TN	1990	NA	5805	5456	349	6
CN4702500000000	47	025	Claiborne County, TN	1990	NA	10790	10006	784	7.3
CN4702700000000	47	027	Clay County, TN	1990	NA	3389	3198	191	5.6
CN4702900000000	47	029	Cocke County, TN	1990	NA	14016	12545	1471	10.5
CN4703100000000	47	031	Coffee County, TN	1990	NA	18751	17759	992	5.3
CN4703300000000	47	033	Crockett County, TN	1990	NA	6478	6141	337	5.2
CN4703500000000	47	035	Cumberland County, TN	1990	NA	15248	14165	1083	7.1
CN4703700000000	47	037	Davidson County, TN	1990	NA	275139	265106	10033	3.6
CN4703900000000	47	039	Decatur County, TN	1990	NA	4817	4421	396	8.2
CN4704100000000	47	041	DeKalb County, TN	1990	NA	7310	6894	416	5.7
CN4704300000000	47	043	Dickson County, TN	1990	NA	17139	16155	984	5.7
CN4704500000000	47	045	Dyer County, TN	1990	NA	16709	15821	888	5.3
CN4704700000000	47	047	Fayette County, TN	1990	NA	11407	10631	776	6.8
CN4704900000000	47	049	Fentress County, TN	1990	NA	6288	5696	592	9.4
CN4705100000000	47	051	Franklin County, TN	1990	NA	15891	15073	818	5.1
CN4705300000000	47	053	Gibson County, TN	1990	NA	21812	20113	1699	7.8
CN4705500000000	47	055	Giles County, TN	1990	NA	12474	11796	678	5.4
CN4705700000000	47	057	Grainger County, TN	1990	NA	7994	7462	532	6.7
CN4705900000000	47	059	Greene County, TN	1990	NA	28718	26230	2488	8.7
CN4706100000000	47	061	Grundy County, TN	1990	NA	5374	4909	465	8.7
CN4706300000000	47	063	Hamblen County, TN	1990	NA	25865	24230	1635	6.3
CN4706500000000	47	065	Hamilton County, TN	1990	NA	140751	135065	5686	4
CN4706700000000	47	067	Hancock County, TN	1990	NA	2217	2079	138	6.2
CN4706900000000	47	069	Hardeman County, TN	1990	NA	9530	8905	625	6.6
CN4707100000000	47	071	Hardin County, TN	1990	NA	10619	9826	793	7.5
CN4707300000000	47	073	Hawkins County, TN	1990	NA	20574	19558	1016	4.9
CN4707500000000	47	075	Haywood County, TN	1990	NA	8268	7511	757	9.2
CN4707700000000	47	077	Henderson County, TN	1990	NA	11109	10212	897	8.1
CN4707900000000	47	079	Henry County, TN	1990	NA	12462	11640	822	6.6
CN4708100000000	47	081	Hickman County, TN	1990	NA	7747	7153	594	7.7
CN4708300000000	47	083	Houston County, TN	1990	NA	3025	2717	308	10.2
CN4708500000000	47	085	Humphreys County, TN	1990	NA	7298	6478	820	11.2
CN4708700000000	47	087	Jackson County, TN	1990	NA	4229	3908	321	7.6
CN4708900000000	47	089	Jefferson County, TN	1990	NA	16529	15308	1221	7.4
CN4709100000000	47	091	Johnson County, TN	1990	NA	5986	5608	378	6.3
CN4709300000000	47	093	Knox County, TN	1990	NA	173391	166177	7214	4.2
CN4709500000000	47	095	Lake County, TN	1990	NA	2601	2437	164	6.3
CN4709700000000	47	097	Lauderdale County, TN	1990	NA	9907	9127	780	7.9
CN4709900000000	47	099	Lawrence County, TN	1990	NA	17036	15576	1460	8.6
CN4710100000000	47	101	Lewis County, TN	1990	NA	4232	3889	343	8.1
CN4710300000000	47	103	Lincoln County, TN	1990	NA	14089	13446	643	4.6
CN4710500000000	47	105	Loudon County, TN	1990	NA	15937	15019	918	5.8
CN4710700000000	47	107	McMinn County, TN	1990	NA	20603	18830	1773	8.6
CN4710900000000	47	109	McNairy County, TN	1990	NA	10306	9533	773	7.5
CN4711100000000	47	111	Macon County, TN	1990	NA	7943	7420	523	6.6
CN4711300000000	47	113	Madison County, TN	1990	NA	38139	36113	2026	5.3
CN4711500000000	47	115	Marion County, TN	1990	NA	11327	10655	672	5.9
CN4711700000000	47	117	Marshall County, TN	1990	NA	11327	10725	602	5.3
CN4711900000000	47	119	Maury County, TN	1990	NA	28594	26673	1921	6.7
CN4712100000000	47	121	Meigs County, TN	1990	NA	3861	3463	398	10.3
CN4712300000000	47	123	Monroe County, TN	1990	NA	14518	12986	1532	10.6
CN4712500000000	47	125	Montgomery County, TN	1990	NA	40472	38149	2323	5.7
CN4712700000000	47	127	Moore County, TN	1990	NA	2507	2415	92	3.7
CN4712900000000	47	129	Morgan County, TN	1990	NA	6818	6211	607	8.9
CN4713100000000	47	131	Obion County, TN	1990	NA	15087	14142	945	6.3
CN4713300000000	47	133	Overton County, TN	1990	NA	8628	7852	776	9
CN4713500000000	47	135	Perry County, TN	1990	NA	3011	2796	215	7.1
CN4713700000000	47	137	Pickett County, TN	1990	NA	2031	1895	136	6.7
CN4713900000000	47	139	Polk County, TN	1990	NA	6452	5919	533	8.3
CN4714100000000	47	141	Putnam County, TN	1990	NA	26397	24529	1868	7.1
CN4714300000000	47	143	Rhea County, TN	1990	NA	11144	10330	814	7.3
CN4714500000000	47	145	Roane County, TN	1990	NA	21751	19930	1821	8.4
CN4714700000000	47	147	Robertson County, TN	1990	NA	21165	20038	1127	5.3
CN4714900000000	47	149	Rutherford County, TN	1990	NA	64416	61627	2789	4.3
CN4715100000000	47	151	Scott County, TN	1990	NA	7145	6458	687	9.6
CN4715300000000	47	153	Sequatchie County, TN	1990	NA	4050	3856	194	4.8
CN4715500000000	47	155	Sevier County, TN	1990	NA	27170	24790	2380	8.8
CN4715700000000	47	157	Shelby County, TN	1990	NA	396770	378906	17864	4.5
CN4715900000000	47	159	Smith County, TN	1990	NA	6755	6301	454	6.7
CN4716100000000	47	161	Stewart County, TN	1990	NA	4422	4117	305	6.9
CN4716300000000	47	163	Sullivan County, TN	1990	NA	69039	66275	2764	4
CN4716500000000	47	165	Sumner County, TN	1990	NA	54501	51711	2790	5.1
CN4716700000000	47	167	Tipton County, TN	1990	NA	16814	15956	858	5.1
CN4716900000000	47	169	Trousdale County, TN	1990	NA	2885	2709	176	6.1
CN4717100000000	47	171	Unicoi County, TN	1990	NA	7512	6922	590	7.9
CN4717300000000	47	173	Union County, TN	1990	NA	6300	5965	335	5.3
CN4717500000000	47	175	Van Buren County, TN	1990	NA	2248	2022	226	10.1
CN4717700000000	47	177	Warren County, TN	1990	NA	16941	15682	1259	7.4
CN4717900000000	47	179	Washington County, TN	1990	NA	45756	43719	2037	4.5
CN4718100000000	47	181	Wayne County, TN	1990	NA	6894	6394	500	7.3
CN4718300000000	47	183	Weakley County, TN	1990	NA	16143	15085	1058	6.6
CN4718500000000	47	185	White County, TN	1990	NA	9772	8909	863	8.8
CN4718700000000	47	187	Williamson County, TN	1990	NA	42860	41642	1218	2.8
CN4718900000000	47	189	Wilson County, TN	1990	NA	36052	34253	1799	5
CN4800100000000	48	001	Anderson County, TX	1990	NA	17851	16599	1252	7
CN4800300000000	48	003	Andrews County, TX	1990	NA	6335	6102	233	3.7
CN4800500000000	48	005	Angelina County, TX	1990	NA	32155	30083	2072	6.4
CN4800700000000	48	007	Aransas County, TX	1990	NA	7412	7115	297	4
CN4800900000000	48	009	Archer County, TX	1990	NA	3856	3710	146	3.8
CN4801100000000	48	011	Armstrong County, TX	1990	NA	994	947	47	4.7
CN4801300000000	48	013	Atascosa County, TX	1990	NA	12729	11850	879	6.9
CN4801500000000	48	015	Austin County, TX	1990	NA	9193	8856	337	3.7
CN4801700000000	48	017	Bailey County, TX	1990	NA	3650	3548	102	2.8
CN4801900000000	48	019	Bandera County, TX	1990	NA	5513	5421	92	1.7
CN4802100000000	48	021	Bastrop County, TX	1990	NA	18515	17638	877	4.7
CN4802300000000	48	023	Baylor County, TX	1990	NA	1986	1912	74	3.7
CN4802500000000	48	025	Bee County, TX	1990	NA	9717	9032	685	7
CN4802700000000	48	027	Bell County, TX	1990	NA	76833	71289	5544	7.2
CN4802900000000	48	029	Bexar County, TX	1990	NA	563648	522540	41108	7.3
CN4803100000000	48	031	Blanco County, TX	1990	NA	2858	2812	46	1.6
CN4803300000000	48	033	Borden County, TX	1990	NA	438	424	14	3.2
CN4803500000000	48	035	Bosque County, TX	1990	NA	6379	5942	437	6.9
CN4803700000000	48	037	Bowie County, TX	1990	NA	38098	35554	2544	6.7
CN4803900000000	48	039	Brazoria County, TX	1990	NA	98105	93572	4533	4.6
CN4804100000000	48	041	Brazos County, TX	1990	NA	61595	58306	3289	5.3
CN4804300000000	48	043	Brewster County, TX	1990	NA	4252	4052	200	4.7
CN4804500000000	48	045	Briscoe County, TX	1990	NA	922	910	12	1.3
CN4804700000000	48	047	Brooks County, TX	1990	NA	3059	2789	270	8.8
CN4804900000000	48	049	Brown County, TX	1990	NA	15400	14279	1121	7.3
CN4805100000000	48	051	Burleson County, TX	1990	NA	6119	5807	312	5.1
CN4805300000000	48	053	Burnet County, TX	1990	NA	9385	9043	342	3.6
CN4805500000000	48	055	Caldwell County, TX	1990	NA	11782	11084	698	5.9
CN4805700000000	48	057	Calhoun County, TX	1990	NA	8435	7902	533	6.3
CN4805900000000	48	059	Callahan County, TX	1990	NA	5295	5072	223	4.2
CN4806100000000	48	061	Cameron County, TX	1990	NA	104152	90888	13264	12.7
CN4806300000000	48	063	Camp County, TX	1990	NA	4731	4367	364	7.7
CN4806500000000	48	065	Carson County, TX	1990	NA	3050	2953	97	3.2
CN4806700000000	48	067	Cass County, TX	1990	NA	13288	12280	1008	7.6
CN4806900000000	48	069	Castro County, TX	1990	NA	4061	3894	167	4.1
CN4807100000000	48	071	Chambers County, TX	1990	NA	9835	9465	370	3.8
CN4807300000000	48	073	Cherokee County, TX	1990	NA	18852	17675	1177	6.2
CN4807500000000	48	075	Childress County, TX	1990	NA	2598	2470	128	4.9
CN4807700000000	48	077	Clay County, TX	1990	NA	4731	4553	178	3.8
CN4807900000000	48	079	Cochran County, TX	1990	NA	1944	1864	80	4.1
CN4808100000000	48	081	Coke County, TX	1990	NA	1394	1372	22	1.6
CN4808300000000	48	083	Coleman County, TX	1990	NA	3977	3631	346	8.7
CN4808500000000	48	085	Collin County, TX	1990	NA	161227	155069	6158	3.8
CN4808700000000	48	087	Collingsworth County, TX	1990	NA	1790	1727	63	3.5
CN4808900000000	48	089	Colorado County, TX	1990	NA	7998	7786	212	2.7
CN4809100000000	48	091	Comal County, TX	1990	NA	25764	24382	1382	5.4
CN4809300000000	48	093	Comanche County, TX	1990	NA	5974	5674	300	5
CN4809500000000	48	095	Concho County, TX	1990	NA	1449	1404	45	3.1
CN4809700000000	48	097	Cooke County, TX	1990	NA	14776	14057	719	4.9
CN4809900000000	48	099	Coryell County, TX	1990	NA	17942	16458	1484	8.3
CN4810100000000	48	101	Cottle County, TX	1990	NA	1007	975	32	3.2
CN4810300000000	48	103	Crane County, TX	1990	NA	2225	2144	81	3.6
CN4810500000000	48	105	Crockett County, TX	1990	NA	1867	1791	76	4.1
CN4810700000000	48	107	Crosby County, TX	1990	NA	3234	3093	141	4.4
CN4810900000000	48	109	Culberson County, TX	1990	NA	1615	1499	116	7.2
CN4811100000000	48	111	Dallam County, TX	1990	NA	2500	2444	56	2.2
CN4811300000000	48	113	Dallas County, TX	1990	NA	1073287	1016640	56647	5.3
CN4811500000000	48	115	Dawson County, TX	1990	NA	5957	5473	484	8.1
CN4811700000000	48	117	Deaf Smith County, TX	1990	NA	8982	8499	483	5.4
CN4811900000000	48	119	Delta County, TX	1990	NA	2267	2148	119	5.2
CN4812100000000	48	121	Denton County, TX	1990	NA	169862	162882	6980	4.1
CN4812300000000	48	123	DeWitt County, TX	1990	NA	7815	7400	415	5.3
CN4812500000000	48	125	Dickens County, TX	1990	NA	1090	1041	49	4.5
CN4812700000000	48	127	Dimmit County, TX	1990	NA	3924	3374	550	14
CN4812900000000	48	129	Donley County, TX	1990	NA	1685	1596	89	5.3
CN4813100000000	48	131	Duval County, TX	1990	NA	4446	3987	459	10.3
CN4813300000000	48	133	Eastland County, TX	1990	NA	8028	7447	581	7.2
CN4813500000000	48	135	Ector County, TX	1990	NA	55931	52791	3140	5.6
CN4813700000000	48	137	Edwards County, TX	1990	NA	944	885	59	6.3
CN4813900000000	48	139	Ellis County, TX	1990	NA	43925	41537	2388	5.4
CN4814100000000	48	141	El Paso County, TX	1990	NA	259755	229415	30340	11.7
CN4814300000000	48	143	Erath County, TX	1990	NA	14137	13257	880	6.2
CN4814500000000	48	145	Falls County, TX	1990	NA	7096	6766	330	4.7
CN4814700000000	48	147	Fannin County, TX	1990	NA	11116	10330	786	7.1
CN4814900000000	48	149	Fayette County, TX	1990	NA	9426	9199	227	2.4
CN4815100000000	48	151	Fisher County, TX	1990	NA	2195	2058	137	6.2
CN4815300000000	48	153	Floyd County, TX	1990	NA	3947	3793	154	3.9
CN4815500000000	48	155	Foard County, TX	1990	NA	840	826	14	1.7
CN4815700000000	48	157	Fort Bend County, TX	1990	NA	122373	118105	4268	3.5
CN4815900000000	48	159	Franklin County, TX	1990	NA	3514	3304	210	6
CN4816100000000	48	161	Freestone County, TX	1990	NA	7061	6671	390	5.5
CN4816300000000	48	163	Frio County, TX	1990	NA	6108	5685	423	6.9
CN4816500000000	48	165	Gaines County, TX	1990	NA	6462	6210	252	3.9
CN4816700000000	48	167	Galveston County, TX	1990	NA	113422	105449	7973	7
CN4816900000000	48	169	Garza County, TX	1990	NA	2228	2132	96	4.3
CN4817100000000	48	171	Gillespie County, TX	1990	NA	8042	7912	130	1.6
CN4817300000000	48	173	Glasscock County, TX	1990	NA	662	650	12	1.8
CN4817500000000	48	175	Goliad County, TX	1990	NA	2617	2498	119	4.5
CN4817700000000	48	177	Gonzales County, TX	1990	NA	7690	7458	232	3
CN4817900000000	48	179	Gray County, TX	1990	NA	11142	10668	474	4.3
CN4818100000000	48	181	Grayson County, TX	1990	NA	46437	43815	2622	5.6
CN4818300000000	48	183	Gregg County, TX	1990	NA	53298	49001	4297	8.1
CN4818500000000	48	185	Grimes County, TX	1990	NA	7365	6983	382	5.2
CN4818700000000	48	187	Guadalupe County, TX	1990	NA	32217	30794	1423	4.4
CN4818900000000	48	189	Hale County, TX	1990	NA	16832	16000	832	4.9
CN4819100000000	48	191	Hall County, TX	1990	NA	2062	1938	124	6
CN4819300000000	48	193	Hamilton County, TX	1990	NA	3411	3242	169	5
CN4819500000000	48	195	Hansford County, TX	1990	NA	2749	2681	68	2.5
CN4819700000000	48	197	Hardeman County, TX	1990	NA	2247	2109	138	6.1
CN4819900000000	48	199	Hardin County, TX	1990	NA	19112	17906	1206	6.3
CN4820100000000	48	201	Harris County, TX	1990	NA	1551276	1471869	79407	5.1
CN4820300000000	48	203	Harrison County, TX	1990	NA	25512	23827	1685	6.6
CN4820500000000	48	205	Hartley County, TX	1990	NA	1728	1701	27	1.6
CN4820700000000	48	207	Haskell County, TX	1990	NA	3074	2977	97	3.2
CN4820900000000	48	209	Hays County, TX	1990	NA	34005	32243	1762	5.2
CN4821100000000	48	211	Hemphill County, TX	1990	NA	1803	1758	45	2.5
CN4821300000000	48	213	Henderson County, TX	1990	NA	25971	23521	2450	9.4
CN4821500000000	48	215	Hidalgo County, TX	1990	NA	165779	128595	37184	22.4
CN4821700000000	48	217	Hill County, TX	1990	NA	11781	11032	749	6.4
CN4821900000000	48	219	Hockley County, TX	1990	NA	11276	10713	563	5
CN4822100000000	48	221	Hood County, TX	1990	NA	13766	12302	1464	10.6
CN4822300000000	48	223	Hopkins County, TX	1990	NA	13983	13179	804	5.7
CN4822500000000	48	225	Houston County, TX	1990	NA	8493	8057	436	5.1
CN4822700000000	48	227	Howard County, TX	1990	NA	14734	14020	714	4.8
CN4822900000000	48	229	Hudspeth County, TX	1990	NA	1260	1227	33	2.6
CN4823100000000	48	231	Hunt County, TX	1990	NA	32511	30337	2174	6.7
CN4823300000000	48	233	Hutchinson County, TX	1990	NA	10852	10330	522	4.8
CN4823500000000	48	235	Irion County, TX	1990	NA	773	757	16	2.1
CN4823700000000	48	237	Jack County, TX	1990	NA	3067	2955	112	3.7
CN4823900000000	48	239	Jackson County, TX	1990	NA	5512	5336	176	3.2
CN4824100000000	48	241	Jasper County, TX	1990	NA	12497	11337	1160	9.3
CN4824300000000	48	243	Jeff Davis County, TX	1990	NA	863	837	26	3
CN4824500000000	48	245	Jefferson County, TX	1990	NA	112687	104700	7987	7.1
CN4824700000000	48	247	Jim Hogg County, TX	1990	NA	2169	1928	241	11.1
CN4824900000000	48	249	Jim Wells County, TX	1990	NA	15222	14095	1127	7.4
CN4825100000000	48	251	Johnson County, TX	1990	NA	49786	47014	2772	5.6
CN4825300000000	48	253	Jones County, TX	1990	NA	7391	7054	337	4.6
CN4825500000000	48	255	Karnes County, TX	1990	NA	4979	4762	217	4.4
CN4825700000000	48	257	Kaufman County, TX	1990	NA	25342	23946	1396	5.5
CN4825900000000	48	259	Kendall County, TX	1990	NA	7419	7253	166	2.2
CN4826100000000	48	261	Kenedy County, TX	1990	NA	231	222	9	3.9
CN4826300000000	48	263	Kent County, TX	1990	NA	458	450	8	1.7
CN4826500000000	48	265	Kerr County, TX	1990	NA	15569	15154	415	2.7
CN4826700000000	48	267	Kimble County, TX	1990	NA	2042	2002	40	2
CN4826900000000	48	269	King County, TX	1990	NA	210	206	4	1.9
CN4827100000000	48	271	Kinney County, TX	1990	NA	1043	1005	38	3.6
CN4827300000000	48	273	Kleberg County, TX	1990	NA	12656	11756	900	7.1
CN4827500000000	48	275	Knox County, TX	1990	NA	2087	2023	64	3.1
CN4827700000000	48	277	Lamar County, TX	1990	NA	20397	18977	1420	7
CN4827900000000	48	279	Lamb County, TX	1990	NA	6417	6134	283	4.4
CN4828100000000	48	281	Lampasas County, TX	1990	NA	6215	5834	381	6.1
CN4828300000000	48	283	La Salle County, TX	1990	NA	2249	2098	151	6.7
CN4828500000000	48	285	Lavaca County, TX	1990	NA	8482	8367	115	1.4
CN4828700000000	48	287	Lee County, TX	1990	NA	6149	5834	315	5.1
CN4828900000000	48	289	Leon County, TX	1990	NA	5115	4804	311	6.1
CN4829100000000	48	291	Liberty County, TX	1990	NA	23110	21563	1547	6.7
CN4829300000000	48	293	Limestone County, TX	1990	NA	8966	8576	390	4.3
CN4829500000000	48	295	Lipscomb County, TX	1990	NA	1425	1391	34	2.4
CN4829700000000	48	297	Live Oak County, TX	1990	NA	4146	3987	159	3.8
CN4829900000000	48	299	Llano County, TX	1990	NA	3877	3758	119	3.1
CN4830100000000	48	301	Loving County, TX	1990	NA	64	61	3	4.7
CN4830300000000	48	303	Lubbock County, TX	1990	NA	113666	107849	5817	5.1
CN4830500000000	48	305	Lynn County, TX	1990	NA	3023	2938	85	2.8
CN4830700000000	48	307	McCulloch County, TX	1990	NA	3609	3221	388	10.8
CN4830900000000	48	309	McLennan County, TX	1990	NA	92695	86369	6326	6.8
CN4831100000000	48	311	McMullen County, TX	1990	NA	366	363	3	0.8
CN4831300000000	48	313	Madison County, TX	1990	NA	3950	3736	214	5.4
CN4831500000000	48	315	Marion County, TX	1990	NA	3792	3513	279	7.4
CN4831700000000	48	317	Martin County, TX	1990	NA	2020	1986	34	1.7
CN4831900000000	48	319	Mason County, TX	1990	NA	1544	1502	42	2.7
CN4832100000000	48	321	Matagorda County, TX	1990	NA	17394	15600	1794	10.3
CN4832300000000	48	323	Maverick County, TX	1990	NA	15618	10897	4721	30.2
CN4832500000000	48	325	Medina County, TX	1990	NA	11704	11071	633	5.4
CN4832700000000	48	327	Menard County, TX	1990	NA	943	905	38	4
CN4832900000000	48	329	Midland County, TX	1990	NA	54553	51636	2917	5.3
CN4833100000000	48	331	Milam County, TX	1990	NA	9551	8977	574	6
CN4833300000000	48	333	Mills County, TX	1990	NA	1974	1917	57	2.9
CN4833500000000	48	335	Mitchell County, TX	1990	NA	3298	3075	223	6.8
CN4833700000000	48	337	Montague County, TX	1990	NA	7492	7171	321	4.3
CN4833900000000	48	339	Montgomery County, TX	1990	NA	93956	89317	4639	4.9
CN4834100000000	48	341	Moore County, TX	1990	NA	8551	8297	254	3
CN4834300000000	48	343	Morris County, TX	1990	NA	5950	5391	559	9.4
CN4834500000000	48	345	Motley County, TX	1990	NA	724	710	14	1.9
CN4834700000000	48	347	Nacogdoches County, TX	1990	NA	26147	24399	1748	6.7
CN4834900000000	48	349	Navarro County, TX	1990	NA	18656	17223	1433	7.7
CN4835100000000	48	351	Newton County, TX	1990	NA	4960	4491	469	9.5
CN4835300000000	48	353	Nolan County, TX	1990	NA	7735	7137	598	7.7
CN4835500000000	48	355	Nueces County, TX	1990	NA	136119	126927	9192	6.8
CN4835700000000	48	357	Ochiltree County, TX	1990	NA	4500	4373	127	2.8
CN4835900000000	48	359	Oldham County, TX	1990	NA	1050	998	52	5
CN4836100000000	48	361	Orange County, TX	1990	NA	38299	34866	3433	9
CN4836300000000	48	363	Palo Pinto County, TX	1990	NA	11310	10581	729	6.4
CN4836500000000	48	365	Panola County, TX	1990	NA	8976	8392	584	6.5
CN4836700000000	48	367	Parker County, TX	1990	NA	32823	31320	1503	4.6
CN4836900000000	48	369	Parmer County, TX	1990	NA	4408	4241	167	3.8
CN4837100000000	48	371	Pecos County, TX	1990	NA	6219	5854	365	5.9
CN4837300000000	48	373	Polk County, TX	1990	NA	11666	10948	718	6.2
CN4837500000000	48	375	Potter County, TX	1990	NA	47288	44358	2930	6.2
CN4837700000000	48	377	Presidio County, TX	1990	NA	3115	2654	461	14.8
CN4837900000000	48	379	Rains County, TX	1990	NA	2959	2802	157	5.3
CN4838100000000	48	381	Randall County, TX	1990	NA	50504	48631	1873	3.7
CN4838300000000	48	383	Reagan County, TX	1990	NA	1989	1924	65	3.3
CN4838500000000	48	385	Real County, TX	1990	NA	1030	958	72	7
CN4838700000000	48	387	Red River County, TX	1990	NA	5764	5331	433	7.5
CN4838900000000	48	389	Reeves County, TX	1990	NA	6622	6054	568	8.6
CN4839100000000	48	391	Refugio County, TX	1990	NA	3379	3268	111	3.3
CN4839300000000	48	393	Roberts County, TX	1990	NA	576	549	27	4.7
CN4839500000000	48	395	Robertson County, TX	1990	NA	6289	5897	392	6.2
CN4839700000000	48	397	Rockwall County, TX	1990	NA	14640	14088	552	3.8
CN4839900000000	48	399	Runnels County, TX	1990	NA	5220	5028	192	3.7
CN4840100000000	48	401	Rusk County, TX	1990	NA	19758	18361	1397	7.1
CN4840300000000	48	403	Sabine County, TX	1990	NA	3376	3138	238	7
CN4840500000000	48	405	San Augustine County, TX	1990	NA	3009	2859	150	5
CN4840700000000	48	407	San Jacinto County, TX	1990	NA	6077	5821	256	4.2
CN4840900000000	48	409	San Patricio County, TX	1990	NA	24994	23253	1741	7
CN4841100000000	48	411	San Saba County, TX	1990	NA	2197	2058	139	6.3
CN4841300000000	48	413	Schleicher County, TX	1990	NA	1285	1224	61	4.7
CN4841500000000	48	415	Scurry County, TX	1990	NA	8075	7718	357	4.4
CN4841700000000	48	417	Shackelford County, TX	1990	NA	1523	1482	41	2.7
CN4841900000000	48	419	Shelby County, TX	1990	NA	8728	8207	521	6
CN4842100000000	48	421	Sherman County, TX	1990	NA	1423	1398	25	1.8
CN4842300000000	48	423	Smith County, TX	1990	NA	75737	70988	4749	6.3
CN4842500000000	48	425	Somervell County, TX	1990	NA	2641	2202	439	16.6
CN4842700000000	48	427	Starr County, TX	1990	NA	18510	11025	7485	40.4
CN4842900000000	48	429	Stephens County, TX	1990	NA	3793	3634	159	4.2
CN4843100000000	48	431	Sterling County, TX	1990	NA	653	640	13	2
CN4843300000000	48	433	Stonewall County, TX	1990	NA	896	860	36	4
CN4843500000000	48	435	Sutton County, TX	1990	NA	2061	1957	104	5
CN4843700000000	48	437	Swisher County, TX	1990	NA	3726	3609	117	3.1
CN4843900000000	48	439	Tarrant County, TX	1990	NA	666412	631417	34995	5.3
CN4844100000000	48	441	Taylor County, TX	1990	NA	55912	52403	3509	6.3
CN4844300000000	48	443	Terrell County, TX	1990	NA	650	640	10	1.5
CN4844500000000	48	445	Terry County, TX	1990	NA	5928	5556	372	6.3
CN4844700000000	48	447	Throckmorton County, TX	1990	NA	878	866	12	1.4
CN4844900000000	48	449	Titus County, TX	1990	NA	11656	10854	802	6.9
CN4845100000000	48	451	Tom Green County, TX	1990	NA	46357	43598	2759	6
CN4845300000000	48	453	Travis County, TX	1990	NA	335174	318591	16583	4.9
CN4845500000000	48	455	Trinity County, TX	1990	NA	4440	4232	208	4.7
CN4845700000000	48	457	Tyler County, TX	1990	NA	6528	6118	410	6.3
CN4845900000000	48	459	Upshur County, TX	1990	NA	14084	13242	842	6
CN4846100000000	48	461	Upton County, TX	1990	NA	1875	1827	48	2.6
CN4846300000000	48	463	Uvalde County, TX	1990	NA	10817	9470	1347	12.5
CN4846500000000	48	465	Val Verde County, TX	1990	NA	15133	13156	1977	13.1
CN4846700000000	48	467	Van Zandt County, TX	1990	NA	16553	15608	945	5.7
CN4846900000000	48	469	Victoria County, TX	1990	NA	36301	34655	1646	4.5
CN4847100000000	48	471	Walker County, TX	1990	NA	19731	18826	905	4.6
CN4847300000000	48	473	Waller County, TX	1990	NA	10772	10231	541	5
CN4847500000000	48	475	Ward County, TX	1990	NA	5398	5064	334	6.2
CN4847700000000	48	477	Washington County, TX	1990	NA	12840	12421	419	3.3
CN4847900000000	48	479	Webb County, TX	1990	NA	55453	48777	6676	12
CN4848100000000	48	481	Wharton County, TX	1990	NA	19070	18289	781	4.1
CN4848300000000	48	483	Wheeler County, TX	1990	NA	2750	2679	71	2.6
CN4848500000000	48	485	Wichita County, TX	1990	NA	57020	53202	3818	6.7
CN4848700000000	48	487	Wilbarger County, TX	1990	NA	7146	6846	300	4.2
CN4848900000000	48	489	Willacy County, TX	1990	NA	7204	6002	1202	16.7
CN4849100000000	48	491	Williamson County, TX	1990	NA	78524	75169	3355	4.3
CN4849300000000	48	493	Wilson County, TX	1990	NA	10407	9983	424	4.1
CN4849500000000	48	495	Winkler County, TX	1990	NA	3427	3249	178	5.2
CN4849700000000	48	497	Wise County, TX	1990	NA	15890	15191	699	4.4
CN4849900000000	48	499	Wood County, TX	1990	NA	12679	11944	735	5.8
CN4850100000000	48	501	Yoakum County, TX	1990	NA	3929	3807	122	3.1
CN4850300000000	48	503	Young County, TX	1990	NA	8599	8309	290	3.4
CN4850500000000	48	505	Zapata County, TX	1990	NA	3000	2616	384	12.8
CN4850700000000	48	507	Zavala County, TX	1990	NA	4716	3736	980	20.8
CN4900100000000	49	001	Beaver County, UT	1990	NA	1863	1787	76	4.1
CN4900300000000	49	003	Box Elder County, UT	1990	NA	16194	15463	731	4.5
CN4900500000000	49	005	Cache County, UT	1990	NA	33262	31933	1329	4
CN4900700000000	49	007	Carbon County, UT	1990	NA	8659	7981	678	7.8
CN4900900000000	49	009	Daggett County, UT	1990	NA	353	347	6	1.7
CN4901100000000	49	011	Davis County, UT	1990	NA	87062	83588	3474	4
CN4901300000000	49	013	Duchesne County, UT	1990	NA	5016	4608	408	8.1
CN4901500000000	49	015	Emery County, UT	1990	NA	4186	3843	343	8.2
CN4901700000000	49	017	Garfield County, UT	1990	NA	2071	1878	193	9.3
CN4901900000000	49	019	Grand County, UT	1990	NA	3329	3086	243	7.3
CN4902100000000	49	021	Iron County, UT	1990	NA	9185	8718	467	5.1
CN4902300000000	49	023	Juab County, UT	1990	NA	2702	2573	129	4.8
CN4902500000000	49	025	Kane County, UT	1990	NA	2540	2386	154	6.1
CN4902700000000	49	027	Millard County, UT	1990	NA	4650	4438	212	4.6
CN4902900000000	49	029	Morgan County, UT	1990	NA	2515	2385	130	5.2
CN4903100000000	49	031	Piute County, UT	1990	NA	470	436	34	7.2
CN4903300000000	49	033	Rich County, UT	1990	NA	718	703	15	2.1
CN4903500000000	49	035	Salt Lake County, UT	1990	NA	371230	357125	14105	3.8
CN4903700000000	49	037	San Juan County, UT	1990	NA	4141	3773	368	8.9
CN4903900000000	49	039	Sanpete County, UT	1990	NA	6432	5739	693	10.8
CN4904100000000	49	041	Sevier County, UT	1990	NA	6340	5987	353	5.6
CN4904300000000	49	043	Summit County, UT	1990	NA	8050	7549	501	6.2
CN4904500000000	49	045	Tooele County, UT	1990	NA	12378	11712	666	5.4
CN4904700000000	49	047	Uintah County, UT	1990	NA	8892	8360	532	6
CN4904900000000	49	049	Utah County, UT	1990	NA	117241	112049	5192	4.4
CN4905100000000	49	051	Wasatch County, UT	1990	NA	4560	4266	294	6.4
CN4905300000000	49	053	Washington County, UT	1990	NA	19312	18554	758	3.9
CN4905500000000	49	055	Wayne County, UT	1990	NA	944	862	82	8.7
CN4905700000000	49	057	Weber County, UT	1990	NA	77917	73947	3970	5.1
CN5000100000000	50	001	Addison County, VT	1990	NA	18320	17539	781	4.3
CN5000300000000	50	003	Bennington County, VT	1990	NA	18735	17702	1033	5.5
CN5000500000000	50	005	Caledonia County, VT	1990	NA	14250	13383	867	6.1
CN5000700000000	50	007	Chittenden County, VT	1990	NA	77122	74043	3079	4
CN5000900000000	50	009	Essex County, VT	1990	NA	2792	2558	234	8.4
CN5001100000000	50	011	Franklin County, VT	1990	NA	20898	19667	1231	5.9
CN5001300000000	50	013	Grand Isle County, VT	1990	NA	2814	2619	195	6.9
CN5001500000000	50	015	Lamoille County, VT	1990	NA	10592	9875	717	6.8
CN5001700000000	50	017	Orange County, VT	1990	NA	14117	13423	694	4.9
CN5001900000000	50	019	Orleans County, VT	1990	NA	11884	10971	913	7.7
CN5002100000000	50	021	Rutland County, VT	1990	NA	32592	31024	1568	4.8
CN5002300000000	50	023	Washington County, VT	1990	NA	29680	28087	1593	5.4
CN5002500000000	50	025	Windham County, VT	1990	NA	21756	20712	1044	4.8
CN5002700000000	50	027	Windsor County, VT	1990	NA	29203	27907	1296	4.4
CN5100100000000	51	001	Accomack County, VA	1990	NA	15110	14280	830	5.5
CN5100300000000	51	003	Albemarle County, VA	1990	NA	35137	34383	754	2.1
CN5100500000000	51	005	Alleghany County, VA	1990	NA	8597	7916	681	7.9
CN5100700000000	51	007	Amelia County, VA	1990	NA	4325	4170	155	3.6
CN5100900000000	51	009	Amherst County, VA	1990	NA	14416	13676	740	5.1
CN5101100000000	51	011	Appomattox County, VA	1990	NA	6266	5936	330	5.3
CN5101300000000	51	013	Arlington County, VA	1990	NA	108861	106694	2167	2
CN5101500000000	51	015	Augusta County, VA	1990	NA	29209	28025	1184	4.1
CN5101700000000	51	017	Bath County, VA	1990	NA	2637	2317	320	12.1
CN5101900000000	51	019	Bedford County, VA	1990	NA	27799	26587	1212	4.4
CN5102100000000	51	021	Bland County, VA	1990	NA	3243	3050	193	6
CN5102300000000	51	023	Botetourt County, VA	1990	NA	13771	13279	492	3.6
CN5102500000000	51	025	Brunswick County, VA	1990	NA	7148	6462	686	9.6
CN5102700000000	51	027	Buchanan County, VA	1990	NA	11418	10132	1286	11.3
CN5102900000000	51	029	Buckingham County, VA	1990	NA	5555	5253	302	5.4
CN5103100000000	51	031	Campbell County, VA	1990	NA	26019	24638	1381	5.3
CN5103300000000	51	033	Caroline County, VA	1990	NA	9948	9205	743	7.5
CN5103500000000	51	035	Carroll County, VA	1990	NA	13637	12595	1042	7.6
CN5103600000000	51	036	Charles City County, VA	1990	NA	3405	3225	180	5.3
CN5103700000000	51	037	Charlotte County, VA	1990	NA	5740	5158	582	10.1
CN5104100000000	51	041	Chesterfield County, VA	1990	NA	119955	116138	3817	3.2
CN5104300000000	51	043	Clarke County, VA	1990	NA	6441	6251	190	2.9
CN5104500000000	51	045	Craig County, VA	1990	NA	2214	2077	137	6.2
CN5104700000000	51	047	Culpeper County, VA	1990	NA	14360	13829	531	3.7
CN5104900000000	51	049	Cumberland County, VA	1990	NA	3875	3698	177	4.6
CN5105100000000	51	051	Dickenson County, VA	1990	NA	6247	5195	1052	16.8
CN5105300000000	51	053	Dinwiddie County, VA	1990	NA	10530	9994	536	5.1
CN5105700000000	51	057	Essex County, VA	1990	NA	4373	4076	297	6.8
CN5105900000000	51	059	Fairfax County, VA	1990	NA	485432	475838	9594	2
CN5106100000000	51	061	Fauquier County, VA	1990	NA	26639	25950	689	2.6
CN5106300000000	51	063	Floyd County, VA	1990	NA	6195	5683	512	8.3
CN5106500000000	51	065	Fluvanna County, VA	1990	NA	6395	6214	181	2.8
CN5106700000000	51	067	Franklin County, VA	1990	NA	21289	20044	1245	5.8
CN5106900000000	51	069	Frederick County, VA	1990	NA	26093	24671	1422	5.4
CN5107100000000	51	071	Giles County, VA	1990	NA	8440	7699	741	8.8
CN5107300000000	51	073	Gloucester County, VA	1990	NA	15368	14823	545	3.5
CN5107500000000	51	075	Goochland County, VA	1990	NA	7420	7188	232	3.1
CN5107700000000	51	077	Grayson County, VA	1990	NA	8637	7815	822	9.5
CN5107900000000	51	079	Greene County, VA	1990	NA	5663	5498	165	2.9
CN5108100000000	51	081	Greensville County, VA	1990	NA	4466	4203	263	5.9
CN5108300000000	51	083	Halifax County, VA	1990	NA	18230	16813	1417	7.8
CN5108500000000	51	085	Hanover County, VA	1990	NA	36367	35338	1029	2.8
CN5108700000000	51	087	Henrico County, VA	1990	NA	126509	122735	3774	3
CN5108900000000	51	089	Henry County, VA	1990	NA	32345	29824	2521	7.8
CN5109100000000	51	091	Highland County, VA	1990	NA	1354	1296	58	4.3
CN5109300000000	51	093	Isle of Wight County, VA	1990	NA	13049	12370	679	5.2
CN5109500000000	51	095	James City County, VA	1990	NA	19028	18453	575	3
CN5109700000000	51	097	King and Queen County, VA	1990	NA	3117	2970	147	4.7
CN5109900000000	51	099	King George County, VA	1990	NA	6992	6726	266	3.8
CN5110100000000	51	101	King William County, VA	1990	NA	5831	5649	182	3.1
CN5110300000000	51	103	Lancaster County, VA	1990	NA	5040	4479	561	11.1
CN5110500000000	51	105	Lee County, VA	1990	NA	9120	8252	868	9.5
CN5110700000000	51	107	Loudoun County, VA	1990	NA	52572	51702	870	1.7
CN5110900000000	51	109	Louisa County, VA	1990	NA	10420	9842	578	5.5
CN5111100000000	51	111	Lunenburg County, VA	1990	NA	5552	5116	436	7.9
CN5111300000000	51	113	Madison County, VA	1990	NA	5773	5611	162	2.8
CN5111500000000	51	115	Mathews County, VA	1990	NA	4189	4053	136	3.2
CN5111700000000	51	117	Mecklenburg County, VA	1990	NA	14397	13562	835	5.8
CN5111900000000	51	119	Middlesex County, VA	1990	NA	4075	3940	135	3.3
CN5112100000000	51	121	Montgomery County, VA	1990	NA	37410	34587	2823	7.5
CN5112500000000	51	125	Nelson County, VA	1990	NA	6081	5820	261	4.3
CN5112700000000	51	127	New Kent County, VA	1990	NA	5669	5478	191	3.4
CN5113100000000	51	131	Northampton County, VA	1990	NA	5703	5394	309	5.4
CN5113300000000	51	133	Northumberland County, VA	1990	NA	4924	4428	496	10.1
CN5113500000000	51	135	Nottoway County, VA	1990	NA	6607	6315	292	4.4
CN5113700000000	51	137	Orange County, VA	1990	NA	10840	10262	578	5.3
CN5113900000000	51	139	Page County, VA	1990	NA	11300	9794	1506	13.3
CN5114100000000	51	141	Patrick County, VA	1990	NA	9451	9006	445	4.7
CN5114300000000	51	143	Pittsylvania County, VA	1990	NA	30413	27907	2506	8.2
CN5114500000000	51	145	Powhatan County, VA	1990	NA	7557	7318	239	3.2
CN5114700000000	51	147	Prince Edward County, VA	1990	NA	7746	7113	633	8.2
CN5114900000000	51	149	Prince George County, VA	1990	NA	11968	11509	459	3.8
CN5115300000000	51	153	Prince William County, VA	1990	NA	117965	115203	2762	2.3
CN5115500000000	51	155	Pulaski County, VA	1990	NA	18329	15828	2501	13.6
CN5115700000000	51	157	Rappahannock County, VA	1990	NA	3613	3403	210	5.8
CN5115900000000	51	159	Richmond County, VA	1990	NA	3500	3257	243	6.9
CN5116100000000	51	161	Roanoke County, VA	1990	NA	45169	43845	1324	2.9
CN5116300000000	51	163	Rockbridge County, VA	1990	NA	9514	8962	552	5.8
CN5116500000000	51	165	Rockingham County, VA	1990	NA	32380	30729	1651	5.1
CN5116700000000	51	167	Russell County, VA	1990	NA	11949	10572	1377	11.5
CN5116900000000	51	169	Scott County, VA	1990	NA	9716	8940	776	8
CN5117100000000	51	171	Shenandoah County, VA	1990	NA	16619	15827	792	4.8
CN5117300000000	51	173	Smyth County, VA	1990	NA	16449	14825	1624	9.9
CN5117500000000	51	175	Southampton County, VA	1990	NA	7808	7415	393	5
CN5117700000000	51	177	Spotsylvania County, VA	1990	NA	31523	30294	1229	3.9
CN5117900000000	51	179	Stafford County, VA	1990	NA	32349	31305	1044	3.2
CN5118100000000	51	181	Surry County, VA	1990	NA	3137	2933	204	6.5
CN5118300000000	51	183	Sussex County, VA	1990	NA	4841	4560	281	5.8
CN5118500000000	51	185	Tazewell County, VA	1990	NA	18917	17140	1777	9.4
CN5118700000000	51	187	Warren County, VA	1990	NA	14113	13082	1031	7.3
CN5119100000000	51	191	Washington County, VA	1990	NA	23871	21920	1951	8.2
CN5119300000000	51	193	Westmoreland County, VA	1990	NA	7358	6740	618	8.4
CN5119500000000	51	195	Wise County, VA	1990	NA	15570	13870	1700	10.9
CN5119700000000	51	197	Wythe County, VA	1990	NA	13433	12131	1302	9.7
CN5119900000000	51	199	York County, VA	1990	NA	20704	19980	724	3.5
CN5151000000000	51	510	Alexandria city, VA	1990	NA	73894	71827	2067	2.8
CN5152000000000	51	520	Bristol city, VA	1990	NA	8904	8194	710	8
CN5153000000000	51	530	Buena Vista city, VA	1990	NA	3413	3104	309	9.1
CN5154000000000	51	540	Charlottesville city, VA	1990	NA	20675	20147	528	2.6
CN5155000000000	51	550	Chesapeake city, VA	1990	NA	80153	76720	3433	4.3
CN5157000000000	51	570	Colonial Heights city, VA	1990	NA	8606	8248	358	4.2
CN5158000000000	51	580	Covington city, VA	1990	NA	3259	2932	327	10
CN5159000000000	51	590	Danville city, VA	1990	NA	26149	23699	2450	9.4
CN5159500000000	51	595	Emporia city, VA	1990	NA	2443	2282	161	6.6
CN5160000000000	51	600	Fairfax city, VA	1990	NA	12262	12065	197	1.6
CN5161000000000	51	610	Falls Church city, VA	1990	NA	5874	5780	94	1.6
CN5162000000000	51	620	Franklin city, VA	1990	NA	3475	3316	159	4.6
CN5163000000000	51	630	Fredericksburg city, VA	1990	NA	10396	9896	500	4.8
CN5164000000000	51	640	Galax city, VA	1990	NA	3520	3225	295	8.4
CN5165000000000	51	650	Hampton city, VA	1990	NA	64936	61480	3456	5.3
CN5166000000000	51	660	Harrisonburg city, VA	1990	NA	16075	15080	995	6.2
CN5167000000000	51	670	Hopewell city, VA	1990	NA	11527	10813	714	6.2
CN5167800000000	51	678	Lexington city, VA	1990	NA	2904	2671	233	8
CN5168000000000	51	680	Lynchburg city, VA	1990	NA	32172	30311	1861	5.8
CN5168300000000	51	683	Manassas city, VA	1990	NA	16517	16117	400	2.4
CN5168500000000	51	685	Manassas Park city, VA	1990	NA	3844	3763	81	2.1
CN5169000000000	51	690	Martinsville city, VA	1990	NA	8282	7479	803	9.7
CN5170000000000	51	700	Newport News city, VA	1990	NA	81038	76831	4207	5.2
CN5171000000000	51	710	Norfolk city, VA	1990	NA	98488	93821	4667	4.7
CN5172000000000	51	720	Norton city, VA	1990	NA	1641	1483	158	9.6
CN5173000000000	51	730	Petersburg city, VA	1990	NA	18238	16926	1312	7.2
CN5173500000000	51	735	Poquoson city, VA	1990	NA	5880	5651	229	3.9
CN5174000000000	51	740	Portsmouth city, VA	1990	NA	47133	44009	3124	6.6
CN5175000000000	51	750	Radford city, VA	1990	NA	7230	6381	849	11.7
CN5176000000000	51	760	Richmond city, VA	1990	NA	104210	98296	5914	5.7
CN5177000000000	51	770	Roanoke city, VA	1990	NA	48953	46674	2279	4.7
CN5177500000000	51	775	Salem city, VA	1990	NA	12805	12392	413	3.2
CN5179000000000	51	790	Staunton city, VA	1990	NA	11846	11331	515	4.3
CN5180000000000	51	800	Suffolk city, VA	1990	NA	25182	23602	1580	6.3
CN5181000000000	51	810	Virginia Beach city, VA	1990	NA	191985	184421	7564	3.9
CN5182000000000	51	820	Waynesboro city, VA	1990	NA	9125	8735	390	4.3
CN5183000000000	51	830	Williamsburg city, VA	1990	NA	5828	5307	521	8.9
CN5184000000000	51	840	Winchester city, VA	1990	NA	12597	11803	794	6.3
CN5300100000000	53	001	Adams County, WA	1990	NA	7784	6933	851	10.9
CN5300300000000	53	003	Asotin County, WA	1990	NA	9447	8941	506	5.4
CN5300500000000	53	005	Benton County, WA	1990	NA	61336	57395	3941	6.4
CN5300700000000	53	007	Chelan County, WA	1990	NA	31764	28928	2836	8.9
CN5300900000000	53	009	Clallam County, WA	1990	NA	23210	21524	1686	7.3
CN5301100000000	53	011	Clark County, WA	1990	NA	128576	122317	6259	4.9
CN5301300000000	53	013	Columbia County, WA	1990	NA	1496	1302	194	13
CN5301500000000	53	015	Cowlitz County, WA	1990	NA	38256	35526	2730	7.1
CN5301700000000	53	017	Douglas County, WA	1990	NA	16040	14747	1293	8.1
CN5301900000000	53	019	Ferry County, WA	1990	NA	2824	2481	343	12.1
CN5302100000000	53	021	Franklin County, WA	1990	NA	19183	17124	2059	10.7
CN5302300000000	53	023	Garfield County, WA	1990	NA	1067	1033	34	3.2
CN5302500000000	53	025	Grant County, WA	1990	NA	27333	24852	2481	9.1
CN5302700000000	53	027	Grays Harbor County, WA	1990	NA	27575	24855	2720	9.9
CN5302900000000	53	029	Island County, WA	1990	NA	23040	22225	815	3.5
CN5303100000000	53	031	Jefferson County, WA	1990	NA	8418	7977	441	5.2
CN5303300000000	53	033	King County, WA	1990	NA	857056	826082	30974	3.6
CN5303500000000	53	035	Kitsap County, WA	1990	NA	84866	81258	3608	4.3
CN5303700000000	53	037	Kittitas County, WA	1990	NA	12723	11690	1033	8.1
CN5303900000000	53	039	Klickitat County, WA	1990	NA	7966	6990	976	12.3
CN5304100000000	53	041	Lewis County, WA	1990	NA	26490	24271	2219	8.4
CN5304300000000	53	043	Lincoln County, WA	1990	NA	4180	4015	165	3.9
CN5304500000000	53	045	Mason County, WA	1990	NA	15960	14994	966	6.1
CN5304700000000	53	047	Okanogan County, WA	1990	NA	19057	17158	1899	10
CN5304900000000	53	049	Pacific County, WA	1990	NA	7558	6916	642	8.5
CN5305100000000	53	051	Pend Oreille County, WA	1990	NA	3499	2984	515	14.7
CN5305300000000	53	053	Pierce County, WA	1990	NA	277634	263924	13710	4.9
CN5305500000000	53	055	San Juan County, WA	1990	NA	5107	4955	152	3
CN5305700000000	53	057	Skagit County, WA	1990	NA	39549	36733	2816	7.1
CN5305900000000	53	059	Skamania County, WA	1990	NA	3947	3532	415	10.5
CN5306100000000	53	061	Snohomish County, WA	1990	NA	249722	239417	10305	4.1
CN5306300000000	53	063	Spokane County, WA	1990	NA	173569	163488	10081	5.8
CN5306500000000	53	065	Stevens County, WA	1990	NA	13457	12282	1175	8.7
CN5306700000000	53	067	Thurston County, WA	1990	NA	81191	77048	4143	5.1
CN5306900000000	53	069	Wahkiakum County, WA	1990	NA	1535	1439	96	6.3
CN5307100000000	53	071	Walla Walla County, WA	1990	NA	23859	22185	1674	7
CN5307300000000	53	073	Whatcom County, WA	1990	NA	68105	64411	3694	5.4
CN5307500000000	53	075	Whitman County, WA	1990	NA	17524	17238	286	1.6
CN5307700000000	53	077	Yakima County, WA	1990	NA	103424	91722	11702	11.3
CN5400100000000	54	001	Barbour County, WV	1990	NA	6021	5261	760	12.6
CN5400300000000	54	003	Berkeley County, WV	1990	NA	29606	27715	1891	6.4
CN5400500000000	54	005	Boone County, WV	1990	NA	8484	7688	796	9.4
CN5400700000000	54	007	Braxton County, WV	1990	NA	4989	4320	669	13.4
CN5400900000000	54	009	Brooke County, WV	1990	NA	11975	11220	755	6.3
CN5401100000000	54	011	Cabell County, WV	1990	NA	43004	40173	2831	6.6
CN5401300000000	54	013	Calhoun County, WV	1990	NA	3038	2527	511	16.8
CN5401500000000	54	015	Clay County, WV	1990	NA	2938	2461	477	16.2
CN5401700000000	54	017	Doddridge County, WV	1990	NA	2718	2514	204	7.5
CN5401900000000	54	019	Fayette County, WV	1990	NA	16857	14967	1890	11.2
CN5402100000000	54	021	Gilmer County, WV	1990	NA	2798	2492	306	10.9
CN5402300000000	54	023	Grant County, WV	1990	NA	5388	5012	376	7
CN5402500000000	54	025	Greenbrier County, WV	1990	NA	15525	13661	1864	12
CN5402700000000	54	027	Hampshire County, WV	1990	NA	7460	6768	692	9.3
CN5402900000000	54	029	Hancock County, WV	1990	NA	15799	14902	897	5.7
CN5403100000000	54	031	Hardy County, WV	1990	NA	5406	5099	307	5.7
CN5403300000000	54	033	Harrison County, WV	1990	NA	29891	27301	2590	8.7
CN5403500000000	54	035	Jackson County, WV	1990	NA	11350	10301	1049	9.2
CN5403700000000	54	037	Jefferson County, WV	1990	NA	18803	17742	1061	5.6
CN5403900000000	54	039	Kanawha County, WV	1990	NA	96595	90577	6018	6.2
CN5404100000000	54	041	Lewis County, WV	1990	NA	7132	6349	783	11
CN5404300000000	54	043	Lincoln County, WV	1990	NA	6990	6000	990	14.2
CN5404500000000	54	045	Logan County, WV	1990	NA	14395	12764	1631	11.3
CN5404700000000	54	047	McDowell County, WV	1990	NA	8831	7671	1160	13.1
CN5404900000000	54	049	Marion County, WV	1990	NA	23873	21744	2129	8.9
CN5405100000000	54	051	Marshall County, WV	1990	NA	16057	14860	1197	7.5
CN5405300000000	54	053	Mason County, WV	1990	NA	10027	9122	905	9
CN5405500000000	54	055	Mercer County, WV	1990	NA	28534	26212	2322	8.1
CN5405700000000	54	057	Mineral County, WV	1990	NA	11776	10982	794	6.7
CN5405900000000	54	059	Mingo County, WV	1990	NA	9837	8772	1065	10.8
CN5406100000000	54	061	Monongalia County, WV	1990	NA	36711	34323	2388	6.5
CN5406300000000	54	063	Monroe County, WV	1990	NA	5113	4637	476	9.3
CN5406500000000	54	065	Morgan County, WV	1990	NA	5709	5438	271	4.7
CN5406700000000	54	067	Nicholas County, WV	1990	NA	10301	8963	1338	13
CN5406900000000	54	069	Ohio County, WV	1990	NA	24248	22955	1293	5.3
CN5407100000000	54	071	Pendleton County, WV	1990	NA	3665	3454	211	5.8
CN5407300000000	54	073	Pleasants County, WV	1990	NA	3227	2899	328	10.2
CN5407500000000	54	075	Pocahontas County, WV	1990	NA	4198	3640	558	13.3
CN5407700000000	54	077	Preston County, WV	1990	NA	12168	10944	1224	10.1
CN5407900000000	54	079	Putnam County, WV	1990	NA	20076	18665	1411	7
CN5408100000000	54	081	Raleigh County, WV	1990	NA	29177	26600	2577	8.8
CN5408300000000	54	083	Randolph County, WV	1990	NA	12226	10465	1761	14.4
CN5408500000000	54	085	Ritchie County, WV	1990	NA	4456	3827	629	14.1
CN5408700000000	54	087	Roane County, WV	1990	NA	5917	5011	906	15.3
CN5408900000000	54	089	Summers County, WV	1990	NA	4673	4221	452	9.7
CN5409100000000	54	091	Taylor County, WV	1990	NA	6132	5520	612	10
CN5409300000000	54	093	Tucker County, WV	1990	NA	3512	3085	427	12.2
CN5409500000000	54	095	Tyler County, WV	1990	NA	4159	3746	413	9.9
CN5409700000000	54	097	Upshur County, WV	1990	NA	9818	8763	1055	10.7
CN5409900000000	54	099	Wayne County, WV	1990	NA	16517	15134	1383	8.4
CN5410100000000	54	101	Webster County, WV	1990	NA	3407	2756	651	19.1
CN5410300000000	54	103	Wetzel County, WV	1990	NA	7768	6913	855	11
CN5410500000000	54	105	Wirt County, WV	1990	NA	2350	1939	411	17.5
CN5410700000000	54	107	Wood County, WV	1990	NA	41966	39019	2947	7
CN5410900000000	54	109	Wyoming County, WV	1990	NA	8577	7541	1036	12.1
CN5500100000000	55	001	Adams County, WI	1990	NA	6119	5786	333	5.4
CN5500300000000	55	003	Ashland County, WI	1990	NA	7549	6950	599	7.9
CN5500500000000	55	005	Barron County, WI	1990	NA	20791	19529	1262	6.1
CN5500700000000	55	007	Bayfield County, WI	1990	NA	6637	6129	508	7.7
CN5500900000000	55	009	Brown County, WI	1990	NA	106092	102006	4086	3.9
CN5501100000000	55	011	Buffalo County, WI	1990	NA	7131	6733	398	5.6
CN5501300000000	55	013	Burnett County, WI	1990	NA	5805	5437	368	6.3
CN5501500000000	55	015	Calumet County, WI	1990	NA	21423	20009	1414	6.6
CN5501700000000	55	017	Chippewa County, WI	1990	NA	26100	24618	1482	5.7
CN5501900000000	55	019	Clark County, WI	1990	NA	15500	14563	937	6
CN5502100000000	55	021	Columbia County, WI	1990	NA	24870	23478	1392	5.6
CN5502300000000	55	023	Crawford County, WI	1990	NA	7991	7560	431	5.4
CN5502500000000	55	025	Dane County, WI	1990	NA	217880	213475	4405	2
CN5502700000000	55	027	Dodge County, WI	1990	NA	39296	37496	1800	4.6
CN5502900000000	55	029	Door County, WI	1990	NA	14784	13799	985	6.7
CN5503100000000	55	031	Douglas County, WI	1990	NA	19382	18270	1112	5.7
CN5503300000000	55	033	Dunn County, WI	1990	NA	18198	17481	717	3.9
CN5503500000000	55	035	Eau Claire County, WI	1990	NA	44175	41950	2225	5
CN5503700000000	55	037	Florence County, WI	1990	NA	2164	2083	81	3.7
CN5503900000000	55	039	Fond du Lac County, WI	1990	NA	48679	46173	2506	5.1
CN5504100000000	55	041	Forest County, WI	1990	NA	3534	3296	238	6.7
CN5504300000000	55	043	Grant County, WI	1990	NA	25190	24015	1175	4.7
CN5504500000000	55	045	Green County, WI	1990	NA	17792	17104	688	3.9
CN5504700000000	55	047	Green Lake County, WI	1990	NA	9435	8848	587	6.2
CN5504900000000	55	049	Iowa County, WI	1990	NA	11809	11342	467	4
CN5505100000000	55	051	Iron County, WI	1990	NA	2795	2623	172	6.2
CN5505300000000	55	053	Jackson County, WI	1990	NA	8104	7602	502	6.2
CN5505500000000	55	055	Jefferson County, WI	1990	NA	37600	36138	1462	3.9
CN5505700000000	55	057	Juneau County, WI	1990	NA	10503	9774	729	6.9
CN5505900000000	55	059	Kenosha County, WI	1990	NA	66291	62246	4045	6.1
CN5506100000000	55	061	Kewaunee County, WI	1990	NA	10027	9568	459	4.6
CN5506300000000	55	063	La Crosse County, WI	1990	NA	53196	51122	2074	3.9
CN5506500000000	55	065	Lafayette County, WI	1990	NA	8382	8066	316	3.8
CN5506700000000	55	067	Langlade County, WI	1990	NA	9037	8571	466	5.2
CN5506900000000	55	069	Lincoln County, WI	1990	NA	13657	12919	738	5.4
CN5507100000000	55	071	Manitowoc County, WI	1990	NA	41548	39532	2016	4.9
CN5507300000000	55	073	Marathon County, WI	1990	NA	62089	59498	2591	4.2
CN5507500000000	55	075	Marinette County, WI	1990	NA	19193	17831	1362	7.1
CN5507700000000	55	077	Marquette County, WI	1990	NA	5998	5600	398	6.6
CN5507800000000	55	078	Menominee County, WI	1990	NA	1163	1056	107	9.2
CN5507900000000	55	079	Milwaukee County, WI	1990	NA	475405	453338	22067	4.6
CN5508100000000	55	081	Monroe County, WI	1990	NA	18126	17206	920	5.1
CN5508300000000	55	083	Oconto County, WI	1990	NA	14471	13327	1144	7.9
CN5508500000000	55	085	Oneida County, WI	1990	NA	15985	15266	719	4.5
CN5508700000000	55	087	Outagamie County, WI	1990	NA	84267	81548	2719	3.2
CN5508900000000	55	089	Ozaukee County, WI	1990	NA	41187	39886	1301	3.2
CN5509100000000	55	091	Pepin County, WI	1990	NA	3405	3242	163	4.8
CN5509300000000	55	093	Pierce County, WI	1990	NA	18146	17481	665	3.7
CN5509500000000	55	095	Polk County, WI	1990	NA	17160	16147	1013	5.9
CN5509700000000	55	097	Portage County, WI	1990	NA	32441	31239	1202	3.7
CN5509900000000	55	099	Price County, WI	1990	NA	7416	7024	392	5.3
CN5510100000000	55	101	Racine County, WI	1990	NA	89858	85705	4153	4.6
CN5510300000000	55	103	Richland County, WI	1990	NA	8674	8319	355	4.1
CN5510500000000	55	105	Rock County, WI	1990	NA	72243	68285	3958	5.5
CN5510700000000	55	107	Rusk County, WI	1990	NA	6973	6405	568	8.1
CN5510900000000	55	109	St. Croix County, WI	1990	NA	27195	26226	969	3.6
CN5511100000000	55	111	Sauk County, WI	1990	NA	26188	24788	1400	5.3
CN5511300000000	55	113	Sawyer County, WI	1990	NA	6366	5851	515	8.1
CN5511500000000	55	115	Shawano County, WI	1990	NA	18316	17395	921	5
CN5511700000000	55	117	Sheboygan County, WI	1990	NA	55741	53433	2308	4.1
CN5511900000000	55	119	Taylor County, WI	1990	NA	9933	9275	658	6.6
CN5512100000000	55	121	Trempealeau County, WI	1990	NA	13375	12517	858	6.4
CN5512300000000	55	123	Vernon County, WI	1990	NA	12587	12004	583	4.6
CN5512500000000	55	125	Vilas County, WI	1990	NA	8254	7791	463	5.6
CN5512700000000	55	127	Walworth County, WI	1990	NA	41724	40582	1142	2.7
CN5512900000000	55	129	Washburn County, WI	1990	NA	6294	5846	448	7.1
CN5513100000000	55	131	Washington County, WI	1990	NA	53579	51545	2034	3.8
CN5513300000000	55	133	Waukesha County, WI	1990	NA	173719	167830	5889	3.4
CN5513500000000	55	135	Waupaca County, WI	1990	NA	22911	21808	1103	4.8
CN5513700000000	55	137	Waushara County, WI	1990	NA	9043	8492	551	6.1
CN5513900000000	55	139	Winnebago County, WI	1990	NA	83581	80711	2870	3.4
CN5514100000000	55	141	Wood County, WI	1990	NA	37407	35838	1569	4.2
CN5600100000000	56	001	Albany County, WY	1990	NA	16709	15821	888	5.3
CN5600300000000	56	003	Big Horn County, WY	1990	NA	4868	4576	292	6
CN5600500000000	56	005	Campbell County, WY	1990	NA	16402	15596	806	4.9
CN5600700000000	56	007	Carbon County, WY	1990	NA	8820	8362	458	5.2
CN5600900000000	56	009	Converse County, WY	1990	NA	5728	5408	320	5.6
CN5601100000000	56	011	Crook County, WY	1990	NA	2676	2592	84	3.1
CN5601300000000	56	013	Fremont County, WY	1990	NA	15730	14548	1182	7.5
CN5601500000000	56	015	Goshen County, WY	1990	NA	5947	5675	272	4.6
CN5601700000000	56	017	Hot Springs County, WY	1990	NA	2409	2316	93	3.9
CN5601900000000	56	019	Johnson County, WY	1990	NA	3415	3250	165	4.8
CN5602100000000	56	021	Laramie County, WY	1990	NA	36696	34868	1828	5
CN5602300000000	56	023	Lincoln County, WY	1990	NA	5776	5411	365	6.3
CN5602500000000	56	025	Natrona County, WY	1990	NA	31885	29944	1941	6.1
CN5602700000000	56	027	Niobrara County, WY	1990	NA	1181	1137	44	3.7
CN5602900000000	56	029	Park County, WY	1990	NA	13054	12442	612	4.7
CN5603100000000	56	031	Platte County, WY	1990	NA	3865	3669	196	5.1
CN5603300000000	56	033	Sheridan County, WY	1990	NA	12113	11441	672	5.5
CN5603500000000	56	035	Sublette County, WY	1990	NA	2663	2590	73	2.7
CN5603700000000	56	037	Sweetwater County, WY	1990	NA	20349	19274	1075	5.3
CN5603900000000	56	039	Teton County, WY	1990	NA	8212	8049	163	2
CN5604100000000	56	041	Uinta County, WY	1990	NA	9899	9246	653	6.6
CN5604300000000	56	043	Washakie County, WY	1990	NA	4244	4046	198	4.7
CN5604500000000	56	045	Weston County, WY	1990	NA	3324	3177	147	4.4
CN7200100000000	72	001	Adjuntas Municipio, PR	1990	NA	4823	4025	798	16.5
CN7200300000000	72	003	Aguada Municipio, PR	1990	NA	12874	10319	2555	19.8
CN7200500000000	72	005	Aguadilla Municipio, PR	1990	NA	18207	14804	3403	18.7
CN7200700000000	72	007	Aguas Buenas Municipio, PR	1990	NA	7493	6164	1329	17.7
CN7200900000000	72	009	Aibonito Municipio, PR	1990	NA	8738	7711	1027	11.8
CN7201100000000	72	011	Anasco Municipio, PR	1990	NA	9221	7447	1774	19.2
CN7201300000000	72	013	Arecibo Municipio, PR	1990	NA	28961	24384	4577	15.8
CN7201500000000	72	015	Arroyo Municipio, PR	1990	NA	4918	3857	1061	21.6
CN7201700000000	72	017	Barceloneta Municipio, PR	1990	NA	6124	4977	1147	18.7
CN7201900000000	72	019	Barranquitas Municipio, PR	1990	NA	6151	5392	759	12.3
CN7202100000000	72	021	Bayamon Municipio, PR	1990	NA	78069	70569	7500	9.6
CN7202300000000	72	023	Cabo Rojo Municipio, PR	1990	NA	13090	10758	2332	17.8
CN7202500000000	72	025	Caguas Municipio, PR	1990	NA	49786	42806	6980	14
CN7202700000000	72	027	Camuy Municipio, PR	1990	NA	8976	7549	1427	15.9
CN7202900000000	72	029	Canovanas Municipio, PR	1990	NA	11870	10034	1836	15.5
CN7203100000000	72	031	Carolina Municipio, PR	1990	NA	69275	63525	5750	8.3
CN7203300000000	72	033	Catano Municipio, PR	1990	NA	10004	8967	1037	10.4
CN7203500000000	72	035	Cayey Municipio, PR	1990	NA	14341	11789	2552	17.8
CN7203700000000	72	037	Ceiba Municipio, PR	1990	NA	5126	4274	852	16.6
CN7203900000000	72	039	Ciales Municipio, PR	1990	NA	4694	3839	855	18.2
CN7204100000000	72	041	Cidra Municipio, PR	1990	NA	10888	9238	1650	15.2
CN7204300000000	72	043	Coamo Municipio, PR	1990	NA	9033	7427	1606	17.8
CN7204500000000	72	045	Comerio Municipio, PR	1990	NA	5585	4415	1170	20.9
CN7204700000000	72	047	Corozal Municipio, PR	1990	NA	8634	7539	1095	12.7
CN7204900000000	72	049	Culebra Municipio, PR	1990	NA	727	683	44	6.1
CN7205100000000	72	051	Dorado Municipio, PR	1990	NA	9483	8349	1134	12
CN7205300000000	72	053	Fajardo Municipio, PR	1990	NA	12327	10181	2146	17.4
CN7205400000000	72	054	Florida Municipio, PR	1990	NA	2583	2039	544	21.1
CN7205500000000	72	055	Guanica Municipio, PR	1990	NA	4497	3487	1010	22.5
CN7205700000000	72	057	Guayama Municipio, PR	1990	NA	10609	8280	2329	22
CN7205900000000	72	059	Guayanilla Municipio, PR	1990	NA	6148	4798	1350	22
CN7206100000000	72	061	Guaynabo Municipio, PR	1990	NA	34663	32604	2059	5.9
CN7206300000000	72	063	Gurabo Municipio, PR	1990	NA	9304	7844	1460	15.7
CN7206500000000	72	065	Hatillo Municipio, PR	1990	NA	9828	8193	1635	16.6
CN7206700000000	72	067	Hormigueros Municipio, PR	1990	NA	5990	5093	897	15
CN7206900000000	72	069	Humacao Municipio, PR	1990	NA	18137	14993	3144	17.3
CN7207100000000	72	071	Isabela Municipio, PR	1990	NA	12165	10192	1973	16.2
CN7207300000000	72	073	Jayuya Municipio, PR	1990	NA	3345	2930	415	12.4
CN7207500000000	72	075	Juana Diaz Municipio, PR	1990	NA	12136	9641	2495	20.6
CN7207700000000	72	077	Juncos Municipio, PR	1990	NA	8928	7454	1474	16.5
CN7207900000000	72	079	Lajas Municipio, PR	1990	NA	7333	5922	1411	19.2
CN7208100000000	72	081	Lares Municipio, PR	1990	NA	7037	5749	1288	18.3
CN7208300000000	72	083	Las Marias Municipio, PR	1990	NA	3257	2733	524	16.1
CN7208500000000	72	085	Las Piedras Municipio, PR	1990	NA	8759	7306	1453	16.6
CN7208700000000	72	087	Loiza Municipio, PR	1990	NA	8117	7096	1021	12.6
CN7208900000000	72	089	Luquillo Municipio, PR	1990	NA	6028	4810	1218	20.2
CN7209100000000	72	091	Manati Municipio, PR	1990	NA	12058	9923	2135	17.7
CN7209300000000	72	093	Maricao Municipio, PR	1990	NA	1960	1673	287	14.6
CN7209500000000	72	095	Maunabo Municipio, PR	1990	NA	2646	2080	566	21.4
CN7209700000000	72	097	Mayaguez Municipio, PR	1990	NA	33887	28291	5596	16.5
CN7209900000000	72	099	Moca Municipio, PR	1990	NA	10949	8491	2458	22.4
CN7210100000000	72	101	Morovis Municipio, PR	1990	NA	7203	5987	1216	16.9
CN7210300000000	72	103	Naguabo Municipio, PR	1990	NA	6287	5062	1225	19.5
CN7210500000000	72	105	Naranjito Municipio, PR	1990	NA	6629	5562	1067	16.1
CN7210700000000	72	107	Orocovis Municipio, PR	1990	NA	5168	4285	883	17.1
CN7210900000000	72	109	Patillas Municipio, PR	1990	NA	5337	4028	1309	24.5
CN7211100000000	72	111	Penuelas Municipio, PR	1990	NA	6362	4957	1405	22.1
CN7211300000000	72	113	Ponce Municipio, PR	1990	NA	56338	47054	9284	16.5
CN7211500000000	72	115	Quebradillas Municipio, PR	1990	NA	6692	5541	1151	17.2
CN7211700000000	72	117	Rincon Municipio, PR	1990	NA	4945	4051	894	18.1
CN7211900000000	72	119	Rio Grande Municipio, PR	1990	NA	15011	12724	2287	15.2
CN7212100000000	72	121	Sabana Grande Municipio, PR	1990	NA	7684	6341	1343	17.5
CN7212300000000	72	123	Salinas Municipio, PR	1990	NA	8071	5777	2294	28.4
CN7212500000000	72	125	San German Municipio, PR	1990	NA	12042	9751	2291	19
CN7212700000000	72	127	San Juan Municipio, PR	1990	NA	152473	139713	12760	8.4
CN7212900000000	72	129	San Lorenzo Municipio, PR	1990	NA	10628	8744	1884	17.7
CN7213100000000	72	131	San Sebastian Municipio, PR	1990	NA	12128	8993	3135	25.8
CN7213300000000	72	133	Santa Isabel Municipio, PR	1990	NA	4852	3429	1423	29.3
CN7213500000000	72	135	Toa Alta Municipio, PR	1990	NA	14419	12894	1525	10.6
CN7213700000000	72	137	Toa Baja Municipio, PR	1990	NA	31211	28713	2498	8
CN7213900000000	72	139	Trujillo Alto Municipio, PR	1990	NA	22306	20762	1544	6.9
CN7214100000000	72	141	Utuado Municipio, PR	1990	NA	8043	6732	1311	16.3
CN7214300000000	72	143	Vega Alta Municipio, PR	1990	NA	10334	8992	1342	13
CN7214500000000	72	145	Vega Baja Municipio, PR	1990	NA	16876	14176	2700	16
CN7214700000000	72	147	Vieques Municipio, PR	1990	NA	2477	2163	314	12.7
CN7214900000000	72	149	Villalba Municipio, PR	1990	NA	5870	4518	1352	23
CN7215100000000	72	151	Yabucoa Municipio, PR	1990	NA	10532	8218	2314	22
CN7215300000000	72	153	Yauco Municipio, PR	1990	NA	12633	10004	2629	20.8
NA	NA	NA	NA	NA	NA	NA	NA	NA	NA
SOURCE:  BLS, LAUS	NA	NA	NA	NA	NA	NA	NA	NA	NA
March 18, 2016	NA	NA	NA	NA	NA	NA	NA	NA	NA
