LAUS_CODE	STATE_FIPS	COUNTY_FIPS	COUNTY	YEAR	ESTIMATED	LABOR_FORCE	EMPLOYED	UNEMPLOYED_LEVEL	UNEMPLOYED_RATE
CN0100100000000	01	001	Autauga County, AL	2016	NA	26031	24709	1322	5.1
CN0100300000000	01	003	Baldwin County, AL	2016	NA	90895	86060	4835	5.3
CN0100500000000	01	005	Barbour County, AL	2016	NA	8436	7736	700	8.3
CN0100700000000	01	007	Bibb County, AL	2016	NA	8644	8088	556	6.4
CN0100900000000	01	009	Blount County, AL	2016	NA	24684	23358	1326	5.4
CN0101100000000	01	011	Bullock County, AL	2016	NA	4844	4514	330	6.8
CN0101300000000	01	013	Butler County, AL	2016	NA	9229	8593	636	6.9
CN0101500000000	01	015	Calhoun County, AL	2016	NA	46013	43016	2997	6.5
CN0101700000000	01	017	Chambers County, AL	2016	NA	15043	14225	818	5.4
CN0101900000000	01	019	Cherokee County, AL	2016	NA	11382	10808	574	5
CN0102100000000	01	021	Chilton County, AL	2016	NA	19266	18213	1053	5.5
CN0102300000000	01	023	Choctaw County, AL	2016	NA	4344	3976	368	8.5
CN0102500000000	01	025	Clarke County, AL	2016	NA	7985	7121	864	10.8
CN0102700000000	01	027	Clay County, AL	2016	NA	5648	5314	334	5.9
CN0102900000000	01	029	Cleburne County, AL	2016	NA	5810	5464	346	6
CN0103100000000	01	031	Coffee County, AL	2016	NA	20684	19474	1210	5.8
CN0103300000000	01	033	Colbert County, AL	2016	NA	23548	21918	1630	6.9
CN0103500000000	01	035	Conecuh County, AL	2016	NA	4567	4184	383	8.4
CN0103700000000	01	037	Coosa County, AL	2016	NA	4399	4137	262	6
CN0103900000000	01	039	Covington County, AL	2016	NA	15556	14509	1047	6.7
CN0104100000000	01	041	Crenshaw County, AL	2016	NA	6480	6101	379	5.8
CN0104300000000	01	043	Cullman County, AL	2016	NA	38064	36179	1885	5
CN0104500000000	01	045	Dale County, AL	2016	NA	20043	18888	1155	5.8
CN0104700000000	01	047	Dallas County, AL	2016	NA	15480	14059	1421	9.2
CN0104900000000	01	049	DeKalb County, AL	2016	NA	29355	27582	1773	6
CN0105100000000	01	051	Elmore County, AL	2016	NA	37384	35613	1771	4.7
CN0105300000000	01	053	Escambia County, AL	2016	NA	14613	13646	967	6.6
CN0105500000000	01	055	Etowah County, AL	2016	NA	43451	40892	2559	5.9
CN0105700000000	01	057	Fayette County, AL	2016	NA	6623	6178	445	6.7
CN0105900000000	01	059	Franklin County, AL	2016	NA	13924	13108	816	5.9
CN0106100000000	01	061	Geneva County, AL	2016	NA	10853	10226	627	5.8
CN0106300000000	01	063	Greene County, AL	2016	NA	2884	2598	286	9.9
CN0106500000000	01	065	Hale County, AL	2016	NA	6006	5548	458	7.6
CN0106700000000	01	067	Henry County, AL	2016	NA	6749	6311	438	6.5
CN0106900000000	01	069	Houston County, AL	2016	NA	44735	42156	2579	5.8
CN0107100000000	01	071	Jackson County, AL	2016	NA	23681	22193	1488	6.3
CN0107300000000	01	073	Jefferson County, AL	2016	NA	312478	294630	17848	5.7
CN0107500000000	01	075	Lamar County, AL	2016	NA	5713	5392	321	5.6
CN0107700000000	01	077	Lauderdale County, AL	2016	NA	42703	39998	2705	6.3
CN0107900000000	01	079	Lawrence County, AL	2016	NA	13775	12828	947	6.9
CN0108100000000	01	081	Lee County, AL	2016	NA	72653	68867	3786	5.2
CN0108300000000	01	083	Limestone County, AL	2016	NA	40853	38720	2133	5.2
CN0108500000000	01	085	Lowndes County, AL	2016	NA	3815	3414	401	10.5
CN0108700000000	01	087	Macon County, AL	2016	NA	7900	7301	599	7.6
CN0108900000000	01	089	Madison County, AL	2016	NA	174275	165388	8887	5.1
CN0109100000000	01	091	Marengo County, AL	2016	NA	7703	7155	548	7.1
CN0109300000000	01	093	Marion County, AL	2016	NA	12547	11720	827	6.6
CN0109500000000	01	095	Marshall County, AL	2016	NA	41754	39535	2219	5.3
CN0109700000000	01	097	Mobile County, AL	2016	NA	188542	176094	12448	6.6
CN0109900000000	01	099	Monroe County, AL	2016	NA	7344	6681	663	9
CN0110100000000	01	101	Montgomery County, AL	2016	NA	106190	100202	5988	5.6
CN0110300000000	01	103	Morgan County, AL	2016	NA	55092	52056	3036	5.5
CN0110500000000	01	105	Perry County, AL	2016	NA	3481	3123	358	10.3
CN0110700000000	01	107	Pickens County, AL	2016	NA	7798	7265	533	6.8
CN0110900000000	01	109	Pike County, AL	2016	NA	15009	14038	971	6.5
CN0111100000000	01	111	Randolph County, AL	2016	NA	9467	8941	526	5.6
CN0111300000000	01	113	Russell County, AL	2016	NA	23627	22322	1305	5.5
CN0111500000000	01	115	St. Clair County, AL	2016	NA	39241	37217	2024	5.2
CN0111700000000	01	117	Shelby County, AL	2016	NA	110035	105324	4711	4.3
CN0111900000000	01	119	Sumter County, AL	2016	NA	5131	4738	393	7.7
CN0112100000000	01	121	Talladega County, AL	2016	NA	34955	32660	2295	6.6
CN0112300000000	01	123	Tallapoosa County, AL	2016	NA	18656	17620	1036	5.6
CN0112500000000	01	125	Tuscaloosa County, AL	2016	NA	99659	94059	5600	5.6
CN0112700000000	01	127	Walker County, AL	2016	NA	25669	23767	1902	7.4
CN0112900000000	01	129	Washington County, AL	2016	NA	6769	6188	581	8.6
CN0113100000000	01	131	Wilcox County, AL	2016	NA	2828	2422	406	14.4
CN0113300000000	01	133	Winston County, AL	2016	NA	9571	8895	676	7.1
CN0201300000000	02	013	Aleutians East Borough, AK	2016	NA	2583	2514	69	2.7
CN0201600000000	02	016	Aleutians West Census Area, AK	2016	NA	3974	3842	132	3.3
CN0202000000000	02	020	Anchorage Borough/municipality, AK	2016	NA	155274	146720	8554	5.5
CN0205000000000	02	050	Bethel Census Area, AK	2016	NA	7237	6207	1030	14.2
CN0206000000000	02	060	Bristol Bay Borough, AK	2016	NA	413	384	29	7
CN0206800000000	02	068	Denali Borough, AK	2016	NA	1093	994	99	9.1
CN0207000000000	02	070	Dillingham Census Area, AK	2016	NA	2075	1875	200	9.6
CN0209000000000	02	090	Fairbanks North Star Borough, AK	2016	NA	46394	43667	2727	5.9
CN0210000000000	02	100	Haines Borough, AK	2016	NA	1073	963	110	10.3
CN0210500000000	02	105	Hoonah-Angoon Census Area, AK	2016	NA	1202	1060	142	11.8
CN0211000000000	02	110	Juneau Borough/city, AK	2016	NA	17316	16540	776	4.5
CN0212200000000	02	122	Kenai Peninsula Borough, AK	2016	NA	27127	24818	2309	8.5
CN0213000000000	02	130	Ketchikan Gateway Borough, AK	2016	NA	7015	6558	457	6.5
CN0215000000000	02	150	Kodiak Island Borough, AK	2016	NA	6409	6079	330	5.1
CN0215800000000	02	158	Kusilvak Census Area, AK	2016	NA	2721	2133	588	21.6
CN0216400000000	02	164	Lake and Peninsula Borough, AK	2016	NA	655	573	82	12.5
CN0217000000000	02	170	Matanuska-Susitna Borough, AK	2016	NA	47351	43455	3896	8.2
CN0218000000000	02	180	Nome Census Area, AK	2016	NA	4079	3561	518	12.7
CN0218500000000	02	185	North Slope Borough, AK	2016	NA	3948	3681	267	6.8
CN0218800000000	02	188	Northwest Arctic Borough, AK	2016	NA	2960	2487	473	16
CN0219500000000	02	195	Petersburg Borough, AK	2016	NA	1449	1318	131	9
CN0219800000000	02	198	Prince of Wales-Hyder Census Area, AK	2016	NA	2765	2428	337	12.2
CN0222000000000	02	220	Sitka Borough/city, AK	2016	NA	4366	4164	202	4.6
CN0223000000000	02	230	Skagway Municipality, AK	2016	NA	805	715	90	11.2
CN0224000000000	02	240	Southeast Fairbanks Census Area, AK	2016	NA	2993	2671	322	10.8
CN0226100000000	02	261	Valdez-Cordova Census Area, AK	2016	NA	4804	4391	413	8.6
CN0227500000000	02	275	Wrangell Borough/city, AK	2016	NA	1053	974	79	7.5
CN0228200000000	02	282	Yakutat Borough/city, AK	2016	NA	243	223	20	8.2
CN0229000000000	02	290	Yukon-Koyukuk Census Area, AK	2016	NA	2419	1987	432	17.9
CN0400100000000	04	001	Apache County, AZ	2016	NA	20284	17966	2318	11.4
CN0400300000000	04	003	Cochise County, AZ	2016	NA	49528	46452	3076	6.2
CN0400500000000	04	005	Coconino County, AZ	2016	NA	74081	69639	4442	6
CN0400700000000	04	007	Gila County, AZ	2016	NA	20965	19455	1510	7.2
CN0400900000000	04	009	Graham County, AZ	2016	NA	14352	13389	963	6.7
CN0401100000000	04	011	Greenlee County, AZ	2016	NA	3894	3600	294	7.6
CN0401200000000	04	012	La Paz County, AZ	2016	NA	8459	7949	510	6
CN0401300000000	04	013	Maricopa County, AZ	2016	NA	2077868	1983062	94806	4.6
CN0401500000000	04	015	Mohave County, AZ	2016	NA	80396	75095	5301	6.6
CN0401700000000	04	017	Navajo County, AZ	2016	NA	41267	37871	3396	8.2
CN0401900000000	04	019	Pima County, AZ	2016	NA	469004	445827	23177	4.9
CN0402100000000	04	021	Pinal County, AZ	2016	NA	163726	154681	9045	5.5
CN0402300000000	04	023	Santa Cruz County, AZ	2016	NA	19161	17244	1917	10
CN0402500000000	04	025	Yavapai County, AZ	2016	NA	99398	94517	4881	4.9
CN0402700000000	04	027	Yuma County, AZ	2016	NA	93912	76271	17641	18.8
CN0500100000000	05	001	Arkansas County, AR	2016	NA	9255	8940	315	3.4
CN0500300000000	05	003	Ashley County, AR	2016	NA	7940	7454	486	6.1
CN0500500000000	05	005	Baxter County, AR	2016	NA	16077	15387	690	4.3
CN0500700000000	05	007	Benton County, AR	2016	NA	127720	124007	3713	2.9
CN0500900000000	05	009	Boone County, AR	2016	NA	15904	15321	583	3.7
CN0501100000000	05	011	Bradley County, AR	2016	NA	4477	4252	225	5
CN0501300000000	05	013	Calhoun County, AR	2016	NA	2389	2279	110	4.6
CN0501500000000	05	015	Carroll County, AR	2016	NA	12850	12393	457	3.6
CN0501700000000	05	017	Chicot County, AR	2016	NA	3577	3342	235	6.6
CN0501900000000	05	019	Clark County, AR	2016	NA	9557	9144	413	4.3
CN0502100000000	05	021	Clay County, AR	2016	NA	6028	5688	340	5.6
CN0502300000000	05	023	Cleburne County, AR	2016	NA	9469	8907	562	5.9
CN0502500000000	05	025	Cleveland County, AR	2016	NA	3338	3188	150	4.5
CN0502700000000	05	027	Columbia County, AR	2016	NA	9281	8753	528	5.7
CN0502900000000	05	029	Conway County, AR	2016	NA	8439	7958	481	5.7
CN0503100000000	05	031	Craighead County, AR	2016	NA	52147	50456	1691	3.2
CN0503300000000	05	033	Crawford County, AR	2016	NA	26907	25860	1047	3.9
CN0503500000000	05	035	Crittenden County, AR	2016	NA	21573	20600	973	4.5
CN0503700000000	05	037	Cross County, AR	2016	NA	7871	7523	348	4.4
CN0503900000000	05	039	Dallas County, AR	2016	NA	2977	2833	144	4.8
CN0504100000000	05	041	Desha County, AR	2016	NA	5437	5141	296	5.4
CN0504300000000	05	043	Drew County, AR	2016	NA	7977	7525	452	5.7
CN0504500000000	05	045	Faulkner County, AR	2016	NA	60456	58164	2292	3.8
CN0504700000000	05	047	Franklin County, AR	2016	NA	7353	7057	296	4
CN0504900000000	05	049	Fulton County, AR	2016	NA	4660	4458	202	4.3
CN0505100000000	05	051	Garland County, AR	2016	NA	40021	38301	1720	4.3
CN0505300000000	05	053	Grant County, AR	2016	NA	8261	7964	297	3.6
CN0505500000000	05	055	Greene County, AR	2016	NA	19774	18927	847	4.3
CN0505700000000	05	057	Hempstead County, AR	2016	NA	9988	9613	375	3.8
CN0505900000000	05	059	Hot Spring County, AR	2016	NA	14092	13539	553	3.9
CN0506100000000	05	061	Howard County, AR	2016	NA	5970	5775	195	3.3
CN0506300000000	05	063	Independence County, AR	2016	NA	15986	15195	791	4.9
CN0506500000000	05	065	Izard County, AR	2016	NA	4959	4681	278	5.6
CN0506700000000	05	067	Jackson County, AR	2016	NA	6048	5671	377	6.2
CN0506900000000	05	069	Jefferson County, AR	2016	NA	28278	26695	1583	5.6
CN0507100000000	05	071	Johnson County, AR	2016	NA	10516	10018	498	4.7
CN0507300000000	05	073	Lafayette County, AR	2016	NA	2578	2428	150	5.8
CN0507500000000	05	075	Lawrence County, AR	2016	NA	6906	6607	299	4.3
CN0507700000000	05	077	Lee County, AR	2016	NA	3087	2942	145	4.7
CN0507900000000	05	079	Lincoln County, AR	2016	NA	4088	3891	197	4.8
CN0508100000000	05	081	Little River County, AR	2016	NA	5584	5323	261	4.7
CN0508300000000	05	083	Logan County, AR	2016	NA	9114	8696	418	4.6
CN0508500000000	05	085	Lonoke County, AR	2016	NA	33335	32226	1109	3.3
CN0508700000000	05	087	Madison County, AR	2016	NA	7274	7041	233	3.2
CN0508900000000	05	089	Marion County, AR	2016	NA	6511	6251	260	4
CN0509100000000	05	091	Miller County, AR	2016	NA	19837	19007	830	4.2
CN0509300000000	05	093	Mississippi County, AR	2016	NA	18039	16817	1222	6.8
CN0509500000000	05	095	Monroe County, AR	2016	NA	2876	2738	138	4.8
CN0509700000000	05	097	Montgomery County, AR	2016	NA	3123	2963	160	5.1
CN0509900000000	05	099	Nevada County, AR	2016	NA	3638	3504	134	3.7
CN0510100000000	05	101	Newton County, AR	2016	NA	3407	3274	133	3.9
CN0510300000000	05	103	Ouachita County, AR	2016	NA	9864	9369	495	5
CN0510500000000	05	105	Perry County, AR	2016	NA	4161	3962	199	4.8
CN0510700000000	05	107	Phillips County, AR	2016	NA	6645	6254	391	5.9
CN0510900000000	05	109	Pike County, AR	2016	NA	4214	4035	179	4.2
CN0511100000000	05	111	Poinsett County, AR	2016	NA	10075	9645	430	4.3
CN0511300000000	05	113	Polk County, AR	2016	NA	8168	7770	398	4.9
CN0511500000000	05	115	Pope County, AR	2016	NA	29234	27893	1341	4.6
CN0511700000000	05	117	Prairie County, AR	2016	NA	3644	3505	139	3.8
CN0511900000000	05	119	Pulaski County, AR	2016	NA	186810	180191	6619	3.5
CN0512100000000	05	121	Randolph County, AR	2016	NA	6513	6213	300	4.6
CN0512300000000	05	123	St. Francis County, AR	2016	NA	8826	8368	458	5.2
CN0512500000000	05	125	Saline County, AR	2016	NA	56768	54998	1770	3.1
CN0512700000000	05	127	Scott County, AR	2016	NA	4456	4292	164	3.7
CN0512900000000	05	129	Searcy County, AR	2016	NA	2984	2848	136	4.6
CN0513100000000	05	131	Sebastian County, AR	2016	NA	57509	55370	2139	3.7
CN0513300000000	05	133	Sevier County, AR	2016	NA	5685	5410	275	4.8
CN0513500000000	05	135	Sharp County, AR	2016	NA	6041	5713	328	5.4
CN0513700000000	05	137	Stone County, AR	2016	NA	4733	4490	243	5.1
CN0513900000000	05	139	Union County, AR	2016	NA	16346	15455	891	5.5
CN0514100000000	05	141	Van Buren County, AR	2016	NA	6092	5674	418	6.9
CN0514300000000	05	143	Washington County, AR	2016	NA	118196	114945	3251	2.8
CN0514500000000	05	145	White County, AR	2016	NA	33984	32217	1767	5.2
CN0514700000000	05	147	Woodruff County, AR	2016	NA	2964	2802	162	5.5
CN0514900000000	05	149	Yell County, AR	2016	NA	8672	8285	387	4.5
CN0600100000000	06	001	Alameda County, CA	2016	NA	831718	796037	35681	4.3
CN0600300000000	06	003	Alpine County, CA	2016	NA	553	518	35	6.3
CN0600500000000	06	005	Amador County, CA	2016	NA	14522	13658	864	5.9
CN0600700000000	06	007	Butte County, CA	2016	NA	101627	94909	6718	6.6
CN0600900000000	06	009	Calaveras County, CA	2016	NA	20794	19615	1179	5.7
CN0601100000000	06	011	Colusa County, CA	2016	NA	10901	9205	1696	15.6
CN0601300000000	06	013	Contra Costa County, CA	2016	NA	553145	528400	24745	4.5
CN0601500000000	06	015	Del Norte County, CA	2016	NA	9753	9019	734	7.5
CN0601700000000	06	017	El Dorado County, CA	2016	NA	88810	84248	4562	5.1
CN0601900000000	06	019	Fresno County, CA	2016	NA	444599	402365	42234	9.5
CN0602100000000	06	021	Glenn County, CA	2016	NA	12945	11867	1078	8.3
CN0602300000000	06	023	Humboldt County, CA	2016	NA	62413	59337	3076	4.9
CN0602500000000	06	025	Imperial County, CA	2016	NA	75141	56997	18144	24.1
CN0602700000000	06	027	Inyo County, CA	2016	NA	8857	8389	468	5.3
CN0602900000000	06	029	Kern County, CA	2016	NA	387978	347694	40284	10.4
CN0603100000000	06	031	Kings County, CA	2016	NA	57141	51446	5695	10
CN0603300000000	06	033	Lake County, CA	2016	NA	29061	27108	1953	6.7
CN0603500000000	06	035	Lassen County, CA	2016	NA	10360	9642	718	6.9
CN0603700000000	06	037	Los Angeles County, CA	2016	NA	5030508	4765899	264609	5.3
CN0603900000000	06	039	Madera County, CA	2016	NA	61032	55393	5639	9.2
CN0604100000000	06	041	Marin County, CA	2016	NA	139619	135040	4579	3.3
CN0604300000000	06	043	Mariposa County, CA	2016	NA	7567	7048	519	6.9
CN0604500000000	06	045	Mendocino County, CA	2016	NA	39609	37521	2088	5.3
CN0604700000000	06	047	Merced County, CA	2016	NA	114296	102212	12084	10.6
CN0604900000000	06	049	Modoc County, CA	2016	NA	3291	3034	257	7.8
CN0605100000000	06	051	Mono County, CA	2016	NA	8363	7915	448	5.4
CN0605300000000	06	053	Monterey County, CA	2016	NA	218730	201975	16755	7.7
CN0605500000000	06	055	Napa County, CA	2016	NA	72929	69799	3130	4.3
CN0605700000000	06	057	Nevada County, CA	2016	NA	48140	45838	2302	4.8
CN0605900000000	06	059	Orange County, CA	2016	NA	1597258	1532720	64538	4
CN0606100000000	06	061	Placer County, CA	2016	NA	179604	171549	8055	4.5
CN0606300000000	06	063	Plumas County, CA	2016	NA	7848	7085	763	9.7
CN0606500000000	06	065	Riverside County, CA	2016	NA	1051430	987183	64247	6.1
CN0606700000000	06	067	Sacramento County, CA	2016	NA	693868	656358	37510	5.4
CN0606900000000	06	069	San Benito County, CA	2016	NA	30426	28397	2029	6.7
CN0607100000000	06	071	San Bernardino County, CA	2016	NA	930088	876384	53704	5.8
CN0607300000000	06	073	San Diego County, CA	2016	NA	1562997	1489140	73857	4.7
CN0607500000000	06	075	San Francisco County/city, CA	2016	NA	555264	536972	18292	3.3
CN0607700000000	06	077	San Joaquin County, CA	2016	NA	318233	292367	25866	8.1
CN0607900000000	06	079	San Luis Obispo County, CA	2016	NA	139465	133437	6028	4.3
CN0608100000000	06	081	San Mateo County, CA	2016	NA	441754	428282	13472	3
CN0608300000000	06	083	Santa Barbara County, CA	2016	NA	215220	204328	10892	5.1
CN0608500000000	06	085	Santa Clara County, CA	2016	NA	1027805	989046	38759	3.8
CN0608700000000	06	087	Santa Cruz County, CA	2016	NA	143726	133730	9996	7
CN0608900000000	06	089	Shasta County, CA	2016	NA	74190	69019	5171	7
CN0609100000000	06	091	Sierra County, CA	2016	NA	1333	1232	101	7.6
CN0609300000000	06	093	Siskiyou County, CA	2016	NA	17890	16370	1520	8.5
CN0609500000000	06	095	Solano County, CA	2016	NA	207235	195834	11401	5.5
CN0609700000000	06	097	Sonoma County, CA	2016	NA	259183	248876	10307	4
CN0609900000000	06	099	Stanislaus County, CA	2016	NA	242669	221770	20899	8.6
CN0610100000000	06	101	Sutter County, CA	2016	NA	44968	40613	4355	9.7
CN0610300000000	06	103	Tehama County, CA	2016	NA	25066	23281	1785	7.1
CN0610500000000	06	105	Trinity County, CA	2016	NA	4991	4638	353	7.1
CN0610700000000	06	107	Tulare County, CA	2016	NA	203219	180502	22717	11.2
CN0610900000000	06	109	Tuolumne County, CA	2016	NA	21563	20221	1342	6.2
CN0611100000000	06	111	Ventura County, CA	2016	NA	425280	403083	22197	5.2
CN0611300000000	06	113	Yolo County, CA	2016	NA	106058	99812	6246	5.9
CN0611500000000	06	115	Yuba County, CA	2016	NA	28144	25722	2422	8.6
CN0800100000000	08	001	Adams County, CO	2016	NA	253398	244332	9066	3.6
CN0800300000000	08	003	Alamosa County, CO	2016	NA	7962	7640	322	4
CN0800500000000	08	005	Arapahoe County, CO	2016	NA	340304	329761	10543	3.1
CN0800700000000	08	007	Archuleta County, CO	2016	NA	6360	6151	209	3.3
CN0800900000000	08	009	Baca County, CO	2016	NA	2091	2055	36	1.7
CN0801100000000	08	011	Bent County, CO	2016	NA	1850	1793	57	3.1
CN0801300000000	08	013	Boulder County, CO	2016	NA	180697	175874	4823	2.7
CN0801400000000	08	014	Broomfield County/city, CO	2016	NA	36747	35684	1063	2.9
CN0801500000000	08	015	Chaffee County, CO	2016	NA	8834	8600	234	2.6
CN0801700000000	08	017	Cheyenne County, CO	2016	NA	1080	1056	24	2.2
CN0801900000000	08	019	Clear Creek County, CO	2016	NA	5681	5500	181	3.2
CN0802100000000	08	021	Conejos County, CO	2016	NA	3768	3585	183	4.9
CN0802300000000	08	023	Costilla County, CO	2016	NA	1727	1644	83	4.8
CN0802500000000	08	025	Crowley County, CO	2016	NA	1421	1371	50	3.5
CN0802700000000	08	027	Custer County, CO	2016	NA	2016	1953	63	3.1
CN0802900000000	08	029	Delta County, CO	2016	NA	13949	13263	686	4.9
CN0803100000000	08	031	Denver County/city, CO	2016	NA	384721	372773	11948	3.1
CN0803300000000	08	033	Dolores County, CO	2016	NA	1071	1029	42	3.9
CN0803500000000	08	035	Douglas County, CO	2016	NA	177371	172638	4733	2.7
CN0803700000000	08	037	Eagle County, CO	2016	NA	33696	32770	926	2.7
CN0803900000000	08	039	Elbert County, CO	2016	NA	13786	13428	358	2.6
CN0804100000000	08	041	El Paso County, CO	2016	NA	314454	302644	11810	3.8
CN0804300000000	08	043	Fremont County, CO	2016	NA	14697	13936	761	5.2
CN0804500000000	08	045	Garfield County, CO	2016	NA	30971	29888	1083	3.5
CN0804700000000	08	047	Gilpin County, CO	2016	NA	3481	3398	83	2.4
CN0804900000000	08	049	Grand County, CO	2016	NA	9181	8934	247	2.7
CN0805100000000	08	051	Gunnison County, CO	2016	NA	10127	9894	233	2.3
CN0805300000000	08	053	Hinsdale County, CO	2016	NA	447	436	11	2.5
CN0805500000000	08	055	Huerfano County, CO	2016	NA	2499	2341	158	6.3
CN0805700000000	08	057	Jackson County, CO	2016	NA	891	867	24	2.7
CN0805900000000	08	059	Jefferson County, CO	2016	NA	315094	305778	9316	3
CN0806100000000	08	061	Kiowa County, CO	2016	NA	846	829	17	2
CN0806300000000	08	063	Kit Carson County, CO	2016	NA	4534	4438	96	2.1
CN0806500000000	08	065	Lake County, CO	2016	NA	4613	4481	132	2.9
CN0806700000000	08	067	La Plata County, CO	2016	NA	30961	30072	889	2.9
CN0806900000000	08	069	Larimer County, CO	2016	NA	187205	181951	5254	2.8
CN0807100000000	08	071	Las Animas County, CO	2016	NA	6182	5870	312	5
CN0807300000000	08	073	Lincoln County, CO	2016	NA	2277	2219	58	2.5
CN0807500000000	08	075	Logan County, CO	2016	NA	11006	10682	324	2.9
CN0807700000000	08	077	Mesa County, CO	2016	NA	72056	68215	3841	5.3
CN0807900000000	08	079	Mineral County, CO	2016	NA	463	453	10	2.2
CN0808100000000	08	081	Moffat County, CO	2016	NA	7177	6892	285	4
CN0808300000000	08	083	Montezuma County, CO	2016	NA	12717	12085	632	5
CN0808500000000	08	085	Montrose County, CO	2016	NA	20054	19224	830	4.1
CN0808700000000	08	087	Morgan County, CO	2016	NA	15027	14508	519	3.5
CN0808900000000	08	089	Otero County, CO	2016	NA	8109	7727	382	4.7
CN0809100000000	08	091	Ouray County, CO	2016	NA	2164	2083	81	3.7
CN0809300000000	08	093	Park County, CO	2016	NA	9826	9552	274	2.8
CN0809500000000	08	095	Phillips County, CO	2016	NA	2470	2421	49	2
CN0809700000000	08	097	Pitkin County, CO	2016	NA	10728	10365	363	3.4
CN0809900000000	08	099	Prowers County, CO	2016	NA	6000	5806	194	3.2
CN0810100000000	08	101	Pueblo County, CO	2016	NA	73046	69551	3495	4.8
CN0810300000000	08	103	Rio Blanco County, CO	2016	NA	2736	2597	139	5.1
CN0810500000000	08	105	Rio Grande County, CO	2016	NA	5153	4898	255	4.9
CN0810700000000	08	107	Routt County, CO	2016	NA	14894	14504	390	2.6
CN0810900000000	08	109	Saguache County, CO	2016	NA	3226	3068	158	4.9
CN0811100000000	08	111	San Juan County, CO	2016	NA	479	461	18	3.8
CN0811300000000	08	113	San Miguel County, CO	2016	NA	5181	5012	169	3.3
CN0811500000000	08	115	Sedgwick County, CO	2016	NA	1176	1149	27	2.3
CN0811700000000	08	117	Summit County, CO	2016	NA	21109	20672	437	2.1
CN0811900000000	08	119	Teller County, CO	2016	NA	11723	11288	435	3.7
CN0812100000000	08	121	Washington County, CO	2016	NA	2917	2854	63	2.2
CN0812300000000	08	123	Weld County, CO	2016	NA	149828	144709	5119	3.4
CN0812500000000	08	125	Yuma County, CO	2016	NA	5434	5318	116	2.1
CN0900100000000	09	001	Fairfield County, CT	2016	NA	480577	457145	23432	4.9
CN0900300000000	09	003	Hartford County, CT	2016	NA	474272	448868	25404	5.4
CN0900500000000	09	005	Litchfield County, CT	2016	NA	104743	99796	4947	4.7
CN0900700000000	09	007	Middlesex County, CT	2016	NA	92277	88179	4098	4.4
CN0900900000000	09	009	New Haven County, CT	2016	NA	455797	430672	25125	5.5
CN0901100000000	09	011	New London County, CT	2016	NA	136035	129057	6978	5.1
CN0901300000000	09	013	Tolland County, CT	2016	NA	85320	81489	3831	4.5
CN0901500000000	09	015	Windham County, CT	2016	NA	62764	59271	3493	5.6
CN1000100000000	10	001	Kent County, DE	2016	NA	77196	73404	3792	4.9
CN1000300000000	10	003	New Castle County, DE	2016	NA	293641	280645	12996	4.4
CN1000500000000	10	005	Sussex County, DE	2016	NA	101015	96477	4538	4.5
CN1100100000000	11	001	District of Columbia	2016	NA	395021	370897	24124	6.1
CN1200100000000	12	001	Alachua County, FL	2016	NA	132392	126746	5646	4.3
CN1200300000000	12	003	Baker County, FL	2016	NA	11397	10844	553	4.9
CN1200500000000	12	005	Bay County, FL	2016	NA	87761	83595	4166	4.7
CN1200700000000	12	007	Bradford County, FL	2016	NA	10841	10381	460	4.2
CN1200900000000	12	009	Brevard County, FL	2016	NA	262074	248726	13348	5.1
CN1201100000000	12	011	Broward County, FL	2016	NA	1002237	957296	44941	4.5
CN1201300000000	12	013	Calhoun County, FL	2016	NA	4976	4692	284	5.7
CN1201500000000	12	015	Charlotte County, FL	2016	NA	69161	65493	3668	5.3
CN1201700000000	12	017	Citrus County, FL	2016	NA	47749	44552	3197	6.7
CN1201900000000	12	019	Clay County, FL	2016	NA	100841	96324	4517	4.5
CN1202100000000	12	021	Collier County, FL	2016	NA	168898	161045	7853	4.6
CN1202300000000	12	023	Columbia County, FL	2016	NA	29705	28263	1442	4.9
CN1202700000000	12	027	DeSoto County, FL	2016	NA	13447	12741	706	5.3
CN1202900000000	12	029	Dixie County, FL	2016	NA	5640	5334	306	5.4
CN1203100000000	12	031	Duval County, FL	2016	NA	466779	443960	22819	4.9
CN1203300000000	12	033	Escambia County, FL	2016	NA	140696	133760	6936	4.9
CN1203500000000	12	035	Flagler County, FL	2016	NA	45257	42779	2478	5.5
CN1203700000000	12	037	Franklin County, FL	2016	NA	4728	4524	204	4.3
CN1203900000000	12	039	Gadsden County, FL	2016	NA	18172	17039	1133	6.2
CN1204100000000	12	041	Gilchrist County, FL	2016	NA	6665	6333	332	5
CN1204300000000	12	043	Glades County, FL	2016	NA	4708	4416	292	6.2
CN1204500000000	12	045	Gulf County, FL	2016	NA	5955	5679	276	4.6
CN1204700000000	12	047	Hamilton County, FL	2016	NA	4648	4386	262	5.6
CN1204900000000	12	049	Hardee County, FL	2016	NA	9237	8626	611	6.6
CN1205100000000	12	051	Hendry County, FL	2016	NA	15374	14071	1303	8.5
CN1205300000000	12	053	Hernando County, FL	2016	NA	67794	63712	4082	6
CN1205500000000	12	055	Highlands County, FL	2016	NA	35655	33334	2321	6.5
CN1205700000000	12	057	Hillsborough County, FL	2016	NA	705974	674848	31126	4.4
CN1205900000000	12	059	Holmes County, FL	2016	NA	6699	6339	360	5.4
CN1206100000000	12	061	Indian River County, FL	2016	NA	62067	58348	3719	6
CN1206300000000	12	063	Jackson County, FL	2016	NA	17307	16408	899	5.2
CN1206500000000	12	065	Jefferson County, FL	2016	NA	5376	5095	281	5.2
CN1206700000000	12	067	Lafayette County, FL	2016	NA	2962	2833	129	4.4
CN1206900000000	12	069	Lake County, FL	2016	NA	145832	138781	7051	4.8
CN1207100000000	12	071	Lee County, FL	2016	NA	328730	313612	15118	4.6
CN1207300000000	12	073	Leon County, FL	2016	NA	149944	143181	6763	4.5
CN1207500000000	12	075	Levy County, FL	2016	NA	16617	15762	855	5.1
CN1207700000000	12	077	Liberty County, FL	2016	NA	2632	2498	134	5.1
CN1207900000000	12	079	Madison County, FL	2016	NA	7312	6929	383	5.2
CN1208100000000	12	081	Manatee County, FL	2016	NA	170287	162567	7720	4.5
CN1208300000000	12	083	Marion County, FL	2016	NA	131780	124145	7635	5.8
CN1208500000000	12	085	Martin County, FL	2016	NA	70764	67350	3414	4.8
CN1208600000000	12	086	Miami-Dade County, FL	2016	NA	1313067	1244190	68877	5.2
CN1208700000000	12	087	Monroe County, FL	2016	NA	46367	44898	1469	3.2
CN1208900000000	12	089	Nassau County, FL	2016	NA	37706	36018	1688	4.5
CN1209100000000	12	091	Okaloosa County, FL	2016	NA	93070	89347	3723	4
CN1209300000000	12	093	Okeechobee County, FL	2016	NA	18113	17187	926	5.1
CN1209500000000	12	095	Orange County, FL	2016	NA	705308	674711	30597	4.3
CN1209700000000	12	097	Osceola County, FL	2016	NA	163954	155857	8097	4.9
CN1209900000000	12	099	Palm Beach County, FL	2016	NA	707957	674875	33082	4.7
CN1210100000000	12	101	Pasco County, FL	2016	NA	222107	210767	11340	5.1
CN1210300000000	12	103	Pinellas County, FL	2016	NA	477373	456719	20654	4.3
CN1210500000000	12	105	Polk County, FL	2016	NA	286350	270598	15752	5.5
CN1210700000000	12	107	Putnam County, FL	2016	NA	26926	25221	1705	6.3
CN1210900000000	12	109	St. Johns County, FL	2016	NA	118381	113922	4459	3.8
CN1211100000000	12	111	St. Lucie County, FL	2016	NA	134948	127177	7771	5.8
CN1211300000000	12	113	Santa Rosa County, FL	2016	NA	75987	72574	3413	4.5
CN1211500000000	12	115	Sarasota County, FL	2016	NA	180693	172515	8178	4.5
CN1211700000000	12	117	Seminole County, FL	2016	NA	241602	231320	10282	4.3
CN1211900000000	12	119	Sumter County, FL	2016	NA	29330	27239	2091	7.1
CN1212100000000	12	121	Suwannee County, FL	2016	NA	18151	17266	885	4.9
CN1212300000000	12	123	Taylor County, FL	2016	NA	8820	8346	474	5.4
CN1212500000000	12	125	Union County, FL	2016	NA	4787	4581	206	4.3
CN1212700000000	12	127	Volusia County, FL	2016	NA	245026	232679	12347	5
CN1212900000000	12	129	Wakulla County, FL	2016	NA	14271	13683	588	4.1
CN1213100000000	12	131	Walton County, FL	2016	NA	28889	27654	1235	4.3
CN1213300000000	12	133	Washington County, FL	2016	NA	9682	9187	495	5.1
CN1300100000000	13	001	Appling County, GA	2016	NA	9174	8589	585	6.4
CN1300300000000	13	003	Atkinson County, GA	2016	NA	3971	3763	208	5.2
CN1300500000000	13	005	Bacon County, GA	2016	NA	4973	4713	260	5.2
CN1300700000000	13	007	Baker County, GA	2016	NA	1180	1089	91	7.7
CN1300900000000	13	009	Baldwin County, GA	2016	NA	17606	16401	1205	6.8
CN1301100000000	13	011	Banks County, GA	2016	NA	8801	8374	427	4.9
CN1301300000000	13	013	Barrow County, GA	2016	NA	37638	35863	1775	4.7
CN1301500000000	13	015	Bartow County, GA	2016	NA	48113	45649	2464	5.1
CN1301700000000	13	017	Ben Hill County, GA	2016	NA	5538	5084	454	8.2
CN1301900000000	13	019	Berrien County, GA	2016	NA	7209	6767	442	6.1
CN1302100000000	13	021	Bibb County, GA	2016	NA	68537	64465	4072	5.9
CN1302300000000	13	023	Bleckley County, GA	2016	NA	4495	4139	356	7.9
CN1302500000000	13	025	Brantley County, GA	2016	NA	7085	6609	476	6.7
CN1302700000000	13	027	Brooks County, GA	2016	NA	6999	6632	367	5.2
CN1302900000000	13	029	Bryan County, GA	2016	NA	16901	16079	822	4.9
CN1303100000000	13	031	Bulloch County, GA	2016	NA	35907	33852	2055	5.7
CN1303300000000	13	033	Burke County, GA	2016	NA	9227	8516	711	7.7
CN1303500000000	13	035	Butts County, GA	2016	NA	10361	9778	583	5.6
CN1303700000000	13	037	Calhoun County, GA	2016	NA	2160	2038	122	5.6
CN1303900000000	13	039	Camden County, GA	2016	NA	20318	19149	1169	5.8
CN1304300000000	13	043	Candler County, GA	2016	NA	5063	4821	242	4.8
CN1304500000000	13	045	Carroll County, GA	2016	NA	53456	50247	3209	6
CN1304700000000	13	047	Catoosa County, GA	2016	NA	32121	30569	1552	4.8
CN1304900000000	13	049	Charlton County, GA	2016	NA	4733	4466	267	5.6
CN1305100000000	13	051	Chatham County, GA	2016	NA	135862	128743	7119	5.2
CN1305300000000	13	053	Chattahoochee County, GA	2016	NA	2055	1885	170	8.3
CN1305500000000	13	055	Chattooga County, GA	2016	NA	10419	9762	657	6.3
CN1305700000000	13	057	Cherokee County, GA	2016	NA	125693	120346	5347	4.3
CN1305900000000	13	059	Clarke County, GA	2016	NA	58666	55434	3232	5.5
CN1306100000000	13	061	Clay County, GA	2016	NA	882	790	92	10.4
CN1306300000000	13	063	Clayton County, GA	2016	NA	130556	121941	8615	6.6
CN1306500000000	13	065	Clinch County, GA	2016	NA	2765	2595	170	6.1
CN1306700000000	13	067	Cobb County, GA	2016	NA	409444	390646	18798	4.6
CN1306900000000	13	069	Coffee County, GA	2016	NA	18057	17008	1049	5.8
CN1307100000000	13	071	Colquitt County, GA	2016	NA	21065	19959	1106	5.3
CN1307300000000	13	073	Columbia County, GA	2016	NA	70932	67640	3292	4.6
CN1307500000000	13	075	Cook County, GA	2016	NA	7511	7105	406	5.4
CN1307700000000	13	077	Coweta County, GA	2016	NA	70287	66795	3492	5
CN1307900000000	13	079	Crawford County, GA	2016	NA	5668	5334	334	5.9
CN1308100000000	13	081	Crisp County, GA	2016	NA	9174	8621	553	6
CN1308300000000	13	083	Dade County, GA	2016	NA	8004	7600	404	5
CN1308500000000	13	085	Dawson County, GA	2016	NA	11313	10784	529	4.7
CN1308700000000	13	087	Decatur County, GA	2016	NA	11455	10694	761	6.6
CN1308900000000	13	089	DeKalb County, GA	2016	NA	382087	361505	20582	5.4
CN1309100000000	13	091	Dodge County, GA	2016	NA	7004	6495	509	7.3
CN1309300000000	13	093	Dooly County, GA	2016	NA	4942	4656	286	5.8
CN1309500000000	13	095	Dougherty County, GA	2016	NA	38098	35492	2606	6.8
CN1309700000000	13	097	Douglas County, GA	2016	NA	70108	66215	3893	5.6
CN1309900000000	13	099	Early County, GA	2016	NA	4393	4091	302	6.9
CN1310100000000	13	101	Echols County, GA	2016	NA	1879	1798	81	4.3
CN1310300000000	13	103	Effingham County, GA	2016	NA	28371	27002	1369	4.8
CN1310500000000	13	105	Elbert County, GA	2016	NA	7717	7217	500	6.5
CN1310700000000	13	107	Emanuel County, GA	2016	NA	8432	7780	652	7.7
CN1310900000000	13	109	Evans County, GA	2016	NA	4781	4546	235	4.9
CN1311100000000	13	111	Fannin County, GA	2016	NA	10811	10233	578	5.3
CN1311300000000	13	113	Fayette County, GA	2016	NA	55624	53005	2619	4.7
CN1311500000000	13	115	Floyd County, GA	2016	NA	43428	40822	2606	6
CN1311700000000	13	117	Forsyth County, GA	2016	NA	110823	106203	4620	4.2
CN1311900000000	13	119	Franklin County, GA	2016	NA	9772	9261	511	5.2
CN1312100000000	13	121	Fulton County, GA	2016	NA	530235	501729	28506	5.4
CN1312300000000	13	123	Gilmer County, GA	2016	NA	11815	11145	670	5.7
CN1312500000000	13	125	Glascock County, GA	2016	NA	1266	1190	76	6
CN1312700000000	13	127	Glynn County, GA	2016	NA	39114	37040	2074	5.3
CN1312900000000	13	129	Gordon County, GA	2016	NA	25259	23846	1413	5.6
CN1313100000000	13	131	Grady County, GA	2016	NA	10236	9680	556	5.4
CN1313300000000	13	133	Greene County, GA	2016	NA	6593	6195	398	6
CN1313500000000	13	135	Gwinnett County, GA	2016	NA	466965	444758	22207	4.8
CN1313700000000	13	137	Habersham County, GA	2016	NA	19271	18254	1017	5.3
CN1313900000000	13	139	Hall County, GA	2016	NA	96156	91834	4322	4.5
CN1314100000000	13	141	Hancock County, GA	2016	NA	2527	2315	212	8.4
CN1314300000000	13	143	Haralson County, GA	2016	NA	12138	11435	703	5.8
CN1314500000000	13	145	Harris County, GA	2016	NA	16042	15260	782	4.9
CN1314700000000	13	147	Hart County, GA	2016	NA	10994	10404	590	5.4
CN1314900000000	13	149	Heard County, GA	2016	NA	4987	4693	294	5.9
CN1315100000000	13	151	Henry County, GA	2016	NA	108731	102754	5977	5.5
CN1315300000000	13	153	Houston County, GA	2016	NA	67559	63950	3609	5.3
CN1315500000000	13	155	Irwin County, GA	2016	NA	3213	2962	251	7.8
CN1315700000000	13	157	Jackson County, GA	2016	NA	33234	31819	1415	4.3
CN1315900000000	13	159	Jasper County, GA	2016	NA	6571	6257	314	4.8
CN1316100000000	13	161	Jeff Davis County, GA	2016	NA	6217	5822	395	6.4
CN1316300000000	13	163	Jefferson County, GA	2016	NA	6586	6100	486	7.4
CN1316500000000	13	165	Jenkins County, GA	2016	NA	3157	2919	238	7.5
CN1316700000000	13	167	Johnson County, GA	2016	NA	3920	3681	239	6.1
CN1316900000000	13	169	Jones County, GA	2016	NA	13771	13110	661	4.8
CN1317100000000	13	171	Lamar County, GA	2016	NA	7886	7369	517	6.6
CN1317300000000	13	173	Lanier County, GA	2016	NA	3822	3601	221	5.8
CN1317500000000	13	175	Laurens County, GA	2016	NA	19032	17767	1265	6.6
CN1317700000000	13	177	Lee County, GA	2016	NA	14533	13852	681	4.7
CN1317900000000	13	179	Liberty County, GA	2016	NA	25004	23542	1462	5.8
CN1318100000000	13	181	Lincoln County, GA	2016	NA	3472	3268	204	5.9
CN1318300000000	13	183	Long County, GA	2016	NA	7412	7012	400	5.4
CN1318500000000	13	185	Lowndes County, GA	2016	NA	51227	48527	2700	5.3
CN1318700000000	13	187	Lumpkin County, GA	2016	NA	15945	15183	762	4.8
CN1318900000000	13	189	McDuffie County, GA	2016	NA	8786	8144	642	7.3
CN1319100000000	13	191	McIntosh County, GA	2016	NA	5994	5644	350	5.8
CN1319300000000	13	193	Macon County, GA	2016	NA	4671	4285	386	8.3
CN1319500000000	13	195	Madison County, GA	2016	NA	13062	12417	645	4.9
CN1319700000000	13	197	Marion County, GA	2016	NA	3374	3127	247	7.3
CN1319900000000	13	199	Meriwether County, GA	2016	NA	8743	8143	600	6.9
CN1320100000000	13	201	Miller County, GA	2016	NA	2748	2600	148	5.4
CN1320500000000	13	205	Mitchell County, GA	2016	NA	8555	7994	561	6.6
CN1320700000000	13	207	Monroe County, GA	2016	NA	12997	12326	671	5.2
CN1320900000000	13	209	Montgomery County, GA	2016	NA	3719	3442	277	7.4
CN1321100000000	13	211	Morgan County, GA	2016	NA	8685	8247	438	5
CN1321300000000	13	213	Murray County, GA	2016	NA	15618	14511	1107	7.1
CN1321500000000	13	215	Muscogee County, GA	2016	NA	78298	72985	5313	6.8
CN1321700000000	13	217	Newton County, GA	2016	NA	49918	46931	2987	6
CN1321900000000	13	219	Oconee County, GA	2016	NA	18445	17690	755	4.1
CN1322100000000	13	221	Oglethorpe County, GA	2016	NA	6908	6572	336	4.9
CN1322300000000	13	223	Paulding County, GA	2016	NA	79521	75847	3674	4.6
CN1322500000000	13	225	Peach County, GA	2016	NA	11420	10621	799	7
CN1322700000000	13	227	Pickens County, GA	2016	NA	14379	13680	699	4.9
CN1322900000000	13	229	Pierce County, GA	2016	NA	8542	8090	452	5.3
CN1323100000000	13	231	Pike County, GA	2016	NA	8389	7954	435	5.2
CN1323300000000	13	233	Polk County, GA	2016	NA	18042	16935	1107	6.1
CN1323500000000	13	235	Pulaski County, GA	2016	NA	4032	3796	236	5.9
CN1323700000000	13	237	Putnam County, GA	2016	NA	7939	7381	558	7
CN1323900000000	13	239	Quitman County, GA	2016	NA	813	754	59	7.3
CN1324100000000	13	241	Rabun County, GA	2016	NA	6687	6292	395	5.9
CN1324300000000	13	243	Randolph County, GA	2016	NA	2469	2261	208	8.4
CN1324500000000	13	245	Richmond County, GA	2016	NA	84693	78975	5718	6.8
CN1324700000000	13	247	Rockdale County, GA	2016	NA	43179	40679	2500	5.8
CN1324900000000	13	249	Schley County, GA	2016	NA	2113	1980	133	6.3
CN1325100000000	13	251	Screven County, GA	2016	NA	5229	4836	393	7.5
CN1325300000000	13	253	Seminole County, GA	2016	NA	3087	2844	243	7.9
CN1325500000000	13	255	Spalding County, GA	2016	NA	27746	25841	1905	6.9
CN1325700000000	13	257	Stephens County, GA	2016	NA	11015	10368	647	5.9
CN1325900000000	13	259	Stewart County, GA	2016	NA	2134	1998	136	6.4
CN1326100000000	13	261	Sumter County, GA	2016	NA	12824	11854	970	7.6
CN1326300000000	13	263	Talbot County, GA	2016	NA	2740	2557	183	6.7
CN1326500000000	13	265	Taliaferro County, GA	2016	NA	548	510	38	6.9
CN1326700000000	13	267	Tattnall County, GA	2016	NA	9316	8818	498	5.3
CN1326900000000	13	269	Taylor County, GA	2016	NA	3318	3070	248	7.5
CN1327100000000	13	271	Telfair County, GA	2016	NA	4805	4403	402	8.4
CN1327300000000	13	273	Terrell County, GA	2016	NA	3651	3414	237	6.5
CN1327500000000	13	275	Thomas County, GA	2016	NA	17504	16413	1091	6.2
CN1327700000000	13	277	Tift County, GA	2016	NA	18523	17527	996	5.4
CN1327900000000	13	279	Toombs County, GA	2016	NA	11767	10849	918	7.8
CN1328100000000	13	281	Towns County, GA	2016	NA	4102	3823	279	6.8
CN1328300000000	13	283	Treutlen County, GA	2016	NA	2737	2527	210	7.7
CN1328500000000	13	285	Troup County, GA	2016	NA	36778	34906	1872	5.1
CN1328700000000	13	287	Turner County, GA	2016	NA	3230	3021	209	6.5
CN1328900000000	13	289	Twiggs County, GA	2016	NA	2944	2688	256	8.7
CN1329100000000	13	291	Union County, GA	2016	NA	10433	9939	494	4.7
CN1329300000000	13	293	Upson County, GA	2016	NA	11124	10407	717	6.4
CN1329500000000	13	295	Walker County, GA	2016	NA	29888	28224	1664	5.6
CN1329700000000	13	297	Walton County, GA	2016	NA	43313	41186	2127	4.9
CN1329900000000	13	299	Ware County, GA	2016	NA	15457	14625	832	5.4
CN1330100000000	13	301	Warren County, GA	2016	NA	2695	2508	187	6.9
CN1330300000000	13	303	Washington County, GA	2016	NA	7172	6718	454	6.3
CN1330500000000	13	305	Wayne County, GA	2016	NA	11277	10505	772	6.8
CN1330700000000	13	307	Webster County, GA	2016	NA	965	882	83	8.6
CN1330900000000	13	309	Wheeler County, GA	2016	NA	1731	1575	156	9
CN1331100000000	13	311	White County, GA	2016	NA	14459	13789	670	4.6
CN1331300000000	13	313	Whitfield County, GA	2016	NA	44669	41939	2730	6.1
CN1331500000000	13	315	Wilcox County, GA	2016	NA	2716	2520	196	7.2
CN1331700000000	13	317	Wilkes County, GA	2016	NA	3701	3456	245	6.6
CN1331900000000	13	319	Wilkinson County, GA	2016	NA	3645	3414	231	6.3
CN1332100000000	13	321	Worth County, GA	2016	NA	9108	8577	531	5.8
CN1500100000000	15	001	Hawaii County, HI	2016	NA	93057	89703	3354	3.6
CN1500300000000	15	003	Honolulu County/city, HI	2016	NA	466140	453131	13009	2.8
CN1500700000000	15	007	Kauai County, HI	2016	NA	36810	35657	1153	3.1
CN1500900000000	15	009	Maui County, HI	2016	NA	87215	84564	2651	3
CN1600100000000	16	001	Ada County, ID	2016	NA	225548	218120	7428	3.3
CN1600300000000	16	003	Adams County, ID	2016	NA	1747	1626	121	6.9
CN1600500000000	16	005	Bannock County, ID	2016	NA	41147	39682	1465	3.6
CN1600700000000	16	007	Bear Lake County, ID	2016	NA	2816	2687	129	4.6
CN1600900000000	16	009	Benewah County, ID	2016	NA	4019	3781	238	5.9
CN1601100000000	16	011	Bingham County, ID	2016	NA	22830	22027	803	3.5
CN1601300000000	16	013	Blaine County, ID	2016	NA	11867	11493	374	3.2
CN1601500000000	16	015	Boise County, ID	2016	NA	3102	2938	164	5.3
CN1601700000000	16	017	Bonner County, ID	2016	NA	18921	17895	1026	5.4
CN1601900000000	16	019	Bonneville County, ID	2016	NA	52476	50808	1668	3.2
CN1602100000000	16	021	Boundary County, ID	2016	NA	5114	4846	268	5.2
CN1602300000000	16	023	Butte County, ID	2016	NA	1295	1242	53	4.1
CN1602500000000	16	025	Camas County, ID	2016	NA	659	635	24	3.6
CN1602700000000	16	027	Canyon County, ID	2016	NA	93783	89703	4080	4.4
CN1602900000000	16	029	Caribou County, ID	2016	NA	3801	3664	137	3.6
CN1603100000000	16	031	Cassia County, ID	2016	NA	11610	11265	345	3
CN1603300000000	16	033	Clark County, ID	2016	NA	394	381	13	3.3
CN1603500000000	16	035	Clearwater County, ID	2016	NA	3055	2832	223	7.3
CN1603700000000	16	037	Custer County, ID	2016	NA	2144	2035	109	5.1
CN1603900000000	16	039	Elmore County, ID	2016	NA	10973	10520	453	4.1
CN1604100000000	16	041	Franklin County, ID	2016	NA	6652	6448	204	3.1
CN1604300000000	16	043	Fremont County, ID	2016	NA	7382	7134	248	3.4
CN1604500000000	16	045	Gem County, ID	2016	NA	7743	7379	364	4.7
CN1604700000000	16	047	Gooding County, ID	2016	NA	8012	7766	246	3.1
CN1604900000000	16	049	Idaho County, ID	2016	NA	6352	5992	360	5.7
CN1605100000000	16	051	Jefferson County, ID	2016	NA	12848	12451	397	3.1
CN1605300000000	16	053	Jerome County, ID	2016	NA	11366	11008	358	3.1
CN1605500000000	16	055	Kootenai County, ID	2016	NA	73965	70512	3453	4.7
CN1605700000000	16	057	Latah County, ID	2016	NA	19930	19298	632	3.2
CN1605900000000	16	059	Lemhi County, ID	2016	NA	3414	3205	209	6.1
CN1606100000000	16	061	Lewis County, ID	2016	NA	1629	1525	104	6.4
CN1606300000000	16	063	Lincoln County, ID	2016	NA	2646	2528	118	4.5
CN1606500000000	16	065	Madison County, ID	2016	NA	20599	20101	498	2.4
CN1606700000000	16	067	Minidoka County, ID	2016	NA	10893	10545	348	3.2
CN1606900000000	16	069	Nez Perce County, ID	2016	NA	20902	20216	686	3.3
CN1607100000000	16	071	Oneida County, ID	2016	NA	2204	2125	79	3.6
CN1607300000000	16	073	Owyhee County, ID	2016	NA	5289	5047	242	4.6
CN1607500000000	16	075	Payette County, ID	2016	NA	11275	10752	523	4.6
CN1607700000000	16	077	Power County, ID	2016	NA	3937	3776	161	4.1
CN1607900000000	16	079	Shoshone County, ID	2016	NA	5126	4762	364	7.1
CN1608100000000	16	081	Teton County, ID	2016	NA	5992	5799	193	3.2
CN1608300000000	16	083	Twin Falls County, ID	2016	NA	39633	38284	1349	3.4
CN1608500000000	16	085	Valley County, ID	2016	NA	4973	4705	268	5.4
CN1608700000000	16	087	Washington County, ID	2016	NA	4608	4354	254	5.5
CN1700100000000	17	001	Adams County, IL	2016	NA	32483	30936	1547	4.8
CN1700300000000	17	003	Alexander County, IL	2016	NA	2205	1999	206	9.3
CN1700500000000	17	005	Bond County, IL	2016	NA	7878	7475	403	5.1
CN1700700000000	17	007	Boone County, IL	2016	NA	26325	24648	1677	6.4
CN1700900000000	17	009	Brown County, IL	2016	NA	2856	2760	96	3.4
CN1701100000000	17	011	Bureau County, IL	2016	NA	17374	16324	1050	6
CN1701300000000	17	013	Calhoun County, IL	2016	NA	2374	2227	147	6.2
CN1701500000000	17	015	Carroll County, IL	2016	NA	7865	7420	445	5.7
CN1701700000000	17	017	Cass County, IL	2016	NA	6213	5866	347	5.6
CN1701900000000	17	019	Champaign County, IL	2016	NA	107398	102018	5380	5
CN1702100000000	17	021	Christian County, IL	2016	NA	15291	14315	976	6.4
CN1702300000000	17	023	Clark County, IL	2016	NA	8162	7687	475	5.8
CN1702500000000	17	025	Clay County, IL	2016	NA	6705	6247	458	6.8
CN1702700000000	17	027	Clinton County, IL	2016	NA	20450	19537	913	4.5
CN1702900000000	17	029	Coles County, IL	2016	NA	24523	23075	1448	5.9
CN1703100000000	17	031	Cook County, IL	2016	NA	2660740	2500024	160716	6
CN1703300000000	17	033	Crawford County, IL	2016	NA	9026	8463	563	6.2
CN1703500000000	17	035	Cumberland County, IL	2016	NA	5981	5670	311	5.2
CN1703700000000	17	037	DeKalb County, IL	2016	NA	55182	52231	2951	5.3
CN1703900000000	17	039	De Witt County, IL	2016	NA	7941	7489	452	5.7
CN1704100000000	17	041	Douglas County, IL	2016	NA	10282	9797	485	4.7
CN1704300000000	17	043	DuPage County, IL	2016	NA	516207	491840	24367	4.7
CN1704500000000	17	045	Edgar County, IL	2016	NA	9706	9124	582	6
CN1704700000000	17	047	Edwards County, IL	2016	NA	2972	2799	173	5.8
CN1704900000000	17	049	Effingham County, IL	2016	NA	18687	17804	883	4.7
CN1705100000000	17	051	Fayette County, IL	2016	NA	9753	9110	643	6.6
CN1705300000000	17	053	Ford County, IL	2016	NA	6653	6292	361	5.4
CN1705500000000	17	055	Franklin County, IL	2016	NA	16692	15340	1352	8.1
CN1705700000000	17	057	Fulton County, IL	2016	NA	15803	14635	1168	7.4
CN1705900000000	17	059	Gallatin County, IL	2016	NA	2534	2342	192	7.6
CN1706100000000	17	061	Greene County, IL	2016	NA	6070	5716	354	5.8
CN1706300000000	17	063	Grundy County, IL	2016	NA	25722	23999	1723	6.7
CN1706500000000	17	065	Hamilton County, IL	2016	NA	4257	3990	267	6.3
CN1706700000000	17	067	Hancock County, IL	2016	NA	8829	8253	576	6.5
CN1706900000000	17	069	Hardin County, IL	2016	NA	1399	1263	136	9.7
CN1707100000000	17	071	Henderson County, IL	2016	NA	3717	3490	227	6.1
CN1707300000000	17	073	Henry County, IL	2016	NA	25215	23692	1523	6
CN1707500000000	17	075	Iroquois County, IL	2016	NA	14795	13980	815	5.5
CN1707700000000	17	077	Jackson County, IL	2016	NA	28679	27133	1546	5.4
CN1707900000000	17	079	Jasper County, IL	2016	NA	4647	4355	292	6.3
CN1708100000000	17	081	Jefferson County, IL	2016	NA	17568	16442	1126	6.4
CN1708300000000	17	083	Jersey County, IL	2016	NA	11055	10410	645	5.8
CN1708500000000	17	085	Jo Daviess County, IL	2016	NA	11376	10764	612	5.4
CN1708700000000	17	087	Johnson County, IL	2016	NA	4209	3842	367	8.7
CN1708900000000	17	089	Kane County, IL	2016	NA	270169	255214	14955	5.5
CN1709100000000	17	091	Kankakee County, IL	2016	NA	54706	51162	3544	6.5
CN1709300000000	17	093	Kendall County, IL	2016	NA	67876	64412	3464	5.1
CN1709500000000	17	095	Knox County, IL	2016	NA	22941	21528	1413	6.2
CN1709700000000	17	097	Lake County, IL	2016	NA	371791	352296	19495	5.2
CN1709900000000	17	099	LaSalle County, IL	2016	NA	57117	53251	3866	6.8
CN1710100000000	17	101	Lawrence County, IL	2016	NA	6176	5717	459	7.4
CN1710300000000	17	103	Lee County, IL	2016	NA	18021	17095	926	5.1
CN1710500000000	17	105	Livingston County, IL	2016	NA	17027	16105	922	5.4
CN1710700000000	17	107	Logan County, IL	2016	NA	13042	12346	696	5.3
CN1710900000000	17	109	McDonough County, IL	2016	NA	14027	13147	880	6.3
CN1711100000000	17	111	McHenry County, IL	2016	NA	167654	158888	8766	5.2
CN1711300000000	17	113	McLean County, IL	2016	NA	90527	85947	4580	5.1
CN1711500000000	17	115	Macon County, IL	2016	NA	50568	47229	3339	6.6
CN1711700000000	17	117	Macoupin County, IL	2016	NA	23358	21966	1392	6
CN1711900000000	17	119	Madison County, IL	2016	NA	135113	127149	7964	5.9
CN1712100000000	17	121	Marion County, IL	2016	NA	18026	16875	1151	6.4
CN1712300000000	17	123	Marshall County, IL	2016	NA	5631	5257	374	6.6
CN1712500000000	17	125	Mason County, IL	2016	NA	6439	5979	460	7.1
CN1712700000000	17	127	Massac County, IL	2016	NA	5992	5564	428	7.1
CN1712900000000	17	129	Menard County, IL	2016	NA	6747	6431	316	4.7
CN1713100000000	17	131	Mercer County, IL	2016	NA	8222	7711	511	6.2
CN1713300000000	17	133	Monroe County, IL	2016	NA	18486	17735	751	4.1
CN1713500000000	17	135	Montgomery County, IL	2016	NA	12110	11250	860	7.1
CN1713700000000	17	137	Morgan County, IL	2016	NA	16935	16098	837	4.9
CN1713900000000	17	139	Moultrie County, IL	2016	NA	7444	7103	341	4.6
CN1714100000000	17	141	Ogle County, IL	2016	NA	25791	24265	1526	5.9
CN1714300000000	17	143	Peoria County, IL	2016	NA	88039	81962	6077	6.9
CN1714500000000	17	145	Perry County, IL	2016	NA	8705	8086	619	7.1
CN1714700000000	17	147	Piatt County, IL	2016	NA	8691	8269	422	4.9
CN1714900000000	17	149	Pike County, IL	2016	NA	7508	7125	383	5.1
CN1715100000000	17	151	Pope County, IL	2016	NA	1761	1640	121	6.9
CN1715300000000	17	153	Pulaski County, IL	2016	NA	2194	2008	186	8.5
CN1715500000000	17	155	Putnam County, IL	2016	NA	3107	2933	174	5.6
CN1715700000000	17	157	Randolph County, IL	2016	NA	14548	13819	729	5
CN1715900000000	17	159	Richland County, IL	2016	NA	7540	7093	447	5.9
CN1716100000000	17	161	Rock Island County, IL	2016	NA	72081	67558	4523	6.3
CN1716300000000	17	163	St. Clair County, IL	2016	NA	127192	119462	7730	6.1
CN1716500000000	17	165	Saline County, IL	2016	NA	10050	9189	861	8.6
CN1716700000000	17	167	Sangamon County, IL	2016	NA	103862	98686	5176	5
CN1716900000000	17	169	Schuyler County, IL	2016	NA	3358	3169	189	5.6
CN1717100000000	17	171	Scott County, IL	2016	NA	2527	2384	143	5.7
CN1717300000000	17	173	Shelby County, IL	2016	NA	10396	9800	596	5.7
CN1717500000000	17	175	Stark County, IL	2016	NA	2759	2556	203	7.4
CN1717700000000	17	177	Stephenson County, IL	2016	NA	21407	20151	1256	5.9
CN1717900000000	17	179	Tazewell County, IL	2016	NA	65774	61543	4231	6.4
CN1718100000000	17	181	Union County, IL	2016	NA	7524	6966	558	7.4
CN1718300000000	17	183	Vermilion County, IL	2016	NA	34892	32361	2531	7.3
CN1718500000000	17	185	Wabash County, IL	2016	NA	5753	5392	361	6.3
CN1718700000000	17	187	Warren County, IL	2016	NA	8697	8238	459	5.3
CN1718900000000	17	189	Washington County, IL	2016	NA	9645	9282	363	3.8
CN1719100000000	17	191	Wayne County, IL	2016	NA	7302	6679	623	8.5
CN1719300000000	17	193	White County, IL	2016	NA	6889	6437	452	6.6
CN1719500000000	17	195	Whiteside County, IL	2016	NA	28728	27061	1667	5.8
CN1719700000000	17	197	Will County, IL	2016	NA	362361	340776	21585	6
CN1719900000000	17	199	Williamson County, IL	2016	NA	32325	30336	1989	6.2
CN1720100000000	17	201	Winnebago County, IL	2016	NA	141312	131886	9426	6.7
CN1720300000000	17	203	Woodford County, IL	2016	NA	19351	18289	1062	5.5
CN1800100000000	18	001	Adams County, IN	2016	NA	17037	16427	610	3.6
CN1800300000000	18	003	Allen County, IN	2016	NA	180853	173132	7721	4.3
CN1800500000000	18	005	Bartholomew County, IN	2016	NA	44444	42938	1506	3.4
CN1800700000000	18	007	Benton County, IN	2016	NA	4565	4372	193	4.2
CN1800900000000	18	009	Blackford County, IN	2016	NA	5336	5050	286	5.4
CN1801100000000	18	011	Boone County, IN	2016	NA	34853	33677	1176	3.4
CN1801300000000	18	013	Brown County, IN	2016	NA	7521	7219	302	4
CN1801500000000	18	015	Carroll County, IN	2016	NA	10108	9679	429	4.2
CN1801700000000	18	017	Cass County, IN	2016	NA	18047	17209	838	4.6
CN1801900000000	18	019	Clark County, IN	2016	NA	60529	58008	2521	4.2
CN1802100000000	18	021	Clay County, IN	2016	NA	12384	11806	578	4.7
CN1802300000000	18	023	Clinton County, IN	2016	NA	17150	16484	666	3.9
CN1802500000000	18	025	Crawford County, IN	2016	NA	4999	4717	282	5.6
CN1802700000000	18	027	Daviess County, IN	2016	NA	15972	15407	565	3.5
CN1802900000000	18	029	Dearborn County, IN	2016	NA	25596	24390	1206	4.7
CN1803100000000	18	031	Decatur County, IN	2016	NA	14553	14035	518	3.6
CN1803300000000	18	033	DeKalb County, IN	2016	NA	22232	21361	871	3.9
CN1803500000000	18	035	Delaware County, IN	2016	NA	55079	52254	2825	5.1
CN1803700000000	18	037	Dubois County, IN	2016	NA	23392	22664	728	3.1
CN1803900000000	18	039	Elkhart County, IN	2016	NA	108457	104678	3779	3.5
CN1804100000000	18	041	Fayette County, IN	2016	NA	9350	8812	538	5.8
CN1804300000000	18	043	Floyd County, IN	2016	NA	40981	39303	1678	4.1
CN1804500000000	18	045	Fountain County, IN	2016	NA	7970	7507	463	5.8
CN1804700000000	18	047	Franklin County, IN	2016	NA	11477	10979	498	4.3
CN1804900000000	18	049	Fulton County, IN	2016	NA	9887	9423	464	4.7
CN1805100000000	18	051	Gibson County, IN	2016	NA	19197	18501	696	3.6
CN1805300000000	18	053	Grant County, IN	2016	NA	32141	30556	1585	4.9
CN1805500000000	18	055	Greene County, IN	2016	NA	13741	12843	898	6.5
CN1805700000000	18	057	Hamilton County, IN	2016	NA	174473	168883	5590	3.2
CN1805900000000	18	059	Hancock County, IN	2016	NA	38682	37218	1464	3.8
CN1806100000000	18	061	Harrison County, IN	2016	NA	19955	19116	839	4.2
CN1806300000000	18	063	Hendricks County, IN	2016	NA	85776	82780	2996	3.5
CN1806500000000	18	065	Henry County, IN	2016	NA	22114	21093	1021	4.6
CN1806700000000	18	067	Howard County, IN	2016	NA	38078	36304	1774	4.7
CN1806900000000	18	069	Huntington County, IN	2016	NA	18687	17928	759	4.1
CN1807100000000	18	071	Jackson County, IN	2016	NA	22344	21527	817	3.7
CN1807300000000	18	073	Jasper County, IN	2016	NA	16570	15688	882	5.3
CN1807500000000	18	075	Jay County, IN	2016	NA	9945	9494	451	4.5
CN1807700000000	18	077	Jefferson County, IN	2016	NA	15285	14573	712	4.7
CN1807900000000	18	079	Jennings County, IN	2016	NA	13265	12635	630	4.7
CN1808100000000	18	081	Johnson County, IN	2016	NA	80246	77330	2916	3.6
CN1808300000000	18	083	Knox County, IN	2016	NA	19063	18230	833	4.4
CN1808500000000	18	085	Kosciusko County, IN	2016	NA	41495	39941	1554	3.7
CN1808700000000	18	087	LaGrange County, IN	2016	NA	19422	18752	670	3.4
CN1808900000000	18	089	Lake County, IN	2016	NA	232236	217542	14694	6.3
CN1809100000000	18	091	LaPorte County, IN	2016	NA	48647	45786	2861	5.9
CN1809300000000	18	093	Lawrence County, IN	2016	NA	20593	19423	1170	5.7
CN1809500000000	18	095	Madison County, IN	2016	NA	58964	55991	2973	5
CN1809700000000	18	097	Marion County, IN	2016	NA	481434	459887	21547	4.5
CN1809900000000	18	099	Marshall County, IN	2016	NA	24324	23412	912	3.7
CN1810100000000	18	101	Martin County, IN	2016	NA	5150	4939	211	4.1
CN1810300000000	18	103	Miami County, IN	2016	NA	16085	15326	759	4.7
CN1810500000000	18	105	Monroe County, IN	2016	NA	67986	64824	3162	4.7
CN1810700000000	18	107	Montgomery County, IN	2016	NA	19156	18419	737	3.8
CN1810900000000	18	109	Morgan County, IN	2016	NA	36037	34503	1534	4.3
CN1811100000000	18	111	Newton County, IN	2016	NA	7037	6644	393	5.6
CN1811300000000	18	113	Noble County, IN	2016	NA	23329	22382	947	4.1
CN1811500000000	18	115	Ohio County, IN	2016	NA	3226	3067	159	4.9
CN1811700000000	18	117	Orange County, IN	2016	NA	8880	8429	451	5.1
CN1811900000000	18	119	Owen County, IN	2016	NA	9259	8744	515	5.6
CN1812100000000	18	121	Parke County, IN	2016	NA	7267	6888	379	5.2
CN1812300000000	18	123	Perry County, IN	2016	NA	9460	9029	431	4.6
CN1812500000000	18	125	Pike County, IN	2016	NA	6330	6055	275	4.3
CN1812700000000	18	127	Porter County, IN	2016	NA	86273	81852	4421	5.1
CN1812900000000	18	129	Posey County, IN	2016	NA	13450	12919	531	3.9
CN1813100000000	18	131	Pulaski County, IN	2016	NA	6379	6094	285	4.5
CN1813300000000	18	133	Putnam County, IN	2016	NA	16604	15854	750	4.5
CN1813500000000	18	135	Randolph County, IN	2016	NA	12668	12098	570	4.5
CN1813700000000	18	137	Ripley County, IN	2016	NA	14066	13420	646	4.6
CN1813900000000	18	139	Rush County, IN	2016	NA	8978	8639	339	3.8
CN1814100000000	18	141	St. Joseph County, IN	2016	NA	134119	128039	6080	4.5
CN1814300000000	18	143	Scott County, IN	2016	NA	10475	9967	508	4.8
CN1814500000000	18	145	Shelby County, IN	2016	NA	22954	22037	917	4
CN1814700000000	18	147	Spencer County, IN	2016	NA	10975	10525	450	4.1
CN1814900000000	18	149	Starke County, IN	2016	NA	10858	10271	587	5.4
CN1815100000000	18	151	Steuben County, IN	2016	NA	20081	19346	735	3.7
CN1815300000000	18	153	Sullivan County, IN	2016	NA	8699	8188	511	5.9
CN1815500000000	18	155	Switzerland County, IN	2016	NA	4996	4752	244	4.9
CN1815700000000	18	157	Tippecanoe County, IN	2016	NA	94383	90548	3835	4.1
CN1815900000000	18	159	Tipton County, IN	2016	NA	8527	8199	328	3.8
CN1816100000000	18	161	Union County, IN	2016	NA	3637	3490	147	4
CN1816300000000	18	163	Vanderburgh County, IN	2016	NA	93222	89389	3833	4.1
CN1816500000000	18	165	Vermillion County, IN	2016	NA	7271	6792	479	6.6
CN1816700000000	18	167	Vigo County, IN	2016	NA	49375	46714	2661	5.4
CN1816900000000	18	169	Wabash County, IN	2016	NA	15477	14818	659	4.3
CN1817100000000	18	171	Warren County, IN	2016	NA	4111	3912	199	4.8
CN1817300000000	18	173	Warrick County, IN	2016	NA	32481	31169	1312	4
CN1817500000000	18	175	Washington County, IN	2016	NA	13682	13056	626	4.6
CN1817700000000	18	177	Wayne County, IN	2016	NA	30950	29465	1485	4.8
CN1817900000000	18	179	Wells County, IN	2016	NA	14167	13662	505	3.6
CN1818100000000	18	181	White County, IN	2016	NA	13643	13100	543	4
CN1818300000000	18	183	Whitley County, IN	2016	NA	17234	16564	670	3.9
CN1900100000000	19	001	Adair County, IA	2016	NA	4222	4097	125	3
CN1900300000000	19	003	Adams County, IA	2016	NA	2209	2152	57	2.6
CN1900500000000	19	005	Allamakee County, IA	2016	NA	7648	7269	379	5
CN1900700000000	19	007	Appanoose County, IA	2016	NA	6142	5851	291	4.7
CN1900900000000	19	009	Audubon County, IA	2016	NA	3267	3159	108	3.3
CN1901100000000	19	011	Benton County, IA	2016	NA	13561	13071	490	3.6
CN1901300000000	19	013	Black Hawk County, IA	2016	NA	69082	65879	3203	4.6
CN1901500000000	19	015	Boone County, IA	2016	NA	15072	14651	421	2.8
CN1901700000000	19	017	Bremer County, IA	2016	NA	13868	13372	496	3.6
CN1901900000000	19	019	Buchanan County, IA	2016	NA	11171	10711	460	4.1
CN1902100000000	19	021	Buena Vista County, IA	2016	NA	11481	11076	405	3.5
CN1902300000000	19	023	Butler County, IA	2016	NA	8006	7658	348	4.3
CN1902500000000	19	025	Calhoun County, IA	2016	NA	4509	4339	170	3.8
CN1902700000000	19	027	Carroll County, IA	2016	NA	11247	10958	289	2.6
CN1902900000000	19	029	Cass County, IA	2016	NA	7244	7007	237	3.3
CN1903100000000	19	031	Cedar County, IA	2016	NA	10828	10468	360	3.3
CN1903300000000	19	033	Cerro Gordo County, IA	2016	NA	23053	22224	829	3.6
CN1903500000000	19	035	Cherokee County, IA	2016	NA	6303	6074	229	3.6
CN1903700000000	19	037	Chickasaw County, IA	2016	NA	6408	6124	284	4.4
CN1903900000000	19	039	Clarke County, IA	2016	NA	4817	4655	162	3.4
CN1904100000000	19	041	Clay County, IA	2016	NA	8695	8360	335	3.9
CN1904300000000	19	043	Clayton County, IA	2016	NA	10273	9837	436	4.2
CN1904500000000	19	045	Clinton County, IA	2016	NA	23751	22578	1173	4.9
CN1904700000000	19	047	Crawford County, IA	2016	NA	8414	7954	460	5.5
CN1904900000000	19	049	Dallas County, IA	2016	NA	45693	44488	1205	2.6
CN1905100000000	19	051	Davis County, IA	2016	NA	4278	4096	182	4.3
CN1905300000000	19	053	Decatur County, IA	2016	NA	4393	4252	141	3.2
CN1905500000000	19	055	Delaware County, IA	2016	NA	10698	10327	371	3.5
CN1905700000000	19	057	Des Moines County, IA	2016	NA	19986	18998	988	4.9
CN1905900000000	19	059	Dickinson County, IA	2016	NA	10273	9831	442	4.3
CN1906100000000	19	061	Dubuque County, IA	2016	NA	54537	52594	1943	3.6
CN1906300000000	19	063	Emmet County, IA	2016	NA	5581	5343	238	4.3
CN1906500000000	19	065	Fayette County, IA	2016	NA	10683	10208	475	4.4
CN1906700000000	19	067	Floyd County, IA	2016	NA	8666	8351	315	3.6
CN1906900000000	19	069	Franklin County, IA	2016	NA	5929	5723	206	3.5
CN1907100000000	19	071	Fremont County, IA	2016	NA	3977	3846	131	3.3
CN1907300000000	19	073	Greene County, IA	2016	NA	5651	5474	177	3.1
CN1907500000000	19	075	Grundy County, IA	2016	NA	6617	6388	229	3.5
CN1907700000000	19	077	Guthrie County, IA	2016	NA	5609	5407	202	3.6
CN1907900000000	19	079	Hamilton County, IA	2016	NA	7121	6853	268	3.8
CN1908100000000	19	081	Hancock County, IA	2016	NA	6373	6201	172	2.7
CN1908300000000	19	083	Hardin County, IA	2016	NA	8550	8217	333	3.9
CN1908500000000	19	085	Harrison County, IA	2016	NA	7430	7179	251	3.4
CN1908700000000	19	087	Henry County, IA	2016	NA	9536	9197	339	3.6
CN1908900000000	19	089	Howard County, IA	2016	NA	5315	5124	191	3.6
CN1909100000000	19	091	Humboldt County, IA	2016	NA	5372	5217	155	2.9
CN1909300000000	19	093	Ida County, IA	2016	NA	4014	3911	103	2.6
CN1909500000000	19	095	Iowa County, IA	2016	NA	10530	10202	328	3.1
CN1909700000000	19	097	Jackson County, IA	2016	NA	11034	10571	463	4.2
CN1909900000000	19	099	Jasper County, IA	2016	NA	19194	18512	682	3.6
CN1910100000000	19	101	Jefferson County, IA	2016	NA	9160	8824	336	3.7
CN1910300000000	19	103	Johnson County, IA	2016	NA	84086	81903	2183	2.6
CN1910500000000	19	105	Jones County, IA	2016	NA	10660	10203	457	4.3
CN1910700000000	19	107	Keokuk County, IA	2016	NA	5307	5079	228	4.3
CN1910900000000	19	109	Kossuth County, IA	2016	NA	8870	8638	232	2.6
CN1911100000000	19	111	Lee County, IA	2016	NA	17416	16364	1052	6
CN1911300000000	19	113	Linn County, IA	2016	NA	118477	114131	4346	3.7
CN1911500000000	19	115	Louisa County, IA	2016	NA	6087	5848	239	3.9
CN1911700000000	19	117	Lucas County, IA	2016	NA	4370	4231	139	3.2
CN1911900000000	19	119	Lyon County, IA	2016	NA	7068	6924	144	2
CN1912100000000	19	121	Madison County, IA	2016	NA	8229	7937	292	3.5
CN1912300000000	19	123	Mahaska County, IA	2016	NA	11768	11330	438	3.7
CN1912500000000	19	125	Marion County, IA	2016	NA	17400	16875	525	3
CN1912700000000	19	127	Marshall County, IA	2016	NA	19085	18150	935	4.9
CN1912900000000	19	129	Mills County, IA	2016	NA	7387	7118	269	3.6
CN1913100000000	19	131	Mitchell County, IA	2016	NA	5864	5710	154	2.6
CN1913300000000	19	133	Monona County, IA	2016	NA	4713	4520	193	4.1
CN1913500000000	19	135	Monroe County, IA	2016	NA	3947	3765	182	4.6
CN1913700000000	19	137	Montgomery County, IA	2016	NA	5099	4919	180	3.5
CN1913900000000	19	139	Muscatine County, IA	2016	NA	22372	21520	852	3.8
CN1914100000000	19	141	O'Brien County, IA	2016	NA	8338	8107	231	2.8
CN1914300000000	19	143	Osceola County, IA	2016	NA	3633	3537	96	2.6
CN1914500000000	19	145	Page County, IA	2016	NA	6450	6126	324	5
CN1914700000000	19	147	Palo Alto County, IA	2016	NA	4953	4799	154	3.1
CN1914900000000	19	149	Plymouth County, IA	2016	NA	14968	14585	383	2.6
CN1915100000000	19	151	Pocahontas County, IA	2016	NA	4305	4182	123	2.9
CN1915300000000	19	153	Polk County, IA	2016	NA	256655	247743	8912	3.5
CN1915500000000	19	155	Pottawattamie County, IA	2016	NA	48137	46503	1634	3.4
CN1915700000000	19	157	Poweshiek County, IA	2016	NA	10395	10038	357	3.4
CN1915900000000	19	159	Ringgold County, IA	2016	NA	2600	2509	91	3.5
CN1916100000000	19	161	Sac County, IA	2016	NA	5480	5315	165	3
CN1916300000000	19	163	Scott County, IA	2016	NA	86497	82592	3905	4.5
CN1916500000000	19	165	Shelby County, IA	2016	NA	6805	6605	200	2.9
CN1916700000000	19	167	Sioux County, IA	2016	NA	20631	20157	474	2.3
CN1916900000000	19	169	Story County, IA	2016	NA	56811	55478	1333	2.3
CN1917100000000	19	171	Tama County, IA	2016	NA	9742	9334	408	4.2
CN1917300000000	19	173	Taylor County, IA	2016	NA	3221	3126	95	2.9
CN1917500000000	19	175	Union County, IA	2016	NA	6497	6250	247	3.8
CN1917700000000	19	177	Van Buren County, IA	2016	NA	3849	3708	141	3.7
CN1917900000000	19	179	Wapello County, IA	2016	NA	17846	16811	1035	5.8
CN1918100000000	19	181	Warren County, IA	2016	NA	27037	26172	865	3.2
CN1918300000000	19	183	Washington County, IA	2016	NA	12322	11961	361	2.9
CN1918500000000	19	185	Wayne County, IA	2016	NA	2833	2726	107	3.8
CN1918700000000	19	187	Webster County, IA	2016	NA	20379	19564	815	4
CN1918900000000	19	189	Winnebago County, IA	2016	NA	5185	5005	180	3.5
CN1919100000000	19	191	Winneshiek County, IA	2016	NA	12029	11606	423	3.5
CN1919300000000	19	193	Woodbury County, IA	2016	NA	55604	53622	1982	3.6
CN1919500000000	19	195	Worth County, IA	2016	NA	4258	4112	146	3.4
CN1919700000000	19	197	Wright County, IA	2016	NA	6674	6399	275	4.1
CN2000100000000	20	001	Allen County, KS	2016	NA	6432	6073	359	5.6
CN2000300000000	20	003	Anderson County, KS	2016	NA	4169	3991	178	4.3
CN2000500000000	20	005	Atchison County, KS	2016	NA	7038	6600	438	6.2
CN2000700000000	20	007	Barber County, KS	2016	NA	2524	2431	93	3.7
CN2000900000000	20	009	Barton County, KS	2016	NA	14008	13380	628	4.5
CN2001100000000	20	011	Bourbon County, KS	2016	NA	7120	6774	346	4.9
CN2001300000000	20	013	Brown County, KS	2016	NA	5159	4972	187	3.6
CN2001500000000	20	015	Butler County, KS	2016	NA	32159	30816	1343	4.2
CN2001700000000	20	017	Chase County, KS	2016	NA	1405	1356	49	3.5
CN2001900000000	20	019	Chautauqua County, KS	2016	NA	1539	1459	80	5.2
CN2002100000000	20	021	Cherokee County, KS	2016	NA	10278	9822	456	4.4
CN2002300000000	20	023	Cheyenne County, KS	2016	NA	1342	1305	37	2.8
CN2002500000000	20	025	Clark County, KS	2016	NA	1115	1084	31	2.8
CN2002700000000	20	027	Clay County, KS	2016	NA	4030	3866	164	4.1
CN2002900000000	20	029	Cloud County, KS	2016	NA	4252	4077	175	4.1
CN2003100000000	20	031	Coffey County, KS	2016	NA	4278	4013	265	6.2
CN2003300000000	20	033	Comanche County, KS	2016	NA	970	940	30	3.1
CN2003500000000	20	035	Cowley County, KS	2016	NA	16891	16143	748	4.4
CN2003700000000	20	037	Crawford County, KS	2016	NA	18894	17984	910	4.8
CN2003900000000	20	039	Decatur County, KS	2016	NA	1291	1240	51	4
CN2004100000000	20	041	Dickinson County, KS	2016	NA	9157	8752	405	4.4
CN2004300000000	20	043	Doniphan County, KS	2016	NA	4269	4104	165	3.9
CN2004500000000	20	045	Douglas County, KS	2016	NA	65198	62893	2305	3.5
CN2004700000000	20	047	Edwards County, KS	2016	NA	1652	1602	50	3
CN2004900000000	20	049	Elk County, KS	2016	NA	1187	1128	59	5
CN2005100000000	20	051	Ellis County, KS	2016	NA	16994	16469	525	3.1
CN2005300000000	20	053	Ellsworth County, KS	2016	NA	2831	2722	109	3.9
CN2005500000000	20	055	Finney County, KS	2016	NA	20129	19507	622	3.1
CN2005700000000	20	057	Ford County, KS	2016	NA	17865	17300	565	3.2
CN2005900000000	20	059	Franklin County, KS	2016	NA	14210	13614	596	4.2
CN2006100000000	20	061	Geary County, KS	2016	NA	12044	11365	679	5.6
CN2006300000000	20	063	Gove County, KS	2016	NA	1449	1414	35	2.4
CN2006500000000	20	065	Graham County, KS	2016	NA	1223	1169	54	4.4
CN2006700000000	20	067	Grant County, KS	2016	NA	3769	3635	134	3.6
CN2006900000000	20	069	Gray County, KS	2016	NA	3406	3329	77	2.3
CN2007100000000	20	071	Greeley County, KS	2016	NA	911	892	19	2.1
CN2007300000000	20	073	Greenwood County, KS	2016	NA	3319	3157	162	4.9
CN2007500000000	20	075	Hamilton County, KS	2016	NA	1641	1597	44	2.7
CN2007700000000	20	077	Harper County, KS	2016	NA	2878	2775	103	3.6
CN2007900000000	20	079	Harvey County, KS	2016	NA	17186	16459	727	4.2
CN2008100000000	20	081	Haskell County, KS	2016	NA	2302	2242	60	2.6
CN2008300000000	20	083	Hodgeman County, KS	2016	NA	1028	1001	27	2.6
CN2008500000000	20	085	Jackson County, KS	2016	NA	7251	7000	251	3.5
CN2008700000000	20	087	Jefferson County, KS	2016	NA	10205	9808	397	3.9
CN2008900000000	20	089	Jewell County, KS	2016	NA	1329	1272	57	4.3
CN2009100000000	20	091	Johnson County, KS	2016	NA	327981	317290	10691	3.3
CN2009300000000	20	093	Kearny County, KS	2016	NA	2056	1991	65	3.2
CN2009500000000	20	095	Kingman County, KS	2016	NA	3524	3369	155	4.4
CN2009700000000	20	097	Kiowa County, KS	2016	NA	1418	1379	39	2.8
CN2009900000000	20	099	Labette County, KS	2016	NA	10722	10143	579	5.4
CN2010100000000	20	101	Lane County, KS	2016	NA	810	785	25	3.1
CN2010300000000	20	103	Leavenworth County, KS	2016	NA	35747	34206	1541	4.3
CN2010500000000	20	105	Lincoln County, KS	2016	NA	1735	1676	59	3.4
CN2010700000000	20	107	Linn County, KS	2016	NA	4338	4059	279	6.4
CN2010900000000	20	109	Logan County, KS	2016	NA	1721	1677	44	2.6
CN2011100000000	20	111	Lyon County, KS	2016	NA	16802	16114	688	4.1
CN2011300000000	20	113	McPherson County, KS	2016	NA	16321	15806	515	3.2
CN2011500000000	20	115	Marion County, KS	2016	NA	6114	5873	241	3.9
CN2011700000000	20	117	Marshall County, KS	2016	NA	5556	5388	168	3
CN2011900000000	20	119	Meade County, KS	2016	NA	2374	2310	64	2.7
CN2012100000000	20	121	Miami County, KS	2016	NA	17003	16296	707	4.2
CN2012300000000	20	123	Mitchell County, KS	2016	NA	3692	3570	122	3.3
CN2012500000000	20	125	Montgomery County, KS	2016	NA	15982	15002	980	6.1
CN2012700000000	20	127	Morris County, KS	2016	NA	3047	2930	117	3.8
CN2012900000000	20	129	Morton County, KS	2016	NA	1342	1290	52	3.9
CN2013100000000	20	131	Nemaha County, KS	2016	NA	5890	5732	158	2.7
CN2013300000000	20	133	Neosho County, KS	2016	NA	6050	5616	434	7.2
CN2013500000000	20	135	Ness County, KS	2016	NA	1421	1372	49	3.4
CN2013700000000	20	137	Norton County, KS	2016	NA	2869	2799	70	2.4
CN2013900000000	20	139	Osage County, KS	2016	NA	8049	7694	355	4.4
CN2014100000000	20	141	Osborne County, KS	2016	NA	2057	1987	70	3.4
CN2014300000000	20	143	Ottawa County, KS	2016	NA	3159	3039	120	3.8
CN2014500000000	20	145	Pawnee County, KS	2016	NA	3206	3100	106	3.3
CN2014700000000	20	147	Phillips County, KS	2016	NA	2854	2764	90	3.2
CN2014900000000	20	149	Pottawatomie County, KS	2016	NA	12138	11714	424	3.5
CN2015100000000	20	151	Pratt County, KS	2016	NA	5098	4891	207	4.1
CN2015300000000	20	153	Rawlins County, KS	2016	NA	1543	1506	37	2.4
CN2015500000000	20	155	Reno County, KS	2016	NA	30104	28778	1326	4.4
CN2015700000000	20	157	Republic County, KS	2016	NA	2541	2471	70	2.8
CN2015900000000	20	159	Rice County, KS	2016	NA	5299	5088	211	4
CN2016100000000	20	161	Riley County, KS	2016	NA	34848	33666	1182	3.4
CN2016300000000	20	163	Rooks County, KS	2016	NA	2666	2540	126	4.7
CN2016500000000	20	165	Rush County, KS	2016	NA	1730	1661	69	4
CN2016700000000	20	167	Russell County, KS	2016	NA	3570	3420	150	4.2
CN2016900000000	20	169	Saline County, KS	2016	NA	30078	28956	1122	3.7
CN2017100000000	20	171	Scott County, KS	2016	NA	2884	2813	71	2.5
CN2017300000000	20	173	Sedgwick County, KS	2016	NA	247016	235528	11488	4.7
CN2017500000000	20	175	Seward County, KS	2016	NA	10220	9775	445	4.4
CN2017700000000	20	177	Shawnee County, KS	2016	NA	91580	87910	3670	4
CN2017900000000	20	179	Sheridan County, KS	2016	NA	1448	1413	35	2.4
CN2018100000000	20	181	Sherman County, KS	2016	NA	2938	2841	97	3.3
CN2018300000000	20	183	Smith County, KS	2016	NA	2031	1966	65	3.2
CN2018500000000	20	185	Stafford County, KS	2016	NA	2092	2015	77	3.7
CN2018700000000	20	187	Stanton County, KS	2016	NA	1070	1040	30	2.8
CN2018900000000	20	189	Stevens County, KS	2016	NA	2905	2790	115	4
CN2019100000000	20	191	Sumner County, KS	2016	NA	10920	10457	463	4.2
CN2019300000000	20	193	Thomas County, KS	2016	NA	4347	4228	119	2.7
CN2019500000000	20	195	Trego County, KS	2016	NA	1474	1415	59	4
CN2019700000000	20	197	Wabaunsee County, KS	2016	NA	3702	3570	132	3.6
CN2019900000000	20	199	Wallace County, KS	2016	NA	859	836	23	2.7
CN2020100000000	20	201	Washington County, KS	2016	NA	3080	2979	101	3.3
CN2020300000000	20	203	Wichita County, KS	2016	NA	1204	1176	28	2.3
CN2020500000000	20	205	Wilson County, KS	2016	NA	4111	3864	247	6
CN2020700000000	20	207	Woodson County, KS	2016	NA	1616	1523	93	5.8
CN2020900000000	20	209	Wyandotte County, KS	2016	NA	76353	72109	4244	5.6
CN2100100000000	21	001	Adair County, KY	2016	NA	7085	6614	471	6.6
CN2100300000000	21	003	Allen County, KY	2016	NA	8850	8466	384	4.3
CN2100500000000	21	005	Anderson County, KY	2016	NA	11455	10991	464	4.1
CN2100700000000	21	007	Ballard County, KY	2016	NA	3643	3316	327	9
CN2100900000000	21	009	Barren County, KY	2016	NA	18854	17962	892	4.7
CN2101100000000	21	011	Bath County, KY	2016	NA	4759	4406	353	7.4
CN2101300000000	21	013	Bell County, KY	2016	NA	8659	7859	800	9.2
CN2101500000000	21	015	Boone County, KY	2016	NA	67249	64670	2579	3.8
CN2101700000000	21	017	Bourbon County, KY	2016	NA	9877	9404	473	4.8
CN2101900000000	21	019	Boyd County, KY	2016	NA	18548	17036	1512	8.2
CN2102100000000	21	021	Boyle County, KY	2016	NA	12310	11696	614	5
CN2102300000000	21	023	Bracken County, KY	2016	NA	3831	3599	232	6.1
CN2102500000000	21	025	Breathitt County, KY	2016	NA	3747	3376	371	9.9
CN2102700000000	21	027	Breckinridge County, KY	2016	NA	7737	7246	491	6.3
CN2102900000000	21	029	Bullitt County, KY	2016	NA	40517	38822	1695	4.2
CN2103100000000	21	031	Butler County, KY	2016	NA	5160	4877	283	5.5
CN2103300000000	21	033	Caldwell County, KY	2016	NA	5354	5061	293	5.5
CN2103500000000	21	035	Calloway County, KY	2016	NA	18688	17837	851	4.6
CN2103700000000	21	037	Campbell County, KY	2016	NA	48706	46831	1875	3.8
CN2103900000000	21	039	Carlisle County, KY	2016	NA	2564	2397	167	6.5
CN2104100000000	21	041	Carroll County, KY	2016	NA	5182	4924	258	5
CN2104300000000	21	043	Carter County, KY	2016	NA	9943	8888	1055	10.6
CN2104500000000	21	045	Casey County, KY	2016	NA	6689	6363	326	4.9
CN2104700000000	21	047	Christian County, KY	2016	NA	24890	23351	1539	6.2
CN2104900000000	21	049	Clark County, KY	2016	NA	17018	16194	824	4.8
CN2105100000000	21	051	Clay County, KY	2016	NA	5454	4898	556	10.2
CN2105300000000	21	053	Clinton County, KY	2016	NA	3750	3466	284	7.6
CN2105500000000	21	055	Crittenden County, KY	2016	NA	4022	3809	213	5.3
CN2105700000000	21	057	Cumberland County, KY	2016	NA	2890	2724	166	5.7
CN2105900000000	21	059	Daviess County, KY	2016	NA	46674	44577	2097	4.5
CN2106100000000	21	061	Edmonson County, KY	2016	NA	4805	4505	300	6.2
CN2106300000000	21	063	Elliott County, KY	2016	NA	2099	1856	243	11.6
CN2106500000000	21	065	Estill County, KY	2016	NA	5241	4930	311	5.9
CN2106700000000	21	067	Fayette County, KY	2016	NA	171402	165244	6158	3.6
CN2106900000000	21	069	Fleming County, KY	2016	NA	5945	5572	373	6.3
CN2107100000000	21	071	Floyd County, KY	2016	NA	11459	10156	1303	11.4
CN2107300000000	21	073	Franklin County, KY	2016	NA	24438	23436	1002	4.1
CN2107500000000	21	075	Fulton County, KY	2016	NA	2067	1923	144	7
CN2107700000000	21	077	Gallatin County, KY	2016	NA	3903	3713	190	4.9
CN2107900000000	21	079	Garrard County, KY	2016	NA	7524	7156	368	4.9
CN2108100000000	21	081	Grant County, KY	2016	NA	11347	10792	555	4.9
CN2108300000000	21	083	Graves County, KY	2016	NA	15306	14348	958	6.3
CN2108500000000	21	085	Grayson County, KY	2016	NA	10728	10002	726	6.8
CN2108700000000	21	087	Green County, KY	2016	NA	5000	4773	227	4.5
CN2108900000000	21	089	Greenup County, KY	2016	NA	13891	12681	1210	8.7
CN2109100000000	21	091	Hancock County, KY	2016	NA	4039	3821	218	5.4
CN2109300000000	21	093	Hardin County, KY	2016	NA	47783	45627	2156	4.5
CN2109500000000	21	095	Harlan County, KY	2016	NA	6747	5854	893	13.2
CN2109700000000	21	097	Harrison County, KY	2016	NA	8492	8089	403	4.7
CN2109900000000	21	099	Hart County, KY	2016	NA	7901	7525	376	4.8
CN2110100000000	21	101	Henderson County, KY	2016	NA	21600	20567	1033	4.8
CN2110300000000	21	103	Henry County, KY	2016	NA	7925	7597	328	4.1
CN2110500000000	21	105	Hickman County, KY	2016	NA	1921	1805	116	6
CN2110700000000	21	107	Hopkins County, KY	2016	NA	19635	18506	1129	5.7
CN2110900000000	21	109	Jackson County, KY	2016	NA	4168	3836	332	8
CN2111100000000	21	111	Jefferson County, KY	2016	NA	386617	369452	17165	4.4
CN2111300000000	21	113	Jessamine County, KY	2016	NA	25654	24644	1010	3.9
CN2111500000000	21	115	Johnson County, KY	2016	NA	7015	6288	727	10.4
CN2111700000000	21	117	Kenton County, KY	2016	NA	84703	81200	3503	4.1
CN2111900000000	21	119	Knott County, KY	2016	NA	4561	4030	531	11.6
CN2112100000000	21	121	Knox County, KY	2016	NA	9899	9103	796	8
CN2112300000000	21	123	Larue County, KY	2016	NA	5898	5624	274	4.6
CN2112500000000	21	125	Laurel County, KY	2016	NA	23913	22421	1492	6.2
CN2112700000000	21	127	Lawrence County, KY	2016	NA	5045	4491	554	11
CN2112900000000	21	129	Lee County, KY	2016	NA	1899	1712	187	9.8
CN2113100000000	21	131	Leslie County, KY	2016	NA	2792	2413	379	13.6
CN2113300000000	21	133	Letcher County, KY	2016	NA	6429	5627	802	12.5
CN2113500000000	21	135	Lewis County, KY	2016	NA	4745	4275	470	9.9
CN2113700000000	21	137	Lincoln County, KY	2016	NA	9149	8588	561	6.1
CN2113900000000	21	139	Livingston County, KY	2016	NA	3687	3420	267	7.2
CN2114100000000	21	141	Logan County, KY	2016	NA	11731	11211	520	4.4
CN2114300000000	21	143	Lyon County, KY	2016	NA	2960	2785	175	5.9
CN2114500000000	21	145	McCracken County, KY	2016	NA	29002	27318	1684	5.8
CN2114700000000	21	147	McCreary County, KY	2016	NA	4603	4229	374	8.1
CN2114900000000	21	149	McLean County, KY	2016	NA	4331	4121	210	4.8
CN2115100000000	21	151	Madison County, KY	2016	NA	45097	43198	1899	4.2
CN2115300000000	21	153	Magoffin County, KY	2016	NA	3148	2522	626	19.9
CN2115500000000	21	155	Marion County, KY	2016	NA	9400	8999	401	4.3
CN2115700000000	21	157	Marshall County, KY	2016	NA	14910	14039	871	5.8
CN2115900000000	21	159	Martin County, KY	2016	NA	3085	2765	320	10.4
CN2116100000000	21	161	Mason County, KY	2016	NA	7138	6679	459	6.4
CN2116300000000	21	163	Meade County, KY	2016	NA	12088	11461	627	5.2
CN2116500000000	21	165	Menifee County, KY	2016	NA	2393	2185	208	8.7
CN2116700000000	21	167	Mercer County, KY	2016	NA	9888	9406	482	4.9
CN2116900000000	21	169	Metcalfe County, KY	2016	NA	4119	3929	190	4.6
CN2117100000000	21	171	Monroe County, KY	2016	NA	4600	4405	195	4.2
CN2117300000000	21	173	Montgomery County, KY	2016	NA	11854	11086	768	6.5
CN2117500000000	21	175	Morgan County, KY	2016	NA	4486	4124	362	8.1
CN2117700000000	21	177	Muhlenberg County, KY	2016	NA	11363	10526	837	7.4
CN2117900000000	21	179	Nelson County, KY	2016	NA	21698	20704	994	4.6
CN2118100000000	21	181	Nicholas County, KY	2016	NA	3219	3032	187	5.8
CN2118300000000	21	183	Ohio County, KY	2016	NA	9524	8882	642	6.7
CN2118500000000	21	185	Oldham County, KY	2016	NA	31913	30822	1091	3.4
CN2118700000000	21	187	Owen County, KY	2016	NA	5488	5250	238	4.3
CN2118900000000	21	189	Owsley County, KY	2016	NA	1122	1011	111	9.9
CN2119100000000	21	191	Pendleton County, KY	2016	NA	6849	6518	331	4.8
CN2119300000000	21	193	Perry County, KY	2016	NA	8557	7624	933	10.9
CN2119500000000	21	195	Pike County, KY	2016	NA	20245	18029	2216	10.9
CN2119700000000	21	197	Powell County, KY	2016	NA	4959	4601	358	7.2
CN2119900000000	21	199	Pulaski County, KY	2016	NA	25382	23989	1393	5.5
CN2120100000000	21	201	Robertson County, KY	2016	NA	805	755	50	6.2
CN2120300000000	21	203	Rockcastle County, KY	2016	NA	6683	6272	411	6.1
CN2120500000000	21	205	Rowan County, KY	2016	NA	10574	9942	632	6
CN2120700000000	21	207	Russell County, KY	2016	NA	6138	5619	519	8.5
CN2120900000000	21	209	Scott County, KY	2016	NA	27978	26908	1070	3.8
CN2121100000000	21	211	Shelby County, KY	2016	NA	23797	22942	855	3.6
CN2121300000000	21	213	Simpson County, KY	2016	NA	8389	8011	378	4.5
CN2121500000000	21	215	Spencer County, KY	2016	NA	9651	9281	370	3.8
CN2121700000000	21	217	Taylor County, KY	2016	NA	12215	11607	608	5
CN2121900000000	21	219	Todd County, KY	2016	NA	5302	5064	238	4.5
CN2122100000000	21	221	Trigg County, KY	2016	NA	5818	5490	328	5.6
CN2122300000000	21	223	Trimble County, KY	2016	NA	3868	3658	210	5.4
CN2122500000000	21	225	Union County, KY	2016	NA	6164	5742	422	6.8
CN2122700000000	21	227	Warren County, KY	2016	NA	61962	59522	2440	3.9
CN2122900000000	21	229	Washington County, KY	2016	NA	6080	5817	263	4.3
CN2123100000000	21	231	Wayne County, KY	2016	NA	7262	6700	562	7.7
CN2123300000000	21	233	Webster County, KY	2016	NA	5832	5479	353	6.1
CN2123500000000	21	235	Whitley County, KY	2016	NA	13350	12463	887	6.6
CN2123700000000	21	237	Wolfe County, KY	2016	NA	1919	1723	196	10.2
CN2123900000000	21	239	Woodford County, KY	2016	NA	14753	14276	477	3.2
CN2200100000000	22	001	Acadia Parish, LA	2016	NA	24508	22697	1811	7.4
CN2200300000000	22	003	Allen Parish, LA	2016	NA	8899	8327	572	6.4
CN2200500000000	22	005	Ascension Parish, LA	2016	NA	61982	58949	3033	4.9
CN2200700000000	22	007	Assumption Parish, LA	2016	NA	9206	8433	773	8.4
CN2200900000000	22	009	Avoyelles Parish, LA	2016	NA	15682	14574	1108	7.1
CN2201100000000	22	011	Beauregard Parish, LA	2016	NA	15063	14151	912	6.1
CN2201300000000	22	013	Bienville Parish, LA	2016	NA	5664	5233	431	7.6
CN2201500000000	22	015	Bossier Parish, LA	2016	NA	57579	54516	3063	5.3
CN2201700000000	22	017	Caddo Parish, LA	2016	NA	107031	99951	7080	6.6
CN2201900000000	22	019	Calcasieu Parish, LA	2016	NA	102869	97954	4915	4.8
CN2202100000000	22	021	Caldwell Parish, LA	2016	NA	3982	3678	304	7.6
CN2202300000000	22	023	Cameron Parish, LA	2016	NA	3817	3650	167	4.4
CN2202500000000	22	025	Catahoula Parish, LA	2016	NA	3423	3105	318	9.3
CN2202700000000	22	027	Claiborne Parish, LA	2016	NA	5950	5553	397	6.7
CN2202900000000	22	029	Concordia Parish, LA	2016	NA	7250	6651	599	8.3
CN2203100000000	22	031	De Soto Parish, LA	2016	NA	10888	10088	800	7.3
CN2203300000000	22	033	East Baton Rouge Parish, LA	2016	NA	232108	220144	11964	5.2
CN2203500000000	22	035	East Carroll Parish, LA	2016	NA	2139	1891	248	11.6
CN2203700000000	22	037	East Feliciana Parish, LA	2016	NA	8102	7635	467	5.8
CN2203900000000	22	039	Evangeline Parish, LA	2016	NA	12670	11731	939	7.4
CN2204100000000	22	041	Franklin Parish, LA	2016	NA	7279	6619	660	9.1
CN2204300000000	22	043	Grant Parish, LA	2016	NA	8325	7743	582	7
CN2204500000000	22	045	Iberia Parish, LA	2016	NA	30110	27282	2828	9.4
CN2204700000000	22	047	Iberville Parish, LA	2016	NA	14108	13141	967	6.9
CN2204900000000	22	049	Jackson Parish, LA	2016	NA	7083	6688	395	5.6
CN2205100000000	22	051	Jefferson Parish, LA	2016	NA	216473	205046	11427	5.3
CN2205300000000	22	053	Jefferson Davis Parish, LA	2016	NA	13574	12757	817	6
CN2205500000000	22	055	Lafayette Parish, LA	2016	NA	114343	107328	7015	6.1
CN2205700000000	22	057	Lafourche Parish, LA	2016	NA	43290	40569	2721	6.3
CN2205900000000	22	059	LaSalle Parish, LA	2016	NA	6270	5855	415	6.6
CN2206100000000	22	061	Lincoln Parish, LA	2016	NA	21462	20129	1333	6.2
CN2206300000000	22	063	Livingston Parish, LA	2016	NA	68671	65194	3477	5.1
CN2206500000000	22	065	Madison Parish, LA	2016	NA	3835	3491	344	9
CN2206700000000	22	067	Morehouse Parish, LA	2016	NA	10621	9591	1030	9.7
CN2206900000000	22	069	Natchitoches Parish, LA	2016	NA	16711	15587	1124	6.7
CN2207100000000	22	071	Orleans Parish, LA	2016	NA	179955	169401	10554	5.9
CN2207300000000	22	073	Ouachita Parish, LA	2016	NA	71551	67199	4352	6.1
CN2207500000000	22	075	Plaquemines Parish, LA	2016	NA	10184	9639	545	5.4
CN2207700000000	22	077	Pointe Coupee Parish, LA	2016	NA	9960	9314	646	6.5
CN2207900000000	22	079	Rapides Parish, LA	2016	NA	57272	53741	3531	6.2
CN2208100000000	22	081	Red River Parish, LA	2016	NA	3808	3579	229	6
CN2208300000000	22	083	Richland Parish, LA	2016	NA	8445	7818	627	7.4
CN2208500000000	22	085	Sabine Parish, LA	2016	NA	9137	8505	632	6.9
CN2208700000000	22	087	St. Bernard Parish, LA	2016	NA	19546	18357	1189	6.1
CN2208900000000	22	089	St. Charles Parish, LA	2016	NA	25319	23975	1344	5.3
CN2209100000000	22	091	St. Helena Parish, LA	2016	NA	4390	4054	336	7.7
CN2209300000000	22	093	St. James Parish, LA	2016	NA	9606	8888	718	7.5
CN2209500000000	22	095	St. John the Baptist Parish, LA	2016	NA	20054	18683	1371	6.8
CN2209700000000	22	097	St. Landry Parish, LA	2016	NA	32807	30158	2649	8.1
CN2209900000000	22	099	St. Martin Parish, LA	2016	NA	22963	21183	1780	7.8
CN2210100000000	22	101	St. Mary Parish, LA	2016	NA	21939	19880	2059	9.4
CN2210300000000	22	103	St. Tammany Parish, LA	2016	NA	117481	111641	5840	5
CN2210500000000	22	105	Tangipahoa Parish, LA	2016	NA	54158	50506	3652	6.7
CN2210700000000	22	107	Tensas Parish, LA	2016	NA	1626	1467	159	9.8
CN2210900000000	22	109	Terrebonne Parish, LA	2016	NA	48948	45538	3410	7
CN2211100000000	22	111	Union Parish, LA	2016	NA	9242	8636	606	6.6
CN2211300000000	22	113	Vermilion Parish, LA	2016	NA	24701	22821	1880	7.6
CN2211500000000	22	115	Vernon Parish, LA	2016	NA	16928	15702	1226	7.2
CN2211700000000	22	117	Washington Parish, LA	2016	NA	16943	15754	1189	7
CN2211900000000	22	119	Webster Parish, LA	2016	NA	15198	13902	1296	8.5
CN2212100000000	22	121	West Baton Rouge Parish, LA	2016	NA	13239	12534	705	5.3
CN2212300000000	22	123	West Carroll Parish, LA	2016	NA	4104	3613	491	12
CN2212500000000	22	125	West Feliciana Parish, LA	2016	NA	5328	5052	276	5.2
CN2212700000000	22	127	Winn Parish, LA	2016	NA	5185	4783	402	7.8
CN2300100000000	23	001	Androscoggin County, ME	2016	NA	55245	53266	1979	3.6
CN2300300000000	23	003	Aroostook County, ME	2016	NA	31419	29714	1705	5.4
CN2300500000000	23	005	Cumberland County, ME	2016	NA	161698	156997	4701	2.9
CN2300700000000	23	007	Franklin County, ME	2016	NA	14423	13779	644	4.5
CN2300900000000	23	009	Hancock County, ME	2016	NA	29129	27817	1312	4.5
CN2301100000000	23	011	Kennebec County, ME	2016	NA	62194	59932	2262	3.6
CN2301300000000	23	013	Knox County, ME	2016	NA	20675	19948	727	3.5
CN2301500000000	23	015	Lincoln County, ME	2016	NA	16986	16358	628	3.7
CN2301700000000	23	017	Oxford County, ME	2016	NA	26522	25297	1225	4.6
CN2301900000000	23	019	Penobscot County, ME	2016	NA	76854	73529	3325	4.3
CN2302100000000	23	021	Piscataquis County, ME	2016	NA	7462	7092	370	5
CN2302300000000	23	023	Sagadahoc County, ME	2016	NA	19160	18592	568	3
CN2302500000000	23	025	Somerset County, ME	2016	NA	23444	22128	1316	5.6
CN2302700000000	23	027	Waldo County, ME	2016	NA	20827	19955	872	4.2
CN2302900000000	23	029	Washington County, ME	2016	NA	13985	13211	774	5.5
CN2303100000000	23	031	York County, ME	2016	NA	110962	107223	3739	3.4
CN2400100000000	24	001	Allegany County, MD	2016	NA	32492	30460	2032	6.3
CN2400300000000	24	003	Anne Arundel County, MD	2016	NA	304143	292511	11632	3.8
CN2400500000000	24	005	Baltimore County, MD	2016	NA	446180	425357	20823	4.7
CN2400900000000	24	009	Calvert County, MD	2016	NA	48896	46998	1898	3.9
CN2401100000000	24	011	Caroline County, MD	2016	NA	17704	16855	849	4.8
CN2401300000000	24	013	Carroll County, MD	2016	NA	93288	89884	3404	3.6
CN2401500000000	24	015	Cecil County, MD	2016	NA	52752	49984	2768	5.2
CN2401700000000	24	017	Charles County, MD	2016	NA	84078	80496	3582	4.3
CN2401900000000	24	019	Dorchester County, MD	2016	NA	15926	14933	993	6.2
CN2402100000000	24	021	Frederick County, MD	2016	NA	128923	123872	5051	3.9
CN2402300000000	24	023	Garrett County, MD	2016	NA	15542	14657	885	5.7
CN2402500000000	24	025	Harford County, MD	2016	NA	136631	130843	5788	4.2
CN2402700000000	24	027	Howard County, MD	2016	NA	179621	173675	5946	3.3
CN2402900000000	24	029	Kent County, MD	2016	NA	10265	9764	501	4.9
CN2403100000000	24	031	Montgomery County, MD	2016	NA	546204	527278	18926	3.5
CN2403300000000	24	033	Prince George's County, MD	2016	NA	501485	479096	22389	4.5
CN2403500000000	24	035	Queen Anne's County, MD	2016	NA	26647	25601	1046	3.9
CN2403700000000	24	037	St. Mary's County, MD	2016	NA	54902	52562	2340	4.3
CN2403900000000	24	039	Somerset County, MD	2016	NA	9260	8586	674	7.3
CN2404100000000	24	041	Talbot County, MD	2016	NA	19579	18755	824	4.2
CN2404300000000	24	043	Washington County, MD	2016	NA	75569	71680	3889	5.1
CN2404500000000	24	045	Wicomico County, MD	2016	NA	50562	47402	3160	6.2
CN2404700000000	24	047	Worcester County, MD	2016	NA	25291	22935	2356	9.3
CN2451000000000	24	510	Baltimore city, MD	2016	NA	290265	271061	19204	6.6
CN2500100000000	25	001	Barnstable County, MA	2016	NA	111595	106122	5473	4.9
CN2500300000000	25	003	Berkshire County, MA	2016	NA	64353	61454	2899	4.5
CN2500500000000	25	005	Bristol County, MA	2016	NA	290659	276376	14283	4.9
CN2500700000000	25	007	Dukes County, MA	2016	NA	9349	8866	483	5.2
CN2500900000000	25	009	Essex County, MA	2016	NA	410540	394209	16331	4
CN2501100000000	25	011	Franklin County, MA	2016	NA	39535	38150	1385	3.5
CN2501300000000	25	013	Hampden County, MA	2016	NA	221992	210339	11653	5.2
CN2501500000000	25	015	Hampshire County, MA	2016	NA	88038	84846	3192	3.6
CN2501700000000	25	017	Middlesex County, MA	2016	NA	873687	846042	27645	3.2
CN2501900000000	25	019	Nantucket County/town, MA	2016	NA	7047	6734	313	4.4
CN2502100000000	25	021	Norfolk County, MA	2016	NA	372620	360049	12571	3.4
CN2502300000000	25	023	Plymouth County, MA	2016	NA	270868	259853	11015	4.1
CN2502500000000	25	025	Suffolk County, MA	2016	NA	427223	412113	15110	3.5
CN2502700000000	25	027	Worcester County, MA	2016	NA	430028	412400	17628	4.1
CN2600100000000	26	001	Alcona County, MI	2016	NA	3827	3534	293	7.7
CN2600300000000	26	003	Alger County, MI	2016	NA	3263	2994	269	8.2
CN2600500000000	26	005	Allegan County, MI	2016	NA	61265	58880	2385	3.9
CN2600700000000	26	007	Alpena County, MI	2016	NA	13646	12834	812	6
CN2600900000000	26	009	Antrim County, MI	2016	NA	10065	9354	711	7.1
CN2601100000000	26	011	Arenac County, MI	2016	NA	6119	5612	507	8.3
CN2601300000000	26	013	Baraga County, MI	2016	NA	3219	2954	265	8.2
CN2601500000000	26	015	Barry County, MI	2016	NA	30738	29508	1230	4
CN2601700000000	26	017	Bay County, MI	2016	NA	51874	49042	2832	5.5
CN2601900000000	26	019	Benzie County, MI	2016	NA	8835	8254	581	6.6
CN2602100000000	26	021	Berrien County, MI	2016	NA	73776	70115	3661	5
CN2602300000000	26	023	Branch County, MI	2016	NA	19097	18177	920	4.8
CN2602500000000	26	025	Calhoun County, MI	2016	NA	64390	61295	3095	4.8
CN2602700000000	26	027	Cass County, MI	2016	NA	24334	23194	1140	4.7
CN2602900000000	26	029	Charlevoix County, MI	2016	NA	13053	12330	723	5.5
CN2603100000000	26	031	Cheboygan County, MI	2016	NA	10813	9795	1018	9.4
CN2603300000000	26	033	Chippewa County, MI	2016	NA	16383	15126	1257	7.7
CN2603500000000	26	035	Clare County, MI	2016	NA	11951	11077	874	7.3
CN2603700000000	26	037	Clinton County, MI	2016	NA	40488	38993	1495	3.7
CN2603900000000	26	039	Crawford County, MI	2016	NA	5365	4959	406	7.6
CN2604100000000	26	041	Delta County, MI	2016	NA	17114	15992	1122	6.6
CN2604300000000	26	043	Dickinson County, MI	2016	NA	12501	11852	649	5.2
CN2604500000000	26	045	Eaton County, MI	2016	NA	56875	54530	2345	4.1
CN2604700000000	26	047	Emmet County, MI	2016	NA	17592	16446	1146	6.5
CN2604900000000	26	049	Genesee County, MI	2016	NA	182491	172185	10306	5.6
CN2605100000000	26	051	Gladwin County, MI	2016	NA	9883	9193	690	7
CN2605300000000	26	053	Gogebic County, MI	2016	NA	6333	5945	388	6.1
CN2605500000000	26	055	Grand Traverse County, MI	2016	NA	49365	47247	2118	4.3
CN2605700000000	26	057	Gratiot County, MI	2016	NA	18162	17222	940	5.2
CN2605900000000	26	059	Hillsdale County, MI	2016	NA	21169	20098	1071	5.1
CN2606100000000	26	061	Houghton County, MI	2016	NA	16559	15545	1014	6.1
CN2606300000000	26	063	Huron County, MI	2016	NA	15992	15165	827	5.2
CN2606500000000	26	065	Ingham County, MI	2016	NA	148872	142487	6385	4.3
CN2606700000000	26	067	Ionia County, MI	2016	NA	29646	28395	1251	4.2
CN2606900000000	26	069	Iosco County, MI	2016	NA	10106	9370	736	7.3
CN2607100000000	26	071	Iron County, MI	2016	NA	5216	4878	338	6.5
CN2607300000000	26	073	Isabella County, MI	2016	NA	35341	33681	1660	4.7
CN2607500000000	26	075	Jackson County, MI	2016	NA	74383	70781	3602	4.8
CN2607700000000	26	077	Kalamazoo County, MI	2016	NA	131966	126621	5345	4.1
CN2607900000000	26	079	Kalkaska County, MI	2016	NA	7717	7163	554	7.2
CN2608100000000	26	081	Kent County, MI	2016	NA	350238	337914	12324	3.5
CN2608300000000	26	083	Keweenaw County, MI	2016	NA	941	860	81	8.6
CN2608500000000	26	085	Lake County, MI	2016	NA	3751	3470	281	7.5
CN2608700000000	26	087	Lapeer County, MI	2016	NA	40758	38137	2621	6.4
CN2608900000000	26	089	Leelanau County, MI	2016	NA	10571	10057	514	4.9
CN2609100000000	26	091	Lenawee County, MI	2016	NA	47334	45161	2173	4.6
CN2609300000000	26	093	Livingston County, MI	2016	NA	100123	96031	4092	4.1
CN2609500000000	26	095	Luce County, MI	2016	NA	2401	2239	162	6.7
CN2609700000000	26	097	Mackinac County, MI	2016	NA	5188	4675	513	9.9
CN2609900000000	26	099	Macomb County, MI	2016	NA	436316	413581	22735	5.2
CN2610100000000	26	101	Manistee County, MI	2016	NA	10530	9840	690	6.6
CN2610300000000	26	103	Marquette County, MI	2016	NA	33309	31408	1901	5.7
CN2610500000000	26	105	Mason County, MI	2016	NA	14271	13440	831	5.8
CN2610700000000	26	107	Mecosta County, MI	2016	NA	19098	18024	1074	5.6
CN2610900000000	26	109	Menominee County, MI	2016	NA	11247	10666	581	5.2
CN2611100000000	26	111	Midland County, MI	2016	NA	41012	39079	1933	4.7
CN2611300000000	26	113	Missaukee County, MI	2016	NA	7023	6605	418	6
CN2611500000000	26	115	Monroe County, MI	2016	NA	76387	73088	3299	4.3
CN2611700000000	26	117	Montcalm County, MI	2016	NA	27911	26432	1479	5.3
CN2611900000000	26	119	Montmorency County, MI	2016	NA	3059	2748	311	10.2
CN2612100000000	26	121	Muskegon County, MI	2016	NA	77421	73194	4227	5.5
CN2612300000000	26	123	Newaygo County, MI	2016	NA	23322	22181	1141	4.9
CN2612500000000	26	125	Oakland County, MI	2016	NA	653664	626554	27110	4.1
CN2612700000000	26	127	Oceana County, MI	2016	NA	12318	11415	903	7.3
CN2612900000000	26	129	Ogemaw County, MI	2016	NA	8234	7592	642	7.8
CN2613100000000	26	131	Ontonagon County, MI	2016	NA	2202	2014	188	8.5
CN2613300000000	26	133	Osceola County, MI	2016	NA	10429	9834	595	5.7
CN2613500000000	26	135	Oscoda County, MI	2016	NA	2906	2693	213	7.3
CN2613700000000	26	137	Otsego County, MI	2016	NA	11684	10988	696	6
CN2613900000000	26	139	Ottawa County, MI	2016	NA	155338	150104	5234	3.4
CN2614100000000	26	141	Presque Isle County, MI	2016	NA	5286	4780	506	9.6
CN2614300000000	26	143	Roscommon County, MI	2016	NA	7866	7200	666	8.5
CN2614500000000	26	145	Saginaw County, MI	2016	NA	88569	83845	4724	5.3
CN2614700000000	26	147	St. Clair County, MI	2016	NA	74762	70209	4553	6.1
CN2614900000000	26	149	St. Joseph County, MI	2016	NA	29114	27913	1201	4.1
CN2615100000000	26	151	Sanilac County, MI	2016	NA	19407	18199	1208	6.2
CN2615300000000	26	153	Schoolcraft County, MI	2016	NA	3388	3079	309	9.1
CN2615500000000	26	155	Shiawassee County, MI	2016	NA	33477	31714	1763	5.3
CN2615700000000	26	157	Tuscola County, MI	2016	NA	24217	22694	1523	6.3
CN2615900000000	26	159	Van Buren County, MI	2016	NA	35454	33415	2039	5.8
CN2616100000000	26	161	Washtenaw County, MI	2016	NA	191443	184440	7003	3.7
CN2616300000000	26	163	Wayne County, MI	2016	NA	780565	731656	48909	6.3
CN2616500000000	26	165	Wexford County, MI	2016	NA	14694	13832	862	5.9
CN2700100000000	27	001	Aitkin County, MN	2016	NA	7052	6558	494	7
CN2700300000000	27	003	Anoka County, MN	2016	NA	192557	185393	7164	3.7
CN2700500000000	27	005	Becker County, MN	2016	NA	18621	17771	850	4.6
CN2700700000000	27	007	Beltrami County, MN	2016	NA	23757	22519	1238	5.2
CN2700900000000	27	009	Benton County, MN	2016	NA	21850	20888	962	4.4
CN2701100000000	27	011	Big Stone County, MN	2016	NA	2713	2583	130	4.8
CN2701300000000	27	013	Blue Earth County, MN	2016	NA	39754	38480	1274	3.2
CN2701500000000	27	015	Brown County, MN	2016	NA	14570	13960	610	4.2
CN2701700000000	27	017	Carlton County, MN	2016	NA	17800	16859	941	5.3
CN2701900000000	27	019	Carver County, MN	2016	NA	56518	54657	1861	3.3
CN2702100000000	27	021	Cass County, MN	2016	NA	14203	13237	966	6.8
CN2702300000000	27	023	Chippewa County, MN	2016	NA	6989	6675	314	4.5
CN2702500000000	27	025	Chisago County, MN	2016	NA	29245	27983	1262	4.3
CN2702700000000	27	027	Clay County, MN	2016	NA	35734	34508	1226	3.4
CN2702900000000	27	029	Clearwater County, MN	2016	NA	4731	4278	453	9.6
CN2703100000000	27	031	Cook County, MN	2016	NA	3104	2964	140	4.5
CN2703300000000	27	033	Cottonwood County, MN	2016	NA	5551	5154	397	7.2
CN2703500000000	27	035	Crow Wing County, MN	2016	NA	31944	30322	1622	5.1
CN2703700000000	27	037	Dakota County, MN	2016	NA	235892	227902	7990	3.4
CN2703900000000	27	039	Dodge County, MN	2016	NA	11596	11166	430	3.7
CN2704100000000	27	041	Douglas County, MN	2016	NA	20299	19593	706	3.5
CN2704300000000	27	043	Faribault County, MN	2016	NA	7346	7024	322	4.4
CN2704500000000	27	045	Fillmore County, MN	2016	NA	11537	11073	464	4
CN2704700000000	27	047	Freeborn County, MN	2016	NA	16340	15717	623	3.8
CN2704900000000	27	049	Goodhue County, MN	2016	NA	26938	25938	1000	3.7
CN2705100000000	27	051	Grant County, MN	2016	NA	3298	3144	154	4.7
CN2705300000000	27	053	Hennepin County, MN	2016	NA	687887	664996	22891	3.3
CN2705500000000	27	055	Houston County, MN	2016	NA	10636	10221	415	3.9
CN2705700000000	27	057	Hubbard County, MN	2016	NA	9827	9191	636	6.5
CN2705900000000	27	059	Isanti County, MN	2016	NA	20744	19778	966	4.7
CN2706100000000	27	061	Itasca County, MN	2016	NA	22098	20214	1884	8.5
CN2706300000000	27	063	Jackson County, MN	2016	NA	6119	5843	276	4.5
CN2706500000000	27	065	Kanabec County, MN	2016	NA	9021	8436	585	6.5
CN2706700000000	27	067	Kandiyohi County, MN	2016	NA	24271	23351	920	3.8
CN2706900000000	27	069	Kittson County, MN	2016	NA	2412	2302	110	4.6
CN2707100000000	27	071	Koochiching County, MN	2016	NA	6183	5659	524	8.5
CN2707300000000	27	073	Lac qui Parle County, MN	2016	NA	3631	3476	155	4.3
CN2707500000000	27	075	Lake County, MN	2016	NA	5435	5090	345	6.3
CN2707700000000	27	077	Lake of the Woods County, MN	2016	NA	2391	2276	115	4.8
CN2707900000000	27	079	Le Sueur County, MN	2016	NA	15611	14850	761	4.9
CN2708100000000	27	081	Lincoln County, MN	2016	NA	3395	3271	124	3.7
CN2708300000000	27	083	Lyon County, MN	2016	NA	15238	14697	541	3.6
CN2708500000000	27	085	McLeod County, MN	2016	NA	19843	18969	874	4.4
CN2708700000000	27	087	Mahnomen County, MN	2016	NA	2397	2259	138	5.8
CN2708900000000	27	089	Marshall County, MN	2016	NA	5636	5225	411	7.3
CN2709100000000	27	091	Martin County, MN	2016	NA	10497	10066	431	4.1
CN2709300000000	27	093	Meeker County, MN	2016	NA	13306	12710	596	4.5
CN2709500000000	27	095	Mille Lacs County, MN	2016	NA	12765	12006	759	5.9
CN2709700000000	27	097	Morrison County, MN	2016	NA	17925	16922	1003	5.6
CN2709900000000	27	099	Mower County, MN	2016	NA	20589	19938	651	3.2
CN2710100000000	27	101	Murray County, MN	2016	NA	4973	4738	235	4.7
CN2710300000000	27	103	Nicollet County, MN	2016	NA	20424	19847	577	2.8
CN2710500000000	27	105	Nobles County, MN	2016	NA	11495	11062	433	3.8
CN2710700000000	27	107	Norman County, MN	2016	NA	3454	3289	165	4.8
CN2710900000000	27	109	Olmsted County, MN	2016	NA	85507	82964	2543	3
CN2711100000000	27	111	Otter Tail County, MN	2016	NA	31400	30036	1364	4.3
CN2711300000000	27	113	Pennington County, MN	2016	NA	9074	8553	521	5.7
CN2711500000000	27	115	Pine County, MN	2016	NA	14887	14020	867	5.8
CN2711700000000	27	117	Pipestone County, MN	2016	NA	4918	4731	187	3.8
CN2711900000000	27	119	Polk County, MN	2016	NA	17205	16459	746	4.3
CN2712100000000	27	121	Pope County, MN	2016	NA	6324	6100	224	3.5
CN2712300000000	27	123	Ramsey County, MN	2016	NA	283359	273167	10192	3.6
CN2712500000000	27	125	Red Lake County, MN	2016	NA	2297	2129	168	7.3
CN2712700000000	27	127	Redwood County, MN	2016	NA	8349	8007	342	4.1
CN2712900000000	27	129	Renville County, MN	2016	NA	8444	8001	443	5.2
CN2713100000000	27	131	Rice County, MN	2016	NA	36228	34960	1268	3.5
CN2713300000000	27	133	Rock County, MN	2016	NA	5930	5793	137	2.3
CN2713500000000	27	135	Roseau County, MN	2016	NA	8276	7854	422	5.1
CN2713700000000	27	137	St. Louis County, MN	2016	NA	102962	97080	5882	5.7
CN2713900000000	27	139	Scott County, MN	2016	NA	80987	78387	2600	3.2
CN2714100000000	27	141	Sherburne County, MN	2016	NA	50867	48801	2066	4.1
CN2714300000000	27	143	Sibley County, MN	2016	NA	8522	8158	364	4.3
CN2714500000000	27	145	Stearns County, MN	2016	NA	89247	85890	3357	3.8
CN2714700000000	27	147	Steele County, MN	2016	NA	21262	20505	757	3.6
CN2714900000000	27	149	Stevens County, MN	2016	NA	5671	5501	170	3
CN2715100000000	27	151	Swift County, MN	2016	NA	5064	4792	272	5.4
CN2715300000000	27	153	Todd County, MN	2016	NA	12951	12342	609	4.7
CN2715500000000	27	155	Traverse County, MN	2016	NA	1713	1646	67	3.9
CN2715700000000	27	157	Wabasha County, MN	2016	NA	12055	11611	444	3.7
CN2715900000000	27	159	Wadena County, MN	2016	NA	6270	5899	371	5.9
CN2716100000000	27	161	Waseca County, MN	2016	NA	9499	9092	407	4.3
CN2716300000000	27	163	Washington County, MN	2016	NA	139295	134651	4644	3.3
CN2716500000000	27	165	Watonwan County, MN	2016	NA	6600	6279	321	4.9
CN2716700000000	27	167	Wilkin County, MN	2016	NA	3733	3612	121	3.2
CN2716900000000	27	169	Winona County, MN	2016	NA	29365	28327	1038	3.5
CN2717100000000	27	171	Wright County, MN	2016	NA	73353	70529	2824	3.8
CN2717300000000	27	173	Yellow Medicine County, MN	2016	NA	5497	5287	210	3.8
CN2800100000000	28	001	Adams County, MS	2016	NA	11258	10331	927	8.2
CN2800300000000	28	003	Alcorn County, MS	2016	NA	15831	15012	819	5.2
CN2800500000000	28	005	Amite County, MS	2016	NA	4512	4182	330	7.3
CN2800700000000	28	007	Attala County, MS	2016	NA	7018	6550	468	6.7
CN2800900000000	28	009	Benton County, MS	2016	NA	3050	2846	204	6.7
CN2801100000000	28	011	Bolivar County, MS	2016	NA	13411	12444	967	7.2
CN2801300000000	28	013	Calhoun County, MS	2016	NA	6189	5859	330	5.3
CN2801500000000	28	015	Carroll County, MS	2016	NA	3566	3308	258	7.2
CN2801700000000	28	017	Chickasaw County, MS	2016	NA	7097	6633	464	6.5
CN2801900000000	28	019	Choctaw County, MS	2016	NA	3729	3519	210	5.6
CN2802100000000	28	021	Claiborne County, MS	2016	NA	3093	2743	350	11.3
CN2802300000000	28	023	Clarke County, MS	2016	NA	6080	5670	410	6.7
CN2802500000000	28	025	Clay County, MS	2016	NA	8024	7375	649	8.1
CN2802700000000	28	027	Coahoma County, MS	2016	NA	9222	8424	798	8.7
CN2802900000000	28	029	Copiah County, MS	2016	NA	11286	10553	733	6.5
CN2803100000000	28	031	Covington County, MS	2016	NA	8161	7719	442	5.4
CN2803300000000	28	033	DeSoto County, MS	2016	NA	87344	83679	3665	4.2
CN2803500000000	28	035	Forrest County, MS	2016	NA	33404	31501	1903	5.7
CN2803700000000	28	037	Franklin County, MS	2016	NA	2855	2651	204	7.1
CN2803900000000	28	039	George County, MS	2016	NA	8818	8168	650	7.4
CN2804100000000	28	041	Greene County, MS	2016	NA	4289	3978	311	7.3
CN2804300000000	28	043	Grenada County, MS	2016	NA	9615	9125	490	5.1
CN2804500000000	28	045	Hancock County, MS	2016	NA	18885	17740	1145	6.1
CN2804700000000	28	047	Harrison County, MS	2016	NA	86791	82022	4769	5.5
CN2804900000000	28	049	Hinds County, MS	2016	NA	110065	104105	5960	5.4
CN2805100000000	28	051	Holmes County, MS	2016	NA	5981	5326	655	11
CN2805300000000	28	053	Humphreys County, MS	2016	NA	2375	2105	270	11.4
CN2805500000000	28	055	Issaquena County, MS	2016	NA	401	345	56	14
CN2805700000000	28	057	Itawamba County, MS	2016	NA	10409	9884	525	5
CN2805900000000	28	059	Jackson County, MS	2016	NA	59142	55271	3871	6.5
CN2806100000000	28	061	Jasper County, MS	2016	NA	6196	5723	473	7.6
CN2806300000000	28	063	Jefferson County, MS	2016	NA	2228	1897	331	14.9
CN2806500000000	28	065	Jefferson Davis County, MS	2016	NA	4183	3840	343	8.2
CN2806700000000	28	067	Jones County, MS	2016	NA	25811	24239	1572	6.1
CN2806900000000	28	069	Kemper County, MS	2016	NA	3556	3247	309	8.7
CN2807100000000	28	071	Lafayette County, MS	2016	NA	26008	24746	1262	4.9
CN2807300000000	28	073	Lamar County, MS	2016	NA	29627	28288	1339	4.5
CN2807500000000	28	075	Lauderdale County, MS	2016	NA	31802	29942	1860	5.8
CN2807700000000	28	077	Lawrence County, MS	2016	NA	4679	4347	332	7.1
CN2807900000000	28	079	Leake County, MS	2016	NA	7759	7291	468	6
CN2808100000000	28	081	Lee County, MS	2016	NA	40839	38861	1978	4.8
CN2808300000000	28	083	Leflore County, MS	2016	NA	10340	9406	934	9
CN2808500000000	28	085	Lincoln County, MS	2016	NA	14433	13616	817	5.7
CN2808700000000	28	087	Lowndes County, MS	2016	NA	25535	23975	1560	6.1
CN2808900000000	28	089	Madison County, MS	2016	NA	53406	51114	2292	4.3
CN2809100000000	28	091	Marion County, MS	2016	NA	10271	9601	670	6.5
CN2809300000000	28	093	Marshall County, MS	2016	NA	14566	13692	874	6
CN2809500000000	28	095	Monroe County, MS	2016	NA	15648	14666	982	6.3
CN2809700000000	28	097	Montgomery County, MS	2016	NA	4240	3970	270	6.4
CN2809900000000	28	099	Neshoba County, MS	2016	NA	10708	10095	613	5.7
CN2810100000000	28	101	Newton County, MS	2016	NA	8647	8140	507	5.9
CN2810300000000	28	103	Noxubee County, MS	2016	NA	3967	3640	327	8.2
CN2810500000000	28	105	Oktibbeha County, MS	2016	NA	23069	21823	1246	5.4
CN2810700000000	28	107	Panola County, MS	2016	NA	13192	12226	966	7.3
CN2810900000000	28	109	Pearl River County, MS	2016	NA	23234	21853	1381	5.9
CN2811100000000	28	111	Perry County, MS	2016	NA	4360	4050	310	7.1
CN2811300000000	28	113	Pike County, MS	2016	NA	14681	13689	992	6.8
CN2811500000000	28	115	Pontotoc County, MS	2016	NA	14446	13766	680	4.7
CN2811700000000	28	117	Prentiss County, MS	2016	NA	11069	10468	601	5.4
CN2811900000000	28	119	Quitman County, MS	2016	NA	2618	2364	254	9.7
CN2812100000000	28	121	Rankin County, MS	2016	NA	74995	72044	2951	3.9
CN2812300000000	28	123	Scott County, MS	2016	NA	13271	12665	606	4.6
CN2812500000000	28	125	Sharkey County, MS	2016	NA	1715	1565	150	8.7
CN2812700000000	28	127	Simpson County, MS	2016	NA	10939	10347	592	5.4
CN2812900000000	28	129	Smith County, MS	2016	NA	6742	6389	353	5.2
CN2813100000000	28	131	Stone County, MS	2016	NA	6497	6062	435	6.7
CN2813300000000	28	133	Sunflower County, MS	2016	NA	8344	7572	772	9.3
CN2813500000000	28	135	Tallahatchie County, MS	2016	NA	5740	5352	388	6.8
CN2813700000000	28	137	Tate County, MS	2016	NA	12089	11385	704	5.8
CN2813900000000	28	139	Tippah County, MS	2016	NA	9403	8883	520	5.5
CN2814100000000	28	141	Tishomingo County, MS	2016	NA	8261	7810	451	5.5
CN2814300000000	28	143	Tunica County, MS	2016	NA	4611	4285	326	7.1
CN2814500000000	28	145	Union County, MS	2016	NA	13668	13067	601	4.4
CN2814700000000	28	147	Walthall County, MS	2016	NA	5039	4652	387	7.7
CN2814900000000	28	149	Warren County, MS	2016	NA	20820	19508	1312	6.3
CN2815100000000	28	151	Washington County, MS	2016	NA	17768	16177	1591	9
CN2815300000000	28	153	Wayne County, MS	2016	NA	7540	6991	549	7.3
CN2815500000000	28	155	Webster County, MS	2016	NA	3907	3665	242	6.2
CN2815700000000	28	157	Wilkinson County, MS	2016	NA	2836	2549	287	10.1
CN2815900000000	28	159	Winston County, MS	2016	NA	7110	6608	502	7.1
CN2816100000000	28	161	Yalobusha County, MS	2016	NA	4889	4584	305	6.2
CN2816300000000	28	163	Yazoo County, MS	2016	NA	9252	8572	680	7.3
CN2900100000000	29	001	Adair County, MO	2016	NA	10388	9798	590	5.7
CN2900300000000	29	003	Andrew County, MO	2016	NA	10048	9674	374	3.7
CN2900500000000	29	005	Atchison County, MO	2016	NA	2846	2716	130	4.6
CN2900700000000	29	007	Audrain County, MO	2016	NA	11151	10677	474	4.3
CN2900900000000	29	009	Barry County, MO	2016	NA	15217	14533	684	4.5
CN2901100000000	29	011	Barton County, MO	2016	NA	5328	5049	279	5.2
CN2901300000000	29	013	Bates County, MO	2016	NA	8169	7732	437	5.3
CN2901500000000	29	015	Benton County, MO	2016	NA	7268	6828	440	6.1
CN2901700000000	29	017	Bollinger County, MO	2016	NA	5469	5182	287	5.2
CN2901900000000	29	019	Boone County, MO	2016	NA	98313	95073	3240	3.3
CN2902100000000	29	021	Buchanan County, MO	2016	NA	46769	44857	1912	4.1
CN2902300000000	29	023	Butler County, MO	2016	NA	18826	17748	1078	5.7
CN2902500000000	29	025	Caldwell County, MO	2016	NA	4481	4270	211	4.7
CN2902700000000	29	027	Callaway County, MO	2016	NA	21860	20962	898	4.1
CN2902900000000	29	029	Camden County, MO	2016	NA	18751	17664	1087	5.8
CN2903100000000	29	031	Cape Girardeau County, MO	2016	NA	40824	39053	1771	4.3
CN2903300000000	29	033	Carroll County, MO	2016	NA	4776	4519	257	5.4
CN2903500000000	29	035	Carter County, MO	2016	NA	2547	2366	181	7.1
CN2903700000000	29	037	Cass County, MO	2016	NA	54599	52331	2268	4.2
CN2903900000000	29	039	Cedar County, MO	2016	NA	5806	5516	290	5
CN2904100000000	29	041	Chariton County, MO	2016	NA	3862	3694	168	4.4
CN2904300000000	29	043	Christian County, MO	2016	NA	43426	41721	1705	3.9
CN2904500000000	29	045	Clark County, MO	2016	NA	3375	3127	248	7.3
CN2904700000000	29	047	Clay County, MO	2016	NA	134218	128981	5237	3.9
CN2904900000000	29	049	Clinton County, MO	2016	NA	11029	10563	466	4.2
CN2905100000000	29	051	Cole County, MO	2016	NA	39488	38081	1407	3.6
CN2905300000000	29	053	Cooper County, MO	2016	NA	7494	7125	369	4.9
CN2905500000000	29	055	Crawford County, MO	2016	NA	10846	10266	580	5.3
CN2905700000000	29	057	Dade County, MO	2016	NA	3591	3431	160	4.5
CN2905900000000	29	059	Dallas County, MO	2016	NA	6967	6584	383	5.5
CN2906100000000	29	061	Daviess County, MO	2016	NA	4122	3963	159	3.9
CN2906300000000	29	063	DeKalb County, MO	2016	NA	5092	4869	223	4.4
CN2906500000000	29	065	Dent County, MO	2016	NA	6213	5878	335	5.4
CN2906700000000	29	067	Douglas County, MO	2016	NA	5089	4780	309	6.1
CN2906900000000	29	069	Dunklin County, MO	2016	NA	12857	11798	1059	8.2
CN2907100000000	29	071	Franklin County, MO	2016	NA	52756	50453	2303	4.4
CN2907300000000	29	073	Gasconade County, MO	2016	NA	7712	7380	332	4.3
CN2907500000000	29	075	Gentry County, MO	2016	NA	3594	3460	134	3.7
CN2907700000000	29	077	Greene County, MO	2016	NA	148822	143173	5649	3.8
CN2907900000000	29	079	Grundy County, MO	2016	NA	4910	4686	224	4.6
CN2908100000000	29	081	Harrison County, MO	2016	NA	3979	3811	168	4.2
CN2908300000000	29	083	Henry County, MO	2016	NA	9907	9412	495	5
CN2908500000000	29	085	Hickory County, MO	2016	NA	3701	3493	208	5.6
CN2908700000000	29	087	Holt County, MO	2016	NA	2689	2602	87	3.2
CN2908900000000	29	089	Howard County, MO	2016	NA	5038	4815	223	4.4
CN2909100000000	29	091	Howell County, MO	2016	NA	16143	15118	1025	6.3
CN2909300000000	29	093	Iron County, MO	2016	NA	3721	3454	267	7.2
CN2909500000000	29	095	Jackson County, MO	2016	NA	364782	346091	18691	5.1
CN2909700000000	29	097	Jasper County, MO	2016	NA	57829	55422	2407	4.2
CN2909900000000	29	099	Jefferson County, MO	2016	NA	117823	112753	5070	4.3
CN2910100000000	29	101	Johnson County, MO	2016	NA	23221	22081	1140	4.9
CN2910300000000	29	103	Knox County, MO	2016	NA	1987	1915	72	3.6
CN2910500000000	29	105	Laclede County, MO	2016	NA	16186	15303	883	5.5
CN2910700000000	29	107	Lafayette County, MO	2016	NA	17219	16476	743	4.3
CN2910900000000	29	109	Lawrence County, MO	2016	NA	17815	17036	779	4.4
CN2911100000000	29	111	Lewis County, MO	2016	NA	5146	4913	233	4.5
CN2911300000000	29	113	Lincoln County, MO	2016	NA	27271	26047	1224	4.5
CN2911500000000	29	115	Linn County, MO	2016	NA	5282	4927	355	6.7
CN2911700000000	29	117	Livingston County, MO	2016	NA	7362	7074	288	3.9
CN2911900000000	29	119	McDonald County, MO	2016	NA	10492	10036	456	4.3
CN2912100000000	29	121	Macon County, MO	2016	NA	7626	7262	364	4.8
CN2912300000000	29	123	Madison County, MO	2016	NA	5487	5185	302	5.5
CN2912500000000	29	125	Maries County, MO	2016	NA	3916	3719	197	5
CN2912700000000	29	127	Marion County, MO	2016	NA	14597	13972	625	4.3
CN2912900000000	29	129	Mercer County, MO	2016	NA	1932	1843	89	4.6
CN2913100000000	29	131	Miller County, MO	2016	NA	11902	11286	616	5.2
CN2913300000000	29	133	Mississippi County, MO	2016	NA	6225	5812	413	6.6
CN2913500000000	29	135	Moniteau County, MO	2016	NA	7483	7158	325	4.3
CN2913700000000	29	137	Monroe County, MO	2016	NA	4169	3967	202	4.8
CN2913900000000	29	139	Montgomery County, MO	2016	NA	5758	5495	263	4.6
CN2914100000000	29	141	Morgan County, MO	2016	NA	7980	7511	469	5.9
CN2914300000000	29	143	New Madrid County, MO	2016	NA	8256	7488	768	9.3
CN2914500000000	29	145	Newton County, MO	2016	NA	28266	27031	1235	4.4
CN2914700000000	29	147	Nodaway County, MO	2016	NA	10869	10361	508	4.7
CN2914900000000	29	149	Oregon County, MO	2016	NA	4121	3874	247	6
CN2915100000000	29	151	Osage County, MO	2016	NA	7238	6992	246	3.4
CN2915300000000	29	153	Ozark County, MO	2016	NA	3636	3372	264	7.3
CN2915500000000	29	155	Pemiscot County, MO	2016	NA	7044	6418	626	8.9
CN2915700000000	29	157	Perry County, MO	2016	NA	10095	9735	360	3.6
CN2915900000000	29	159	Pettis County, MO	2016	NA	20659	19639	1020	4.9
CN2916100000000	29	161	Phelps County, MO	2016	NA	19539	18610	929	4.8
CN2916300000000	29	163	Pike County, MO	2016	NA	8078	7714	364	4.5
CN2916500000000	29	165	Platte County, MO	2016	NA	56800	54742	2058	3.6
CN2916700000000	29	167	Polk County, MO	2016	NA	14245	13551	694	4.9
CN2916900000000	29	169	Pulaski County, MO	2016	NA	14501	13713	788	5.4
CN2917100000000	29	171	Putnam County, MO	2016	NA	2458	2346	112	4.6
CN2917300000000	29	173	Ralls County, MO	2016	NA	5636	5409	227	4
CN2917500000000	29	175	Randolph County, MO	2016	NA	10511	9959	552	5.3
CN2917700000000	29	177	Ray County, MO	2016	NA	11165	10615	550	4.9
CN2917900000000	29	179	Reynolds County, MO	2016	NA	2687	2513	174	6.5
CN2918100000000	29	181	Ripley County, MO	2016	NA	5345	4967	378	7.1
CN2918300000000	29	183	St. Charles County, MO	2016	NA	221494	213718	7776	3.5
CN2918500000000	29	185	St. Clair County, MO	2016	NA	3923	3677	246	6.3
CN2918600000000	29	186	Ste. Genevieve County, MO	2016	NA	9004	8585	419	4.7
CN2918700000000	29	187	St. Francois County, MO	2016	NA	26283	24834	1449	5.5
CN2918900000000	29	189	St. Louis County, MO	2016	NA	532537	510089	22448	4.2
CN2919500000000	29	195	Saline County, MO	2016	NA	10756	10254	502	4.7
CN2919700000000	29	197	Schuyler County, MO	2016	NA	1909	1788	121	6.3
CN2919900000000	29	199	Scotland County, MO	2016	NA	2459	2357	102	4.1
CN2920100000000	29	201	Scott County, MO	2016	NA	20005	18859	1146	5.7
CN2920300000000	29	203	Shannon County, MO	2016	NA	3332	3087	245	7.4
CN2920500000000	29	205	Shelby County, MO	2016	NA	3076	2947	129	4.2
CN2920700000000	29	207	Stoddard County, MO	2016	NA	13321	12468	853	6.4
CN2920900000000	29	209	Stone County, MO	2016	NA	13449	12509	940	7
CN2921100000000	29	211	Sullivan County, MO	2016	NA	2776	2616	160	5.8
CN2921300000000	29	213	Taney County, MO	2016	NA	26370	24422	1948	7.4
CN2921500000000	29	215	Texas County, MO	2016	NA	9338	8753	585	6.3
CN2921700000000	29	217	Vernon County, MO	2016	NA	9624	9157	467	4.9
CN2921900000000	29	219	Warren County, MO	2016	NA	17526	16793	733	4.2
CN2922100000000	29	221	Washington County, MO	2016	NA	10359	9702	657	6.3
CN2922300000000	29	223	Wayne County, MO	2016	NA	5668	5365	303	5.3
CN2922500000000	29	225	Webster County, MO	2016	NA	16929	16096	833	4.9
CN2922700000000	29	227	Worth County, MO	2016	NA	1213	1177	36	3
CN2922900000000	29	229	Wright County, MO	2016	NA	7616	7165	451	5.9
CN2951000000000	29	510	St. Louis city, MO	2016	NA	157649	149054	8595	5.5
CN3000100000000	30	001	Beaverhead County, MT	2016	NA	5077	4909	168	3.3
CN3000300000000	30	003	Big Horn County, MT	2016	NA	5540	5139	401	7.2
CN3000500000000	30	005	Blaine County, MT	2016	NA	2372	2264	108	4.6
CN3000700000000	30	007	Broadwater County, MT	2016	NA	2553	2428	125	4.9
CN3000900000000	30	009	Carbon County, MT	2016	NA	5426	5212	214	3.9
CN3001100000000	30	011	Carter County, MT	2016	NA	697	678	19	2.7
CN3001300000000	30	013	Cascade County, MT	2016	NA	37838	36336	1502	4
CN3001500000000	30	015	Chouteau County, MT	2016	NA	2516	2422	94	3.7
CN3001700000000	30	017	Custer County, MT	2016	NA	6246	6026	220	3.5
CN3001900000000	30	019	Daniels County, MT	2016	NA	936	912	24	2.6
CN3002100000000	30	021	Dawson County, MT	2016	NA	4608	4431	177	3.8
CN3002300000000	30	023	Deer Lodge County, MT	2016	NA	5304	5103	201	3.8
CN3002500000000	30	025	Fallon County, MT	2016	NA	1814	1748	66	3.6
CN3002700000000	30	027	Fergus County, MT	2016	NA	5772	5545	227	3.9
CN3002900000000	30	029	Flathead County, MT	2016	NA	46004	43436	2568	5.6
CN3003100000000	30	031	Gallatin County, MT	2016	NA	62187	60437	1750	2.8
CN3003300000000	30	033	Garfield County, MT	2016	NA	765	743	22	2.9
CN3003500000000	30	035	Glacier County, MT	2016	NA	5824	5327	497	8.5
CN3003700000000	30	037	Golden Valley County, MT	2016	NA	379	362	17	4.5
CN3003900000000	30	039	Granite County, MT	2016	NA	1633	1537	96	5.9
CN3004100000000	30	041	Hill County, MT	2016	NA	7808	7471	337	4.3
CN3004300000000	30	043	Jefferson County, MT	2016	NA	5676	5415	261	4.6
CN3004500000000	30	045	Judith Basin County, MT	2016	NA	934	902	32	3.4
CN3004700000000	30	047	Lake County, MT	2016	NA	13094	12474	620	4.7
CN3004900000000	30	049	Lewis and Clark County, MT	2016	NA	35230	34067	1163	3.3
CN3005100000000	30	051	Liberty County, MT	2016	NA	990	959	31	3.1
CN3005300000000	30	053	Lincoln County, MT	2016	NA	7938	7223	715	9
CN3005500000000	30	055	McCone County, MT	2016	NA	1044	1024	20	1.9
CN3005700000000	30	057	Madison County, MT	2016	NA	4418	4251	167	3.8
CN3005900000000	30	059	Meagher County, MT	2016	NA	917	880	37	4
CN3006100000000	30	061	Mineral County, MT	2016	NA	1688	1560	128	7.6
CN3006300000000	30	063	Missoula County, MT	2016	NA	61457	59156	2301	3.7
CN3006500000000	30	065	Musselshell County, MT	2016	NA	2297	2179	118	5.1
CN3006700000000	30	067	Park County, MT	2016	NA	8417	8057	360	4.3
CN3006900000000	30	069	Petroleum County, MT	2016	NA	278	265	13	4.7
CN3007100000000	30	071	Phillips County, MT	2016	NA	1938	1835	103	5.3
CN3007300000000	30	073	Pondera County, MT	2016	NA	2868	2747	121	4.2
CN3007500000000	30	075	Powder River County, MT	2016	NA	1068	1043	25	2.3
CN3007700000000	30	077	Powell County, MT	2016	NA	2870	2726	144	5
CN3007900000000	30	079	Prairie County, MT	2016	NA	527	509	18	3.4
CN3008100000000	30	081	Ravalli County, MT	2016	NA	19593	18653	940	4.8
CN3008300000000	30	083	Richland County, MT	2016	NA	6219	5911	308	5
CN3008500000000	30	085	Roosevelt County, MT	2016	NA	4692	4442	250	5.3
CN3008700000000	30	087	Rosebud County, MT	2016	NA	4111	3886	225	5.5
CN3008900000000	30	089	Sanders County, MT	2016	NA	4759	4391	368	7.7
CN3009100000000	30	091	Sheridan County, MT	2016	NA	1962	1898	64	3.3
CN3009300000000	30	093	Silver Bow County, MT	2016	NA	17208	16472	736	4.3
CN3009500000000	30	095	Stillwater County, MT	2016	NA	4815	4624	191	4
CN3009700000000	30	097	Sweet Grass County, MT	2016	NA	1799	1743	56	3.1
CN3009900000000	30	099	Teton County, MT	2016	NA	2832	2730	102	3.6
CN3010100000000	30	101	Toole County, MT	2016	NA	2228	2151	77	3.5
CN3010300000000	30	103	Treasure County, MT	2016	NA	353	338	15	4.2
CN3010500000000	30	105	Valley County, MT	2016	NA	4408	4259	149	3.4
CN3010700000000	30	107	Wheatland County, MT	2016	NA	797	757	40	5
CN3010900000000	30	109	Wibaux County, MT	2016	NA	513	493	20	3.9
CN3011100000000	30	111	Yellowstone County, MT	2016	NA	81264	78343	2921	3.6
CN3100100000000	31	001	Adams County, NE	2016	NA	16637	16116	521	3.1
CN3100300000000	31	003	Antelope County, NE	2016	NA	3589	3495	94	2.6
CN3100500000000	31	005	Arthur County, NE	2016	NA	227	214	13	5.7
CN3100700000000	31	007	Banner County, NE	2016	NA	416	402	14	3.4
CN3100900000000	31	009	Blaine County, NE	2016	NA	264	253	11	4.2
CN3101100000000	31	011	Boone County, NE	2016	NA	3000	2921	79	2.6
CN3101300000000	31	013	Box Butte County, NE	2016	NA	5638	5435	203	3.6
CN3101500000000	31	015	Boyd County, NE	2016	NA	1098	1065	33	3
CN3101700000000	31	017	Brown County, NE	2016	NA	1378	1328	50	3.6
CN3101900000000	31	019	Buffalo County, NE	2016	NA	27185	26504	681	2.5
CN3102100000000	31	021	Burt County, NE	2016	NA	3542	3412	130	3.7
CN3102300000000	31	023	Butler County, NE	2016	NA	4620	4472	148	3.2
CN3102500000000	31	025	Cass County, NE	2016	NA	13128	12687	441	3.4
CN3102700000000	31	027	Cedar County, NE	2016	NA	4564	4448	116	2.5
CN3102900000000	31	029	Chase County, NE	2016	NA	2289	2242	47	2.1
CN3103100000000	31	031	Cherry County, NE	2016	NA	3467	3389	78	2.2
CN3103300000000	31	033	Cheyenne County, NE	2016	NA	5445	5292	153	2.8
CN3103500000000	31	035	Clay County, NE	2016	NA	3318	3215	103	3.1
CN3103700000000	31	037	Colfax County, NE	2016	NA	5544	5387	157	2.8
CN3103900000000	31	039	Cuming County, NE	2016	NA	4711	4575	136	2.9
CN3104100000000	31	041	Custer County, NE	2016	NA	6345	6196	149	2.3
CN3104300000000	31	043	Dakota County, NE	2016	NA	10895	10443	452	4.1
CN3104500000000	31	045	Dawes County, NE	2016	NA	5208	5054	154	3
CN3104700000000	31	047	Dawson County, NE	2016	NA	12949	12566	383	3
CN3104900000000	31	049	Deuel County, NE	2016	NA	1059	1032	27	2.5
CN3105100000000	31	051	Dixon County, NE	2016	NA	3065	2964	101	3.3
CN3105300000000	31	053	Dodge County, NE	2016	NA	19107	18521	586	3.1
CN3105500000000	31	055	Douglas County, NE	2016	NA	287660	278127	9533	3.3
CN3105700000000	31	057	Dundy County, NE	2016	NA	1194	1168	26	2.2
CN3105900000000	31	059	Fillmore County, NE	2016	NA	3180	3092	88	2.8
CN3106100000000	31	061	Franklin County, NE	2016	NA	1499	1454	45	3
CN3106300000000	31	063	Frontier County, NE	2016	NA	1568	1524	44	2.8
CN3106500000000	31	065	Furnas County, NE	2016	NA	2711	2636	75	2.8
CN3106700000000	31	067	Gage County, NE	2016	NA	11036	10675	361	3.3
CN3106900000000	31	069	Garden County, NE	2016	NA	1186	1147	39	3.3
CN3107100000000	31	071	Garfield County, NE	2016	NA	1154	1125	29	2.5
CN3107300000000	31	073	Gosper County, NE	2016	NA	1055	1028	27	2.6
CN3107500000000	31	075	Grant County, NE	2016	NA	452	442	10	2.2
CN3107700000000	31	077	Greeley County, NE	2016	NA	1232	1194	38	3.1
CN3107900000000	31	079	Hall County, NE	2016	NA	31371	30221	1150	3.7
CN3108100000000	31	081	Hamilton County, NE	2016	NA	4647	4518	129	2.8
CN3108300000000	31	083	Harlan County, NE	2016	NA	1755	1711	44	2.5
CN3108500000000	31	085	Hayes County, NE	2016	NA	589	575	14	2.4
CN3108700000000	31	087	Hitchcock County, NE	2016	NA	1304	1257	47	3.6
CN3108900000000	31	089	Holt County, NE	2016	NA	5852	5708	144	2.5
CN3109100000000	31	091	Hooker County, NE	2016	NA	391	377	14	3.6
CN3109300000000	31	093	Howard County, NE	2016	NA	3296	3187	109	3.3
CN3109500000000	31	095	Jefferson County, NE	2016	NA	4216	4115	101	2.4
CN3109700000000	31	097	Johnson County, NE	2016	NA	2089	2023	66	3.2
CN3109900000000	31	099	Kearney County, NE	2016	NA	3736	3648	88	2.4
CN3110100000000	31	101	Keith County, NE	2016	NA	4611	4478	133	2.9
CN3110300000000	31	103	Keya Paha County, NE	2016	NA	619	606	13	2.1
CN3110500000000	31	105	Kimball County, NE	2016	NA	1969	1889	80	4.1
CN3110700000000	31	107	Knox County, NE	2016	NA	4714	4570	144	3.1
CN3110900000000	31	109	Lancaster County, NE	2016	NA	168830	164151	4679	2.8
CN3111100000000	31	111	Lincoln County, NE	2016	NA	18687	18113	574	3.1
CN3111300000000	31	113	Logan County, NE	2016	NA	483	469	14	2.9
CN3111500000000	31	115	Loup County, NE	2016	NA	396	382	14	3.5
CN3111700000000	31	117	McPherson County, NE	2016	NA	463	452	11	2.4
CN3111900000000	31	119	Madison County, NE	2016	NA	19136	18610	526	2.7
CN3112100000000	31	121	Merrick County, NE	2016	NA	4029	3884	145	3.6
CN3112300000000	31	123	Morrill County, NE	2016	NA	2645	2561	84	3.2
CN3112500000000	31	125	Nance County, NE	2016	NA	1997	1942	55	2.8
CN3112700000000	31	127	Nemaha County, NE	2016	NA	3612	3481	131	3.6
CN3112900000000	31	129	Nuckolls County, NE	2016	NA	2363	2295	68	2.9
CN3113100000000	31	131	Otoe County, NE	2016	NA	8251	7971	280	3.4
CN3113300000000	31	133	Pawnee County, NE	2016	NA	1651	1614	37	2.2
CN3113500000000	31	135	Perkins County, NE	2016	NA	1817	1778	39	2.1
CN3113700000000	31	137	Phelps County, NE	2016	NA	4923	4800	123	2.5
CN3113900000000	31	139	Pierce County, NE	2016	NA	4141	4032	109	2.6
CN3114100000000	31	141	Platte County, NE	2016	NA	16953	16364	589	3.5
CN3114300000000	31	143	Polk County, NE	2016	NA	2878	2802	76	2.6
CN3114500000000	31	145	Red Willow County, NE	2016	NA	5968	5800	168	2.8
CN3114700000000	31	147	Richardson County, NE	2016	NA	4233	4096	137	3.2
CN3114900000000	31	149	Rock County, NE	2016	NA	890	867	23	2.6
CN3115100000000	31	151	Saline County, NE	2016	NA	7341	7115	226	3.1
CN3115300000000	31	153	Sarpy County, NE	2016	NA	91943	89269	2674	2.9
CN3115500000000	31	155	Saunders County, NE	2016	NA	10860	10527	333	3.1
CN3115700000000	31	157	Scotts Bluff County, NE	2016	NA	18821	18164	657	3.5
CN3115900000000	31	159	Seward County, NE	2016	NA	8743	8493	250	2.9
CN3116100000000	31	161	Sheridan County, NE	2016	NA	2735	2657	78	2.9
CN3116300000000	31	163	Sherman County, NE	2016	NA	1715	1660	55	3.2
CN3116500000000	31	165	Sioux County, NE	2016	NA	783	762	21	2.7
CN3116700000000	31	167	Stanton County, NE	2016	NA	3437	3347	90	2.6
CN3116900000000	31	169	Thayer County, NE	2016	NA	2900	2829	71	2.4
CN3117100000000	31	171	Thomas County, NE	2016	NA	448	433	15	3.3
CN3117300000000	31	173	Thurston County, NE	2016	NA	2976	2832	144	4.8
CN3117500000000	31	175	Valley County, NE	2016	NA	2089	2031	58	2.8
CN3117700000000	31	177	Washington County, NE	2016	NA	11093	10739	354	3.2
CN3117900000000	31	179	Wayne County, NE	2016	NA	5617	5468	149	2.7
CN3118100000000	31	181	Webster County, NE	2016	NA	1711	1657	54	3.2
CN3118300000000	31	183	Wheeler County, NE	2016	NA	565	553	12	2.1
CN3118500000000	31	185	York County, NE	2016	NA	7314	7117	197	2.7
CN3200100000000	32	001	Churchill County, NV	2016	NA	10385	9810	575	5.5
CN3200300000000	32	003	Clark County, NV	2016	NA	1048544	987517	61027	5.8
CN3200500000000	32	005	Douglas County, NV	2016	NA	22243	20995	1248	5.6
CN3200700000000	32	007	Elko County, NV	2016	NA	26924	25724	1200	4.5
CN3200900000000	32	009	Esmeralda County, NV	2016	NA	515	491	24	4.7
CN3201100000000	32	011	Eureka County, NV	2016	NA	988	943	45	4.6
CN3201300000000	32	013	Humboldt County, NV	2016	NA	8052	7612	440	5.5
CN3201500000000	32	015	Lander County, NV	2016	NA	3130	2935	195	6.2
CN3201700000000	32	017	Lincoln County, NV	2016	NA	1985	1880	105	5.3
CN3201900000000	32	019	Lyon County, NV	2016	NA	21267	19674	1593	7.5
CN3202100000000	32	021	Mineral County, NV	2016	NA	2011	1883	128	6.4
CN3202300000000	32	023	Nye County, NV	2016	NA	16025	14852	1173	7.3
CN3202700000000	32	027	Pershing County, NV	2016	NA	2458	2313	145	5.9
CN3202900000000	32	029	Storey County, NV	2016	NA	1906	1786	120	6.3
CN3203100000000	32	031	Washoe County, NV	2016	NA	229817	218347	11470	5
CN3203300000000	32	033	White Pine County, NV	2016	NA	4484	4276	208	4.6
CN3251000000000	32	510	Carson City, NV	2016	NA	24721	23222	1499	6.1
CN3300100000000	33	001	Belknap County, NH	2016	NA	31386	30496	890	2.8
CN3300300000000	33	003	Carroll County, NH	2016	NA	23672	22974	698	2.9
CN3300500000000	33	005	Cheshire County, NH	2016	NA	41402	40269	1133	2.7
CN3300700000000	33	007	Coos County, NH	2016	NA	14642	14090	552	3.8
CN3300900000000	33	009	Grafton County, NH	2016	NA	48748	47596	1152	2.4
CN3301100000000	33	011	Hillsborough County, NH	2016	NA	232001	224981	7020	3
CN3301300000000	33	013	Merrimack County, NH	2016	NA	81926	79835	2091	2.6
CN3301500000000	33	015	Rockingham County, NH	2016	NA	181713	176210	5503	3
CN3301700000000	33	017	Strafford County, NH	2016	NA	72417	70572	1845	2.5
CN3301900000000	33	019	Sullivan County, NH	2016	NA	23593	23044	549	2.3
CN3400100000000	34	001	Atlantic County, NJ	2016	NA	122411	113320	9091	7.4
CN3400300000000	34	003	Bergen County, NJ	2016	NA	478906	458863	20043	4.2
CN3400500000000	34	005	Burlington County, NJ	2016	NA	229949	219677	10272	4.5
CN3400700000000	34	007	Camden County, NJ	2016	NA	252368	238479	13889	5.5
CN3400900000000	34	009	Cape May County, NJ	2016	NA	46601	42016	4585	9.8
CN3401100000000	34	011	Cumberland County, NJ	2016	NA	66246	61285	4961	7.5
CN3401300000000	34	013	Essex County, NJ	2016	NA	368262	346140	22122	6
CN3401500000000	34	015	Gloucester County, NJ	2016	NA	148764	141227	7537	5.1
CN3401700000000	34	017	Hudson County, NJ	2016	NA	359225	342429	16796	4.7
CN3401900000000	34	019	Hunterdon County, NJ	2016	NA	64277	61855	2422	3.8
CN3402100000000	34	021	Mercer County, NJ	2016	NA	198103	189516	8587	4.3
CN3402300000000	34	023	Middlesex County, NJ	2016	NA	435237	415904	19333	4.4
CN3402500000000	34	025	Monmouth County, NJ	2016	NA	325773	311239	14534	4.5
CN3402700000000	34	027	Morris County, NJ	2016	NA	258177	248057	10120	3.9
CN3402900000000	34	029	Ocean County, NJ	2016	NA	267316	253333	13983	5.2
CN3403100000000	34	031	Passaic County, NJ	2016	NA	243597	228552	15045	6.2
CN3403300000000	34	033	Salem County, NJ	2016	NA	29970	28051	1919	6.4
CN3403500000000	34	035	Somerset County, NJ	2016	NA	172080	165098	6982	4.1
CN3403700000000	34	037	Sussex County, NJ	2016	NA	74843	71312	3531	4.7
CN3403900000000	34	039	Union County, NJ	2016	NA	275373	261137	14236	5.2
CN3404100000000	34	041	Warren County, NJ	2016	NA	56302	53719	2583	4.6
CN3500100000000	35	001	Bernalillo County, NM	2016	NA	326722	307963	18759	5.7
CN3500300000000	35	003	Catron County, NM	2016	NA	1204	1108	96	8
CN3500500000000	35	005	Chaves County, NM	2016	NA	28031	26172	1859	6.6
CN3500600000000	35	006	Cibola County, NM	2016	NA	9300	8546	754	8.1
CN3500700000000	35	007	Colfax County, NM	2016	NA	5828	5482	346	5.9
CN3500900000000	35	009	Curry County, NM	2016	NA	21969	20872	1097	5
CN3501100000000	35	011	De Baca County, NM	2016	NA	833	794	39	4.7
CN3501300000000	35	013	Dona Ana County, NM	2016	NA	95598	88827	6771	7.1
CN3501500000000	35	015	Eddy County, NM	2016	NA	28685	26843	1842	6.4
CN3501700000000	35	017	Grant County, NM	2016	NA	12460	11666	794	6.4
CN3501900000000	35	019	Guadalupe County, NM	2016	NA	1691	1583	108	6.4
CN3502100000000	35	021	Harding County, NM	2016	NA	277	258	19	6.9
CN3502300000000	35	023	Hidalgo County, NM	2016	NA	2202	2082	120	5.4
CN3502500000000	35	025	Lea County, NM	2016	NA	27727	25200	2527	9.1
CN3502700000000	35	027	Lincoln County, NM	2016	NA	8641	8133	508	5.9
CN3502800000000	35	028	Los Alamos County, NM	2016	NA	8797	8429	368	4.2
CN3502900000000	35	029	Luna County, NM	2016	NA	10771	9225	1546	14.4
CN3503100000000	35	031	McKinley County, NM	2016	NA	24375	22120	2255	9.3
CN3503300000000	35	033	Mora County, NM	2016	NA	2237	2044	193	8.6
CN3503500000000	35	035	Otero County, NM	2016	NA	25473	23949	1524	6
CN3503700000000	35	037	Quay County, NM	2016	NA	3210	2994	216	6.7
CN3503900000000	35	039	Rio Arriba County, NM	2016	NA	16756	15519	1237	7.4
CN3504100000000	35	041	Roosevelt County, NM	2016	NA	8068	7613	455	5.6
CN3504300000000	35	043	Sandoval County, NM	2016	NA	64093	59921	4172	6.5
CN3504500000000	35	045	San Juan County, NM	2016	NA	54211	49510	4701	8.7
CN3504700000000	35	047	San Miguel County, NM	2016	NA	11088	10245	843	7.6
CN3504900000000	35	049	Santa Fe County, NM	2016	NA	73496	69657	3839	5.2
CN3505100000000	35	051	Sierra County, NM	2016	NA	4060	3721	339	8.3
CN3505300000000	35	053	Socorro County, NM	2016	NA	6678	6194	484	7.2
CN3505500000000	35	055	Taos County, NM	2016	NA	14937	13694	1243	8.3
CN3505700000000	35	057	Torrance County, NM	2016	NA	5506	5010	496	9
CN3505900000000	35	059	Union County, NM	2016	NA	1894	1819	75	4
CN3506100000000	35	061	Valencia County, NM	2016	NA	29911	27781	2130	7.1
CN3600100000000	36	001	Albany County, NY	2016	NA	158435	152009	6426	4.1
CN3600300000000	36	003	Allegany County, NY	2016	NA	20052	18786	1266	6.3
CN3600500000000	36	005	Bronx County, NY	2016	NA	607295	563965	43330	7.1
CN3600700000000	36	007	Broome County, NY	2016	NA	85851	81196	4655	5.4
CN3600900000000	36	009	Cattaraugus County, NY	2016	NA	34849	32768	2081	6
CN3601100000000	36	011	Cayuga County, NY	2016	NA	36691	34836	1855	5.1
CN3601300000000	36	013	Chautauqua County, NY	2016	NA	56113	52857	3256	5.8
CN3601500000000	36	015	Chemung County, NY	2016	NA	36202	34131	2071	5.7
CN3601700000000	36	017	Chenango County, NY	2016	NA	22829	21673	1156	5.1
CN3601900000000	36	019	Clinton County, NY	2016	NA	35795	33877	1918	5.4
CN3602100000000	36	021	Columbia County, NY	2016	NA	31460	30301	1159	3.7
CN3602300000000	36	023	Cortland County, NY	2016	NA	22982	21673	1309	5.7
CN3602500000000	36	025	Delaware County, NY	2016	NA	19220	18159	1061	5.5
CN3602700000000	36	027	Dutchess County, NY	2016	NA	143032	137076	5956	4.2
CN3602900000000	36	029	Erie County, NY	2016	NA	445070	423157	21913	4.9
CN3603100000000	36	031	Essex County, NY	2016	NA	17235	16315	920	5.3
CN3603300000000	36	033	Franklin County, NY	2016	NA	19788	18666	1122	5.7
CN3603500000000	36	035	Fulton County, NY	2016	NA	23219	21891	1328	5.7
CN3603700000000	36	037	Genesee County, NY	2016	NA	29726	28363	1363	4.6
CN3603900000000	36	039	Greene County, NY	2016	NA	20559	19521	1038	5
CN3604100000000	36	041	Hamilton County, NY	2016	NA	2363	2210	153	6.5
CN3604300000000	36	043	Herkimer County, NY	2016	NA	28164	26626	1538	5.5
CN3604500000000	36	045	Jefferson County, NY	2016	NA	45649	42804	2845	6.2
CN3604700000000	36	047	Kings County, NY	2016	NA	1214539	1149735	64804	5.3
CN3604900000000	36	049	Lewis County, NY	2016	NA	11739	10951	788	6.7
CN3605100000000	36	051	Livingston County, NY	2016	NA	31030	29498	1532	4.9
CN3605300000000	36	053	Madison County, NY	2016	NA	32694	30973	1721	5.3
CN3605500000000	36	055	Monroe County, NY	2016	NA	363191	346126	17065	4.7
CN3605700000000	36	057	Montgomery County, NY	2016	NA	22302	21027	1275	5.7
CN3605900000000	36	059	Nassau County, NY	2016	NA	699796	672454	27342	3.9
CN3606100000000	36	061	New York County, NY	2016	NA	914469	872736	41733	4.6
CN3606300000000	36	063	Niagara County, NY	2016	NA	100198	94366	5832	5.8
CN3606500000000	36	065	Oneida County, NY	2016	NA	101631	96711	4920	4.8
CN3606700000000	36	067	Onondaga County, NY	2016	NA	221119	211142	9977	4.5
CN3606900000000	36	069	Ontario County, NY	2016	NA	55054	52680	2374	4.3
CN3607100000000	36	071	Orange County, NY	2016	NA	178863	171135	7728	4.3
CN3607300000000	36	073	Orleans County, NY	2016	NA	17745	16731	1014	5.7
CN3607500000000	36	075	Oswego County, NY	2016	NA	53286	49847	3439	6.5
CN3607700000000	36	077	Otsego County, NY	2016	NA	28197	26812	1385	4.9
CN3607900000000	36	079	Putnam County, NY	2016	NA	50674	48657	2017	4
CN3608100000000	36	081	Queens County, NY	2016	NA	1158611	1105906	52705	4.5
CN3608300000000	36	083	Rensselaer County, NY	2016	NA	81541	78055	3486	4.3
CN3608500000000	36	085	Richmond County, NY	2016	NA	220823	209238	11585	5.2
CN3608700000000	36	087	Rockland County, NY	2016	NA	152479	146098	6381	4.2
CN3608900000000	36	089	St. Lawrence County, NY	2016	NA	43346	40489	2857	6.6
CN3609100000000	36	091	Saratoga County, NY	2016	NA	117440	112961	4479	3.8
CN3609300000000	36	093	Schenectady County, NY	2016	NA	75764	72482	3282	4.3
CN3609500000000	36	095	Schoharie County, NY	2016	NA	14720	13921	799	5.4
CN3609700000000	36	097	Schuyler County, NY	2016	NA	8275	7777	498	6
CN3609900000000	36	099	Seneca County, NY	2016	NA	15484	14747	737	4.8
CN3610100000000	36	101	Steuben County, NY	2016	NA	43152	40638	2514	5.8
CN3610300000000	36	103	Suffolk County, NY	2016	NA	773871	740123	33748	4.4
CN3610500000000	36	105	Sullivan County, NY	2016	NA	34025	32399	1626	4.8
CN3610700000000	36	107	Tioga County, NY	2016	NA	23010	21829	1181	5.1
CN3610900000000	36	109	Tompkins County, NY	2016	NA	50351	48257	2094	4.2
CN3611100000000	36	111	Ulster County, NY	2016	NA	88138	84242	3896	4.4
CN3611300000000	36	113	Warren County, NY	2016	NA	31980	30298	1682	5.3
CN3611500000000	36	115	Washington County, NY	2016	NA	28335	27018	1317	4.6
CN3611700000000	36	117	Wayne County, NY	2016	NA	43980	41789	2191	5
CN3611900000000	36	119	Westchester County, NY	2016	NA	477692	457221	20471	4.3
CN3612100000000	36	121	Wyoming County, NY	2016	NA	18102	17137	965	5.3
CN3612300000000	36	123	Yates County, NY	2016	NA	11713	11196	517	4.4
CN3700100000000	37	001	Alamance County, NC	2016	NA	78943	75209	3734	4.7
CN3700300000000	37	003	Alexander County, NC	2016	NA	17835	17078	757	4.2
CN3700500000000	37	005	Alleghany County, NC	2016	NA	4426	4183	243	5.5
CN3700700000000	37	007	Anson County, NC	2016	NA	10660	10043	617	5.8
CN3700900000000	37	009	Ashe County, NC	2016	NA	12508	11909	599	4.8
CN3701100000000	37	011	Avery County, NC	2016	NA	7576	7195	381	5
CN3701300000000	37	013	Beaufort County, NC	2016	NA	20307	19153	1154	5.7
CN3701500000000	37	015	Bertie County, NC	2016	NA	8436	7879	557	6.6
CN3701700000000	37	017	Bladen County, NC	2016	NA	14569	13564	1005	6.9
CN3701900000000	37	019	Brunswick County, NC	2016	NA	49705	46504	3201	6.4
CN3702100000000	37	021	Buncombe County, NC	2016	NA	134374	129188	5186	3.9
CN3702300000000	37	023	Burke County, NC	2016	NA	39858	37921	1937	4.9
CN3702500000000	37	025	Cabarrus County, NC	2016	NA	101184	96569	4615	4.6
CN3702700000000	37	027	Caldwell County, NC	2016	NA	35899	34039	1860	5.2
CN3702900000000	37	029	Camden County, NC	2016	NA	4659	4419	240	5.2
CN3703100000000	37	031	Carteret County, NC	2016	NA	31574	29947	1627	5.2
CN3703300000000	37	033	Caswell County, NC	2016	NA	9690	9164	526	5.4
CN3703500000000	37	035	Catawba County, NC	2016	NA	76890	73255	3635	4.7
CN3703700000000	37	037	Chatham County, NC	2016	NA	34527	33065	1462	4.2
CN3703900000000	37	039	Cherokee County, NC	2016	NA	11146	10514	632	5.7
CN3704100000000	37	041	Chowan County, NC	2016	NA	5602	5244	358	6.4
CN3704300000000	37	043	Clay County, NC	2016	NA	4051	3830	221	5.5
CN3704500000000	37	045	Cleveland County, NC	2016	NA	46815	44259	2556	5.5
CN3704700000000	37	047	Columbus County, NC	2016	NA	22596	21149	1447	6.4
CN3704900000000	37	049	Craven County, NC	2016	NA	41759	39576	2183	5.2
CN3705100000000	37	051	Cumberland County, NC	2016	NA	127339	119205	8134	6.4
CN3705300000000	37	053	Currituck County, NC	2016	NA	13153	12487	666	5.1
CN3705500000000	37	055	Dare County, NC	2016	NA	20004	18654	1350	6.7
CN3705700000000	37	057	Davidson County, NC	2016	NA	79516	75690	3826	4.8
CN3705900000000	37	059	Davie County, NC	2016	NA	20172	19265	907	4.5
CN3706100000000	37	061	Duplin County, NC	2016	NA	26506	25094	1412	5.3
CN3706300000000	37	063	Durham County, NC	2016	NA	162115	154825	7290	4.5
CN3706500000000	37	065	Edgecombe County, NC	2016	NA	22421	20478	1943	8.7
CN3706700000000	37	067	Forsyth County, NC	2016	NA	182652	173776	8876	4.9
CN3706900000000	37	069	Franklin County, NC	2016	NA	29347	27816	1531	5.2
CN3707100000000	37	071	Gaston County, NC	2016	NA	105652	100025	5627	5.3
CN3707300000000	37	073	Gates County, NC	2016	NA	5191	4925	266	5.1
CN3707500000000	37	075	Graham County, NC	2016	NA	3102	2828	274	8.8
CN3707700000000	37	077	Granville County, NC	2016	NA	29283	28019	1264	4.3
CN3707900000000	37	079	Greene County, NC	2016	NA	9524	9021	503	5.3
CN3708100000000	37	081	Guilford County, NC	2016	NA	258484	244973	13511	5.2
CN3708300000000	37	083	Halifax County, NC	2016	NA	20684	19047	1637	7.9
CN3708500000000	37	085	Harnett County, NC	2016	NA	51461	48486	2975	5.8
CN3708700000000	37	087	Haywood County, NC	2016	NA	28486	27193	1293	4.5
CN3708900000000	37	089	Henderson County, NC	2016	NA	52299	50072	2227	4.3
CN3709100000000	37	091	Hertford County, NC	2016	NA	9316	8704	612	6.6
CN3709300000000	37	093	Hoke County, NC	2016	NA	19916	18605	1311	6.6
CN3709500000000	37	095	Hyde County, NC	2016	NA	2110	1910	200	9.5
CN3709700000000	37	097	Iredell County, NC	2016	NA	84565	80506	4059	4.8
CN3709900000000	37	099	Jackson County, NC	2016	NA	18831	17809	1022	5.4
CN3710100000000	37	101	Johnston County, NC	2016	NA	91592	87311	4281	4.7
CN3710300000000	37	103	Jones County, NC	2016	NA	4515	4277	238	5.3
CN3710500000000	37	105	Lee County, NC	2016	NA	26231	24691	1540	5.9
CN3710700000000	37	107	Lenoir County, NC	2016	NA	27651	26032	1619	5.9
CN3710900000000	37	109	Lincoln County, NC	2016	NA	41095	39160	1935	4.7
CN3711100000000	37	111	McDowell County, NC	2016	NA	21015	20008	1007	4.8
CN3711300000000	37	113	Macon County, NC	2016	NA	15219	14400	819	5.4
CN3711500000000	37	115	Madison County, NC	2016	NA	9702	9230	472	4.9
CN3711700000000	37	117	Martin County, NC	2016	NA	9814	9152	662	6.7
CN3711900000000	37	119	Mecklenburg County, NC	2016	NA	583478	555878	27600	4.7
CN3712100000000	37	121	Mitchell County, NC	2016	NA	6188	5810	378	6.1
CN3712300000000	37	123	Montgomery County, NC	2016	NA	11700	11097	603	5.2
CN3712500000000	37	125	Moore County, NC	2016	NA	39513	37533	1980	5
CN3712700000000	37	127	Nash County, NC	2016	NA	43928	41043	2885	6.6
CN3712900000000	37	129	New Hanover County, NC	2016	NA	116055	110586	5469	4.7
CN3713100000000	37	131	Northampton County, NC	2016	NA	7816	7249	567	7.3
CN3713300000000	37	133	Onslow County, NC	2016	NA	63719	60214	3505	5.5
CN3713500000000	37	135	Orange County, NC	2016	NA	74933	71765	3168	4.2
CN3713700000000	37	137	Pamlico County, NC	2016	NA	5408	5123	285	5.3
CN3713900000000	37	139	Pasquotank County, NC	2016	NA	17397	16305	1092	6.3
CN3714100000000	37	141	Pender County, NC	2016	NA	26852	25433	1419	5.3
CN3714300000000	37	143	Perquimans County, NC	2016	NA	5101	4773	328	6.4
CN3714500000000	37	145	Person County, NC	2016	NA	18036	17048	988	5.5
CN3714700000000	37	147	Pitt County, NC	2016	NA	88213	83304	4909	5.6
CN3714900000000	37	149	Polk County, NC	2016	NA	8825	8416	409	4.6
CN3715100000000	37	151	Randolph County, NC	2016	NA	66894	63603	3291	4.9
CN3715300000000	37	153	Richmond County, NC	2016	NA	16790	15630	1160	6.9
CN3715500000000	37	155	Robeson County, NC	2016	NA	50549	46545	4004	7.9
CN3715700000000	37	157	Rockingham County, NC	2016	NA	40854	38549	2305	5.6
CN3715900000000	37	159	Rowan County, NC	2016	NA	64233	60664	3569	5.6
CN3716100000000	37	161	Rutherford County, NC	2016	NA	24811	23153	1658	6.7
CN3716300000000	37	163	Sampson County, NC	2016	NA	29517	27908	1609	5.5
CN3716500000000	37	165	Scotland County, NC	2016	NA	11635	10574	1061	9.1
CN3716700000000	37	167	Stanly County, NC	2016	NA	29288	27931	1357	4.6
CN3716900000000	37	169	Stokes County, NC	2016	NA	21874	20830	1044	4.8
CN3717100000000	37	171	Surry County, NC	2016	NA	33524	31924	1600	4.8
CN3717300000000	37	173	Swain County, NC	2016	NA	7118	6684	434	6.1
CN3717500000000	37	175	Transylvania County, NC	2016	NA	13959	13280	679	4.9
CN3717700000000	37	177	Tyrrell County, NC	2016	NA	1530	1401	129	8.4
CN3717900000000	37	179	Union County, NC	2016	NA	115773	110681	5092	4.4
CN3718100000000	37	181	Vance County, NC	2016	NA	18004	16718	1286	7.1
CN3718300000000	37	183	Wake County, NC	2016	NA	556706	532827	23879	4.3
CN3718500000000	37	185	Warren County, NC	2016	NA	7143	6622	521	7.3
CN3718700000000	37	187	Washington County, NC	2016	NA	4865	4505	360	7.4
CN3718900000000	37	189	Watauga County, NC	2016	NA	27949	26695	1254	4.5
CN3719100000000	37	191	Wayne County, NC	2016	NA	53556	50438	3118	5.8
CN3719300000000	37	193	Wilkes County, NC	2016	NA	30204	28759	1445	4.8
CN3719500000000	37	195	Wilson County, NC	2016	NA	36486	33517	2969	8.1
CN3719700000000	37	197	Yadkin County, NC	2016	NA	17612	16841	771	4.4
CN3719900000000	37	199	Yancey County, NC	2016	NA	7478	7093	385	5.1
CN3800100000000	38	001	Adams County, ND	2016	NA	1132	1103	29	2.6
CN3800300000000	38	003	Barnes County, ND	2016	NA	5619	5440	179	3.2
CN3800500000000	38	005	Benson County, ND	2016	NA	2434	2336	98	4
CN3800700000000	38	007	Billings County, ND	2016	NA	438	425	13	3
CN3800900000000	38	009	Bottineau County, ND	2016	NA	3227	3077	150	4.6
CN3801100000000	38	011	Bowman County, ND	2016	NA	1835	1796	39	2.1
CN3801300000000	38	013	Burke County, ND	2016	NA	1145	1093	52	4.5
CN3801500000000	38	015	Burleigh County, ND	2016	NA	50602	49297	1305	2.6
CN3801700000000	38	017	Cass County, ND	2016	NA	100165	97926	2239	2.2
CN3801900000000	38	019	Cavalier County, ND	2016	NA	2115	2059	56	2.6
CN3802100000000	38	021	Dickey County, ND	2016	NA	2545	2496	49	1.9
CN3802300000000	38	023	Divide County, ND	2016	NA	1683	1639	44	2.6
CN3802500000000	38	025	Dunn County, ND	2016	NA	3247	3145	102	3.1
CN3802700000000	38	027	Eddy County, ND	2016	NA	1278	1223	55	4.3
CN3802900000000	38	029	Emmons County, ND	2016	NA	1584	1515	69	4.4
CN3803100000000	38	031	Foster County, ND	2016	NA	1685	1635	50	3
CN3803300000000	38	033	Golden Valley County, ND	2016	NA	971	945	26	2.7
CN3803500000000	38	035	Grand Forks County, ND	2016	NA	38797	37883	914	2.4
CN3803700000000	38	037	Grant County, ND	2016	NA	1296	1257	39	3
CN3803900000000	38	039	Griggs County, ND	2016	NA	1159	1126	33	2.8
CN3804100000000	38	041	Hettinger County, ND	2016	NA	1539	1493	46	3
CN3804300000000	38	043	Kidder County, ND	2016	NA	1375	1323	52	3.8
CN3804500000000	38	045	LaMoure County, ND	2016	NA	2314	2259	55	2.4
CN3804700000000	38	047	Logan County, ND	2016	NA	960	926	34	3.5
CN3804900000000	38	049	McHenry County, ND	2016	NA	3374	3209	165	4.9
CN3805100000000	38	051	McIntosh County, ND	2016	NA	1240	1202	38	3.1
CN3805300000000	38	053	McKenzie County, ND	2016	NA	7943	7644	299	3.8
CN3805500000000	38	055	McLean County, ND	2016	NA	5066	4890	176	3.5
CN3805700000000	38	057	Mercer County, ND	2016	NA	4651	4447	204	4.4
CN3805900000000	38	059	Morton County, ND	2016	NA	16786	16239	547	3.3
CN3806100000000	38	061	Mountrail County, ND	2016	NA	7128	6916	212	3
CN3806300000000	38	063	Nelson County, ND	2016	NA	1533	1481	52	3.4
CN3806500000000	38	065	Oliver County, ND	2016	NA	898	849	49	5.5
CN3806700000000	38	067	Pembina County, ND	2016	NA	3658	3475	183	5
CN3806900000000	38	069	Pierce County, ND	2016	NA	1897	1822	75	4
CN3807100000000	38	071	Ramsey County, ND	2016	NA	6143	5968	175	2.8
CN3807300000000	38	073	Ransom County, ND	2016	NA	2838	2774	64	2.3
CN3807500000000	38	075	Renville County, ND	2016	NA	1307	1257	50	3.8
CN3807700000000	38	077	Richland County, ND	2016	NA	8899	8655	244	2.7
CN3807900000000	38	079	Rolette County, ND	2016	NA	4983	4444	539	10.8
CN3808100000000	38	081	Sargent County, ND	2016	NA	2331	2286	45	1.9
CN3808300000000	38	083	Sheridan County, ND	2016	NA	737	695	42	5.7
CN3808500000000	38	085	Sioux County, ND	2016	NA	1338	1279	59	4.4
CN3808700000000	38	087	Slope County, ND	2016	NA	436	425	11	2.5
CN3808900000000	38	089	Stark County, ND	2016	NA	18076	17370	706	3.9
CN3809100000000	38	091	Steele County, ND	2016	NA	1074	1051	23	2.1
CN3809300000000	38	093	Stutsman County, ND	2016	NA	11073	10800	273	2.5
CN3809500000000	38	095	Towner County, ND	2016	NA	1332	1302	30	2.3
CN3809700000000	38	097	Traill County, ND	2016	NA	4597	4469	128	2.8
CN3809900000000	38	099	Walsh County, ND	2016	NA	5659	5445	214	3.8
CN3810100000000	38	101	Ward County, ND	2016	NA	33522	32142	1380	4.1
CN3810300000000	38	103	Wells County, ND	2016	NA	2190	2105	85	3.9
CN3810500000000	38	105	Williams County, ND	2016	NA	22621	21636	985	4.4
CN3900100000000	39	001	Adams County, OH	2016	NA	10939	10112	827	7.6
CN3900300000000	39	003	Allen County, OH	2016	NA	48242	45808	2434	5
CN3900500000000	39	005	Ashland County, OH	2016	NA	26250	24910	1340	5.1
CN3900700000000	39	007	Ashtabula County, OH	2016	NA	44206	41494	2712	6.1
CN3900900000000	39	009	Athens County, OH	2016	NA	28008	26205	1803	6.4
CN3901100000000	39	011	Auglaize County, OH	2016	NA	24610	23687	923	3.8
CN3901300000000	39	013	Belmont County, OH	2016	NA	31000	28674	2326	7.5
CN3901500000000	39	015	Brown County, OH	2016	NA	19485	18350	1135	5.8
CN3901700000000	39	017	Butler County, OH	2016	NA	189364	180784	8580	4.5
CN3901900000000	39	019	Carroll County, OH	2016	NA	13432	12508	924	6.9
CN3902100000000	39	021	Champaign County, OH	2016	NA	19874	18974	900	4.5
CN3902300000000	39	023	Clark County, OH	2016	NA	63553	60203	3350	5.3
CN3902500000000	39	025	Clermont County, OH	2016	NA	103866	99226	4640	4.5
CN3902700000000	39	027	Clinton County, OH	2016	NA	17163	16158	1005	5.9
CN3902900000000	39	029	Columbiana County, OH	2016	NA	48366	45115	3251	6.7
CN3903100000000	39	031	Coshocton County, OH	2016	NA	14989	13920	1069	7.1
CN3903300000000	39	033	Crawford County, OH	2016	NA	19163	18001	1162	6.1
CN3903500000000	39	035	Cuyahoga County, OH	2016	NA	617505	583926	33579	5.4
CN3903700000000	39	037	Darke County, OH	2016	NA	26364	25272	1092	4.1
CN3903900000000	39	039	Defiance County, OH	2016	NA	18373	17461	912	5
CN3904100000000	39	041	Delaware County, OH	2016	NA	104813	101003	3810	3.6
CN3904300000000	39	043	Erie County, OH	2016	NA	37409	35341	2068	5.5
CN3904500000000	39	045	Fairfield County, OH	2016	NA	75927	72627	3300	4.3
CN3904700000000	39	047	Fayette County, OH	2016	NA	14482	13836	646	4.5
CN3904900000000	39	049	Franklin County, OH	2016	NA	666583	638923	27660	4.1
CN3905100000000	39	051	Fulton County, OH	2016	NA	22668	21607	1061	4.7
CN3905300000000	39	053	Gallia County, OH	2016	NA	12122	11291	831	6.9
CN3905500000000	39	055	Geauga County, OH	2016	NA	49486	47319	2167	4.4
CN3905700000000	39	057	Greene County, OH	2016	NA	81065	77519	3546	4.4
CN3905900000000	39	059	Guernsey County, OH	2016	NA	18883	17538	1345	7.1
CN3906100000000	39	061	Hamilton County, OH	2016	NA	404791	386761	18030	4.5
CN3906300000000	39	063	Hancock County, OH	2016	NA	41446	39908	1538	3.7
CN3906500000000	39	065	Hardin County, OH	2016	NA	14372	13650	722	5
CN3906700000000	39	067	Harrison County, OH	2016	NA	6967	6432	535	7.7
CN3906900000000	39	069	Henry County, OH	2016	NA	13600	12869	731	5.4
CN3907100000000	39	071	Highland County, OH	2016	NA	16924	15845	1079	6.4
CN3907300000000	39	073	Hocking County, OH	2016	NA	13005	12275	730	5.6
CN3907500000000	39	075	Holmes County, OH	2016	NA	20983	20222	761	3.6
CN3907700000000	39	077	Huron County, OH	2016	NA	28107	26267	1840	6.5
CN3907900000000	39	079	Jackson County, OH	2016	NA	12797	11786	1011	7.9
CN3908100000000	39	081	Jefferson County, OH	2016	NA	28897	26469	2428	8.4
CN3908300000000	39	083	Knox County, OH	2016	NA	31219	29766	1453	4.7
CN3908500000000	39	085	Lake County, OH	2016	NA	125662	119629	6033	4.8
CN3908700000000	39	087	Lawrence County, OH	2016	NA	24743	23123	1620	6.5
CN3908900000000	39	089	Licking County, OH	2016	NA	88215	84323	3892	4.4
CN3909100000000	39	091	Logan County, OH	2016	NA	23313	22330	983	4.2
CN3909300000000	39	093	Lorain County, OH	2016	NA	153570	144544	9026	5.9
CN3909500000000	39	095	Lucas County, OH	2016	NA	210347	199375	10972	5.2
CN3909700000000	39	097	Madison County, OH	2016	NA	20329	19524	805	4
CN3909900000000	39	099	Mahoning County, OH	2016	NA	105917	99115	6802	6.4
CN3910100000000	39	101	Marion County, OH	2016	NA	27729	26312	1417	5.1
CN3910300000000	39	103	Medina County, OH	2016	NA	96746	92570	4176	4.3
CN3910500000000	39	105	Meigs County, OH	2016	NA	8951	8183	768	8.6
CN3910700000000	39	107	Mercer County, OH	2016	NA	23415	22645	770	3.3
CN3910900000000	39	109	Miami County, OH	2016	NA	52992	50669	2323	4.4
CN3911100000000	39	111	Monroe County, OH	2016	NA	5319	4724	595	11.2
CN3911300000000	39	113	Montgomery County, OH	2016	NA	249967	237552	12415	5
CN3911500000000	39	115	Morgan County, OH	2016	NA	6751	6188	563	8.3
CN3911700000000	39	117	Morrow County, OH	2016	NA	16761	15909	852	5.1
CN3911900000000	39	119	Muskingum County, OH	2016	NA	39724	37314	2410	6.1
CN3912100000000	39	121	Noble County, OH	2016	NA	4891	4462	429	8.8
CN3912300000000	39	123	Ottawa County, OH	2016	NA	21024	19659	1365	6.5
CN3912500000000	39	125	Paulding County, OH	2016	NA	8872	8462	410	4.6
CN3912700000000	39	127	Perry County, OH	2016	NA	15885	14866	1019	6.4
CN3912900000000	39	129	Pickaway County, OH	2016	NA	26194	24921	1273	4.9
CN3913100000000	39	131	Pike County, OH	2016	NA	10804	9988	816	7.6
CN3913300000000	39	133	Portage County, OH	2016	NA	87094	82692	4402	5.1
CN3913500000000	39	135	Preble County, OH	2016	NA	21012	20004	1008	4.8
CN3913700000000	39	137	Putnam County, OH	2016	NA	18893	18197	696	3.7
CN3913900000000	39	139	Richland County, OH	2016	NA	53393	50416	2977	5.6
CN3914100000000	39	141	Ross County, OH	2016	NA	33827	31950	1877	5.5
CN3914300000000	39	143	Sandusky County, OH	2016	NA	31014	29541	1473	4.7
CN3914500000000	39	145	Scioto County, OH	2016	NA	29868	27543	2325	7.8
CN3914700000000	39	147	Seneca County, OH	2016	NA	27140	25803	1337	4.9
CN3914900000000	39	149	Shelby County, OH	2016	NA	24064	23059	1005	4.2
CN3915100000000	39	151	Stark County, OH	2016	NA	186400	176173	10227	5.5
CN3915300000000	39	153	Summit County, OH	2016	NA	272310	258318	13992	5.1
CN3915500000000	39	155	Trumbull County, OH	2016	NA	90400	84249	6151	6.8
CN3915700000000	39	157	Tuscarawas County, OH	2016	NA	45004	42402	2602	5.8
CN3915900000000	39	159	Union County, OH	2016	NA	27783	26715	1068	3.8
CN3916100000000	39	161	Van Wert County, OH	2016	NA	14300	13718	582	4.1
CN3916300000000	39	163	Vinton County, OH	2016	NA	5453	5066	387	7.1
CN3916500000000	39	165	Warren County, OH	2016	NA	114558	109770	4788	4.2
CN3916700000000	39	167	Washington County, OH	2016	NA	27769	25819	1950	7
CN3916900000000	39	169	Wayne County, OH	2016	NA	61196	58742	2454	4
CN3917100000000	39	171	Williams County, OH	2016	NA	19018	18154	864	4.5
CN3917300000000	39	173	Wood County, OH	2016	NA	70624	67655	2969	4.2
CN3917500000000	39	175	Wyandot County, OH	2016	NA	12669	12196	473	3.7
CN4000100000000	40	001	Adair County, OK	2016	NA	8160	7685	475	5.8
CN4000300000000	40	003	Alfalfa County, OK	2016	NA	2969	2871	98	3.3
CN4000500000000	40	005	Atoka County, OK	2016	NA	5065	4733	332	6.6
CN4000700000000	40	007	Beaver County, OK	2016	NA	2889	2799	90	3.1
CN4000900000000	40	009	Beckham County, OK	2016	NA	11042	10249	793	7.2
CN4001100000000	40	011	Blaine County, OK	2016	NA	4395	4233	162	3.7
CN4001300000000	40	013	Bryan County, OK	2016	NA	19525	18686	839	4.3
CN4001500000000	40	015	Caddo County, OK	2016	NA	11934	11302	632	5.3
CN4001700000000	40	017	Canadian County, OK	2016	NA	69467	66703	2764	4
CN4001900000000	40	019	Carter County, OK	2016	NA	22738	21563	1175	5.2
CN4002100000000	40	021	Cherokee County, OK	2016	NA	19302	18242	1060	5.5
CN4002300000000	40	023	Choctaw County, OK	2016	NA	5760	5321	439	7.6
CN4002500000000	40	025	Cimarron County, OK	2016	NA	1417	1382	35	2.5
CN4002700000000	40	027	Cleveland County, OK	2016	NA	139263	133954	5309	3.8
CN4002900000000	40	029	Coal County, OK	2016	NA	2323	2153	170	7.3
CN4003100000000	40	031	Comanche County, OK	2016	NA	49487	47211	2276	4.6
CN4003300000000	40	033	Cotton County, OK	2016	NA	2892	2754	138	4.8
CN4003500000000	40	035	Craig County, OK	2016	NA	6258	5956	302	4.8
CN4003700000000	40	037	Creek County, OK	2016	NA	31526	29697	1829	5.8
CN4003900000000	40	039	Custer County, OK	2016	NA	15210	14519	691	4.5
CN4004100000000	40	041	Delaware County, OK	2016	NA	17984	17105	879	4.9
CN4004300000000	40	043	Dewey County, OK	2016	NA	2677	2569	108	4
CN4004500000000	40	045	Ellis County, OK	2016	NA	2257	2171	86	3.8
CN4004700000000	40	047	Garfield County, OK	2016	NA	29021	27756	1265	4.4
CN4004900000000	40	049	Garvin County, OK	2016	NA	12725	12046	679	5.3
CN4005100000000	40	051	Grady County, OK	2016	NA	26113	24818	1295	5
CN4005300000000	40	053	Grant County, OK	2016	NA	3007	2911	96	3.2
CN4005500000000	40	055	Greer County, OK	2016	NA	2192	2030	162	7.4
CN4005700000000	40	057	Harmon County, OK	2016	NA	1293	1244	49	3.8
CN4005900000000	40	059	Harper County, OK	2016	NA	1911	1838	73	3.8
CN4006100000000	40	061	Haskell County, OK	2016	NA	4507	4135	372	8.3
CN4006300000000	40	063	Hughes County, OK	2016	NA	5519	5119	400	7.2
CN4006500000000	40	065	Jackson County, OK	2016	NA	11012	10529	483	4.4
CN4006700000000	40	067	Jefferson County, OK	2016	NA	2712	2519	193	7.1
CN4006900000000	40	069	Johnston County, OK	2016	NA	4377	4121	256	5.8
CN4007100000000	40	071	Kay County, OK	2016	NA	18961	17766	1195	6.3
CN4007300000000	40	073	Kingfisher County, OK	2016	NA	8457	8177	280	3.3
CN4007500000000	40	075	Kiowa County, OK	2016	NA	4113	3894	219	5.3
CN4007700000000	40	077	Latimer County, OK	2016	NA	3728	3407	321	8.6
CN4007900000000	40	079	Le Flore County, OK	2016	NA	19773	18411	1362	6.9
CN4008100000000	40	081	Lincoln County, OK	2016	NA	15893	15049	844	5.3
CN4008300000000	40	083	Logan County, OK	2016	NA	21595	20723	872	4
CN4008500000000	40	085	Love County, OK	2016	NA	6577	6370	207	3.1
CN4008700000000	40	087	McClain County, OK	2016	NA	18976	18197	779	4.1
CN4008900000000	40	089	McCurtain County, OK	2016	NA	14822	13764	1058	7.1
CN4009100000000	40	091	McIntosh County, OK	2016	NA	7066	6437	629	8.9
CN4009300000000	40	093	Major County, OK	2016	NA	3997	3833	164	4.1
CN4009500000000	40	095	Marshall County, OK	2016	NA	6621	6287	334	5
CN4009700000000	40	097	Mayes County, OK	2016	NA	19460	18470	990	5.1
CN4009900000000	40	099	Murray County, OK	2016	NA	6350	6064	286	4.5
CN4010100000000	40	101	Muskogee County, OK	2016	NA	29656	28042	1614	5.4
CN4010300000000	40	103	Noble County, OK	2016	NA	5766	5562	204	3.5
CN4010500000000	40	105	Nowata County, OK	2016	NA	4692	4406	286	6.1
CN4010700000000	40	107	Okfuskee County, OK	2016	NA	4557	4280	277	6.1
CN4010900000000	40	109	Oklahoma County, OK	2016	NA	375442	359374	16068	4.3
CN4011100000000	40	111	Okmulgee County, OK	2016	NA	16169	15010	1159	7.2
CN4011300000000	40	113	Osage County, OK	2016	NA	21089	19877	1212	5.7
CN4011500000000	40	115	Ottawa County, OK	2016	NA	14480	13754	726	5
CN4011700000000	40	117	Pawnee County, OK	2016	NA	7498	7002	496	6.6
CN4011900000000	40	119	Payne County, OK	2016	NA	38944	37500	1444	3.7
CN4012100000000	40	121	Pittsburg County, OK	2016	NA	17648	16566	1082	6.1
CN4012300000000	40	123	Pontotoc County, OK	2016	NA	18473	17722	751	4.1
CN4012500000000	40	125	Pottawatomie County, OK	2016	NA	33090	31563	1527	4.6
CN4012700000000	40	127	Pushmataha County, OK	2016	NA	4880	4525	355	7.3
CN4012900000000	40	129	Roger Mills County, OK	2016	NA	1813	1720	93	5.1
CN4013100000000	40	131	Rogers County, OK	2016	NA	44925	42673	2252	5
CN4013300000000	40	133	Seminole County, OK	2016	NA	9451	8798	653	6.9
CN4013500000000	40	135	Sequoyah County, OK	2016	NA	16857	15804	1053	6.2
CN4013700000000	40	137	Stephens County, OK	2016	NA	19042	17237	1805	9.5
CN4013900000000	40	139	Texas County, OK	2016	NA	9410	9092	318	3.4
CN4014100000000	40	141	Tillman County, OK	2016	NA	3315	3168	147	4.4
CN4014300000000	40	143	Tulsa County, OK	2016	NA	318525	303683	14842	4.7
CN4014500000000	40	145	Wagoner County, OK	2016	NA	36649	34903	1746	4.8
CN4014700000000	40	147	Washington County, OK	2016	NA	23954	22786	1168	4.9
CN4014900000000	40	149	Washita County, OK	2016	NA	5326	4958	368	6.9
CN4015100000000	40	151	Woods County, OK	2016	NA	5224	5056	168	3.2
CN4015300000000	40	153	Woodward County, OK	2016	NA	9526	8936	590	6.2
CN4100100000000	41	001	Baker County, OR	2016	NA	6951	6513	438	6.3
CN4100300000000	41	003	Benton County, OR	2016	NA	46783	44947	1836	3.9
CN4100500000000	41	005	Clackamas County, OR	2016	NA	212633	203367	9266	4.4
CN4100700000000	41	007	Clatsop County, OR	2016	NA	19017	18120	897	4.7
CN4100900000000	41	009	Columbia County, OR	2016	NA	23612	22171	1441	6.1
CN4101100000000	41	011	Coos County, OR	2016	NA	26434	24745	1689	6.4
CN4101300000000	41	013	Crook County, OR	2016	NA	9341	8693	648	6.9
CN4101500000000	41	015	Curry County, OR	2016	NA	9043	8432	611	6.8
CN4101700000000	41	017	Deschutes County, OR	2016	NA	89853	85483	4370	4.9
CN4101900000000	41	019	Douglas County, OR	2016	NA	45693	42826	2867	6.3
CN4102100000000	41	021	Gilliam County, OR	2016	NA	837	788	49	5.9
CN4102300000000	41	023	Grant County, OR	2016	NA	3108	2870	238	7.7
CN4102500000000	41	025	Harney County, OR	2016	NA	3423	3209	214	6.3
CN4102700000000	41	027	Hood River County, OR	2016	NA	13906	13330	576	4.1
CN4102900000000	41	029	Jackson County, OR	2016	NA	101378	95552	5826	5.7
CN4103100000000	41	031	Jefferson County, OR	2016	NA	9859	9207	652	6.6
CN4103300000000	41	033	Josephine County, OR	2016	NA	34281	32061	2220	6.5
CN4103500000000	41	035	Klamath County, OR	2016	NA	29222	27242	1980	6.8
CN4103700000000	41	037	Lake County, OR	2016	NA	3452	3232	220	6.4
CN4103900000000	41	039	Lane County, OR	2016	NA	178428	169361	9067	5.1
CN4104100000000	41	041	Lincoln County, OR	2016	NA	20893	19721	1172	5.6
CN4104300000000	41	043	Linn County, OR	2016	NA	56815	53574	3241	5.7
CN4104500000000	41	045	Malheur County, OR	2016	NA	12475	11787	688	5.5
CN4104700000000	41	047	Marion County, OR	2016	NA	157354	149396	7958	5.1
CN4104900000000	41	049	Morrow County, OR	2016	NA	5765	5485	280	4.9
CN4105100000000	41	051	Multnomah County, OR	2016	NA	443744	425011	18733	4.2
CN4105300000000	41	053	Polk County, OR	2016	NA	38318	36384	1934	5
CN4105500000000	41	055	Sherman County, OR	2016	NA	894	853	41	4.6
CN4105700000000	41	057	Tillamook County, OR	2016	NA	11638	11066	572	4.9
CN4105900000000	41	059	Umatilla County, OR	2016	NA	36004	34084	1920	5.3
CN4106100000000	41	061	Union County, OR	2016	NA	11973	11266	707	5.9
CN4106300000000	41	063	Wallowa County, OR	2016	NA	3315	3091	224	6.8
CN4106500000000	41	065	Wasco County, OR	2016	NA	13687	13030	657	4.8
CN4106700000000	41	067	Washington County, OR	2016	NA	313325	300470	12855	4.1
CN4106900000000	41	069	Wheeler County, OR	2016	NA	686	657	29	4.2
CN4107100000000	41	071	Yamhill County, OR	2016	NA	53176	50733	2443	4.6
CN4200100000000	42	001	Adams County, PA	2016	NA	55378	53186	2192	4
CN4200300000000	42	003	Allegheny County, PA	2016	NA	647300	613814	33486	5.2
CN4200500000000	42	005	Armstrong County, PA	2016	NA	33078	30603	2475	7.5
CN4200700000000	42	007	Beaver County, PA	2016	NA	85293	80021	5272	6.2
CN4200900000000	42	009	Bedford County, PA	2016	NA	24043	22639	1404	5.8
CN4201100000000	42	011	Berks County, PA	2016	NA	213140	202560	10580	5
CN4201300000000	42	013	Blair County, PA	2016	NA	60828	57624	3204	5.3
CN4201500000000	42	015	Bradford County, PA	2016	NA	30163	28196	1967	6.5
CN4201700000000	42	017	Bucks County, PA	2016	NA	340728	325030	15698	4.6
CN4201900000000	42	019	Butler County, PA	2016	NA	98572	93599	4973	5
CN4202100000000	42	021	Cambria County, PA	2016	NA	61318	57163	4155	6.8
CN4202300000000	42	023	Cameron County, PA	2016	NA	2231	2067	164	7.4
CN4202500000000	42	025	Carbon County, PA	2016	NA	31552	29674	1878	6
CN4202700000000	42	027	Centre County, PA	2016	NA	78909	75622	3287	4.2
CN4202900000000	42	029	Chester County, PA	2016	NA	280252	269412	10840	3.9
CN4203100000000	42	031	Clarion County, PA	2016	NA	18020	16913	1107	6.1
CN4203300000000	42	033	Clearfield County, PA	2016	NA	36293	33655	2638	7.3
CN4203500000000	42	035	Clinton County, PA	2016	NA	18547	17238	1309	7.1
CN4203700000000	42	037	Columbia County, PA	2016	NA	33883	32012	1871	5.5
CN4203900000000	42	039	Crawford County, PA	2016	NA	40485	38059	2426	6
CN4204100000000	42	041	Cumberland County, PA	2016	NA	130077	124806	5271	4.1
CN4204300000000	42	043	Dauphin County, PA	2016	NA	142071	135314	6757	4.8
CN4204500000000	42	045	Delaware County, PA	2016	NA	294104	279800	14304	4.9
CN4204700000000	42	047	Elk County, PA	2016	NA	16326	15428	898	5.5
CN4204900000000	42	049	Erie County, PA	2016	NA	133534	124864	8670	6.5
CN4205100000000	42	051	Fayette County, PA	2016	NA	58413	53690	4723	8.1
CN4205300000000	42	053	Forest County, PA	2016	NA	1890	1742	148	7.8
CN4205500000000	42	055	Franklin County, PA	2016	NA	77466	73480	3986	5.1
CN4205700000000	42	057	Fulton County, PA	2016	NA	7301	6841	460	6.3
CN4205900000000	42	059	Greene County, PA	2016	NA	17290	15954	1336	7.7
CN4206100000000	42	061	Huntingdon County, PA	2016	NA	19656	18286	1370	7
CN4206300000000	42	063	Indiana County, PA	2016	NA	40150	37234	2916	7.3
CN4206500000000	42	065	Jefferson County, PA	2016	NA	20694	19281	1413	6.8
CN4206700000000	42	067	Juniata County, PA	2016	NA	12196	11544	652	5.3
CN4206900000000	42	069	Lackawanna County, PA	2016	NA	106729	100704	6025	5.6
CN4207100000000	42	071	Lancaster County, PA	2016	NA	279731	268202	11529	4.1
CN4207300000000	42	073	Lawrence County, PA	2016	NA	41491	38709	2782	6.7
CN4207500000000	42	075	Lebanon County, PA	2016	NA	70557	67401	3156	4.5
CN4207700000000	42	077	Lehigh County, PA	2016	NA	188955	178878	10077	5.3
CN4207900000000	42	079	Luzerne County, PA	2016	NA	158671	148700	9971	6.3
CN4208100000000	42	081	Lycoming County, PA	2016	NA	58697	54813	3884	6.6
CN4208300000000	42	083	McKean County, PA	2016	NA	18484	17263	1221	6.6
CN4208500000000	42	085	Mercer County, PA	2016	NA	52515	49387	3128	6
CN4208700000000	42	087	Mifflin County, PA	2016	NA	20798	19611	1187	5.7
CN4208900000000	42	089	Monroe County, PA	2016	NA	81855	76753	5102	6.2
CN4209100000000	42	091	Montgomery County, PA	2016	NA	447250	428784	18466	4.1
CN4209300000000	42	093	Montour County, PA	2016	NA	9124	8735	389	4.3
CN4209500000000	42	095	Northampton County, PA	2016	NA	158776	150594	8182	5.2
CN4209700000000	42	097	Northumberland County, PA	2016	NA	43937	41200	2737	6.2
CN4209900000000	42	099	Perry County, PA	2016	NA	24276	23158	1118	4.6
CN4210100000000	42	101	Philadelphia County/city, PA	2016	NA	703114	655667	47447	6.7
CN4210300000000	42	103	Pike County, PA	2016	NA	24902	23317	1585	6.4
CN4210500000000	42	105	Potter County, PA	2016	NA	7378	6800	578	7.8
CN4210700000000	42	107	Schuylkill County, PA	2016	NA	67544	63377	4167	6.2
CN4210900000000	42	109	Snyder County, PA	2016	NA	20511	19552	959	4.7
CN4211100000000	42	111	Somerset County, PA	2016	NA	34160	31711	2449	7.2
CN4211300000000	42	113	Sullivan County, PA	2016	NA	2840	2636	204	7.2
CN4211500000000	42	115	Susquehanna County, PA	2016	NA	20859	19676	1183	5.7
CN4211700000000	42	117	Tioga County, PA	2016	NA	19858	18446	1412	7.1
CN4211900000000	42	119	Union County, PA	2016	NA	19774	18830	944	4.8
CN4212100000000	42	121	Venango County, PA	2016	NA	23703	21989	1714	7.2
CN4212300000000	42	123	Warren County, PA	2016	NA	19769	18688	1081	5.5
CN4212500000000	42	125	Washington County, PA	2016	NA	107218	100679	6539	6.1
CN4212700000000	42	127	Wayne County, PA	2016	NA	22515	21225	1290	5.7
CN4212900000000	42	129	Westmoreland County, PA	2016	NA	182739	172070	10669	5.8
CN4213100000000	42	131	Wyoming County, PA	2016	NA	14082	13209	873	6.2
CN4213300000000	42	133	York County, PA	2016	NA	234807	223986	10821	4.6
CN4400100000000	44	001	Bristol County, RI	2016	NA	26132	24924	1208	4.6
CN4400300000000	44	003	Kent County, RI	2016	NA	90721	86433	4288	4.7
CN4400500000000	44	005	Newport County, RI	2016	NA	44233	42154	2079	4.7
CN4400700000000	44	007	Providence County, RI	2016	NA	323192	305351	17841	5.5
CN4400900000000	44	009	Washington County, RI	2016	NA	68898	65630	3268	4.7
CN4500100000000	45	001	Abbeville County, SC	2016	NA	10300	9734	566	5.5
CN4500300000000	45	003	Aiken County, SC	2016	NA	74254	70528	3726	5
CN4500500000000	45	005	Allendale County, SC	2016	NA	2666	2437	229	8.6
CN4500700000000	45	007	Anderson County, SC	2016	NA	89049	84947	4102	4.6
CN4500900000000	45	009	Bamberg County, SC	2016	NA	5326	4843	483	9.1
CN4501100000000	45	011	Barnwell County, SC	2016	NA	8086	7487	599	7.4
CN4501300000000	45	013	Beaufort County, SC	2016	NA	72630	69147	3483	4.8
CN4501500000000	45	015	Berkeley County, SC	2016	NA	97155	92694	4461	4.6
CN4501700000000	45	017	Calhoun County, SC	2016	NA	6913	6484	429	6.2
CN4501900000000	45	019	Charleston County, SC	2016	NA	202083	193793	8290	4.1
CN4502100000000	45	021	Cherokee County, SC	2016	NA	23572	22159	1413	6
CN4502300000000	45	023	Chester County, SC	2016	NA	13415	12446	969	7.2
CN4502500000000	45	025	Chesterfield County, SC	2016	NA	21670	20585	1085	5
CN4502700000000	45	027	Clarendon County, SC	2016	NA	12741	11888	853	6.7
CN4502900000000	45	029	Colleton County, SC	2016	NA	16783	15841	942	5.6
CN4503100000000	45	031	Darlington County, SC	2016	NA	29960	28087	1873	6.3
CN4503300000000	45	033	Dillon County, SC	2016	NA	12708	11845	863	6.8
CN4503500000000	45	035	Dorchester County, SC	2016	NA	73287	69918	3369	4.6
CN4503700000000	45	037	Edgefield County, SC	2016	NA	10565	9964	601	5.7
CN4503900000000	45	039	Fairfield County, SC	2016	NA	10014	9289	725	7.2
CN4504100000000	45	041	Florence County, SC	2016	NA	65488	62024	3464	5.3
CN4504300000000	45	043	Georgetown County, SC	2016	NA	25009	23303	1706	6.8
CN4504500000000	45	045	Greenville County, SC	2016	NA	245926	235461	10465	4.3
CN4504700000000	45	047	Greenwood County, SC	2016	NA	31401	29770	1631	5.2
CN4504900000000	45	049	Hampton County, SC	2016	NA	8243	7760	483	5.9
CN4505100000000	45	051	Horry County, SC	2016	NA	140424	132187	8237	5.9
CN4505300000000	45	053	Jasper County, SC	2016	NA	12018	11492	526	4.4
CN4505500000000	45	055	Kershaw County, SC	2016	NA	29296	27761	1535	5.2
CN4505700000000	45	057	Lancaster County, SC	2016	NA	38406	36354	2052	5.3
CN4505900000000	45	059	Laurens County, SC	2016	NA	30085	28512	1573	5.2
CN4506100000000	45	061	Lee County, SC	2016	NA	6450	5992	458	7.1
CN4506300000000	45	063	Lexington County, SC	2016	NA	148313	142252	6061	4.1
CN4506500000000	45	065	McCormick County, SC	2016	NA	3398	3208	190	5.6
CN4506700000000	45	067	Marion County, SC	2016	NA	12704	11592	1112	8.8
CN4506900000000	45	069	Marlboro County, SC	2016	NA	9329	8542	787	8.4
CN4507100000000	45	071	Newberry County, SC	2016	NA	19222	18365	857	4.5
CN4507300000000	45	073	Oconee County, SC	2016	NA	34279	32504	1775	5.2
CN4507500000000	45	075	Orangeburg County, SC	2016	NA	35681	32503	3178	8.9
CN4507700000000	45	077	Pickens County, SC	2016	NA	56452	53633	2819	5
CN4507900000000	45	079	Richland County, SC	2016	NA	200756	191043	9713	4.8
CN4508100000000	45	081	Saluda County, SC	2016	NA	8910	8504	406	4.6
CN4508300000000	45	083	Spartanburg County, SC	2016	NA	142621	135864	6757	4.7
CN4508500000000	45	085	Sumter County, SC	2016	NA	44351	41734	2617	5.9
CN4508700000000	45	087	Union County, SC	2016	NA	11487	10772	715	6.2
CN4508900000000	45	089	Williamsburg County, SC	2016	NA	12497	11528	969	7.8
CN4509100000000	45	091	York County, SC	2016	NA	130876	124812	6064	4.6
CN4600300000000	46	003	Aurora County, SD	2016	NA	1521	1487	34	2.2
CN4600500000000	46	005	Beadle County, SD	2016	NA	9411	9168	243	2.6
CN4600700000000	46	007	Bennett County, SD	2016	NA	1123	1079	44	3.9
CN4600900000000	46	009	Bon Homme County, SD	2016	NA	2945	2865	80	2.7
CN4601100000000	46	011	Brookings County, SD	2016	NA	18886	18369	517	2.7
CN4601300000000	46	013	Brown County, SD	2016	NA	21087	20524	563	2.7
CN4601500000000	46	015	Brule County, SD	2016	NA	2471	2408	63	2.5
CN4601700000000	46	017	Buffalo County, SD	2016	NA	726	666	60	8.3
CN4601900000000	46	019	Butte County, SD	2016	NA	5047	4873	174	3.4
CN4602100000000	46	021	Campbell County, SD	2016	NA	850	825	25	2.9
CN4602300000000	46	023	Charles Mix County, SD	2016	NA	3888	3764	124	3.2
CN4602500000000	46	025	Clark County, SD	2016	NA	1920	1845	75	3.9
CN4602700000000	46	027	Clay County, SD	2016	NA	6986	6777	209	3
CN4602900000000	46	029	Codington County, SD	2016	NA	15205	14737	468	3.1
CN4603100000000	46	031	Corson County, SD	2016	NA	1454	1389	65	4.5
CN4603300000000	46	033	Custer County, SD	2016	NA	3993	3833	160	4
CN4603500000000	46	035	Davison County, SD	2016	NA	11237	10968	269	2.4
CN4603700000000	46	037	Day County, SD	2016	NA	2858	2737	121	4.2
CN4603900000000	46	039	Deuel County, SD	2016	NA	2239	2130	109	4.9
CN4604100000000	46	041	Dewey County, SD	2016	NA	2251	2049	202	9
CN4604300000000	46	043	Douglas County, SD	2016	NA	1671	1629	42	2.5
CN4604500000000	46	045	Edmunds County, SD	2016	NA	2163	2113	50	2.3
CN4604700000000	46	047	Fall River County, SD	2016	NA	3023	2891	132	4.4
CN4604900000000	46	049	Faulk County, SD	2016	NA	1113	1084	29	2.6
CN4605100000000	46	051	Grant County, SD	2016	NA	4457	4314	143	3.2
CN4605300000000	46	053	Gregory County, SD	2016	NA	2075	2013	62	3
CN4605500000000	46	055	Haakon County, SD	2016	NA	1106	1079	27	2.4
CN4605700000000	46	057	Hamlin County, SD	2016	NA	3173	3067	106	3.3
CN4605900000000	46	059	Hand County, SD	2016	NA	1831	1792	39	2.1
CN4606100000000	46	061	Hanson County, SD	2016	NA	1769	1709	60	3.4
CN4606300000000	46	063	Harding County, SD	2016	NA	761	739	22	2.9
CN4606500000000	46	065	Hughes County, SD	2016	NA	10063	9825	238	2.4
CN4606700000000	46	067	Hutchinson County, SD	2016	NA	3650	3557	93	2.5
CN4606900000000	46	069	Hyde County, SD	2016	NA	698	679	19	2.7
CN4607100000000	46	071	Jackson County, SD	2016	NA	1304	1250	54	4.1
CN4607300000000	46	073	Jerauld County, SD	2016	NA	1071	1045	26	2.4
CN4607500000000	46	075	Jones County, SD	2016	NA	569	556	13	2.3
CN4607700000000	46	077	Kingsbury County, SD	2016	NA	2740	2668	72	2.6
CN4607900000000	46	079	Lake County, SD	2016	NA	6456	6237	219	3.4
CN4608100000000	46	081	Lawrence County, SD	2016	NA	13062	12632	430	3.3
CN4608300000000	46	083	Lincoln County, SD	2016	NA	31437	30760	677	2.2
CN4608500000000	46	085	Lyman County, SD	2016	NA	1775	1692	83	4.7
CN4608700000000	46	087	McCook County, SD	2016	NA	3132	3055	77	2.5
CN4608900000000	46	089	McPherson County, SD	2016	NA	1088	1051	37	3.4
CN4609100000000	46	091	Marshall County, SD	2016	NA	2460	2365	95	3.9
CN4609300000000	46	093	Meade County, SD	2016	NA	13675	13246	429	3.1
CN4609500000000	46	095	Mellette County, SD	2016	NA	770	738	32	4.2
CN4609700000000	46	097	Miner County, SD	2016	NA	1201	1169	32	2.7
CN4609900000000	46	099	Minnehaha County, SD	2016	NA	107702	104943	2759	2.6
CN4610100000000	46	101	Moody County, SD	2016	NA	3949	3805	144	3.6
CN4610200000000	46	102	Oglala Lakota County, SD	2016	NA	3611	3224	387	10.7
CN4610300000000	46	103	Pennington County, SD	2016	NA	54706	53024	1682	3.1
CN4610500000000	46	105	Perkins County, SD	2016	NA	1577	1532	45	2.9
CN4610700000000	46	107	Potter County, SD	2016	NA	1157	1126	31	2.7
CN4610900000000	46	109	Roberts County, SD	2016	NA	4840	4640	200	4.1
CN4611100000000	46	111	Sanborn County, SD	2016	NA	1209	1173	36	3
CN4611500000000	46	115	Spink County, SD	2016	NA	3285	3184	101	3.1
CN4611700000000	46	117	Stanley County, SD	2016	NA	1870	1825	45	2.4
CN4611900000000	46	119	Sully County, SD	2016	NA	859	839	20	2.3
CN4612100000000	46	121	Todd County, SD	2016	NA	3059	2862	197	6.4
CN4612300000000	46	123	Tripp County, SD	2016	NA	3063	2995	68	2.2
CN4612500000000	46	125	Turner County, SD	2016	NA	4676	4546	130	2.8
CN4612700000000	46	127	Union County, SD	2016	NA	8048	7798	250	3.1
CN4612900000000	46	129	Walworth County, SD	2016	NA	2241	2126	115	5.1
CN4613500000000	46	135	Yankton County, SD	2016	NA	11583	11286	297	2.6
CN4613700000000	46	137	Ziebach County, SD	2016	NA	976	932	44	4.5
CN4700100000000	47	001	Anderson County, TN	2016	NA	33547	31921	1626	4.8
CN4700300000000	47	003	Bedford County, TN	2016	NA	19752	18773	979	5
CN4700500000000	47	005	Benton County, TN	2016	NA	6714	6237	477	7.1
CN4700700000000	47	007	Bledsoe County, TN	2016	NA	4306	4007	299	6.9
CN4700900000000	47	009	Blount County, TN	2016	NA	60618	57977	2641	4.4
CN4701100000000	47	011	Bradley County, TN	2016	NA	49945	47725	2220	4.4
CN4701300000000	47	013	Campbell County, TN	2016	NA	14680	13667	1013	6.9
CN4701500000000	47	015	Cannon County, TN	2016	NA	5999	5722	277	4.6
CN4701700000000	47	017	Carroll County, TN	2016	NA	11979	11176	803	6.7
CN4701900000000	47	019	Carter County, TN	2016	NA	23584	22255	1329	5.6
CN4702100000000	47	021	Cheatham County, TN	2016	NA	20188	19387	801	4
CN4702300000000	47	023	Chester County, TN	2016	NA	8415	7997	418	5
CN4702500000000	47	025	Claiborne County, TN	2016	NA	12652	11867	785	6.2
CN4702700000000	47	027	Clay County, TN	2016	NA	3031	2833	198	6.5
CN4702900000000	47	029	Cocke County, TN	2016	NA	14398	13491	907	6.3
CN4703100000000	47	031	Coffee County, TN	2016	NA	24364	23219	1145	4.7
CN4703300000000	47	033	Crockett County, TN	2016	NA	6861	6503	358	5.2
CN4703500000000	47	035	Cumberland County, TN	2016	NA	23475	22088	1387	5.9
CN4703700000000	47	037	Davidson County, TN	2016	NA	372624	359204	13420	3.6
CN4703900000000	47	039	Decatur County, TN	2016	NA	4644	4325	319	6.9
CN4704100000000	47	041	DeKalb County, TN	2016	NA	7520	7103	417	5.5
CN4704300000000	47	043	Dickson County, TN	2016	NA	24696	23623	1073	4.3
CN4704500000000	47	045	Dyer County, TN	2016	NA	16307	15298	1009	6.2
CN4704700000000	47	047	Fayette County, TN	2016	NA	18216	17301	915	5
CN4704900000000	47	049	Fentress County, TN	2016	NA	7081	6645	436	6.2
CN4705100000000	47	051	Franklin County, TN	2016	NA	19768	18811	957	4.8
CN4705300000000	47	053	Gibson County, TN	2016	NA	21160	19924	1236	5.8
CN4705500000000	47	055	Giles County, TN	2016	NA	15219	14608	611	4
CN4705700000000	47	057	Grainger County, TN	2016	NA	9252	8752	500	5.4
CN4705900000000	47	059	Greene County, TN	2016	NA	30763	29089	1674	5.4
CN4706100000000	47	061	Grundy County, TN	2016	NA	4772	4464	308	6.5
CN4706300000000	47	063	Hamblen County, TN	2016	NA	26753	25390	1363	5.1
CN4706500000000	47	065	Hamilton County, TN	2016	NA	171297	163427	7870	4.6
CN4706700000000	47	067	Hancock County, TN	2016	NA	2026	1866	160	7.9
CN4706900000000	47	069	Hardeman County, TN	2016	NA	9161	8599	562	6.1
CN4707100000000	47	071	Hardin County, TN	2016	NA	10168	9562	606	6
CN4707300000000	47	073	Hawkins County, TN	2016	NA	23623	22352	1271	5.4
CN4707500000000	47	075	Haywood County, TN	2016	NA	7649	7154	495	6.5
CN4707700000000	47	077	Henderson County, TN	2016	NA	11944	11129	815	6.8
CN4707900000000	47	079	Henry County, TN	2016	NA	13873	13058	815	5.9
CN4708100000000	47	081	Hickman County, TN	2016	NA	10398	9918	480	4.6
CN4708300000000	47	083	Houston County, TN	2016	NA	3186	2947	239	7.5
CN4708500000000	47	085	Humphreys County, TN	2016	NA	8611	8095	516	6
CN4708700000000	47	087	Jackson County, TN	2016	NA	4476	4164	312	7
CN4708900000000	47	089	Jefferson County, TN	2016	NA	23529	22290	1239	5.3
CN4709100000000	47	091	Johnson County, TN	2016	NA	7514	7154	360	4.8
CN4709300000000	47	093	Knox County, TN	2016	NA	232864	223589	9275	4
CN4709500000000	47	095	Lake County, TN	2016	NA	1908	1760	148	7.8
CN4709700000000	47	097	Lauderdale County, TN	2016	NA	9400	8676	724	7.7
CN4709900000000	47	099	Lawrence County, TN	2016	NA	17731	16711	1020	5.8
CN4710100000000	47	101	Lewis County, TN	2016	NA	4869	4581	288	5.9
CN4710300000000	47	103	Lincoln County, TN	2016	NA	15908	15258	650	4.1
CN4710500000000	47	105	Loudon County, TN	2016	NA	22202	21168	1034	4.7
CN4710700000000	47	107	McMinn County, TN	2016	NA	22679	21451	1228	5.4
CN4710900000000	47	109	McNairy County, TN	2016	NA	8734	8122	612	7
CN4711100000000	47	111	Macon County, TN	2016	NA	10201	9757	444	4.4
CN4711300000000	47	113	Madison County, TN	2016	NA	47628	45317	2311	4.9
CN4711500000000	47	115	Marion County, TN	2016	NA	11878	11133	745	6.3
CN4711700000000	47	117	Marshall County, TN	2016	NA	15020	14329	691	4.6
CN4711900000000	47	119	Maury County, TN	2016	NA	43933	42164	1769	4
CN4712100000000	47	121	Meigs County, TN	2016	NA	4880	4548	332	6.8
CN4712300000000	47	123	Monroe County, TN	2016	NA	19335	18317	1018	5.3
CN4712500000000	47	125	Montgomery County, TN	2016	NA	79683	75637	4046	5.1
CN4712700000000	47	127	Moore County, TN	2016	NA	3374	3247	127	3.8
CN4712900000000	47	129	Morgan County, TN	2016	NA	7776	7276	500	6.4
CN4713100000000	47	131	Obion County, TN	2016	NA	12525	11645	880	7
CN4713300000000	47	133	Overton County, TN	2016	NA	9183	8693	490	5.3
CN4713500000000	47	135	Perry County, TN	2016	NA	3179	2978	201	6.3
CN4713700000000	47	137	Pickett County, TN	2016	NA	2318	2165	153	6.6
CN4713900000000	47	139	Polk County, TN	2016	NA	7364	6943	421	5.7
CN4714100000000	47	141	Putnam County, TN	2016	NA	33140	31521	1619	4.9
CN4714300000000	47	143	Rhea County, TN	2016	NA	13426	12475	951	7.1
CN4714500000000	47	145	Roane County, TN	2016	NA	22780	21516	1264	5.5
CN4714700000000	47	147	Robertson County, TN	2016	NA	34635	33199	1436	4.1
CN4714900000000	47	149	Rutherford County, TN	2016	NA	163069	157053	6016	3.7
CN4715100000000	47	151	Scott County, TN	2016	NA	7993	7403	590	7.4
CN4715300000000	47	153	Sequatchie County, TN	2016	NA	5900	5557	343	5.8
CN4715500000000	47	155	Sevier County, TN	2016	NA	51026	48508	2518	4.9
CN4715700000000	47	157	Shelby County, TN	2016	NA	432665	409622	23043	5.3
CN4715900000000	47	159	Smith County, TN	2016	NA	8650	8255	395	4.6
CN4716100000000	47	161	Stewart County, TN	2016	NA	5148	4800	348	6.8
CN4716300000000	47	163	Sullivan County, TN	2016	NA	69521	65937	3584	5.2
CN4716500000000	47	165	Sumner County, TN	2016	NA	92013	88448	3565	3.9
CN4716700000000	47	167	Tipton County, TN	2016	NA	27410	25857	1553	5.7
CN4716900000000	47	169	Trousdale County, TN	2016	NA	3833	3648	185	4.8
CN4717100000000	47	171	Unicoi County, TN	2016	NA	6987	6492	495	7.1
CN4717300000000	47	173	Union County, TN	2016	NA	7254	6836	418	5.8
CN4717500000000	47	175	Van Buren County, TN	2016	NA	2030	1905	125	6.2
CN4717700000000	47	177	Warren County, TN	2016	NA	17612	16767	845	4.8
CN4717900000000	47	179	Washington County, TN	2016	NA	58537	55747	2790	4.8
CN4718100000000	47	181	Wayne County, TN	2016	NA	6067	5669	398	6.6
CN4718300000000	47	183	Weakley County, TN	2016	NA	15808	14886	922	5.8
CN4718500000000	47	185	White County, TN	2016	NA	11721	11139	582	5
CN4718700000000	47	187	Williamson County, TN	2016	NA	113165	109311	3854	3.4
CN4718900000000	47	189	Wilson County, TN	2016	NA	67595	64999	2596	3.8
CN4800100000000	48	001	Anderson County, TX	2016	NA	23500	22484	1016	4.3
CN4800300000000	48	003	Andrews County, TX	2016	NA	8686	8277	409	4.7
CN4800500000000	48	005	Angelina County, TX	2016	NA	37048	34864	2184	5.9
CN4800700000000	48	007	Aransas County, TX	2016	NA	10234	9663	571	5.6
CN4800900000000	48	009	Archer County, TX	2016	NA	4087	3911	176	4.3
CN4801100000000	48	011	Armstrong County, TX	2016	NA	934	908	26	2.8
CN4801300000000	48	013	Atascosa County, TX	2016	NA	21012	19892	1120	5.3
CN4801500000000	48	015	Austin County, TX	2016	NA	14024	13278	746	5.3
CN4801700000000	48	017	Bailey County, TX	2016	NA	2717	2598	119	4.4
CN4801900000000	48	019	Bandera County, TX	2016	NA	9499	9110	389	4.1
CN4802100000000	48	021	Bastrop County, TX	2016	NA	39014	37557	1457	3.7
CN4802300000000	48	023	Baylor County, TX	2016	NA	1605	1547	58	3.6
CN4802500000000	48	025	Bee County, TX	2016	NA	10305	9531	774	7.5
CN4802700000000	48	027	Bell County, TX	2016	NA	139445	133173	6272	4.5
CN4802900000000	48	029	Bexar County, TX	2016	NA	905115	871260	33855	3.7
CN4803100000000	48	031	Blanco County, TX	2016	NA	5932	5749	183	3.1
CN4803300000000	48	033	Borden County, TX	2016	NA	366	353	13	3.6
CN4803500000000	48	035	Bosque County, TX	2016	NA	8185	7833	352	4.3
CN4803700000000	48	037	Bowie County, TX	2016	NA	39610	37749	1861	4.7
CN4803900000000	48	039	Brazoria County, TX	2016	NA	169795	161001	8794	5.2
CN4804100000000	48	041	Brazos County, TX	2016	NA	111251	107409	3842	3.5
CN4804300000000	48	043	Brewster County, TX	2016	NA	3960	3811	149	3.8
CN4804500000000	48	045	Briscoe County, TX	2016	NA	548	524	24	4.4
CN4804700000000	48	047	Brooks County, TX	2016	NA	2438	2151	287	11.8
CN4804900000000	48	049	Brown County, TX	2016	NA	16164	15463	701	4.3
CN4805100000000	48	051	Burleson County, TX	2016	NA	7872	7507	365	4.6
CN4805300000000	48	053	Burnet County, TX	2016	NA	21986	21226	760	3.5
CN4805500000000	48	055	Caldwell County, TX	2016	NA	17936	17161	775	4.3
CN4805700000000	48	057	Calhoun County, TX	2016	NA	10771	10171	600	5.6
CN4805900000000	48	059	Callahan County, TX	2016	NA	5804	5557	247	4.3
CN4806100000000	48	061	Cameron County, TX	2016	NA	165955	154064	11891	7.2
CN4806300000000	48	063	Camp County, TX	2016	NA	5059	4714	345	6.8
CN4806500000000	48	065	Carson County, TX	2016	NA	3096	2995	101	3.3
CN4806700000000	48	067	Cass County, TX	2016	NA	12264	11384	880	7.2
CN4806900000000	48	069	Castro County, TX	2016	NA	3494	3387	107	3.1
CN4807100000000	48	071	Chambers County, TX	2016	NA	18204	17098	1106	6.1
CN4807300000000	48	073	Cherokee County, TX	2016	NA	21190	20115	1075	5.1
CN4807500000000	48	075	Childress County, TX	2016	NA	2958	2870	88	3
CN4807700000000	48	077	Clay County, TX	2016	NA	4793	4584	209	4.4
CN4807900000000	48	079	Cochran County, TX	2016	NA	1174	1114	60	5.1
CN4808100000000	48	081	Coke County, TX	2016	NA	1421	1362	59	4.2
CN4808300000000	48	083	Coleman County, TX	2016	NA	3064	2886	178	5.8
CN4808500000000	48	085	Collin County, TX	2016	NA	512827	494723	18104	3.5
CN4808700000000	48	087	Collingsworth County, TX	2016	NA	1215	1173	42	3.5
CN4808900000000	48	089	Colorado County, TX	2016	NA	9790	9329	461	4.7
CN4809100000000	48	091	Comal County, TX	2016	NA	65468	63103	2365	3.6
CN4809300000000	48	093	Comanche County, TX	2016	NA	5356	5126	230	4.3
CN4809500000000	48	095	Concho County, TX	2016	NA	1331	1286	45	3.4
CN4809700000000	48	097	Cooke County, TX	2016	NA	18907	18158	749	4
CN4809900000000	48	099	Coryell County, TX	2016	NA	24407	23269	1138	4.7
CN4810100000000	48	101	Cottle County, TX	2016	NA	525	498	27	5.1
CN4810300000000	48	103	Crane County, TX	2016	NA	1705	1559	146	8.6
CN4810500000000	48	105	Crockett County, TX	2016	NA	1735	1605	130	7.5
CN4810700000000	48	107	Crosby County, TX	2016	NA	2620	2506	114	4.4
CN4810900000000	48	109	Culberson County, TX	2016	NA	1000	959	41	4.1
CN4811100000000	48	111	Dallam County, TX	2016	NA	3998	3909	89	2.2
CN4811300000000	48	113	Dallas County, TX	2016	NA	1298058	1245964	52094	4
CN4811500000000	48	115	Dawson County, TX	2016	NA	4638	4406	232	5
CN4811700000000	48	117	Deaf Smith County, TX	2016	NA	8606	8338	268	3.1
CN4811900000000	48	119	Delta County, TX	2016	NA	2606	2507	99	3.8
CN4812100000000	48	121	Denton County, TX	2016	NA	451787	436317	15470	3.4
CN4812300000000	48	123	DeWitt County, TX	2016	NA	9495	8977	518	5.5
CN4812500000000	48	125	Dickens County, TX	2016	NA	691	657	34	4.9
CN4812700000000	48	127	Dimmit County, TX	2016	NA	6236	5792	444	7.1
CN4812900000000	48	129	Donley County, TX	2016	NA	1556	1493	63	4
CN4813100000000	48	131	Duval County, TX	2016	NA	4882	4349	533	10.9
CN4813300000000	48	133	Eastland County, TX	2016	NA	7417	7014	403	5.4
CN4813500000000	48	135	Ector County, TX	2016	NA	76176	71340	4836	6.3
CN4813700000000	48	137	Edwards County, TX	2016	NA	866	826	40	4.6
CN4813900000000	48	139	Ellis County, TX	2016	NA	84956	81779	3177	3.7
CN4814100000000	48	141	El Paso County, TX	2016	NA	349633	332375	17258	4.9
CN4814300000000	48	143	Erath County, TX	2016	NA	20224	19405	819	4
CN4814500000000	48	145	Falls County, TX	2016	NA	6607	6317	290	4.4
CN4814700000000	48	147	Fannin County, TX	2016	NA	15760	15168	592	3.8
CN4814900000000	48	149	Fayette County, TX	2016	NA	12485	12030	455	3.6
CN4815100000000	48	151	Fisher County, TX	2016	NA	1758	1683	75	4.3
CN4815300000000	48	153	Floyd County, TX	2016	NA	2736	2598	138	5
CN4815500000000	48	155	Foard County, TX	2016	NA	540	520	20	3.7
CN4815700000000	48	157	Fort Bend County, TX	2016	NA	366735	348446	18289	5
CN4815900000000	48	159	Franklin County, TX	2016	NA	4507	4287	220	4.9
CN4816100000000	48	161	Freestone County, TX	2016	NA	6866	6408	458	6.7
CN4816300000000	48	163	Frio County, TX	2016	NA	8776	8350	426	4.9
CN4816500000000	48	165	Gaines County, TX	2016	NA	9179	8838	341	3.7
CN4816700000000	48	167	Galveston County, TX	2016	NA	160038	151521	8517	5.3
CN4816900000000	48	169	Garza County, TX	2016	NA	2129	2046	83	3.9
CN4817100000000	48	171	Gillespie County, TX	2016	NA	12991	12622	369	2.8
CN4817300000000	48	173	Glasscock County, TX	2016	NA	749	720	29	3.9
CN4817500000000	48	175	Goliad County, TX	2016	NA	3316	3124	192	5.8
CN4817700000000	48	177	Gonzales County, TX	2016	NA	9567	9162	405	4.2
CN4817900000000	48	179	Gray County, TX	2016	NA	8481	7898	583	6.9
CN4818100000000	48	181	Grayson County, TX	2016	NA	61180	58827	2353	3.8
CN4818300000000	48	183	Gregg County, TX	2016	NA	58332	54789	3543	6.1
CN4818500000000	48	185	Grimes County, TX	2016	NA	11048	10319	729	6.6
CN4818700000000	48	187	Guadalupe County, TX	2016	NA	75931	73213	2718	3.6
CN4818900000000	48	189	Hale County, TX	2016	NA	12585	11879	706	5.6
CN4819100000000	48	191	Hall County, TX	2016	NA	1165	1087	78	6.7
CN4819300000000	48	193	Hamilton County, TX	2016	NA	3598	3422	176	4.9
CN4819500000000	48	195	Hansford County, TX	2016	NA	2944	2852	92	3.1
CN4819700000000	48	197	Hardeman County, TX	2016	NA	1624	1560	64	3.9
CN4819900000000	48	199	Hardin County, TX	2016	NA	25148	23620	1528	6.1
CN4820100000000	48	201	Harris County, TX	2016	NA	2249341	2129674	119667	5.3
CN4820300000000	48	203	Harrison County, TX	2016	NA	29935	28140	1795	6
CN4820500000000	48	205	Hartley County, TX	2016	NA	2959	2899	60	2
CN4820700000000	48	207	Haskell County, TX	2016	NA	2508	2402	106	4.2
CN4820900000000	48	209	Hays County, TX	2016	NA	104838	101347	3491	3.3
CN4821100000000	48	211	Hemphill County, TX	2016	NA	2114	2035	79	3.7
CN4821300000000	48	213	Henderson County, TX	2016	NA	35369	33718	1651	4.7
CN4821500000000	48	215	Hidalgo County, TX	2016	NA	336926	310647	26279	7.8
CN4821700000000	48	217	Hill County, TX	2016	NA	15799	15104	695	4.4
CN4821900000000	48	219	Hockley County, TX	2016	NA	11167	10649	518	4.6
CN4822100000000	48	221	Hood County, TX	2016	NA	25255	24070	1185	4.7
CN4822300000000	48	223	Hopkins County, TX	2016	NA	17317	16628	689	4
CN4822500000000	48	225	Houston County, TX	2016	NA	10058	9595	463	4.6
CN4822700000000	48	227	Howard County, TX	2016	NA	13207	12477	730	5.5
CN4822900000000	48	229	Hudspeth County, TX	2016	NA	1541	1449	92	6
CN4823100000000	48	231	Hunt County, TX	2016	NA	40499	38767	1732	4.3
CN4823300000000	48	233	Hutchinson County, TX	2016	NA	9630	9089	541	5.6
CN4823500000000	48	235	Irion County, TX	2016	NA	780	755	25	3.2
CN4823700000000	48	237	Jack County, TX	2016	NA	3853	3663	190	4.9
CN4823900000000	48	239	Jackson County, TX	2016	NA	7271	6932	339	4.7
CN4824100000000	48	241	Jasper County, TX	2016	NA	13460	12429	1031	7.7
CN4824300000000	48	243	Jeff Davis County, TX	2016	NA	1072	1041	31	2.9
CN4824500000000	48	245	Jefferson County, TX	2016	NA	107450	99932	7518	7
CN4824700000000	48	247	Jim Hogg County, TX	2016	NA	1943	1758	185	9.5
CN4824900000000	48	249	Jim Wells County, TX	2016	NA	17452	15614	1838	10.5
CN4825100000000	48	251	Johnson County, TX	2016	NA	76008	72703	3305	4.3
CN4825300000000	48	253	Jones County, TX	2016	NA	5622	5297	325	5.8
CN4825500000000	48	255	Karnes County, TX	2016	NA	6274	5968	306	4.9
CN4825700000000	48	257	Kaufman County, TX	2016	NA	57893	55704	2189	3.8
CN4825900000000	48	259	Kendall County, TX	2016	NA	20338	19689	649	3.2
CN4826100000000	48	261	Kenedy County, TX	2016	NA	217	207	10	4.6
CN4826300000000	48	263	Kent County, TX	2016	NA	469	455	14	3
CN4826500000000	48	265	Kerr County, TX	2016	NA	21349	20583	766	3.6
CN4826700000000	48	267	Kimble County, TX	2016	NA	1951	1877	74	3.8
CN4826900000000	48	269	King County, TX	2016	NA	178	171	7	3.9
CN4827100000000	48	271	Kinney County, TX	2016	NA	1156	1089	67	5.8
CN4827300000000	48	273	Kleberg County, TX	2016	NA	14103	13157	946	6.7
CN4827500000000	48	275	Knox County, TX	2016	NA	1558	1492	66	4.2
CN4827700000000	48	277	Lamar County, TX	2016	NA	23219	22146	1073	4.6
CN4827900000000	48	279	Lamb County, TX	2016	NA	5245	4905	340	6.5
CN4828100000000	48	281	Lampasas County, TX	2016	NA	9157	8777	380	4.1
CN4828300000000	48	283	La Salle County, TX	2016	NA	3884	3685	199	5.1
CN4828500000000	48	285	Lavaca County, TX	2016	NA	8738	8370	368	4.2
CN4828700000000	48	287	Lee County, TX	2016	NA	9280	8930	350	3.8
CN4828900000000	48	289	Leon County, TX	2016	NA	6508	6087	421	6.5
CN4829100000000	48	291	Liberty County, TX	2016	NA	31525	29156	2369	7.5
CN4829300000000	48	293	Limestone County, TX	2016	NA	8322	7857	465	5.6
CN4829500000000	48	295	Lipscomb County, TX	2016	NA	1651	1578	73	4.4
CN4829700000000	48	297	Live Oak County, TX	2016	NA	5201	4893	308	5.9
CN4829900000000	48	299	Llano County, TX	2016	NA	8289	7944	345	4.2
CN4830100000000	48	301	Loving County, TX	2016	NA	86	82	4	4.7
CN4830300000000	48	303	Lubbock County, TX	2016	NA	153504	148310	5194	3.4
CN4830500000000	48	305	Lynn County, TX	2016	NA	2729	2621	108	4
CN4830700000000	48	307	McCulloch County, TX	2016	NA	3709	3543	166	4.5
CN4830900000000	48	309	McLennan County, TX	2016	NA	116053	111471	4582	3.9
CN4831100000000	48	311	McMullen County, TX	2016	NA	861	843	18	2.1
CN4831300000000	48	313	Madison County, TX	2016	NA	4766	4524	242	5.1
CN4831500000000	48	315	Marion County, TX	2016	NA	4340	4036	304	7
CN4831700000000	48	317	Martin County, TX	2016	NA	2481	2372	109	4.4
CN4831900000000	48	319	Mason County, TX	2016	NA	1790	1725	65	3.6
CN4832100000000	48	321	Matagorda County, TX	2016	NA	16874	15642	1232	7.3
CN4832300000000	48	323	Maverick County, TX	2016	NA	24222	21505	2717	11.2
CN4832500000000	48	325	Medina County, TX	2016	NA	20982	20060	922	4.4
CN4832700000000	48	327	Menard County, TX	2016	NA	816	780	36	4.4
CN4832900000000	48	329	Midland County, TX	2016	NA	85010	81271	3739	4.4
CN4833100000000	48	331	Milam County, TX	2016	NA	10263	9735	528	5.1
CN4833300000000	48	333	Mills County, TX	2016	NA	1924	1844	80	4.2
CN4833500000000	48	335	Mitchell County, TX	2016	NA	2608	2425	183	7
CN4833700000000	48	337	Montague County, TX	2016	NA	9028	8582	446	4.9
CN4833900000000	48	339	Montgomery County, TX	2016	NA	265773	252769	13004	4.9
CN4834100000000	48	341	Moore County, TX	2016	NA	11188	10857	331	3
CN4834300000000	48	343	Morris County, TX	2016	NA	4891	4357	534	10.9
CN4834500000000	48	345	Motley County, TX	2016	NA	508	490	18	3.5
CN4834700000000	48	347	Nacogdoches County, TX	2016	NA	28697	27356	1341	4.7
CN4834900000000	48	349	Navarro County, TX	2016	NA	22757	21807	950	4.2
CN4835100000000	48	351	Newton County, TX	2016	NA	5349	4926	423	7.9
CN4835300000000	48	353	Nolan County, TX	2016	NA	6862	6533	329	4.8
CN4835500000000	48	355	Nueces County, TX	2016	NA	167680	158247	9433	5.6
CN4835700000000	48	357	Ochiltree County, TX	2016	NA	4660	4416	244	5.2
CN4835900000000	48	359	Oldham County, TX	2016	NA	908	881	27	3
CN4836100000000	48	361	Orange County, TX	2016	NA	37334	34835	2499	6.7
CN4836300000000	48	363	Palo Pinto County, TX	2016	NA	13244	12522	722	5.5
CN4836500000000	48	365	Panola County, TX	2016	NA	10225	9493	732	7.2
CN4836700000000	48	367	Parker County, TX	2016	NA	61245	58758	2487	4.1
CN4836900000000	48	369	Parmer County, TX	2016	NA	4946	4822	124	2.5
CN4837100000000	48	371	Pecos County, TX	2016	NA	6493	6112	381	5.9
CN4837300000000	48	373	Polk County, TX	2016	NA	17372	16276	1096	6.3
CN4837500000000	48	375	Potter County, TX	2016	NA	56133	54257	1876	3.3
CN4837700000000	48	377	Presidio County, TX	2016	NA	3078	2749	329	10.7
CN4837900000000	48	379	Rains County, TX	2016	NA	5551	5329	222	4
CN4838100000000	48	381	Randall County, TX	2016	NA	70631	68549	2082	2.9
CN4838300000000	48	383	Reagan County, TX	2016	NA	1701	1596	105	6.2
CN4838500000000	48	385	Real County, TX	2016	NA	1041	982	59	5.7
CN4838700000000	48	387	Red River County, TX	2016	NA	5031	4740	291	5.8
CN4838900000000	48	389	Reeves County, TX	2016	NA	6031	5711	320	5.3
CN4839100000000	48	391	Refugio County, TX	2016	NA	3134	2927	207	6.6
CN4839300000000	48	393	Roberts County, TX	2016	NA	442	422	20	4.5
CN4839500000000	48	395	Robertson County, TX	2016	NA	7253	6886	367	5.1
CN4839700000000	48	397	Rockwall County, TX	2016	NA	47329	45673	1656	3.5
CN4839900000000	48	399	Runnels County, TX	2016	NA	4646	4463	183	3.9
CN4840100000000	48	401	Rusk County, TX	2016	NA	22363	21062	1301	5.8
CN4840300000000	48	403	Sabine County, TX	2016	NA	3481	3155	326	9.4
CN4840500000000	48	405	San Augustine County, TX	2016	NA	2802	2552	250	8.9
CN4840700000000	48	407	San Jacinto County, TX	2016	NA	11421	10706	715	6.3
CN4840900000000	48	409	San Patricio County, TX	2016	NA	30594	28316	2278	7.4
CN4841100000000	48	411	San Saba County, TX	2016	NA	2447	2364	83	3.4
CN4841300000000	48	413	Schleicher County, TX	2016	NA	1420	1346	74	5.2
CN4841500000000	48	415	Scurry County, TX	2016	NA	7404	6969	435	5.9
CN4841700000000	48	417	Shackelford County, TX	2016	NA	1876	1804	72	3.8
CN4841900000000	48	419	Shelby County, TX	2016	NA	10949	10293	656	6
CN4842100000000	48	421	Sherman County, TX	2016	NA	1349	1310	39	2.9
CN4842300000000	48	423	Smith County, TX	2016	NA	105398	100638	4760	4.5
CN4842500000000	48	425	Somervell County, TX	2016	NA	4130	3932	198	4.8
CN4842700000000	48	427	Starr County, TX	2016	NA	26333	22821	3512	13.3
CN4842900000000	48	429	Stephens County, TX	2016	NA	4015	3804	211	5.3
CN4843100000000	48	431	Sterling County, TX	2016	NA	669	643	26	3.9
CN4843300000000	48	433	Stonewall County, TX	2016	NA	640	612	28	4.4
CN4843500000000	48	435	Sutton County, TX	2016	NA	1590	1464	126	7.9
CN4843700000000	48	437	Swisher County, TX	2016	NA	2714	2599	115	4.2
CN4843900000000	48	439	Tarrant County, TX	2016	NA	1010694	970542	40152	4
CN4844100000000	48	441	Taylor County, TX	2016	NA	63271	60908	2363	3.7
CN4844300000000	48	443	Terrell County, TX	2016	NA	406	390	16	3.9
CN4844500000000	48	445	Terry County, TX	2016	NA	5348	5093	255	4.8
CN4844700000000	48	447	Throckmorton County, TX	2016	NA	743	717	26	3.5
CN4844900000000	48	449	Titus County, TX	2016	NA	12872	12080	792	6.2
CN4845100000000	48	451	Tom Green County, TX	2016	NA	54228	51803	2425	4.5
CN4845300000000	48	453	Travis County, TX	2016	NA	677945	656425	21520	3.2
CN4845500000000	48	455	Trinity County, TX	2016	NA	5480	5147	333	6.1
CN4845700000000	48	457	Tyler County, TX	2016	NA	7210	6684	526	7.3
CN4845900000000	48	459	Upshur County, TX	2016	NA	17887	16742	1145	6.4
CN4846100000000	48	461	Upton County, TX	2016	NA	1581	1497	84	5.3
CN4846300000000	48	463	Uvalde County, TX	2016	NA	11803	11177	626	5.3
CN4846500000000	48	465	Val Verde County, TX	2016	NA	20129	18874	1255	6.2
CN4846700000000	48	467	Van Zandt County, TX	2016	NA	24842	23775	1067	4.3
CN4846900000000	48	469	Victoria County, TX	2016	NA	43695	41329	2366	5.4
CN4847100000000	48	471	Walker County, TX	2016	NA	23774	22531	1243	5.2
CN4847300000000	48	473	Waller County, TX	2016	NA	22161	20925	1236	5.6
CN4847500000000	48	475	Ward County, TX	2016	NA	5392	5085	307	5.7
CN4847700000000	48	477	Washington County, TX	2016	NA	15076	14311	765	5.1
CN4847900000000	48	479	Webb County, TX	2016	NA	113792	108240	5552	4.9
CN4848100000000	48	481	Wharton County, TX	2016	NA	21061	20004	1057	5
CN4848300000000	48	483	Wheeler County, TX	2016	NA	2481	2364	117	4.7
CN4848500000000	48	485	Wichita County, TX	2016	NA	55437	53035	2402	4.3
CN4848700000000	48	487	Wilbarger County, TX	2016	NA	5046	4809	237	4.7
CN4848900000000	48	489	Willacy County, TX	2016	NA	6498	5703	795	12.2
CN4849100000000	48	491	Williamson County, TX	2016	NA	278496	269165	9331	3.4
CN4849300000000	48	493	Wilson County, TX	2016	NA	23741	22815	926	3.9
CN4849500000000	48	495	Winkler County, TX	2016	NA	3068	2832	236	7.7
CN4849700000000	48	497	Wise County, TX	2016	NA	29413	28025	1388	4.7
CN4849900000000	48	499	Wood County, TX	2016	NA	17234	16328	906	5.3
CN4850100000000	48	501	Yoakum County, TX	2016	NA	3758	3579	179	4.8
CN4850300000000	48	503	Young County, TX	2016	NA	8304	7941	363	4.4
CN4850500000000	48	505	Zapata County, TX	2016	NA	5204	4645	559	10.7
CN4850700000000	48	507	Zavala County, TX	2016	NA	3883	3345	538	13.9
CN4900100000000	49	001	Beaver County, UT	2016	NA	3076	2924	152	4.9
CN4900300000000	49	003	Box Elder County, UT	2016	NA	24683	23821	862	3.5
CN4900500000000	49	005	Cache County, UT	2016	NA	61232	59361	1871	3.1
CN4900700000000	49	007	Carbon County, UT	2016	NA	8334	7838	496	6
CN4900900000000	49	009	Daggett County, UT	2016	NA	463	439	24	5.2
CN4901100000000	49	011	Davis County, UT	2016	NA	164341	159150	5191	3.2
CN4901300000000	49	013	Duchesne County, UT	2016	NA	8113	7391	722	8.9
CN4901500000000	49	015	Emery County, UT	2016	NA	4265	3998	267	6.3
CN4901700000000	49	017	Garfield County, UT	2016	NA	2794	2561	233	8.3
CN4901900000000	49	019	Grand County, UT	2016	NA	5727	5390	337	5.9
CN4902100000000	49	021	Iron County, UT	2016	NA	21467	20531	936	4.4
CN4902300000000	49	023	Juab County, UT	2016	NA	5218	5028	190	3.6
CN4902500000000	49	025	Kane County, UT	2016	NA	3693	3552	141	3.8
CN4902700000000	49	027	Millard County, UT	2016	NA	6212	6005	207	3.3
CN4902900000000	49	029	Morgan County, UT	2016	NA	5142	4989	153	3
CN4903100000000	49	031	Piute County, UT	2016	NA	458	431	27	5.9
CN4903300000000	49	033	Rich County, UT	2016	NA	1095	1060	35	3.2
CN4903500000000	49	035	Salt Lake County, UT	2016	NA	601570	582448	19122	3.2
CN4903700000000	49	037	San Juan County, UT	2016	NA	5742	5278	464	8.1
CN4903900000000	49	039	Sanpete County, UT	2016	NA	11799	11328	471	4
CN4904100000000	49	041	Sevier County, UT	2016	NA	9589	9168	421	4.4
CN4904300000000	49	043	Summit County, UT	2016	NA	23873	23121	752	3.2
CN4904500000000	49	045	Tooele County, UT	2016	NA	30826	29655	1171	3.8
CN4904700000000	49	047	Uintah County, UT	2016	NA	14133	12814	1319	9.3
CN4904900000000	49	049	Utah County, UT	2016	NA	278913	270282	8631	3.1
CN4905100000000	49	051	Wasatch County, UT	2016	NA	13902	13431	471	3.4
CN4905300000000	49	053	Washington County, UT	2016	NA	67252	64738	2514	3.7
CN4905500000000	49	055	Wayne County, UT	2016	NA	1428	1316	112	7.8
CN4905700000000	49	057	Weber County, UT	2016	NA	120114	115498	4616	3.8
CN5000100000000	50	001	Addison County, VT	2016	NA	20855	20237	618	3
CN5000300000000	50	003	Bennington County, VT	2016	NA	18449	17756	693	3.8
CN5000500000000	50	005	Caledonia County, VT	2016	NA	14901	14284	617	4.1
CN5000700000000	50	007	Chittenden County, VT	2016	NA	95230	92854	2376	2.5
CN5000900000000	50	009	Essex County, VT	2016	NA	2700	2566	134	5
CN5001100000000	50	011	Franklin County, VT	2016	NA	27357	26510	847	3.1
CN5001300000000	50	013	Grand Isle County, VT	2016	NA	3975	3827	148	3.7
CN5001500000000	50	015	Lamoille County, VT	2016	NA	13922	13333	589	4.2
CN5001700000000	50	017	Orange County, VT	2016	NA	15900	15407	493	3.1
CN5001900000000	50	019	Orleans County, VT	2016	NA	13537	12828	709	5.2
CN5002100000000	50	021	Rutland County, VT	2016	NA	31460	30277	1183	3.8
CN5002300000000	50	023	Washington County, VT	2016	NA	33905	32826	1079	3.2
CN5002500000000	50	025	Windham County, VT	2016	NA	23221	22449	772	3.3
CN5002700000000	50	027	Windsor County, VT	2016	NA	29331	28473	858	2.9
CN5100100000000	51	001	Accomack County, VA	2016	NA	15783	15003	780	4.9
CN5100300000000	51	003	Albemarle County, VA	2016	NA	54381	52432	1949	3.6
CN5100500000000	51	005	Alleghany County, VA	2016	NA	6924	6568	356	5.1
CN5100700000000	51	007	Amelia County, VA	2016	NA	6191	5925	266	4.3
CN5100900000000	51	009	Amherst County, VA	2016	NA	14972	14310	662	4.4
CN5101100000000	51	011	Appomattox County, VA	2016	NA	6988	6658	330	4.7
CN5101300000000	51	013	Arlington County, VA	2016	NA	146178	142317	3861	2.6
CN5101500000000	51	015	Augusta County, VA	2016	NA	36795	35436	1359	3.7
CN5101700000000	51	017	Bath County, VA	2016	NA	2492	2399	93	3.7
CN5101900000000	51	019	Bedford County, VA	2016	NA	37913	36349	1564	4.1
CN5102100000000	51	021	Bland County, VA	2016	NA	2736	2591	145	5.3
CN5102300000000	51	023	Botetourt County, VA	2016	NA	17326	16691	635	3.7
CN5102500000000	51	025	Brunswick County, VA	2016	NA	6203	5830	373	6
CN5102700000000	51	027	Buchanan County, VA	2016	NA	6854	6113	741	10.8
CN5102900000000	51	029	Buckingham County, VA	2016	NA	6259	5916	343	5.5
CN5103100000000	51	031	Campbell County, VA	2016	NA	25906	24746	1160	4.5
CN5103300000000	51	033	Caroline County, VA	2016	NA	14839	14170	669	4.5
CN5103500000000	51	035	Carroll County, VA	2016	NA	12946	12274	672	5.2
CN5103600000000	51	036	Charles City County, VA	2016	NA	3716	3545	171	4.6
CN5103700000000	51	037	Charlotte County, VA	2016	NA	5246	4981	265	5.1
CN5104100000000	51	041	Chesterfield County, VA	2016	NA	180485	173447	7038	3.9
CN5104300000000	51	043	Clarke County, VA	2016	NA	7424	7156	268	3.6
CN5104500000000	51	045	Craig County, VA	2016	NA	2347	2234	113	4.8
CN5104700000000	51	047	Culpeper County, VA	2016	NA	23416	22499	917	3.9
CN5104900000000	51	049	Cumberland County, VA	2016	NA	4598	4384	214	4.7
CN5105100000000	51	051	Dickenson County, VA	2016	NA	4570	4112	458	10
CN5105300000000	51	053	Dinwiddie County, VA	2016	NA	13428	12767	661	4.9
CN5105700000000	51	057	Essex County, VA	2016	NA	5517	5247	270	4.9
CN5105900000000	51	059	Fairfax County, VA	2016	NA	615904	595834	20070	3.3
CN5106100000000	51	061	Fauquier County, VA	2016	NA	35876	34614	1262	3.5
CN5106300000000	51	063	Floyd County, VA	2016	NA	8179	7843	336	4.1
CN5106500000000	51	065	Fluvanna County, VA	2016	NA	13164	12716	448	3.4
CN5106700000000	51	067	Franklin County, VA	2016	NA	26333	25192	1141	4.3
CN5106900000000	51	069	Frederick County, VA	2016	NA	45277	43677	1600	3.5
CN5107100000000	51	071	Giles County, VA	2016	NA	7932	7502	430	5.4
CN5107300000000	51	073	Gloucester County, VA	2016	NA	19064	18360	704	3.7
CN5107500000000	51	075	Goochland County, VA	2016	NA	10815	10403	412	3.8
CN5107700000000	51	077	Grayson County, VA	2016	NA	7014	6652	362	5.2
CN5107900000000	51	079	Greene County, VA	2016	NA	9918	9590	328	3.3
CN5108100000000	51	081	Greensville County, VA	2016	NA	4202	3987	215	5.1
CN5108300000000	51	083	Halifax County, VA	2016	NA	14848	13973	875	5.9
CN5108500000000	51	085	Hanover County, VA	2016	NA	57094	55071	2023	3.5
CN5108700000000	51	087	Henrico County, VA	2016	NA	178604	171571	7033	3.9
CN5108900000000	51	089	Henry County, VA	2016	NA	22114	20866	1248	5.6
CN5109100000000	51	091	Highland County, VA	2016	NA	1306	1264	42	3.2
CN5109300000000	51	093	Isle of Wight County, VA	2016	NA	18905	18082	823	4.4
CN5109500000000	51	095	James City County, VA	2016	NA	34816	33453	1363	3.9
CN5109700000000	51	097	King and Queen County, VA	2016	NA	3655	3501	154	4.2
CN5109900000000	51	099	King George County, VA	2016	NA	12304	11772	532	4.3
CN5110100000000	51	101	King William County, VA	2016	NA	8738	8403	335	3.8
CN5110300000000	51	103	Lancaster County, VA	2016	NA	5103	4813	290	5.7
CN5110500000000	51	105	Lee County, VA	2016	NA	8435	7856	579	6.9
CN5110700000000	51	107	Loudoun County, VA	2016	NA	207000	200319	6681	3.2
CN5110900000000	51	109	Louisa County, VA	2016	NA	18543	17827	716	3.9
CN5111100000000	51	111	Lunenburg County, VA	2016	NA	5245	5001	244	4.7
CN5111300000000	51	113	Madison County, VA	2016	NA	7162	6936	226	3.2
CN5111500000000	51	115	Mathews County, VA	2016	NA	4034	3871	163	4
CN5111700000000	51	117	Mecklenburg County, VA	2016	NA	12445	11738	707	5.7
CN5111900000000	51	119	Middlesex County, VA	2016	NA	5021	4827	194	3.9
CN5112100000000	51	121	Montgomery County, VA	2016	NA	49664	47588	2076	4.2
CN5112500000000	51	125	Nelson County, VA	2016	NA	7226	6963	263	3.6
CN5112700000000	51	127	New Kent County, VA	2016	NA	11656	11257	399	3.4
CN5113100000000	51	131	Northampton County, VA	2016	NA	5869	5525	344	5.9
CN5113300000000	51	133	Northumberland County, VA	2016	NA	5442	5142	300	5.5
CN5113500000000	51	135	Nottoway County, VA	2016	NA	7026	6743	283	4
CN5113700000000	51	137	Orange County, VA	2016	NA	16341	15670	671	4.1
CN5113900000000	51	139	Page County, VA	2016	NA	11581	10930	651	5.6
CN5114100000000	51	141	Patrick County, VA	2016	NA	7943	7554	389	4.9
CN5114300000000	51	143	Pittsylvania County, VA	2016	NA	29660	28236	1424	4.8
CN5114500000000	51	145	Powhatan County, VA	2016	NA	13618	13130	488	3.6
CN5114700000000	51	147	Prince Edward County, VA	2016	NA	10142	9596	546	5.4
CN5114900000000	51	149	Prince George County, VA	2016	NA	14913	14180	733	4.9
CN5115300000000	51	153	Prince William County, VA	2016	NA	234634	225991	8643	3.7
CN5115500000000	51	155	Pulaski County, VA	2016	NA	16252	15273	979	6
CN5115700000000	51	157	Rappahannock County, VA	2016	NA	3706	3574	132	3.6
CN5115900000000	51	159	Richmond County, VA	2016	NA	3903	3757	146	3.7
CN5116100000000	51	161	Roanoke County, VA	2016	NA	49068	47296	1772	3.6
CN5116300000000	51	163	Rockbridge County, VA	2016	NA	10448	9986	462	4.4
CN5116500000000	51	165	Rockingham County, VA	2016	NA	40502	39064	1438	3.6
CN5116700000000	51	167	Russell County, VA	2016	NA	11231	10498	733	6.5
CN5116900000000	51	169	Scott County, VA	2016	NA	9413	8948	465	4.9
CN5117100000000	51	171	Shenandoah County, VA	2016	NA	20799	20008	791	3.8
CN5117300000000	51	173	Smyth County, VA	2016	NA	13661	12860	801	5.9
CN5117500000000	51	175	Southampton County, VA	2016	NA	9024	8666	358	4
CN5117700000000	51	177	Spotsylvania County, VA	2016	NA	64856	62177	2679	4.1
CN5117900000000	51	179	Stafford County, VA	2016	NA	68200	65501	2699	4
CN5118100000000	51	181	Surry County, VA	2016	NA	3652	3458	194	5.3
CN5118300000000	51	183	Sussex County, VA	2016	NA	3944	3694	250	6.3
CN5118500000000	51	185	Tazewell County, VA	2016	NA	15938	14731	1207	7.6
CN5118700000000	51	187	Warren County, VA	2016	NA	19672	18868	804	4.1
CN5119100000000	51	191	Washington County, VA	2016	NA	26812	25590	1222	4.6
CN5119300000000	51	193	Westmoreland County, VA	2016	NA	8967	8552	415	4.6
CN5119500000000	51	195	Wise County, VA	2016	NA	13192	12063	1129	8.6
CN5119700000000	51	197	Wythe County, VA	2016	NA	13642	12856	786	5.8
CN5119900000000	51	199	York County, VA	2016	NA	32068	30810	1258	3.9
CN5151000000000	51	510	Alexandria city, VA	2016	NA	96248	93422	2826	2.9
CN5152000000000	51	520	Bristol city, VA	2016	NA	7439	7058	381	5.1
CN5153000000000	51	530	Buena Vista city, VA	2016	NA	3272	3104	168	5.1
CN5154000000000	51	540	Charlottesville city, VA	2016	NA	24844	23997	847	3.4
CN5155000000000	51	550	Chesapeake city, VA	2016	NA	117782	112696	5086	4.3
CN5157000000000	51	570	Colonial Heights city, VA	2016	NA	8700	8306	394	4.5
CN5158000000000	51	580	Covington city, VA	2016	NA	2380	2239	141	5.9
CN5159000000000	51	590	Danville city, VA	2016	NA	19085	17916	1169	6.1
CN5159500000000	51	595	Emporia city, VA	2016	NA	2242	2096	146	6.5
CN5160000000000	51	600	Fairfax city, VA	2016	NA	12954	12554	400	3.1
CN5161000000000	51	610	Falls Church city, VA	2016	NA	7968	7748	220	2.8
CN5162000000000	51	620	Franklin city, VA	2016	NA	3533	3317	216	6.1
CN5163000000000	51	630	Fredericksburg city, VA	2016	NA	13542	12887	655	4.8
CN5164000000000	51	640	Galax city, VA	2016	NA	2899	2754	145	5
CN5165000000000	51	650	Hampton city, VA	2016	NA	63889	60210	3679	5.8
CN5166000000000	51	660	Harrisonburg city, VA	2016	NA	24199	23019	1180	4.9
CN5167000000000	51	670	Hopewell city, VA	2016	NA	9766	9122	644	6.6
CN5167800000000	51	678	Lexington city, VA	2016	NA	2262	2122	140	6.2
CN5168000000000	51	680	Lynchburg city, VA	2016	NA	35473	33610	1863	5.3
CN5168300000000	51	683	Manassas city, VA	2016	NA	21566	20779	787	3.6
CN5168500000000	51	685	Manassas Park city, VA	2016	NA	8469	8157	312	3.7
CN5169000000000	51	690	Martinsville city, VA	2016	NA	5157	4789	368	7.1
CN5170000000000	51	700	Newport News city, VA	2016	NA	88729	84133	4596	5.2
CN5171000000000	51	710	Norfolk city, VA	2016	NA	110210	104327	5883	5.3
CN5172000000000	51	720	Norton city, VA	2016	NA	1659	1544	115	6.9
CN5173000000000	51	730	Petersburg city, VA	2016	NA	13193	12148	1045	7.9
CN5173500000000	51	735	Poquoson city, VA	2016	NA	6158	5940	218	3.5
CN5174000000000	51	740	Portsmouth city, VA	2016	NA	44012	41279	2733	6.2
CN5175000000000	51	750	Radford city, VA	2016	NA	8248	7797	451	5.5
CN5176000000000	51	760	Richmond city, VA	2016	NA	114514	109135	5379	4.7
CN5177000000000	51	770	Roanoke city, VA	2016	NA	48871	46746	2125	4.3
CN5177500000000	51	775	Salem city, VA	2016	NA	12874	12362	512	4
CN5179000000000	51	790	Staunton city, VA	2016	NA	11776	11311	465	3.9
CN5180000000000	51	800	Suffolk city, VA	2016	NA	42908	40875	2033	4.7
CN5181000000000	51	810	Virginia Beach city, VA	2016	NA	228905	219741	9164	4
CN5182000000000	51	820	Waynesboro city, VA	2016	NA	10178	9751	427	4.2
CN5183000000000	51	830	Williamsburg city, VA	2016	NA	6705	6330	375	5.6
CN5184000000000	51	840	Winchester city, VA	2016	NA	14305	13727	578	4
CN5300100000000	53	001	Adams County, WA	2016	NA	8700	8137	563	6.5
CN5300300000000	53	003	Asotin County, WA	2016	NA	9944	9448	496	5
CN5300500000000	53	005	Benton County, WA	2016	NA	94130	88182	5948	6.3
CN5300700000000	53	007	Chelan County, WA	2016	NA	43215	40734	2481	5.7
CN5300900000000	53	009	Clallam County, WA	2016	NA	27270	25193	2077	7.6
CN5301100000000	53	011	Clark County, WA	2016	NA	220404	206972	13432	6.1
CN5301300000000	53	013	Columbia County, WA	2016	NA	1716	1604	112	6.5
CN5301500000000	53	015	Cowlitz County, WA	2016	NA	44769	41559	3210	7.2
CN5301700000000	53	017	Douglas County, WA	2016	NA	20504	19087	1417	6.9
CN5301900000000	53	019	Ferry County, WA	2016	NA	2489	2231	258	10.4
CN5302100000000	53	021	Franklin County, WA	2016	NA	39787	36820	2967	7.5
CN5302300000000	53	023	Garfield County, WA	2016	NA	918	864	54	5.9
CN5302500000000	53	025	Grant County, WA	2016	NA	44501	41314	3187	7.2
CN5302700000000	53	027	Grays Harbor County, WA	2016	NA	27197	24927	2270	8.3
CN5302900000000	53	029	Island County, WA	2016	NA	32678	30747	1931	5.9
CN5303100000000	53	031	Jefferson County, WA	2016	NA	11488	10675	813	7.1
CN5303300000000	53	033	King County, WA	2016	NA	1213744	1167122	46622	3.8
CN5303500000000	53	035	Kitsap County, WA	2016	NA	117955	111377	6578	5.6
CN5303700000000	53	037	Kittitas County, WA	2016	NA	21495	20212	1283	6
CN5303900000000	53	039	Klickitat County, WA	2016	NA	9627	8970	657	6.8
CN5304100000000	53	041	Lewis County, WA	2016	NA	31866	29375	2491	7.8
CN5304300000000	53	043	Lincoln County, WA	2016	NA	4882	4609	273	5.6
CN5304500000000	53	045	Mason County, WA	2016	NA	23464	21690	1774	7.6
CN5304700000000	53	047	Okanogan County, WA	2016	NA	21373	19946	1427	6.7
CN5304900000000	53	049	Pacific County, WA	2016	NA	8277	7609	668	8.1
CN5305100000000	53	051	Pend Oreille County, WA	2016	NA	4654	4238	416	8.9
CN5305300000000	53	053	Pierce County, WA	2016	NA	403890	379561	24329	6
CN5305500000000	53	055	San Juan County, WA	2016	NA	7860	7491	369	4.7
CN5305700000000	53	057	Skagit County, WA	2016	NA	57868	54089	3779	6.5
CN5305900000000	53	059	Skamania County, WA	2016	NA	5065	4713	352	6.9
CN5306100000000	53	061	Snohomish County, WA	2016	NA	415507	397933	17574	4.2
CN5306300000000	53	063	Spokane County, WA	2016	NA	234083	219816	14267	6.1
CN5306500000000	53	065	Stevens County, WA	2016	NA	17859	16385	1474	8.3
CN5306700000000	53	067	Thurston County, WA	2016	NA	129543	122228	7315	5.6
CN5306900000000	53	069	Wahkiakum County, WA	2016	NA	1286	1175	111	8.6
CN5307100000000	53	071	Walla Walla County, WA	2016	NA	28661	27107	1554	5.4
CN5307300000000	53	073	Whatcom County, WA	2016	NA	106929	100688	6241	5.8
CN5307500000000	53	075	Whitman County, WA	2016	NA	23064	21907	1157	5
CN5307700000000	53	077	Yakima County, WA	2016	NA	125655	116117	9538	7.6
CN5400100000000	54	001	Barbour County, WV	2016	NA	6958	6484	474	6.8
CN5400300000000	54	003	Berkeley County, WV	2016	NA	54066	51923	2143	4
CN5400500000000	54	005	Boone County, WV	2016	NA	7986	7258	728	9.1
CN5400700000000	54	007	Braxton County, WV	2016	NA	5490	5008	482	8.8
CN5400900000000	54	009	Brooke County, WV	2016	NA	9976	9272	704	7.1
CN5401100000000	54	011	Cabell County, WV	2016	NA	41199	39214	1985	4.8
CN5401300000000	54	013	Calhoun County, WV	2016	NA	2621	2284	337	12.9
CN5401500000000	54	015	Clay County, WV	2016	NA	3258	2920	338	10.4
CN5401700000000	54	017	Doddridge County, WV	2016	NA	3780	3584	196	5.2
CN5401900000000	54	019	Fayette County, WV	2016	NA	15967	14699	1268	7.9
CN5402100000000	54	021	Gilmer County, WV	2016	NA	2539	2329	210	8.3
CN5402300000000	54	023	Grant County, WV	2016	NA	5953	5599	354	5.9
CN5402500000000	54	025	Greenbrier County, WV	2016	NA	15680	14832	848	5.4
CN5402700000000	54	027	Hampshire County, WV	2016	NA	9892	9461	431	4.4
CN5402900000000	54	029	Hancock County, WV	2016	NA	12854	11952	902	7
CN5403100000000	54	031	Hardy County, WV	2016	NA	5715	5389	326	5.7
CN5403300000000	54	033	Harrison County, WV	2016	NA	32336	30446	1890	5.8
CN5403500000000	54	035	Jackson County, WV	2016	NA	12001	11222	779	6.5
CN5403700000000	54	037	Jefferson County, WV	2016	NA	28546	27584	962	3.4
CN5403900000000	54	039	Kanawha County, WV	2016	NA	85268	80606	4662	5.5
CN5404100000000	54	041	Lewis County, WV	2016	NA	6826	6245	581	8.5
CN5404300000000	54	043	Lincoln County, WV	2016	NA	7287	6664	623	8.5
CN5404500000000	54	045	Logan County, WV	2016	NA	11154	10015	1139	10.2
CN5404700000000	54	047	McDowell County, WV	2016	NA	5083	4464	619	12.2
CN5404900000000	54	049	Marion County, WV	2016	NA	25662	23982	1680	6.5
CN5405100000000	54	051	Marshall County, WV	2016	NA	14061	12939	1122	8
CN5405300000000	54	053	Mason County, WV	2016	NA	10027	9311	716	7.1
CN5405500000000	54	055	Mercer County, WV	2016	NA	21680	20228	1452	6.7
CN5405700000000	54	057	Mineral County, WV	2016	NA	11905	11195	710	6
CN5405900000000	54	059	Mingo County, WV	2016	NA	6726	5877	849	12.6
CN5406100000000	54	061	Monongalia County, WV	2016	NA	51263	49043	2220	4.3
CN5406300000000	54	063	Monroe County, WV	2016	NA	5976	5704	272	4.6
CN5406500000000	54	065	Morgan County, WV	2016	NA	7652	7316	336	4.4
CN5406700000000	54	067	Nicholas County, WV	2016	NA	9584	8738	846	8.8
CN5406900000000	54	069	Ohio County, WV	2016	NA	20621	19476	1145	5.6
CN5407100000000	54	071	Pendleton County, WV	2016	NA	3653	3511	142	3.9
CN5407300000000	54	073	Pleasants County, WV	2016	NA	2953	2711	242	8.2
CN5407500000000	54	075	Pocahontas County, WV	2016	NA	3725	3477	248	6.7
CN5407700000000	54	077	Preston County, WV	2016	NA	14847	13993	854	5.8
CN5407900000000	54	079	Putnam County, WV	2016	NA	25765	24505	1260	4.9
CN5408100000000	54	081	Raleigh County, WV	2016	NA	29925	27831	2094	7
CN5408300000000	54	083	Randolph County, WV	2016	NA	12201	11470	731	6
CN5408500000000	54	085	Ritchie County, WV	2016	NA	4562	4263	299	6.6
CN5408700000000	54	087	Roane County, WV	2016	NA	5200	4664	536	10.3
CN5408900000000	54	089	Summers County, WV	2016	NA	4568	4288	280	6.1
CN5409100000000	54	091	Taylor County, WV	2016	NA	7816	7375	441	5.6
CN5409300000000	54	093	Tucker County, WV	2016	NA	3475	3287	188	5.4
CN5409500000000	54	095	Tyler County, WV	2016	NA	3546	3230	316	8.9
CN5409700000000	54	097	Upshur County, WV	2016	NA	9802	9062	740	7.5
CN5409900000000	54	099	Wayne County, WV	2016	NA	15526	14500	1026	6.6
CN5410100000000	54	101	Webster County, WV	2016	NA	3489	3198	291	8.3
CN5410300000000	54	103	Wetzel County, WV	2016	NA	7199	6533	666	9.3
CN5410500000000	54	105	Wirt County, WV	2016	NA	2230	2034	196	8.8
CN5410700000000	54	107	Wood County, WV	2016	NA	36806	34691	2115	5.7
CN5410900000000	54	109	Wyoming County, WV	2016	NA	7417	6660	757	10.2
CN5500100000000	55	001	Adams County, WI	2016	NA	8296	7796	500	6
CN5500300000000	55	003	Ashland County, WI	2016	NA	7967	7535	432	5.4
CN5500500000000	55	005	Barron County, WI	2016	NA	24389	23280	1109	4.5
CN5500700000000	55	007	Bayfield County, WI	2016	NA	7547	7027	520	6.9
CN5500900000000	55	009	Brown County, WI	2016	NA	141375	136269	5106	3.6
CN5501100000000	55	011	Buffalo County, WI	2016	NA	6583	6289	294	4.5
CN5501300000000	55	013	Burnett County, WI	2016	NA	7188	6757	431	6
CN5501500000000	55	015	Calumet County, WI	2016	NA	27761	26871	890	3.2
CN5501700000000	55	017	Chippewa County, WI	2016	NA	33414	31993	1421	4.3
CN5501900000000	55	019	Clark County, WI	2016	NA	17558	16873	685	3.9
CN5502100000000	55	021	Columbia County, WI	2016	NA	31623	30485	1138	3.6
CN5502300000000	55	023	Crawford County, WI	2016	NA	7934	7547	387	4.9
CN5502500000000	55	025	Dane County, WI	2016	NA	318231	309163	9068	2.8
CN5502700000000	55	027	Dodge County, WI	2016	NA	47942	46196	1746	3.6
CN5502900000000	55	029	Door County, WI	2016	NA	15530	14761	769	5
CN5503100000000	55	031	Douglas County, WI	2016	NA	23606	22369	1237	5.2
CN5503300000000	55	033	Dunn County, WI	2016	NA	24363	23368	995	4.1
CN5503500000000	55	035	Eau Claire County, WI	2016	NA	58968	56957	2011	3.4
CN5503700000000	55	037	Florence County, WI	2016	NA	2232	2100	132	5.9
CN5503900000000	55	039	Fond du Lac County, WI	2016	NA	57020	55016	2004	3.5
CN5504100000000	55	041	Forest County, WI	2016	NA	4006	3757	249	6.2
CN5504300000000	55	043	Grant County, WI	2016	NA	28247	27144	1103	3.9
CN5504500000000	55	045	Green County, WI	2016	NA	21240	20534	706	3.3
CN5504700000000	55	047	Green Lake County, WI	2016	NA	9778	9301	477	4.9
CN5504900000000	55	049	Iowa County, WI	2016	NA	13720	13239	481	3.5
CN5505100000000	55	051	Iron County, WI	2016	NA	2642	2446	196	7.4
CN5505300000000	55	053	Jackson County, WI	2016	NA	10344	9891	453	4.4
CN5505500000000	55	055	Jefferson County, WI	2016	NA	45775	43996	1779	3.9
CN5505700000000	55	057	Juneau County, WI	2016	NA	13559	12959	600	4.4
CN5505900000000	55	059	Kenosha County, WI	2016	NA	88448	84339	4109	4.6
CN5506100000000	55	061	Kewaunee County, WI	2016	NA	11051	10646	405	3.7
CN5506300000000	55	063	La Crosse County, WI	2016	NA	67666	65227	2439	3.6
CN5506500000000	55	065	Lafayette County, WI	2016	NA	9859	9546	313	3.2
CN5506700000000	55	067	Langlade County, WI	2016	NA	9591	9094	497	5.2
CN5506900000000	55	069	Lincoln County, WI	2016	NA	15285	14618	667	4.4
CN5507100000000	55	071	Manitowoc County, WI	2016	NA	41912	40109	1803	4.3
CN5507300000000	55	073	Marathon County, WI	2016	NA	73739	71117	2622	3.6
CN5507500000000	55	075	Marinette County, WI	2016	NA	20266	19157	1109	5.5
CN5507700000000	55	077	Marquette County, WI	2016	NA	7566	7182	384	5.1
CN5507800000000	55	078	Menominee County, WI	2016	NA	1577	1457	120	7.6
CN5507900000000	55	079	Milwaukee County, WI	2016	NA	477381	453685	23696	5
CN5508100000000	55	081	Monroe County, WI	2016	NA	23063	22183	880	3.8
CN5508300000000	55	083	Oconto County, WI	2016	NA	20496	19591	905	4.4
CN5508500000000	55	085	Oneida County, WI	2016	NA	18617	17713	904	4.9
CN5508700000000	55	087	Outagamie County, WI	2016	NA	104042	100371	3671	3.5
CN5508900000000	55	089	Ozaukee County, WI	2016	NA	49120	47484	1636	3.3
CN5509100000000	55	091	Pepin County, WI	2016	NA	4174	4015	159	3.8
CN5509300000000	55	093	Pierce County, WI	2016	NA	24722	23723	999	4
CN5509500000000	55	095	Polk County, WI	2016	NA	24921	23780	1141	4.6
CN5509700000000	55	097	Portage County, WI	2016	NA	39555	38046	1509	3.8
CN5509900000000	55	099	Price County, WI	2016	NA	6894	6598	296	4.3
CN5510100000000	55	101	Racine County, WI	2016	NA	99890	94975	4915	4.9
CN5510300000000	55	103	Richland County, WI	2016	NA	9280	8931	349	3.8
CN5510500000000	55	105	Rock County, WI	2016	NA	84246	80545	3701	4.4
CN5510700000000	55	107	Rusk County, WI	2016	NA	7015	6656	359	5.1
CN5510900000000	55	109	St. Croix County, WI	2016	NA	49746	47872	1874	3.8
CN5511100000000	55	111	Sauk County, WI	2016	NA	35291	34033	1258	3.6
CN5511300000000	55	113	Sawyer County, WI	2016	NA	7933	7438	495	6.2
CN5511500000000	55	115	Shawano County, WI	2016	NA	21328	20443	885	4.1
CN5511700000000	55	117	Sheboygan County, WI	2016	NA	61829	59732	2097	3.4
CN5511900000000	55	119	Taylor County, WI	2016	NA	11098	10640	458	4.1
CN5512100000000	55	121	Trempealeau County, WI	2016	NA	16693	16077	616	3.7
CN5512300000000	55	123	Vernon County, WI	2016	NA	15785	15209	576	3.6
CN5512500000000	55	125	Vilas County, WI	2016	NA	9992	9426	566	5.7
CN5512700000000	55	127	Walworth County, WI	2016	NA	57796	55490	2306	4
CN5512900000000	55	129	Washburn County, WI	2016	NA	7989	7591	398	5
CN5513100000000	55	131	Washington County, WI	2016	NA	77322	74739	2583	3.3
CN5513300000000	55	133	Waukesha County, WI	2016	NA	225184	217425	7759	3.4
CN5513500000000	55	135	Waupaca County, WI	2016	NA	27016	25950	1066	3.9
CN5513700000000	55	137	Waushara County, WI	2016	NA	11500	10922	578	5
CN5513900000000	55	139	Winnebago County, WI	2016	NA	93217	89901	3316	3.6
CN5514100000000	55	141	Wood County, WI	2016	NA	34671	33038	1633	4.7
CN5600100000000	56	001	Albany County, WY	2016	NA	20960	20287	673	3.2
CN5600300000000	56	003	Big Horn County, WY	2016	NA	5536	5260	276	5
CN5600500000000	56	005	Campbell County, WY	2016	NA	24396	22635	1761	7.2
CN5600700000000	56	007	Carbon County, WY	2016	NA	8358	7965	393	4.7
CN5600900000000	56	009	Converse County, WY	2016	NA	7873	7381	492	6.2
CN5601100000000	56	011	Crook County, WY	2016	NA	3737	3565	172	4.6
CN5601300000000	56	013	Fremont County, WY	2016	NA	20026	18581	1445	7.2
CN5601500000000	56	015	Goshen County, WY	2016	NA	7024	6780	244	3.5
CN5601700000000	56	017	Hot Springs County, WY	2016	NA	2424	2307	117	4.8
CN5601900000000	56	019	Johnson County, WY	2016	NA	4205	3979	226	5.4
CN5602100000000	56	021	Laramie County, WY	2016	NA	48772	46740	2032	4.2
CN5602300000000	56	023	Lincoln County, WY	2016	NA	8719	8308	411	4.7
CN5602500000000	56	025	Natrona County, WY	2016	NA	40985	38052	2933	7.2
CN5602700000000	56	027	Niobrara County, WY	2016	NA	1338	1294	44	3.3
CN5602900000000	56	029	Park County, WY	2016	NA	15922	15167	755	4.7
CN5603100000000	56	031	Platte County, WY	2016	NA	4772	4542	230	4.8
CN5603300000000	56	033	Sheridan County, WY	2016	NA	16118	15355	763	4.7
CN5603500000000	56	035	Sublette County, WY	2016	NA	4229	3956	273	6.5
CN5603700000000	56	037	Sweetwater County, WY	2016	NA	22125	20782	1343	6.1
CN5603900000000	56	039	Teton County, WY	2016	NA	15237	14708	529	3.5
CN5604100000000	56	041	Uinta County, WY	2016	NA	9420	8871	549	5.8
CN5604300000000	56	043	Washakie County, WY	2016	NA	4212	4011	201	4.8
CN5604500000000	56	045	Weston County, WY	2016	NA	3957	3759	198	5
CN7200100000000	72	001	Adjuntas Municipio, PR	2016	NA	4470	3717	753	16.8
CN7200300000000	72	003	Aguada Municipio, PR	2016	NA	11907	10245	1662	14
CN7200500000000	72	005	Aguadilla Municipio, PR	2016	NA	14906	12689	2217	14.9
CN7200700000000	72	007	Aguas Buenas Municipio, PR	2016	NA	6787	5814	973	14.3
CN7200900000000	72	009	Aibonito Municipio, PR	2016	NA	6673	5680	993	14.9
CN7201100000000	72	011	Anasco Municipio, PR	2016	NA	8893	7749	1144	12.9
CN7201300000000	72	013	Arecibo Municipio, PR	2016	NA	23997	20832	3165	13.2
CN7201500000000	72	015	Arroyo Municipio, PR	2016	NA	5140	4187	953	18.5
CN7201700000000	72	017	Barceloneta Municipio, PR	2016	NA	5863	5034	829	14.1
CN7201900000000	72	019	Barranquitas Municipio, PR	2016	NA	7480	6521	959	12.8
CN7202100000000	72	021	Bayamon Municipio, PR	2016	NA	66356	60399	5957	9
CN7202300000000	72	023	Cabo Rojo Municipio, PR	2016	NA	14168	12405	1763	12.4
CN7202500000000	72	025	Caguas Municipio, PR	2016	NA	48264	43281	4983	10.3
CN7202700000000	72	027	Camuy Municipio, PR	2016	NA	9505	8330	1175	12.4
CN7202900000000	72	029	Canovanas Municipio, PR	2016	NA	16274	14404	1870	11.5
CN7203100000000	72	031	Carolina Municipio, PR	2016	NA	62164	56791	5373	8.6
CN7203300000000	72	033	Catano Municipio, PR	2016	NA	7912	7119	793	10
CN7203500000000	72	035	Cayey Municipio, PR	2016	NA	16220	14480	1740	10.7
CN7203700000000	72	037	Ceiba Municipio, PR	2016	NA	3798	3301	497	13.1
CN7203900000000	72	039	Ciales Municipio, PR	2016	NA	3839	3220	619	16.1
CN7204100000000	72	041	Cidra Municipio, PR	2016	NA	15580	13986	1594	10.2
CN7204300000000	72	043	Coamo Municipio, PR	2016	NA	10868	8903	1965	18.1
CN7204500000000	72	045	Comerio Municipio, PR	2016	NA	5072	4389	683	13.5
CN7204700000000	72	047	Corozal Municipio, PR	2016	NA	9250	8114	1136	12.3
CN7204900000000	72	049	Culebra Municipio, PR	2016	NA	896	866	30	3.3
CN7205100000000	72	051	Dorado Municipio, PR	2016	NA	12924	11882	1042	8.1
CN7205300000000	72	053	Fajardo Municipio, PR	2016	NA	11285	9728	1557	13.8
CN7205400000000	72	054	Florida Municipio, PR	2016	NA	3370	2882	488	14.5
CN7205500000000	72	055	Guanica Municipio, PR	2016	NA	4142	3394	748	18.1
CN7205700000000	72	057	Guayama Municipio, PR	2016	NA	12052	10076	1976	16.4
CN7205900000000	72	059	Guayanilla Municipio, PR	2016	NA	5292	4302	990	18.7
CN7206100000000	72	061	Guaynabo Municipio, PR	2016	NA	37190	34975	2215	6
CN7206300000000	72	063	Gurabo Municipio, PR	2016	NA	17513	16026	1487	8.5
CN7206500000000	72	065	Hatillo Municipio, PR	2016	NA	13323	11253	2070	15.5
CN7206700000000	72	067	Hormigueros Municipio, PR	2016	NA	5621	4933	688	12.2
CN7206900000000	72	069	Humacao Municipio, PR	2016	NA	17467	15004	2463	14.1
CN7207100000000	72	071	Isabela Municipio, PR	2016	NA	12613	10835	1778	14.1
CN7207300000000	72	073	Jayuya Municipio, PR	2016	NA	4221	3675	546	12.9
CN7207500000000	72	075	Juana Diaz Municipio, PR	2016	NA	15597	13338	2259	14.5
CN7207700000000	72	077	Juncos Municipio, PR	2016	NA	12462	10817	1645	13.2
CN7207900000000	72	079	Lajas Municipio, PR	2016	NA	5631	4580	1051	18.7
CN7208100000000	72	081	Lares Municipio, PR	2016	NA	7412	5980	1432	19.3
CN7208300000000	72	083	Las Marias Municipio, PR	2016	NA	2865	2439	426	14.9
CN7208500000000	72	085	Las Piedras Municipio, PR	2016	NA	11365	9835	1530	13.5
CN7208700000000	72	087	Loiza Municipio, PR	2016	NA	8654	7675	979	11.3
CN7208900000000	72	089	Luquillo Municipio, PR	2016	NA	6333	5434	899	14.2
CN7209100000000	72	091	Manati Municipio, PR	2016	NA	11648	10295	1353	11.6
CN7209300000000	72	093	Maricao Municipio, PR	2016	NA	1955	1657	298	15.2
CN7209500000000	72	095	Maunabo Municipio, PR	2016	NA	3020	2466	554	18.3
CN7209700000000	72	097	Mayaguez Municipio, PR	2016	NA	23225	20039	3186	13.7
CN7209900000000	72	099	Moca Municipio, PR	2016	NA	10745	9073	1672	15.6
CN7210100000000	72	101	Morovis Municipio, PR	2016	NA	8119	7027	1092	13.4
CN7210300000000	72	103	Naguabo Municipio, PR	2016	NA	8086	7089	997	12.3
CN7210500000000	72	105	Naranjito Municipio, PR	2016	NA	7260	6319	941	13
CN7210700000000	72	107	Orocovis Municipio, PR	2016	NA	5204	4397	807	15.5
CN7210900000000	72	109	Patillas Municipio, PR	2016	NA	4813	3820	993	20.6
CN7211100000000	72	111	Penuelas Municipio, PR	2016	NA	6120	5099	1021	16.7
CN7211300000000	72	113	Ponce Municipio, PR	2016	NA	47812	41397	6415	13.4
CN7211500000000	72	115	Quebradillas Municipio, PR	2016	NA	6079	5109	970	16
CN7211700000000	72	117	Rincon Municipio, PR	2016	NA	4631	3908	723	15.6
CN7211900000000	72	119	Rio Grande Municipio, PR	2016	NA	17095	15303	1792	10.5
CN7212100000000	72	121	Sabana Grande Municipio, PR	2016	NA	6446	5424	1022	15.9
CN7212300000000	72	123	Salinas Municipio, PR	2016	NA	7568	5928	1640	21.7
CN7212500000000	72	125	San German Municipio, PR	2016	NA	10356	8775	1581	15.3
CN7212700000000	72	127	San Juan Municipio, PR	2016	NA	135159	124495	10664	7.9
CN7212900000000	72	129	San Lorenzo Municipio, PR	2016	NA	11910	10418	1492	12.5
CN7213100000000	72	131	San Sebastian Municipio, PR	2016	NA	10721	8694	2027	18.9
CN7213300000000	72	133	Santa Isabel Municipio, PR	2016	NA	9898	8244	1654	16.7
CN7213500000000	72	135	Toa Alta Municipio, PR	2016	NA	26551	24343	2208	8.3
CN7213700000000	72	137	Toa Baja Municipio, PR	2016	NA	29753	27071	2682	9
CN7213900000000	72	139	Trujillo Alto Municipio, PR	2016	NA	27127	25174	1953	7.2
CN7214100000000	72	141	Utuado Municipio, PR	2016	NA	6885	5817	1068	15.5
CN7214300000000	72	143	Vega Alta Municipio, PR	2016	NA	9878	8740	1138	11.5
CN7214500000000	72	145	Vega Baja Municipio, PR	2016	NA	13733	11829	1904	13.9
CN7214700000000	72	147	Vieques Municipio, PR	2016	NA	3260	2914	346	10.6
CN7214900000000	72	149	Villalba Municipio, PR	2016	NA	7815	6235	1580	20.2
CN7215100000000	72	151	Yabucoa Municipio, PR	2016	NA	9081	7545	1536	16.9
CN7215300000000	72	153	Yauco Municipio, PR	2016	NA	10735	8719	2016	18.8
NA	NA	NA	NA	NA	NA	NA	NA	NA	NA
SOURCE:  BLS, LAUS	NA	NA	NA	NA	NA	NA	NA	NA	NA
April 17, 2020	NA	NA	NA	NA	NA	NA	NA	NA	NA
