LAUS_CODE	STATE_FIPS	COUNTY_FIPS	COUNTY	YEAR	ESTIMATED	LABOR_FORCE	EMPLOYED	UNEMPLOYED_LEVEL	UNEMPLOYED_RATE
CN0100100000000	01	001	Autauga County, AL	2013	NA	25810	24205	1605	6.2
CN0100300000000	01	003	Baldwin County, AL	2013	NA	85280	79626	5654	6.6
CN0100500000000	01	005	Barbour County, AL	2013	NA	9099	8168	931	10.2
CN0100700000000	01	007	Bibb County, AL	2013	NA	8705	8016	689	7.9
CN0100900000000	01	009	Blount County, AL	2013	NA	24887	23325	1562	6.3
CN0101100000000	01	011	Bullock County, AL	2013	NA	4778	4331	447	9.4
CN0101300000000	01	013	Butler County, AL	2013	NA	9147	8206	941	10.3
CN0101500000000	01	015	Calhoun County, AL	2013	NA	48405	44163	4242	8.8
CN0101700000000	01	017	Chambers County, AL	2013	NA	15275	14058	1217	8
CN0101900000000	01	019	Cherokee County, AL	2013	NA	11403	10649	754	6.6
CN0102100000000	01	021	Chilton County, AL	2013	NA	19359	18090	1269	6.6
CN0102300000000	01	023	Choctaw County, AL	2013	NA	4703	4270	433	9.2
CN0102500000000	01	025	Clarke County, AL	2013	NA	8285	7145	1140	13.8
CN0102700000000	01	027	Clay County, AL	2013	NA	5393	4943	450	8.3
CN0102900000000	01	029	Cleburne County, AL	2013	NA	5830	5383	447	7.7
CN0103100000000	01	031	Coffee County, AL	2013	NA	20516	19105	1411	6.9
CN0103300000000	01	033	Colbert County, AL	2013	NA	23896	21937	1959	8.2
CN0103500000000	01	035	Conecuh County, AL	2013	NA	4695	4191	504	10.7
CN0103700000000	01	037	Coosa County, AL	2013	NA	4452	4044	408	9.2
CN0103900000000	01	039	Covington County, AL	2013	NA	16066	14768	1298	8.1
CN0104100000000	01	041	Crenshaw County, AL	2013	NA	6311	5828	483	7.7
CN0104300000000	01	043	Cullman County, AL	2013	NA	35783	33402	2381	6.7
CN0104500000000	01	045	Dale County, AL	2013	NA	20750	19220	1530	7.4
CN0104700000000	01	047	Dallas County, AL	2013	NA	16293	14301	1992	12.2
CN0104900000000	01	049	DeKalb County, AL	2013	NA	29033	26823	2210	7.6
CN0105100000000	01	051	Elmore County, AL	2013	NA	36930	34658	2272	6.2
CN0105300000000	01	053	Escambia County, AL	2013	NA	14292	13065	1227	8.6
CN0105500000000	01	055	Etowah County, AL	2013	NA	43862	40538	3324	7.6
CN0105700000000	01	057	Fayette County, AL	2013	NA	6406	5875	531	8.3
CN0105900000000	01	059	Franklin County, AL	2013	NA	13678	12578	1100	8
CN0106100000000	01	061	Geneva County, AL	2013	NA	11044	10276	768	7
CN0106300000000	01	063	Greene County, AL	2013	NA	2997	2614	383	12.8
CN0106500000000	01	065	Hale County, AL	2013	NA	6208	5486	722	11.6
CN0106700000000	01	067	Henry County, AL	2013	NA	6954	6421	533	7.7
CN0106900000000	01	069	Houston County, AL	2013	NA	45711	42553	3158	6.9
CN0107100000000	01	071	Jackson County, AL	2013	NA	23687	21822	1865	7.9
CN0107300000000	01	073	Jefferson County, AL	2013	NA	315405	294426	20979	6.7
CN0107500000000	01	075	Lamar County, AL	2013	NA	5802	5394	408	7
CN0107700000000	01	077	Lauderdale County, AL	2013	NA	43150	40083	3067	7.1
CN0107900000000	01	079	Lawrence County, AL	2013	NA	14282	13093	1189	8.3
CN0108100000000	01	081	Lee County, AL	2013	NA	70523	66379	4144	5.9
CN0108300000000	01	083	Limestone County, AL	2013	NA	39435	36969	2466	6.3
CN0108500000000	01	085	Lowndes County, AL	2013	NA	4009	3443	566	14.1
CN0108700000000	01	087	Macon County, AL	2013	NA	8414	7603	811	9.6
CN0108900000000	01	089	Madison County, AL	2013	NA	171363	160551	10812	6.3
CN0109100000000	01	091	Marengo County, AL	2013	NA	7634	6955	679	8.9
CN0109300000000	01	093	Marion County, AL	2013	NA	12487	11499	988	7.9
CN0109500000000	01	095	Marshall County, AL	2013	NA	40614	37841	2773	6.8
CN0109700000000	01	097	Mobile County, AL	2013	NA	187046	171088	15958	8.5
CN0109900000000	01	099	Monroe County, AL	2013	NA	7766	6843	923	11.9
CN0110100000000	01	101	Montgomery County, AL	2013	NA	106360	98613	7747	7.3
CN0110300000000	01	103	Morgan County, AL	2013	NA	57001	53090	3911	6.9
CN0110500000000	01	105	Perry County, AL	2013	NA	3566	3083	483	13.5
CN0110700000000	01	107	Pickens County, AL	2013	NA	7420	6727	693	9.3
CN0110900000000	01	109	Pike County, AL	2013	NA	14924	13785	1139	7.6
CN0111100000000	01	111	Randolph County, AL	2013	NA	9212	8498	714	7.8
CN0111300000000	01	113	Russell County, AL	2013	NA	25018	23208	1810	7.2
CN0111500000000	01	115	St. Clair County, AL	2013	NA	38835	36455	2380	6.1
CN0111700000000	01	117	Shelby County, AL	2013	NA	107004	102054	4950	4.6
CN0111900000000	01	119	Sumter County, AL	2013	NA	5463	4969	494	9
CN0112100000000	01	121	Talladega County, AL	2013	NA	35771	32700	3071	8.6
CN0112300000000	01	123	Tallapoosa County, AL	2013	NA	18399	16909	1490	8.1
CN0112500000000	01	125	Tuscaloosa County, AL	2013	NA	95678	89602	6076	6.4
CN0112700000000	01	127	Walker County, AL	2013	NA	26364	24136	2228	8.5
CN0112900000000	01	129	Washington County, AL	2013	NA	6714	5985	729	10.9
CN0113100000000	01	131	Wilcox County, AL	2013	NA	2780	2244	536	19.3
CN0113300000000	01	133	Winston County, AL	2013	NA	9644	8737	907	9.4
CN0201300000000	02	013	Aleutians East Borough, AK	2013	NA	2217	2083	134	6
CN0201600000000	02	016	Aleutians West Census Area, AK	2013	NA	4272	3976	296	6.9
CN0202000000000	02	020	Anchorage Borough/municipality, AK	2013	NA	158401	150169	8232	5.2
CN0205000000000	02	050	Bethel Census Area, AK	2013	NA	7424	6224	1200	16.2
CN0206000000000	02	060	Bristol Bay Borough, AK	2013	NA	491	448	43	8.8
CN0206800000000	02	068	Denali Borough, AK	2013	NA	1078	943	135	12.5
CN0207000000000	02	070	Dillingham Census Area, AK	2013	NA	2134	1916	218	10.2
CN0209000000000	02	090	Fairbanks North Star Borough, AK	2013	NA	47286	44514	2772	5.9
CN0210000000000	02	100	Haines Borough, AK	2013	NA	1142	1026	116	10.2
CN0210500000000	02	105	Hoonah-Angoon Census Area, AK	2013	NA	1124	959	165	14.7
CN0211000000000	02	110	Juneau Borough/city, AK	2013	NA	17589	16702	887	5
CN0212200000000	02	122	Kenai Peninsula Borough, AK	2013	NA	27831	25592	2239	8
CN0213000000000	02	130	Ketchikan Gateway Borough, AK	2013	NA	7168	6606	562	7.8
CN0215000000000	02	150	Kodiak Island Borough, AK	2013	NA	6594	6183	411	6.2
CN0215800000000	02	158	Kusilvak Census Area, AK	2013	NA	2782	2124	658	23.7
CN0216400000000	02	164	Lake and Peninsula Borough, AK	2013	NA	638	539	99	15.5
CN0217000000000	02	170	Matanuska-Susitna Borough, AK	2013	NA	43925	40253	3672	8.4
CN0218000000000	02	180	Nome Census Area, AK	2013	NA	4142	3631	511	12.3
CN0218500000000	02	185	North Slope Borough, AK	2013	NA	4072	3772	300	7.4
CN0218800000000	02	188	Northwest Arctic Borough, AK	2013	NA	3068	2564	504	16.4
CN0219500000000	02	195	Petersburg Borough, AK	2013	NA	1659	1515	144	8.7
CN0219800000000	02	198	Prince of Wales-Hyder Census Area, AK	2013	NA	2811	2468	343	12.2
CN0222000000000	02	220	Sitka Borough/city, AK	2013	NA	4625	4371	254	5.5
CN0223000000000	02	230	Skagway Municipality, AK	2013	NA	794	695	99	12.5
CN0224000000000	02	240	Southeast Fairbanks Census Area, AK	2013	NA	3013	2617	396	13.1
CN0226100000000	02	261	Valdez-Cordova Census Area, AK	2013	NA	4934	4444	490	9.9
CN0227500000000	02	275	Wrangell Borough/city, AK	2013	NA	1059	974	85	8
CN0228200000000	02	282	Yakutat Borough/city, AK	2013	NA	285	258	27	9.5
CN0229000000000	02	290	Yukon-Koyukuk Census Area, AK	2013	NA	2736	2234	502	18.3
CN0400100000000	04	001	Apache County, AZ	2013	NA	21829	17813	4016	18.4
CN0400300000000	04	003	Cochise County, AZ	2013	NA	51308	46587	4721	9.2
CN0400500000000	04	005	Coconino County, AZ	2013	NA	70877	65110	5767	8.1
CN0400700000000	04	007	Gila County, AZ	2013	NA	20901	18890	2011	9.6
CN0400900000000	04	009	Graham County, AZ	2013	NA	14276	13173	1103	7.7
CN0401100000000	04	011	Greenlee County, AZ	2013	NA	4580	4311	269	5.9
CN0401200000000	04	012	La Paz County, AZ	2013	NA	8028	7372	656	8.2
CN0401300000000	04	013	Maricopa County, AZ	2013	NA	1907171	1781737	125434	6.6
CN0401500000000	04	015	Mohave County, AZ	2013	NA	76838	68888	7950	10.3
CN0401700000000	04	017	Navajo County, AZ	2013	NA	41925	36283	5642	13.5
CN0401900000000	04	019	Pima County, AZ	2013	NA	456994	426120	30874	6.8
CN0402100000000	04	021	Pinal County, AZ	2013	NA	148275	136324	11951	8.1
CN0402300000000	04	023	Santa Cruz County, AZ	2013	NA	20111	17023	3088	15.4
CN0402500000000	04	025	Yavapai County, AZ	2013	NA	91587	84500	7087	7.7
CN0402700000000	04	027	Yuma County, AZ	2013	NA	94729	70567	24162	25.5
CN0500100000000	05	001	Arkansas County, AR	2013	NA	9586	8881	705	7.4
CN0500300000000	05	003	Ashley County, AR	2013	NA	9102	8132	970	10.7
CN0500500000000	05	005	Baxter County, AR	2013	NA	16053	14761	1292	8
CN0500700000000	05	007	Benton County, AR	2013	NA	111733	105443	6290	5.6
CN0500900000000	05	009	Boone County, AR	2013	NA	16032	14906	1126	7
CN0501100000000	05	011	Bradley County, AR	2013	NA	4271	3866	405	9.5
CN0501300000000	05	013	Calhoun County, AR	2013	NA	2437	2239	198	8.1
CN0501500000000	05	015	Carroll County, AR	2013	NA	12272	11536	736	6
CN0501700000000	05	017	Chicot County, AR	2013	NA	3841	3395	446	11.6
CN0501900000000	05	019	Clark County, AR	2013	NA	10092	9199	893	8.8
CN0502100000000	05	021	Clay County, AR	2013	NA	6522	5887	635	9.7
CN0502300000000	05	023	Cleburne County, AR	2013	NA	10028	9172	856	8.5
CN0502500000000	05	025	Cleveland County, AR	2013	NA	3596	3324	272	7.6
CN0502700000000	05	027	Columbia County, AR	2013	NA	9691	8842	849	8.8
CN0502900000000	05	029	Conway County, AR	2013	NA	8646	7849	797	9.2
CN0503100000000	05	031	Craighead County, AR	2013	NA	49279	46050	3229	6.6
CN0503300000000	05	033	Crawford County, AR	2013	NA	27027	24960	2067	7.6
CN0503500000000	05	035	Crittenden County, AR	2013	NA	21518	19714	1804	8.4
CN0503700000000	05	037	Cross County, AR	2013	NA	8200	7579	621	7.6
CN0503900000000	05	039	Dallas County, AR	2013	NA	3036	2718	318	10.5
CN0504100000000	05	041	Desha County, AR	2013	NA	5646	5102	544	9.6
CN0504300000000	05	043	Drew County, AR	2013	NA	8289	7490	799	9.6
CN0504500000000	05	045	Faulkner County, AR	2013	NA	59235	55393	3842	6.5
CN0504700000000	05	047	Franklin County, AR	2013	NA	7415	6905	510	6.9
CN0504900000000	05	049	Fulton County, AR	2013	NA	4913	4574	339	6.9
CN0505100000000	05	051	Garland County, AR	2013	NA	40790	37699	3091	7.6
CN0505300000000	05	053	Grant County, AR	2013	NA	8264	7724	540	6.5
CN0505500000000	05	055	Greene County, AR	2013	NA	19399	17868	1531	7.9
CN0505700000000	05	057	Hempstead County, AR	2013	NA	10115	9384	731	7.2
CN0505900000000	05	059	Hot Spring County, AR	2013	NA	14140	13113	1027	7.3
CN0506100000000	05	061	Howard County, AR	2013	NA	6250	5852	398	6.4
CN0506300000000	05	063	Independence County, AR	2013	NA	15789	14366	1423	9
CN0506500000000	05	065	Izard County, AR	2013	NA	4998	4566	432	8.6
CN0506700000000	05	067	Jackson County, AR	2013	NA	6272	5589	683	10.9
CN0506900000000	05	069	Jefferson County, AR	2013	NA	30994	27797	3197	10.3
CN0507100000000	05	071	Johnson County, AR	2013	NA	10562	9754	808	7.7
CN0507300000000	05	073	Lafayette County, AR	2013	NA	2773	2509	264	9.5
CN0507500000000	05	075	Lawrence County, AR	2013	NA	7144	6510	634	8.9
CN0507700000000	05	077	Lee County, AR	2013	NA	3309	3001	308	9.3
CN0507900000000	05	079	Lincoln County, AR	2013	NA	4349	3988	361	8.3
CN0508100000000	05	081	Little River County, AR	2013	NA	5702	5269	433	7.6
CN0508300000000	05	083	Logan County, AR	2013	NA	9237	8519	718	7.8
CN0508500000000	05	085	Lonoke County, AR	2013	NA	32761	30764	1997	6.1
CN0508700000000	05	087	Madison County, AR	2013	NA	6849	6453	396	5.8
CN0508900000000	05	089	Marion County, AR	2013	NA	6508	6007	501	7.7
CN0509100000000	05	091	Miller County, AR	2013	NA	19534	18281	1253	6.4
CN0509300000000	05	093	Mississippi County, AR	2013	NA	18979	16831	2148	11.3
CN0509500000000	05	095	Monroe County, AR	2013	NA	3121	2847	274	8.8
CN0509700000000	05	097	Montgomery County, AR	2013	NA	3437	3150	287	8.4
CN0509900000000	05	099	Nevada County, AR	2013	NA	3786	3495	291	7.7
CN0510100000000	05	101	Newton County, AR	2013	NA	3487	3246	241	6.9
CN0510300000000	05	103	Ouachita County, AR	2013	NA	10316	9324	992	9.6
CN0510500000000	05	105	Perry County, AR	2013	NA	4360	3952	408	9.4
CN0510700000000	05	107	Phillips County, AR	2013	NA	7589	6726	863	11.4
CN0510900000000	05	109	Pike County, AR	2013	NA	4235	3864	371	8.8
CN0511100000000	05	111	Poinsett County, AR	2013	NA	10136	9278	858	8.5
CN0511300000000	05	113	Polk County, AR	2013	NA	8486	7881	605	7.1
CN0511500000000	05	115	Pope County, AR	2013	NA	29698	27527	2171	7.3
CN0511700000000	05	117	Prairie County, AR	2013	NA	3801	3533	268	7.1
CN0511900000000	05	119	Pulaski County, AR	2013	NA	186520	174354	12166	6.5
CN0512100000000	05	121	Randolph County, AR	2013	NA	6687	6050	637	9.5
CN0512300000000	05	123	St. Francis County, AR	2013	NA	9166	8213	953	10.4
CN0512500000000	05	125	Saline County, AR	2013	NA	54723	51559	3164	5.8
CN0512700000000	05	127	Scott County, AR	2013	NA	4623	4335	288	6.2
CN0512900000000	05	129	Searcy County, AR	2013	NA	3122	2874	248	7.9
CN0513100000000	05	131	Sebastian County, AR	2013	NA	58090	53761	4329	7.5
CN0513300000000	05	133	Sevier County, AR	2013	NA	5980	5485	495	8.3
CN0513500000000	05	135	Sharp County, AR	2013	NA	6013	5427	586	9.7
CN0513700000000	05	137	Stone County, AR	2013	NA	4795	4392	403	8.4
CN0513900000000	05	139	Union County, AR	2013	NA	16630	15204	1426	8.6
CN0514100000000	05	141	Van Buren County, AR	2013	NA	6488	5859	629	9.7
CN0514300000000	05	143	Washington County, AR	2013	NA	106733	101019	5714	5.4
CN0514500000000	05	145	White County, AR	2013	NA	35071	32336	2735	7.8
CN0514700000000	05	147	Woodruff County, AR	2013	NA	3234	2927	307	9.5
CN0514900000000	05	149	Yell County, AR	2013	NA	9078	8484	594	6.5
CN0600100000000	06	001	Alameda County, CA	2013	NA	802813	744764	58049	7.2
CN0600300000000	06	003	Alpine County, CA	2013	NA	525	474	51	9.7
CN0600500000000	06	005	Amador County, CA	2013	NA	14449	12959	1490	10.3
CN0600700000000	06	007	Butte County, CA	2013	NA	101748	91263	10485	10.3
CN0600900000000	06	009	Calaveras County, CA	2013	NA	20255	18243	2012	9.9
CN0601100000000	06	011	Colusa County, CA	2013	NA	11292	9156	2136	18.9
CN0601300000000	06	013	Contra Costa County, CA	2013	NA	538002	497661	40341	7.5
CN0601500000000	06	015	Del Norte County, CA	2013	NA	10330	9107	1223	11.8
CN0601700000000	06	017	El Dorado County, CA	2013	NA	88598	81063	7535	8.5
CN0601900000000	06	019	Fresno County, CA	2013	NA	437908	379850	58058	13.3
CN0602100000000	06	021	Glenn County, CA	2013	NA	12990	11418	1572	12.1
CN0602300000000	06	023	Humboldt County, CA	2013	NA	63055	57947	5108	8.1
CN0602500000000	06	025	Imperial County, CA	2013	NA	78271	58670	19601	25
CN0602700000000	06	027	Inyo County, CA	2013	NA	9390	8654	736	7.8
CN0602900000000	06	029	Kern County, CA	2013	NA	393440	347213	46227	11.7
CN0603100000000	06	031	Kings County, CA	2013	NA	58198	50387	7811	13.4
CN0603300000000	06	033	Lake County, CA	2013	NA	29259	26068	3191	10.9
CN0603500000000	06	035	Lassen County, CA	2013	NA	11005	9838	1167	10.6
CN0603700000000	06	037	Los Angeles County, CA	2013	NA	4967167	4482594	484573	9.8
CN0603900000000	06	039	Madera County, CA	2013	NA	62263	54428	7835	12.6
CN0604100000000	06	041	Marin County, CA	2013	NA	138367	131216	7151	5.2
CN0604300000000	06	043	Mariposa County, CA	2013	NA	8229	7363	866	10.5
CN0604500000000	06	045	Mendocino County, CA	2013	NA	40837	37425	3412	8.4
CN0604700000000	06	047	Merced County, CA	2013	NA	114628	98009	16619	14.5
CN0604900000000	06	049	Modoc County, CA	2013	NA	3503	3073	430	12.3
CN0605100000000	06	051	Mono County, CA	2013	NA	8368	7655	713	8.5
CN0605300000000	06	053	Monterey County, CA	2013	NA	216380	194075	22305	10.3
CN0605500000000	06	055	Napa County, CA	2013	NA	72809	67766	5043	6.9
CN0605700000000	06	057	Nevada County, CA	2013	NA	48169	44267	3902	8.1
CN0605900000000	06	059	Orange County, CA	2013	NA	1565334	1462270	103064	6.6
CN0606100000000	06	061	Placer County, CA	2013	NA	175833	162264	13569	7.7
CN0606300000000	06	063	Plumas County, CA	2013	NA	8256	7114	1142	13.8
CN0606500000000	06	065	Riverside County, CA	2013	NA	996412	897723	98689	9.9
CN0606700000000	06	067	Sacramento County, CA	2013	NA	680241	619835	60406	8.9
CN0606900000000	06	069	San Benito County, CA	2013	NA	28904	25696	3208	11.1
CN0607100000000	06	071	San Bernardino County, CA	2013	NA	896673	809057	87616	9.8
CN0607300000000	06	073	San Diego County, CA	2013	NA	1543189	1422391	120798	7.8
CN0607500000000	06	075	San Francisco County/city, CA	2013	NA	516300	488121	28179	5.5
CN0607700000000	06	077	San Joaquin County, CA	2013	NA	313101	274562	38539	12.3
CN0607900000000	06	079	San Luis Obispo County, CA	2013	NA	138258	128819	9439	6.8
CN0608100000000	06	081	San Mateo County, CA	2013	NA	418085	396092	21993	5.3
CN0608300000000	06	083	Santa Barbara County, CA	2013	NA	217331	201680	15651	7.2
CN0608500000000	06	085	Santa Clara County, CA	2013	NA	971863	909040	62823	6.5
CN0608700000000	06	087	Santa Cruz County, CA	2013	NA	142067	127466	14601	10.3
CN0608900000000	06	089	Shasta County, CA	2013	NA	75285	66385	8900	11.8
CN0609100000000	06	091	Sierra County, CA	2013	NA	1452	1267	185	12.7
CN0609300000000	06	093	Siskiyou County, CA	2013	NA	18293	15888	2405	13.1
CN0609500000000	06	095	Solano County, CA	2013	NA	203055	184630	18425	9.1
CN0609700000000	06	097	Sonoma County, CA	2013	NA	249962	232197	17765	7.1
CN0609900000000	06	099	Stanislaus County, CA	2013	NA	240987	209781	31206	12.9
CN0610100000000	06	101	Sutter County, CA	2013	NA	44792	38243	6549	14.6
CN0610300000000	06	103	Tehama County, CA	2013	NA	25086	22171	2915	11.6
CN0610500000000	06	105	Trinity County, CA	2013	NA	5192	4572	620	11.9
CN0610700000000	06	107	Tulare County, CA	2013	NA	201053	172171	28882	14.4
CN0610900000000	06	109	Tuolumne County, CA	2013	NA	21749	19406	2343	10.8
CN0611100000000	06	111	Ventura County, CA	2013	NA	433914	399769	34145	7.9
CN0611300000000	06	113	Yolo County, CA	2013	NA	101835	92660	9175	9
CN0611500000000	06	115	Yuba County, CA	2013	NA	28250	24531	3719	13.2
CN0800100000000	08	001	Adams County, CO	2013	NA	241765	222106	19659	8.1
CN0800300000000	08	003	Alamosa County, CO	2013	NA	7562	6827	735	9.7
CN0800500000000	08	005	Arapahoe County, CO	2013	NA	326280	304753	21527	6.6
CN0800700000000	08	007	Archuleta County, CO	2013	NA	5699	5200	499	8.8
CN0800900000000	08	009	Baca County, CO	2013	NA	1895	1817	78	4.1
CN0801100000000	08	011	Bent County, CO	2013	NA	1646	1519	127	7.7
CN0801300000000	08	013	Boulder County, CO	2013	NA	174782	165184	9598	5.5
CN0801400000000	08	014	Broomfield County/city, CO	2013	NA	32776	30871	1905	5.8
CN0801500000000	08	015	Chaffee County, CO	2013	NA	8301	7790	511	6.2
CN0801700000000	08	017	Cheyenne County, CO	2013	NA	969	928	41	4.2
CN0801900000000	08	019	Clear Creek County, CO	2013	NA	5440	5099	341	6.3
CN0802100000000	08	021	Conejos County, CO	2013	NA	3610	3226	384	10.6
CN0802300000000	08	023	Costilla County, CO	2013	NA	1596	1417	179	11.2
CN0802500000000	08	025	Crowley County, CO	2013	NA	1322	1227	95	7.2
CN0802700000000	08	027	Custer County, CO	2013	NA	1919	1797	122	6.4
CN0802900000000	08	029	Delta County, CO	2013	NA	13852	12617	1235	8.9
CN0803100000000	08	031	Denver County/city, CO	2013	NA	362752	338686	24066	6.6
CN0803300000000	08	033	Dolores County, CO	2013	NA	1014	930	84	8.3
CN0803500000000	08	035	Douglas County, CO	2013	NA	164441	155708	8733	5.3
CN0803700000000	08	037	Eagle County, CO	2013	NA	31874	29947	1927	6
CN0803900000000	08	039	Elbert County, CO	2013	NA	12693	11946	747	5.9
CN0804100000000	08	041	El Paso County, CO	2013	NA	306761	282583	24178	7.9
CN0804300000000	08	043	Fremont County, CO	2013	NA	14946	13349	1597	10.7
CN0804500000000	08	045	Garfield County, CO	2013	NA	30944	28635	2309	7.5
CN0804700000000	08	047	Gilpin County, CO	2013	NA	3314	3115	199	6
CN0804900000000	08	049	Grand County, CO	2013	NA	8769	8257	512	5.8
CN0805100000000	08	051	Gunnison County, CO	2013	NA	9635	9108	527	5.5
CN0805300000000	08	053	Hinsdale County, CO	2013	NA	432	412	20	4.6
CN0805500000000	08	055	Huerfano County, CO	2013	NA	2541	2193	348	13.7
CN0805700000000	08	057	Jackson County, CO	2013	NA	793	755	38	4.8
CN0805900000000	08	059	Jefferson County, CO	2013	NA	305200	286109	19091	6.3
CN0806100000000	08	061	Kiowa County, CO	2013	NA	764	730	34	4.5
CN0806300000000	08	063	Kit Carson County, CO	2013	NA	4081	3921	160	3.9
CN0806500000000	08	065	Lake County, CO	2013	NA	4440	4120	320	7.2
CN0806700000000	08	067	La Plata County, CO	2013	NA	29559	27873	1686	5.7
CN0806900000000	08	069	Larimer County, CO	2013	NA	174165	164046	10119	5.8
CN0807100000000	08	071	Las Animas County, CO	2013	NA	6734	5983	751	11.2
CN0807300000000	08	073	Lincoln County, CO	2013	NA	2105	1982	123	5.8
CN0807500000000	08	075	Logan County, CO	2013	NA	10798	10245	553	5.1
CN0807700000000	08	077	Mesa County, CO	2013	NA	73542	67108	6434	8.7
CN0807900000000	08	079	Mineral County, CO	2013	NA	425	400	25	5.9
CN0808100000000	08	081	Moffat County, CO	2013	NA	7535	7013	522	6.9
CN0808300000000	08	083	Montezuma County, CO	2013	NA	12713	11730	983	7.7
CN0808500000000	08	085	Montrose County, CO	2013	NA	19297	17474	1823	9.4
CN0808700000000	08	087	Morgan County, CO	2013	NA	14659	13702	957	6.5
CN0808900000000	08	089	Otero County, CO	2013	NA	8207	7399	808	9.8
CN0809100000000	08	091	Ouray County, CO	2013	NA	2128	1966	162	7.6
CN0809300000000	08	093	Park County, CO	2013	NA	9252	8691	561	6.1
CN0809500000000	08	095	Phillips County, CO	2013	NA	2124	2026	98	4.6
CN0809700000000	08	097	Pitkin County, CO	2013	NA	10782	10084	698	6.5
CN0809900000000	08	099	Prowers County, CO	2013	NA	5857	5489	368	6.3
CN0810100000000	08	101	Pueblo County, CO	2013	NA	73335	66114	7221	9.8
CN0810300000000	08	103	Rio Blanco County, CO	2013	NA	3072	2831	241	7.8
CN0810500000000	08	105	Rio Grande County, CO	2013	NA	4878	4313	565	11.6
CN0810700000000	08	107	Routt County, CO	2013	NA	14494	13632	862	5.9
CN0810900000000	08	109	Saguache County, CO	2013	NA	2953	2620	333	11.3
CN0811100000000	08	111	San Juan County, CO	2013	NA	477	436	41	8.6
CN0811300000000	08	113	San Miguel County, CO	2013	NA	4777	4459	318	6.7
CN0811500000000	08	115	Sedgwick County, CO	2013	NA	1090	1022	68	6.2
CN0811700000000	08	117	Summit County, CO	2013	NA	19350	18379	971	5
CN0811900000000	08	119	Teller County, CO	2013	NA	11712	10798	914	7.8
CN0812100000000	08	121	Washington County, CO	2013	NA	2549	2432	117	4.6
CN0812300000000	08	123	Weld County, CO	2013	NA	139047	129920	9127	6.6
CN0812500000000	08	125	Yuma County, CO	2013	NA	4736	4511	225	4.8
CN0900100000000	09	001	Fairfield County, CT	2013	NA	467788	433763	34025	7.3
CN0900300000000	09	003	Hartford County, CT	2013	NA	466963	429703	37260	8
CN0900500000000	09	005	Litchfield County, CT	2013	NA	104495	97057	7438	7.1
CN0900700000000	09	007	Middlesex County, CT	2013	NA	90986	84887	6099	6.7
CN0900900000000	09	009	New Haven County, CT	2013	NA	450703	412280	38423	8.5
CN0901100000000	09	011	New London County, CT	2013	NA	136809	125667	11142	8.1
CN0901300000000	09	013	Tolland County, CT	2013	NA	83410	77680	5730	6.9
CN0901500000000	09	015	Windham County, CT	2013	NA	62186	56728	5458	8.8
CN1000100000000	10	001	Kent County, DE	2013	NA	73824	68405	5419	7.3
CN1000300000000	10	003	New Castle County, DE	2013	NA	276688	258787	17901	6.5
CN1000500000000	10	005	Sussex County, DE	2013	NA	92216	85927	6289	6.8
CN1100100000000	11	001	District of Columbia	2013	NA	374126	342351	31775	8.5
CN1200100000000	12	001	Alachua County, FL	2013	NA	129435	122038	7397	5.7
CN1200300000000	12	003	Baker County, FL	2013	NA	11270	10438	832	7.4
CN1200500000000	12	005	Bay County, FL	2013	NA	86420	80126	6294	7.3
CN1200700000000	12	007	Bradford County, FL	2013	NA	10985	10293	692	6.3
CN1200900000000	12	009	Brevard County, FL	2013	NA	258685	237228	21457	8.3
CN1201100000000	12	011	Broward County, FL	2013	NA	974428	908457	65971	6.8
CN1201300000000	12	013	Calhoun County, FL	2013	NA	4916	4530	386	7.9
CN1201500000000	12	015	Charlotte County, FL	2013	NA	66196	60889	5307	8
CN1201700000000	12	017	Citrus County, FL	2013	NA	49374	44587	4787	9.7
CN1201900000000	12	019	Clay County, FL	2013	NA	96943	90794	6149	6.3
CN1202100000000	12	021	Collier County, FL	2013	NA	155575	144588	10987	7.1
CN1202300000000	12	023	Columbia County, FL	2013	NA	27867	25759	2108	7.6
CN1202700000000	12	027	DeSoto County, FL	2013	NA	13133	12056	1077	8.2
CN1202900000000	12	029	Dixie County, FL	2013	NA	5846	5348	498	8.5
CN1203100000000	12	031	Duval County, FL	2013	NA	457588	423256	34332	7.5
CN1203300000000	12	033	Escambia County, FL	2013	NA	138979	128926	10053	7.2
CN1203500000000	12	035	Flagler County, FL	2013	NA	44020	40340	3680	8.4
CN1203700000000	12	037	Franklin County, FL	2013	NA	4992	4716	276	5.5
CN1203900000000	12	039	Gadsden County, FL	2013	NA	18866	17138	1728	9.2
CN1204100000000	12	041	Gilchrist County, FL	2013	NA	6623	6103	520	7.9
CN1204300000000	12	043	Glades County, FL	2013	NA	5468	5062	406	7.4
CN1204500000000	12	045	Gulf County, FL	2013	NA	6162	5746	416	6.8
CN1204700000000	12	047	Hamilton County, FL	2013	NA	4633	4236	397	8.6
CN1204900000000	12	049	Hardee County, FL	2013	NA	11052	10141	911	8.2
CN1205100000000	12	051	Hendry County, FL	2013	NA	16651	14661	1990	12
CN1205300000000	12	053	Hernando County, FL	2013	NA	66338	60381	5957	9
CN1205500000000	12	055	Highlands County, FL	2013	NA	36128	32688	3440	9.5
CN1205700000000	12	057	Hillsborough County, FL	2013	NA	673420	629073	44347	6.6
CN1205900000000	12	059	Holmes County, FL	2013	NA	7012	6461	551	7.9
CN1206100000000	12	061	Indian River County, FL	2013	NA	61499	55568	5931	9.6
CN1206300000000	12	063	Jackson County, FL	2013	NA	17779	16438	1341	7.5
CN1206500000000	12	065	Jefferson County, FL	2013	NA	5469	5045	424	7.8
CN1206700000000	12	067	Lafayette County, FL	2013	NA	3501	3319	182	5.2
CN1206900000000	12	069	Lake County, FL	2013	NA	135456	125441	10015	7.4
CN1207100000000	12	071	Lee County, FL	2013	NA	299129	277332	21797	7.3
CN1207300000000	12	073	Leon County, FL	2013	NA	148268	139235	9033	6.1
CN1207500000000	12	075	Levy County, FL	2013	NA	16335	15001	1334	8.2
CN1207700000000	12	077	Liberty County, FL	2013	NA	2844	2654	190	6.7
CN1207900000000	12	079	Madison County, FL	2013	NA	7910	7295	615	7.8
CN1208100000000	12	081	Manatee County, FL	2013	NA	155326	144918	10408	6.7
CN1208300000000	12	083	Marion County, FL	2013	NA	131043	119852	11191	8.5
CN1208500000000	12	085	Martin County, FL	2013	NA	67497	62628	4869	7.2
CN1208600000000	12	086	Miami-Dade County, FL	2013	NA	1291199	1195237	95962	7.4
CN1208700000000	12	087	Monroe County, FL	2013	NA	44317	42172	2145	4.8
CN1208900000000	12	089	Nassau County, FL	2013	NA	36175	33743	2432	6.7
CN1209100000000	12	091	Okaloosa County, FL	2013	NA	92170	86899	5271	5.7
CN1209300000000	12	093	Okeechobee County, FL	2013	NA	18103	16519	1584	8.7
CN1209500000000	12	095	Orange County, FL	2013	NA	663087	618150	44937	6.8
CN1209700000000	12	097	Osceola County, FL	2013	NA	147899	136197	11702	7.9
CN1209900000000	12	099	Palm Beach County, FL	2013	NA	672215	624322	47893	7.1
CN1210100000000	12	101	Pasco County, FL	2013	NA	210396	194247	16149	7.7
CN1210300000000	12	103	Pinellas County, FL	2013	NA	470232	438997	31235	6.6
CN1210500000000	12	105	Polk County, FL	2013	NA	278708	255795	22913	8.2
CN1210700000000	12	107	Putnam County, FL	2013	NA	28211	25274	2937	10.4
CN1210900000000	12	109	St. Johns County, FL	2013	NA	107375	101542	5833	5.4
CN1211100000000	12	111	St. Lucie County, FL	2013	NA	129208	116341	12867	10
CN1211300000000	12	113	Santa Rosa County, FL	2013	NA	73045	68373	4672	6.4
CN1211500000000	12	115	Sarasota County, FL	2013	NA	170746	158821	11925	7
CN1211700000000	12	117	Seminole County, FL	2013	NA	232955	217434	15521	6.7
CN1211900000000	12	119	Sumter County, FL	2013	NA	27572	25020	2552	9.3
CN1212100000000	12	121	Suwannee County, FL	2013	NA	18077	16826	1251	6.9
CN1212300000000	12	123	Taylor County, FL	2013	NA	9484	8742	742	7.8
CN1212500000000	12	125	Union County, FL	2013	NA	4984	4669	315	6.3
CN1212700000000	12	127	Volusia County, FL	2013	NA	235627	216323	19304	8.2
CN1212900000000	12	129	Wakulla County, FL	2013	NA	14078	13238	840	6
CN1213100000000	12	131	Walton County, FL	2013	NA	26975	25329	1646	6.1
CN1213300000000	12	133	Washington County, FL	2013	NA	9853	9094	759	7.7
CN1300100000000	13	001	Appling County, GA	2013	NA	8673	7741	932	10.7
CN1300300000000	13	003	Atkinson County, GA	2013	NA	3485	3159	326	9.4
CN1300500000000	13	005	Bacon County, GA	2013	NA	4628	4237	391	8.4
CN1300700000000	13	007	Baker County, GA	2013	NA	1129	1010	119	10.5
CN1300900000000	13	009	Baldwin County, GA	2013	NA	18527	16649	1878	10.1
CN1301100000000	13	011	Banks County, GA	2013	NA	7995	7365	630	7.9
CN1301300000000	13	013	Barrow County, GA	2013	NA	34681	32118	2563	7.4
CN1301500000000	13	015	Bartow County, GA	2013	NA	47053	42976	4077	8.7
CN1301700000000	13	017	Ben Hill County, GA	2013	NA	5775	5055	720	12.5
CN1301900000000	13	019	Berrien County, GA	2013	NA	7410	6703	707	9.5
CN1302100000000	13	021	Bibb County, GA	2013	NA	69888	63407	6481	9.3
CN1302300000000	13	023	Bleckley County, GA	2013	NA	4788	4118	670	14
CN1302500000000	13	025	Brantley County, GA	2013	NA	7036	6287	749	10.6
CN1302700000000	13	027	Brooks County, GA	2013	NA	6682	6125	557	8.3
CN1302900000000	13	029	Bryan County, GA	2013	NA	15417	14270	1147	7.4
CN1303100000000	13	031	Bulloch County, GA	2013	NA	34177	31209	2968	8.7
CN1303300000000	13	033	Burke County, GA	2013	NA	9484	8348	1136	12
CN1303500000000	13	035	Butts County, GA	2013	NA	10197	9250	947	9.3
CN1303700000000	13	037	Calhoun County, GA	2013	NA	2105	1934	171	8.1
CN1303900000000	13	039	Camden County, GA	2013	NA	21579	19904	1675	7.8
CN1304300000000	13	043	Candler County, GA	2013	NA	5102	4685	417	8.2
CN1304500000000	13	045	Carroll County, GA	2013	NA	51854	46866	4988	9.6
CN1304700000000	13	047	Catoosa County, GA	2013	NA	31646	29516	2130	6.7
CN1304900000000	13	049	Charlton County, GA	2013	NA	4919	4504	415	8.4
CN1305100000000	13	051	Chatham County, GA	2013	NA	131360	120499	10861	8.3
CN1305300000000	13	053	Chattahoochee County, GA	2013	NA	2461	2191	270	11
CN1305500000000	13	055	Chattooga County, GA	2013	NA	10537	9589	948	9
CN1305700000000	13	057	Cherokee County, GA	2013	NA	115674	108567	7107	6.1
CN1305900000000	13	059	Clarke County, GA	2013	NA	57878	53353	4525	7.8
CN1306100000000	13	061	Clay County, GA	2013	NA	955	846	109	11.4
CN1306300000000	13	063	Clayton County, GA	2013	NA	125018	111547	13471	10.8
CN1306500000000	13	065	Clinch County, GA	2013	NA	2830	2571	259	9.2
CN1306700000000	13	067	Cobb County, GA	2013	NA	388813	362780	26033	6.7
CN1306900000000	13	069	Coffee County, GA	2013	NA	17509	15772	1737	9.9
CN1307100000000	13	071	Colquitt County, GA	2013	NA	20328	18545	1783	8.8
CN1307300000000	13	073	Columbia County, GA	2013	NA	65565	61317	4248	6.5
CN1307500000000	13	075	Cook County, GA	2013	NA	7437	6802	635	8.5
CN1307700000000	13	077	Coweta County, GA	2013	NA	65810	61216	4594	7
CN1307900000000	13	079	Crawford County, GA	2013	NA	5688	5185	503	8.8
CN1308100000000	13	081	Crisp County, GA	2013	NA	9674	8594	1080	11.2
CN1308300000000	13	083	Dade County, GA	2013	NA	8127	7548	579	7.1
CN1308500000000	13	085	Dawson County, GA	2013	NA	10782	9986	796	7.4
CN1308700000000	13	087	Decatur County, GA	2013	NA	11575	10476	1099	9.5
CN1308900000000	13	089	DeKalb County, GA	2013	NA	368650	337594	31056	8.4
CN1309100000000	13	091	Dodge County, GA	2013	NA	7781	6896	885	11.4
CN1309300000000	13	093	Dooly County, GA	2013	NA	4515	3996	519	11.5
CN1309500000000	13	095	Dougherty County, GA	2013	NA	39714	35610	4104	10.3
CN1309700000000	13	097	Douglas County, GA	2013	NA	67309	61525	5784	8.6
CN1309900000000	13	099	Early County, GA	2013	NA	4375	3975	400	9.1
CN1310100000000	13	101	Echols County, GA	2013	NA	1780	1667	113	6.3
CN1310300000000	13	103	Effingham County, GA	2013	NA	26177	24303	1874	7.2
CN1310500000000	13	105	Elbert County, GA	2013	NA	8368	7463	905	10.8
CN1310700000000	13	107	Emanuel County, GA	2013	NA	8845	7738	1107	12.5
CN1310900000000	13	109	Evans County, GA	2013	NA	4727	4367	360	7.6
CN1311100000000	13	111	Fannin County, GA	2013	NA	9762	8884	878	9
CN1311300000000	13	113	Fayette County, GA	2013	NA	53405	49826	3579	6.7
CN1311500000000	13	115	Floyd County, GA	2013	NA	43769	39614	4155	9.5
CN1311700000000	13	117	Forsyth County, GA	2013	NA	96487	90817	5670	5.9
CN1311900000000	13	119	Franklin County, GA	2013	NA	9331	8420	911	9.8
CN1312100000000	13	121	Fulton County, GA	2013	NA	508273	467197	41076	8.1
CN1312300000000	13	123	Gilmer County, GA	2013	NA	11907	10837	1070	9
CN1312500000000	13	125	Glascock County, GA	2013	NA	1289	1167	122	9.5
CN1312700000000	13	127	Glynn County, GA	2013	NA	38055	34821	3234	8.5
CN1312900000000	13	129	Gordon County, GA	2013	NA	26195	23876	2319	8.9
CN1313100000000	13	131	Grady County, GA	2013	NA	10482	9673	809	7.7
CN1313300000000	13	133	Greene County, GA	2013	NA	6350	5721	629	9.9
CN1313500000000	13	135	Gwinnett County, GA	2013	NA	438240	408130	30110	6.9
CN1313700000000	13	137	Habersham County, GA	2013	NA	19316	17768	1548	8
CN1313900000000	13	139	Hall County, GA	2013	NA	89494	83366	6128	6.8
CN1314100000000	13	141	Hancock County, GA	2013	NA	2641	2253	388	14.7
CN1314300000000	13	143	Haralson County, GA	2013	NA	11968	10859	1109	9.3
CN1314500000000	13	145	Harris County, GA	2013	NA	15810	14776	1034	6.5
CN1314700000000	13	147	Hart County, GA	2013	NA	10498	9533	965	9.2
CN1314900000000	13	149	Heard County, GA	2013	NA	5010	4539	471	9.4
CN1315100000000	13	151	Henry County, GA	2013	NA	103433	94697	8736	8.4
CN1315300000000	13	153	Houston County, GA	2013	NA	67462	62389	5073	7.5
CN1315500000000	13	155	Irwin County, GA	2013	NA	3371	3013	358	10.6
CN1315700000000	13	157	Jackson County, GA	2013	NA	29599	27557	2042	6.9
CN1315900000000	13	159	Jasper County, GA	2013	NA	6514	5975	539	8.3
CN1316100000000	13	161	Jeff Davis County, GA	2013	NA	6383	5749	634	9.9
CN1316300000000	13	163	Jefferson County, GA	2013	NA	6841	5885	956	14
CN1316500000000	13	165	Jenkins County, GA	2013	NA	3324	2914	410	12.3
CN1316700000000	13	167	Johnson County, GA	2013	NA	4000	3607	393	9.8
CN1316900000000	13	169	Jones County, GA	2013	NA	13610	12619	991	7.3
CN1317100000000	13	171	Lamar County, GA	2013	NA	7822	6939	883	11.3
CN1317300000000	13	173	Lanier County, GA	2013	NA	3844	3514	330	8.6
CN1317500000000	13	175	Laurens County, GA	2013	NA	19422	17331	2091	10.8
CN1317700000000	13	177	Lee County, GA	2013	NA	14297	13314	983	6.9
CN1317900000000	13	179	Liberty County, GA	2013	NA	26201	23978	2223	8.5
CN1318100000000	13	181	Lincoln County, GA	2013	NA	3451	3105	346	10
CN1318300000000	13	183	Long County, GA	2013	NA	6697	6152	545	8.1
CN1318500000000	13	185	Lowndes County, GA	2013	NA	51098	46998	4100	8
CN1318700000000	13	187	Lumpkin County, GA	2013	NA	15140	14024	1116	7.4
CN1318900000000	13	189	McDuffie County, GA	2013	NA	9079	8053	1026	11.3
CN1319100000000	13	191	McIntosh County, GA	2013	NA	5931	5399	532	9
CN1319300000000	13	193	Macon County, GA	2013	NA	4964	4331	633	12.8
CN1319500000000	13	195	Madison County, GA	2013	NA	12909	11931	978	7.6
CN1319700000000	13	197	Marion County, GA	2013	NA	3453	3148	305	8.8
CN1319900000000	13	199	Meriwether County, GA	2013	NA	8815	7867	948	10.8
CN1320100000000	13	201	Miller County, GA	2013	NA	2655	2462	193	7.3
CN1320500000000	13	205	Mitchell County, GA	2013	NA	9016	8242	774	8.6
CN1320700000000	13	207	Monroe County, GA	2013	NA	12768	11742	1026	8
CN1320900000000	13	209	Montgomery County, GA	2013	NA	4049	3587	462	11.4
CN1321100000000	13	211	Morgan County, GA	2013	NA	8348	7674	674	8.1
CN1321300000000	13	213	Murray County, GA	2013	NA	15887	14102	1785	11.2
CN1321500000000	13	215	Muscogee County, GA	2013	NA	83129	75375	7754	9.3
CN1321700000000	13	217	Newton County, GA	2013	NA	48066	43403	4663	9.7
CN1321900000000	13	219	Oconee County, GA	2013	NA	17095	16137	958	5.6
CN1322100000000	13	221	Oglethorpe County, GA	2013	NA	6739	6229	510	7.6
CN1322300000000	13	223	Paulding County, GA	2013	NA	74530	69166	5364	7.2
CN1322500000000	13	225	Peach County, GA	2013	NA	11890	10622	1268	10.7
CN1322700000000	13	227	Pickens County, GA	2013	NA	13809	12710	1099	8
CN1322900000000	13	229	Pierce County, GA	2013	NA	8159	7463	696	8.5
CN1323100000000	13	231	Pike County, GA	2013	NA	8302	7599	703	8.5
CN1323300000000	13	233	Polk County, GA	2013	NA	18507	16860	1647	8.9
CN1323500000000	13	235	Pulaski County, GA	2013	NA	4197	3826	371	8.8
CN1323700000000	13	237	Putnam County, GA	2013	NA	8143	7303	840	10.3
CN1323900000000	13	239	Quitman County, GA	2013	NA	902	828	74	8.2
CN1324100000000	13	241	Rabun County, GA	2013	NA	6822	6146	676	9.9
CN1324300000000	13	243	Randolph County, GA	2013	NA	2790	2502	288	10.3
CN1324500000000	13	245	Richmond County, GA	2013	NA	86714	78191	8523	9.8
CN1324700000000	13	247	Rockdale County, GA	2013	NA	42178	38321	3857	9.1
CN1324900000000	13	249	Schley County, GA	2013	NA	2131	1934	197	9.2
CN1325100000000	13	251	Screven County, GA	2013	NA	5563	4863	700	12.6
CN1325300000000	13	253	Seminole County, GA	2013	NA	3138	2817	321	10.2
CN1325500000000	13	255	Spalding County, GA	2013	NA	27777	24587	3190	11.5
CN1325700000000	13	257	Stephens County, GA	2013	NA	11511	10458	1053	9.1
CN1325900000000	13	259	Stewart County, GA	2013	NA	2287	2087	200	8.7
CN1326100000000	13	261	Sumter County, GA	2013	NA	13416	11905	1511	11.3
CN1326300000000	13	263	Talbot County, GA	2013	NA	2861	2596	265	9.3
CN1326500000000	13	265	Taliaferro County, GA	2013	NA	590	520	70	11.9
CN1326700000000	13	267	Tattnall County, GA	2013	NA	9561	8801	760	7.9
CN1326900000000	13	269	Taylor County, GA	2013	NA	3173	2803	370	11.7
CN1327100000000	13	271	Telfair County, GA	2013	NA	5295	4691	604	11.4
CN1327300000000	13	273	Terrell County, GA	2013	NA	3665	3307	358	9.8
CN1327500000000	13	275	Thomas County, GA	2013	NA	17803	16198	1605	9
CN1327700000000	13	277	Tift County, GA	2013	NA	18694	17106	1588	8.5
CN1327900000000	13	279	Toombs County, GA	2013	NA	12790	11383	1407	11
CN1328100000000	13	281	Towns County, GA	2013	NA	4159	3719	440	10.6
CN1328300000000	13	283	Treutlen County, GA	2013	NA	2828	2480	348	12.3
CN1328500000000	13	285	Troup County, GA	2013	NA	36163	33048	3115	8.6
CN1328700000000	13	287	Turner County, GA	2013	NA	3336	3003	333	10
CN1328900000000	13	289	Twiggs County, GA	2013	NA	3122	2693	429	13.7
CN1329100000000	13	291	Union County, GA	2013	NA	9329	8593	736	7.9
CN1329300000000	13	293	Upson County, GA	2013	NA	11923	10752	1171	9.8
CN1329500000000	13	295	Walker County, GA	2013	NA	30158	27725	2433	8.1
CN1329700000000	13	297	Walton County, GA	2013	NA	41052	37860	3192	7.8
CN1329900000000	13	299	Ware County, GA	2013	NA	15098	13685	1413	9.4
CN1330100000000	13	301	Warren County, GA	2013	NA	2728	2400	328	12
CN1330300000000	13	303	Washington County, GA	2013	NA	7688	6947	741	9.6
CN1330500000000	13	305	Wayne County, GA	2013	NA	12292	11091	1201	9.8
CN1330700000000	13	307	Webster County, GA	2013	NA	1036	940	96	9.3
CN1330900000000	13	309	Wheeler County, GA	2013	NA	1894	1656	238	12.6
CN1331100000000	13	311	White County, GA	2013	NA	13791	12775	1016	7.4
CN1331300000000	13	313	Whitfield County, GA	2013	NA	44658	40391	4267	9.6
CN1331500000000	13	315	Wilcox County, GA	2013	NA	2819	2506	313	11.1
CN1331700000000	13	317	Wilkes County, GA	2013	NA	3738	3320	418	11.2
CN1331900000000	13	319	Wilkinson County, GA	2013	NA	3717	3333	384	10.3
CN1332100000000	13	321	Worth County, GA	2013	NA	9246	8393	853	9.2
CN1500100000000	15	001	Hawaii County, HI	2013	NA	87001	81242	5759	6.6
CN1500300000000	15	003	Honolulu County/city, HI	2013	NA	449026	428988	20038	4.5
CN1500700000000	15	007	Kauai County, HI	2013	NA	34725	32796	1929	5.6
CN1500900000000	15	009	Maui County, HI	2013	NA	80805	76665	4140	5.1
CN1600100000000	16	001	Ada County, ID	2013	NA	206575	195843	10732	5.2
CN1600300000000	16	003	Adams County, ID	2013	NA	1709	1476	233	13.6
CN1600500000000	16	005	Bannock County, ID	2013	NA	41413	38998	2415	5.8
CN1600700000000	16	007	Bear Lake County, ID	2013	NA	2884	2736	148	5.1
CN1600900000000	16	009	Benewah County, ID	2013	NA	3990	3588	402	10.1
CN1601100000000	16	011	Bingham County, ID	2013	NA	22302	20995	1307	5.9
CN1601300000000	16	013	Blaine County, ID	2013	NA	11587	10926	661	5.7
CN1601500000000	16	015	Boise County, ID	2013	NA	2922	2684	238	8.1
CN1601700000000	16	017	Bonner County, ID	2013	NA	18280	16674	1606	8.8
CN1601900000000	16	019	Bonneville County, ID	2013	NA	48959	46293	2666	5.4
CN1602100000000	16	021	Boundary County, ID	2013	NA	4907	4516	391	8
CN1602300000000	16	023	Butte County, ID	2013	NA	1296	1207	89	6.9
CN1602500000000	16	025	Camas County, ID	2013	NA	634	593	41	6.5
CN1602700000000	16	027	Canyon County, ID	2013	NA	87750	81143	6607	7.5
CN1602900000000	16	029	Caribou County, ID	2013	NA	3899	3693	206	5.3
CN1603100000000	16	031	Cassia County, ID	2013	NA	11119	10538	581	5.2
CN1603300000000	16	033	Clark County, ID	2013	NA	425	398	27	6.4
CN1603500000000	16	035	Clearwater County, ID	2013	NA	3188	2828	360	11.3
CN1603700000000	16	037	Custer County, ID	2013	NA	2209	2024	185	8.4
CN1603900000000	16	039	Elmore County, ID	2013	NA	10783	10059	724	6.7
CN1604100000000	16	041	Franklin County, ID	2013	NA	6265	6005	260	4.2
CN1604300000000	16	043	Fremont County, ID	2013	NA	6915	6552	363	5.2
CN1604500000000	16	045	Gem County, ID	2013	NA	7500	6913	587	7.8
CN1604700000000	16	047	Gooding County, ID	2013	NA	8033	7638	395	4.9
CN1604900000000	16	049	Idaho County, ID	2013	NA	6583	5930	653	9.9
CN1605100000000	16	051	Jefferson County, ID	2013	NA	12143	11522	621	5.1
CN1605300000000	16	053	Jerome County, ID	2013	NA	10829	10250	579	5.3
CN1605500000000	16	055	Kootenai County, ID	2013	NA	69255	64204	5051	7.3
CN1605700000000	16	057	Latah County, ID	2013	NA	19422	18468	954	4.9
CN1605900000000	16	059	Lemhi County, ID	2013	NA	3437	3115	322	9.4
CN1606100000000	16	061	Lewis County, ID	2013	NA	1612	1531	81	5
CN1606300000000	16	063	Lincoln County, ID	2013	NA	2647	2446	201	7.6
CN1606500000000	16	065	Madison County, ID	2013	NA	18447	17695	752	4.1
CN1606700000000	16	067	Minidoka County, ID	2013	NA	10383	9809	574	5.5
CN1606900000000	16	069	Nez Perce County, ID	2013	NA	20223	19217	1006	5
CN1607100000000	16	071	Oneida County, ID	2013	NA	2095	2005	90	4.3
CN1607300000000	16	073	Owyhee County, ID	2013	NA	5121	4924	197	3.8
CN1607500000000	16	075	Payette County, ID	2013	NA	10818	10116	702	6.5
CN1607700000000	16	077	Power County, ID	2013	NA	3981	3719	262	6.6
CN1607900000000	16	079	Shoshone County, ID	2013	NA	5493	4828	665	12.1
CN1608100000000	16	081	Teton County, ID	2013	NA	5455	5182	273	5
CN1608300000000	16	083	Twin Falls County, ID	2013	NA	38044	35863	2181	5.7
CN1608500000000	16	085	Valley County, ID	2013	NA	4542	4079	463	10.2
CN1608700000000	16	087	Washington County, ID	2013	NA	4764	4413	351	7.4
CN1700100000000	17	001	Adams County, IL	2013	NA	32944	30710	2234	6.8
CN1700300000000	17	003	Alexander County, IL	2013	NA	2689	2348	341	12.7
CN1700500000000	17	005	Bond County, IL	2013	NA	8032	7336	696	8.7
CN1700700000000	17	007	Boone County, IL	2013	NA	26369	23693	2676	10.1
CN1700900000000	17	009	Brown County, IL	2013	NA	2613	2452	161	6.2
CN1701100000000	17	011	Bureau County, IL	2013	NA	17726	16099	1627	9.2
CN1701300000000	17	013	Calhoun County, IL	2013	NA	2415	2178	237	9.8
CN1701500000000	17	015	Carroll County, IL	2013	NA	7877	7250	627	8
CN1701700000000	17	017	Cass County, IL	2013	NA	6429	5842	587	9.1
CN1701900000000	17	019	Champaign County, IL	2013	NA	106218	98552	7666	7.2
CN1702100000000	17	021	Christian County, IL	2013	NA	15977	14423	1554	9.7
CN1702300000000	17	023	Clark County, IL	2013	NA	7939	7200	739	9.3
CN1702500000000	17	025	Clay County, IL	2013	NA	6315	5689	626	9.9
CN1702700000000	17	027	Clinton County, IL	2013	NA	19940	18586	1354	6.8
CN1702900000000	17	029	Coles County, IL	2013	NA	24407	22263	2144	8.8
CN1703100000000	17	031	Cook County, IL	2013	NA	2671901	2414719	257182	9.6
CN1703300000000	17	033	Crawford County, IL	2013	NA	9961	9132	829	8.3
CN1703500000000	17	035	Cumberland County, IL	2013	NA	5816	5361	455	7.8
CN1703700000000	17	037	DeKalb County, IL	2013	NA	54903	50418	4485	8.2
CN1703900000000	17	039	De Witt County, IL	2013	NA	8178	7498	680	8.3
CN1704100000000	17	041	Douglas County, IL	2013	NA	9862	9180	682	6.9
CN1704300000000	17	043	DuPage County, IL	2013	NA	510631	473037	37594	7.4
CN1704500000000	17	045	Edgar County, IL	2013	NA	9030	8176	854	9.5
CN1704700000000	17	047	Edwards County, IL	2013	NA	2868	2622	246	8.6
CN1704900000000	17	049	Effingham County, IL	2013	NA	18063	16813	1250	6.9
CN1705100000000	17	051	Fayette County, IL	2013	NA	10128	9194	934	9.2
CN1705300000000	17	053	Ford County, IL	2013	NA	6731	6233	498	7.4
CN1705500000000	17	055	Franklin County, IL	2013	NA	16918	14908	2010	11.9
CN1705700000000	17	057	Fulton County, IL	2013	NA	16206	14435	1771	10.9
CN1705900000000	17	059	Gallatin County, IL	2013	NA	2479	2245	234	9.4
CN1706100000000	17	061	Greene County, IL	2013	NA	6316	5770	546	8.6
CN1706300000000	17	063	Grundy County, IL	2013	NA	25906	22898	3008	11.6
CN1706500000000	17	065	Hamilton County, IL	2013	NA	4086	3768	318	7.8
CN1706700000000	17	067	Hancock County, IL	2013	NA	8894	8140	754	8.5
CN1706900000000	17	069	Hardin County, IL	2013	NA	1734	1537	197	11.4
CN1707100000000	17	071	Henderson County, IL	2013	NA	3669	3380	289	7.9
CN1707300000000	17	073	Henry County, IL	2013	NA	25503	23530	1973	7.7
CN1707500000000	17	075	Iroquois County, IL	2013	NA	14941	13672	1269	8.5
CN1707700000000	17	077	Jackson County, IL	2013	NA	28522	26256	2266	7.9
CN1707900000000	17	079	Jasper County, IL	2013	NA	4727	4352	375	7.9
CN1708100000000	17	081	Jefferson County, IL	2013	NA	17826	16128	1698	9.5
CN1708300000000	17	083	Jersey County, IL	2013	NA	11148	10149	999	9
CN1708500000000	17	085	Jo Daviess County, IL	2013	NA	11589	10705	884	7.6
CN1708700000000	17	087	Johnson County, IL	2013	NA	4285	3762	523	12.2
CN1708900000000	17	089	Kane County, IL	2013	NA	265389	242355	23034	8.7
CN1709100000000	17	091	Kankakee County, IL	2013	NA	55147	49336	5811	10.5
CN1709300000000	17	093	Kendall County, IL	2013	NA	64446	59054	5392	8.4
CN1709500000000	17	095	Knox County, IL	2013	NA	23664	21566	2098	8.9
CN1709700000000	17	097	Lake County, IL	2013	NA	363609	334814	28795	7.9
CN1709900000000	17	099	LaSalle County, IL	2013	NA	58100	52094	6006	10.3
CN1710100000000	17	101	Lawrence County, IL	2013	NA	6326	5680	646	10.2
CN1710300000000	17	103	Lee County, IL	2013	NA	18088	16638	1450	8
CN1710500000000	17	105	Livingston County, IL	2013	NA	17693	16264	1429	8.1
CN1710700000000	17	107	Logan County, IL	2013	NA	13059	12002	1057	8.1
CN1710900000000	17	109	McDonough County, IL	2013	NA	14629	13415	1214	8.3
CN1711100000000	17	111	McHenry County, IL	2013	NA	166937	152512	14425	8.6
CN1711300000000	17	113	McLean County, IL	2013	NA	92706	86609	6097	6.6
CN1711500000000	17	115	Macon County, IL	2013	NA	52722	46771	5951	11.3
CN1711700000000	17	117	Macoupin County, IL	2013	NA	23463	21244	2219	9.5
CN1711900000000	17	119	Madison County, IL	2013	NA	133179	121346	11833	8.9
CN1712100000000	17	121	Marion County, IL	2013	NA	18107	16285	1822	10.1
CN1712300000000	17	123	Marshall County, IL	2013	NA	5902	5363	539	9.1
CN1712500000000	17	125	Mason County, IL	2013	NA	6731	5994	737	10.9
CN1712700000000	17	127	Massac County, IL	2013	NA	6406	5777	629	9.8
CN1712900000000	17	129	Menard County, IL	2013	NA	6590	6116	474	7.2
CN1713100000000	17	131	Mercer County, IL	2013	NA	8424	7764	660	7.8
CN1713300000000	17	133	Monroe County, IL	2013	NA	17724	16538	1186	6.7
CN1713500000000	17	135	Montgomery County, IL	2013	NA	12571	11196	1375	10.9
CN1713700000000	17	137	Morgan County, IL	2013	NA	17339	15974	1365	7.9
CN1713900000000	17	139	Moultrie County, IL	2013	NA	7100	6589	511	7.2
CN1714100000000	17	141	Ogle County, IL	2013	NA	25763	23223	2540	9.9
CN1714300000000	17	143	Peoria County, IL	2013	NA	93432	84426	9006	9.6
CN1714500000000	17	145	Perry County, IL	2013	NA	9020	8024	996	11
CN1714700000000	17	147	Piatt County, IL	2013	NA	8620	8020	600	7
CN1714900000000	17	149	Pike County, IL	2013	NA	7690	7112	578	7.5
CN1715100000000	17	151	Pope County, IL	2013	NA	1831	1662	169	9.2
CN1715300000000	17	153	Pulaski County, IL	2013	NA	2217	1939	278	12.5
CN1715500000000	17	155	Putnam County, IL	2013	NA	3053	2750	303	9.9
CN1715700000000	17	157	Randolph County, IL	2013	NA	14372	13169	1203	8.4
CN1715900000000	17	159	Richland County, IL	2013	NA	7370	6755	615	8.3
CN1716100000000	17	161	Rock Island County, IL	2013	NA	73845	67726	6119	8.3
CN1716300000000	17	163	St. Clair County, IL	2013	NA	127740	115227	12513	9.8
CN1716500000000	17	165	Saline County, IL	2013	NA	11276	10083	1193	10.6
CN1716700000000	17	167	Sangamon County, IL	2013	NA	101778	94115	7663	7.5
CN1716900000000	17	169	Schuyler County, IL	2013	NA	3474	3185	289	8.3
CN1717100000000	17	171	Scott County, IL	2013	NA	2599	2368	231	8.9
CN1717300000000	17	173	Shelby County, IL	2013	NA	10304	9405	899	8.7
CN1717500000000	17	175	Stark County, IL	2013	NA	2882	2607	275	9.5
CN1717700000000	17	177	Stephenson County, IL	2013	NA	22727	20591	2136	9.4
CN1717900000000	17	179	Tazewell County, IL	2013	NA	69029	63057	5972	8.7
CN1718100000000	17	181	Union County, IL	2013	NA	7411	6579	832	11.2
CN1718300000000	17	183	Vermilion County, IL	2013	NA	35857	32051	3806	10.6
CN1718500000000	17	185	Wabash County, IL	2013	NA	5640	5216	424	7.5
CN1718700000000	17	187	Warren County, IL	2013	NA	8820	8171	649	7.4
CN1718900000000	17	189	Washington County, IL	2013	NA	8917	8363	554	6.2
CN1719100000000	17	191	Wayne County, IL	2013	NA	7880	7267	613	7.8
CN1719300000000	17	193	White County, IL	2013	NA	7026	6486	540	7.7
CN1719500000000	17	195	Whiteside County, IL	2013	NA	29377	26814	2563	8.7
CN1719700000000	17	197	Will County, IL	2013	NA	358410	323349	35061	9.8
CN1719900000000	17	199	Williamson County, IL	2013	NA	31471	28636	2835	9
CN1720100000000	17	201	Winnebago County, IL	2013	NA	142974	127946	15028	10.5
CN1720300000000	17	203	Woodford County, IL	2013	NA	19912	18496	1416	7.1
CN1800100000000	18	001	Adams County, IN	2013	NA	15888	14922	966	6.1
CN1800300000000	18	003	Allen County, IN	2013	NA	174128	161046	13082	7.5
CN1800500000000	18	005	Bartholomew County, IN	2013	NA	41587	39102	2485	6
CN1800700000000	18	007	Benton County, IN	2013	NA	4462	4147	315	7.1
CN1800900000000	18	009	Blackford County, IN	2013	NA	5440	4902	538	9.9
CN1801100000000	18	011	Boone County, IN	2013	NA	31079	29308	1771	5.7
CN1801300000000	18	013	Brown County, IN	2013	NA	7316	6773	543	7.4
CN1801500000000	18	015	Carroll County, IN	2013	NA	9906	9209	697	7
CN1801700000000	18	017	Cass County, IN	2013	NA	17671	16309	1362	7.7
CN1801900000000	18	019	Clark County, IN	2013	NA	56230	52343	3887	6.9
CN1802100000000	18	021	Clay County, IN	2013	NA	12582	11459	1123	8.9
CN1802300000000	18	023	Clinton County, IN	2013	NA	16420	15255	1165	7.1
CN1802500000000	18	025	Crawford County, IN	2013	NA	4841	4356	485	10
CN1802700000000	18	027	Daviess County, IN	2013	NA	14869	14028	841	5.7
CN1802900000000	18	029	Dearborn County, IN	2013	NA	25174	23043	2131	8.5
CN1803100000000	18	031	Decatur County, IN	2013	NA	13861	12933	928	6.7
CN1803300000000	18	033	DeKalb County, IN	2013	NA	20941	19443	1498	7.2
CN1803500000000	18	035	Delaware County, IN	2013	NA	54166	49495	4671	8.6
CN1803700000000	18	037	Dubois County, IN	2013	NA	21629	20480	1149	5.3
CN1803900000000	18	039	Elkhart County, IN	2013	NA	98969	91804	7165	7.2
CN1804100000000	18	041	Fayette County, IN	2013	NA	9023	8091	932	10.3
CN1804300000000	18	043	Floyd County, IN	2013	NA	38502	36061	2441	6.3
CN1804500000000	18	045	Fountain County, IN	2013	NA	8313	7497	816	9.8
CN1804700000000	18	047	Franklin County, IN	2013	NA	10769	9835	934	8.7
CN1804900000000	18	049	Fulton County, IN	2013	NA	9884	9067	817	8.3
CN1805100000000	18	051	Gibson County, IN	2013	NA	18014	16959	1055	5.9
CN1805300000000	18	053	Grant County, IN	2013	NA	32462	29531	2931	9
CN1805500000000	18	055	Greene County, IN	2013	NA	13758	12352	1406	10.2
CN1805700000000	18	057	Hamilton County, IN	2013	NA	155747	147897	7850	5
CN1805900000000	18	059	Hancock County, IN	2013	NA	36064	33672	2392	6.6
CN1806100000000	18	061	Harrison County, IN	2013	NA	18703	17398	1305	7
CN1806300000000	18	063	Hendricks County, IN	2013	NA	78648	74095	4553	5.8
CN1806500000000	18	065	Henry County, IN	2013	NA	21311	19427	1884	8.8
CN1806700000000	18	067	Howard County, IN	2013	NA	36411	33447	2964	8.1
CN1806900000000	18	069	Huntington County, IN	2013	NA	18520	17092	1428	7.7
CN1807100000000	18	071	Jackson County, IN	2013	NA	20848	19494	1354	6.5
CN1807300000000	18	073	Jasper County, IN	2013	NA	15939	14705	1234	7.7
CN1807500000000	18	075	Jay County, IN	2013	NA	10047	9271	776	7.7
CN1807700000000	18	077	Jefferson County, IN	2013	NA	15307	14101	1206	7.9
CN1807900000000	18	079	Jennings County, IN	2013	NA	13033	11835	1198	9.2
CN1808100000000	18	081	Johnson County, IN	2013	NA	73663	69067	4596	6.2
CN1808300000000	18	083	Knox County, IN	2013	NA	18626	17372	1254	6.7
CN1808500000000	18	085	Kosciusko County, IN	2013	NA	39729	37112	2617	6.6
CN1808700000000	18	087	LaGrange County, IN	2013	NA	17610	16570	1040	5.9
CN1808900000000	18	089	Lake County, IN	2013	NA	229970	209126	20844	9.1
CN1809100000000	18	091	LaPorte County, IN	2013	NA	48938	44379	4559	9.3
CN1809300000000	18	093	Lawrence County, IN	2013	NA	20656	18570	2086	10.1
CN1809500000000	18	095	Madison County, IN	2013	NA	58068	52652	5416	9.3
CN1809700000000	18	097	Marion County, IN	2013	NA	463346	423961	39385	8.5
CN1809900000000	18	099	Marshall County, IN	2013	NA	23095	21385	1710	7.4
CN1810100000000	18	101	Martin County, IN	2013	NA	4950	4637	313	6.3
CN1810300000000	18	103	Miami County, IN	2013	NA	15605	14250	1355	8.7
CN1810500000000	18	105	Monroe County, IN	2013	NA	66653	62095	4558	6.8
CN1810700000000	18	107	Montgomery County, IN	2013	NA	18399	17078	1321	7.2
CN1810900000000	18	109	Morgan County, IN	2013	NA	34826	32193	2633	7.6
CN1811100000000	18	111	Newton County, IN	2013	NA	6910	6290	620	9
CN1811300000000	18	113	Noble County, IN	2013	NA	22617	20960	1657	7.3
CN1811500000000	18	115	Ohio County, IN	2013	NA	3165	2902	263	8.3
CN1811700000000	18	117	Orange County, IN	2013	NA	8755	7887	868	9.9
CN1811900000000	18	119	Owen County, IN	2013	NA	9637	8667	970	10.1
CN1812100000000	18	121	Parke County, IN	2013	NA	6931	6292	639	9.2
CN1812300000000	18	123	Perry County, IN	2013	NA	8931	8237	694	7.8
CN1812500000000	18	125	Pike County, IN	2013	NA	6261	5836	425	6.8
CN1812700000000	18	127	Porter County, IN	2013	NA	83171	77172	5999	7.2
CN1812900000000	18	129	Posey County, IN	2013	NA	12945	12125	820	6.3
CN1813100000000	18	131	Pulaski County, IN	2013	NA	6117	5687	430	7
CN1813300000000	18	133	Putnam County, IN	2013	NA	16159	14760	1399	8.7
CN1813500000000	18	135	Randolph County, IN	2013	NA	12576	11488	1088	8.7
CN1813700000000	18	137	Ripley County, IN	2013	NA	13634	12464	1170	8.6
CN1813900000000	18	139	Rush County, IN	2013	NA	8334	7717	617	7.4
CN1814100000000	18	141	St. Joseph County, IN	2013	NA	127095	116036	11059	8.7
CN1814300000000	18	143	Scott County, IN	2013	NA	10238	9324	914	8.9
CN1814500000000	18	145	Shelby County, IN	2013	NA	22345	20705	1640	7.3
CN1814700000000	18	147	Spencer County, IN	2013	NA	10689	9977	712	6.7
CN1814900000000	18	149	Starke County, IN	2013	NA	10213	9247	966	9.5
CN1815100000000	18	151	Steuben County, IN	2013	NA	19319	18109	1210	6.3
CN1815300000000	18	153	Sullivan County, IN	2013	NA	8705	7917	788	9.1
CN1815500000000	18	155	Switzerland County, IN	2013	NA	4883	4519	364	7.5
CN1815700000000	18	157	Tippecanoe County, IN	2013	NA	89629	83674	5955	6.6
CN1815900000000	18	159	Tipton County, IN	2013	NA	7958	7423	535	6.7
CN1816100000000	18	161	Union County, IN	2013	NA	3519	3266	253	7.2
CN1816300000000	18	163	Vanderburgh County, IN	2013	NA	90897	84411	6486	7.1
CN1816500000000	18	165	Vermillion County, IN	2013	NA	7324	6537	787	10.7
CN1816700000000	18	167	Vigo County, IN	2013	NA	49522	44879	4643	9.4
CN1816900000000	18	169	Wabash County, IN	2013	NA	15453	14275	1178	7.6
CN1817100000000	18	171	Warren County, IN	2013	NA	4152	3787	365	8.8
CN1817300000000	18	173	Warrick County, IN	2013	NA	30709	28777	1932	6.3
CN1817500000000	18	175	Washington County, IN	2013	NA	13142	11994	1148	8.7
CN1817700000000	18	177	Wayne County, IN	2013	NA	30535	27887	2648	8.7
CN1817900000000	18	179	Wells County, IN	2013	NA	13650	12784	866	6.3
CN1818100000000	18	181	White County, IN	2013	NA	12930	12042	888	6.9
CN1818300000000	18	183	Whitley County, IN	2013	NA	16760	15590	1170	7
CN1900100000000	19	001	Adair County, IA	2013	NA	4073	3901	172	4.2
CN1900300000000	19	003	Adams County, IA	2013	NA	2150	2071	79	3.7
CN1900500000000	19	005	Allamakee County, IA	2013	NA	7652	7167	485	6.3
CN1900700000000	19	007	Appanoose County, IA	2013	NA	5925	5548	377	6.4
CN1900900000000	19	009	Audubon County, IA	2013	NA	3237	3079	158	4.9
CN1901100000000	19	011	Benton County, IA	2013	NA	13722	13024	698	5.1
CN1901300000000	19	013	Black Hawk County, IA	2013	NA	71742	68079	3663	5.1
CN1901500000000	19	015	Boone County, IA	2013	NA	14881	14278	603	4.1
CN1901700000000	19	017	Bremer County, IA	2013	NA	13998	13468	530	3.8
CN1901900000000	19	019	Buchanan County, IA	2013	NA	11166	10637	529	4.7
CN1902100000000	19	021	Buena Vista County, IA	2013	NA	11307	10860	447	4
CN1902300000000	19	023	Butler County, IA	2013	NA	8261	7887	374	4.5
CN1902500000000	19	025	Calhoun County, IA	2013	NA	4360	4134	226	5.2
CN1902700000000	19	027	Carroll County, IA	2013	NA	11270	10891	379	3.4
CN1902900000000	19	029	Cass County, IA	2013	NA	7290	6922	368	5
CN1903100000000	19	031	Cedar County, IA	2013	NA	10812	10346	466	4.3
CN1903300000000	19	033	Cerro Gordo County, IA	2013	NA	23333	22072	1261	5.4
CN1903500000000	19	035	Cherokee County, IA	2013	NA	6840	6546	294	4.3
CN1903700000000	19	037	Chickasaw County, IA	2013	NA	6366	6049	317	5
CN1903900000000	19	039	Clarke County, IA	2013	NA	4585	4332	253	5.5
CN1904100000000	19	041	Clay County, IA	2013	NA	8813	8416	397	4.5
CN1904300000000	19	043	Clayton County, IA	2013	NA	10074	9506	568	5.6
CN1904500000000	19	045	Clinton County, IA	2013	NA	24921	23487	1434	5.8
CN1904700000000	19	047	Crawford County, IA	2013	NA	8768	8386	382	4.4
CN1904900000000	19	049	Dallas County, IA	2013	NA	40897	39422	1475	3.6
CN1905100000000	19	051	Davis County, IA	2013	NA	4120	3893	227	5.5
CN1905300000000	19	053	Decatur County, IA	2013	NA	4301	4107	194	4.5
CN1905500000000	19	055	Delaware County, IA	2013	NA	10388	9941	447	4.3
CN1905700000000	19	057	Des Moines County, IA	2013	NA	20494	19257	1237	6
CN1905900000000	19	059	Dickinson County, IA	2013	NA	9335	8838	497	5.3
CN1906100000000	19	061	Dubuque County, IA	2013	NA	55050	52549	2501	4.5
CN1906300000000	19	063	Emmet County, IA	2013	NA	5683	5450	233	4.1
CN1906500000000	19	065	Fayette County, IA	2013	NA	10667	10104	563	5.3
CN1906700000000	19	067	Floyd County, IA	2013	NA	8272	7815	457	5.5
CN1906900000000	19	069	Franklin County, IA	2013	NA	5914	5651	263	4.4
CN1907100000000	19	071	Fremont County, IA	2013	NA	4127	3953	174	4.2
CN1907300000000	19	073	Greene County, IA	2013	NA	5123	4883	240	4.7
CN1907500000000	19	075	Grundy County, IA	2013	NA	6599	6311	288	4.4
CN1907700000000	19	077	Guthrie County, IA	2013	NA	5532	5247	285	5.2
CN1907900000000	19	079	Hamilton County, IA	2013	NA	7038	6655	383	5.4
CN1908100000000	19	081	Hancock County, IA	2013	NA	6209	5961	248	4
CN1908300000000	19	083	Hardin County, IA	2013	NA	8696	8252	444	5.1
CN1908500000000	19	085	Harrison County, IA	2013	NA	7507	7169	338	4.5
CN1908700000000	19	087	Henry County, IA	2013	NA	9548	9042	506	5.3
CN1908900000000	19	089	Howard County, IA	2013	NA	5230	4988	242	4.6
CN1909100000000	19	091	Humboldt County, IA	2013	NA	5216	5003	213	4.1
CN1909300000000	19	093	Ida County, IA	2013	NA	3813	3661	152	4
CN1909500000000	19	095	Iowa County, IA	2013	NA	9926	9515	411	4.1
CN1909700000000	19	097	Jackson County, IA	2013	NA	10845	10261	584	5.4
CN1909900000000	19	099	Jasper County, IA	2013	NA	19053	18085	968	5.1
CN1910100000000	19	101	Jefferson County, IA	2013	NA	8925	8482	443	5
CN1910300000000	19	103	Johnson County, IA	2013	NA	82734	79913	2821	3.4
CN1910500000000	19	105	Jones County, IA	2013	NA	10731	10161	570	5.3
CN1910700000000	19	107	Keokuk County, IA	2013	NA	5477	5199	278	5.1
CN1910900000000	19	109	Kossuth County, IA	2013	NA	8473	8172	301	3.6
CN1911100000000	19	111	Lee County, IA	2013	NA	17124	15904	1220	7.1
CN1911300000000	19	113	Linn County, IA	2013	NA	119662	113669	5993	5
CN1911500000000	19	115	Louisa County, IA	2013	NA	5850	5554	296	5.1
CN1911700000000	19	117	Lucas County, IA	2013	NA	4245	4046	199	4.7
CN1911900000000	19	119	Lyon County, IA	2013	NA	6853	6655	198	2.9
CN1912100000000	19	121	Madison County, IA	2013	NA	8090	7679	411	5.1
CN1912300000000	19	123	Mahaska County, IA	2013	NA	11650	11089	561	4.8
CN1912500000000	19	125	Marion County, IA	2013	NA	17318	16546	772	4.5
CN1912700000000	19	127	Marshall County, IA	2013	NA	19797	18606	1191	6
CN1912900000000	19	129	Mills County, IA	2013	NA	7326	7004	322	4.4
CN1913100000000	19	131	Mitchell County, IA	2013	NA	5508	5271	237	4.3
CN1913300000000	19	133	Monona County, IA	2013	NA	4624	4359	265	5.7
CN1913500000000	19	135	Monroe County, IA	2013	NA	4025	3796	229	5.7
CN1913700000000	19	137	Montgomery County, IA	2013	NA	5122	4872	250	4.9
CN1913900000000	19	139	Muscatine County, IA	2013	NA	21694	20562	1132	5.2
CN1914100000000	19	141	O'Brien County, IA	2013	NA	8041	7749	292	3.6
CN1914300000000	19	143	Osceola County, IA	2013	NA	3409	3278	131	3.8
CN1914500000000	19	145	Page County, IA	2013	NA	6553	6207	346	5.3
CN1914700000000	19	147	Palo Alto County, IA	2013	NA	4776	4597	179	3.7
CN1914900000000	19	149	Plymouth County, IA	2013	NA	14489	13909	580	4
CN1915100000000	19	151	Pocahontas County, IA	2013	NA	4192	4033	159	3.8
CN1915300000000	19	153	Polk County, IA	2013	NA	250374	238328	12046	4.8
CN1915500000000	19	155	Pottawattamie County, IA	2013	NA	48626	46404	2222	4.6
CN1915700000000	19	157	Poweshiek County, IA	2013	NA	10343	9864	479	4.6
CN1915900000000	19	159	Ringgold County, IA	2013	NA	2514	2406	108	4.3
CN1916100000000	19	161	Sac County, IA	2013	NA	5514	5282	232	4.2
CN1916300000000	19	163	Scott County, IA	2013	NA	88122	83199	4923	5.6
CN1916500000000	19	165	Shelby County, IA	2013	NA	6940	6679	261	3.8
CN1916700000000	19	167	Sioux County, IA	2013	NA	19566	18890	676	3.5
CN1916900000000	19	169	Story County, IA	2013	NA	54750	52926	1824	3.3
CN1917100000000	19	171	Tama County, IA	2013	NA	9106	8600	506	5.6
CN1917300000000	19	173	Taylor County, IA	2013	NA	3165	3045	120	3.8
CN1917500000000	19	175	Union County, IA	2013	NA	6896	6559	337	4.9
CN1917700000000	19	177	Van Buren County, IA	2013	NA	3833	3622	211	5.5
CN1917900000000	19	179	Wapello County, IA	2013	NA	18132	16985	1147	6.3
CN1918100000000	19	181	Warren County, IA	2013	NA	26338	25154	1184	4.5
CN1918300000000	19	183	Washington County, IA	2013	NA	12272	11810	462	3.8
CN1918500000000	19	185	Wayne County, IA	2013	NA	2850	2702	148	5.2
CN1918700000000	19	187	Webster County, IA	2013	NA	19752	18703	1049	5.3
CN1918900000000	19	189	Winnebago County, IA	2013	NA	5166	4918	248	4.8
CN1919100000000	19	191	Winneshiek County, IA	2013	NA	11890	11339	551	4.6
CN1919300000000	19	193	Woodbury County, IA	2013	NA	55210	52567	2643	4.8
CN1919500000000	19	195	Worth County, IA	2013	NA	4184	3968	216	5.2
CN1919700000000	19	197	Wright County, IA	2013	NA	6844	6537	307	4.5
CN2000100000000	20	001	Allen County, KS	2013	NA	6890	6471	419	6.1
CN2000300000000	20	003	Anderson County, KS	2013	NA	4238	3992	246	5.8
CN2000500000000	20	005	Atchison County, KS	2013	NA	7777	7110	667	8.6
CN2000700000000	20	007	Barber County, KS	2013	NA	2761	2651	110	4
CN2000900000000	20	009	Barton County, KS	2013	NA	15097	14485	612	4.1
CN2001100000000	20	011	Bourbon County, KS	2013	NA	6868	6423	445	6.5
CN2001300000000	20	013	Brown County, KS	2013	NA	5455	5182	273	5
CN2001500000000	20	015	Butler County, KS	2013	NA	31823	30062	1761	5.5
CN2001700000000	20	017	Chase County, KS	2013	NA	1250	1180	70	5.6
CN2001900000000	20	019	Chautauqua County, KS	2013	NA	1620	1520	100	6.2
CN2002100000000	20	021	Cherokee County, KS	2013	NA	10498	9828	670	6.4
CN2002300000000	20	023	Cheyenne County, KS	2013	NA	1310	1265	45	3.4
CN2002500000000	20	025	Clark County, KS	2013	NA	1188	1151	37	3.1
CN2002700000000	20	027	Clay County, KS	2013	NA	4194	3983	211	5
CN2002900000000	20	029	Cloud County, KS	2013	NA	4452	4258	194	4.4
CN2003100000000	20	031	Coffey County, KS	2013	NA	4943	4651	292	5.9
CN2003300000000	20	033	Comanche County, KS	2013	NA	1033	997	36	3.5
CN2003500000000	20	035	Cowley County, KS	2013	NA	17163	16166	997	5.8
CN2003700000000	20	037	Crawford County, KS	2013	NA	19282	18144	1138	5.9
CN2003900000000	20	039	Decatur County, KS	2013	NA	1361	1307	54	4
CN2004100000000	20	041	Dickinson County, KS	2013	NA	9859	9278	581	5.9
CN2004300000000	20	043	Doniphan County, KS	2013	NA	4337	4102	235	5.4
CN2004500000000	20	045	Douglas County, KS	2013	NA	63535	60479	3056	4.8
CN2004700000000	20	047	Edwards County, KS	2013	NA	1607	1547	60	3.7
CN2004900000000	20	049	Elk County, KS	2013	NA	1323	1248	75	5.7
CN2005100000000	20	051	Ellis County, KS	2013	NA	18044	17477	567	3.1
CN2005300000000	20	053	Ellsworth County, KS	2013	NA	3447	3332	115	3.3
CN2005500000000	20	055	Finney County, KS	2013	NA	19980	19124	856	4.3
CN2005700000000	20	057	Ford County, KS	2013	NA	18629	17883	746	4
CN2005900000000	20	059	Franklin County, KS	2013	NA	13966	13108	858	6.1
CN2006100000000	20	061	Geary County, KS	2013	NA	12663	11566	1097	8.7
CN2006300000000	20	063	Gove County, KS	2013	NA	1488	1439	49	3.3
CN2006500000000	20	065	Graham County, KS	2013	NA	1351	1295	56	4.1
CN2006700000000	20	067	Grant County, KS	2013	NA	3991	3847	144	3.6
CN2006900000000	20	069	Gray County, KS	2013	NA	3487	3383	104	3
CN2007100000000	20	071	Greeley County, KS	2013	NA	908	886	22	2.4
CN2007300000000	20	073	Greenwood County, KS	2013	NA	3358	3179	179	5.3
CN2007500000000	20	075	Hamilton County, KS	2013	NA	1715	1666	49	2.9
CN2007700000000	20	077	Harper County, KS	2013	NA	3104	2979	125	4
CN2007900000000	20	079	Harvey County, KS	2013	NA	17110	16278	832	4.9
CN2008100000000	20	081	Haskell County, KS	2013	NA	2389	2319	70	2.9
CN2008300000000	20	083	Hodgeman County, KS	2013	NA	1116	1073	43	3.9
CN2008500000000	20	085	Jackson County, KS	2013	NA	7286	6916	370	5.1
CN2008700000000	20	087	Jefferson County, KS	2013	NA	10187	9604	583	5.7
CN2008900000000	20	089	Jewell County, KS	2013	NA	1422	1370	52	3.7
CN2009100000000	20	091	Johnson County, KS	2013	NA	314173	300633	13540	4.3
CN2009300000000	20	093	Kearny County, KS	2013	NA	2099	2023	76	3.6
CN2009500000000	20	095	Kingman County, KS	2013	NA	3716	3514	202	5.4
CN2009700000000	20	097	Kiowa County, KS	2013	NA	1422	1374	48	3.4
CN2009900000000	20	099	Labette County, KS	2013	NA	10728	9959	769	7.2
CN2010100000000	20	101	Lane County, KS	2013	NA	883	852	31	3.5
CN2010300000000	20	103	Leavenworth County, KS	2013	NA	34597	32529	2068	6
CN2010500000000	20	105	Lincoln County, KS	2013	NA	1778	1696	82	4.6
CN2010700000000	20	107	Linn County, KS	2013	NA	4334	3959	375	8.7
CN2010900000000	20	109	Logan County, KS	2013	NA	1742	1694	48	2.8
CN2011100000000	20	111	Lyon County, KS	2013	NA	16426	15247	1179	7.2
CN2011300000000	20	113	McPherson County, KS	2013	NA	16579	15937	642	3.9
CN2011500000000	20	115	Marion County, KS	2013	NA	6210	5920	290	4.7
CN2011700000000	20	117	Marshall County, KS	2013	NA	6042	5809	233	3.9
CN2011900000000	20	119	Meade County, KS	2013	NA	2351	2277	74	3.1
CN2012100000000	20	121	Miami County, KS	2013	NA	16783	15847	936	5.6
CN2012300000000	20	123	Mitchell County, KS	2013	NA	3877	3764	113	2.9
CN2012500000000	20	125	Montgomery County, KS	2013	NA	17835	16631	1204	6.8
CN2012700000000	20	127	Morris County, KS	2013	NA	3100	2931	169	5.5
CN2012900000000	20	129	Morton County, KS	2013	NA	1593	1531	62	3.9
CN2013100000000	20	131	Nemaha County, KS	2013	NA	5823	5622	201	3.5
CN2013300000000	20	133	Neosho County, KS	2013	NA	6733	6160	573	8.5
CN2013500000000	20	135	Ness County, KS	2013	NA	1602	1553	49	3.1
CN2013700000000	20	137	Norton County, KS	2013	NA	3085	2999	86	2.8
CN2013900000000	20	139	Osage County, KS	2013	NA	8278	7727	551	6.7
CN2014100000000	20	141	Osborne County, KS	2013	NA	2121	2031	90	4.2
CN2014300000000	20	143	Ottawa County, KS	2013	NA	3238	3092	146	4.5
CN2014500000000	20	145	Pawnee County, KS	2013	NA	3414	3265	149	4.4
CN2014700000000	20	147	Phillips County, KS	2013	NA	2965	2839	126	4.2
CN2014900000000	20	149	Pottawatomie County, KS	2013	NA	11923	11375	548	4.6
CN2015100000000	20	151	Pratt County, KS	2013	NA	5439	5223	216	4
CN2015300000000	20	153	Rawlins County, KS	2013	NA	1549	1507	42	2.7
CN2015500000000	20	155	Reno County, KS	2013	NA	31588	29930	1658	5.2
CN2015700000000	20	157	Republic County, KS	2013	NA	2649	2560	89	3.4
CN2015900000000	20	159	Rice County, KS	2013	NA	5442	5209	233	4.3
CN2016100000000	20	161	Riley County, KS	2013	NA	36571	35030	1541	4.2
CN2016300000000	20	163	Rooks County, KS	2013	NA	2779	2663	116	4.2
CN2016500000000	20	165	Rush County, KS	2013	NA	1810	1732	78	4.3
CN2016700000000	20	167	Russell County, KS	2013	NA	3849	3697	152	3.9
CN2016900000000	20	169	Saline County, KS	2013	NA	31098	29550	1548	5
CN2017100000000	20	171	Scott County, KS	2013	NA	2838	2756	82	2.9
CN2017300000000	20	173	Sedgwick County, KS	2013	NA	246243	231111	15132	6.1
CN2017500000000	20	175	Seward County, KS	2013	NA	11082	10628	454	4.1
CN2017700000000	20	177	Shawnee County, KS	2013	NA	92035	86721	5314	5.8
CN2017900000000	20	179	Sheridan County, KS	2013	NA	1498	1457	41	2.7
CN2018100000000	20	181	Sherman County, KS	2013	NA	3128	3003	125	4
CN2018300000000	20	183	Smith County, KS	2013	NA	2157	2080	77	3.6
CN2018500000000	20	185	Stafford County, KS	2013	NA	2216	2119	97	4.4
CN2018700000000	20	187	Stanton County, KS	2013	NA	1045	1007	38	3.6
CN2018900000000	20	189	Stevens County, KS	2013	NA	3314	3215	99	3
CN2019100000000	20	191	Sumner County, KS	2013	NA	11144	10516	628	5.6
CN2019300000000	20	193	Thomas County, KS	2013	NA	4465	4309	156	3.5
CN2019500000000	20	195	Trego County, KS	2013	NA	1491	1436	55	3.7
CN2019700000000	20	197	Wabaunsee County, KS	2013	NA	3769	3579	190	5
CN2019900000000	20	199	Wallace County, KS	2013	NA	852	825	27	3.2
CN2020100000000	20	201	Washington County, KS	2013	NA	3127	3011	116	3.7
CN2020300000000	20	203	Wichita County, KS	2013	NA	1288	1243	45	3.5
CN2020500000000	20	205	Wilson County, KS	2013	NA	4110	3746	364	8.9
CN2020700000000	20	207	Woodson County, KS	2013	NA	1627	1526	101	6.2
CN2020900000000	20	209	Wyandotte County, KS	2013	NA	74775	68839	5936	7.9
CN2100100000000	21	001	Adair County, KY	2013	NA	7559	6792	767	10.1
CN2100300000000	21	003	Allen County, KY	2013	NA	8950	8284	666	7.4
CN2100500000000	21	005	Anderson County, KY	2013	NA	11531	10788	743	6.4
CN2100700000000	21	007	Ballard County, KY	2013	NA	3825	3474	351	9.2
CN2100900000000	21	009	Barren County, KY	2013	NA	19575	18070	1505	7.7
CN2101100000000	21	011	Bath County, KY	2013	NA	4828	4330	498	10.3
CN2101300000000	21	013	Bell County, KY	2013	NA	9866	8552	1314	13.3
CN2101500000000	21	015	Boone County, KY	2013	NA	66021	61650	4371	6.6
CN2101700000000	21	017	Bourbon County, KY	2013	NA	9824	9136	688	7
CN2101900000000	21	019	Boyd County, KY	2013	NA	19704	17845	1859	9.4
CN2102100000000	21	021	Boyle County, KY	2013	NA	12813	11683	1130	8.8
CN2102300000000	21	023	Bracken County, KY	2013	NA	3932	3547	385	9.8
CN2102500000000	21	025	Breathitt County, KY	2013	NA	4484	3816	668	14.9
CN2102700000000	21	027	Breckinridge County, KY	2013	NA	8243	7487	756	9.2
CN2102900000000	21	029	Bullitt County, KY	2013	NA	39671	36740	2931	7.4
CN2103100000000	21	031	Butler County, KY	2013	NA	5375	4883	492	9.2
CN2103300000000	21	033	Caldwell County, KY	2013	NA	5632	5171	461	8.2
CN2103500000000	21	035	Calloway County, KY	2013	NA	18141	16825	1316	7.3
CN2103700000000	21	037	Campbell County, KY	2013	NA	48752	45550	3202	6.6
CN2103900000000	21	039	Carlisle County, KY	2013	NA	2375	2205	170	7.2
CN2104100000000	21	041	Carroll County, KY	2013	NA	5167	4695	472	9.1
CN2104300000000	21	043	Carter County, KY	2013	NA	11034	9637	1397	12.7
CN2104500000000	21	045	Casey County, KY	2013	NA	6813	6225	588	8.6
CN2104700000000	21	047	Christian County, KY	2013	NA	26605	24098	2507	9.4
CN2104900000000	21	049	Clark County, KY	2013	NA	17266	15968	1298	7.5
CN2105100000000	21	051	Clay County, KY	2013	NA	5752	4930	822	14.3
CN2105300000000	21	053	Clinton County, KY	2013	NA	4113	3683	430	10.5
CN2105500000000	21	055	Crittenden County, KY	2013	NA	4099	3795	304	7.4
CN2105700000000	21	057	Cumberland County, KY	2013	NA	3038	2714	324	10.7
CN2105900000000	21	059	Daviess County, KY	2013	NA	47636	44363	3273	6.9
CN2106100000000	21	061	Edmonson County, KY	2013	NA	4996	4496	500	10
CN2106300000000	21	063	Elliott County, KY	2013	NA	2255	1928	327	14.5
CN2106500000000	21	065	Estill County, KY	2013	NA	5536	4997	539	9.7
CN2106700000000	21	067	Fayette County, KY	2013	NA	168417	158648	9769	5.8
CN2106900000000	21	069	Fleming County, KY	2013	NA	6521	5903	618	9.5
CN2107100000000	21	071	Floyd County, KY	2013	NA	13134	11392	1742	13.3
CN2107300000000	21	073	Franklin County, KY	2013	NA	24573	22958	1615	6.6
CN2107500000000	21	075	Fulton County, KY	2013	NA	2387	2130	257	10.8
CN2107700000000	21	077	Gallatin County, KY	2013	NA	3953	3584	369	9.3
CN2107900000000	21	079	Garrard County, KY	2013	NA	7745	7111	634	8.2
CN2108100000000	21	081	Grant County, KY	2013	NA	11504	10549	955	8.3
CN2108300000000	21	083	Graves County, KY	2013	NA	16479	15085	1394	8.5
CN2108500000000	21	085	Grayson County, KY	2013	NA	11242	10085	1157	10.3
CN2108700000000	21	087	Green County, KY	2013	NA	5320	4880	440	8.3
CN2108900000000	21	089	Greenup County, KY	2013	NA	14793	13283	1510	10.2
CN2109100000000	21	091	Hancock County, KY	2013	NA	4099	3803	296	7.2
CN2109300000000	21	093	Hardin County, KY	2013	NA	47819	44154	3665	7.7
CN2109500000000	21	095	Harlan County, KY	2013	NA	9510	7793	1717	18.1
CN2109700000000	21	097	Harrison County, KY	2013	NA	8745	8084	661	7.6
CN2109900000000	21	099	Hart County, KY	2013	NA	8057	7420	637	7.9
CN2110100000000	21	101	Henderson County, KY	2013	NA	22130	20474	1656	7.5
CN2110300000000	21	103	Henry County, KY	2013	NA	7761	7201	560	7.2
CN2110500000000	21	105	Hickman County, KY	2013	NA	2160	2006	154	7.1
CN2110700000000	21	107	Hopkins County, KY	2013	NA	21504	19807	1697	7.9
CN2110900000000	21	109	Jackson County, KY	2013	NA	4834	4274	560	11.6
CN2111100000000	21	111	Jefferson County, KY	2013	NA	385274	356481	28793	7.5
CN2111300000000	21	113	Jessamine County, KY	2013	NA	25084	23455	1629	6.5
CN2111500000000	21	115	Johnson County, KY	2013	NA	8363	7441	922	11
CN2111700000000	21	117	Kenton County, KY	2013	NA	85069	79105	5964	7
CN2111900000000	21	119	Knott County, KY	2013	NA	5589	4728	861	15.4
CN2112100000000	21	121	Knox County, KY	2013	NA	10526	9161	1365	13
CN2112300000000	21	123	Larue County, KY	2013	NA	5889	5407	482	8.2
CN2112500000000	21	125	Laurel County, KY	2013	NA	24642	22244	2398	9.7
CN2112700000000	21	127	Lawrence County, KY	2013	NA	5578	4952	626	11.2
CN2112900000000	21	129	Lee County, KY	2013	NA	2371	2075	296	12.5
CN2113100000000	21	131	Leslie County, KY	2013	NA	3495	2880	615	17.6
CN2113300000000	21	133	Letcher County, KY	2013	NA	8047	6703	1344	16.7
CN2113500000000	21	135	Lewis County, KY	2013	NA	5293	4650	643	12.1
CN2113700000000	21	137	Lincoln County, KY	2013	NA	9918	8861	1057	10.7
CN2113900000000	21	139	Livingston County, KY	2013	NA	3887	3503	384	9.9
CN2114100000000	21	141	Logan County, KY	2013	NA	12134	11271	863	7.1
CN2114300000000	21	143	Lyon County, KY	2013	NA	3092	2838	254	8.2
CN2114500000000	21	145	McCracken County, KY	2013	NA	30282	27892	2390	7.9
CN2114700000000	21	147	McCreary County, KY	2013	NA	5342	4643	699	13.1
CN2114900000000	21	149	McLean County, KY	2013	NA	4479	4136	343	7.7
CN2115100000000	21	151	Madison County, KY	2013	NA	45747	42740	3007	6.6
CN2115300000000	21	153	Magoffin County, KY	2013	NA	4002	3299	703	17.6
CN2115500000000	21	155	Marion County, KY	2013	NA	9297	8539	758	8.2
CN2115700000000	21	157	Marshall County, KY	2013	NA	15323	14079	1244	8.1
CN2115900000000	21	159	Martin County, KY	2013	NA	3641	3286	355	9.8
CN2116100000000	21	161	Mason County, KY	2013	NA	7792	7013	779	10
CN2116300000000	21	163	Meade County, KY	2013	NA	12534	11409	1125	9
CN2116500000000	21	165	Menifee County, KY	2013	NA	2489	2189	300	12.1
CN2116700000000	21	167	Mercer County, KY	2013	NA	10190	9390	800	7.9
CN2116900000000	21	169	Metcalfe County, KY	2013	NA	4333	3995	338	7.8
CN2117100000000	21	171	Monroe County, KY	2013	NA	4743	4404	339	7.1
CN2117300000000	21	173	Montgomery County, KY	2013	NA	12138	11110	1028	8.5
CN2117500000000	21	175	Morgan County, KY	2013	NA	5057	4520	537	10.6
CN2117700000000	21	177	Muhlenberg County, KY	2013	NA	12963	11748	1215	9.4
CN2117900000000	21	179	Nelson County, KY	2013	NA	21683	20046	1637	7.5
CN2118100000000	21	181	Nicholas County, KY	2013	NA	3530	3225	305	8.6
CN2118300000000	21	183	Ohio County, KY	2013	NA	9901	8982	919	9.3
CN2118500000000	21	185	Oldham County, KY	2013	NA	30308	28582	1726	5.7
CN2118700000000	21	187	Owen County, KY	2013	NA	5682	5322	360	6.3
CN2118900000000	21	189	Owsley County, KY	2013	NA	1291	1128	163	12.6
CN2119100000000	21	191	Pendleton County, KY	2013	NA	7016	6428	588	8.4
CN2119300000000	21	193	Perry County, KY	2013	NA	10407	8957	1450	13.9
CN2119500000000	21	195	Pike County, KY	2013	NA	23294	20527	2767	11.9
CN2119700000000	21	197	Powell County, KY	2013	NA	5057	4513	544	10.8
CN2119900000000	21	199	Pulaski County, KY	2013	NA	27242	24742	2500	9.2
CN2120100000000	21	201	Robertson County, KY	2013	NA	849	756	93	11
CN2120300000000	21	203	Rockcastle County, KY	2013	NA	7084	6428	656	9.3
CN2120500000000	21	205	Rowan County, KY	2013	NA	10929	10021	908	8.3
CN2120700000000	21	207	Russell County, KY	2013	NA	7029	6216	813	11.6
CN2120900000000	21	209	Scott County, KY	2013	NA	26264	24667	1597	6.1
CN2121100000000	21	211	Shelby County, KY	2013	NA	22623	21250	1373	6.1
CN2121300000000	21	213	Simpson County, KY	2013	NA	8854	8189	665	7.5
CN2121500000000	21	215	Spencer County, KY	2013	NA	9341	8740	601	6.4
CN2121700000000	21	217	Taylor County, KY	2013	NA	11389	10313	1076	9.4
CN2121900000000	21	219	Todd County, KY	2013	NA	5632	5214	418	7.4
CN2122100000000	21	221	Trigg County, KY	2013	NA	6046	5500	546	9
CN2122300000000	21	223	Trimble County, KY	2013	NA	3967	3637	330	8.3
CN2122500000000	21	225	Union County, KY	2013	NA	6856	6328	528	7.7
CN2122700000000	21	227	Warren County, KY	2013	NA	60475	56322	4153	6.9
CN2122900000000	21	229	Washington County, KY	2013	NA	6139	5716	423	6.9
CN2123100000000	21	231	Wayne County, KY	2013	NA	7461	6572	889	11.9
CN2123300000000	21	233	Webster County, KY	2013	NA	6182	5742	440	7.1
CN2123500000000	21	235	Whitley County, KY	2013	NA	13850	12382	1468	10.6
CN2123700000000	21	237	Wolfe County, KY	2013	NA	2110	1811	299	14.2
CN2123900000000	21	239	Woodford County, KY	2013	NA	14249	13494	755	5.3
CN2200100000000	22	001	Acadia Parish, LA	2013	NA	26330	24760	1570	6
CN2200300000000	22	003	Allen Parish, LA	2013	NA	8745	8086	659	7.5
CN2200500000000	22	005	Ascension Parish, LA	2013	NA	56781	53609	3172	5.6
CN2200700000000	22	007	Assumption Parish, LA	2013	NA	9912	9090	822	8.3
CN2200900000000	22	009	Avoyelles Parish, LA	2013	NA	16000	14807	1193	7.5
CN2201100000000	22	011	Beauregard Parish, LA	2013	NA	14445	13381	1064	7.4
CN2201300000000	22	013	Bienville Parish, LA	2013	NA	5947	5431	516	8.7
CN2201500000000	22	015	Bossier Parish, LA	2013	NA	56863	53437	3426	6
CN2201700000000	22	017	Caddo Parish, LA	2013	NA	110922	102176	8746	7.9
CN2201900000000	22	019	Calcasieu Parish, LA	2013	NA	89356	83592	5764	6.5
CN2202100000000	22	021	Caldwell Parish, LA	2013	NA	3958	3635	323	8.2
CN2202300000000	22	023	Cameron Parish, LA	2013	NA	3313	3136	177	5.3
CN2202500000000	22	025	Catahoula Parish, LA	2013	NA	3900	3570	330	8.5
CN2202700000000	22	027	Claiborne Parish, LA	2013	NA	6525	6037	488	7.5
CN2202900000000	22	029	Concordia Parish, LA	2013	NA	7806	7143	663	8.5
CN2203100000000	22	031	De Soto Parish, LA	2013	NA	11013	10039	974	8.8
CN2203300000000	22	033	East Baton Rouge Parish, LA	2013	NA	225959	211944	14015	6.2
CN2203500000000	22	035	East Carroll Parish, LA	2013	NA	2272	1888	384	16.9
CN2203700000000	22	037	East Feliciana Parish, LA	2013	NA	7954	7407	547	6.9
CN2203900000000	22	039	Evangeline Parish, LA	2013	NA	12863	11991	872	6.8
CN2204100000000	22	041	Franklin Parish, LA	2013	NA	7702	6927	775	10.1
CN2204300000000	22	043	Grant Parish, LA	2013	NA	8147	7550	597	7.3
CN2204500000000	22	045	Iberia Parish, LA	2013	NA	32283	30200	2083	6.5
CN2204700000000	22	047	Iberville Parish, LA	2013	NA	14039	12869	1170	8.3
CN2204900000000	22	049	Jackson Parish, LA	2013	NA	7025	6568	457	6.5
CN2205100000000	22	051	Jefferson Parish, LA	2013	NA	213643	200234	13409	6.3
CN2205300000000	22	053	Jefferson Davis Parish, LA	2013	NA	13163	12346	817	6.2
CN2205500000000	22	055	Lafayette Parish, LA	2013	NA	118870	113007	5863	4.9
CN2205700000000	22	057	Lafourche Parish, LA	2013	NA	46823	44522	2301	4.9
CN2205900000000	22	059	LaSalle Parish, LA	2013	NA	6973	6626	347	5
CN2206100000000	22	061	Lincoln Parish, LA	2013	NA	20549	18936	1613	7.8
CN2206300000000	22	063	Livingston Parish, LA	2013	NA	64070	60324	3746	5.8
CN2206500000000	22	065	Madison Parish, LA	2013	NA	3959	3522	437	11
CN2206700000000	22	067	Morehouse Parish, LA	2013	NA	11117	9739	1378	12.4
CN2206900000000	22	069	Natchitoches Parish, LA	2013	NA	16827	15425	1402	8.3
CN2207100000000	22	071	Orleans Parish, LA	2013	NA	173465	160741	12724	7.3
CN2207300000000	22	073	Ouachita Parish, LA	2013	NA	70977	65856	5121	7.2
CN2207500000000	22	075	Plaquemines Parish, LA	2013	NA	10057	9486	571	5.7
CN2207700000000	22	077	Pointe Coupee Parish, LA	2013	NA	9910	9158	752	7.6
CN2207900000000	22	079	Rapides Parish, LA	2013	NA	57207	53286	3921	6.9
CN2208100000000	22	081	Red River Parish, LA	2013	NA	3858	3567	291	7.5
CN2208300000000	22	083	Richland Parish, LA	2013	NA	8663	7828	835	9.6
CN2208500000000	22	085	Sabine Parish, LA	2013	NA	9190	8569	621	6.8
CN2208700000000	22	087	St. Bernard Parish, LA	2013	NA	18518	17148	1370	7.4
CN2208900000000	22	089	St. Charles Parish, LA	2013	NA	24931	23368	1563	6.3
CN2209100000000	22	091	St. Helena Parish, LA	2013	NA	4574	4056	518	11.3
CN2209300000000	22	093	St. James Parish, LA	2013	NA	9680	8781	899	9.3
CN2209500000000	22	095	St. John the Baptist Parish, LA	2013	NA	20104	18361	1743	8.7
CN2209700000000	22	097	St. Landry Parish, LA	2013	NA	33711	31077	2634	7.8
CN2209900000000	22	099	St. Martin Parish, LA	2013	NA	24303	22872	1431	5.9
CN2210100000000	22	101	St. Mary Parish, LA	2013	NA	24985	23343	1642	6.6
CN2210300000000	22	103	St. Tammany Parish, LA	2013	NA	111065	104680	6385	5.7
CN2210500000000	22	105	Tangipahoa Parish, LA	2013	NA	52934	48682	4252	8
CN2210700000000	22	107	Tensas Parish, LA	2013	NA	1767	1601	166	9.4
CN2210900000000	22	109	Terrebonne Parish, LA	2013	NA	53032	50362	2670	5
CN2211100000000	22	111	Union Parish, LA	2013	NA	9166	8451	715	7.8
CN2211300000000	22	113	Vermilion Parish, LA	2013	NA	26113	24652	1461	5.6
CN2211500000000	22	115	Vernon Parish, LA	2013	NA	17876	16299	1577	8.8
CN2211700000000	22	117	Washington Parish, LA	2013	NA	16423	15050	1373	8.4
CN2211900000000	22	119	Webster Parish, LA	2013	NA	15713	14210	1503	9.6
CN2212100000000	22	121	West Baton Rouge Parish, LA	2013	NA	12294	11540	754	6.1
CN2212300000000	22	123	West Carroll Parish, LA	2013	NA	4247	3707	540	12.7
CN2212500000000	22	125	West Feliciana Parish, LA	2013	NA	5228	4919	309	5.9
CN2212700000000	22	127	Winn Parish, LA	2013	NA	5377	4938	439	8.2
CN2300100000000	23	001	Androscoggin County, ME	2013	NA	56466	52696	3770	6.7
CN2300300000000	23	003	Aroostook County, ME	2013	NA	33869	30955	2914	8.6
CN2300500000000	23	005	Cumberland County, ME	2013	NA	160923	152393	8530	5.3
CN2300700000000	23	007	Franklin County, ME	2013	NA	15395	14209	1186	7.7
CN2300900000000	23	009	Hancock County, ME	2013	NA	30101	27728	2373	7.9
CN2301100000000	23	011	Kennebec County, ME	2013	NA	63868	59883	3985	6.2
CN2301300000000	23	013	Knox County, ME	2013	NA	20785	19551	1234	5.9
CN2301500000000	23	015	Lincoln County, ME	2013	NA	17367	16186	1181	6.8
CN2301700000000	23	017	Oxford County, ME	2013	NA	27768	25469	2299	8.3
CN2301900000000	23	019	Penobscot County, ME	2013	NA	80082	74603	5479	6.8
CN2302100000000	23	021	Piscataquis County, ME	2013	NA	7894	7197	697	8.8
CN2302300000000	23	023	Sagadahoc County, ME	2013	NA	19124	18049	1075	5.6
CN2302500000000	23	025	Somerset County, ME	2013	NA	24811	22538	2273	9.2
CN2302700000000	23	027	Waldo County, ME	2013	NA	21009	19502	1507	7.2
CN2302900000000	23	029	Washington County, ME	2013	NA	14636	13281	1355	9.3
CN2303100000000	23	031	York County, ME	2013	NA	111315	104279	7036	6.3
CN2400100000000	24	001	Allegany County, MD	2013	NA	33625	30773	2852	8.5
CN2400300000000	24	003	Anne Arundel County, MD	2013	NA	296544	279676	16868	5.7
CN2400500000000	24	005	Baltimore County, MD	2013	NA	442221	411840	30381	6.9
CN2400900000000	24	009	Calvert County, MD	2013	NA	47760	44935	2825	5.9
CN2401100000000	24	011	Caroline County, MD	2013	NA	17683	16458	1225	6.9
CN2401300000000	24	013	Carroll County, MD	2013	NA	93058	87954	5104	5.5
CN2401500000000	24	015	Cecil County, MD	2013	NA	52246	48225	4021	7.7
CN2401700000000	24	017	Charles County, MD	2013	NA	80256	75074	5182	6.5
CN2401900000000	24	019	Dorchester County, MD	2013	NA	15956	14400	1556	9.8
CN2402100000000	24	021	Frederick County, MD	2013	NA	128454	121083	7371	5.7
CN2402300000000	24	023	Garrett County, MD	2013	NA	15748	14480	1268	8.1
CN2402500000000	24	025	Harford County, MD	2013	NA	135689	126865	8824	6.5
CN2402700000000	24	027	Howard County, MD	2013	NA	171321	163072	8249	4.8
CN2402900000000	24	029	Kent County, MD	2013	NA	10347	9605	742	7.2
CN2403100000000	24	031	Montgomery County, MD	2013	NA	543131	516271	26860	4.9
CN2403300000000	24	033	Prince George's County, MD	2013	NA	486017	452445	33572	6.9
CN2403500000000	24	035	Queen Anne's County, MD	2013	NA	26466	24922	1544	5.8
CN2403700000000	24	037	St. Mary's County, MD	2013	NA	54261	51029	3232	6
CN2403900000000	24	039	Somerset County, MD	2013	NA	9577	8554	1023	10.7
CN2404100000000	24	041	Talbot County, MD	2013	NA	19162	17934	1228	6.4
CN2404300000000	24	043	Washington County, MD	2013	NA	77220	71574	5646	7.3
CN2404500000000	24	045	Wicomico County, MD	2013	NA	50137	45782	4355	8.7
CN2404700000000	24	047	Worcester County, MD	2013	NA	25909	22654	3255	12.6
CN2451000000000	24	510	Baltimore city, MD	2013	NA	296567	267895	28672	9.7
CN2500100000000	25	001	Barnstable County, MA	2013	NA	108445	99327	9118	8.4
CN2500300000000	25	003	Berkshire County, MA	2013	NA	65536	60667	4869	7.4
CN2500500000000	25	005	Bristol County, MA	2013	NA	286534	261595	24939	8.7
CN2500700000000	25	007	Dukes County, MA	2013	NA	9402	8545	857	9.1
CN2500900000000	25	009	Essex County, MA	2013	NA	399294	371152	28142	7
CN2501100000000	25	011	Franklin County, MA	2013	NA	39300	36877	2423	6.2
CN2501300000000	25	013	Hampden County, MA	2013	NA	220156	201055	19101	8.7
CN2501500000000	25	015	Hampshire County, MA	2013	NA	85408	80230	5178	6.1
CN2501700000000	25	017	Middlesex County, MA	2013	NA	839619	793605	46014	5.5
CN2501900000000	25	019	Nantucket County/town, MA	2013	NA	6591	6110	481	7.3
CN2502100000000	25	021	Norfolk County, MA	2013	NA	362466	341393	21073	5.8
CN2502300000000	25	023	Plymouth County, MA	2013	NA	262732	244367	18365	7
CN2502500000000	25	025	Suffolk County, MA	2013	NA	406846	381623	25223	6.2
CN2502700000000	25	027	Worcester County, MA	2013	NA	420502	390249	30253	7.2
CN2600100000000	26	001	Alcona County, MI	2013	NA	3794	3288	506	13.3
CN2600300000000	26	003	Alger County, MI	2013	NA	3373	2978	395	11.7
CN2600500000000	26	005	Allegan County, MI	2013	NA	57933	54066	3867	6.7
CN2600700000000	26	007	Alpena County, MI	2013	NA	13367	12075	1292	9.7
CN2600900000000	26	009	Antrim County, MI	2013	NA	9975	8835	1140	11.4
CN2601100000000	26	011	Arenac County, MI	2013	NA	6485	5642	843	13
CN2601300000000	26	013	Baraga County, MI	2013	NA	3540	3028	512	14.5
CN2601500000000	26	015	Barry County, MI	2013	NA	29242	27375	1867	6.4
CN2601700000000	26	017	Bay County, MI	2013	NA	53013	48386	4627	8.7
CN2601900000000	26	019	Benzie County, MI	2013	NA	8592	7707	885	10.3
CN2602100000000	26	021	Berrien County, MI	2013	NA	72420	66133	6287	8.7
CN2602300000000	26	023	Branch County, MI	2013	NA	19007	17404	1603	8.4
CN2602500000000	26	025	Calhoun County, MI	2013	NA	62761	57804	4957	7.9
CN2602700000000	26	027	Cass County, MI	2013	NA	23514	21583	1931	8.2
CN2602900000000	26	029	Charlevoix County, MI	2013	NA	12991	11599	1392	10.7
CN2603100000000	26	031	Cheboygan County, MI	2013	NA	10497	9286	1211	11.5
CN2603300000000	26	033	Chippewa County, MI	2013	NA	16987	15211	1776	10.5
CN2603500000000	26	035	Clare County, MI	2013	NA	11870	10479	1391	11.7
CN2603700000000	26	037	Clinton County, MI	2013	NA	39008	36649	2359	6
CN2603900000000	26	039	Crawford County, MI	2013	NA	5375	4760	615	11.4
CN2604100000000	26	041	Delta County, MI	2013	NA	17484	15690	1794	10.3
CN2604300000000	26	043	Dickinson County, MI	2013	NA	12611	11565	1046	8.3
CN2604500000000	26	045	Eaton County, MI	2013	NA	55291	51602	3689	6.7
CN2604700000000	26	047	Emmet County, MI	2013	NA	18113	15969	2144	11.8
CN2604900000000	26	049	Genesee County, MI	2013	NA	183792	165917	17875	9.7
CN2605100000000	26	051	Gladwin County, MI	2013	NA	10011	8842	1169	11.7
CN2605300000000	26	053	Gogebic County, MI	2013	NA	6708	5981	727	10.8
CN2605500000000	26	055	Grand Traverse County, MI	2013	NA	47035	43446	3589	7.6
CN2605700000000	26	057	Gratiot County, MI	2013	NA	18419	16780	1639	8.9
CN2605900000000	26	059	Hillsdale County, MI	2013	NA	20505	18680	1825	8.9
CN2606100000000	26	061	Houghton County, MI	2013	NA	16824	15333	1491	8.9
CN2606300000000	26	063	Huron County, MI	2013	NA	16323	14958	1365	8.4
CN2606500000000	26	065	Ingham County, MI	2013	NA	144121	133094	11027	7.7
CN2606700000000	26	067	Ionia County, MI	2013	NA	28765	26474	2291	8
CN2606900000000	26	069	Iosco County, MI	2013	NA	10188	9023	1165	11.4
CN2607100000000	26	071	Iron County, MI	2013	NA	5068	4553	515	10.2
CN2607300000000	26	073	Isabella County, MI	2013	NA	34863	32344	2519	7.2
CN2607500000000	26	075	Jackson County, MI	2013	NA	72095	66139	5956	8.3
CN2607700000000	26	077	Kalamazoo County, MI	2013	NA	124901	116335	8566	6.9
CN2607900000000	26	079	Kalkaska County, MI	2013	NA	7557	6713	844	11.2
CN2608100000000	26	081	Kent County, MI	2013	NA	326607	306212	20395	6.2
CN2608300000000	26	083	Keweenaw County, MI	2013	NA	986	852	134	13.6
CN2608500000000	26	085	Lake County, MI	2013	NA	3619	3139	480	13.3
CN2608700000000	26	087	Lapeer County, MI	2013	NA	40283	35679	4604	11.4
CN2608900000000	26	089	Leelanau County, MI	2013	NA	10259	9472	787	7.7
CN2609100000000	26	091	Lenawee County, MI	2013	NA	47581	43858	3723	7.8
CN2609300000000	26	093	Livingston County, MI	2013	NA	94808	87770	7038	7.4
CN2609500000000	26	095	Luce County, MI	2013	NA	2397	2149	248	10.3
CN2609700000000	26	097	Mackinac County, MI	2013	NA	5238	4597	641	12.2
CN2609900000000	26	099	Macomb County, MI	2013	NA	420290	380495	39795	9.5
CN2610100000000	26	101	Manistee County, MI	2013	NA	10484	9371	1113	10.6
CN2610300000000	26	103	Marquette County, MI	2013	NA	33926	31153	2773	8.2
CN2610500000000	26	105	Mason County, MI	2013	NA	14467	13139	1328	9.2
CN2610700000000	26	107	Mecosta County, MI	2013	NA	18704	16831	1873	10
CN2610900000000	26	109	Menominee County, MI	2013	NA	11748	10834	914	7.8
CN2611100000000	26	111	Midland County, MI	2013	NA	40777	37630	3147	7.7
CN2611300000000	26	113	Missaukee County, MI	2013	NA	6937	6296	641	9.2
CN2611500000000	26	115	Monroe County, MI	2013	NA	74365	68874	5491	7.4
CN2611700000000	26	117	Montcalm County, MI	2013	NA	27452	24819	2633	9.6
CN2611900000000	26	119	Montmorency County, MI	2013	NA	3198	2685	513	16
CN2612100000000	26	121	Muskegon County, MI	2013	NA	76165	68623	7542	9.9
CN2612300000000	26	123	Newaygo County, MI	2013	NA	22019	20067	1952	8.9
CN2612500000000	26	125	Oakland County, MI	2013	NA	628635	579614	49021	7.8
CN2612700000000	26	127	Oceana County, MI	2013	NA	12719	11145	1574	12.4
CN2612900000000	26	129	Ogemaw County, MI	2013	NA	8599	7586	1013	11.8
CN2613100000000	26	131	Ontonagon County, MI	2013	NA	2445	2107	338	13.8
CN2613300000000	26	133	Osceola County, MI	2013	NA	10015	9017	998	10
CN2613500000000	26	135	Oscoda County, MI	2013	NA	2959	2498	461	15.6
CN2613700000000	26	137	Otsego County, MI	2013	NA	11213	10045	1168	10.4
CN2613900000000	26	139	Ottawa County, MI	2013	NA	144633	135820	8813	6.1
CN2614100000000	26	141	Presque Isle County, MI	2013	NA	5459	4656	803	14.7
CN2614300000000	26	143	Roscommon County, MI	2013	NA	8077	6957	1120	13.9
CN2614500000000	26	145	Saginaw County, MI	2013	NA	88844	80811	8033	9
CN2614700000000	26	147	St. Clair County, MI	2013	NA	74581	65988	8593	11.5
CN2614900000000	26	149	St. Joseph County, MI	2013	NA	28150	25963	2187	7.8
CN2615100000000	26	151	Sanilac County, MI	2013	NA	19369	17336	2033	10.5
CN2615300000000	26	153	Schoolcraft County, MI	2013	NA	3558	3102	456	12.8
CN2615500000000	26	155	Shiawassee County, MI	2013	NA	33046	29948	3098	9.4
CN2615700000000	26	157	Tuscola County, MI	2013	NA	25033	22398	2635	10.5
CN2615900000000	26	159	Van Buren County, MI	2013	NA	34980	31454	3526	10.1
CN2616100000000	26	161	Washtenaw County, MI	2013	NA	183727	173018	10709	5.8
CN2616300000000	26	163	Wayne County, MI	2013	NA	776560	687300	89260	11.5
CN2616500000000	26	165	Wexford County, MI	2013	NA	14622	13000	1622	11.1
CN2700100000000	27	001	Aitkin County, MN	2013	NA	6802	6295	507	7.5
CN2700300000000	27	003	Anoka County, MN	2013	NA	188370	178904	9466	5
CN2700500000000	27	005	Becker County, MN	2013	NA	17969	16985	984	5.5
CN2700700000000	27	007	Beltrami County, MN	2013	NA	23024	21588	1436	6.2
CN2700900000000	27	009	Benton County, MN	2013	NA	21437	20167	1270	5.9
CN2701100000000	27	011	Big Stone County, MN	2013	NA	2557	2419	138	5.4
CN2701300000000	27	013	Blue Earth County, MN	2013	NA	38620	37017	1603	4.2
CN2701500000000	27	015	Brown County, MN	2013	NA	14524	13769	755	5.2
CN2701700000000	27	017	Carlton County, MN	2013	NA	17509	16462	1047	6
CN2701900000000	27	019	Carver County, MN	2013	NA	53318	51020	2298	4.3
CN2702100000000	27	021	Cass County, MN	2013	NA	13991	12842	1149	8.2
CN2702300000000	27	023	Chippewa County, MN	2013	NA	6945	6588	357	5.1
CN2702500000000	27	025	Chisago County, MN	2013	NA	28523	26932	1591	5.6
CN2702700000000	27	027	Clay County, MN	2013	NA	34830	33337	1493	4.3
CN2702900000000	27	029	Clearwater County, MN	2013	NA	4474	3998	476	10.6
CN2703100000000	27	031	Cook County, MN	2013	NA	3055	2878	177	5.8
CN2703300000000	27	033	Cottonwood County, MN	2013	NA	5756	5422	334	5.8
CN2703500000000	27	035	Crow Wing County, MN	2013	NA	31432	29255	2177	6.9
CN2703700000000	27	037	Dakota County, MN	2013	NA	229724	219309	10415	4.5
CN2703900000000	27	039	Dodge County, MN	2013	NA	11330	10794	536	4.7
CN2704100000000	27	041	Douglas County, MN	2013	NA	19873	18991	882	4.4
CN2704300000000	27	043	Faribault County, MN	2013	NA	7494	7090	404	5.4
CN2704500000000	27	045	Fillmore County, MN	2013	NA	11107	10549	558	5
CN2704700000000	27	047	Freeborn County, MN	2013	NA	16459	15640	819	5
CN2704900000000	27	049	Goodhue County, MN	2013	NA	26821	25565	1256	4.7
CN2705100000000	27	051	Grant County, MN	2013	NA	3282	3094	188	5.7
CN2705300000000	27	053	Hennepin County, MN	2013	NA	666831	636298	30533	4.6
CN2705500000000	27	055	Houston County, MN	2013	NA	10478	9953	525	5
CN2705700000000	27	057	Hubbard County, MN	2013	NA	9534	8846	688	7.2
CN2705900000000	27	059	Isanti County, MN	2013	NA	20202	18989	1213	6
CN2706100000000	27	061	Itasca County, MN	2013	NA	21916	20238	1678	7.7
CN2706300000000	27	063	Jackson County, MN	2013	NA	6229	5971	258	4.1
CN2706500000000	27	065	Kanabec County, MN	2013	NA	8793	8077	716	8.1
CN2706700000000	27	067	Kandiyohi County, MN	2013	NA	23472	22357	1115	4.8
CN2706900000000	27	069	Kittson County, MN	2013	NA	2419	2274	145	6
CN2707100000000	27	071	Koochiching County, MN	2013	NA	6725	6168	557	8.3
CN2707300000000	27	073	Lac qui Parle County, MN	2013	NA	3667	3462	205	5.6
CN2707500000000	27	075	Lake County, MN	2013	NA	5775	5417	358	6.2
CN2707700000000	27	077	Lake of the Woods County, MN	2013	NA	2374	2240	134	5.6
CN2707900000000	27	079	Le Sueur County, MN	2013	NA	15497	14553	944	6.1
CN2708100000000	27	081	Lincoln County, MN	2013	NA	3311	3158	153	4.6
CN2708300000000	27	083	Lyon County, MN	2013	NA	15280	14649	631	4.1
CN2708500000000	27	085	McLeod County, MN	2013	NA	20019	18899	1120	5.6
CN2708700000000	27	087	Mahnomen County, MN	2013	NA	2397	2259	138	5.8
CN2708900000000	27	089	Marshall County, MN	2013	NA	5567	5142	425	7.6
CN2709100000000	27	091	Martin County, MN	2013	NA	10335	9791	544	5.3
CN2709300000000	27	093	Meeker County, MN	2013	NA	12741	12036	705	5.5
CN2709500000000	27	095	Mille Lacs County, MN	2013	NA	12678	11727	951	7.5
CN2709700000000	27	097	Morrison County, MN	2013	NA	17677	16486	1191	6.7
CN2709900000000	27	099	Mower County, MN	2013	NA	20474	19557	917	4.5
CN2710100000000	27	101	Murray County, MN	2013	NA	4837	4579	258	5.3
CN2710300000000	27	103	Nicollet County, MN	2013	NA	19715	18978	737	3.7
CN2710500000000	27	105	Nobles County, MN	2013	NA	11061	10615	446	4
CN2710700000000	27	107	Norman County, MN	2013	NA	3312	3122	190	5.7
CN2710900000000	27	109	Olmsted County, MN	2013	NA	83374	80035	3339	4
CN2711100000000	27	111	Otter Tail County, MN	2013	NA	30867	29246	1621	5.3
CN2711300000000	27	113	Pennington County, MN	2013	NA	8656	8109	547	6.3
CN2711500000000	27	115	Pine County, MN	2013	NA	14831	13805	1026	6.9
CN2711700000000	27	117	Pipestone County, MN	2013	NA	4689	4473	216	4.6
CN2711900000000	27	119	Polk County, MN	2013	NA	17100	16180	920	5.4
CN2712100000000	27	121	Pope County, MN	2013	NA	5964	5710	254	4.3
CN2712300000000	27	123	Ramsey County, MN	2013	NA	275220	261715	13505	4.9
CN2712500000000	27	125	Red Lake County, MN	2013	NA	2255	2103	152	6.7
CN2712700000000	27	127	Redwood County, MN	2013	NA	8051	7610	441	5.5
CN2712900000000	27	129	Renville County, MN	2013	NA	8238	7702	536	6.5
CN2713100000000	27	131	Rice County, MN	2013	NA	34992	33260	1732	4.9
CN2713300000000	27	133	Rock County, MN	2013	NA	5626	5446	180	3.2
CN2713500000000	27	135	Roseau County, MN	2013	NA	8614	8235	379	4.4
CN2713700000000	27	137	St. Louis County, MN	2013	NA	102216	96029	6187	6.1
CN2713900000000	27	139	Scott County, MN	2013	NA	76971	73598	3373	4.4
CN2714100000000	27	141	Sherburne County, MN	2013	NA	48786	46184	2602	5.3
CN2714300000000	27	143	Sibley County, MN	2013	NA	8320	7863	457	5.5
CN2714500000000	27	145	Stearns County, MN	2013	NA	86690	82446	4244	4.9
CN2714700000000	27	147	Steele County, MN	2013	NA	21395	20419	976	4.6
CN2714900000000	27	149	Stevens County, MN	2013	NA	5510	5303	207	3.8
CN2715100000000	27	151	Swift County, MN	2013	NA	4894	4609	285	5.8
CN2715300000000	27	153	Todd County, MN	2013	NA	12851	12166	685	5.3
CN2715500000000	27	155	Traverse County, MN	2013	NA	1660	1576	84	5.1
CN2715700000000	27	157	Wabasha County, MN	2013	NA	11829	11284	545	4.6
CN2715900000000	27	159	Wadena County, MN	2013	NA	6166	5735	431	7
CN2716100000000	27	161	Waseca County, MN	2013	NA	9926	9380	546	5.5
CN2716300000000	27	163	Washington County, MN	2013	NA	134883	128912	5971	4.4
CN2716500000000	27	165	Watonwan County, MN	2013	NA	6179	5853	326	5.3
CN2716700000000	27	167	Wilkin County, MN	2013	NA	3625	3474	151	4.2
CN2716900000000	27	169	Winona County, MN	2013	NA	29580	28287	1293	4.4
CN2717100000000	27	171	Wright County, MN	2013	NA	70559	66999	3560	5
CN2717300000000	27	173	Yellow Medicine County, MN	2013	NA	5541	5269	272	4.9
CN2800100000000	28	001	Adams County, MS	2013	NA	11835	10732	1103	9.3
CN2800300000000	28	003	Alcorn County, MS	2013	NA	15378	14183	1195	7.8
CN2800500000000	28	005	Amite County, MS	2013	NA	4549	4134	415	9.1
CN2800700000000	28	007	Attala County, MS	2013	NA	7251	6572	679	9.4
CN2800900000000	28	009	Benton County, MS	2013	NA	3136	2808	328	10.5
CN2801100000000	28	011	Bolivar County, MS	2013	NA	13795	12321	1474	10.7
CN2801300000000	28	013	Calhoun County, MS	2013	NA	6403	5865	538	8.4
CN2801500000000	28	015	Carroll County, MS	2013	NA	3473	3106	367	10.6
CN2801700000000	28	017	Chickasaw County, MS	2013	NA	7609	6797	812	10.7
CN2801900000000	28	019	Choctaw County, MS	2013	NA	3746	3427	319	8.5
CN2802100000000	28	021	Claiborne County, MS	2013	NA	3299	2739	560	17
CN2802300000000	28	023	Clarke County, MS	2013	NA	6657	5993	664	10
CN2802500000000	28	025	Clay County, MS	2013	NA	8387	7094	1293	15.4
CN2802700000000	28	027	Coahoma County, MS	2013	NA	9813	8548	1265	12.9
CN2802900000000	28	029	Copiah County, MS	2013	NA	11475	10269	1206	10.5
CN2803100000000	28	031	Covington County, MS	2013	NA	7955	7329	626	7.9
CN2803300000000	28	033	DeSoto County, MS	2013	NA	81100	76308	4792	5.9
CN2803500000000	28	035	Forrest County, MS	2013	NA	33102	30310	2792	8.4
CN2803700000000	28	037	Franklin County, MS	2013	NA	2953	2681	272	9.2
CN2803900000000	28	039	George County, MS	2013	NA	8564	7757	807	9.4
CN2804100000000	28	041	Greene County, MS	2013	NA	4435	3984	451	10.2
CN2804300000000	28	043	Grenada County, MS	2013	NA	9334	8510	824	8.8
CN2804500000000	28	045	Hancock County, MS	2013	NA	18932	17446	1486	7.8
CN2804700000000	28	047	Harrison County, MS	2013	NA	86617	80121	6496	7.5
CN2804900000000	28	049	Hinds County, MS	2013	NA	110759	101375	9384	8.5
CN2805100000000	28	051	Holmes County, MS	2013	NA	6301	5247	1054	16.7
CN2805300000000	28	053	Humphreys County, MS	2013	NA	3053	2529	524	17.2
CN2805500000000	28	055	Issaquena County, MS	2013	NA	446	355	91	20.4
CN2805700000000	28	057	Itawamba County, MS	2013	NA	10027	9223	804	8
CN2805900000000	28	059	Jackson County, MS	2013	NA	60944	55537	5407	8.9
CN2806100000000	28	061	Jasper County, MS	2013	NA	6514	5867	647	9.9
CN2806300000000	28	063	Jefferson County, MS	2013	NA	2480	2003	477	19.2
CN2806500000000	28	065	Jefferson Davis County, MS	2013	NA	4218	3686	532	12.6
CN2806700000000	28	067	Jones County, MS	2013	NA	27346	25417	1929	7.1
CN2806900000000	28	069	Kemper County, MS	2013	NA	3956	3447	509	12.9
CN2807100000000	28	071	Lafayette County, MS	2013	NA	23038	21391	1647	7.1
CN2807300000000	28	073	Lamar County, MS	2013	NA	27531	25904	1627	5.9
CN2807500000000	28	075	Lauderdale County, MS	2013	NA	34590	31701	2889	8.4
CN2807700000000	28	077	Lawrence County, MS	2013	NA	4717	4281	436	9.2
CN2807900000000	28	079	Leake County, MS	2013	NA	8108	7415	693	8.5
CN2808100000000	28	081	Lee County, MS	2013	NA	39557	36395	3162	8
CN2808300000000	28	083	Leflore County, MS	2013	NA	10738	9207	1531	14.3
CN2808500000000	28	085	Lincoln County, MS	2013	NA	13920	12848	1072	7.7
CN2808700000000	28	087	Lowndes County, MS	2013	NA	26976	24470	2506	9.3
CN2808900000000	28	089	Madison County, MS	2013	NA	49764	46853	2911	5.8
CN2809100000000	28	091	Marion County, MS	2013	NA	9936	9000	936	9.4
CN2809300000000	28	093	Marshall County, MS	2013	NA	14805	13303	1502	10.1
CN2809500000000	28	095	Monroe County, MS	2013	NA	15505	13681	1824	11.8
CN2809700000000	28	097	Montgomery County, MS	2013	NA	4375	3881	494	11.3
CN2809900000000	28	099	Neshoba County, MS	2013	NA	10958	10105	853	7.8
CN2810100000000	28	101	Newton County, MS	2013	NA	8981	8311	670	7.5
CN2810300000000	28	103	Noxubee County, MS	2013	NA	4087	3540	547	13.4
CN2810500000000	28	105	Oktibbeha County, MS	2013	NA	22213	20446	1767	8
CN2810700000000	28	107	Panola County, MS	2013	NA	13674	12047	1627	11.9
CN2810900000000	28	109	Pearl River County, MS	2013	NA	22827	21135	1692	7.4
CN2811100000000	28	111	Perry County, MS	2013	NA	4249	3807	442	10.4
CN2811300000000	28	113	Pike County, MS	2013	NA	14642	13206	1436	9.8
CN2811500000000	28	115	Pontotoc County, MS	2013	NA	13672	12659	1013	7.4
CN2811700000000	28	117	Prentiss County, MS	2013	NA	10947	10023	924	8.4
CN2811900000000	28	119	Quitman County, MS	2013	NA	2858	2434	424	14.8
CN2812100000000	28	121	Rankin County, MS	2013	NA	71226	67505	3721	5.2
CN2812300000000	28	123	Scott County, MS	2013	NA	12742	11900	842	6.6
CN2812500000000	28	125	Sharkey County, MS	2013	NA	1844	1604	240	13
CN2812700000000	28	127	Simpson County, MS	2013	NA	10948	10137	811	7.4
CN2812900000000	28	129	Smith County, MS	2013	NA	6839	6380	459	6.7
CN2813100000000	28	131	Stone County, MS	2013	NA	6461	5846	615	9.5
CN2813300000000	28	133	Sunflower County, MS	2013	NA	8994	7744	1250	13.9
CN2813500000000	28	135	Tallahatchie County, MS	2013	NA	5809	5163	646	11.1
CN2813700000000	28	137	Tate County, MS	2013	NA	11969	10902	1067	8.9
CN2813900000000	28	139	Tippah County, MS	2013	NA	8735	7879	856	9.8
CN2814100000000	28	141	Tishomingo County, MS	2013	NA	7695	6985	710	9.2
CN2814300000000	28	143	Tunica County, MS	2013	NA	4791	4196	595	12.4
CN2814500000000	28	145	Union County, MS	2013	NA	13076	12149	927	7.1
CN2814700000000	28	147	Walthall County, MS	2013	NA	5295	4730	565	10.7
CN2814900000000	28	149	Warren County, MS	2013	NA	21636	19688	1948	9
CN2815100000000	28	151	Washington County, MS	2013	NA	19117	16343	2774	14.5
CN2815300000000	28	153	Wayne County, MS	2013	NA	7893	7049	844	10.7
CN2815500000000	28	155	Webster County, MS	2013	NA	4070	3682	388	9.5
CN2815700000000	28	157	Wilkinson County, MS	2013	NA	2983	2613	370	12.4
CN2815900000000	28	159	Winston County, MS	2013	NA	7388	6575	813	11
CN2816100000000	28	161	Yalobusha County, MS	2013	NA	5024	4523	501	10
CN2816300000000	28	163	Yazoo County, MS	2013	NA	9442	8404	1038	11
CN2900100000000	29	001	Adair County, MO	2013	NA	10778	10038	740	6.9
CN2900300000000	29	003	Andrew County, MO	2013	NA	9896	9366	530	5.4
CN2900500000000	29	005	Atchison County, MO	2013	NA	2880	2712	168	5.8
CN2900700000000	29	007	Audrain County, MO	2013	NA	11236	10525	711	6.3
CN2900900000000	29	009	Barry County, MO	2013	NA	14905	13888	1017	6.8
CN2901100000000	29	011	Barton County, MO	2013	NA	5490	5096	394	7.2
CN2901300000000	29	013	Bates County, MO	2013	NA	8001	7390	611	7.6
CN2901500000000	29	015	Benton County, MO	2013	NA	7256	6640	616	8.5
CN2901700000000	29	017	Bollinger County, MO	2013	NA	5753	5345	408	7.1
CN2901900000000	29	019	Boone County, MO	2013	NA	97547	93154	4393	4.5
CN2902100000000	29	021	Buchanan County, MO	2013	NA	46590	43698	2892	6.2
CN2902300000000	29	023	Butler County, MO	2013	NA	18709	17237	1472	7.9
CN2902500000000	29	025	Caldwell County, MO	2013	NA	4348	4057	291	6.7
CN2902700000000	29	027	Callaway County, MO	2013	NA	21630	20329	1301	6
CN2902900000000	29	029	Camden County, MO	2013	NA	18806	17070	1736	9.2
CN2903100000000	29	031	Cape Girardeau County, MO	2013	NA	40913	38559	2354	5.8
CN2903300000000	29	033	Carroll County, MO	2013	NA	4678	4336	342	7.3
CN2903500000000	29	035	Carter County, MO	2013	NA	2548	2304	244	9.6
CN2903700000000	29	037	Cass County, MO	2013	NA	52287	48993	3294	6.3
CN2903900000000	29	039	Cedar County, MO	2013	NA	5879	5465	414	7
CN2904100000000	29	041	Chariton County, MO	2013	NA	3740	3506	234	6.3
CN2904300000000	29	043	Christian County, MO	2013	NA	41036	38796	2240	5.5
CN2904500000000	29	045	Clark County, MO	2013	NA	3361	3094	267	7.9
CN2904700000000	29	047	Clay County, MO	2013	NA	126817	119105	7712	6.1
CN2904900000000	29	049	Clinton County, MO	2013	NA	10753	10041	712	6.6
CN2905100000000	29	051	Cole County, MO	2013	NA	39752	37668	2084	5.2
CN2905300000000	29	053	Cooper County, MO	2013	NA	7692	7158	534	6.9
CN2905500000000	29	055	Crawford County, MO	2013	NA	10900	9968	932	8.6
CN2905700000000	29	057	Dade County, MO	2013	NA	3450	3215	235	6.8
CN2905900000000	29	059	Dallas County, MO	2013	NA	6960	6359	601	8.6
CN2906100000000	29	061	Daviess County, MO	2013	NA	4074	3820	254	6.2
CN2906300000000	29	063	DeKalb County, MO	2013	NA	5041	4738	303	6
CN2906500000000	29	065	Dent County, MO	2013	NA	6255	5783	472	7.5
CN2906700000000	29	067	Douglas County, MO	2013	NA	5072	4596	476	9.4
CN2906900000000	29	069	Dunklin County, MO	2013	NA	13008	11718	1290	9.9
CN2907100000000	29	071	Franklin County, MO	2013	NA	51642	47925	3717	7.2
CN2907300000000	29	073	Gasconade County, MO	2013	NA	7541	7064	477	6.3
CN2907500000000	29	075	Gentry County, MO	2013	NA	3598	3409	189	5.3
CN2907700000000	29	077	Greene County, MO	2013	NA	144536	136572	7964	5.5
CN2907900000000	29	079	Grundy County, MO	2013	NA	4922	4634	288	5.9
CN2908100000000	29	081	Harrison County, MO	2013	NA	3966	3676	290	7.3
CN2908300000000	29	083	Henry County, MO	2013	NA	9867	9162	705	7.1
CN2908500000000	29	085	Hickory County, MO	2013	NA	3689	3322	367	9.9
CN2908700000000	29	087	Holt County, MO	2013	NA	2742	2595	147	5.4
CN2908900000000	29	089	Howard County, MO	2013	NA	4927	4609	318	6.5
CN2909100000000	29	091	Howell County, MO	2013	NA	16415	15131	1284	7.8
CN2909300000000	29	093	Iron County, MO	2013	NA	3932	3514	418	10.6
CN2909500000000	29	095	Jackson County, MO	2013	NA	353084	326123	26961	7.6
CN2909700000000	29	097	Jasper County, MO	2013	NA	57982	54596	3386	5.8
CN2909900000000	29	099	Jefferson County, MO	2013	NA	114854	107043	7811	6.8
CN2910100000000	29	101	Johnson County, MO	2013	NA	22943	21282	1661	7.2
CN2910300000000	29	103	Knox County, MO	2013	NA	1984	1875	109	5.5
CN2910500000000	29	105	Laclede County, MO	2013	NA	15595	14099	1496	9.6
CN2910700000000	29	107	Lafayette County, MO	2013	NA	16918	15831	1087	6.4
CN2910900000000	29	109	Lawrence County, MO	2013	NA	17426	16276	1150	6.6
CN2911100000000	29	111	Lewis County, MO	2013	NA	5081	4799	282	5.6
CN2911300000000	29	113	Lincoln County, MO	2013	NA	26314	24321	1993	7.6
CN2911500000000	29	115	Linn County, MO	2013	NA	5317	4849	468	8.8
CN2911700000000	29	117	Livingston County, MO	2013	NA	7269	6859	410	5.6
CN2911900000000	29	119	McDonald County, MO	2013	NA	9980	9338	642	6.4
CN2912100000000	29	121	Macon County, MO	2013	NA	7426	6941	485	6.5
CN2912300000000	29	123	Madison County, MO	2013	NA	5564	5139	425	7.6
CN2912500000000	29	125	Maries County, MO	2013	NA	4179	3903	276	6.6
CN2912700000000	29	127	Marion County, MO	2013	NA	14636	13756	880	6
CN2912900000000	29	129	Mercer County, MO	2013	NA	1810	1711	99	5.5
CN2913100000000	29	131	Miller County, MO	2013	NA	11497	10492	1005	8.7
CN2913300000000	29	133	Mississippi County, MO	2013	NA	6303	5811	492	7.8
CN2913500000000	29	135	Moniteau County, MO	2013	NA	7318	6853	465	6.4
CN2913700000000	29	137	Monroe County, MO	2013	NA	4111	3810	301	7.3
CN2913900000000	29	139	Montgomery County, MO	2013	NA	5720	5308	412	7.2
CN2914100000000	29	141	Morgan County, MO	2013	NA	7850	7108	742	9.5
CN2914300000000	29	143	New Madrid County, MO	2013	NA	8286	7638	648	7.8
CN2914500000000	29	145	Newton County, MO	2013	NA	28942	27198	1744	6
CN2914700000000	29	147	Nodaway County, MO	2013	NA	11357	10614	743	6.5
CN2914900000000	29	149	Oregon County, MO	2013	NA	4137	3808	329	8
CN2915100000000	29	151	Osage County, MO	2013	NA	7207	6848	359	5
CN2915300000000	29	153	Ozark County, MO	2013	NA	3677	3297	380	10.3
CN2915500000000	29	155	Pemiscot County, MO	2013	NA	7102	6368	734	10.3
CN2915700000000	29	157	Perry County, MO	2013	NA	10138	9587	551	5.4
CN2915900000000	29	159	Pettis County, MO	2013	NA	20082	18763	1319	6.6
CN2916100000000	29	161	Phelps County, MO	2013	NA	19353	17995	1358	7
CN2916300000000	29	163	Pike County, MO	2013	NA	8097	7570	527	6.5
CN2916500000000	29	165	Platte County, MO	2013	NA	52743	49755	2988	5.7
CN2916700000000	29	167	Polk County, MO	2013	NA	13918	12927	991	7.1
CN2916900000000	29	169	Pulaski County, MO	2013	NA	15626	14387	1239	7.9
CN2917100000000	29	171	Putnam County, MO	2013	NA	2450	2305	145	5.9
CN2917300000000	29	173	Ralls County, MO	2013	NA	5605	5280	325	5.8
CN2917500000000	29	175	Randolph County, MO	2013	NA	10533	9672	861	8.2
CN2917700000000	29	177	Ray County, MO	2013	NA	11131	10271	860	7.7
CN2917900000000	29	179	Reynolds County, MO	2013	NA	2522	2284	238	9.4
CN2918100000000	29	181	Ripley County, MO	2013	NA	5554	5040	514	9.3
CN2918300000000	29	183	St. Charles County, MO	2013	NA	207053	196045	11008	5.3
CN2918500000000	29	185	St. Clair County, MO	2013	NA	3918	3614	304	7.8
CN2918600000000	29	186	Ste. Genevieve County, MO	2013	NA	9020	8370	650	7.2
CN2918700000000	29	187	St. Francois County, MO	2013	NA	26293	24046	2247	8.5
CN2918900000000	29	189	St. Louis County, MO	2013	NA	524367	491621	32746	6.2
CN2919500000000	29	195	Saline County, MO	2013	NA	11092	10428	664	6
CN2919700000000	29	197	Schuyler County, MO	2013	NA	1902	1753	149	7.8
CN2919900000000	29	199	Scotland County, MO	2013	NA	2375	2248	127	5.3
CN2920100000000	29	201	Scott County, MO	2013	NA	19825	18412	1413	7.1
CN2920300000000	29	203	Shannon County, MO	2013	NA	3368	3047	321	9.5
CN2920500000000	29	205	Shelby County, MO	2013	NA	3062	2891	171	5.6
CN2920700000000	29	207	Stoddard County, MO	2013	NA	13229	12060	1169	8.8
CN2920900000000	29	209	Stone County, MO	2013	NA	13598	12169	1429	10.5
CN2921100000000	29	211	Sullivan County, MO	2013	NA	2716	2540	176	6.5
CN2921300000000	29	213	Taney County, MO	2013	NA	25840	23086	2754	10.7
CN2921500000000	29	215	Texas County, MO	2013	NA	9707	8912	795	8.2
CN2921700000000	29	217	Vernon County, MO	2013	NA	9780	9202	578	5.9
CN2921900000000	29	219	Warren County, MO	2013	NA	16865	15713	1152	6.8
CN2922100000000	29	221	Washington County, MO	2013	NA	10473	9454	1019	9.7
CN2922300000000	29	223	Wayne County, MO	2013	NA	5639	5174	465	8.2
CN2922500000000	29	225	Webster County, MO	2013	NA	15913	14839	1074	6.7
CN2922700000000	29	227	Worth County, MO	2013	NA	1319	1265	54	4.1
CN2922900000000	29	229	Wright County, MO	2013	NA	7599	6962	637	8.4
CN2951000000000	29	510	St. Louis city, MO	2013	NA	159822	146476	13346	8.4
CN3000100000000	30	001	Beaverhead County, MT	2013	NA	4840	4612	228	4.7
CN3000300000000	30	003	Big Horn County, MT	2013	NA	5701	4900	801	14.1
CN3000500000000	30	005	Blaine County, MT	2013	NA	2471	2319	152	6.2
CN3000700000000	30	007	Broadwater County, MT	2013	NA	2508	2348	160	6.4
CN3000900000000	30	009	Carbon County, MT	2013	NA	5395	5154	241	4.5
CN3001100000000	30	011	Carter County, MT	2013	NA	672	651	21	3.1
CN3001300000000	30	013	Cascade County, MT	2013	NA	38386	36422	1964	5.1
CN3001500000000	30	015	Chouteau County, MT	2013	NA	2586	2491	95	3.7
CN3001700000000	30	017	Custer County, MT	2013	NA	6632	6409	223	3.4
CN3001900000000	30	019	Daniels County, MT	2013	NA	932	902	30	3.2
CN3002100000000	30	021	Dawson County, MT	2013	NA	4807	4655	152	3.2
CN3002300000000	30	023	Deer Lodge County, MT	2013	NA	5209	4952	257	4.9
CN3002500000000	30	025	Fallon County, MT	2013	NA	2038	1998	40	2
CN3002700000000	30	027	Fergus County, MT	2013	NA	5870	5582	288	4.9
CN3002900000000	30	029	Flathead County, MT	2013	NA	43843	40469	3374	7.7
CN3003100000000	30	031	Gallatin County, MT	2013	NA	54783	52526	2257	4.1
CN3003300000000	30	033	Garfield County, MT	2013	NA	761	737	24	3.2
CN3003500000000	30	035	Glacier County, MT	2013	NA	6341	5701	640	10.1
CN3003700000000	30	037	Golden Valley County, MT	2013	NA	397	377	20	5
CN3003900000000	30	039	Granite County, MT	2013	NA	1501	1387	114	7.6
CN3004100000000	30	041	Hill County, MT	2013	NA	7938	7416	522	6.6
CN3004300000000	30	043	Jefferson County, MT	2013	NA	5608	5333	275	4.9
CN3004500000000	30	045	Judith Basin County, MT	2013	NA	978	930	48	4.9
CN3004700000000	30	047	Lake County, MT	2013	NA	12370	11565	805	6.5
CN3004900000000	30	049	Lewis and Clark County, MT	2013	NA	35064	33537	1527	4.4
CN3005100000000	30	051	Liberty County, MT	2013	NA	991	957	34	3.4
CN3005300000000	30	053	Lincoln County, MT	2013	NA	8122	7068	1054	13
CN3005500000000	30	055	McCone County, MT	2013	NA	1095	1069	26	2.4
CN3005700000000	30	057	Madison County, MT	2013	NA	4161	3932	229	5.5
CN3005900000000	30	059	Meagher County, MT	2013	NA	931	882	49	5.3
CN3006100000000	30	061	Mineral County, MT	2013	NA	1781	1595	186	10.4
CN3006300000000	30	063	Missoula County, MT	2013	NA	59395	56311	3084	5.2
CN3006500000000	30	065	Musselshell County, MT	2013	NA	2376	2256	120	5.1
CN3006700000000	30	067	Park County, MT	2013	NA	8011	7502	509	6.4
CN3006900000000	30	069	Petroleum County, MT	2013	NA	294	280	14	4.8
CN3007100000000	30	071	Phillips County, MT	2013	NA	2057	1936	121	5.9
CN3007300000000	30	073	Pondera County, MT	2013	NA	2901	2758	143	4.9
CN3007500000000	30	075	Powder River County, MT	2013	NA	1124	1087	37	3.3
CN3007700000000	30	077	Powell County, MT	2013	NA	2946	2782	164	5.6
CN3007900000000	30	079	Prairie County, MT	2013	NA	521	497	24	4.6
CN3008100000000	30	081	Ravalli County, MT	2013	NA	18747	17484	1263	6.7
CN3008300000000	30	083	Richland County, MT	2013	NA	7070	6885	185	2.6
CN3008500000000	30	085	Roosevelt County, MT	2013	NA	4921	4650	271	5.5
CN3008700000000	30	087	Rosebud County, MT	2013	NA	4200	3931	269	6.4
CN3008900000000	30	089	Sanders County, MT	2013	NA	4739	4243	496	10.5
CN3009100000000	30	091	Sheridan County, MT	2013	NA	2172	2111	61	2.8
CN3009300000000	30	093	Silver Bow County, MT	2013	NA	17176	16237	939	5.5
CN3009500000000	30	095	Stillwater County, MT	2013	NA	5064	4860	204	4
CN3009700000000	30	097	Sweet Grass County, MT	2013	NA	1769	1703	66	3.7
CN3009900000000	30	099	Teton County, MT	2013	NA	2953	2826	127	4.3
CN3010100000000	30	101	Toole County, MT	2013	NA	2387	2295	92	3.9
CN3010300000000	30	103	Treasure County, MT	2013	NA	355	339	16	4.5
CN3010500000000	30	105	Valley County, MT	2013	NA	4244	4083	161	3.8
CN3010700000000	30	107	Wheatland County, MT	2013	NA	824	773	51	6.2
CN3010900000000	30	109	Wibaux County, MT	2013	NA	558	539	19	3.4
CN3011100000000	30	111	Yellowstone County, MT	2013	NA	79268	75831	3437	4.3
CN3100100000000	31	001	Adams County, NE	2013	NA	16963	16346	617	3.6
CN3100300000000	31	003	Antelope County, NE	2013	NA	3619	3503	116	3.2
CN3100500000000	31	005	Arthur County, NE	2013	NA	221	204	17	7.7
CN3100700000000	31	007	Banner County, NE	2013	NA	437	417	20	4.6
CN3100900000000	31	009	Blaine County, NE	2013	NA	272	258	14	5.1
CN3101100000000	31	011	Boone County, NE	2013	NA	3060	2960	100	3.3
CN3101300000000	31	013	Box Butte County, NE	2013	NA	5988	5757	231	3.9
CN3101500000000	31	015	Boyd County, NE	2013	NA	1130	1090	40	3.5
CN3101700000000	31	017	Brown County, NE	2013	NA	1437	1381	56	3.9
CN3101900000000	31	019	Buffalo County, NE	2013	NA	27441	26553	888	3.2
CN3102100000000	31	021	Burt County, NE	2013	NA	3658	3492	166	4.5
CN3102300000000	31	023	Butler County, NE	2013	NA	4791	4629	162	3.4
CN3102500000000	31	025	Cass County, NE	2013	NA	13321	12743	578	4.3
CN3102700000000	31	027	Cedar County, NE	2013	NA	4733	4593	140	3
CN3102900000000	31	029	Chase County, NE	2013	NA	2406	2349	57	2.4
CN3103100000000	31	031	Cherry County, NE	2013	NA	3490	3394	96	2.8
CN3103300000000	31	033	Cheyenne County, NE	2013	NA	5819	5655	164	2.8
CN3103500000000	31	035	Clay County, NE	2013	NA	3503	3383	120	3.4
CN3103700000000	31	037	Colfax County, NE	2013	NA	5626	5428	198	3.5
CN3103900000000	31	039	Cuming County, NE	2013	NA	4961	4811	150	3
CN3104100000000	31	041	Custer County, NE	2013	NA	6162	5991	171	2.8
CN3104300000000	31	043	Dakota County, NE	2013	NA	11215	10688	527	4.7
CN3104500000000	31	045	Dawes County, NE	2013	NA	5429	5234	195	3.6
CN3104700000000	31	047	Dawson County, NE	2013	NA	13275	12769	506	3.8
CN3104900000000	31	049	Deuel County, NE	2013	NA	1134	1096	38	3.4
CN3105100000000	31	051	Dixon County, NE	2013	NA	3123	3006	117	3.7
CN3105300000000	31	053	Dodge County, NE	2013	NA	19259	18449	810	4.2
CN3105500000000	31	055	Douglas County, NE	2013	NA	286568	274688	11880	4.1
CN3105700000000	31	057	Dundy County, NE	2013	NA	1304	1268	36	2.8
CN3105900000000	31	059	Fillmore County, NE	2013	NA	3306	3207	99	3
CN3106100000000	31	061	Franklin County, NE	2013	NA	1600	1544	56	3.5
CN3106300000000	31	063	Frontier County, NE	2013	NA	1598	1544	54	3.4
CN3106500000000	31	065	Furnas County, NE	2013	NA	2732	2636	96	3.5
CN3106700000000	31	067	Gage County, NE	2013	NA	11128	10617	511	4.6
CN3106900000000	31	069	Garden County, NE	2013	NA	1237	1202	35	2.8
CN3107100000000	31	071	Garfield County, NE	2013	NA	1231	1193	38	3.1
CN3107300000000	31	073	Gosper County, NE	2013	NA	1166	1126	40	3.4
CN3107500000000	31	075	Grant County, NE	2013	NA	420	406	14	3.3
CN3107700000000	31	077	Greeley County, NE	2013	NA	1302	1256	46	3.5
CN3107900000000	31	079	Hall County, NE	2013	NA	32586	31376	1210	3.7
CN3108100000000	31	081	Hamilton County, NE	2013	NA	4853	4698	155	3.2
CN3108300000000	31	083	Harlan County, NE	2013	NA	1863	1805	58	3.1
CN3108500000000	31	085	Hayes County, NE	2013	NA	648	626	22	3.4
CN3108700000000	31	087	Hitchcock County, NE	2013	NA	1363	1308	55	4
CN3108900000000	31	089	Holt County, NE	2013	NA	6014	5825	189	3.1
CN3109100000000	31	091	Hooker County, NE	2013	NA	436	415	21	4.8
CN3109300000000	31	093	Howard County, NE	2013	NA	3425	3299	126	3.7
CN3109500000000	31	095	Jefferson County, NE	2013	NA	4346	4185	161	3.7
CN3109700000000	31	097	Johnson County, NE	2013	NA	2186	2091	95	4.3
CN3109900000000	31	099	Kearney County, NE	2013	NA	3905	3795	110	2.8
CN3110100000000	31	101	Keith County, NE	2013	NA	4713	4543	170	3.6
CN3110300000000	31	103	Keya Paha County, NE	2013	NA	611	591	20	3.3
CN3110500000000	31	105	Kimball County, NE	2013	NA	2199	2126	73	3.3
CN3110700000000	31	107	Knox County, NE	2013	NA	4808	4638	170	3.5
CN3110900000000	31	109	Lancaster County, NE	2013	NA	168939	163096	5843	3.5
CN3111100000000	31	111	Lincoln County, NE	2013	NA	19247	18518	729	3.8
CN3111300000000	31	113	Logan County, NE	2013	NA	503	487	16	3.2
CN3111500000000	31	115	Loup County, NE	2013	NA	378	361	17	4.5
CN3111700000000	31	117	McPherson County, NE	2013	NA	372	358	14	3.8
CN3111900000000	31	119	Madison County, NE	2013	NA	19357	18681	676	3.5
CN3112100000000	31	121	Merrick County, NE	2013	NA	4210	4054	156	3.7
CN3112300000000	31	123	Morrill County, NE	2013	NA	2756	2667	89	3.2
CN3112500000000	31	125	Nance County, NE	2013	NA	2079	2012	67	3.2
CN3112700000000	31	127	Nemaha County, NE	2013	NA	3824	3633	191	5
CN3112900000000	31	129	Nuckolls County, NE	2013	NA	2458	2379	79	3.2
CN3113100000000	31	131	Otoe County, NE	2013	NA	8438	8078	360	4.3
CN3113300000000	31	133	Pawnee County, NE	2013	NA	1685	1632	53	3.1
CN3113500000000	31	135	Perkins County, NE	2013	NA	1823	1776	47	2.6
CN3113700000000	31	137	Phelps County, NE	2013	NA	5093	4942	151	3
CN3113900000000	31	139	Pierce County, NE	2013	NA	4223	4082	141	3.3
CN3114100000000	31	141	Platte County, NE	2013	NA	17752	17136	616	3.5
CN3114300000000	31	143	Polk County, NE	2013	NA	3001	2899	102	3.4
CN3114500000000	31	145	Red Willow County, NE	2013	NA	6439	6249	190	3
CN3114700000000	31	147	Richardson County, NE	2013	NA	4365	4170	195	4.5
CN3114900000000	31	149	Rock County, NE	2013	NA	887	859	28	3.2
CN3115100000000	31	151	Saline County, NE	2013	NA	7400	7085	315	4.3
CN3115300000000	31	153	Sarpy County, NE	2013	NA	89279	86071	3208	3.6
CN3115500000000	31	155	Saunders County, NE	2013	NA	11178	10727	451	4
CN3115700000000	31	157	Scotts Bluff County, NE	2013	NA	19161	18356	805	4.2
CN3115900000000	31	159	Seward County, NE	2013	NA	9023	8690	333	3.7
CN3116100000000	31	161	Sheridan County, NE	2013	NA	2801	2710	91	3.2
CN3116300000000	31	163	Sherman County, NE	2013	NA	1740	1682	58	3.3
CN3116500000000	31	165	Sioux County, NE	2013	NA	806	779	27	3.3
CN3116700000000	31	167	Stanton County, NE	2013	NA	3693	3570	123	3.3
CN3116900000000	31	169	Thayer County, NE	2013	NA	3058	2973	85	2.8
CN3117100000000	31	171	Thomas County, NE	2013	NA	455	437	18	4
CN3117300000000	31	173	Thurston County, NE	2013	NA	3105	2867	238	7.7
CN3117500000000	31	175	Valley County, NE	2013	NA	2143	2072	71	3.3
CN3117700000000	31	177	Washington County, NE	2013	NA	11140	10731	409	3.7
CN3117900000000	31	179	Wayne County, NE	2013	NA	5689	5509	180	3.2
CN3118100000000	31	181	Webster County, NE	2013	NA	1748	1680	68	3.9
CN3118300000000	31	183	Wheeler County, NE	2013	NA	525	508	17	3.2
CN3118500000000	31	185	York County, NE	2013	NA	7507	7237	270	3.6
CN3200100000000	32	001	Churchill County, NV	2013	NA	10916	9880	1036	9.5
CN3200300000000	32	003	Clark County, NV	2013	NA	1005660	908300	97360	9.7
CN3200500000000	32	005	Douglas County, NV	2013	NA	22636	20429	2207	9.7
CN3200700000000	32	007	Elko County, NV	2013	NA	28762	26975	1787	6.2
CN3200900000000	32	009	Esmeralda County, NV	2013	NA	541	515	26	4.8
CN3201100000000	32	011	Eureka County, NV	2013	NA	1091	1024	67	6.1
CN3201300000000	32	013	Humboldt County, NV	2013	NA	9078	8496	582	6.4
CN3201500000000	32	015	Lander County, NV	2013	NA	3517	3258	259	7.4
CN3201700000000	32	017	Lincoln County, NV	2013	NA	2016	1822	194	9.6
CN3201900000000	32	019	Lyon County, NV	2013	NA	22351	19494	2857	12.8
CN3202100000000	32	021	Mineral County, NV	2013	NA	1841	1610	231	12.5
CN3202300000000	32	023	Nye County, NV	2013	NA	16351	14361	1990	12.2
CN3202700000000	32	027	Pershing County, NV	2013	NA	2619	2384	235	9
CN3202900000000	32	029	Storey County, NV	2013	NA	1896	1676	220	11.6
CN3203100000000	32	031	Washoe County, NV	2013	NA	221619	200638	20981	9.5
CN3203300000000	32	033	White Pine County, NV	2013	NA	4865	4506	359	7.4
CN3251000000000	32	510	Carson City, NV	2013	NA	25400	22755	2645	10.4
CN3300100000000	33	001	Belknap County, NH	2013	NA	31992	30389	1603	5
CN3300300000000	33	003	Carroll County, NH	2013	NA	24429	23228	1201	4.9
CN3300500000000	33	005	Cheshire County, NH	2013	NA	41945	39958	1987	4.7
CN3300700000000	33	007	Coos County, NH	2013	NA	15929	14960	969	6.1
CN3300900000000	33	009	Grafton County, NH	2013	NA	48366	46322	2044	4.2
CN3301100000000	33	011	Hillsborough County, NH	2013	NA	227769	215532	12237	5.4
CN3301300000000	33	013	Merrimack County, NH	2013	NA	80880	77141	3739	4.6
CN3301500000000	33	015	Rockingham County, NH	2013	NA	175733	166177	9556	5.4
CN3301700000000	33	017	Strafford County, NH	2013	NA	70150	66728	3422	4.9
CN3301900000000	33	019	Sullivan County, NH	2013	NA	24092	23100	992	4.1
CN3400100000000	34	001	Atlantic County, NJ	2013	NA	137707	121628	16079	11.7
CN3400300000000	34	003	Bergen County, NJ	2013	NA	481398	449009	32389	6.7
CN3400500000000	34	005	Burlington County, NJ	2013	NA	232955	215038	17917	7.7
CN3400700000000	34	007	Camden County, NJ	2013	NA	258070	233809	24261	9.4
CN3400900000000	34	009	Cape May County, NJ	2013	NA	49389	42349	7040	14.3
CN3401100000000	34	011	Cumberland County, NJ	2013	NA	69744	61557	8187	11.7
CN3401300000000	34	013	Essex County, NJ	2013	NA	379967	343127	36840	9.7
CN3401500000000	34	015	Gloucester County, NJ	2013	NA	150305	136764	13541	9
CN3401700000000	34	017	Hudson County, NJ	2013	NA	359472	331172	28300	7.9
CN3401900000000	34	019	Hunterdon County, NJ	2013	NA	66590	62694	3896	5.9
CN3402100000000	34	021	Mercer County, NJ	2013	NA	193914	179786	14128	7.3
CN3402300000000	34	023	Middlesex County, NJ	2013	NA	432083	399517	32566	7.5
CN3402500000000	34	025	Monmouth County, NJ	2013	NA	328758	304017	24741	7.5
CN3402700000000	34	027	Morris County, NJ	2013	NA	265032	248681	16351	6.2
CN3402900000000	34	029	Ocean County, NJ	2013	NA	266927	242170	24757	9.3
CN3403100000000	34	031	Passaic County, NJ	2013	NA	250983	225959	25024	10
CN3403300000000	34	033	Salem County, NJ	2013	NA	31832	28513	3319	10.4
CN3403500000000	34	035	Somerset County, NJ	2013	NA	174719	163627	11092	6.3
CN3403700000000	34	037	Sussex County, NJ	2013	NA	79412	73105	6307	7.9
CN3403900000000	34	039	Union County, NJ	2013	NA	281378	257806	23572	8.4
CN3404100000000	34	041	Warren County, NJ	2013	NA	57922	53498	4424	7.6
CN3500100000000	35	001	Bernalillo County, NM	2013	NA	319638	298965	20673	6.5
CN3500300000000	35	003	Catron County, NM	2013	NA	1240	1130	110	8.9
CN3500500000000	35	005	Chaves County, NM	2013	NA	26633	24960	1673	6.3
CN3500600000000	35	006	Cibola County, NM	2013	NA	9105	8330	775	8.5
CN3500700000000	35	007	Colfax County, NM	2013	NA	6173	5735	438	7.1
CN3500900000000	35	009	Curry County, NM	2013	NA	21427	20330	1097	5.1
CN3501100000000	35	011	De Baca County, NM	2013	NA	809	772	37	4.6
CN3501300000000	35	013	Dona Ana County, NM	2013	NA	93721	86715	7006	7.5
CN3501500000000	35	015	Eddy County, NM	2013	NA	27668	26399	1269	4.6
CN3501700000000	35	017	Grant County, NM	2013	NA	12842	11973	869	6.8
CN3501900000000	35	019	Guadalupe County, NM	2013	NA	1632	1490	142	8.7
CN3502100000000	35	021	Harding County, NM	2013	NA	284	269	15	5.3
CN3502300000000	35	023	Hidalgo County, NM	2013	NA	2174	2010	164	7.5
CN3502500000000	35	025	Lea County, NM	2013	NA	29310	27998	1312	4.5
CN3502700000000	35	027	Lincoln County, NM	2013	NA	8804	8237	567	6.4
CN3502800000000	35	028	Los Alamos County, NM	2013	NA	8621	8257	364	4.2
CN3502900000000	35	029	Luna County, NM	2013	NA	11300	9151	2149	19
CN3503100000000	35	031	McKinley County, NM	2013	NA	24305	21847	2458	10.1
CN3503300000000	35	033	Mora County, NM	2013	NA	2254	1991	263	11.7
CN3503500000000	35	035	Otero County, NM	2013	NA	25244	23635	1609	6.4
CN3503700000000	35	037	Quay County, NM	2013	NA	3305	3065	240	7.3
CN3503900000000	35	039	Rio Arriba County, NM	2013	NA	16644	15053	1591	9.6
CN3504100000000	35	041	Roosevelt County, NM	2013	NA	8342	7877	465	5.6
CN3504300000000	35	043	Sandoval County, NM	2013	NA	60574	56064	4510	7.4
CN3504500000000	35	045	San Juan County, NM	2013	NA	54546	50846	3700	6.8
CN3504700000000	35	047	San Miguel County, NM	2013	NA	11093	10166	927	8.4
CN3504900000000	35	049	Santa Fe County, NM	2013	NA	73219	69131	4088	5.6
CN3505100000000	35	051	Sierra County, NM	2013	NA	3989	3600	389	9.8
CN3505300000000	35	053	Socorro County, NM	2013	NA	6612	6124	488	7.4
CN3505500000000	35	055	Taos County, NM	2013	NA	15047	13493	1554	10.3
CN3505700000000	35	057	Torrance County, NM	2013	NA	5597	5025	572	10.2
CN3505900000000	35	059	Union County, NM	2013	NA	1865	1779	86	4.6
CN3506100000000	35	061	Valencia County, NM	2013	NA	29884	27388	2496	8.4
CN3600100000000	36	001	Albany County, NY	2013	NA	160805	151059	9746	6.1
CN3600300000000	36	003	Allegany County, NY	2013	NA	23799	22014	1785	7.5
CN3600500000000	36	005	Bronx County, NY	2013	NA	603461	532428	71033	11.8
CN3600700000000	36	007	Broome County, NY	2013	NA	91934	84779	7155	7.8
CN3600900000000	36	009	Cattaraugus County, NY	2013	NA	38100	34851	3249	8.5
CN3601100000000	36	011	Cayuga County, NY	2013	NA	38854	35989	2865	7.4
CN3601300000000	36	013	Chautauqua County, NY	2013	NA	60218	55387	4831	8
CN3601500000000	36	015	Chemung County, NY	2013	NA	39609	36479	3130	7.9
CN3601700000000	36	017	Chenango County, NY	2013	NA	24097	22335	1762	7.3
CN3601900000000	36	019	Clinton County, NY	2013	NA	37176	34085	3091	8.3
CN3602100000000	36	021	Columbia County, NY	2013	NA	31847	29936	1911	6
CN3602300000000	36	023	Cortland County, NY	2013	NA	24308	22426	1882	7.7
CN3602500000000	36	025	Delaware County, NY	2013	NA	21050	19394	1656	7.9
CN3602700000000	36	027	Dutchess County, NY	2013	NA	145589	135882	9707	6.7
CN3602900000000	36	029	Erie County, NY	2013	NA	460260	426138	34122	7.4
CN3603100000000	36	031	Essex County, NY	2013	NA	18113	16615	1498	8.3
CN3603300000000	36	033	Franklin County, NY	2013	NA	21544	19640	1904	8.8
CN3603500000000	36	035	Fulton County, NY	2013	NA	24736	22393	2343	9.5
CN3603700000000	36	037	Genesee County, NY	2013	NA	30534	28447	2087	6.8
CN3603900000000	36	039	Greene County, NY	2013	NA	21353	19483	1870	8.8
CN3604100000000	36	041	Hamilton County, NY	2013	NA	2430	2198	232	9.5
CN3604300000000	36	043	Herkimer County, NY	2013	NA	30004	27656	2348	7.8
CN3604500000000	36	045	Jefferson County, NY	2013	NA	48330	43868	4462	9.2
CN3604700000000	36	047	Kings County, NY	2013	NA	1212011	1098648	113363	9.4
CN3604900000000	36	049	Lewis County, NY	2013	NA	12245	11087	1158	9.5
CN3605100000000	36	051	Livingston County, NY	2013	NA	31880	29640	2240	7
CN3605300000000	36	053	Madison County, NY	2013	NA	34421	31803	2618	7.6
CN3605500000000	36	055	Monroe County, NY	2013	NA	374652	348519	26133	7
CN3605700000000	36	057	Montgomery County, NY	2013	NA	23179	21049	2130	9.2
CN3605900000000	36	059	Nassau County, NY	2013	NA	697079	655888	41191	5.9
CN3606100000000	36	061	New York County, NY	2013	NA	904861	836910	67951	7.5
CN3606300000000	36	063	Niagara County, NY	2013	NA	105051	96158	8893	8.5
CN3606500000000	36	065	Oneida County, NY	2013	NA	107247	99277	7970	7.4
CN3606700000000	36	067	Onondaga County, NY	2013	NA	231715	215866	15849	6.8
CN3606900000000	36	069	Ontario County, NY	2013	NA	55910	52396	3514	6.3
CN3607100000000	36	071	Orange County, NY	2013	NA	178952	166724	12228	6.8
CN3607300000000	36	073	Orleans County, NY	2013	NA	18710	17009	1701	9.1
CN3607500000000	36	075	Oswego County, NY	2013	NA	57217	51569	5648	9.9
CN3607700000000	36	077	Otsego County, NY	2013	NA	31133	29012	2121	6.8
CN3607900000000	36	079	Putnam County, NY	2013	NA	51371	48251	3120	6.1
CN3608100000000	36	081	Queens County, NY	2013	NA	1143134	1054708	88426	7.7
CN3608300000000	36	083	Rensselaer County, NY	2013	NA	83498	77929	5569	6.7
CN3608500000000	36	085	Richmond County, NY	2013	NA	221068	201233	19835	9
CN3608700000000	36	087	Rockland County, NY	2013	NA	150777	141334	9443	6.3
CN3608900000000	36	089	St. Lawrence County, NY	2013	NA	48498	44069	4429	9.1
CN3609100000000	36	091	Saratoga County, NY	2013	NA	118109	111244	6865	5.8
CN3609300000000	36	093	Schenectady County, NY	2013	NA	78057	72831	5226	6.7
CN3609500000000	36	095	Schoharie County, NY	2013	NA	15298	14057	1241	8.1
CN3609700000000	36	097	Schuyler County, NY	2013	NA	8880	8099	781	8.8
CN3609900000000	36	099	Seneca County, NY	2013	NA	15922	14817	1105	6.9
CN3610100000000	36	101	Steuben County, NY	2013	NA	45687	41830	3857	8.4
CN3610300000000	36	103	Suffolk County, NY	2013	NA	781627	730042	51585	6.6
CN3610500000000	36	105	Sullivan County, NY	2013	NA	34588	31778	2810	8.1
CN3610700000000	36	107	Tioga County, NY	2013	NA	24972	23194	1778	7.1
CN3610900000000	36	109	Tompkins County, NY	2013	NA	55924	53012	2912	5.2
CN3611100000000	36	111	Ulster County, NY	2013	NA	90350	83899	6451	7.1
CN3611300000000	36	113	Warren County, NY	2013	NA	33147	30437	2710	8.2
CN3611500000000	36	115	Washington County, NY	2013	NA	29415	27222	2193	7.5
CN3611700000000	36	117	Wayne County, NY	2013	NA	45964	42482	3482	7.6
CN3611900000000	36	119	Westchester County, NY	2013	NA	477670	447795	29875	6.3
CN3612100000000	36	121	Wyoming County, NY	2013	NA	18818	17327	1491	7.9
CN3612300000000	36	123	Yates County, NY	2013	NA	11977	11158	819	6.8
CN3700100000000	37	001	Alamance County, NC	2013	NA	77241	71636	5605	7.3
CN3700300000000	37	003	Alexander County, NC	2013	NA	17479	16120	1359	7.8
CN3700500000000	37	005	Alleghany County, NC	2013	NA	4418	4030	388	8.8
CN3700700000000	37	007	Anson County, NC	2013	NA	10919	9886	1033	9.5
CN3700900000000	37	009	Ashe County, NC	2013	NA	12855	11676	1179	9.2
CN3701100000000	37	011	Avery County, NC	2013	NA	7684	7000	684	8.9
CN3701300000000	37	013	Beaufort County, NC	2013	NA	20457	18514	1943	9.5
CN3701500000000	37	015	Bertie County, NC	2013	NA	8460	7608	852	10.1
CN3701700000000	37	017	Bladen County, NC	2013	NA	14348	12692	1656	11.5
CN3701900000000	37	019	Brunswick County, NC	2013	NA	47687	43022	4665	9.8
CN3702100000000	37	021	Buncombe County, NC	2013	NA	127657	120025	7632	6
CN3702300000000	37	023	Burke County, NC	2013	NA	40101	36781	3320	8.3
CN3702500000000	37	025	Cabarrus County, NC	2013	NA	92218	85209	7009	7.6
CN3702700000000	37	027	Caldwell County, NC	2013	NA	36369	32887	3482	9.6
CN3702900000000	37	029	Camden County, NC	2013	NA	4522	4200	322	7.1
CN3703100000000	37	031	Carteret County, NC	2013	NA	31178	28746	2432	7.8
CN3703300000000	37	033	Caswell County, NC	2013	NA	9858	8971	887	9
CN3703500000000	37	035	Catawba County, NC	2013	NA	76000	69551	6449	8.5
CN3703700000000	37	037	Chatham County, NC	2013	NA	31556	29575	1981	6.3
CN3703900000000	37	039	Cherokee County, NC	2013	NA	11264	10226	1038	9.2
CN3704100000000	37	041	Chowan County, NC	2013	NA	5721	5158	563	9.8
CN3704300000000	37	043	Clay County, NC	2013	NA	4054	3699	355	8.8
CN3704500000000	37	045	Cleveland County, NC	2013	NA	46531	42113	4418	9.5
CN3704700000000	37	047	Columbus County, NC	2013	NA	24084	21604	2480	10.3
CN3704900000000	37	049	Craven County, NC	2013	NA	41467	37866	3601	8.7
CN3705100000000	37	051	Cumberland County, NC	2013	NA	130858	118196	12662	9.7
CN3705300000000	37	053	Currituck County, NC	2013	NA	12601	11611	990	7.9
CN3705500000000	37	055	Dare County, NC	2013	NA	20509	18245	2264	11
CN3705700000000	37	057	Davidson County, NC	2013	NA	79304	72799	6505	8.2
CN3705900000000	37	059	Davie County, NC	2013	NA	19961	18464	1497	7.5
CN3706100000000	37	061	Duplin County, NC	2013	NA	26448	24336	2112	8
CN3706300000000	37	063	Durham County, NC	2013	NA	150359	140933	9426	6.3
CN3706500000000	37	065	Edgecombe County, NC	2013	NA	23959	20849	3110	13
CN3706700000000	37	067	Forsyth County, NC	2013	NA	177448	164068	13380	7.5
CN3706900000000	37	069	Franklin County, NC	2013	NA	28238	25905	2333	8.3
CN3707100000000	37	071	Gaston County, NC	2013	NA	100807	91777	9030	9
CN3707300000000	37	073	Gates County, NC	2013	NA	5255	4889	366	7
CN3707500000000	37	075	Graham County, NC	2013	NA	3516	2980	536	15.2
CN3707700000000	37	077	Granville County, NC	2013	NA	28335	26396	1939	6.8
CN3707900000000	37	079	Greene County, NC	2013	NA	9411	8669	742	7.9
CN3708100000000	37	081	Guilford County, NC	2013	NA	255228	234235	20993	8.2
CN3708300000000	37	083	Halifax County, NC	2013	NA	21762	19195	2567	11.8
CN3708500000000	37	085	Harnett County, NC	2013	NA	49676	45085	4591	9.2
CN3708700000000	37	087	Haywood County, NC	2013	NA	27582	25428	2154	7.8
CN3708900000000	37	089	Henderson County, NC	2013	NA	49054	46007	3047	6.2
CN3709100000000	37	091	Hertford County, NC	2013	NA	9503	8610	893	9.4
CN3709300000000	37	093	Hoke County, NC	2013	NA	19761	17808	1953	9.9
CN3709500000000	37	095	Hyde County, NC	2013	NA	2161	1911	250	11.6
CN3709700000000	37	097	Iredell County, NC	2013	NA	79420	72776	6644	8.4
CN3709900000000	37	099	Jackson County, NC	2013	NA	18421	16804	1617	8.8
CN3710100000000	37	101	Johnston County, NC	2013	NA	84436	78453	5983	7.1
CN3710300000000	37	103	Jones County, NC	2013	NA	4539	4157	382	8.4
CN3710500000000	37	105	Lee County, NC	2013	NA	26079	23433	2646	10.1
CN3710700000000	37	107	Lenoir County, NC	2013	NA	28502	26023	2479	8.7
CN3710900000000	37	109	Lincoln County, NC	2013	NA	39874	36584	3290	8.3
CN3711100000000	37	111	McDowell County, NC	2013	NA	20426	18593	1833	9
CN3711300000000	37	113	Macon County, NC	2013	NA	15200	13812	1388	9.1
CN3711500000000	37	115	Madison County, NC	2013	NA	9486	8710	776	8.2
CN3711700000000	37	117	Martin County, NC	2013	NA	10106	9049	1057	10.5
CN3711900000000	37	119	Mecklenburg County, NC	2013	NA	537143	496753	40390	7.5
CN3712100000000	37	121	Mitchell County, NC	2013	NA	6668	5935	733	11
CN3712300000000	37	123	Montgomery County, NC	2013	NA	11679	10711	968	8.3
CN3712500000000	37	125	Moore County, NC	2013	NA	37899	34956	2943	7.8
CN3712700000000	37	127	Nash County, NC	2013	NA	45333	40644	4689	10.3
CN3712900000000	37	129	New Hanover County, NC	2013	NA	109520	101245	8275	7.6
CN3713100000000	37	131	Northampton County, NC	2013	NA	8159	7344	815	10
CN3713300000000	37	133	Onslow County, NC	2013	NA	64041	59535	4506	7
CN3713500000000	37	135	Orange County, NC	2013	NA	72648	68785	3863	5.3
CN3713700000000	37	137	Pamlico County, NC	2013	NA	5330	4883	447	8.4
CN3713900000000	37	139	Pasquotank County, NC	2013	NA	17676	15973	1703	9.6
CN3714100000000	37	141	Pender County, NC	2013	NA	25025	22765	2260	9
CN3714300000000	37	143	Perquimans County, NC	2013	NA	5223	4722	501	9.6
CN3714500000000	37	145	Person County, NC	2013	NA	18290	16445	1845	10.1
CN3714700000000	37	147	Pitt County, NC	2013	NA	87887	80794	7093	8.1
CN3714900000000	37	149	Polk County, NC	2013	NA	8666	8091	575	6.6
CN3715100000000	37	151	Randolph County, NC	2013	NA	67952	62081	5871	8.6
CN3715300000000	37	153	Richmond County, NC	2013	NA	17436	15386	2050	11.8
CN3715500000000	37	155	Robeson County, NC	2013	NA	52119	45939	6180	11.9
CN3715700000000	37	157	Rockingham County, NC	2013	NA	42156	38076	4080	9.7
CN3715900000000	37	159	Rowan County, NC	2013	NA	62823	56994	5829	9.3
CN3716100000000	37	161	Rutherford County, NC	2013	NA	25935	23039	2896	11.2
CN3716300000000	37	163	Sampson County, NC	2013	NA	29661	27265	2396	8.1
CN3716500000000	37	165	Scotland County, NC	2013	NA	12250	10404	1846	15.1
CN3716700000000	37	167	Stanly County, NC	2013	NA	28855	26498	2357	8.2
CN3716900000000	37	169	Stokes County, NC	2013	NA	22180	20437	1743	7.9
CN3717100000000	37	171	Surry County, NC	2013	NA	33280	30507	2773	8.3
CN3717300000000	37	173	Swain County, NC	2013	NA	6598	5782	816	12.4
CN3717500000000	37	175	Transylvania County, NC	2013	NA	13397	12405	992	7.4
CN3717700000000	37	177	Tyrrell County, NC	2013	NA	1562	1360	202	12.9
CN3717900000000	37	179	Union County, NC	2013	NA	105688	98763	6925	6.6
CN3718100000000	37	181	Vance County, NC	2013	NA	18128	16045	2083	11.5
CN3718300000000	37	183	Wake County, NC	2013	NA	511268	480573	30695	6
CN3718500000000	37	185	Warren County, NC	2013	NA	7301	6501	800	11
CN3718700000000	37	187	Washington County, NC	2013	NA	5300	4640	660	12.5
CN3718900000000	37	189	Watauga County, NC	2013	NA	26955	25233	1722	6.4
CN3719100000000	37	191	Wayne County, NC	2013	NA	54777	50520	4257	7.8
CN3719300000000	37	193	Wilkes County, NC	2013	NA	29954	27278	2676	8.9
CN3719500000000	37	195	Wilson County, NC	2013	NA	38146	33663	4483	11.8
CN3719700000000	37	197	Yadkin County, NC	2013	NA	17877	16497	1380	7.7
CN3719900000000	37	199	Yancey County, NC	2013	NA	7807	7064	743	9.5
CN3800100000000	38	001	Adams County, ND	2013	NA	1111	1083	28	2.5
CN3800300000000	38	003	Barnes County, ND	2013	NA	5713	5530	183	3.2
CN3800500000000	38	005	Benson County, ND	2013	NA	2549	2355	194	7.6
CN3800700000000	38	007	Billings County, ND	2013	NA	475	461	14	2.9
CN3800900000000	38	009	Bottineau County, ND	2013	NA	3260	3134	126	3.9
CN3801100000000	38	011	Bowman County, ND	2013	NA	1999	1959	40	2
CN3801300000000	38	013	Burke County, ND	2013	NA	1388	1358	30	2.2
CN3801500000000	38	015	Burleigh County, ND	2013	NA	47344	46166	1178	2.5
CN3801700000000	38	017	Cass County, ND	2013	NA	91442	88921	2521	2.8
CN3801900000000	38	019	Cavalier County, ND	2013	NA	2077	2008	69	3.3
CN3802100000000	38	021	Dickey County, ND	2013	NA	2661	2599	62	2.3
CN3802300000000	38	023	Divide County, ND	2013	NA	1774	1749	25	1.4
CN3802500000000	38	025	Dunn County, ND	2013	NA	4107	4049	58	1.4
CN3802700000000	38	027	Eddy County, ND	2013	NA	1271	1195	76	6
CN3802900000000	38	029	Emmons County, ND	2013	NA	1591	1506	85	5.3
CN3803100000000	38	031	Foster County, ND	2013	NA	1634	1578	56	3.4
CN3803300000000	38	033	Golden Valley County, ND	2013	NA	973	951	22	2.3
CN3803500000000	38	035	Grand Forks County, ND	2013	NA	37216	36083	1133	3
CN3803700000000	38	037	Grant County, ND	2013	NA	1275	1238	37	2.9
CN3803900000000	38	039	Griggs County, ND	2013	NA	1202	1174	28	2.3
CN3804100000000	38	041	Hettinger County, ND	2013	NA	1479	1440	39	2.6
CN3804300000000	38	043	Kidder County, ND	2013	NA	1256	1197	59	4.7
CN3804500000000	38	045	LaMoure County, ND	2013	NA	2238	2187	51	2.3
CN3804700000000	38	047	Logan County, ND	2013	NA	918	890	28	3.1
CN3804900000000	38	049	McHenry County, ND	2013	NA	3292	3155	137	4.2
CN3805100000000	38	051	McIntosh County, ND	2013	NA	1251	1213	38	3
CN3805300000000	38	053	McKenzie County, ND	2013	NA	7561	7448	113	1.5
CN3805500000000	38	055	McLean County, ND	2013	NA	4825	4622	203	4.2
CN3805700000000	38	057	Mercer County, ND	2013	NA	4170	3978	192	4.6
CN3805900000000	38	059	Morton County, ND	2013	NA	15781	15258	523	3.3
CN3806100000000	38	061	Mountrail County, ND	2013	NA	8007	7884	123	1.5
CN3806300000000	38	063	Nelson County, ND	2013	NA	1555	1488	67	4.3
CN3806500000000	38	065	Oliver County, ND	2013	NA	891	837	54	6.1
CN3806700000000	38	067	Pembina County, ND	2013	NA	3627	3407	220	6.1
CN3806900000000	38	069	Pierce County, ND	2013	NA	1830	1753	77	4.2
CN3807100000000	38	071	Ramsey County, ND	2013	NA	5753	5536	217	3.8
CN3807300000000	38	073	Ransom County, ND	2013	NA	2768	2688	80	2.9
CN3807500000000	38	075	Renville County, ND	2013	NA	1403	1369	34	2.4
CN3807700000000	38	077	Richland County, ND	2013	NA	8580	8291	289	3.4
CN3807900000000	38	079	Rolette County, ND	2013	NA	4896	4291	605	12.4
CN3808100000000	38	081	Sargent County, ND	2013	NA	2140	2086	54	2.5
CN3808300000000	38	083	Sheridan County, ND	2013	NA	718	689	29	4
CN3808500000000	38	085	Sioux County, ND	2013	NA	1315	1254	61	4.6
CN3808700000000	38	087	Slope County, ND	2013	NA	523	512	11	2.1
CN3808900000000	38	089	Stark County, ND	2013	NA	19479	19149	330	1.7
CN3809100000000	38	091	Steele County, ND	2013	NA	1042	1017	25	2.4
CN3809300000000	38	093	Stutsman County, ND	2013	NA	10503	10174	329	3.1
CN3809500000000	38	095	Towner County, ND	2013	NA	1215	1168	47	3.9
CN3809700000000	38	097	Traill County, ND	2013	NA	4502	4372	130	2.9
CN3809900000000	38	099	Walsh County, ND	2013	NA	5627	5348	279	5
CN3810100000000	38	101	Ward County, ND	2013	NA	34493	33558	935	2.7
CN3810300000000	38	103	Wells County, ND	2013	NA	2215	2119	96	4.3
CN3810500000000	38	105	Williams County, ND	2013	NA	29283	28922	361	1.2
CN3900100000000	39	001	Adams County, OH	2013	NA	10693	9333	1360	12.7
CN3900300000000	39	003	Allen County, OH	2013	NA	49469	45593	3876	7.8
CN3900500000000	39	005	Ashland County, OH	2013	NA	25526	23459	2067	8.1
CN3900700000000	39	007	Ashtabula County, OH	2013	NA	46023	41653	4370	9.5
CN3900900000000	39	009	Athens County, OH	2013	NA	27507	25027	2480	9
CN3901100000000	39	011	Auglaize County, OH	2013	NA	23963	22547	1416	5.9
CN3901300000000	39	013	Belmont County, OH	2013	NA	31961	29328	2633	8.2
CN3901500000000	39	015	Brown County, OH	2013	NA	20086	18043	2043	10.2
CN3901700000000	39	017	Butler County, OH	2013	NA	186298	172339	13959	7.5
CN3901900000000	39	019	Carroll County, OH	2013	NA	13701	12618	1083	7.9
CN3902100000000	39	021	Champaign County, OH	2013	NA	20016	18632	1384	6.9
CN3902300000000	39	023	Clark County, OH	2013	NA	65934	60980	4954	7.5
CN3902500000000	39	025	Clermont County, OH	2013	NA	102499	94956	7543	7.4
CN3902700000000	39	027	Clinton County, OH	2013	NA	17092	15306	1786	10.4
CN3902900000000	39	029	Columbiana County, OH	2013	NA	50566	46402	4164	8.2
CN3903100000000	39	031	Coshocton County, OH	2013	NA	16354	14756	1598	9.8
CN3903300000000	39	033	Crawford County, OH	2013	NA	19717	17910	1807	9.2
CN3903500000000	39	035	Cuyahoga County, OH	2013	NA	621938	578643	43295	7
CN3903700000000	39	037	Darke County, OH	2013	NA	26400	24550	1850	7
CN3903900000000	39	039	Defiance County, OH	2013	NA	18938	17518	1420	7.5
CN3904100000000	39	041	Delaware County, OH	2013	NA	98089	92856	5233	5.3
CN3904300000000	39	043	Erie County, OH	2013	NA	38552	35423	3129	8.1
CN3904500000000	39	045	Fairfield County, OH	2013	NA	74047	69122	4925	6.7
CN3904700000000	39	047	Fayette County, OH	2013	NA	14379	13276	1103	7.7
CN3904900000000	39	049	Franklin County, OH	2013	NA	638834	597678	41156	6.4
CN3905100000000	39	051	Fulton County, OH	2013	NA	22451	20669	1782	7.9
CN3905300000000	39	053	Gallia County, OH	2013	NA	12514	11301	1213	9.7
CN3905500000000	39	055	Geauga County, OH	2013	NA	49259	46455	2804	5.7
CN3905700000000	39	057	Greene County, OH	2013	NA	79411	73867	5544	7
CN3905900000000	39	059	Guernsey County, OH	2013	NA	18546	16937	1609	8.7
CN3906100000000	39	061	Hamilton County, OH	2013	NA	402433	373075	29358	7.3
CN3906300000000	39	063	Hancock County, OH	2013	NA	40198	37697	2501	6.2
CN3906500000000	39	065	Hardin County, OH	2013	NA	14935	13783	1152	7.7
CN3906700000000	39	067	Harrison County, OH	2013	NA	7290	6712	578	7.9
CN3906900000000	39	069	Henry County, OH	2013	NA	14026	12787	1239	8.8
CN3907100000000	39	071	Highland County, OH	2013	NA	17509	15674	1835	10.5
CN3907300000000	39	073	Hocking County, OH	2013	NA	13199	12129	1070	8.1
CN3907500000000	39	075	Holmes County, OH	2013	NA	20046	19000	1046	5.2
CN3907700000000	39	077	Huron County, OH	2013	NA	28662	25729	2933	10.2
CN3907900000000	39	079	Jackson County, OH	2013	NA	13604	12173	1431	10.5
CN3908100000000	39	081	Jefferson County, OH	2013	NA	30601	27268	3333	10.9
CN3908300000000	39	083	Knox County, OH	2013	NA	30388	28293	2095	6.9
CN3908500000000	39	085	Lake County, OH	2013	NA	125690	117860	7830	6.2
CN3908700000000	39	087	Lawrence County, OH	2013	NA	26127	23831	2296	8.8
CN3908900000000	39	089	Licking County, OH	2013	NA	86490	80506	5984	6.9
CN3909100000000	39	091	Logan County, OH	2013	NA	23045	21468	1577	6.8
CN3909300000000	39	093	Lorain County, OH	2013	NA	151036	139963	11073	7.3
CN3909500000000	39	095	Lucas County, OH	2013	NA	210736	192447	18289	8.7
CN3909700000000	39	097	Madison County, OH	2013	NA	20234	18968	1266	6.3
CN3909900000000	39	099	Mahoning County, OH	2013	NA	109548	100196	9352	8.5
CN3910100000000	39	101	Marion County, OH	2013	NA	28132	25909	2223	7.9
CN3910300000000	39	103	Medina County, OH	2013	NA	95022	89543	5479	5.8
CN3910500000000	39	105	Meigs County, OH	2013	NA	9414	8297	1117	11.9
CN3910700000000	39	107	Mercer County, OH	2013	NA	22395	21248	1147	5.1
CN3910900000000	39	109	Miami County, OH	2013	NA	51861	48121	3740	7.2
CN3911100000000	39	111	Monroe County, OH	2013	NA	6483	5835	648	10
CN3911300000000	39	113	Montgomery County, OH	2013	NA	251314	230464	20850	8.3
CN3911500000000	39	115	Morgan County, OH	2013	NA	6692	6017	675	10.1
CN3911700000000	39	117	Morrow County, OH	2013	NA	16896	15539	1357	8
CN3911900000000	39	119	Muskingum County, OH	2013	NA	39959	36308	3651	9.1
CN3912100000000	39	121	Noble County, OH	2013	NA	5289	4779	510	9.6
CN3912300000000	39	123	Ottawa County, OH	2013	NA	21969	19837	2132	9.7
CN3912500000000	39	125	Paulding County, OH	2013	NA	9021	8332	689	7.6
CN3912700000000	39	127	Perry County, OH	2013	NA	16068	14527	1541	9.6
CN3912900000000	39	129	Pickaway County, OH	2013	NA	25657	23782	1875	7.3
CN3913100000000	39	131	Pike County, OH	2013	NA	10768	9451	1317	12.2
CN3913300000000	39	133	Portage County, OH	2013	NA	87710	80952	6758	7.7
CN3913500000000	39	135	Preble County, OH	2013	NA	21306	19699	1607	7.5
CN3913700000000	39	137	Putnam County, OH	2013	NA	18816	17684	1132	6
CN3913900000000	39	139	Richland County, OH	2013	NA	54943	50214	4729	8.6
CN3914100000000	39	141	Ross County, OH	2013	NA	33507	30593	2914	8.7
CN3914300000000	39	143	Sandusky County, OH	2013	NA	31562	29173	2389	7.6
CN3914500000000	39	145	Scioto County, OH	2013	NA	30349	26730	3619	11.9
CN3914700000000	39	147	Seneca County, OH	2013	NA	27411	25285	2126	7.8
CN3914900000000	39	149	Shelby County, OH	2013	NA	23761	22169	1592	6.7
CN3915100000000	39	151	Stark County, OH	2013	NA	189051	174746	14305	7.6
CN3915300000000	39	153	Summit County, OH	2013	NA	271165	250484	20681	7.6
CN3915500000000	39	155	Trumbull County, OH	2013	NA	94552	85711	8841	9.4
CN3915700000000	39	157	Tuscarawas County, OH	2013	NA	45049	41768	3281	7.3
CN3915900000000	39	159	Union County, OH	2013	NA	26626	25075	1551	5.8
CN3916100000000	39	161	Van Wert County, OH	2013	NA	14212	13223	989	7
CN3916300000000	39	163	Vinton County, OH	2013	NA	5578	4983	595	10.7
CN3916500000000	39	165	Warren County, OH	2013	NA	109855	102770	7085	6.4
CN3916700000000	39	167	Washington County, OH	2013	NA	28367	25927	2440	8.6
CN3916900000000	39	169	Wayne County, OH	2013	NA	59320	55625	3695	6.2
CN3917100000000	39	171	Williams County, OH	2013	NA	18654	17264	1390	7.5
CN3917300000000	39	173	Wood County, OH	2013	NA	69091	64239	4852	7
CN3917500000000	39	175	Wyandot County, OH	2013	NA	12358	11576	782	6.3
CN4000100000000	40	001	Adair County, OK	2013	NA	8268	7458	810	9.8
CN4000300000000	40	003	Alfalfa County, OK	2013	NA	2935	2839	96	3.3
CN4000500000000	40	005	Atoka County, OK	2013	NA	4913	4575	338	6.9
CN4000700000000	40	007	Beaver County, OK	2013	NA	3026	2924	102	3.4
CN4000900000000	40	009	Beckham County, OK	2013	NA	12591	12178	413	3.3
CN4001100000000	40	011	Blaine County, OK	2013	NA	4319	4146	173	4
CN4001300000000	40	013	Bryan County, OK	2013	NA	17738	16771	967	5.5
CN4001500000000	40	015	Caddo County, OK	2013	NA	11382	10668	714	6.3
CN4001700000000	40	017	Canadian County, OK	2013	NA	64764	62100	2664	4.1
CN4001900000000	40	019	Carter County, OK	2013	NA	22035	20864	1171	5.3
CN4002100000000	40	021	Cherokee County, OK	2013	NA	18732	17429	1303	7
CN4002300000000	40	023	Choctaw County, OK	2013	NA	5976	5468	508	8.5
CN4002500000000	40	025	Cimarron County, OK	2013	NA	1233	1193	40	3.2
CN4002700000000	40	027	Cleveland County, OK	2013	NA	137044	131186	5858	4.3
CN4002900000000	40	029	Coal County, OK	2013	NA	2253	2082	171	7.6
CN4003100000000	40	031	Comanche County, OK	2013	NA	50119	47228	2891	5.8
CN4003300000000	40	033	Cotton County, OK	2013	NA	2862	2701	161	5.6
CN4003500000000	40	035	Craig County, OK	2013	NA	6245	5840	405	6.5
CN4003700000000	40	037	Creek County, OK	2013	NA	31249	29367	1882	6
CN4003900000000	40	039	Custer County, OK	2013	NA	16021	15431	590	3.7
CN4004100000000	40	041	Delaware County, OK	2013	NA	16990	15817	1173	6.9
CN4004300000000	40	043	Dewey County, OK	2013	NA	2595	2505	90	3.5
CN4004500000000	40	045	Ellis County, OK	2013	NA	2333	2260	73	3.1
CN4004700000000	40	047	Garfield County, OK	2013	NA	29436	28225	1211	4.1
CN4004900000000	40	049	Garvin County, OK	2013	NA	12456	11835	621	5
CN4005100000000	40	051	Grady County, OK	2013	NA	25532	24317	1215	4.8
CN4005300000000	40	053	Grant County, OK	2013	NA	2661	2572	89	3.3
CN4005500000000	40	055	Greer County, OK	2013	NA	1998	1891	107	5.4
CN4005700000000	40	057	Harmon County, OK	2013	NA	1348	1290	58	4.3
CN4005900000000	40	059	Harper County, OK	2013	NA	1919	1855	64	3.3
CN4006100000000	40	061	Haskell County, OK	2013	NA	4475	4064	411	9.2
CN4006300000000	40	063	Hughes County, OK	2013	NA	5739	5280	459	8
CN4006500000000	40	065	Jackson County, OK	2013	NA	10828	10246	582	5.4
CN4006700000000	40	067	Jefferson County, OK	2013	NA	2582	2446	136	5.3
CN4006900000000	40	069	Johnston County, OK	2013	NA	3587	3295	292	8.1
CN4007100000000	40	071	Kay County, OK	2013	NA	19986	18607	1379	6.9
CN4007300000000	40	073	Kingfisher County, OK	2013	NA	7786	7517	269	3.5
CN4007500000000	40	075	Kiowa County, OK	2013	NA	4150	3947	203	4.9
CN4007700000000	40	077	Latimer County, OK	2013	NA	4145	3777	368	8.9
CN4007900000000	40	079	Le Flore County, OK	2013	NA	19765	18009	1756	8.9
CN4008100000000	40	081	Lincoln County, OK	2013	NA	15467	14672	795	5.1
CN4008300000000	40	083	Logan County, OK	2013	NA	20749	19807	942	4.5
CN4008500000000	40	085	Love County, OK	2013	NA	5251	5022	229	4.4
CN4008700000000	40	087	McClain County, OK	2013	NA	17828	17050	778	4.4
CN4008900000000	40	089	McCurtain County, OK	2013	NA	14336	12992	1344	9.4
CN4009100000000	40	091	McIntosh County, OK	2013	NA	7397	6670	727	9.8
CN4009300000000	40	093	Major County, OK	2013	NA	4130	3991	139	3.4
CN4009500000000	40	095	Marshall County, OK	2013	NA	6956	6555	401	5.8
CN4009700000000	40	097	Mayes County, OK	2013	NA	18855	17764	1091	5.8
CN4009900000000	40	099	Murray County, OK	2013	NA	6474	6149	325	5
CN4010100000000	40	101	Muskogee County, OK	2013	NA	29712	27790	1922	6.5
CN4010300000000	40	103	Noble County, OK	2013	NA	5474	5232	242	4.4
CN4010500000000	40	105	Nowata County, OK	2013	NA	4820	4494	326	6.8
CN4010700000000	40	107	Okfuskee County, OK	2013	NA	4423	4110	313	7.1
CN4010900000000	40	109	Oklahoma County, OK	2013	NA	368547	350727	17820	4.8
CN4011100000000	40	111	Okmulgee County, OK	2013	NA	16247	15017	1230	7.6
CN4011300000000	40	113	Osage County, OK	2013	NA	21114	19885	1229	5.8
CN4011500000000	40	115	Ottawa County, OK	2013	NA	14143	13005	1138	8
CN4011700000000	40	117	Pawnee County, OK	2013	NA	7389	6942	447	6
CN4011900000000	40	119	Payne County, OK	2013	NA	37539	35878	1661	4.4
CN4012100000000	40	121	Pittsburg County, OK	2013	NA	17988	16675	1313	7.3
CN4012300000000	40	123	Pontotoc County, OK	2013	NA	17768	16797	971	5.5
CN4012500000000	40	125	Pottawatomie County, OK	2013	NA	32121	30370	1751	5.5
CN4012700000000	40	127	Pushmataha County, OK	2013	NA	4709	4291	418	8.9
CN4012900000000	40	129	Roger Mills County, OK	2013	NA	1878	1818	60	3.2
CN4013100000000	40	131	Rogers County, OK	2013	NA	43827	41595	2232	5.1
CN4013300000000	40	133	Seminole County, OK	2013	NA	9739	8943	796	8.2
CN4013500000000	40	135	Sequoyah County, OK	2013	NA	16866	15454	1412	8.4
CN4013700000000	40	137	Stephens County, OK	2013	NA	20607	19493	1114	5.4
CN4013900000000	40	139	Texas County, OK	2013	NA	9289	8882	407	4.4
CN4014100000000	40	141	Tillman County, OK	2013	NA	3369	3187	182	5.4
CN4014300000000	40	143	Tulsa County, OK	2013	NA	311042	295184	15858	5.1
CN4014500000000	40	145	Wagoner County, OK	2013	NA	35929	34108	1821	5.1
CN4014700000000	40	147	Washington County, OK	2013	NA	24628	23441	1187	4.8
CN4014900000000	40	149	Washita County, OK	2013	NA	5576	5342	234	4.2
CN4015100000000	40	151	Woods County, OK	2013	NA	5141	4974	167	3.2
CN4015300000000	40	153	Woodward County, OK	2013	NA	10735	10355	380	3.5
CN4100100000000	41	001	Baker County, OR	2013	NA	6798	6142	656	9.6
CN4100300000000	41	003	Benton County, OR	2013	NA	43861	41356	2505	5.7
CN4100500000000	41	005	Clackamas County, OR	2013	NA	196842	182940	13902	7.1
CN4100700000000	41	007	Clatsop County, OR	2013	NA	17859	16470	1389	7.8
CN4100900000000	41	009	Columbia County, OR	2013	NA	22297	20150	2147	9.6
CN4101100000000	41	011	Coos County, OR	2013	NA	26336	23640	2696	10.2
CN4101300000000	41	013	Crook County, OR	2013	NA	8908	7830	1078	12.1
CN4101500000000	41	015	Curry County, OR	2013	NA	8639	7722	917	10.6
CN4101700000000	41	017	Deschutes County, OR	2013	NA	78225	70780	7445	9.5
CN4101900000000	41	019	Douglas County, OR	2013	NA	44120	39463	4657	10.6
CN4102100000000	41	021	Gilliam County, OR	2013	NA	849	768	81	9.5
CN4102300000000	41	023	Grant County, OR	2013	NA	3188	2794	394	12.4
CN4102500000000	41	025	Harney County, OR	2013	NA	3323	2939	384	11.6
CN4102700000000	41	027	Hood River County, OR	2013	NA	13728	12859	869	6.3
CN4102900000000	41	029	Jackson County, OR	2013	NA	95941	86594	9347	9.7
CN4103100000000	41	031	Jefferson County, OR	2013	NA	9215	8253	962	10.4
CN4103300000000	41	033	Josephine County, OR	2013	NA	32200	28636	3564	11.1
CN4103500000000	41	035	Klamath County, OR	2013	NA	28848	25741	3107	10.8
CN4103700000000	41	037	Lake County, OR	2013	NA	3467	3073	394	11.4
CN4103900000000	41	039	Lane County, OR	2013	NA	167538	154123	13415	8
CN4104100000000	41	041	Lincoln County, OR	2013	NA	20605	18792	1813	8.8
CN4104300000000	41	043	Linn County, OR	2013	NA	53526	48355	5171	9.7
CN4104500000000	41	045	Malheur County, OR	2013	NA	12329	11284	1045	8.5
CN4104700000000	41	047	Marion County, OR	2013	NA	147319	134308	13011	8.8
CN4104900000000	41	049	Morrow County, OR	2013	NA	5530	5105	425	7.7
CN4105100000000	41	051	Multnomah County, OR	2013	NA	411694	383774	27920	6.8
CN4105300000000	41	053	Polk County, OR	2013	NA	34690	31889	2801	8.1
CN4105500000000	41	055	Sherman County, OR	2013	NA	864	784	80	9.3
CN4105700000000	41	057	Tillamook County, OR	2013	NA	10924	10010	914	8.4
CN4105900000000	41	059	Umatilla County, OR	2013	NA	35210	32108	3102	8.8
CN4106100000000	41	061	Union County, OR	2013	NA	11733	10744	989	8.4
CN4106300000000	41	063	Wallowa County, OR	2013	NA	3222	2863	359	11.1
CN4106500000000	41	065	Wasco County, OR	2013	NA	13690	12655	1035	7.6
CN4106700000000	41	067	Washington County, OR	2013	NA	287115	269048	18067	6.3
CN4106900000000	41	069	Wheeler County, OR	2013	NA	731	685	46	6.3
CN4107100000000	41	071	Yamhill County, OR	2013	NA	49342	45625	3717	7.5
CN4200100000000	42	001	Adams County, PA	2013	NA	55379	52136	3243	5.9
CN4200300000000	42	003	Allegheny County, PA	2013	NA	651471	608849	42622	6.5
CN4200500000000	42	005	Armstrong County, PA	2013	NA	33614	31036	2578	7.7
CN4200700000000	42	007	Beaver County, PA	2013	NA	86547	80293	6254	7.2
CN4200900000000	42	009	Bedford County, PA	2013	NA	24716	22646	2070	8.4
CN4201100000000	42	011	Berks County, PA	2013	NA	211349	196277	15072	7.1
CN4201300000000	42	013	Blair County, PA	2013	NA	61530	57240	4290	7
CN4201500000000	42	015	Bradford County, PA	2013	NA	31862	29539	2323	7.3
CN4201700000000	42	017	Bucks County, PA	2013	NA	337193	314955	22238	6.6
CN4201900000000	42	019	Butler County, PA	2013	NA	97878	91854	6024	6.2
CN4202100000000	42	021	Cambria County, PA	2013	NA	64646	59007	5639	8.7
CN4202300000000	42	023	Cameron County, PA	2013	NA	2355	2127	228	9.7
CN4202500000000	42	025	Carbon County, PA	2013	NA	32223	29221	3002	9.3
CN4202700000000	42	027	Centre County, PA	2013	NA	78023	73913	4110	5.3
CN4202900000000	42	029	Chester County, PA	2013	NA	273553	259105	14448	5.3
CN4203100000000	42	031	Clarion County, PA	2013	NA	18681	17167	1514	8.1
CN4203300000000	42	033	Clearfield County, PA	2013	NA	37794	34384	3410	9
CN4203500000000	42	035	Clinton County, PA	2013	NA	19289	17545	1744	9
CN4203700000000	42	037	Columbia County, PA	2013	NA	35338	32621	2717	7.7
CN4203900000000	42	039	Crawford County, PA	2013	NA	41793	38773	3020	7.2
CN4204100000000	42	041	Cumberland County, PA	2013	NA	125785	118599	7186	5.7
CN4204300000000	42	043	Dauphin County, PA	2013	NA	140474	130893	9581	6.8
CN4204500000000	42	045	Delaware County, PA	2013	NA	290497	270012	20485	7.1
CN4204700000000	42	047	Elk County, PA	2013	NA	16466	15342	1124	6.8
CN4204900000000	42	049	Erie County, PA	2013	NA	136005	125900	10105	7.4
CN4205100000000	42	051	Fayette County, PA	2013	NA	59733	53988	5745	9.6
CN4205300000000	42	053	Forest County, PA	2013	NA	1975	1779	196	9.9
CN4205500000000	42	055	Franklin County, PA	2013	NA	76621	71560	5061	6.6
CN4205700000000	42	057	Fulton County, PA	2013	NA	7407	6723	684	9.2
CN4205900000000	42	059	Greene County, PA	2013	NA	18767	17413	1354	7.2
CN4206100000000	42	061	Huntingdon County, PA	2013	NA	20339	18341	1998	9.8
CN4206300000000	42	063	Indiana County, PA	2013	NA	44099	40688	3411	7.7
CN4206500000000	42	065	Jefferson County, PA	2013	NA	21100	19366	1734	8.2
CN4206700000000	42	067	Juniata County, PA	2013	NA	12032	11175	857	7.1
CN4206900000000	42	069	Lackawanna County, PA	2013	NA	107648	98713	8935	8.3
CN4207100000000	42	071	Lancaster County, PA	2013	NA	270478	254195	16283	6
CN4207300000000	42	073	Lawrence County, PA	2013	NA	43048	39810	3238	7.5
CN4207500000000	42	075	Lebanon County, PA	2013	NA	70741	66344	4397	6.2
CN4207700000000	42	077	Lehigh County, PA	2013	NA	183266	168918	14348	7.8
CN4207900000000	42	079	Luzerne County, PA	2013	NA	160771	145695	15076	9.4
CN4208100000000	42	081	Lycoming County, PA	2013	NA	61872	57031	4841	7.8
CN4208300000000	42	083	McKean County, PA	2013	NA	19696	18087	1609	8.2
CN4208500000000	42	085	Mercer County, PA	2013	NA	53738	49855	3883	7.2
CN4208700000000	42	087	Mifflin County, PA	2013	NA	21390	19644	1746	8.2
CN4208900000000	42	089	Monroe County, PA	2013	NA	81573	73940	7633	9.4
CN4209100000000	42	091	Montgomery County, PA	2013	NA	435631	410096	25535	5.9
CN4209300000000	42	093	Montour County, PA	2013	NA	9465	8947	518	5.5
CN4209500000000	42	095	Northampton County, PA	2013	NA	155747	144230	11517	7.4
CN4209700000000	42	097	Northumberland County, PA	2013	NA	44732	40820	3912	8.7
CN4209900000000	42	099	Perry County, PA	2013	NA	24261	22674	1587	6.5
CN4210100000000	42	101	Philadelphia County/city, PA	2013	NA	698341	626447	71894	10.3
CN4210300000000	42	103	Pike County, PA	2013	NA	25830	23335	2495	9.7
CN4210500000000	42	105	Potter County, PA	2013	NA	7750	7029	721	9.3
CN4210700000000	42	107	Schuylkill County, PA	2013	NA	70247	63787	6460	9.2
CN4210900000000	42	109	Snyder County, PA	2013	NA	19745	18389	1356	6.9
CN4211100000000	42	111	Somerset County, PA	2013	NA	35811	32504	3307	9.2
CN4211300000000	42	113	Sullivan County, PA	2013	NA	3058	2805	253	8.3
CN4211500000000	42	115	Susquehanna County, PA	2013	NA	22343	20750	1593	7.1
CN4211700000000	42	117	Tioga County, PA	2013	NA	21269	19446	1823	8.6
CN4211900000000	42	119	Union County, PA	2013	NA	19150	17936	1214	6.3
CN4212100000000	42	121	Venango County, PA	2013	NA	25271	23308	1963	7.8
CN4212300000000	42	123	Warren County, PA	2013	NA	20427	19126	1301	6.4
CN4212500000000	42	125	Washington County, PA	2013	NA	107010	99585	7425	6.9
CN4212700000000	42	127	Wayne County, PA	2013	NA	22714	20928	1786	7.9
CN4212900000000	42	129	Westmoreland County, PA	2013	NA	186380	173353	13027	7
CN4213100000000	42	131	Wyoming County, PA	2013	NA	14327	13092	1235	8.6
CN4213300000000	42	133	York County, PA	2013	NA	232152	216526	15626	6.7
CN4400100000000	44	001	Bristol County, RI	2013	NA	26265	24187	2078	7.9
CN4400300000000	44	003	Kent County, RI	2013	NA	91867	83834	8033	8.7
CN4400500000000	44	005	Newport County, RI	2013	NA	44335	40569	3766	8.5
CN4400700000000	44	007	Providence County, RI	2013	NA	324614	292953	31661	9.8
CN4400900000000	44	009	Washington County, RI	2013	NA	69847	63828	6019	8.6
CN4500100000000	45	001	Abbeville County, SC	2013	NA	10543	9540	1003	9.5
CN4500300000000	45	003	Aiken County, SC	2013	NA	72660	67173	5487	7.6
CN4500500000000	45	005	Allendale County, SC	2013	NA	3092	2658	434	14
CN4500700000000	45	007	Anderson County, SC	2013	NA	85793	79702	6091	7.1
CN4500900000000	45	009	Bamberg County, SC	2013	NA	5580	4827	753	13.5
CN4501100000000	45	011	Barnwell County, SC	2013	NA	8716	7660	1056	12.1
CN4501300000000	45	013	Beaufort County, SC	2013	NA	67239	62946	4293	6.4
CN4501500000000	45	015	Berkeley County, SC	2013	NA	88891	82678	6213	7
CN4501700000000	45	017	Calhoun County, SC	2013	NA	6930	6266	664	9.6
CN4501900000000	45	019	Charleston County, SC	2013	NA	187570	176533	11037	5.9
CN4502100000000	45	021	Cherokee County, SC	2013	NA	23727	21241	2486	10.5
CN4502300000000	45	023	Chester County, SC	2013	NA	13675	12005	1670	12.2
CN4502500000000	45	025	Chesterfield County, SC	2013	NA	20991	19066	1925	9.2
CN4502700000000	45	027	Clarendon County, SC	2013	NA	12981	11643	1338	10.3
CN4502900000000	45	029	Colleton County, SC	2013	NA	16338	14716	1622	9.9
CN4503100000000	45	031	Darlington County, SC	2013	NA	30085	27276	2809	9.3
CN4503300000000	45	033	Dillon County, SC	2013	NA	12757	11248	1509	11.8
CN4503500000000	45	035	Dorchester County, SC	2013	NA	68615	64078	4537	6.6
CN4503700000000	45	037	Edgefield County, SC	2013	NA	10518	9671	847	8.1
CN4503900000000	45	039	Fairfield County, SC	2013	NA	10096	9011	1085	10.7
CN4504100000000	45	041	Florence County, SC	2013	NA	64910	59546	5364	8.3
CN4504300000000	45	043	Georgetown County, SC	2013	NA	24370	21897	2473	10.1
CN4504500000000	45	045	Greenville County, SC	2013	NA	230748	216668	14080	6.1
CN4504700000000	45	047	Greenwood County, SC	2013	NA	31544	28826	2718	8.6
CN4504900000000	45	049	Hampton County, SC	2013	NA	8346	7571	775	9.3
CN4505100000000	45	051	Horry County, SC	2013	NA	132824	121377	11447	8.6
CN4505300000000	45	053	Jasper County, SC	2013	NA	11177	10405	772	6.9
CN4505500000000	45	055	Kershaw County, SC	2013	NA	27933	25752	2181	7.8
CN4505700000000	45	057	Lancaster County, SC	2013	NA	34303	31119	3184	9.3
CN4505900000000	45	059	Laurens County, SC	2013	NA	29889	27330	2559	8.6
CN4506100000000	45	061	Lee County, SC	2013	NA	6562	5838	724	11
CN4506300000000	45	063	Lexington County, SC	2013	NA	137482	129529	7953	5.8
CN4506500000000	45	065	McCormick County, SC	2013	NA	3505	3161	344	9.8
CN4506700000000	45	067	Marion County, SC	2013	NA	13048	11342	1706	13.1
CN4506900000000	45	069	Marlboro County, SC	2013	NA	10509	9061	1448	13.8
CN4507100000000	45	071	Newberry County, SC	2013	NA	17934	16632	1302	7.3
CN4507300000000	45	073	Oconee County, SC	2013	NA	33189	30647	2542	7.7
CN4507500000000	45	075	Orangeburg County, SC	2013	NA	38527	33764	4763	12.4
CN4507700000000	45	077	Pickens County, SC	2013	NA	54650	50614	4036	7.4
CN4507900000000	45	079	Richland County, SC	2013	NA	190577	177504	13073	6.9
CN4508100000000	45	081	Saluda County, SC	2013	NA	8569	7976	593	6.9
CN4508300000000	45	083	Spartanburg County, SC	2013	NA	135553	125081	10472	7.7
CN4508500000000	45	085	Sumter County, SC	2013	NA	44194	40331	3863	8.7
CN4508700000000	45	087	Union County, SC	2013	NA	11730	10406	1324	11.3
CN4508900000000	45	089	Williamsburg County, SC	2013	NA	12675	11090	1585	12.5
CN4509100000000	45	091	York County, SC	2013	NA	119431	110241	9190	7.7
CN4600300000000	46	003	Aurora County, SD	2013	NA	1640	1596	44	2.7
CN4600500000000	46	005	Beadle County, SD	2013	NA	9447	9110	337	3.6
CN4600700000000	46	007	Bennett County, SD	2013	NA	1132	1060	72	6.4
CN4600900000000	46	009	Bon Homme County, SD	2013	NA	2994	2897	97	3.2
CN4601100000000	46	011	Brookings County, SD	2013	NA	17711	17107	604	3.4
CN4601300000000	46	013	Brown County, SD	2013	NA	20885	20206	679	3.3
CN4601500000000	46	015	Brule County, SD	2013	NA	2596	2507	89	3.4
CN4601700000000	46	017	Buffalo County, SD	2013	NA	737	672	65	8.8
CN4601900000000	46	019	Butte County, SD	2013	NA	5023	4828	195	3.9
CN4602100000000	46	021	Campbell County, SD	2013	NA	840	810	30	3.6
CN4602300000000	46	023	Charles Mix County, SD	2013	NA	3983	3810	173	4.3
CN4602500000000	46	025	Clark County, SD	2013	NA	1972	1895	77	3.9
CN4602700000000	46	027	Clay County, SD	2013	NA	7062	6802	260	3.7
CN4602900000000	46	029	Codington County, SD	2013	NA	15402	14851	551	3.6
CN4603100000000	46	031	Corson County, SD	2013	NA	1504	1400	104	6.9
CN4603300000000	46	033	Custer County, SD	2013	NA	4012	3808	204	5.1
CN4603500000000	46	035	Davison County, SD	2013	NA	11196	10847	349	3.1
CN4603700000000	46	037	Day County, SD	2013	NA	2912	2759	153	5.3
CN4603900000000	46	039	Deuel County, SD	2013	NA	2374	2241	133	5.6
CN4604100000000	46	041	Dewey County, SD	2013	NA	2413	2039	374	15.5
CN4604300000000	46	043	Douglas County, SD	2013	NA	1699	1645	54	3.2
CN4604500000000	46	045	Edmunds County, SD	2013	NA	2276	2212	64	2.8
CN4604700000000	46	047	Fall River County, SD	2013	NA	3029	2877	152	5
CN4604900000000	46	049	Faulk County, SD	2013	NA	1158	1120	38	3.3
CN4605100000000	46	051	Grant County, SD	2013	NA	4630	4436	194	4.2
CN4605300000000	46	053	Gregory County, SD	2013	NA	2093	2011	82	3.9
CN4605500000000	46	055	Haakon County, SD	2013	NA	1077	1046	31	2.9
CN4605700000000	46	057	Hamlin County, SD	2013	NA	3106	2999	107	3.4
CN4605900000000	46	059	Hand County, SD	2013	NA	1821	1771	50	2.7
CN4606100000000	46	061	Hanson County, SD	2013	NA	1799	1724	75	4.2
CN4606300000000	46	063	Harding County, SD	2013	NA	771	749	22	2.9
CN4606500000000	46	065	Hughes County, SD	2013	NA	9871	9584	287	2.9
CN4606700000000	46	067	Hutchinson County, SD	2013	NA	3654	3535	119	3.3
CN4606900000000	46	069	Hyde County, SD	2013	NA	716	692	24	3.4
CN4607100000000	46	071	Jackson County, SD	2013	NA	1307	1226	81	6.2
CN4607300000000	46	073	Jerauld County, SD	2013	NA	1192	1155	37	3.1
CN4607500000000	46	075	Jones County, SD	2013	NA	618	596	22	3.6
CN4607700000000	46	077	Kingsbury County, SD	2013	NA	2873	2780	93	3.2
CN4607900000000	46	079	Lake County, SD	2013	NA	6293	6050	243	3.9
CN4608100000000	46	081	Lawrence County, SD	2013	NA	12643	12144	499	3.9
CN4608300000000	46	083	Lincoln County, SD	2013	NA	28507	27734	773	2.7
CN4608500000000	46	085	Lyman County, SD	2013	NA	1854	1765	89	4.8
CN4608700000000	46	087	McCook County, SD	2013	NA	3162	3060	102	3.2
CN4608900000000	46	089	McPherson County, SD	2013	NA	1131	1088	43	3.8
CN4609100000000	46	091	Marshall County, SD	2013	NA	2535	2423	112	4.4
CN4609300000000	46	093	Meade County, SD	2013	NA	13518	13004	514	3.8
CN4609500000000	46	095	Mellette County, SD	2013	NA	831	768	63	7.6
CN4609700000000	46	097	Miner County, SD	2013	NA	1231	1186	45	3.7
CN4609900000000	46	099	Minnehaha County, SD	2013	NA	102441	99051	3390	3.3
CN4610100000000	46	101	Moody County, SD	2013	NA	3986	3803	183	4.6
CN4610200000000	46	102	Oglala Lakota County, SD	2013	NA	3664	3168	496	13.5
CN4610300000000	46	103	Pennington County, SD	2013	NA	53179	51108	2071	3.9
CN4610500000000	46	105	Perkins County, SD	2013	NA	1531	1474	57	3.7
CN4610700000000	46	107	Potter County, SD	2013	NA	1199	1153	46	3.8
CN4610900000000	46	109	Roberts County, SD	2013	NA	4823	4572	251	5.2
CN4611100000000	46	111	Sanborn County, SD	2013	NA	1288	1249	39	3
CN4611500000000	46	115	Spink County, SD	2013	NA	3327	3208	119	3.6
CN4611700000000	46	117	Stanley County, SD	2013	NA	1851	1800	51	2.8
CN4611900000000	46	119	Sully County, SD	2013	NA	880	854	26	3
CN4612100000000	46	121	Todd County, SD	2013	NA	3175	2864	311	9.8
CN4612300000000	46	123	Tripp County, SD	2013	NA	3087	2980	107	3.5
CN4612500000000	46	125	Turner County, SD	2013	NA	4707	4564	143	3
CN4612700000000	46	127	Union County, SD	2013	NA	7860	7533	327	4.2
CN4612900000000	46	129	Walworth County, SD	2013	NA	2350	2222	128	5.4
CN4613500000000	46	135	Yankton County, SD	2013	NA	11480	11096	384	3.3
CN4613700000000	46	137	Ziebach County, SD	2013	NA	1028	964	64	6.2
CN4700100000000	47	001	Anderson County, TN	2013	NA	33670	31001	2669	7.9
CN4700300000000	47	003	Bedford County, TN	2013	NA	20010	18167	1843	9.2
CN4700500000000	47	005	Benton County, TN	2013	NA	6881	6207	674	9.8
CN4700700000000	47	007	Bledsoe County, TN	2013	NA	4336	3882	454	10.5
CN4700900000000	47	009	Blount County, TN	2013	NA	59248	55124	4124	7
CN4701100000000	47	011	Bradley County, TN	2013	NA	49460	45942	3518	7.1
CN4701300000000	47	013	Campbell County, TN	2013	NA	15240	13551	1689	11.1
CN4701500000000	47	015	Cannon County, TN	2013	NA	5901	5435	466	7.9
CN4701700000000	47	017	Carroll County, TN	2013	NA	13104	11547	1557	11.9
CN4701900000000	47	019	Carter County, TN	2013	NA	24769	22488	2281	9.2
CN4702100000000	47	021	Cheatham County, TN	2013	NA	19932	18615	1317	6.6
CN4702300000000	47	023	Chester County, TN	2013	NA	8264	7592	672	8.1
CN4702500000000	47	025	Claiborne County, TN	2013	NA	13005	11608	1397	10.7
CN4702700000000	47	027	Clay County, TN	2013	NA	3095	2762	333	10.8
CN4702900000000	47	029	Cocke County, TN	2013	NA	14976	13342	1634	10.9
CN4703100000000	47	031	Coffee County, TN	2013	NA	24434	22525	1909	7.8
CN4703300000000	47	033	Crockett County, TN	2013	NA	7009	6369	640	9.1
CN4703500000000	47	035	Cumberland County, TN	2013	NA	23433	21253	2180	9.3
CN4703700000000	47	037	Davidson County, TN	2013	NA	354139	333157	20982	5.9
CN4703900000000	47	039	Decatur County, TN	2013	NA	5083	4542	541	10.6
CN4704100000000	47	041	DeKalb County, TN	2013	NA	7703	6923	780	10.1
CN4704300000000	47	043	Dickson County, TN	2013	NA	23788	21958	1830	7.7
CN4704500000000	47	045	Dyer County, TN	2013	NA	17060	15277	1783	10.5
CN4704700000000	47	047	Fayette County, TN	2013	NA	18128	16562	1566	8.6
CN4704900000000	47	049	Fentress County, TN	2013	NA	7410	6686	724	9.8
CN4705100000000	47	051	Franklin County, TN	2013	NA	19598	18177	1421	7.3
CN4705300000000	47	053	Gibson County, TN	2013	NA	22064	19629	2435	11
CN4705500000000	47	055	Giles County, TN	2013	NA	14056	12906	1150	8.2
CN4705700000000	47	057	Grainger County, TN	2013	NA	9409	8468	941	10
CN4705900000000	47	059	Greene County, TN	2013	NA	30354	27422	2932	9.7
CN4706100000000	47	061	Grundy County, TN	2013	NA	5319	4783	536	10.1
CN4706300000000	47	063	Hamblen County, TN	2013	NA	26957	24498	2459	9.1
CN4706500000000	47	065	Hamilton County, TN	2013	NA	168353	156177	12176	7.2
CN4706700000000	47	067	Hancock County, TN	2013	NA	2146	1892	254	11.8
CN4706900000000	47	069	Hardeman County, TN	2013	NA	9780	8692	1088	11.1
CN4707100000000	47	071	Hardin County, TN	2013	NA	10975	9839	1136	10.4
CN4707300000000	47	073	Hawkins County, TN	2013	NA	24671	22501	2170	8.8
CN4707500000000	47	075	Haywood County, TN	2013	NA	8098	7142	956	11.8
CN4707700000000	47	077	Henderson County, TN	2013	NA	12664	11334	1330	10.5
CN4707900000000	47	079	Henry County, TN	2013	NA	14296	12942	1354	9.5
CN4708100000000	47	081	Hickman County, TN	2013	NA	10482	9613	869	8.3
CN4708300000000	47	083	Houston County, TN	2013	NA	3363	2995	368	10.9
CN4708500000000	47	085	Humphreys County, TN	2013	NA	8644	7882	762	8.8
CN4708700000000	47	087	Jackson County, TN	2013	NA	4570	4098	472	10.3
CN4708900000000	47	089	Jefferson County, TN	2013	NA	23296	21183	2113	9.1
CN4709100000000	47	091	Johnson County, TN	2013	NA	7329	6668	661	9
CN4709300000000	47	093	Knox County, TN	2013	NA	227126	212736	14390	6.3
CN4709500000000	47	095	Lake County, TN	2013	NA	2179	1959	220	10.1
CN4709700000000	47	097	Lauderdale County, TN	2013	NA	10224	9028	1196	11.7
CN4709900000000	47	099	Lawrence County, TN	2013	NA	18101	16314	1787	9.9
CN4710100000000	47	101	Lewis County, TN	2013	NA	4990	4460	530	10.6
CN4710300000000	47	103	Lincoln County, TN	2013	NA	15549	14577	972	6.3
CN4710500000000	47	105	Loudon County, TN	2013	NA	22077	20358	1719	7.8
CN4710700000000	47	107	McMinn County, TN	2013	NA	22842	20775	2067	9
CN4710900000000	47	109	McNairy County, TN	2013	NA	9327	8233	1094	11.7
CN4711100000000	47	111	Macon County, TN	2013	NA	10056	9232	824	8.2
CN4711300000000	47	113	Madison County, TN	2013	NA	47496	43660	3836	8.1
CN4711500000000	47	115	Marion County, TN	2013	NA	11995	10900	1095	9.1
CN4711700000000	47	117	Marshall County, TN	2013	NA	14317	13148	1169	8.2
CN4711900000000	47	119	Maury County, TN	2013	NA	40771	37872	2899	7.1
CN4712100000000	47	121	Meigs County, TN	2013	NA	5030	4514	516	10.3
CN4712300000000	47	123	Monroe County, TN	2013	NA	19236	17351	1885	9.8
CN4712500000000	47	125	Montgomery County, TN	2013	NA	77325	71473	5852	7.6
CN4712700000000	47	127	Moore County, TN	2013	NA	3323	3123	200	6
CN4712900000000	47	129	Morgan County, TN	2013	NA	8051	7229	822	10.2
CN4713100000000	47	131	Obion County, TN	2013	NA	13660	12072	1588	11.6
CN4713300000000	47	133	Overton County, TN	2013	NA	9492	8636	856	9
CN4713500000000	47	135	Perry County, TN	2013	NA	3114	2821	293	9.4
CN4713700000000	47	137	Pickett County, TN	2013	NA	2318	2097	221	9.5
CN4713900000000	47	139	Polk County, TN	2013	NA	7531	6837	694	9.2
CN4714100000000	47	141	Putnam County, TN	2013	NA	32459	29859	2600	8
CN4714300000000	47	143	Rhea County, TN	2013	NA	13350	11922	1428	10.7
CN4714500000000	47	145	Roane County, TN	2013	NA	23176	21080	2096	9
CN4714700000000	47	147	Robertson County, TN	2013	NA	33566	31296	2270	6.8
CN4714900000000	47	149	Rutherford County, TN	2013	NA	146980	137817	9163	6.2
CN4715100000000	47	151	Scott County, TN	2013	NA	8582	7338	1244	14.5
CN4715300000000	47	153	Sequatchie County, TN	2013	NA	5908	5399	509	8.6
CN4715500000000	47	155	Sevier County, TN	2013	NA	48968	44826	4142	8.5
CN4715700000000	47	157	Shelby County, TN	2013	NA	438627	399995	38632	8.8
CN4715900000000	47	159	Smith County, TN	2013	NA	8513	7848	665	7.8
CN4716100000000	47	161	Stewart County, TN	2013	NA	5339	4754	585	11
CN4716300000000	47	163	Sullivan County, TN	2013	NA	71515	66077	5438	7.6
CN4716500000000	47	165	Sumner County, TN	2013	NA	85370	80082	5288	6.2
CN4716700000000	47	167	Tipton County, TN	2013	NA	27946	25294	2652	9.5
CN4716900000000	47	169	Trousdale County, TN	2013	NA	3649	3339	310	8.5
CN4717100000000	47	171	Unicoi County, TN	2013	NA	7406	6625	781	10.5
CN4717300000000	47	173	Union County, TN	2013	NA	7413	6698	715	9.6
CN4717500000000	47	175	Van Buren County, TN	2013	NA	2192	1939	253	11.5
CN4717700000000	47	177	Warren County, TN	2013	NA	17518	16022	1496	8.5
CN4717900000000	47	179	Washington County, TN	2013	NA	58779	54532	4247	7.2
CN4718100000000	47	181	Wayne County, TN	2013	NA	6531	5899	632	9.7
CN4718300000000	47	183	Weakley County, TN	2013	NA	16516	14800	1716	10.4
CN4718500000000	47	185	White County, TN	2013	NA	11865	10740	1125	9.5
CN4718700000000	47	187	Williamson County, TN	2013	NA	101172	95951	5221	5.2
CN4718900000000	47	189	Wilson County, TN	2013	NA	61464	57587	3877	6.3
CN4800100000000	48	001	Anderson County, TX	2013	NA	22042	20763	1279	5.8
CN4800300000000	48	003	Andrews County, TX	2013	NA	9173	8823	350	3.8
CN4800500000000	48	005	Angelina County, TX	2013	NA	37966	35509	2457	6.5
CN4800700000000	48	007	Aransas County, TX	2013	NA	10069	9408	661	6.6
CN4800900000000	48	009	Archer County, TX	2013	NA	4231	4010	221	5.2
CN4801100000000	48	011	Armstrong County, TX	2013	NA	1006	966	40	4
CN4801300000000	48	013	Atascosa County, TX	2013	NA	20247	18985	1262	6.2
CN4801500000000	48	015	Austin County, TX	2013	NA	14136	13307	829	5.9
CN4801700000000	48	017	Bailey County, TX	2013	NA	3048	2830	218	7.2
CN4801900000000	48	019	Bandera County, TX	2013	NA	9071	8525	546	6
CN4802100000000	48	021	Bastrop County, TX	2013	NA	35910	33700	2210	6.2
CN4802300000000	48	023	Baylor County, TX	2013	NA	1673	1584	89	5.3
CN4802500000000	48	025	Bee County, TX	2013	NA	11321	10577	744	6.6
CN4802700000000	48	027	Bell County, TX	2013	NA	135335	125981	9354	6.9
CN4802900000000	48	029	Bexar County, TX	2013	NA	854655	804941	49714	5.8
CN4803100000000	48	031	Blanco County, TX	2013	NA	5540	5280	260	4.7
CN4803300000000	48	033	Borden County, TX	2013	NA	417	400	17	4.1
CN4803500000000	48	035	Bosque County, TX	2013	NA	8081	7558	523	6.5
CN4803700000000	48	037	Bowie County, TX	2013	NA	40557	37466	3091	7.6
CN4803900000000	48	039	Brazoria County, TX	2013	NA	164345	154302	10043	6.1
CN4804100000000	48	041	Brazos County, TX	2013	NA	102810	97768	5042	4.9
CN4804300000000	48	043	Brewster County, TX	2013	NA	4155	3924	231	5.6
CN4804500000000	48	045	Briscoe County, TX	2013	NA	628	593	35	5.6
CN4804700000000	48	047	Brooks County, TX	2013	NA	2764	2516	248	9
CN4804900000000	48	049	Brown County, TX	2013	NA	15936	14906	1030	6.5
CN4805100000000	48	051	Burleson County, TX	2013	NA	7697	7222	475	6.2
CN4805300000000	48	053	Burnet County, TX	2013	NA	20802	19663	1139	5.5
CN4805500000000	48	055	Caldwell County, TX	2013	NA	17125	16001	1124	6.6
CN4805700000000	48	057	Calhoun County, TX	2013	NA	10844	10172	672	6.2
CN4805900000000	48	059	Callahan County, TX	2013	NA	5917	5578	339	5.7
CN4806100000000	48	061	Cameron County, TX	2013	NA	167093	150439	16654	10
CN4806300000000	48	063	Camp County, TX	2013	NA	5516	5111	405	7.3
CN4806500000000	48	065	Carson County, TX	2013	NA	3178	3037	141	4.4
CN4806700000000	48	067	Cass County, TX	2013	NA	12596	11437	1159	9.2
CN4806900000000	48	069	Castro County, TX	2013	NA	3785	3607	178	4.7
CN4807100000000	48	071	Chambers County, TX	2013	NA	17485	16202	1283	7.3
CN4807300000000	48	073	Cherokee County, TX	2013	NA	21534	20041	1493	6.9
CN4807500000000	48	075	Childress County, TX	2013	NA	2936	2811	125	4.3
CN4807700000000	48	077	Clay County, TX	2013	NA	5141	4857	284	5.5
CN4807900000000	48	079	Cochran County, TX	2013	NA	1403	1310	93	6.6
CN4808100000000	48	081	Coke County, TX	2013	NA	1459	1385	74	5.1
CN4808300000000	48	083	Coleman County, TX	2013	NA	3158	2920	238	7.5
CN4808500000000	48	085	Collin County, TX	2013	NA	457847	432552	25295	5.5
CN4808700000000	48	087	Collingsworth County, TX	2013	NA	1217	1155	62	5.1
CN4808900000000	48	089	Colorado County, TX	2013	NA	10102	9520	582	5.8
CN4809100000000	48	091	Comal County, TX	2013	NA	57924	54472	3452	6
CN4809300000000	48	093	Comanche County, TX	2013	NA	5654	5323	331	5.9
CN4809500000000	48	095	Concho County, TX	2013	NA	1455	1397	58	4
CN4809700000000	48	097	Cooke County, TX	2013	NA	20486	19463	1023	5
CN4809900000000	48	099	Coryell County, TX	2013	NA	25222	23411	1811	7.2
CN4810100000000	48	101	Cottle County, TX	2013	NA	624	582	42	6.7
CN4810300000000	48	103	Crane County, TX	2013	NA	2087	1994	93	4.5
CN4810500000000	48	105	Crockett County, TX	2013	NA	1883	1787	96	5.1
CN4810700000000	48	107	Crosby County, TX	2013	NA	2767	2603	164	5.9
CN4810900000000	48	109	Culberson County, TX	2013	NA	1019	968	51	5
CN4811100000000	48	111	Dallam County, TX	2013	NA	3898	3762	136	3.5
CN4811300000000	48	113	Dallas County, TX	2013	NA	1234933	1153569	81364	6.6
CN4811500000000	48	115	Dawson County, TX	2013	NA	5001	4681	320	6.4
CN4811700000000	48	117	Deaf Smith County, TX	2013	NA	9157	8749	408	4.5
CN4811900000000	48	119	Delta County, TX	2013	NA	2636	2469	167	6.3
CN4812100000000	48	121	Denton County, TX	2013	NA	400381	378959	21422	5.4
CN4812300000000	48	123	DeWitt County, TX	2013	NA	9704	9245	459	4.7
CN4812500000000	48	125	Dickens County, TX	2013	NA	770	699	71	9.2
CN4812700000000	48	127	Dimmit County, TX	2013	NA	6783	6443	340	5
CN4812900000000	48	129	Donley County, TX	2013	NA	1988	1887	101	5.1
CN4813100000000	48	131	Duval County, TX	2013	NA	5542	5188	354	6.4
CN4813300000000	48	133	Eastland County, TX	2013	NA	8530	8014	516	6
CN4813500000000	48	135	Ector County, TX	2013	NA	78750	75338	3412	4.3
CN4813700000000	48	137	Edwards County, TX	2013	NA	904	851	53	5.9
CN4813900000000	48	139	Ellis County, TX	2013	NA	77676	72879	4797	6.2
CN4814100000000	48	141	El Paso County, TX	2013	NA	347223	319781	27442	7.9
CN4814300000000	48	143	Erath County, TX	2013	NA	19851	18780	1071	5.4
CN4814500000000	48	145	Falls County, TX	2013	NA	6779	6299	480	7.1
CN4814700000000	48	147	Fannin County, TX	2013	NA	15283	14217	1066	7
CN4814900000000	48	149	Fayette County, TX	2013	NA	12661	12098	563	4.4
CN4815100000000	48	151	Fisher County, TX	2013	NA	1886	1784	102	5.4
CN4815300000000	48	153	Floyd County, TX	2013	NA	3123	2847	276	8.8
CN4815500000000	48	155	Foard County, TX	2013	NA	578	548	30	5.2
CN4815700000000	48	157	Fort Bend County, TX	2013	NA	333271	314975	18296	5.5
CN4815900000000	48	159	Franklin County, TX	2013	NA	4690	4384	306	6.5
CN4816100000000	48	161	Freestone County, TX	2013	NA	7859	7317	542	6.9
CN4816300000000	48	163	Frio County, TX	2013	NA	9288	8854	434	4.7
CN4816500000000	48	165	Gaines County, TX	2013	NA	8916	8544	372	4.2
CN4816700000000	48	167	Galveston County, TX	2013	NA	155754	145043	10711	6.9
CN4816900000000	48	169	Garza County, TX	2013	NA	2238	2137	101	4.5
CN4817100000000	48	171	Gillespie County, TX	2013	NA	12426	11879	547	4.4
CN4817300000000	48	173	Glasscock County, TX	2013	NA	744	717	27	3.6
CN4817500000000	48	175	Goliad County, TX	2013	NA	3538	3354	184	5.2
CN4817700000000	48	177	Gonzales County, TX	2013	NA	9517	9030	487	5.1
CN4817900000000	48	179	Gray County, TX	2013	NA	9786	9282	504	5.2
CN4818100000000	48	181	Grayson County, TX	2013	NA	60525	56735	3790	6.3
CN4818300000000	48	183	Gregg County, TX	2013	NA	61556	57894	3662	5.9
CN4818500000000	48	185	Grimes County, TX	2013	NA	11818	11110	708	6
CN4818700000000	48	187	Guadalupe County, TX	2013	NA	70098	66253	3845	5.5
CN4818900000000	48	189	Hale County, TX	2013	NA	14811	12843	1968	13.3
CN4819100000000	48	191	Hall County, TX	2013	NA	1290	1199	91	7.1
CN4819300000000	48	193	Hamilton County, TX	2013	NA	3622	3406	216	6
CN4819500000000	48	195	Hansford County, TX	2013	NA	3129	3027	102	3.3
CN4819700000000	48	197	Hardeman County, TX	2013	NA	1699	1600	99	5.8
CN4819900000000	48	199	Hardin County, TX	2013	NA	25303	23267	2036	8
CN4820100000000	48	201	Harris County, TX	2013	NA	2199353	2066248	133105	6.1
CN4820300000000	48	203	Harrison County, TX	2013	NA	32322	30108	2214	6.8
CN4820500000000	48	205	Hartley County, TX	2013	NA	2932	2840	92	3.1
CN4820700000000	48	207	Haskell County, TX	2013	NA	2712	2578	134	4.9
CN4820900000000	48	209	Hays County, TX	2013	NA	89904	85104	4800	5.3
CN4821100000000	48	211	Hemphill County, TX	2013	NA	2476	2401	75	3
CN4821300000000	48	213	Henderson County, TX	2013	NA	34562	32104	2458	7.1
CN4821500000000	48	215	Hidalgo County, TX	2013	NA	331246	296978	34268	10.3
CN4821700000000	48	217	Hill County, TX	2013	NA	15972	14946	1026	6.4
CN4821900000000	48	219	Hockley County, TX	2013	NA	11924	11325	599	5
CN4822100000000	48	221	Hood County, TX	2013	NA	24016	22561	1455	6.1
CN4822300000000	48	223	Hopkins County, TX	2013	NA	17273	16278	995	5.8
CN4822500000000	48	225	Houston County, TX	2013	NA	9852	9238	614	6.2
CN4822700000000	48	227	Howard County, TX	2013	NA	13572	12840	732	5.4
CN4822900000000	48	229	Hudspeth County, TX	2013	NA	1294	1204	90	7
CN4823100000000	48	231	Hunt County, TX	2013	NA	38180	35340	2840	7.4
CN4823300000000	48	233	Hutchinson County, TX	2013	NA	9776	9172	604	6.2
CN4823500000000	48	235	Irion County, TX	2013	NA	851	815	36	4.2
CN4823700000000	48	237	Jack County, TX	2013	NA	4008	3795	213	5.3
CN4823900000000	48	239	Jackson County, TX	2013	NA	7442	7070	372	5
CN4824100000000	48	241	Jasper County, TX	2013	NA	14521	13002	1519	10.5
CN4824300000000	48	243	Jeff Davis County, TX	2013	NA	1162	1114	48	4.1
CN4824500000000	48	245	Jefferson County, TX	2013	NA	111265	99171	12094	10.9
CN4824700000000	48	247	Jim Hogg County, TX	2013	NA	2326	2161	165	7.1
CN4824900000000	48	249	Jim Wells County, TX	2013	NA	20143	18909	1234	6.1
CN4825100000000	48	251	Johnson County, TX	2013	NA	73689	69180	4509	6.1
CN4825300000000	48	253	Jones County, TX	2013	NA	5849	5456	393	6.7
CN4825500000000	48	255	Karnes County, TX	2013	NA	5624	5323	301	5.4
CN4825700000000	48	257	Kaufman County, TX	2013	NA	52451	49120	3331	6.4
CN4825900000000	48	259	Kendall County, TX	2013	NA	18245	17320	925	5.1
CN4826100000000	48	261	Kenedy County, TX	2013	NA	297	285	12	4
CN4826300000000	48	263	Kent County, TX	2013	NA	532	511	21	3.9
CN4826500000000	48	265	Kerr County, TX	2013	NA	21483	20299	1184	5.5
CN4826700000000	48	267	Kimble County, TX	2013	NA	2162	2057	105	4.9
CN4826900000000	48	269	King County, TX	2013	NA	239	228	11	4.6
CN4827100000000	48	271	Kinney County, TX	2013	NA	1218	1102	116	9.5
CN4827300000000	48	273	Kleberg County, TX	2013	NA	15445	14445	1000	6.5
CN4827500000000	48	275	Knox County, TX	2013	NA	1753	1659	94	5.4
CN4827700000000	48	277	Lamar County, TX	2013	NA	22306	20497	1809	8.1
CN4827900000000	48	279	Lamb County, TX	2013	NA	6148	5727	421	6.8
CN4828100000000	48	281	Lampasas County, TX	2013	NA	9130	8477	653	7.2
CN4828300000000	48	283	La Salle County, TX	2013	NA	4177	4020	157	3.8
CN4828500000000	48	285	Lavaca County, TX	2013	NA	9230	8797	433	4.7
CN4828700000000	48	287	Lee County, TX	2013	NA	9140	8673	467	5.1
CN4828900000000	48	289	Leon County, TX	2013	NA	6965	6484	481	6.9
CN4829100000000	48	291	Liberty County, TX	2013	NA	31027	28265	2762	8.9
CN4829300000000	48	293	Limestone County, TX	2013	NA	9484	8845	639	6.7
CN4829500000000	48	295	Lipscomb County, TX	2013	NA	1721	1653	68	4
CN4829700000000	48	297	Live Oak County, TX	2013	NA	6032	5769	263	4.4
CN4829900000000	48	299	Llano County, TX	2013	NA	8109	7588	521	6.4
CN4830100000000	48	301	Loving County, TX	2013	NA	75	71	4	5.3
CN4830300000000	48	303	Lubbock County, TX	2013	NA	147449	140162	7287	4.9
CN4830500000000	48	305	Lynn County, TX	2013	NA	2859	2708	151	5.3
CN4830700000000	48	307	McCulloch County, TX	2013	NA	4272	4047	225	5.3
CN4830900000000	48	309	McLennan County, TX	2013	NA	112195	105259	6936	6.2
CN4831100000000	48	311	McMullen County, TX	2013	NA	882	859	23	2.6
CN4831300000000	48	313	Madison County, TX	2013	NA	4820	4508	312	6.5
CN4831500000000	48	315	Marion County, TX	2013	NA	4541	4175	366	8.1
CN4831700000000	48	317	Martin County, TX	2013	NA	2551	2443	108	4.2
CN4831900000000	48	319	Mason County, TX	2013	NA	1959	1852	107	5.5
CN4832100000000	48	321	Matagorda County, TX	2013	NA	16851	15215	1636	9.7
CN4832300000000	48	323	Maverick County, TX	2013	NA	23667	20712	2955	12.5
CN4832500000000	48	325	Medina County, TX	2013	NA	20326	19091	1235	6.1
CN4832700000000	48	327	Menard County, TX	2013	NA	920	866	54	5.9
CN4832900000000	48	329	Midland County, TX	2013	NA	86065	82915	3150	3.7
CN4833100000000	48	331	Milam County, TX	2013	NA	10128	9334	794	7.8
CN4833300000000	48	333	Mills County, TX	2013	NA	2071	1962	109	5.3
CN4833500000000	48	335	Mitchell County, TX	2013	NA	2878	2719	159	5.5
CN4833700000000	48	337	Montague County, TX	2013	NA	10367	9857	510	4.9
CN4833900000000	48	339	Montgomery County, TX	2013	NA	246342	233018	13324	5.4
CN4834100000000	48	341	Moore County, TX	2013	NA	11440	10953	487	4.3
CN4834300000000	48	343	Morris County, TX	2013	NA	5841	5281	560	9.6
CN4834500000000	48	345	Motley County, TX	2013	NA	502	472	30	6
CN4834700000000	48	347	Nacogdoches County, TX	2013	NA	29229	27325	1904	6.5
CN4834900000000	48	349	Navarro County, TX	2013	NA	23391	21863	1528	6.5
CN4835100000000	48	351	Newton County, TX	2013	NA	5606	5003	603	10.8
CN4835300000000	48	353	Nolan County, TX	2013	NA	6968	6571	397	5.7
CN4835500000000	48	355	Nueces County, TX	2013	NA	168310	158015	10295	6.1
CN4835700000000	48	357	Ochiltree County, TX	2013	NA	5430	5226	204	3.8
CN4835900000000	48	359	Oldham County, TX	2013	NA	961	918	43	4.5
CN4836100000000	48	361	Orange County, TX	2013	NA	37976	34026	3950	10.4
CN4836300000000	48	363	Palo Pinto County, TX	2013	NA	13386	12510	876	6.5
CN4836500000000	48	365	Panola County, TX	2013	NA	12748	11960	788	6.2
CN4836700000000	48	367	Parker County, TX	2013	NA	58687	55438	3249	5.5
CN4836900000000	48	369	Parmer County, TX	2013	NA	5068	4872	196	3.9
CN4837100000000	48	371	Pecos County, TX	2013	NA	6705	6343	362	5.4
CN4837300000000	48	373	Polk County, TX	2013	NA	17371	16030	1341	7.7
CN4837500000000	48	375	Potter County, TX	2013	NA	57539	54644	2895	5
CN4837700000000	48	377	Presidio County, TX	2013	NA	3757	3274	483	12.9
CN4837900000000	48	379	Rains County, TX	2013	NA	5339	5011	328	6.1
CN4838100000000	48	381	Randall County, TX	2013	NA	68531	65580	2951	4.3
CN4838300000000	48	383	Reagan County, TX	2013	NA	1959	1881	78	4
CN4838500000000	48	385	Real County, TX	2013	NA	1063	978	85	8
CN4838700000000	48	387	Red River County, TX	2013	NA	5142	4625	517	10.1
CN4838900000000	48	389	Reeves County, TX	2013	NA	5631	5306	325	5.8
CN4839100000000	48	391	Refugio County, TX	2013	NA	3563	3371	192	5.4
CN4839300000000	48	393	Roberts County, TX	2013	NA	451	431	20	4.4
CN4839500000000	48	395	Robertson County, TX	2013	NA	7289	6778	511	7
CN4839700000000	48	397	Rockwall County, TX	2013	NA	42276	39844	2432	5.8
CN4839900000000	48	399	Runnels County, TX	2013	NA	4979	4717	262	5.3
CN4840100000000	48	401	Rusk County, TX	2013	NA	24311	22801	1510	6.2
CN4840300000000	48	403	Sabine County, TX	2013	NA	3561	3101	460	12.9
CN4840500000000	48	405	San Augustine County, TX	2013	NA	2936	2595	341	11.6
CN4840700000000	48	407	San Jacinto County, TX	2013	NA	11454	10588	866	7.6
CN4840900000000	48	409	San Patricio County, TX	2013	NA	30665	28462	2203	7.2
CN4841100000000	48	411	San Saba County, TX	2013	NA	2273	2143	130	5.7
CN4841300000000	48	413	Schleicher County, TX	2013	NA	1803	1739	64	3.5
CN4841500000000	48	415	Scurry County, TX	2013	NA	8566	8210	356	4.2
CN4841700000000	48	417	Shackelford County, TX	2013	NA	2298	2222	76	3.3
CN4841900000000	48	419	Shelby County, TX	2013	NA	11631	10768	863	7.4
CN4842100000000	48	421	Sherman County, TX	2013	NA	1480	1420	60	4.1
CN4842300000000	48	423	Smith County, TX	2013	NA	101647	94998	6649	6.5
CN4842500000000	48	425	Somervell County, TX	2013	NA	4147	3897	250	6
CN4842700000000	48	427	Starr County, TX	2013	NA	26344	22402	3942	15
CN4842900000000	48	429	Stephens County, TX	2013	NA	4207	3990	217	5.2
CN4843100000000	48	431	Sterling County, TX	2013	NA	752	723	29	3.9
CN4843300000000	48	433	Stonewall County, TX	2013	NA	707	674	33	4.7
CN4843500000000	48	435	Sutton County, TX	2013	NA	2065	1971	94	4.6
CN4843700000000	48	437	Swisher County, TX	2013	NA	2964	2714	250	8.4
CN4843900000000	48	439	Tarrant County, TX	2013	NA	981537	922170	59367	6
CN4844100000000	48	441	Taylor County, TX	2013	NA	64664	61254	3410	5.3
CN4844300000000	48	443	Terrell County, TX	2013	NA	525	499	26	5
CN4844500000000	48	445	Terry County, TX	2013	NA	5533	5205	328	5.9
CN4844700000000	48	447	Throckmorton County, TX	2013	NA	796	756	40	5
CN4844900000000	48	449	Titus County, TX	2013	NA	13079	12107	972	7.4
CN4845100000000	48	451	Tom Green County, TX	2013	NA	54242	51444	2798	5.2
CN4845300000000	48	453	Travis County, TX	2013	NA	629919	598189	31730	5
CN4845500000000	48	455	Trinity County, TX	2013	NA	5569	5153	416	7.5
CN4845700000000	48	457	Tyler County, TX	2013	NA	7602	6822	780	10.3
CN4845900000000	48	459	Upshur County, TX	2013	NA	18538	17353	1185	6.4
CN4846100000000	48	461	Upton County, TX	2013	NA	1710	1640	70	4.1
CN4846300000000	48	463	Uvalde County, TX	2013	NA	11949	11114	835	7
CN4846500000000	48	465	Val Verde County, TX	2013	NA	19633	18180	1453	7.4
CN4846700000000	48	467	Van Zandt County, TX	2013	NA	23851	22295	1556	6.5
CN4846900000000	48	469	Victoria County, TX	2013	NA	45837	43393	2444	5.3
CN4847100000000	48	471	Walker County, TX	2013	NA	23123	21594	1529	6.6
CN4847300000000	48	473	Waller County, TX	2013	NA	20839	19492	1347	6.5
CN4847500000000	48	475	Ward County, TX	2013	NA	5520	5261	259	4.7
CN4847700000000	48	477	Washington County, TX	2013	NA	15728	14867	861	5.5
CN4847900000000	48	479	Webb County, TX	2013	NA	110366	103601	6765	6.1
CN4848100000000	48	481	Wharton County, TX	2013	NA	21509	20226	1283	6
CN4848300000000	48	483	Wheeler County, TX	2013	NA	3137	3002	135	4.3
CN4848500000000	48	485	Wichita County, TX	2013	NA	57339	53984	3355	5.9
CN4848700000000	48	487	Wilbarger County, TX	2013	NA	5779	5445	334	5.8
CN4848900000000	48	489	Willacy County, TX	2013	NA	7436	6263	1173	15.8
CN4849100000000	48	491	Williamson County, TX	2013	NA	246626	233607	13019	5.3
CN4849300000000	48	493	Wilson County, TX	2013	NA	22213	21045	1168	5.3
CN4849500000000	48	495	Winkler County, TX	2013	NA	3322	3147	175	5.3
CN4849700000000	48	497	Wise County, TX	2013	NA	28410	26707	1703	6
CN4849900000000	48	499	Wood County, TX	2013	NA	16725	15507	1218	7.3
CN4850100000000	48	501	Yoakum County, TX	2013	NA	4214	4051	163	3.9
CN4850300000000	48	503	Young County, TX	2013	NA	8574	8132	442	5.2
CN4850500000000	48	505	Zapata County, TX	2013	NA	7064	6624	440	6.2
CN4850700000000	48	507	Zavala County, TX	2013	NA	4011	3430	581	14.5
CN4900100000000	49	001	Beaver County, UT	2013	NA	3021	2880	141	4.7
CN4900300000000	49	003	Box Elder County, UT	2013	NA	23161	22064	1097	4.7
CN4900500000000	49	005	Cache County, UT	2013	NA	57784	55494	2290	4
CN4900700000000	49	007	Carbon County, UT	2013	NA	8948	8383	565	6.3
CN4900900000000	49	009	Daggett County, UT	2013	NA	429	408	21	4.9
CN4901100000000	49	011	Davis County, UT	2013	NA	152577	146091	6486	4.3
CN4901300000000	49	013	Duchesne County, UT	2013	NA	9299	8899	400	4.3
CN4901500000000	49	015	Emery County, UT	2013	NA	4713	4426	287	6.1
CN4901700000000	49	017	Garfield County, UT	2013	NA	2781	2525	256	9.2
CN4901900000000	49	019	Grand County, UT	2013	NA	5455	5033	422	7.7
CN4902100000000	49	021	Iron County, UT	2013	NA	19376	18301	1075	5.5
CN4902300000000	49	023	Juab County, UT	2013	NA	4697	4460	237	5
CN4902500000000	49	025	Kane County, UT	2013	NA	3474	3288	186	5.4
CN4902700000000	49	027	Millard County, UT	2013	NA	5902	5660	242	4.1
CN4902900000000	49	029	Morgan County, UT	2013	NA	4505	4323	182	4
CN4903100000000	49	031	Piute County, UT	2013	NA	484	447	37	7.6
CN4903300000000	49	033	Rich County, UT	2013	NA	984	939	45	4.6
CN4903500000000	49	035	Salt Lake County, UT	2013	NA	569638	544635	25003	4.4
CN4903700000000	49	037	San Juan County, UT	2013	NA	5676	5224	452	8
CN4903900000000	49	039	Sanpete County, UT	2013	NA	11058	10436	622	5.6
CN4904100000000	49	041	Sevier County, UT	2013	NA	9265	8762	503	5.4
CN4904300000000	49	043	Summit County, UT	2013	NA	22039	21124	915	4.2
CN4904500000000	49	045	Tooele County, UT	2013	NA	28488	26941	1547	5.4
CN4904700000000	49	047	Uintah County, UT	2013	NA	15671	14989	682	4.4
CN4904900000000	49	049	Utah County, UT	2013	NA	248743	238194	10549	4.2
CN4905100000000	49	051	Wasatch County, UT	2013	NA	12196	11627	569	4.7
CN4905300000000	49	053	Washington County, UT	2013	NA	59344	56072	3272	5.5
CN4905500000000	49	055	Wayne County, UT	2013	NA	1378	1228	150	10.9
CN4905700000000	49	057	Weber County, UT	2013	NA	114544	108338	6206	5.4
CN5000100000000	50	001	Addison County, VT	2013	NA	20786	19928	858	4.1
CN5000300000000	50	003	Bennington County, VT	2013	NA	19273	18269	1004	5.2
CN5000500000000	50	005	Caledonia County, VT	2013	NA	15757	14921	836	5.3
CN5000700000000	50	007	Chittenden County, VT	2013	NA	95084	91824	3260	3.4
CN5000900000000	50	009	Essex County, VT	2013	NA	2841	2649	192	6.8
CN5001100000000	50	011	Franklin County, VT	2013	NA	27490	26340	1150	4.2
CN5001300000000	50	013	Grand Isle County, VT	2013	NA	4054	3872	182	4.5
CN5001500000000	50	015	Lamoille County, VT	2013	NA	13883	13094	789	5.7
CN5001700000000	50	017	Orange County, VT	2013	NA	16176	15512	664	4.1
CN5001900000000	50	019	Orleans County, VT	2013	NA	13824	12881	943	6.8
CN5002100000000	50	021	Rutland County, VT	2013	NA	32280	30562	1718	5.3
CN5002300000000	50	023	Washington County, VT	2013	NA	34583	33092	1491	4.3
CN5002500000000	50	025	Windham County, VT	2013	NA	24092	22966	1126	4.7
CN5002700000000	50	027	Windsor County, VT	2013	NA	30322	29054	1268	4.2
CN5100100000000	51	001	Accomack County, VA	2013	NA	16230	15058	1172	7.2
CN5100300000000	51	003	Albemarle County, VA	2013	NA	52528	49982	2546	4.8
CN5100500000000	51	005	Alleghany County, VA	2013	NA	7516	7020	496	6.6
CN5100700000000	51	007	Amelia County, VA	2013	NA	6172	5806	366	5.9
CN5100900000000	51	009	Amherst County, VA	2013	NA	15798	14830	968	6.1
CN5101100000000	51	011	Appomattox County, VA	2013	NA	7158	6696	462	6.5
CN5101300000000	51	013	Arlington County, VA	2013	NA	145047	140035	5012	3.5
CN5101500000000	51	015	Augusta County, VA	2013	NA	36891	34964	1927	5.2
CN5101700000000	51	017	Bath County, VA	2013	NA	2577	2441	136	5.3
CN5101900000000	51	019	Bedford County, VA	2013	NA	38232	36052	2180	5.7
CN5102100000000	51	021	Bland County, VA	2013	NA	2877	2682	195	6.8
CN5102300000000	51	023	Botetourt County, VA	2013	NA	17629	16703	926	5.3
CN5102500000000	51	025	Brunswick County, VA	2013	NA	6659	6035	624	9.4
CN5102700000000	51	027	Buchanan County, VA	2013	NA	8169	7269	900	11
CN5102900000000	51	029	Buckingham County, VA	2013	NA	6408	5900	508	7.9
CN5103100000000	51	031	Campbell County, VA	2013	NA	26938	25332	1606	6
CN5103300000000	51	033	Caroline County, VA	2013	NA	14580	13550	1030	7.1
CN5103500000000	51	035	Carroll County, VA	2013	NA	13264	12164	1100	8.3
CN5103600000000	51	036	Charles City County, VA	2013	NA	3789	3532	257	6.8
CN5103700000000	51	037	Charlotte County, VA	2013	NA	5314	4900	414	7.8
CN5104100000000	51	041	Chesterfield County, VA	2013	NA	174669	164793	9876	5.7
CN5104300000000	51	043	Clarke County, VA	2013	NA	7623	7261	362	4.7
CN5104500000000	51	045	Craig County, VA	2013	NA	2456	2283	173	7
CN5104700000000	51	047	Culpeper County, VA	2013	NA	23378	22123	1255	5.4
CN5104900000000	51	049	Cumberland County, VA	2013	NA	4508	4208	300	6.7
CN5105100000000	51	051	Dickenson County, VA	2013	NA	5347	4750	597	11.2
CN5105300000000	51	053	Dinwiddie County, VA	2013	NA	13541	12544	997	7.4
CN5105700000000	51	057	Essex County, VA	2013	NA	5685	5307	378	6.6
CN5105900000000	51	059	Fairfax County, VA	2013	NA	624266	596686	27580	4.4
CN5106100000000	51	061	Fauquier County, VA	2013	NA	35911	34139	1772	4.9
CN5106300000000	51	063	Floyd County, VA	2013	NA	8387	7933	454	5.4
CN5106500000000	51	065	Fluvanna County, VA	2013	NA	13031	12409	622	4.8
CN5106700000000	51	067	Franklin County, VA	2013	NA	27210	25604	1606	5.9
CN5106900000000	51	069	Frederick County, VA	2013	NA	44138	41800	2338	5.3
CN5107100000000	51	071	Giles County, VA	2013	NA	8217	7643	574	7
CN5107300000000	51	073	Gloucester County, VA	2013	NA	19318	18312	1006	5.2
CN5107500000000	51	075	Goochland County, VA	2013	NA	10371	9837	534	5.1
CN5107700000000	51	077	Grayson County, VA	2013	NA	7011	6334	677	9.7
CN5107900000000	51	079	Greene County, VA	2013	NA	9685	9218	467	4.8
CN5108100000000	51	081	Greensville County, VA	2013	NA	4355	4018	337	7.7
CN5108300000000	51	083	Halifax County, VA	2013	NA	15859	14409	1450	9.1
CN5108500000000	51	085	Hanover County, VA	2013	NA	55404	52602	2802	5.1
CN5108700000000	51	087	Henrico County, VA	2013	NA	174077	164368	9709	5.6
CN5108900000000	51	089	Henry County, VA	2013	NA	23405	21274	2131	9.1
CN5109100000000	51	091	Highland County, VA	2013	NA	1419	1358	61	4.3
CN5109300000000	51	093	Isle of Wight County, VA	2013	NA	18857	17773	1084	5.7
CN5109500000000	51	095	James City County, VA	2013	NA	33696	31896	1800	5.3
CN5109700000000	51	097	King and Queen County, VA	2013	NA	3638	3416	222	6.1
CN5109900000000	51	099	King George County, VA	2013	NA	11975	11281	694	5.8
CN5110100000000	51	101	King William County, VA	2013	NA	8699	8208	491	5.6
CN5110300000000	51	103	Lancaster County, VA	2013	NA	5401	4995	406	7.5
CN5110500000000	51	105	Lee County, VA	2013	NA	9305	8488	817	8.8
CN5110700000000	51	107	Loudoun County, VA	2013	NA	191048	182680	8368	4.4
CN5110900000000	51	109	Louisa County, VA	2013	NA	18051	17027	1024	5.7
CN5111100000000	51	111	Lunenburg County, VA	2013	NA	5326	4950	376	7.1
CN5111300000000	51	113	Madison County, VA	2013	NA	7224	6902	322	4.5
CN5111500000000	51	115	Mathews County, VA	2013	NA	4163	3952	211	5.1
CN5111700000000	51	117	Mecklenburg County, VA	2013	NA	12780	11588	1192	9.3
CN5111900000000	51	119	Middlesex County, VA	2013	NA	5113	4830	283	5.5
CN5112100000000	51	121	Montgomery County, VA	2013	NA	49663	46856	2807	5.7
CN5112500000000	51	125	Nelson County, VA	2013	NA	7358	6952	406	5.5
CN5112700000000	51	127	New Kent County, VA	2013	NA	10783	10239	544	5
CN5113100000000	51	131	Northampton County, VA	2013	NA	6035	5485	550	9.1
CN5113300000000	51	133	Northumberland County, VA	2013	NA	5690	5269	421	7.4
CN5113500000000	51	135	Nottoway County, VA	2013	NA	7072	6645	427	6
CN5113700000000	51	137	Orange County, VA	2013	NA	16114	15161	953	5.9
CN5113900000000	51	139	Page County, VA	2013	NA	11944	10841	1103	9.2
CN5114100000000	51	141	Patrick County, VA	2013	NA	7802	7154	648	8.3
CN5114300000000	51	143	Pittsylvania County, VA	2013	NA	30444	28299	2145	7
CN5114500000000	51	145	Powhatan County, VA	2013	NA	13561	12871	690	5.1
CN5114700000000	51	147	Prince Edward County, VA	2013	NA	9990	9151	839	8.4
CN5114900000000	51	149	Prince George County, VA	2013	NA	14741	13709	1032	7
CN5115300000000	51	153	Prince William County, VA	2013	NA	231105	219058	12047	5.2
CN5115500000000	51	155	Pulaski County, VA	2013	NA	16858	15578	1280	7.6
CN5115700000000	51	157	Rappahannock County, VA	2013	NA	3916	3715	201	5.1
CN5115900000000	51	159	Richmond County, VA	2013	NA	3939	3695	244	6.2
CN5116100000000	51	161	Roanoke County, VA	2013	NA	49826	47327	2499	5
CN5116300000000	51	163	Rockbridge County, VA	2013	NA	10416	9811	605	5.8
CN5116500000000	51	165	Rockingham County, VA	2013	NA	40622	38560	2062	5.1
CN5116700000000	51	167	Russell County, VA	2013	NA	11603	10619	984	8.5
CN5116900000000	51	169	Scott County, VA	2013	NA	10003	9305	698	7
CN5117100000000	51	171	Shenandoah County, VA	2013	NA	20940	19764	1176	5.6
CN5117300000000	51	173	Smyth County, VA	2013	NA	13405	12189	1216	9.1
CN5117500000000	51	175	Southampton County, VA	2013	NA	9241	8724	517	5.6
CN5117700000000	51	177	Spotsylvania County, VA	2013	NA	64155	60426	3729	5.8
CN5117900000000	51	179	Stafford County, VA	2013	NA	66087	62345	3742	5.7
CN5118100000000	51	181	Surry County, VA	2013	NA	3633	3368	265	7.3
CN5118300000000	51	183	Sussex County, VA	2013	NA	4185	3797	388	9.3
CN5118500000000	51	185	Tazewell County, VA	2013	NA	17673	16146	1527	8.6
CN5118700000000	51	187	Warren County, VA	2013	NA	20087	18854	1233	6.1
CN5119100000000	51	191	Washington County, VA	2013	NA	27839	26066	1773	6.4
CN5119300000000	51	193	Westmoreland County, VA	2013	NA	9100	8475	625	6.9
CN5119500000000	51	195	Wise County, VA	2013	NA	15100	13538	1562	10.3
CN5119700000000	51	197	Wythe County, VA	2013	NA	14001	12909	1092	7.8
CN5119900000000	51	199	York County, VA	2013	NA	31835	30123	1712	5.4
CN5151000000000	51	510	Alexandria city, VA	2013	NA	93676	89882	3794	4.1
CN5152000000000	51	520	Bristol city, VA	2013	NA	7823	7277	546	7
CN5153000000000	51	530	Buena Vista city, VA	2013	NA	3313	3088	225	6.8
CN5154000000000	51	540	Charlottesville city, VA	2013	NA	23398	22302	1096	4.7
CN5155000000000	51	550	Chesapeake city, VA	2013	NA	116337	109455	6882	5.9
CN5157000000000	51	570	Colonial Heights city, VA	2013	NA	8661	8098	563	6.5
CN5158000000000	51	580	Covington city, VA	2013	NA	2561	2346	215	8.4
CN5159000000000	51	590	Danville city, VA	2013	NA	19805	17864	1941	9.8
CN5159500000000	51	595	Emporia city, VA	2013	NA	2382	2148	234	9.8
CN5160000000000	51	600	Fairfax city, VA	2013	NA	13109	12563	546	4.2
CN5161000000000	51	610	Falls Church city, VA	2013	NA	7840	7534	306	3.9
CN5162000000000	51	620	Franklin city, VA	2013	NA	3694	3351	343	9.3
CN5163000000000	51	630	Fredericksburg city, VA	2013	NA	13762	12872	890	6.5
CN5164000000000	51	640	Galax city, VA	2013	NA	3019	2759	260	8.6
CN5165000000000	51	650	Hampton city, VA	2013	NA	65846	60905	4941	7.5
CN5166000000000	51	660	Harrisonburg city, VA	2013	NA	24034	22408	1626	6.8
CN5167000000000	51	670	Hopewell city, VA	2013	NA	9657	8714	943	9.8
CN5167800000000	51	678	Lexington city, VA	2013	NA	2252	2060	192	8.5
CN5168000000000	51	680	Lynchburg city, VA	2013	NA	35746	33209	2537	7.1
CN5168300000000	51	683	Manassas city, VA	2013	NA	22238	21039	1199	5.4
CN5168500000000	51	685	Manassas Park city, VA	2013	NA	8804	8356	448	5.1
CN5169000000000	51	690	Martinsville city, VA	2013	NA	5700	5059	641	11.2
CN5170000000000	51	700	Newport News city, VA	2013	NA	90473	84337	6136	6.8
CN5171000000000	51	710	Norfolk city, VA	2013	NA	112762	104905	7857	7
CN5172000000000	51	720	Norton city, VA	2013	NA	1871	1715	156	8.3
CN5173000000000	51	730	Petersburg city, VA	2013	NA	13777	12169	1608	11.7
CN5173500000000	51	735	Poquoson city, VA	2013	NA	6346	6031	315	5
CN5174000000000	51	740	Portsmouth city, VA	2013	NA	45482	41776	3706	8.1
CN5175000000000	51	750	Radford city, VA	2013	NA	8338	7709	629	7.5
CN5176000000000	51	760	Richmond city, VA	2013	NA	110462	102949	7513	6.8
CN5177000000000	51	770	Roanoke city, VA	2013	NA	49779	46460	3319	6.7
CN5177500000000	51	775	Salem city, VA	2013	NA	13049	12289	760	5.8
CN5179000000000	51	790	Staunton city, VA	2013	NA	11954	11259	695	5.8
CN5180000000000	51	800	Suffolk city, VA	2013	NA	41983	39325	2658	6.3
CN5181000000000	51	810	Virginia Beach city, VA	2013	NA	231008	218514	12494	5.4
CN5182000000000	51	820	Waynesboro city, VA	2013	NA	10028	9420	608	6.1
CN5183000000000	51	830	Williamsburg city, VA	2013	NA	6877	6349	528	7.7
CN5184000000000	51	840	Winchester city, VA	2013	NA	14359	13524	835	5.8
CN5300100000000	53	001	Adams County, WA	2013	NA	8376	7674	702	8.4
CN5300300000000	53	003	Asotin County, WA	2013	NA	9793	9144	649	6.6
CN5300500000000	53	005	Benton County, WA	2013	NA	90301	82246	8055	8.9
CN5300700000000	53	007	Chelan County, WA	2013	NA	40399	37461	2938	7.3
CN5300900000000	53	009	Clallam County, WA	2013	NA	27336	24710	2626	9.6
CN5301100000000	53	011	Clark County, WA	2013	NA	208351	190701	17650	8.5
CN5301300000000	53	013	Columbia County, WA	2013	NA	1768	1626	142	8
CN5301500000000	53	015	Cowlitz County, WA	2013	NA	43324	39074	4250	9.8
CN5301700000000	53	017	Douglas County, WA	2013	NA	18914	17348	1566	8.3
CN5301900000000	53	019	Ferry County, WA	2013	NA	2485	2150	335	13.5
CN5302100000000	53	021	Franklin County, WA	2013	NA	38399	34773	3626	9.4
CN5302300000000	53	023	Garfield County, WA	2013	NA	986	913	73	7.4
CN5302500000000	53	025	Grant County, WA	2013	NA	44014	40206	3808	8.7
CN5302700000000	53	027	Grays Harbor County, WA	2013	NA	28125	24791	3334	11.9
CN5302900000000	53	029	Island County, WA	2013	NA	31776	29413	2363	7.4
CN5303100000000	53	031	Jefferson County, WA	2013	NA	11424	10351	1073	9.4
CN5303300000000	53	033	King County, WA	2013	NA	1137369	1079695	57674	5.1
CN5303500000000	53	035	Kitsap County, WA	2013	NA	113691	105488	8203	7.2
CN5303700000000	53	037	Kittitas County, WA	2013	NA	20207	18636	1571	7.8
CN5303900000000	53	039	Klickitat County, WA	2013	NA	9722	8805	917	9.4
CN5304100000000	53	041	Lewis County, WA	2013	NA	31352	28046	3306	10.5
CN5304300000000	53	043	Lincoln County, WA	2013	NA	5090	4742	348	6.8
CN5304500000000	53	045	Mason County, WA	2013	NA	23363	21030	2333	10
CN5304700000000	53	047	Okanogan County, WA	2013	NA	21002	19197	1805	8.6
CN5304900000000	53	049	Pacific County, WA	2013	NA	7996	7096	900	11.3
CN5305100000000	53	051	Pend Oreille County, WA	2013	NA	4682	4125	557	11.9
CN5305300000000	53	053	Pierce County, WA	2013	NA	384278	352223	32055	8.3
CN5305500000000	53	055	San Juan County, WA	2013	NA	7788	7323	465	6
CN5305700000000	53	057	Skagit County, WA	2013	NA	56754	51876	4878	8.6
CN5305900000000	53	059	Skamania County, WA	2013	NA	4998	4501	497	9.9
CN5306100000000	53	061	Snohomish County, WA	2013	NA	388729	366189	22540	5.8
CN5306300000000	53	063	Spokane County, WA	2013	NA	227420	208842	18578	8.2
CN5306500000000	53	065	Stevens County, WA	2013	NA	17734	15819	1915	10.8
CN5306700000000	53	067	Thurston County, WA	2013	NA	122799	113494	9305	7.6
CN5306900000000	53	069	Wahkiakum County, WA	2013	NA	1294	1139	155	12
CN5307100000000	53	071	Walla Walla County, WA	2013	NA	28421	26403	2018	7.1
CN5307300000000	53	073	Whatcom County, WA	2013	NA	102157	94564	7593	7.4
CN5307500000000	53	075	Whitman County, WA	2013	NA	22211	20876	1335	6
CN5307700000000	53	077	Yakima County, WA	2013	NA	119049	107154	11895	10
CN5400100000000	54	001	Barbour County, WV	2013	NA	6708	6230	478	7.1
CN5400300000000	54	003	Berkeley County, WV	2013	NA	52548	49590	2958	5.6
CN5400500000000	54	005	Boone County, WV	2013	NA	8653	7826	827	9.6
CN5400700000000	54	007	Braxton County, WV	2013	NA	5331	4783	548	10.3
CN5400900000000	54	009	Brooke County, WV	2013	NA	10372	9572	800	7.7
CN5401100000000	54	011	Cabell County, WV	2013	NA	42399	39956	2443	5.8
CN5401300000000	54	013	Calhoun County, WV	2013	NA	2880	2588	292	10.1
CN5401500000000	54	015	Clay County, WV	2013	NA	3481	3063	418	12
CN5401700000000	54	017	Doddridge County, WV	2013	NA	3517	3329	188	5.3
CN5401900000000	54	019	Fayette County, WV	2013	NA	16983	15521	1462	8.6
CN5402100000000	54	021	Gilmer County, WV	2013	NA	2751	2568	183	6.7
CN5402300000000	54	023	Grant County, WV	2013	NA	5995	5505	490	8.2
CN5402500000000	54	025	Greenbrier County, WV	2013	NA	15465	14314	1151	7.4
CN5402700000000	54	027	Hampshire County, WV	2013	NA	9572	8901	671	7
CN5402900000000	54	029	Hancock County, WV	2013	NA	13397	12309	1088	8.1
CN5403100000000	54	031	Hardy County, WV	2013	NA	5452	4935	517	9.5
CN5403300000000	54	033	Harrison County, WV	2013	NA	31778	30013	1765	5.6
CN5403500000000	54	035	Jackson County, WV	2013	NA	12024	11197	827	6.9
CN5403700000000	54	037	Jefferson County, WV	2013	NA	27404	26092	1312	4.8
CN5403900000000	54	039	Kanawha County, WV	2013	NA	89397	84118	5279	5.9
CN5404100000000	54	041	Lewis County, WV	2013	NA	7359	6887	472	6.4
CN5404300000000	54	043	Lincoln County, WV	2013	NA	7548	6823	725	9.6
CN5404500000000	54	045	Logan County, WV	2013	NA	12378	11163	1215	9.8
CN5404700000000	54	047	McDowell County, WV	2013	NA	6192	5406	786	12.7
CN5404900000000	54	049	Marion County, WV	2013	NA	26745	25157	1588	5.9
CN5405100000000	54	051	Marshall County, WV	2013	NA	14300	13257	1043	7.3
CN5405300000000	54	053	Mason County, WV	2013	NA	10566	9575	991	9.4
CN5405500000000	54	055	Mercer County, WV	2013	NA	23129	21359	1770	7.7
CN5405700000000	54	057	Mineral County, WV	2013	NA	11895	10963	932	7.8
CN5405900000000	54	059	Mingo County, WV	2013	NA	8480	7533	947	11.2
CN5406100000000	54	061	Monongalia County, WV	2013	NA	50023	47763	2260	4.5
CN5406300000000	54	063	Monroe County, WV	2013	NA	5677	5320	357	6.3
CN5406500000000	54	065	Morgan County, WV	2013	NA	7439	6978	461	6.2
CN5406700000000	54	067	Nicholas County, WV	2013	NA	10373	9379	994	9.6
CN5406900000000	54	069	Ohio County, WV	2013	NA	21330	20120	1210	5.7
CN5407100000000	54	071	Pendleton County, WV	2013	NA	3579	3384	195	5.4
CN5407300000000	54	073	Pleasants County, WV	2013	NA	2893	2682	211	7.3
CN5407500000000	54	075	Pocahontas County, WV	2013	NA	3595	3287	308	8.6
CN5407700000000	54	077	Preston County, WV	2013	NA	14631	13675	956	6.5
CN5407900000000	54	079	Putnam County, WV	2013	NA	25958	24485	1473	5.7
CN5408100000000	54	081	Raleigh County, WV	2013	NA	31791	29478	2313	7.3
CN5408300000000	54	083	Randolph County, WV	2013	NA	11921	11061	860	7.2
CN5408500000000	54	085	Ritchie County, WV	2013	NA	4555	4276	279	6.1
CN5408700000000	54	087	Roane County, WV	2013	NA	5358	4803	555	10.4
CN5408900000000	54	089	Summers County, WV	2013	NA	4550	4203	347	7.6
CN5409100000000	54	091	Taylor County, WV	2013	NA	7758	7320	438	5.6
CN5409300000000	54	093	Tucker County, WV	2013	NA	3272	3049	223	6.8
CN5409500000000	54	095	Tyler County, WV	2013	NA	3632	3315	317	8.7
CN5409700000000	54	097	Upshur County, WV	2013	NA	9610	8927	683	7.1
CN5409900000000	54	099	Wayne County, WV	2013	NA	16041	14931	1110	6.9
CN5410100000000	54	101	Webster County, WV	2013	NA	3515	3153	362	10.3
CN5410300000000	54	103	Wetzel County, WV	2013	NA	7282	6620	662	9.1
CN5410500000000	54	105	Wirt County, WV	2013	NA	2318	2083	235	10.1
CN5410700000000	54	107	Wood County, WV	2013	NA	38447	36064	2383	6.2
CN5410900000000	54	109	Wyoming County, WV	2013	NA	8288	7522	766	9.2
CN5500100000000	55	001	Adams County, WI	2013	NA	8728	7779	949	10.9
CN5500300000000	55	003	Ashland County, WI	2013	NA	8163	7416	747	9.2
CN5500500000000	55	005	Barron County, WI	2013	NA	23647	21874	1773	7.5
CN5500700000000	55	007	Bayfield County, WI	2013	NA	7760	6907	853	11
CN5500900000000	55	009	Brown County, WI	2013	NA	138066	129516	8550	6.2
CN5501100000000	55	011	Buffalo County, WI	2013	NA	6553	6123	430	6.6
CN5501300000000	55	013	Burnett County, WI	2013	NA	7488	6852	636	8.5
CN5501500000000	55	015	Calumet County, WI	2013	NA	27185	25755	1430	5.3
CN5501700000000	55	017	Chippewa County, WI	2013	NA	32982	30759	2223	6.7
CN5501900000000	55	019	Clark County, WI	2013	NA	17132	15923	1209	7.1
CN5502100000000	55	021	Columbia County, WI	2013	NA	31237	29196	2041	6.5
CN5502300000000	55	023	Crawford County, WI	2013	NA	8125	7460	665	8.2
CN5502500000000	55	025	Dane County, WI	2013	NA	301195	287098	14097	4.7
CN5502700000000	55	027	Dodge County, WI	2013	NA	47383	44132	3251	6.9
CN5502900000000	55	029	Door County, WI	2013	NA	15744	14190	1554	9.9
CN5503100000000	55	031	Douglas County, WI	2013	NA	23577	22015	1562	6.6
CN5503300000000	55	033	Dunn County, WI	2013	NA	23549	22052	1497	6.4
CN5503500000000	55	035	Eau Claire County, WI	2013	NA	57929	54655	3274	5.7
CN5503700000000	55	037	Florence County, WI	2013	NA	2197	2015	182	8.3
CN5503900000000	55	039	Fond du Lac County, WI	2013	NA	57078	53569	3509	6.1
CN5504100000000	55	041	Forest County, WI	2013	NA	4081	3634	447	11
CN5504300000000	55	043	Grant County, WI	2013	NA	27657	26027	1630	5.9
CN5504500000000	55	045	Green County, WI	2013	NA	20864	19672	1192	5.7
CN5504700000000	55	047	Green Lake County, WI	2013	NA	10208	9398	810	7.9
CN5504900000000	55	049	Iowa County, WI	2013	NA	13547	12670	877	6.5
CN5505100000000	55	051	Iron County, WI	2013	NA	2728	2436	292	10.7
CN5505300000000	55	053	Jackson County, WI	2013	NA	10149	9433	716	7.1
CN5505500000000	55	055	Jefferson County, WI	2013	NA	45919	43042	2877	6.3
CN5505700000000	55	057	Juneau County, WI	2013	NA	13481	12386	1095	8.1
CN5505900000000	55	059	Kenosha County, WI	2013	NA	86956	80302	6654	7.7
CN5506100000000	55	061	Kewaunee County, WI	2013	NA	10937	10239	698	6.4
CN5506300000000	55	063	La Crosse County, WI	2013	NA	66779	63242	3537	5.3
CN5506500000000	55	065	Lafayette County, WI	2013	NA	9350	8846	504	5.4
CN5506700000000	55	067	Langlade County, WI	2013	NA	9815	8923	892	9.1
CN5506900000000	55	069	Lincoln County, WI	2013	NA	15184	13919	1265	8.3
CN5507100000000	55	071	Manitowoc County, WI	2013	NA	42702	39554	3148	7.4
CN5507300000000	55	073	Marathon County, WI	2013	NA	72138	67302	4836	6.7
CN5507500000000	55	075	Marinette County, WI	2013	NA	21453	19754	1699	7.9
CN5507700000000	55	077	Marquette County, WI	2013	NA	7511	6877	634	8.4
CN5507800000000	55	078	Menominee County, WI	2013	NA	1573	1324	249	15.8
CN5507900000000	55	079	Milwaukee County, WI	2013	NA	479081	438864	40217	8.4
CN5508100000000	55	081	Monroe County, WI	2013	NA	22766	21199	1567	6.9
CN5508300000000	55	083	Oconto County, WI	2013	NA	20460	18882	1578	7.7
CN5508500000000	55	085	Oneida County, WI	2013	NA	18598	17004	1594	8.6
CN5508700000000	55	087	Outagamie County, WI	2013	NA	100507	94378	6129	6.1
CN5508900000000	55	089	Ozaukee County, WI	2013	NA	47537	45048	2489	5.2
CN5509100000000	55	091	Pepin County, WI	2013	NA	4031	3803	228	5.7
CN5509300000000	55	093	Pierce County, WI	2013	NA	24001	22737	1264	5.3
CN5509500000000	55	095	Polk County, WI	2013	NA	24314	22583	1731	7.1
CN5509700000000	55	097	Portage County, WI	2013	NA	38959	36267	2692	6.9
CN5509900000000	55	099	Price County, WI	2013	NA	6857	6385	472	6.9
CN5510100000000	55	101	Racine County, WI	2013	NA	99753	91452	8301	8.3
CN5510300000000	55	103	Richland County, WI	2013	NA	9350	8782	568	6.1
CN5510500000000	55	105	Rock County, WI	2013	NA	82187	75851	6336	7.7
CN5510700000000	55	107	Rusk County, WI	2013	NA	6736	6161	575	8.5
CN5510900000000	55	109	St. Croix County, WI	2013	NA	47822	45251	2571	5.4
CN5511100000000	55	111	Sauk County, WI	2013	NA	35393	33180	2213	6.3
CN5511300000000	55	113	Sawyer County, WI	2013	NA	8191	7295	896	10.9
CN5511500000000	55	115	Shawano County, WI	2013	NA	21471	19869	1602	7.5
CN5511700000000	55	117	Sheboygan County, WI	2013	NA	60771	57074	3697	6.1
CN5511900000000	55	119	Taylor County, WI	2013	NA	10992	10286	706	6.4
CN5512100000000	55	121	Trempealeau County, WI	2013	NA	16418	15501	917	5.6
CN5512300000000	55	123	Vernon County, WI	2013	NA	15138	14235	903	6
CN5512500000000	55	125	Vilas County, WI	2013	NA	10183	9152	1031	10.1
CN5512700000000	55	127	Walworth County, WI	2013	NA	56806	52919	3887	6.8
CN5512900000000	55	129	Washburn County, WI	2013	NA	8000	7406	594	7.4
CN5513100000000	55	131	Washington County, WI	2013	NA	75277	70976	4301	5.7
CN5513300000000	55	133	Waukesha County, WI	2013	NA	219067	207002	12065	5.5
CN5513500000000	55	135	Waupaca County, WI	2013	NA	27363	25362	2001	7.3
CN5513700000000	55	137	Waushara County, WI	2013	NA	11830	10816	1014	8.6
CN5513900000000	55	139	Winnebago County, WI	2013	NA	91686	85833	5853	6.4
CN5514100000000	55	141	Wood County, WI	2013	NA	39015	36179	2836	7.3
CN5600100000000	56	001	Albany County, WY	2013	NA	20692	19916	776	3.8
CN5600300000000	56	003	Big Horn County, WY	2013	NA	5583	5293	290	5.2
CN5600500000000	56	005	Campbell County, WY	2013	NA	25698	24607	1091	4.2
CN5600700000000	56	007	Carbon County, WY	2013	NA	8378	8016	362	4.3
CN5600900000000	56	009	Converse County, WY	2013	NA	8108	7811	297	3.7
CN5601100000000	56	011	Crook County, WY	2013	NA	3691	3527	164	4.4
CN5601300000000	56	013	Fremont County, WY	2013	NA	21046	19848	1198	5.7
CN5601500000000	56	015	Goshen County, WY	2013	NA	7333	7025	308	4.2
CN5601700000000	56	017	Hot Springs County, WY	2013	NA	2557	2436	121	4.7
CN5601900000000	56	019	Johnson County, WY	2013	NA	4478	4251	227	5.1
CN5602100000000	56	021	Laramie County, WY	2013	NA	48587	46258	2329	4.8
CN5602300000000	56	023	Lincoln County, WY	2013	NA	8165	7697	468	5.7
CN5602500000000	56	025	Natrona County, WY	2013	NA	43105	41150	1955	4.5
CN5602700000000	56	027	Niobrara County, WY	2013	NA	1381	1332	49	3.5
CN5602900000000	56	029	Park County, WY	2013	NA	15864	15056	808	5.1
CN5603100000000	56	031	Platte County, WY	2013	NA	4804	4593	211	4.4
CN5603300000000	56	033	Sheridan County, WY	2013	NA	15792	14923	869	5.5
CN5603500000000	56	035	Sublette County, WY	2013	NA	5081	4842	239	4.7
CN5603700000000	56	037	Sweetwater County, WY	2013	NA	23883	22838	1045	4.4
CN5603900000000	56	039	Teton County, WY	2013	NA	14107	13318	789	5.6
CN5604100000000	56	041	Uinta County, WY	2013	NA	9960	9435	525	5.3
CN5604300000000	56	043	Washakie County, WY	2013	NA	4362	4146	216	5
CN5604500000000	56	045	Weston County, WY	2013	NA	3956	3814	142	3.6
CN7200100000000	72	001	Adjuntas Municipio, PR	2013	NA	4814	3702	1112	23.1
CN7200300000000	72	003	Aguada Municipio, PR	2013	NA	12355	10071	2284	18.5
CN7200500000000	72	005	Aguadilla Municipio, PR	2013	NA	15382	12693	2689	17.5
CN7200700000000	72	007	Aguas Buenas Municipio, PR	2013	NA	7117	5921	1196	16.8
CN7200900000000	72	009	Aibonito Municipio, PR	2013	NA	7012	5816	1196	17.1
CN7201100000000	72	011	Anasco Municipio, PR	2013	NA	9259	7554	1705	18.4
CN7201300000000	72	013	Arecibo Municipio, PR	2013	NA	25281	21338	3943	15.6
CN7201500000000	72	015	Arroyo Municipio, PR	2013	NA	5661	4227	1434	25.3
CN7201700000000	72	017	Barceloneta Municipio, PR	2013	NA	6321	4964	1357	21.5
CN7201900000000	72	019	Barranquitas Municipio, PR	2013	NA	7725	6527	1198	15.5
CN7202100000000	72	021	Bayamon Municipio, PR	2013	NA	69653	62613	7040	10.1
CN7202300000000	72	023	Cabo Rojo Municipio, PR	2013	NA	14878	11878	3000	20.2
CN7202500000000	72	025	Caguas Municipio, PR	2013	NA	50558	44534	6024	11.9
CN7202700000000	72	027	Camuy Municipio, PR	2013	NA	9990	8486	1504	15.1
CN7202900000000	72	029	Canovanas Municipio, PR	2013	NA	16427	14276	2151	13.1
CN7203100000000	72	031	Carolina Municipio, PR	2013	NA	64572	58444	6128	9.5
CN7203300000000	72	033	Catano Municipio, PR	2013	NA	8470	7366	1104	13
CN7203500000000	72	035	Cayey Municipio, PR	2013	NA	16912	14616	2296	13.6
CN7203700000000	72	037	Ceiba Municipio, PR	2013	NA	4195	3437	758	18.1
CN7203900000000	72	039	Ciales Municipio, PR	2013	NA	4465	3317	1148	25.7
CN7204100000000	72	041	Cidra Municipio, PR	2013	NA	16280	14210	2070	12.7
CN7204300000000	72	043	Coamo Municipio, PR	2013	NA	11414	9106	2308	20.2
CN7204500000000	72	045	Comerio Municipio, PR	2013	NA	5492	4395	1097	20
CN7204700000000	72	047	Corozal Municipio, PR	2013	NA	9748	8285	1463	15
CN7204900000000	72	049	Culebra Municipio, PR	2013	NA	850	793	57	6.7
CN7205100000000	72	051	Dorado Municipio, PR	2013	NA	12844	11707	1137	8.9
CN7205300000000	72	053	Fajardo Municipio, PR	2013	NA	12255	10154	2101	17.1
CN7205400000000	72	054	Florida Municipio, PR	2013	NA	3696	2924	772	20.9
CN7205500000000	72	055	Guanica Municipio, PR	2013	NA	4776	3503	1273	26.7
CN7205700000000	72	057	Guayama Municipio, PR	2013	NA	12982	10159	2823	21.7
CN7205900000000	72	059	Guayanilla Municipio, PR	2013	NA	5696	4443	1253	22
CN7206100000000	72	061	Guaynabo Municipio, PR	2013	NA	37826	35532	2294	6.1
CN7206300000000	72	063	Gurabo Municipio, PR	2013	NA	17235	15394	1841	10.7
CN7206500000000	72	065	Hatillo Municipio, PR	2013	NA	13423	11264	2159	16.1
CN7206700000000	72	067	Hormigueros Municipio, PR	2013	NA	5859	4863	996	17
CN7206900000000	72	069	Humacao Municipio, PR	2013	NA	18539	15140	3399	18.3
CN7207100000000	72	071	Isabela Municipio, PR	2013	NA	12116	10012	2104	17.4
CN7207300000000	72	073	Jayuya Municipio, PR	2013	NA	4374	3574	800	18.3
CN7207500000000	72	075	Juana Diaz Municipio, PR	2013	NA	16078	13566	2512	15.6
CN7207700000000	72	077	Juncos Municipio, PR	2013	NA	12703	10729	1974	15.5
CN7207900000000	72	079	Lajas Municipio, PR	2013	NA	6224	4520	1704	27.4
CN7208100000000	72	081	Lares Municipio, PR	2013	NA	8092	6088	2004	24.8
CN7208300000000	72	083	Las Marias Municipio, PR	2013	NA	3106	2357	749	24.1
CN7208500000000	72	085	Las Piedras Municipio, PR	2013	NA	11794	9724	2070	17.6
CN7208700000000	72	087	Loiza Municipio, PR	2013	NA	9120	7979	1141	12.5
CN7208900000000	72	089	Luquillo Municipio, PR	2013	NA	6796	5513	1283	18.9
CN7209100000000	72	091	Manati Municipio, PR	2013	NA	12064	10407	1657	13.7
CN7209300000000	72	093	Maricao Municipio, PR	2013	NA	2129	1679	450	21.1
CN7209500000000	72	095	Maunabo Municipio, PR	2013	NA	3221	2524	697	21.6
CN7209700000000	72	097	Mayaguez Municipio, PR	2013	NA	25197	20390	4807	19.1
CN7209900000000	72	099	Moca Municipio, PR	2013	NA	11132	8933	2199	19.8
CN7210100000000	72	101	Morovis Municipio, PR	2013	NA	8706	7030	1676	19.3
CN7210300000000	72	103	Naguabo Municipio, PR	2013	NA	8518	7126	1392	16.3
CN7210500000000	72	105	Naranjito Municipio, PR	2013	NA	7670	6403	1267	16.5
CN7210700000000	72	107	Orocovis Municipio, PR	2013	NA	5542	4506	1036	18.7
CN7210900000000	72	109	Patillas Municipio, PR	2013	NA	5139	3886	1253	24.4
CN7211100000000	72	111	Penuelas Municipio, PR	2013	NA	6682	5309	1373	20.5
CN7211300000000	72	113	Ponce Municipio, PR	2013	NA	50837	42728	8109	16
CN7211500000000	72	115	Quebradillas Municipio, PR	2013	NA	6366	5160	1206	18.9
CN7211700000000	72	117	Rincon Municipio, PR	2013	NA	4767	3791	976	20.5
CN7211900000000	72	119	Rio Grande Municipio, PR	2013	NA	17586	15509	2077	11.8
CN7212100000000	72	121	Sabana Grande Municipio, PR	2013	NA	6712	5287	1425	21.2
CN7212300000000	72	123	Salinas Municipio, PR	2013	NA	8610	6374	2236	26
CN7212500000000	72	125	San German Municipio, PR	2013	NA	10853	8689	2164	19.9
CN7212700000000	72	127	San Juan Municipio, PR	2013	NA	139982	128736	11246	8
CN7212900000000	72	129	San Lorenzo Municipio, PR	2013	NA	12656	10558	2098	16.6
CN7213100000000	72	131	San Sebastian Municipio, PR	2013	NA	11363	8654	2709	23.8
CN7213300000000	72	133	Santa Isabel Municipio, PR	2013	NA	10008	8118	1890	18.9
CN7213500000000	72	135	Toa Alta Municipio, PR	2013	NA	26290	23838	2452	9.3
CN7213700000000	72	137	Toa Baja Municipio, PR	2013	NA	31209	27921	3288	10.5
CN7213900000000	72	139	Trujillo Alto Municipio, PR	2013	NA	27826	25725	2101	7.6
CN7214100000000	72	141	Utuado Municipio, PR	2013	NA	7324	5885	1439	19.6
CN7214300000000	72	143	Vega Alta Municipio, PR	2013	NA	10188	8751	1437	14.1
CN7214500000000	72	145	Vega Baja Municipio, PR	2013	NA	14601	12198	2403	16.5
CN7214700000000	72	147	Vieques Municipio, PR	2013	NA	3080	2589	491	15.9
CN7214900000000	72	149	Villalba Municipio, PR	2013	NA	8184	6416	1768	21.6
CN7215100000000	72	151	Yabucoa Municipio, PR	2013	NA	10169	7742	2427	23.9
CN7215300000000	72	153	Yauco Municipio, PR	2013	NA	11350	8959	2391	21.1
NA	NA	NA	NA	NA	NA	NA	NA	NA	NA
SOURCE:  BLS, LAUS	NA	NA	NA	NA	NA	NA	NA	NA	NA
April 17, 2020	NA	NA	NA	NA	NA	NA	NA	NA	NA
