LAUS_CODE	STATE_FIPS	COUNTY_FIPS	COUNTY	YEAR	ESTIMATED	LABOR_FORCE	EMPLOYED	UNEMPLOYED_LEVEL	UNEMPLOYED_RATE
CN0100100000000	01	001	Autauga County, AL	1995	NA	19647	18515	1132	5.8
CN0100300000000	01	003	Baldwin County, AL	1995	NA	60820	57883	2937	4.8
CN0100500000000	01	005	Barbour County, AL	1995	NA	12360	11329	1031	8.3
CN0100700000000	01	007	Bibb County, AL	1995	NA	7993	7461	532	6.7
CN0100900000000	01	009	Blount County, AL	1995	NA	20993	20055	938	4.5
CN0101100000000	01	011	Bullock County, AL	1995	NA	4456	3704	752	16.9
CN0101300000000	01	013	Butler County, AL	1995	NA	10023	9168	855	8.5
CN0101500000000	01	015	Calhoun County, AL	1995	NA	53449	49215	4234	7.9
CN0101700000000	01	017	Chambers County, AL	1995	NA	17161	15885	1276	7.4
CN0101900000000	01	019	Cherokee County, AL	1995	NA	10157	9511	646	6.4
CN0102100000000	01	021	Chilton County, AL	1995	NA	17555	16443	1112	6.3
CN0102300000000	01	023	Choctaw County, AL	1995	NA	6827	6116	711	10.4
CN0102500000000	01	025	Clarke County, AL	1995	NA	13568	12159	1409	10.4
CN0102700000000	01	027	Clay County, AL	1995	NA	6621	6249	372	5.6
CN0102900000000	01	029	Cleburne County, AL	1995	NA	7317	6910	407	5.6
CN0103100000000	01	031	Coffee County, AL	1995	NA	21554	20591	963	4.5
CN0103300000000	01	033	Colbert County, AL	1995	NA	26724	24802	1922	7.2
CN0103500000000	01	035	Conecuh County, AL	1995	NA	6715	6005	710	10.6
CN0103700000000	01	037	Coosa County, AL	1995	NA	5411	5144	267	4.9
CN0103900000000	01	039	Covington County, AL	1995	NA	17682	16478	1204	6.8
CN0104100000000	01	041	Crenshaw County, AL	1995	NA	6039	5689	350	5.8
CN0104300000000	01	043	Cullman County, AL	1995	NA	37455	35464	1991	5.3
CN0104500000000	01	045	Dale County, AL	1995	NA	21011	19599	1412	6.7
CN0104700000000	01	047	Dallas County, AL	1995	NA	21021	18357	2664	12.7
CN0104900000000	01	049	DeKalb County, AL	1995	NA	31232	29600	1632	5.2
CN0105100000000	01	051	Elmore County, AL	1995	NA	26367	25075	1292	4.9
CN0105300000000	01	053	Escambia County, AL	1995	NA	16320	14955	1365	8.4
CN0105500000000	01	055	Etowah County, AL	1995	NA	48527	45426	3101	6.4
CN0105700000000	01	057	Fayette County, AL	1995	NA	8755	8250	505	5.8
CN0105900000000	01	059	Franklin County, AL	1995	NA	15939	14796	1143	7.2
CN0106100000000	01	061	Geneva County, AL	1995	NA	12614	11767	847	6.7
CN0106300000000	01	063	Greene County, AL	1995	NA	3636	3122	514	14.1
CN0106500000000	01	065	Hale County, AL	1995	NA	7129	6453	676	9.5
CN0106700000000	01	067	Henry County, AL	1995	NA	6472	6018	454	7
CN0106900000000	01	069	Houston County, AL	1995	NA	42294	40235	2059	4.9
CN0107100000000	01	071	Jackson County, AL	1995	NA	25255	22862	2393	9.5
CN0107300000000	01	073	Jefferson County, AL	1995	NA	325223	311038	14185	4.4
CN0107500000000	01	075	Lamar County, AL	1995	NA	7905	7423	482	6.1
CN0107700000000	01	077	Lauderdale County, AL	1995	NA	42640	40169	2471	5.8
CN0107900000000	01	079	Lawrence County, AL	1995	NA	15571	14408	1163	7.5
CN0108100000000	01	081	Lee County, AL	1995	NA	46536	44536	2000	4.3
CN0108300000000	01	083	Limestone County, AL	1995	NA	26810	25464	1346	5
CN0108500000000	01	085	Lowndes County, AL	1995	NA	4292	3590	702	16.4
CN0108700000000	01	087	Macon County, AL	1995	NA	8472	7758	714	8.4
CN0108900000000	01	089	Madison County, AL	1995	NA	134837	128718	6119	4.5
CN0109100000000	01	091	Marengo County, AL	1995	NA	10806	9898	908	8.4
CN0109300000000	01	093	Marion County, AL	1995	NA	15634	14708	926	5.9
CN0109500000000	01	095	Marshall County, AL	1995	NA	39458	36718	2740	6.9
CN0109700000000	01	097	Mobile County, AL	1995	NA	192697	178991	13706	7.1
CN0109900000000	01	099	Monroe County, AL	1995	NA	10557	9278	1279	12.1
CN0110100000000	01	101	Montgomery County, AL	1995	NA	106867	101087	5780	5.4
CN0110300000000	01	103	Morgan County, AL	1995	NA	53398	50194	3204	6
CN0110500000000	01	105	Perry County, AL	1995	NA	4906	4059	847	17.3
CN0110700000000	01	107	Pickens County, AL	1995	NA	8938	8140	798	8.9
CN0110900000000	01	109	Pike County, AL	1995	NA	13364	12553	811	6.1
CN0111100000000	01	111	Randolph County, AL	1995	NA	9814	9063	751	7.7
CN0111300000000	01	113	Russell County, AL	1995	NA	24049	22557	1492	6.2
CN0111500000000	01	115	St. Clair County, AL	1995	NA	27322	26301	1021	3.7
CN0111700000000	01	117	Shelby County, AL	1995	NA	68530	66813	1717	2.5
CN0111900000000	01	119	Sumter County, AL	1995	NA	6307	5474	833	13.2
CN0112100000000	01	121	Talladega County, AL	1995	NA	35374	32760	2614	7.4
CN0112300000000	01	123	Tallapoosa County, AL	1995	NA	20240	19087	1153	5.7
CN0112500000000	01	125	Tuscaloosa County, AL	1995	NA	76368	72934	3434	4.5
CN0112700000000	01	127	Walker County, AL	1995	NA	30309	28047	2262	7.5
CN0112900000000	01	129	Washington County, AL	1995	NA	6400	5521	879	13.7
CN0113100000000	01	131	Wilcox County, AL	1995	NA	3949	3322	627	15.9
CN0113300000000	01	133	Winston County, AL	1995	NA	12777	11981	796	6.2
CN0201300000000	02	013	Aleutians East Borough, AK	1995	NA	1585	1530	55	3.5
CN0201600000000	02	016	Aleutians West Census Area, AK	1995	NA	2404	2339	65	2.7
CN0202000000000	02	020	Anchorage Borough/municipality, AK	1995	NA	133751	126722	7029	5.3
CN0205000000000	02	050	Bethel Census Area, AK	1995	NA	5754	5292	462	8
CN0206000000000	02	060	Bristol Bay Borough, AK	1995	NA	564	528	36	6.4
CN0206800000000	02	068	Denali Borough, AK	1995	NA	1142	1037	105	9.2
CN0207000000000	02	070	Dillingham Census Area, AK	1995	NA	1654	1550	104	6.3
CN0209000000000	02	090	Fairbanks North Star Borough, AK	1995	NA	41375	38263	3112	7.5
CN0210000000000	02	100	Haines Borough, AK	1995	NA	1189	1058	131	11
CN0211000000000	02	110	Juneau Borough/city, AK	1995	NA	16739	15774	965	5.8
CN0212200000000	02	122	Kenai Peninsula Borough, AK	1995	NA	21593	18938	2655	12.3
CN0213000000000	02	130	Ketchikan Gateway Borough, AK	1995	NA	7773	7181	592	7.6
CN0215000000000	02	150	Kodiak Island Borough, AK	1995	NA	7527	6783	744	9.9
CN0215800000000	02	158	Kusilvak Census Area, AK	1995	NA	1924	1699	225	11.7
CN0216400000000	02	164	Lake and Peninsula Borough, AK	1995	NA	593	551	42	7.1
CN0217000000000	02	170	Matanuska-Susitna Borough, AK	1995	NA	25555	22960	2595	10.2
CN0218000000000	02	180	Nome Census Area, AK	1995	NA	3406	2966	440	12.9
CN0218500000000	02	185	North Slope Borough, AK	1995	NA	3170	3052	118	3.7
CN0218800000000	02	188	Northwest Arctic Borough, AK	1995	NA	2216	1856	360	16.2
CN0220100000000	02	201	Prince of Wales-Outer Ketchikan Census Area, AK	1995	NA	3314	2956	358	10.8
CN0222000000000	02	220	Sitka Borough/city, AK	1995	NA	4610	4324	286	6.2
CN0223200000000	02	232	Skagway-Hoonah-Angoon Census Area, AK	1995	NA	2324	2145	179	7.7
CN0224000000000	02	240	Southeast Fairbanks Census Area, AK	1995	NA	2527	2211	316	12.5
CN0226100000000	02	261	Valdez-Cordova Census Area, AK	1995	NA	5384	4857	527	9.8
CN0228000000000	02	280	Wrangell-Petersburg Census Area, AK	1995	NA	3745	3352	393	10.5
CN0228200000000	02	282	Yakutat Borough/city, AK	1995	NA	305	283	22	7.2
CN0229000000000	02	290	Yukon-Koyukuk Census Area, AK	1995	NA	2038	1682	356	17.5
CN0400100000000	04	001	Apache County, AZ	1995	NA	20627	17081	3546	17.2
CN0400300000000	04	003	Cochise County, AZ	1995	NA	44404	40101	4303	9.7
CN0400500000000	04	005	Coconino County, AZ	1995	NA	60854	55884	4970	8.2
CN0400700000000	04	007	Gila County, AZ	1995	NA	19613	17973	1640	8.4
CN0400900000000	04	009	Graham County, AZ	1995	NA	12238	11181	1057	8.6
CN0401100000000	04	011	Greenlee County, AZ	1995	NA	4878	4533	345	7.1
CN0401200000000	04	012	La Paz County, AZ	1995	NA	6631	5908	723	10.9
CN0401300000000	04	013	Maricopa County, AZ	1995	NA	1370734	1321421	49313	3.6
CN0401500000000	04	015	Mohave County, AZ	1995	NA	60924	56592	4332	7.1
CN0401700000000	04	017	Navajo County, AZ	1995	NA	33179	27949	5230	15.8
CN0401900000000	04	019	Pima County, AZ	1995	NA	390386	376786	13600	3.5
CN0402100000000	04	021	Pinal County, AZ	1995	NA	52875	50216	2659	5
CN0402300000000	04	023	Santa Cruz County, AZ	1995	NA	15874	12606	3268	20.6
CN0402500000000	04	025	Yavapai County, AZ	1995	NA	65235	61946	3289	5
CN0402700000000	04	027	Yuma County, AZ	1995	NA	70683	49725	20958	29.7
CN0500100000000	05	001	Arkansas County, AR	1995	NA	10928	10386	542	5
CN0500300000000	05	003	Ashley County, AR	1995	NA	11280	10617	663	5.9
CN0500500000000	05	005	Baxter County, AR	1995	NA	14676	14194	482	3.3
CN0500700000000	05	007	Benton County, AR	1995	NA	62956	61547	1409	2.2
CN0500900000000	05	009	Boone County, AR	1995	NA	15163	14538	625	4.1
CN0501100000000	05	011	Bradley County, AR	1995	NA	5040	4617	423	8.4
CN0501300000000	05	013	Calhoun County, AR	1995	NA	2392	2164	228	9.5
CN0501500000000	05	015	Carroll County, AR	1995	NA	12126	11534	592	4.9
CN0501700000000	05	017	Chicot County, AR	1995	NA	6435	5880	555	8.6
CN0501900000000	05	019	Clark County, AR	1995	NA	11802	11469	333	2.8
CN0502100000000	05	021	Clay County, AR	1995	NA	8306	7716	590	7.1
CN0502300000000	05	023	Cleburne County, AR	1995	NA	9424	8959	465	4.9
CN0502500000000	05	025	Cleveland County, AR	1995	NA	4028	3830	198	4.9
CN0502700000000	05	027	Columbia County, AR	1995	NA	11853	11062	791	6.7
CN0502900000000	05	029	Conway County, AR	1995	NA	9614	9128	486	5.1
CN0503100000000	05	031	Craighead County, AR	1995	NA	41368	39899	1469	3.6
CN0503300000000	05	033	Crawford County, AR	1995	NA	23857	22648	1209	5.1
CN0503500000000	05	035	Crittenden County, AR	1995	NA	22679	21479	1200	5.3
CN0503700000000	05	037	Cross County, AR	1995	NA	8892	8405	487	5.5
CN0503900000000	05	039	Dallas County, AR	1995	NA	3851	3589	262	6.8
CN0504100000000	05	041	Desha County, AR	1995	NA	7427	6757	670	9
CN0504300000000	05	043	Drew County, AR	1995	NA	10398	9764	634	6.1
CN0504500000000	05	045	Faulkner County, AR	1995	NA	39006	37290	1716	4.4
CN0504700000000	05	047	Franklin County, AR	1995	NA	8085	7776	309	3.8
CN0504900000000	05	049	Fulton County, AR	1995	NA	4668	4456	212	4.5
CN0505100000000	05	051	Garland County, AR	1995	NA	35907	34135	1772	4.9
CN0505300000000	05	053	Grant County, AR	1995	NA	7257	6915	342	4.7
CN0505500000000	05	055	Greene County, AR	1995	NA	18044	17166	878	4.9
CN0505700000000	05	057	Hempstead County, AR	1995	NA	11607	10810	797	6.9
CN0505900000000	05	059	Hot Spring County, AR	1995	NA	12078	11490	588	4.9
CN0506100000000	05	061	Howard County, AR	1995	NA	7153	6835	318	4.4
CN0506300000000	05	063	Independence County, AR	1995	NA	16870	15853	1017	6
CN0506500000000	05	065	Izard County, AR	1995	NA	4072	3803	269	6.6
CN0506700000000	05	067	Jackson County, AR	1995	NA	8275	7519	756	9.1
CN0506900000000	05	069	Jefferson County, AR	1995	NA	37539	34694	2845	7.6
CN0507100000000	05	071	Johnson County, AR	1995	NA	10626	10202	424	4
CN0507300000000	05	073	Lafayette County, AR	1995	NA	3595	3342	253	7
CN0507500000000	05	075	Lawrence County, AR	1995	NA	7852	7398	454	5.8
CN0507700000000	05	077	Lee County, AR	1995	NA	4861	4408	453	9.3
CN0507900000000	05	079	Lincoln County, AR	1995	NA	5399	5079	320	5.9
CN0508100000000	05	081	Little River County, AR	1995	NA	5817	5405	412	7.1
CN0508300000000	05	083	Logan County, AR	1995	NA	10249	9752	497	4.8
CN0508500000000	05	085	Lonoke County, AR	1995	NA	23722	22913	809	3.4
CN0508700000000	05	087	Madison County, AR	1995	NA	6855	6649	206	3
CN0508900000000	05	089	Marion County, AR	1995	NA	6042	5853	189	3.1
CN0509100000000	05	091	Miller County, AR	1995	NA	17394	16243	1151	6.6
CN0509300000000	05	093	Mississippi County, AR	1995	NA	27047	24455	2592	9.6
CN0509500000000	05	095	Monroe County, AR	1995	NA	4394	4112	282	6.4
CN0509700000000	05	097	Montgomery County, AR	1995	NA	3928	3780	148	3.8
CN0509900000000	05	099	Nevada County, AR	1995	NA	4955	4677	278	5.6
CN0510100000000	05	101	Newton County, AR	1995	NA	3040	2872	168	5.5
CN0510300000000	05	103	Ouachita County, AR	1995	NA	12363	11040	1323	10.7
CN0510500000000	05	105	Perry County, AR	1995	NA	3899	3650	249	6.4
CN0510700000000	05	107	Phillips County, AR	1995	NA	11036	9864	1172	10.6
CN0510900000000	05	109	Pike County, AR	1995	NA	5103	4851	252	4.9
CN0511100000000	05	111	Poinsett County, AR	1995	NA	11210	10547	663	5.9
CN0511300000000	05	113	Polk County, AR	1995	NA	8919	8586	333	3.7
CN0511500000000	05	115	Pope County, AR	1995	NA	26961	25692	1269	4.7
CN0511700000000	05	117	Prairie County, AR	1995	NA	4246	3999	247	5.8
CN0511900000000	05	119	Pulaski County, AR	1995	NA	195545	188534	7011	3.6
CN0512100000000	05	121	Randolph County, AR	1995	NA	8012	7436	576	7.2
CN0512300000000	05	123	St. Francis County, AR	1995	NA	12909	11751	1158	9
CN0512500000000	05	125	Saline County, AR	1995	NA	39596	38586	1010	2.6
CN0512700000000	05	127	Scott County, AR	1995	NA	5022	4865	157	3.1
CN0512900000000	05	129	Searcy County, AR	1995	NA	3035	2882	153	5
CN0513100000000	05	131	Sebastian County, AR	1995	NA	56359	53770	2589	4.6
CN0513300000000	05	133	Sevier County, AR	1995	NA	7128	6789	339	4.8
CN0513500000000	05	135	Sharp County, AR	1995	NA	5848	5485	363	6.2
CN0513700000000	05	137	Stone County, AR	1995	NA	5072	4798	274	5.4
CN0513900000000	05	139	Union County, AR	1995	NA	21499	20199	1300	6
CN0514100000000	05	141	Van Buren County, AR	1995	NA	6186	5769	417	6.7
CN0514300000000	05	143	Washington County, AR	1995	NA	74020	72195	1825	2.5
CN0514500000000	05	145	White County, AR	1995	NA	30244	28449	1795	5.9
CN0514700000000	05	147	Woodruff County, AR	1995	NA	4262	3927	335	7.9
CN0514900000000	05	149	Yell County, AR	1995	NA	9446	9110	336	3.6
CN0600100000000	06	001	Alameda County, CA	1995	NA	676198	637485	38713	5.7
CN0600300000000	06	003	Alpine County, CA	1995	NA	483	432	51	10.6
CN0600500000000	06	005	Amador County, CA	1995	NA	13073	12031	1042	8
CN0600700000000	06	007	Butte County, CA	1995	NA	82161	73988	8173	9.9
CN0600900000000	06	009	Calaveras County, CA	1995	NA	14092	12538	1554	11
CN0601100000000	06	011	Colusa County, CA	1995	NA	8548	6864	1684	19.7
CN0601300000000	06	013	Contra Costa County, CA	1995	NA	452166	426417	25749	5.7
CN0601500000000	06	015	Del Norte County, CA	1995	NA	10071	8834	1237	12.3
CN0601700000000	06	017	El Dorado County, CA	1995	NA	72108	67146	4962	6.9
CN0601900000000	06	019	Fresno County, CA	1995	NA	369904	317959	51945	14
CN0602100000000	06	021	Glenn County, CA	1995	NA	11461	9679	1782	15.5
CN0602300000000	06	023	Humboldt County, CA	1995	NA	59699	54741	4958	8.3
CN0602500000000	06	025	Imperial County, CA	1995	NA	57885	40983	16902	29.2
CN0602700000000	06	027	Inyo County, CA	1995	NA	7091	6427	664	9.4
CN0602900000000	06	029	Kern County, CA	1995	NA	270736	233443	37293	13.8
CN0603100000000	06	031	Kings County, CA	1995	NA	41797	35718	6079	14.5
CN0603300000000	06	033	Lake County, CA	1995	NA	23667	20893	2774	11.7
CN0603500000000	06	035	Lassen County, CA	1995	NA	10982	9769	1213	11
CN0603700000000	06	037	Los Angeles County, CA	1995	NA	4279534	3935618	343916	8
CN0603900000000	06	039	Madera County, CA	1995	NA	50627	43073	7554	14.9
CN0604100000000	06	041	Marin County, CA	1995	NA	127528	122050	5478	4.3
CN0604300000000	06	043	Mariposa County, CA	1995	NA	7435	6741	694	9.3
CN0604500000000	06	045	Mendocino County, CA	1995	NA	40964	37073	3891	9.5
CN0604700000000	06	047	Merced County, CA	1995	NA	82705	68609	14096	17
CN0604900000000	06	049	Modoc County, CA	1995	NA	4212	3655	557	13.2
CN0605100000000	06	051	Mono County, CA	1995	NA	6131	5470	661	10.8
CN0605300000000	06	053	Monterey County, CA	1995	NA	174373	152879	21494	12.3
CN0605500000000	06	055	Napa County, CA	1995	NA	57235	53687	3548	6.2
CN0605700000000	06	057	Nevada County, CA	1995	NA	40097	37071	3026	7.5
CN0605900000000	06	059	Orange County, CA	1995	NA	1319744	1253037	66707	5.1
CN0606100000000	06	061	Placer County, CA	1995	NA	101945	95683	6262	6.1
CN0606300000000	06	063	Plumas County, CA	1995	NA	9732	8448	1284	13.2
CN0606500000000	06	065	Riverside County, CA	1995	NA	606575	549306	57269	9.4
CN0606700000000	06	067	Sacramento County, CA	1995	NA	534232	497960	36272	6.8
CN0606900000000	06	069	San Benito County, CA	1995	NA	22897	19786	3111	13.6
CN0607100000000	06	071	San Bernardino County, CA	1995	NA	674915	621837	53078	7.9
CN0607300000000	06	073	San Diego County, CA	1995	NA	1223371	1145883	77488	6.3
CN0607500000000	06	075	San Francisco County/city, CA	1995	NA	394782	370958	23824	6
CN0607700000000	06	077	San Joaquin County, CA	1995	NA	239900	210482	29418	12.3
CN0607900000000	06	079	San Luis Obispo County, CA	1995	NA	100730	94127	6603	6.6
CN0608100000000	06	081	San Mateo County, CA	1995	NA	366720	351317	15403	4.2
CN0608300000000	06	083	Santa Barbara County, CA	1995	NA	191470	178672	12798	6.7
CN0608500000000	06	085	Santa Clara County, CA	1995	NA	859592	817464	42128	4.9
CN0608700000000	06	087	Santa Cruz County, CA	1995	NA	138504	125651	12853	9.3
CN0608900000000	06	089	Shasta County, CA	1995	NA	72010	63878	8132	11.3
CN0609100000000	06	091	Sierra County, CA	1995	NA	1689	1526	163	9.7
CN0609300000000	06	093	Siskiyou County, CA	1995	NA	18827	16138	2689	14.3
CN0609500000000	06	095	Solano County, CA	1995	NA	171536	157979	13557	7.9
CN0609700000000	06	097	Sonoma County, CA	1995	NA	223400	211091	12309	5.5
CN0609900000000	06	099	Stanislaus County, CA	1995	NA	192015	162419	29596	15.4
CN0610100000000	06	101	Sutter County, CA	1995	NA	34233	28368	5865	17.1
CN0610300000000	06	103	Tehama County, CA	1995	NA	23037	20443	2594	11.3
CN0610500000000	06	105	Trinity County, CA	1995	NA	5273	4502	771	14.6
CN0610700000000	06	107	Tulare County, CA	1995	NA	159505	132943	26562	16.7
CN0610900000000	06	109	Tuolumne County, CA	1995	NA	20105	17925	2180	10.8
CN0611100000000	06	111	Ventura County, CA	1995	NA	378845	350722	28123	7.4
CN0611300000000	06	113	Yolo County, CA	1995	NA	86521	80591	5930	6.9
CN0611500000000	06	115	Yuba County, CA	1995	NA	20950	17818	3132	14.9
CN0800100000000	08	001	Adams County, CO	1995	NA	165592	159031	6561	4
CN0800300000000	08	003	Alamosa County, CO	1995	NA	8004	7515	489	6.1
CN0800500000000	08	005	Arapahoe County, CO	1995	NA	268365	259960	8405	3.1
CN0800700000000	08	007	Archuleta County, CO	1995	NA	3643	3475	168	4.6
CN0800900000000	08	009	Baca County, CO	1995	NA	2226	2171	55	2.5
CN0801100000000	08	011	Bent County, CO	1995	NA	2307	2240	67	2.9
CN0801300000000	08	013	Boulder County, CO	1995	NA	153017	146918	6099	4
CN0801400000000	08	014	Broomfield County/city, CO	1995	NA	17315	16820	495	2.9
CN0801500000000	08	015	Chaffee County, CO	1995	NA	7217	6932	285	3.9
CN0801700000000	08	017	Cheyenne County, CO	1995	NA	1208	1171	37	3.1
CN0801900000000	08	019	Clear Creek County, CO	1995	NA	5272	5056	216	4.1
CN0802100000000	08	021	Conejos County, CO	1995	NA	3609	3299	310	8.6
CN0802300000000	08	023	Costilla County, CO	1995	NA	1583	1407	176	11.1
CN0802500000000	08	025	Crowley County, CO	1995	NA	1256	1210	46	3.7
CN0802700000000	08	027	Custer County, CO	1995	NA	1548	1485	63	4.1
CN0802900000000	08	029	Delta County, CO	1995	NA	10160	9564	596	5.9
CN0803100000000	08	031	Denver County/city, CO	1995	NA	279282	266257	13025	4.7
CN0803300000000	08	033	Dolores County, CO	1995	NA	640	584	56	8.8
CN0803500000000	08	035	Douglas County, CO	1995	NA	60187	58806	1381	2.3
CN0803700000000	08	037	Eagle County, CO	1995	NA	17775	17227	548	3.1
CN0803900000000	08	039	Elbert County, CO	1995	NA	8940	8583	357	4
CN0804100000000	08	041	El Paso County, CO	1995	NA	237452	226972	10480	4.4
CN0804300000000	08	043	Fremont County, CO	1995	NA	16468	15605	863	5.2
CN0804500000000	08	045	Garfield County, CO	1995	NA	20714	19904	810	3.9
CN0804700000000	08	047	Gilpin County, CO	1995	NA	3477	3394	83	2.4
CN0804900000000	08	049	Grand County, CO	1995	NA	5483	5321	162	3
CN0805100000000	08	051	Gunnison County, CO	1995	NA	7885	7404	481	6.1
CN0805300000000	08	053	Hinsdale County, CO	1995	NA	611	601	10	1.6
CN0805500000000	08	055	Huerfano County, CO	1995	NA	3195	2982	213	6.7
CN0805700000000	08	057	Jackson County, CO	1995	NA	923	859	64	6.9
CN0805900000000	08	059	Jefferson County, CO	1995	NA	295754	286558	9196	3.1
CN0806100000000	08	061	Kiowa County, CO	1995	NA	883	864	19	2.2
CN0806300000000	08	063	Kit Carson County, CO	1995	NA	3435	3334	101	2.9
CN0806500000000	08	065	Lake County, CO	1995	NA	3131	2980	151	4.8
CN0806700000000	08	067	La Plata County, CO	1995	NA	23531	22477	1054	4.5
CN0806900000000	08	069	Larimer County, CO	1995	NA	129548	124664	4884	3.8
CN0807100000000	08	071	Las Animas County, CO	1995	NA	6497	6168	329	5.1
CN0807300000000	08	073	Lincoln County, CO	1995	NA	2595	2533	62	2.4
CN0807500000000	08	075	Logan County, CO	1995	NA	10037	9714	323	3.2
CN0807700000000	08	077	Mesa County, CO	1995	NA	54526	51622	2904	5.3
CN0807900000000	08	079	Mineral County, CO	1995	NA	397	364	33	8.3
CN0808100000000	08	081	Moffat County, CO	1995	NA	6857	6463	394	5.7
CN0808300000000	08	083	Montezuma County, CO	1995	NA	11411	10636	775	6.8
CN0808500000000	08	085	Montrose County, CO	1995	NA	14899	14059	840	5.6
CN0808700000000	08	087	Morgan County, CO	1995	NA	13101	12652	449	3.4
CN0808900000000	08	089	Otero County, CO	1995	NA	9052	8571	481	5.3
CN0809100000000	08	091	Ouray County, CO	1995	NA	1692	1609	83	4.9
CN0809300000000	08	093	Park County, CO	1995	NA	7630	7332	298	3.9
CN0809500000000	08	095	Phillips County, CO	1995	NA	1980	1950	30	1.5
CN0809700000000	08	097	Pitkin County, CO	1995	NA	9082	8669	413	4.5
CN0809900000000	08	099	Prowers County, CO	1995	NA	6496	6223	273	4.2
CN0810100000000	08	101	Pueblo County, CO	1995	NA	57922	54588	3334	5.8
CN0810300000000	08	103	Rio Blanco County, CO	1995	NA	3459	3224	235	6.8
CN0810500000000	08	105	Rio Grande County, CO	1995	NA	5249	4807	442	8.4
CN0810700000000	08	107	Routt County, CO	1995	NA	10358	9939	419	4
CN0810900000000	08	109	Saguache County, CO	1995	NA	2677	2402	275	10.3
CN0811100000000	08	111	San Juan County, CO	1995	NA	280	235	45	16.1
CN0811300000000	08	113	San Miguel County, CO	1995	NA	4473	4293	180	4
CN0811500000000	08	115	Sedgwick County, CO	1995	NA	1241	1200	41	3.3
CN0811700000000	08	117	Summit County, CO	1995	NA	11500	11178	322	2.8
CN0811900000000	08	119	Teller County, CO	1995	NA	13088	12515	573	4.4
CN0812100000000	08	121	Washington County, CO	1995	NA	2372	2306	66	2.8
CN0812300000000	08	123	Weld County, CO	1995	NA	80199	76569	3630	4.5
CN0812500000000	08	125	Yuma County, CO	1995	NA	4281	4198	83	1.9
CN0900100000000	09	001	Fairfield County, CT	1995	NA	446228	424962	21266	4.8
CN0900300000000	09	003	Hartford County, CT	1995	NA	431297	404832	26465	6.1
CN0900500000000	09	005	Litchfield County, CT	1995	NA	100269	95579	4690	4.7
CN0900700000000	09	007	Middlesex County, CT	1995	NA	81788	77495	4293	5.2
CN0900900000000	09	009	New Haven County, CT	1995	NA	414486	390416	24070	5.8
CN0901100000000	09	011	New London County, CT	1995	NA	133330	126282	7048	5.3
CN0901300000000	09	013	Tolland County, CT	1995	NA	70223	66795	3428	4.9
CN0901500000000	09	015	Windham County, CT	1995	NA	56447	52699	3748	6.6
CN1000100000000	10	001	Kent County, DE	1995	NA	69913	66739	3174	4.5
CN1000300000000	10	003	New Castle County, DE	1995	NA	247420	237146	10274	4.2
CN1000500000000	10	005	Sussex County, DE	1995	NA	68504	65314	3190	4.7
CN1100100000000	11	001	District of Columbia	1995	NA	300085	273768	26317	8.8
CN1200100000000	12	001	Alachua County, FL	1995	NA	103623	100652	2971	2.9
CN1200300000000	12	003	Baker County, FL	1995	NA	8796	8316	480	5.5
CN1200500000000	12	005	Bay County, FL	1995	NA	64891	60547	4344	6.7
CN1200700000000	12	007	Bradford County, FL	1995	NA	9769	9403	366	3.7
CN1200900000000	12	009	Brevard County, FL	1995	NA	208467	194713	13754	6.6
CN1201100000000	12	011	Broward County, FL	1995	NA	745036	702194	42842	5.8
CN1201300000000	12	013	Calhoun County, FL	1995	NA	4849	4630	219	4.5
CN1201500000000	12	015	Charlotte County, FL	1995	NA	45334	43181	2153	4.7
CN1201700000000	12	017	Citrus County, FL	1995	NA	35387	32945	2442	6.9
CN1201900000000	12	019	Clay County, FL	1995	NA	64584	62620	1964	3
CN1202100000000	12	021	Collier County, FL	1995	NA	83763	77834	5929	7.1
CN1202300000000	12	023	Columbia County, FL	1995	NA	23235	21919	1316	5.7
CN1202700000000	12	027	DeSoto County, FL	1995	NA	10317	9634	683	6.6
CN1202900000000	12	029	Dixie County, FL	1995	NA	4147	3798	349	8.4
CN1203100000000	12	031	Duval County, FL	1995	NA	376576	362048	14528	3.9
CN1203300000000	12	033	Escambia County, FL	1995	NA	123831	118509	5322	4.3
CN1203500000000	12	035	Flagler County, FL	1995	NA	15180	14667	513	3.4
CN1203700000000	12	037	Franklin County, FL	1995	NA	4910	4697	213	4.3
CN1203900000000	12	039	Gadsden County, FL	1995	NA	19431	18601	830	4.3
CN1204100000000	12	041	Gilchrist County, FL	1995	NA	4375	4216	159	3.6
CN1204300000000	12	043	Glades County, FL	1995	NA	3552	3206	346	9.7
CN1204500000000	12	045	Gulf County, FL	1995	NA	5846	5513	333	5.7
CN1204700000000	12	047	Hamilton County, FL	1995	NA	3769	3516	253	6.7
CN1204900000000	12	049	Hardee County, FL	1995	NA	11444	9949	1495	13.1
CN1205100000000	12	051	Hendry County, FL	1995	NA	16626	14102	2524	15.2
CN1205300000000	12	053	Hernando County, FL	1995	NA	43602	41253	2349	5.4
CN1205500000000	12	055	Highlands County, FL	1995	NA	28587	26081	2506	8.8
CN1205700000000	12	057	Hillsborough County, FL	1995	NA	507720	485604	22116	4.4
CN1205900000000	12	059	Holmes County, FL	1995	NA	7043	6548	495	7
CN1206100000000	12	061	Indian River County, FL	1995	NA	42944	38716	4228	9.8
CN1206300000000	12	063	Jackson County, FL	1995	NA	19408	18352	1056	5.4
CN1206500000000	12	065	Jefferson County, FL	1995	NA	5415	5155	260	4.8
CN1206700000000	12	067	Lafayette County, FL	1995	NA	2670	2576	94	3.5
CN1206900000000	12	069	Lake County, FL	1995	NA	78211	74057	4154	5.3
CN1207100000000	12	071	Lee County, FL	1995	NA	175427	168059	7368	4.2
CN1207300000000	12	073	Leon County, FL	1995	NA	127896	124327	3569	2.8
CN1207500000000	12	075	Levy County, FL	1995	NA	12768	12165	603	4.7
CN1207700000000	12	077	Liberty County, FL	1995	NA	2484	2428	56	2.3
CN1207900000000	12	079	Madison County, FL	1995	NA	7500	7194	306	4.1
CN1208100000000	12	081	Manatee County, FL	1995	NA	104619	100448	4171	4
CN1208300000000	12	083	Marion County, FL	1995	NA	92167	87174	4993	5.4
CN1208500000000	12	085	Martin County, FL	1995	NA	46539	42914	3625	7.8
CN1208600000000	12	086	Miami-Dade County, FL	1995	NA	1037572	960532	77040	7.4
CN1208700000000	12	087	Monroe County, FL	1995	NA	44664	43437	1227	2.7
CN1208900000000	12	089	Nassau County, FL	1995	NA	26620	25545	1075	4
CN1209100000000	12	091	Okaloosa County, FL	1995	NA	76921	73520	3401	4.4
CN1209300000000	12	093	Okeechobee County, FL	1995	NA	15890	14305	1585	10
CN1209500000000	12	095	Orange County, FL	1995	NA	435574	415857	19717	4.5
CN1209700000000	12	097	Osceola County, FL	1995	NA	72243	68820	3423	4.7
CN1209900000000	12	099	Palm Beach County, FL	1995	NA	470288	436254	34034	7.2
CN1210100000000	12	101	Pasco County, FL	1995	NA	124034	117700	6334	5.1
CN1210300000000	12	103	Pinellas County, FL	1995	NA	451302	432658	18644	4.1
CN1210500000000	12	105	Polk County, FL	1995	NA	200191	185398	14793	7.4
CN1210700000000	12	107	Putnam County, FL	1995	NA	30325	28749	1576	5.2
CN1210900000000	12	109	St. Johns County, FL	1995	NA	54342	52474	1868	3.4
CN1211100000000	12	111	St. Lucie County, FL	1995	NA	76247	66683	9564	12.5
CN1211300000000	12	113	Santa Rosa County, FL	1995	NA	48402	46404	1998	4.1
CN1211500000000	12	115	Sarasota County, FL	1995	NA	132681	128150	4531	3.4
CN1211700000000	12	117	Seminole County, FL	1995	NA	195416	187541	7875	4
CN1211900000000	12	119	Sumter County, FL	1995	NA	13110	12399	711	5.4
CN1212100000000	12	121	Suwannee County, FL	1995	NA	13291	12608	683	5.1
CN1212300000000	12	123	Taylor County, FL	1995	NA	7707	6950	757	9.8
CN1212500000000	12	125	Union County, FL	1995	NA	4061	3876	185	4.6
CN1212700000000	12	127	Volusia County, FL	1995	NA	179345	170638	8707	4.9
CN1212900000000	12	129	Wakulla County, FL	1995	NA	9491	9092	399	4.2
CN1213100000000	12	131	Walton County, FL	1995	NA	14752	14092	660	4.5
CN1213300000000	12	133	Washington County, FL	1995	NA	8953	8396	557	6.2
CN1300100000000	13	001	Appling County, GA	1995	NA	8133	7525	608	7.5
CN1300300000000	13	003	Atkinson County, GA	1995	NA	3193	2976	217	6.8
CN1300500000000	13	005	Bacon County, GA	1995	NA	4578	4369	209	4.6
CN1300700000000	13	007	Baker County, GA	1995	NA	1474	1359	115	7.8
CN1300900000000	13	009	Baldwin County, GA	1995	NA	17432	16750	682	3.9
CN1301100000000	13	011	Banks County, GA	1995	NA	5737	5467	270	4.7
CN1301300000000	13	013	Barrow County, GA	1995	NA	17819	16838	981	5.5
CN1301500000000	13	015	Bartow County, GA	1995	NA	33488	31458	2030	6.1
CN1301700000000	13	017	Ben Hill County, GA	1995	NA	8434	8000	434	5.1
CN1301900000000	13	019	Berrien County, GA	1995	NA	6538	6155	383	5.9
CN1302100000000	13	021	Bibb County, GA	1995	NA	71467	67646	3821	5.3
CN1302300000000	13	023	Bleckley County, GA	1995	NA	5578	5342	236	4.2
CN1302500000000	13	025	Brantley County, GA	1995	NA	4947	4527	420	8.5
CN1302700000000	13	027	Brooks County, GA	1995	NA	6812	6549	263	3.9
CN1302900000000	13	029	Bryan County, GA	1995	NA	9428	9045	383	4.1
CN1303100000000	13	031	Bulloch County, GA	1995	NA	22883	22104	779	3.4
CN1303300000000	13	033	Burke County, GA	1995	NA	8680	7477	1203	13.9
CN1303500000000	13	035	Butts County, GA	1995	NA	7917	7464	453	5.7
CN1303700000000	13	037	Calhoun County, GA	1995	NA	2251	2074	177	7.9
CN1303900000000	13	039	Camden County, GA	1995	NA	15187	14595	592	3.9
CN1304300000000	13	043	Candler County, GA	1995	NA	3640	3458	182	5
CN1304500000000	13	045	Carroll County, GA	1995	NA	39698	37650	2048	5.2
CN1304700000000	13	047	Catoosa County, GA	1995	NA	24257	23228	1029	4.2
CN1304900000000	13	049	Charlton County, GA	1995	NA	3919	3670	249	6.4
CN1305100000000	13	051	Chatham County, GA	1995	NA	103842	98220	5622	5.4
CN1305300000000	13	053	Chattahoochee County, GA	1995	NA	2093	1941	152	7.3
CN1305500000000	13	055	Chattooga County, GA	1995	NA	11933	11367	566	4.7
CN1305700000000	13	057	Cherokee County, GA	1995	NA	64236	62009	2227	3.5
CN1305900000000	13	059	Clarke County, GA	1995	NA	45566	44030	1536	3.4
CN1306100000000	13	061	Clay County, GA	1995	NA	1509	1401	108	7.2
CN1306300000000	13	063	Clayton County, GA	1995	NA	112328	106697	5631	5
CN1306500000000	13	065	Clinch County, GA	1995	NA	3868	3717	151	3.9
CN1306700000000	13	067	Cobb County, GA	1995	NA	310908	299651	11257	3.6
CN1306900000000	13	069	Coffee County, GA	1995	NA	16656	15654	1002	6
CN1307100000000	13	071	Colquitt County, GA	1995	NA	17195	16501	694	4
CN1307300000000	13	073	Columbia County, GA	1995	NA	40025	38368	1657	4.1
CN1307500000000	13	075	Cook County, GA	1995	NA	6988	6737	251	3.6
CN1307700000000	13	077	Coweta County, GA	1995	NA	36095	34629	1466	4.1
CN1307900000000	13	079	Crawford County, GA	1995	NA	5325	5062	263	4.9
CN1308100000000	13	081	Crisp County, GA	1995	NA	9852	9339	513	5.2
CN1308300000000	13	083	Dade County, GA	1995	NA	6766	6438	328	4.8
CN1308500000000	13	085	Dawson County, GA	1995	NA	8243	7921	322	3.9
CN1308700000000	13	087	Decatur County, GA	1995	NA	11646	10877	769	6.6
CN1308900000000	13	089	DeKalb County, GA	1995	NA	340088	323643	16445	4.8
CN1309100000000	13	091	Dodge County, GA	1995	NA	9694	9170	524	5.4
CN1309300000000	13	093	Dooly County, GA	1995	NA	4639	4324	315	6.8
CN1309500000000	13	095	Dougherty County, GA	1995	NA	44586	41646	2940	6.6
CN1309700000000	13	097	Douglas County, GA	1995	NA	45096	43488	1608	3.6
CN1309900000000	13	099	Early County, GA	1995	NA	4975	4576	399	8
CN1310100000000	13	101	Echols County, GA	1995	NA	1031	994	37	3.6
CN1310300000000	13	103	Effingham County, GA	1995	NA	14893	14267	626	4.2
CN1310500000000	13	105	Elbert County, GA	1995	NA	8687	7983	704	8.1
CN1310700000000	13	107	Emanuel County, GA	1995	NA	8794	7858	936	10.6
CN1310900000000	13	109	Evans County, GA	1995	NA	4468	4217	251	5.6
CN1311100000000	13	111	Fannin County, GA	1995	NA	8020	7525	495	6.2
CN1311300000000	13	113	Fayette County, GA	1995	NA	41532	40476	1056	2.5
CN1311500000000	13	115	Floyd County, GA	1995	NA	45083	42652	2431	5.4
CN1311700000000	13	117	Forsyth County, GA	1995	NA	34209	33173	1036	3
CN1311900000000	13	119	Franklin County, GA	1995	NA	9470	8949	521	5.5
CN1312100000000	13	121	Fulton County, GA	1995	NA	369786	349806	19980	5.4
CN1312300000000	13	123	Gilmer County, GA	1995	NA	7251	6792	459	6.3
CN1312500000000	13	125	Glascock County, GA	1995	NA	977	933	44	4.5
CN1312700000000	13	127	Glynn County, GA	1995	NA	33329	32125	1204	3.6
CN1312900000000	13	129	Gordon County, GA	1995	NA	20962	19681	1281	6.1
CN1313100000000	13	131	Grady County, GA	1995	NA	9659	9162	497	5.1
CN1313300000000	13	133	Greene County, GA	1995	NA	5233	4815	418	8
CN1313500000000	13	135	Gwinnett County, GA	1995	NA	275003	266346	8657	3.1
CN1313700000000	13	137	Habersham County, GA	1995	NA	14728	14134	594	4
CN1313900000000	13	139	Hall County, GA	1995	NA	64304	62010	2294	3.6
CN1314100000000	13	141	Hancock County, GA	1995	NA	4020	3749	271	6.7
CN1314300000000	13	143	Haralson County, GA	1995	NA	9305	8580	725	7.8
CN1314500000000	13	145	Harris County, GA	1995	NA	10038	9586	452	4.5
CN1314700000000	13	147	Hart County, GA	1995	NA	8637	7847	790	9.1
CN1314900000000	13	149	Heard County, GA	1995	NA	3725	3508	217	5.8
CN1315100000000	13	151	Henry County, GA	1995	NA	45380	43851	1529	3.4
CN1315300000000	13	153	Houston County, GA	1995	NA	47334	45395	1939	4.1
CN1315500000000	13	155	Irwin County, GA	1995	NA	4272	4081	191	4.5
CN1315700000000	13	157	Jackson County, GA	1995	NA	19809	18864	945	4.8
CN1315900000000	13	159	Jasper County, GA	1995	NA	4360	4157	203	4.7
CN1316100000000	13	161	Jeff Davis County, GA	1995	NA	5742	5394	348	6.1
CN1316300000000	13	163	Jefferson County, GA	1995	NA	8184	7268	916	11.2
CN1316500000000	13	165	Jenkins County, GA	1995	NA	4210	3854	356	8.5
CN1316700000000	13	167	Johnson County, GA	1995	NA	4057	3624	433	10.7
CN1316900000000	13	169	Jones County, GA	1995	NA	11236	10761	475	4.2
CN1317100000000	13	171	Lamar County, GA	1995	NA	7121	6831	290	4.1
CN1317300000000	13	173	Lanier County, GA	1995	NA	2917	2800	117	4
CN1317500000000	13	175	Laurens County, GA	1995	NA	21644	20456	1188	5.5
CN1317700000000	13	177	Lee County, GA	1995	NA	9996	9557	439	4.4
CN1317900000000	13	179	Liberty County, GA	1995	NA	15729	14367	1362	8.7
CN1318100000000	13	181	Lincoln County, GA	1995	NA	3596	3323	273	7.6
CN1318300000000	13	183	Long County, GA	1995	NA	3043	2916	127	4.2
CN1318500000000	13	185	Lowndes County, GA	1995	NA	37940	36461	1479	3.9
CN1318700000000	13	187	Lumpkin County, GA	1995	NA	8533	8210	323	3.8
CN1318900000000	13	189	McDuffie County, GA	1995	NA	9322	8741	581	6.2
CN1319100000000	13	191	McIntosh County, GA	1995	NA	3771	3551	220	5.8
CN1319300000000	13	193	Macon County, GA	1995	NA	5557	4917	640	11.5
CN1319500000000	13	195	Madison County, GA	1995	NA	12560	12099	461	3.7
CN1319700000000	13	197	Marion County, GA	1995	NA	3224	3084	140	4.3
CN1319900000000	13	199	Meriwether County, GA	1995	NA	8886	8302	584	6.6
CN1320100000000	13	201	Miller County, GA	1995	NA	3190	3015	175	5.5
CN1320500000000	13	205	Mitchell County, GA	1995	NA	10285	9683	602	5.9
CN1320700000000	13	207	Monroe County, GA	1995	NA	7878	7356	522	6.6
CN1320900000000	13	209	Montgomery County, GA	1995	NA	3748	3474	274	7.3
CN1321100000000	13	211	Morgan County, GA	1995	NA	6259	5892	367	5.9
CN1321300000000	13	213	Murray County, GA	1995	NA	18014	17156	858	4.8
CN1321500000000	13	215	Muscogee County, GA	1995	NA	79399	74688	4711	5.9
CN1321700000000	13	217	Newton County, GA	1995	NA	24418	23351	1067	4.4
CN1321900000000	13	219	Oconee County, GA	1995	NA	11581	11361	220	1.9
CN1322100000000	13	221	Oglethorpe County, GA	1995	NA	5061	4829	232	4.6
CN1322300000000	13	223	Paulding County, GA	1995	NA	31130	30049	1081	3.5
CN1322500000000	13	225	Peach County, GA	1995	NA	10390	9649	741	7.1
CN1322700000000	13	227	Pickens County, GA	1995	NA	8692	8217	475	5.5
CN1322900000000	13	229	Pierce County, GA	1995	NA	6766	6321	445	6.6
CN1323100000000	13	231	Pike County, GA	1995	NA	5640	5429	211	3.7
CN1323300000000	13	233	Polk County, GA	1995	NA	15294	13960	1334	8.7
CN1323500000000	13	235	Pulaski County, GA	1995	NA	4303	4126	177	4.1
CN1323700000000	13	237	Putnam County, GA	1995	NA	7816	7587	229	2.9
CN1323900000000	13	239	Quitman County, GA	1995	NA	1108	1017	91	8.2
CN1324100000000	13	241	Rabun County, GA	1995	NA	6953	6660	293	4.2
CN1324300000000	13	243	Randolph County, GA	1995	NA	3170	2896	274	8.6
CN1324500000000	13	245	Richmond County, GA	1995	NA	81295	75423	5872	7.2
CN1324700000000	13	247	Rockdale County, GA	1995	NA	35374	34183	1191	3.4
CN1324900000000	13	249	Schley County, GA	1995	NA	1480	1417	63	4.3
CN1325100000000	13	251	Screven County, GA	1995	NA	6759	6138	621	9.2
CN1325300000000	13	253	Seminole County, GA	1995	NA	4283	4044	239	5.6
CN1325500000000	13	255	Spalding County, GA	1995	NA	27794	26492	1302	4.7
CN1325700000000	13	257	Stephens County, GA	1995	NA	12722	12057	665	5.2
CN1325900000000	13	259	Stewart County, GA	1995	NA	2377	2242	135	5.7
CN1326100000000	13	261	Sumter County, GA	1995	NA	15389	14631	758	4.9
CN1326300000000	13	263	Talbot County, GA	1995	NA	2548	2316	232	9.1
CN1326500000000	13	265	Taliaferro County, GA	1995	NA	568	526	42	7.4
CN1326700000000	13	267	Tattnall County, GA	1995	NA	7026	6676	350	5
CN1326900000000	13	269	Taylor County, GA	1995	NA	3386	3124	262	7.7
CN1327100000000	13	271	Telfair County, GA	1995	NA	4835	4341	494	10.2
CN1327300000000	13	273	Terrell County, GA	1995	NA	4267	3600	667	15.6
CN1327500000000	13	275	Thomas County, GA	1995	NA	19959	19146	813	4.1
CN1327700000000	13	277	Tift County, GA	1995	NA	19412	18303	1109	5.7
CN1327900000000	13	279	Toombs County, GA	1995	NA	12123	11321	802	6.6
CN1328100000000	13	281	Towns County, GA	1995	NA	3185	3055	130	4.1
CN1328300000000	13	283	Treutlen County, GA	1995	NA	2988	2644	344	11.5
CN1328500000000	13	285	Troup County, GA	1995	NA	27459	26041	1418	5.2
CN1328700000000	13	287	Turner County, GA	1995	NA	4068	3776	292	7.2
CN1328900000000	13	289	Twiggs County, GA	1995	NA	4076	3849	227	5.6
CN1329100000000	13	291	Union County, GA	1995	NA	6365	6117	248	3.9
CN1329300000000	13	293	Upson County, GA	1995	NA	12960	12369	591	4.6
CN1329500000000	13	295	Walker County, GA	1995	NA	29951	28248	1703	5.7
CN1329700000000	13	297	Walton County, GA	1995	NA	23308	22213	1095	4.7
CN1329900000000	13	299	Ware County, GA	1995	NA	15417	14521	896	5.8
CN1330100000000	13	301	Warren County, GA	1995	NA	2558	2387	171	6.7
CN1330300000000	13	303	Washington County, GA	1995	NA	9362	8851	511	5.5
CN1330500000000	13	305	Wayne County, GA	1995	NA	10939	10162	777	7.1
CN1330700000000	13	307	Webster County, GA	1995	NA	1089	1044	45	4.1
CN1330900000000	13	309	Wheeler County, GA	1995	NA	1955	1764	191	9.8
CN1331100000000	13	311	White County, GA	1995	NA	8849	8572	277	3.1
CN1331300000000	13	313	Whitfield County, GA	1995	NA	44134	42196	1938	4.4
CN1331500000000	13	315	Wilcox County, GA	1995	NA	3326	3151	175	5.3
CN1331700000000	13	317	Wilkes County, GA	1995	NA	5483	5175	308	5.6
CN1331900000000	13	319	Wilkinson County, GA	1995	NA	4518	4301	217	4.8
CN1332100000000	13	321	Worth County, GA	1995	NA	9053	8482	571	6.3
CN1500100000000	15	001	Hawaii County, HI	1995	NA	65254	58582	6672	10.2
CN1500300000000	15	003	Honolulu County/city, HI	1995	NA	425437	405839	19598	4.6
CN1500700000000	15	007	Kauai County, HI	1995	NA	28835	25536	3299	11.4
CN1500900000000	15	009	Maui County, HI	1995	NA	66955	62052	4903	7.3
CN1600100000000	16	001	Ada County, ID	1995	NA	143493	138446	5047	3.5
CN1600300000000	16	003	Adams County, ID	1995	NA	1775	1524	251	14.1
CN1600500000000	16	005	Bannock County, ID	1995	NA	36286	34151	2135	5.9
CN1600700000000	16	007	Bear Lake County, ID	1995	NA	2937	2787	150	5.1
CN1600900000000	16	009	Benewah County, ID	1995	NA	4196	3751	445	10.6
CN1601100000000	16	011	Bingham County, ID	1995	NA	20536	19378	1158	5.6
CN1601300000000	16	013	Blaine County, ID	1995	NA	10237	9800	437	4.3
CN1601500000000	16	015	Boise County, ID	1995	NA	2457	2332	125	5.1
CN1601700000000	16	017	Bonner County, ID	1995	NA	15812	14391	1421	9
CN1601900000000	16	019	Bonneville County, ID	1995	NA	43646	41769	1877	4.3
CN1602100000000	16	021	Boundary County, ID	1995	NA	4284	3906	378	8.8
CN1602300000000	16	023	Butte County, ID	1995	NA	1564	1501	63	4
CN1602500000000	16	025	Camas County, ID	1995	NA	450	436	14	3.1
CN1602700000000	16	027	Canyon County, ID	1995	NA	54418	51336	3082	5.7
CN1602900000000	16	029	Caribou County, ID	1995	NA	3253	3033	220	6.8
CN1603100000000	16	031	Cassia County, ID	1995	NA	9577	8944	633	6.6
CN1603300000000	16	033	Clark County, ID	1995	NA	629	601	28	4.5
CN1603500000000	16	035	Clearwater County, ID	1995	NA	4063	3527	536	13.2
CN1603700000000	16	037	Custer County, ID	1995	NA	2519	2372	147	5.8
CN1603900000000	16	039	Elmore County, ID	1995	NA	8485	7973	512	6
CN1604100000000	16	041	Franklin County, ID	1995	NA	4287	4106	181	4.2
CN1604300000000	16	043	Fremont County, ID	1995	NA	4594	4207	387	8.4
CN1604500000000	16	045	Gem County, ID	1995	NA	6123	5665	458	7.5
CN1604700000000	16	047	Gooding County, ID	1995	NA	6571	6300	271	4.1
CN1604900000000	16	049	Idaho County, ID	1995	NA	6599	5834	765	11.6
CN1605100000000	16	051	Jefferson County, ID	1995	NA	9274	8797	477	5.1
CN1605300000000	16	053	Jerome County, ID	1995	NA	8836	8424	412	4.7
CN1605500000000	16	055	Kootenai County, ID	1995	NA	48549	44856	3693	7.6
CN1605700000000	16	057	Latah County, ID	1995	NA	16194	15711	483	3
CN1605900000000	16	059	Lemhi County, ID	1995	NA	4157	3858	299	7.2
CN1606100000000	16	061	Lewis County, ID	1995	NA	1635	1521	114	7
CN1606300000000	16	063	Lincoln County, ID	1995	NA	2106	2020	86	4.1
CN1606500000000	16	065	Madison County, ID	1995	NA	9810	9485	325	3.3
CN1606700000000	16	067	Minidoka County, ID	1995	NA	10215	9430	785	7.7
CN1606900000000	16	069	Nez Perce County, ID	1995	NA	22139	21237	902	4.1
CN1607100000000	16	071	Oneida County, ID	1995	NA	1563	1500	63	4
CN1607300000000	16	073	Owyhee County, ID	1995	NA	4640	4497	143	3.1
CN1607500000000	16	075	Payette County, ID	1995	NA	9592	8921	671	7
CN1607700000000	16	077	Power County, ID	1995	NA	3514	3272	242	6.9
CN1607900000000	16	079	Shoshone County, ID	1995	NA	6648	5948	700	10.5
CN1608100000000	16	081	Teton County, ID	1995	NA	2591	2504	87	3.4
CN1608300000000	16	083	Twin Falls County, ID	1995	NA	31981	30452	1529	4.8
CN1608500000000	16	085	Valley County, ID	1995	NA	4098	3726	372	9.1
CN1608700000000	16	087	Washington County, ID	1995	NA	4375	3991	384	8.8
CN1700100000000	17	001	Adams County, IL	1995	NA	35873	34429	1444	4
CN1700300000000	17	003	Alexander County, IL	1995	NA	3893	3554	339	8.7
CN1700500000000	17	005	Bond County, IL	1995	NA	7941	7529	412	5.2
CN1700700000000	17	007	Boone County, IL	1995	NA	20280	19423	857	4.2
CN1700900000000	17	009	Brown County, IL	1995	NA	2707	2627	80	3
CN1701100000000	17	011	Bureau County, IL	1995	NA	18659	17685	974	5.2
CN1701300000000	17	013	Calhoun County, IL	1995	NA	3008	2835	173	5.8
CN1701500000000	17	015	Carroll County, IL	1995	NA	9255	8720	535	5.8
CN1701700000000	17	017	Cass County, IL	1995	NA	7428	7059	369	5
CN1701900000000	17	019	Champaign County, IL	1995	NA	93153	90675	2478	2.7
CN1702100000000	17	021	Christian County, IL	1995	NA	19599	18349	1250	6.4
CN1702300000000	17	023	Clark County, IL	1995	NA	9427	9058	369	3.9
CN1702500000000	17	025	Clay County, IL	1995	NA	6948	6561	387	5.6
CN1702700000000	17	027	Clinton County, IL	1995	NA	16832	16096	736	4.4
CN1702900000000	17	029	Coles County, IL	1995	NA	27579	26591	988	3.6
CN1703100000000	17	031	Cook County, IL	1995	NA	2657730	2499818	157912	5.9
CN1703300000000	17	033	Crawford County, IL	1995	NA	9602	8935	667	6.9
CN1703500000000	17	035	Cumberland County, IL	1995	NA	5638	5385	253	4.5
CN1703700000000	17	037	DeKalb County, IL	1995	NA	45610	43914	1696	3.7
CN1703900000000	17	039	De Witt County, IL	1995	NA	9386	8975	411	4.4
CN1704100000000	17	041	Douglas County, IL	1995	NA	11539	11134	405	3.5
CN1704300000000	17	043	DuPage County, IL	1995	NA	506107	487741	18366	3.6
CN1704500000000	17	045	Edgar County, IL	1995	NA	9772	9359	413	4.2
CN1704700000000	17	047	Edwards County, IL	1995	NA	3686	3493	193	5.2
CN1704900000000	17	049	Effingham County, IL	1995	NA	17999	17290	709	3.9
CN1705100000000	17	051	Fayette County, IL	1995	NA	9975	9413	562	5.6
CN1705300000000	17	053	Ford County, IL	1995	NA	6928	6627	301	4.3
CN1705500000000	17	055	Franklin County, IL	1995	NA	16351	14707	1644	10.1
CN1705700000000	17	057	Fulton County, IL	1995	NA	14753	13757	996	6.8
CN1705900000000	17	059	Gallatin County, IL	1995	NA	2850	2585	265	9.3
CN1706100000000	17	061	Greene County, IL	1995	NA	6981	6608	373	5.3
CN1706300000000	17	063	Grundy County, IL	1995	NA	18495	16987	1508	8.2
CN1706500000000	17	065	Hamilton County, IL	1995	NA	3603	3313	290	8
CN1706700000000	17	067	Hancock County, IL	1995	NA	12312	11819	493	4
CN1706900000000	17	069	Hardin County, IL	1995	NA	1867	1746	121	6.5
CN1707100000000	17	071	Henderson County, IL	1995	NA	4750	4582	168	3.5
CN1707300000000	17	073	Henry County, IL	1995	NA	25736	24582	1154	4.5
CN1707500000000	17	075	Iroquois County, IL	1995	NA	17568	16751	817	4.7
CN1707700000000	17	077	Jackson County, IL	1995	NA	28818	27411	1407	4.9
CN1707900000000	17	079	Jasper County, IL	1995	NA	4727	4493	234	5
CN1708100000000	17	081	Jefferson County, IL	1995	NA	18091	16914	1177	6.5
CN1708300000000	17	083	Jersey County, IL	1995	NA	10256	9689	567	5.5
CN1708500000000	17	085	Jo Daviess County, IL	1995	NA	13506	12980	526	3.9
CN1708700000000	17	087	Johnson County, IL	1995	NA	4526	4171	355	7.8
CN1708900000000	17	089	Kane County, IL	1995	NA	199838	190498	9340	4.7
CN1709100000000	17	091	Kankakee County, IL	1995	NA	52313	49276	3037	5.8
CN1709300000000	17	093	Kendall County, IL	1995	NA	25835	24765	1070	4.1
CN1709500000000	17	095	Knox County, IL	1995	NA	28643	27369	1274	4.4
CN1709700000000	17	097	Lake County, IL	1995	NA	305213	294225	10988	3.6
CN1709900000000	17	099	LaSalle County, IL	1995	NA	54793	50904	3889	7.1
CN1710100000000	17	101	Lawrence County, IL	1995	NA	6967	6435	532	7.6
CN1710300000000	17	103	Lee County, IL	1995	NA	17383	16612	771	4.4
CN1710500000000	17	105	Livingston County, IL	1995	NA	19316	18668	648	3.4
CN1710700000000	17	107	Logan County, IL	1995	NA	12865	12339	526	4.1
CN1710900000000	17	109	McDonough County, IL	1995	NA	18761	18329	432	2.3
CN1711100000000	17	111	McHenry County, IL	1995	NA	126843	121453	5390	4.2
CN1711300000000	17	113	McLean County, IL	1995	NA	79960	77852	2108	2.6
CN1711500000000	17	115	Macon County, IL	1995	NA	60597	56460	4137	6.8
CN1711700000000	17	117	Macoupin County, IL	1995	NA	22708	21412	1296	5.7
CN1711900000000	17	119	Madison County, IL	1995	NA	126054	119559	6495	5.2
CN1712100000000	17	121	Marion County, IL	1995	NA	21197	19630	1567	7.4
CN1712300000000	17	123	Marshall County, IL	1995	NA	6405	6124	281	4.4
CN1712500000000	17	125	Mason County, IL	1995	NA	8077	7571	506	6.3
CN1712700000000	17	127	Massac County, IL	1995	NA	7809	7436	373	4.8
CN1712900000000	17	129	Menard County, IL	1995	NA	6035	5799	236	3.9
CN1713100000000	17	131	Mercer County, IL	1995	NA	8408	7931	477	5.7
CN1713300000000	17	133	Monroe County, IL	1995	NA	12821	12399	422	3.3
CN1713500000000	17	135	Montgomery County, IL	1995	NA	14475	13469	1006	6.9
CN1713700000000	17	137	Morgan County, IL	1995	NA	18276	17414	862	4.7
CN1713900000000	17	139	Moultrie County, IL	1995	NA	7983	7658	325	4.1
CN1714100000000	17	141	Ogle County, IL	1995	NA	27390	26215	1175	4.3
CN1714300000000	17	143	Peoria County, IL	1995	NA	94018	90076	3942	4.2
CN1714500000000	17	145	Perry County, IL	1995	NA	7882	7070	812	10.3
CN1714700000000	17	147	Piatt County, IL	1995	NA	7913	7515	398	5
CN1714900000000	17	149	Pike County, IL	1995	NA	8755	8303	452	5.2
CN1715100000000	17	151	Pope County, IL	1995	NA	1647	1541	106	6.4
CN1715300000000	17	153	Pulaski County, IL	1995	NA	2845	2555	290	10.2
CN1715500000000	17	155	Putnam County, IL	1995	NA	3057	2874	183	6
CN1715700000000	17	157	Randolph County, IL	1995	NA	14235	13333	902	6.3
CN1715900000000	17	159	Richland County, IL	1995	NA	9763	9384	379	3.9
CN1716100000000	17	161	Rock Island County, IL	1995	NA	72991	69589	3402	4.7
CN1716300000000	17	163	St. Clair County, IL	1995	NA	116217	109757	6460	5.6
CN1716500000000	17	165	Saline County, IL	1995	NA	10618	9494	1124	10.6
CN1716700000000	17	167	Sangamon County, IL	1995	NA	101284	97258	4026	4
CN1716900000000	17	169	Schuyler County, IL	1995	NA	3854	3659	195	5.1
CN1717100000000	17	171	Scott County, IL	1995	NA	2758	2592	166	6
CN1717300000000	17	173	Shelby County, IL	1995	NA	11502	10934	568	4.9
CN1717500000000	17	175	Stark County, IL	1995	NA	2877	2726	151	5.2
CN1717700000000	17	177	Stephenson County, IL	1995	NA	25542	24376	1166	4.6
CN1717900000000	17	179	Tazewell County, IL	1995	NA	68553	65834	2719	4
CN1718100000000	17	181	Union County, IL	1995	NA	7957	7345	612	7.7
CN1718300000000	17	183	Vermilion County, IL	1995	NA	40473	37602	2871	7.1
CN1718500000000	17	185	Wabash County, IL	1995	NA	5489	5130	359	6.5
CN1718700000000	17	187	Warren County, IL	1995	NA	9848	9417	431	4.4
CN1718900000000	17	189	Washington County, IL	1995	NA	8010	7697	313	3.9
CN1719100000000	17	191	Wayne County, IL	1995	NA	8195	7728	467	5.7
CN1719300000000	17	193	White County, IL	1995	NA	7490	6981	509	6.8
CN1719500000000	17	195	Whiteside County, IL	1995	NA	31087	29918	1169	3.8
CN1719700000000	17	197	Will County, IL	1995	NA	219174	207112	12062	5.5
CN1719900000000	17	199	Williamson County, IL	1995	NA	26958	24864	2094	7.8
CN1720100000000	17	201	Winnebago County, IL	1995	NA	146434	141032	5402	3.7
CN1720300000000	17	203	Woodford County, IL	1995	NA	18207	17788	419	2.3
CN1800100000000	18	001	Adams County, IN	1995	NA	16845	16005	840	5
CN1800300000000	18	003	Allen County, IN	1995	NA	176444	169801	6643	3.8
CN1800500000000	18	005	Bartholomew County, IN	1995	NA	40205	38986	1219	3
CN1800700000000	18	007	Benton County, IN	1995	NA	5415	5152	263	4.9
CN1800900000000	18	009	Blackford County, IN	1995	NA	6499	6085	414	6.4
CN1801100000000	18	011	Boone County, IN	1995	NA	23550	22923	627	2.7
CN1801300000000	18	013	Brown County, IN	1995	NA	8716	8469	247	2.8
CN1801500000000	18	015	Carroll County, IN	1995	NA	12155	11752	403	3.3
CN1801700000000	18	017	Cass County, IN	1995	NA	19224	17924	1300	6.8
CN1801900000000	18	019	Clark County, IN	1995	NA	50909	48551	2358	4.6
CN1802100000000	18	021	Clay County, IN	1995	NA	13307	12497	810	6.1
CN1802300000000	18	023	Clinton County, IN	1995	NA	15955	15401	554	3.5
CN1802500000000	18	025	Crawford County, IN	1995	NA	4899	4427	472	9.6
CN1802700000000	18	027	Daviess County, IN	1995	NA	13849	13179	670	4.8
CN1802900000000	18	029	Dearborn County, IN	1995	NA	22610	21133	1477	6.5
CN1803100000000	18	031	Decatur County, IN	1995	NA	15444	14836	608	3.9
CN1803300000000	18	033	DeKalb County, IN	1995	NA	21490	20669	821	3.8
CN1803500000000	18	035	Delaware County, IN	1995	NA	67153	63871	3282	4.9
CN1803700000000	18	037	Dubois County, IN	1995	NA	22833	22111	722	3.2
CN1803900000000	18	039	Elkhart County, IN	1995	NA	97032	93478	3554	3.7
CN1804100000000	18	041	Fayette County, IN	1995	NA	12596	11312	1284	10.2
CN1804300000000	18	043	Floyd County, IN	1995	NA	37656	36104	1552	4.1
CN1804500000000	18	045	Fountain County, IN	1995	NA	8817	8365	452	5.1
CN1804700000000	18	047	Franklin County, IN	1995	NA	11050	10344	706	6.4
CN1804900000000	18	049	Fulton County, IN	1995	NA	10829	10352	477	4.4
CN1805100000000	18	051	Gibson County, IN	1995	NA	16211	15205	1006	6.2
CN1805300000000	18	053	Grant County, IN	1995	NA	37006	34385	2621	7.1
CN1805500000000	18	055	Greene County, IN	1995	NA	15884	14422	1462	9.2
CN1805700000000	18	057	Hamilton County, IN	1995	NA	81995	80315	1680	2
CN1805900000000	18	059	Hancock County, IN	1995	NA	28567	27679	888	3.1
CN1806100000000	18	061	Harrison County, IN	1995	NA	17489	16669	820	4.7
CN1806300000000	18	063	Hendricks County, IN	1995	NA	48558	47417	1141	2.3
CN1806500000000	18	065	Henry County, IN	1995	NA	25471	23990	1481	5.8
CN1806700000000	18	067	Howard County, IN	1995	NA	44547	42594	1953	4.4
CN1806900000000	18	069	Huntington County, IN	1995	NA	20778	19887	891	4.3
CN1807100000000	18	071	Jackson County, IN	1995	NA	22162	21299	863	3.9
CN1807300000000	18	073	Jasper County, IN	1995	NA	14565	13685	880	6
CN1807500000000	18	075	Jay County, IN	1995	NA	12130	11455	675	5.6
CN1807700000000	18	077	Jefferson County, IN	1995	NA	15201	14490	711	4.7
CN1807900000000	18	079	Jennings County, IN	1995	NA	14238	13789	449	3.2
CN1808100000000	18	081	Johnson County, IN	1995	NA	57910	56301	1609	2.8
CN1808300000000	18	083	Knox County, IN	1995	NA	21093	20202	891	4.2
CN1808500000000	18	085	Kosciusko County, IN	1995	NA	39804	38502	1302	3.3
CN1808700000000	18	087	LaGrange County, IN	1995	NA	18980	18315	665	3.5
CN1808900000000	18	089	Lake County, IN	1995	NA	230374	214582	15792	6.9
CN1809100000000	18	091	LaPorte County, IN	1995	NA	56155	53076	3079	5.5
CN1809300000000	18	093	Lawrence County, IN	1995	NA	25171	23529	1642	6.5
CN1809500000000	18	095	Madison County, IN	1995	NA	67388	64172	3216	4.8
CN1809700000000	18	097	Marion County, IN	1995	NA	459603	439938	19665	4.3
CN1809900000000	18	099	Marshall County, IN	1995	NA	26619	25724	895	3.4
CN1810100000000	18	101	Martin County, IN	1995	NA	5347	5018	329	6.2
CN1810300000000	18	103	Miami County, IN	1995	NA	15701	14658	1043	6.6
CN1810500000000	18	105	Monroe County, IN	1995	NA	61144	59084	2060	3.4
CN1810700000000	18	107	Montgomery County, IN	1995	NA	20355	19801	554	2.7
CN1810900000000	18	109	Morgan County, IN	1995	NA	33782	32543	1239	3.7
CN1811100000000	18	111	Newton County, IN	1995	NA	6941	6569	372	5.4
CN1811300000000	18	113	Noble County, IN	1995	NA	24714	23798	916	3.7
CN1811500000000	18	115	Ohio County, IN	1995	NA	2714	2555	159	5.9
CN1811700000000	18	117	Orange County, IN	1995	NA	9505	8624	881	9.3
CN1811900000000	18	119	Owen County, IN	1995	NA	10115	9554	561	5.5
CN1812100000000	18	121	Parke County, IN	1995	NA	7789	7348	441	5.7
CN1812300000000	18	123	Perry County, IN	1995	NA	9370	8606	764	8.2
CN1812500000000	18	125	Pike County, IN	1995	NA	6366	5939	427	6.7
CN1812700000000	18	127	Porter County, IN	1995	NA	73463	70032	3431	4.7
CN1812900000000	18	129	Posey County, IN	1995	NA	14074	13504	570	4.1
CN1813100000000	18	131	Pulaski County, IN	1995	NA	6360	6037	323	5.1
CN1813300000000	18	133	Putnam County, IN	1995	NA	17324	16686	638	3.7
CN1813500000000	18	135	Randolph County, IN	1995	NA	12844	11887	957	7.5
CN1813700000000	18	137	Ripley County, IN	1995	NA	13814	13022	792	5.7
CN1813900000000	18	139	Rush County, IN	1995	NA	10307	9838	469	4.6
CN1814100000000	18	141	St. Joseph County, IN	1995	NA	138221	132433	5788	4.2
CN1814300000000	18	143	Scott County, IN	1995	NA	10703	10125	578	5.4
CN1814500000000	18	145	Shelby County, IN	1995	NA	23852	22556	1296	5.4
CN1814700000000	18	147	Spencer County, IN	1995	NA	11278	10643	635	5.6
CN1814900000000	18	149	Starke County, IN	1995	NA	11523	10805	718	6.2
CN1815100000000	18	151	Steuben County, IN	1995	NA	17926	17340	586	3.3
CN1815300000000	18	153	Sullivan County, IN	1995	NA	10399	9482	917	8.8
CN1815500000000	18	155	Switzerland County, IN	1995	NA	4469	4202	267	6
CN1815700000000	18	157	Tippecanoe County, IN	1995	NA	73129	71160	1969	2.7
CN1815900000000	18	159	Tipton County, IN	1995	NA	9192	8861	331	3.6
CN1816100000000	18	161	Union County, IN	1995	NA	4015	3796	219	5.5
CN1816300000000	18	163	Vanderburgh County, IN	1995	NA	92664	87829	4835	5.2
CN1816500000000	18	165	Vermillion County, IN	1995	NA	8495	7799	696	8.2
CN1816700000000	18	167	Vigo County, IN	1995	NA	55089	51873	3216	5.8
CN1816900000000	18	169	Wabash County, IN	1995	NA	18536	17740	796	4.3
CN1817100000000	18	171	Warren County, IN	1995	NA	4040	3856	184	4.6
CN1817300000000	18	173	Warrick County, IN	1995	NA	27910	26609	1301	4.7
CN1817500000000	18	175	Washington County, IN	1995	NA	12198	11433	765	6.3
CN1817700000000	18	177	Wayne County, IN	1995	NA	39160	36919	2241	5.7
CN1817900000000	18	179	Wells County, IN	1995	NA	14864	14359	505	3.4
CN1818100000000	18	181	White County, IN	1995	NA	15651	14951	700	4.5
CN1818300000000	18	183	Whitley County, IN	1995	NA	16452	15879	573	3.5
CN1900100000000	19	001	Adair County, IA	1995	NA	4533	4380	153	3.4
CN1900300000000	19	003	Adams County, IA	1995	NA	2435	2362	73	3
CN1900500000000	19	005	Allamakee County, IA	1995	NA	7736	7344	392	5.1
CN1900700000000	19	007	Appanoose County, IA	1995	NA	6743	6377	366	5.4
CN1900900000000	19	009	Audubon County, IA	1995	NA	3735	3615	120	3.2
CN1901100000000	19	011	Benton County, IA	1995	NA	11983	11482	501	4.2
CN1901300000000	19	013	Black Hawk County, IA	1995	NA	68972	65927	3045	4.4
CN1901500000000	19	015	Boone County, IA	1995	NA	13874	13463	411	3
CN1901700000000	19	017	Bremer County, IA	1995	NA	12543	12172	371	3
CN1901900000000	19	019	Buchanan County, IA	1995	NA	10880	10399	481	4.4
CN1902100000000	19	021	Buena Vista County, IA	1995	NA	11221	10955	266	2.4
CN1902300000000	19	023	Butler County, IA	1995	NA	8205	7794	411	5
CN1902500000000	19	025	Calhoun County, IA	1995	NA	5262	5083	179	3.4
CN1902700000000	19	027	Carroll County, IA	1995	NA	12115	11669	446	3.7
CN1902900000000	19	029	Cass County, IA	1995	NA	7810	7458	352	4.5
CN1903100000000	19	031	Cedar County, IA	1995	NA	9632	9362	270	2.8
CN1903300000000	19	033	Cerro Gordo County, IA	1995	NA	26555	25637	918	3.5
CN1903500000000	19	035	Cherokee County, IA	1995	NA	7032	6809	223	3.2
CN1903700000000	19	037	Chickasaw County, IA	1995	NA	7824	7431	393	5
CN1903900000000	19	039	Clarke County, IA	1995	NA	3937	3701	236	6
CN1904100000000	19	041	Clay County, IA	1995	NA	9835	9555	280	2.8
CN1904300000000	19	043	Clayton County, IA	1995	NA	10626	10068	558	5.3
CN1904500000000	19	045	Clinton County, IA	1995	NA	27394	26068	1326	4.8
CN1904700000000	19	047	Crawford County, IA	1995	NA	8942	8639	303	3.4
CN1904900000000	19	049	Dallas County, IA	1995	NA	18633	18185	448	2.4
CN1905100000000	19	051	Davis County, IA	1995	NA	4407	4228	179	4.1
CN1905300000000	19	053	Decatur County, IA	1995	NA	3993	3727	266	6.7
CN1905500000000	19	055	Delaware County, IA	1995	NA	9340	8871	469	5
CN1905700000000	19	057	Des Moines County, IA	1995	NA	23819	22770	1049	4.4
CN1905900000000	19	059	Dickinson County, IA	1995	NA	9891	9561	330	3.3
CN1906100000000	19	061	Dubuque County, IA	1995	NA	50769	48944	1825	3.6
CN1906300000000	19	063	Emmet County, IA	1995	NA	5644	5379	265	4.7
CN1906500000000	19	065	Fayette County, IA	1995	NA	11614	11135	479	4.1
CN1906700000000	19	067	Floyd County, IA	1995	NA	8250	7810	440	5.3
CN1906900000000	19	069	Franklin County, IA	1995	NA	6142	5963	179	2.9
CN1907100000000	19	071	Fremont County, IA	1995	NA	4008	3884	124	3.1
CN1907300000000	19	073	Greene County, IA	1995	NA	5209	4993	216	4.1
CN1907500000000	19	075	Grundy County, IA	1995	NA	6086	5854	232	3.8
CN1907700000000	19	077	Guthrie County, IA	1995	NA	5995	5797	198	3.3
CN1907900000000	19	079	Hamilton County, IA	1995	NA	8696	8344	352	4
CN1908100000000	19	081	Hancock County, IA	1995	NA	6206	6010	196	3.2
CN1908300000000	19	083	Hardin County, IA	1995	NA	9734	9358	376	3.9
CN1908500000000	19	085	Harrison County, IA	1995	NA	7609	7270	339	4.5
CN1908700000000	19	087	Henry County, IA	1995	NA	11300	10938	362	3.2
CN1908900000000	19	089	Howard County, IA	1995	NA	5436	5237	199	3.7
CN1909100000000	19	091	Humboldt County, IA	1995	NA	5431	5296	135	2.5
CN1909300000000	19	093	Ida County, IA	1995	NA	4174	4061	113	2.7
CN1909500000000	19	095	Iowa County, IA	1995	NA	9366	9137	229	2.4
CN1909700000000	19	097	Jackson County, IA	1995	NA	10572	9974	598	5.7
CN1909900000000	19	099	Jasper County, IA	1995	NA	18784	18167	617	3.3
CN1910100000000	19	101	Jefferson County, IA	1995	NA	9714	9351	363	3.7
CN1910300000000	19	103	Johnson County, IA	1995	NA	65414	63655	1759	2.7
CN1910500000000	19	105	Jones County, IA	1995	NA	9796	9384	412	4.2
CN1910700000000	19	107	Keokuk County, IA	1995	NA	5137	4896	241	4.7
CN1910900000000	19	109	Kossuth County, IA	1995	NA	8886	8543	343	3.9
CN1911100000000	19	111	Lee County, IA	1995	NA	19983	18983	1000	5
CN1911300000000	19	113	Linn County, IA	1995	NA	108892	105909	2983	2.7
CN1911500000000	19	115	Louisa County, IA	1995	NA	6596	6332	264	4
CN1911700000000	19	117	Lucas County, IA	1995	NA	4150	3924	226	5.4
CN1911900000000	19	119	Lyon County, IA	1995	NA	5855	5696	159	2.7
CN1912100000000	19	121	Madison County, IA	1995	NA	7597	7279	318	4.2
CN1912300000000	19	123	Mahaska County, IA	1995	NA	11263	10877	386	3.4
CN1912500000000	19	125	Marion County, IA	1995	NA	17809	17221	588	3.3
CN1912700000000	19	127	Marshall County, IA	1995	NA	21139	20461	678	3.2
CN1912900000000	19	129	Mills County, IA	1995	NA	6287	6088	199	3.2
CN1913100000000	19	131	Mitchell County, IA	1995	NA	5783	5598	185	3.2
CN1913300000000	19	133	Monona County, IA	1995	NA	5259	5084	175	3.3
CN1913500000000	19	135	Monroe County, IA	1995	NA	4314	4121	193	4.5
CN1913700000000	19	137	Montgomery County, IA	1995	NA	6137	5906	231	3.8
CN1913900000000	19	139	Muscatine County, IA	1995	NA	21730	21006	724	3.3
CN1914100000000	19	141	O'Brien County, IA	1995	NA	8045	7830	215	2.7
CN1914300000000	19	143	Osceola County, IA	1995	NA	3755	3627	128	3.4
CN1914500000000	19	145	Page County, IA	1995	NA	9252	8924	328	3.5
CN1914700000000	19	147	Palo Alto County, IA	1995	NA	5356	5187	169	3.2
CN1914900000000	19	149	Plymouth County, IA	1995	NA	12894	12391	503	3.9
CN1915100000000	19	151	Pocahontas County, IA	1995	NA	4395	4233	162	3.7
CN1915300000000	19	153	Polk County, IA	1995	NA	213144	207632	5512	2.6
CN1915500000000	19	155	Pottawattamie County, IA	1995	NA	47198	45721	1477	3.1
CN1915700000000	19	157	Poweshiek County, IA	1995	NA	10556	10139	417	4
CN1915900000000	19	159	Ringgold County, IA	1995	NA	2669	2563	106	4
CN1916100000000	19	161	Sac County, IA	1995	NA	6080	5849	231	3.8
CN1916300000000	19	163	Scott County, IA	1995	NA	83953	80987	2966	3.5
CN1916500000000	19	165	Shelby County, IA	1995	NA	6857	6599	258	3.8
CN1916700000000	19	167	Sioux County, IA	1995	NA	17295	16778	517	3
CN1916900000000	19	169	Story County, IA	1995	NA	45494	44229	1265	2.8
CN1917100000000	19	171	Tama County, IA	1995	NA	9837	9461	376	3.8
CN1917300000000	19	173	Taylor County, IA	1995	NA	3434	3261	173	5
CN1917500000000	19	175	Union County, IA	1995	NA	6422	6130	292	4.5
CN1917700000000	19	177	Van Buren County, IA	1995	NA	4114	3949	165	4
CN1917900000000	19	179	Wapello County, IA	1995	NA	18562	17656	906	4.9
CN1918100000000	19	181	Warren County, IA	1995	NA	23084	22549	535	2.3
CN1918300000000	19	183	Washington County, IA	1995	NA	11375	11020	355	3.1
CN1918500000000	19	185	Wayne County, IA	1995	NA	3410	3276	134	3.9
CN1918700000000	19	187	Webster County, IA	1995	NA	20589	19733	856	4.2
CN1918900000000	19	189	Winnebago County, IA	1995	NA	6807	6630	177	2.6
CN1919100000000	19	191	Winneshiek County, IA	1995	NA	12237	11665	572	4.7
CN1919300000000	19	193	Woodbury County, IA	1995	NA	55996	54272	1724	3.1
CN1919500000000	19	195	Worth County, IA	1995	NA	4136	3996	140	3.4
CN1919700000000	19	197	Wright County, IA	1995	NA	7435	7156	279	3.8
CN2000100000000	20	001	Allen County, KS	1995	NA	7035	6553	482	6.9
CN2000300000000	20	003	Anderson County, KS	1995	NA	4061	3828	233	5.7
CN2000500000000	20	005	Atchison County, KS	1995	NA	8429	7851	578	6.9
CN2000700000000	20	007	Barber County, KS	1995	NA	2533	2428	105	4.1
CN2000900000000	20	009	Barton County, KS	1995	NA	15453	14755	698	4.5
CN2001100000000	20	011	Bourbon County, KS	1995	NA	6635	6252	383	5.8
CN2001300000000	20	013	Brown County, KS	1995	NA	5060	4764	296	5.8
CN2001500000000	20	015	Butler County, KS	1995	NA	29238	28079	1159	4
CN2001700000000	20	017	Chase County, KS	1995	NA	1496	1414	82	5.5
CN2001900000000	20	019	Chautauqua County, KS	1995	NA	1707	1614	93	5.4
CN2002100000000	20	021	Cherokee County, KS	1995	NA	10407	9703	704	6.8
CN2002300000000	20	023	Cheyenne County, KS	1995	NA	1557	1525	32	2.1
CN2002500000000	20	025	Clark County, KS	1995	NA	1313	1281	32	2.4
CN2002700000000	20	027	Clay County, KS	1995	NA	4719	4566	153	3.2
CN2002900000000	20	029	Cloud County, KS	1995	NA	5284	5114	170	3.2
CN2003100000000	20	031	Coffey County, KS	1995	NA	4246	3978	268	6.3
CN2003300000000	20	033	Comanche County, KS	1995	NA	1074	1058	16	1.5
CN2003500000000	20	035	Cowley County, KS	1995	NA	18396	17402	994	5.4
CN2003700000000	20	037	Crawford County, KS	1995	NA	18052	17168	884	4.9
CN2003900000000	20	039	Decatur County, KS	1995	NA	1880	1829	51	2.7
CN2004100000000	20	041	Dickinson County, KS	1995	NA	10184	9619	565	5.5
CN2004300000000	20	043	Doniphan County, KS	1995	NA	4130	3849	281	6.8
CN2004500000000	20	045	Douglas County, KS	1995	NA	51231	48792	2439	4.8
CN2004700000000	20	047	Edwards County, KS	1995	NA	1876	1824	52	2.8
CN2004900000000	20	049	Elk County, KS	1995	NA	1506	1431	75	5
CN2005100000000	20	051	Ellis County, KS	1995	NA	16319	15811	508	3.1
CN2005300000000	20	053	Ellsworth County, KS	1995	NA	2910	2782	128	4.4
CN2005500000000	20	055	Finney County, KS	1995	NA	19349	18691	658	3.4
CN2005700000000	20	057	Ford County, KS	1995	NA	15822	15270	552	3.5
CN2005900000000	20	059	Franklin County, KS	1995	NA	12474	11734	740	5.9
CN2006100000000	20	061	Geary County, KS	1995	NA	10934	10209	725	6.6
CN2006300000000	20	063	Gove County, KS	1995	NA	1565	1538	27	1.7
CN2006500000000	20	065	Graham County, KS	1995	NA	1648	1575	73	4.4
CN2006700000000	20	067	Grant County, KS	1995	NA	4064	3944	120	3
CN2006900000000	20	069	Gray County, KS	1995	NA	2794	2722	72	2.6
CN2007100000000	20	071	Greeley County, KS	1995	NA	912	883	29	3.2
CN2007300000000	20	073	Greenwood County, KS	1995	NA	3350	3166	184	5.5
CN2007500000000	20	075	Hamilton County, KS	1995	NA	1259	1231	28	2.2
CN2007700000000	20	077	Harper County, KS	1995	NA	3051	2949	102	3.3
CN2007900000000	20	079	Harvey County, KS	1995	NA	15994	15352	642	4
CN2008100000000	20	081	Haskell County, KS	1995	NA	2143	2073	70	3.3
CN2008300000000	20	083	Hodgeman County, KS	1995	NA	1021	997	24	2.4
CN2008500000000	20	085	Jackson County, KS	1995	NA	6332	5973	359	5.7
CN2008700000000	20	087	Jefferson County, KS	1995	NA	9778	9355	423	4.3
CN2008900000000	20	089	Jewell County, KS	1995	NA	2180	2125	55	2.5
CN2009100000000	20	091	Johnson County, KS	1995	NA	237045	230126	6919	2.9
CN2009300000000	20	093	Kearny County, KS	1995	NA	2191	2125	66	3
CN2009500000000	20	095	Kingman County, KS	1995	NA	4252	4079	173	4.1
CN2009700000000	20	097	Kiowa County, KS	1995	NA	1826	1780	46	2.5
CN2009900000000	20	099	Labette County, KS	1995	NA	10676	10036	640	6
CN2010100000000	20	101	Lane County, KS	1995	NA	1186	1144	42	3.5
CN2010300000000	20	103	Leavenworth County, KS	1995	NA	27432	26021	1411	5.1
CN2010500000000	20	105	Lincoln County, KS	1995	NA	1831	1734	97	5.3
CN2010700000000	20	107	Linn County, KS	1995	NA	3529	3222	307	8.7
CN2010900000000	20	109	Logan County, KS	1995	NA	1660	1624	36	2.2
CN2011100000000	20	111	Lyon County, KS	1995	NA	19956	19071	885	4.4
CN2011300000000	20	113	McPherson County, KS	1995	NA	15725	15300	425	2.7
CN2011500000000	20	115	Marion County, KS	1995	NA	6918	6739	179	2.6
CN2011700000000	20	117	Marshall County, KS	1995	NA	5932	5752	180	3
CN2011900000000	20	119	Meade County, KS	1995	NA	2322	2265	57	2.5
CN2012100000000	20	121	Miami County, KS	1995	NA	13023	12457	566	4.3
CN2012300000000	20	123	Mitchell County, KS	1995	NA	3615	3508	107	3
CN2012500000000	20	125	Montgomery County, KS	1995	NA	18027	17021	1006	5.6
CN2012700000000	20	127	Morris County, KS	1995	NA	3093	2999	94	3
CN2012900000000	20	129	Morton County, KS	1995	NA	1742	1704	38	2.2
CN2013100000000	20	131	Nemaha County, KS	1995	NA	5656	5528	128	2.3
CN2013300000000	20	133	Neosho County, KS	1995	NA	9023	8617	406	4.5
CN2013500000000	20	135	Ness County, KS	1995	NA	1970	1921	49	2.5
CN2013700000000	20	137	Norton County, KS	1995	NA	3058	2995	63	2.1
CN2013900000000	20	139	Osage County, KS	1995	NA	8285	7732	553	6.7
CN2014100000000	20	141	Osborne County, KS	1995	NA	2539	2476	63	2.5
CN2014300000000	20	143	Ottawa County, KS	1995	NA	2988	2881	107	3.6
CN2014500000000	20	145	Pawnee County, KS	1995	NA	3931	3828	103	2.6
CN2014700000000	20	147	Phillips County, KS	1995	NA	3292	3183	109	3.3
CN2014900000000	20	149	Pottawatomie County, KS	1995	NA	9456	9071	385	4.1
CN2015100000000	20	151	Pratt County, KS	1995	NA	5135	4983	152	3
CN2015300000000	20	153	Rawlins County, KS	1995	NA	1686	1636	50	3
CN2015500000000	20	155	Reno County, KS	1995	NA	32806	31491	1315	4
CN2015700000000	20	157	Republic County, KS	1995	NA	3260	3185	75	2.3
CN2015900000000	20	159	Rice County, KS	1995	NA	4927	4699	228	4.6
CN2016100000000	20	161	Riley County, KS	1995	NA	29975	28669	1306	4.4
CN2016300000000	20	163	Rooks County, KS	1995	NA	2940	2848	92	3.1
CN2016500000000	20	165	Rush County, KS	1995	NA	1866	1809	57	3.1
CN2016700000000	20	167	Russell County, KS	1995	NA	3745	3594	151	4
CN2016900000000	20	169	Saline County, KS	1995	NA	29849	28634	1215	4.1
CN2017100000000	20	171	Scott County, KS	1995	NA	2759	2702	57	2.1
CN2017300000000	20	173	Sedgwick County, KS	1995	NA	220934	210261	10673	4.8
CN2017500000000	20	175	Seward County, KS	1995	NA	10647	10194	453	4.3
CN2017700000000	20	177	Shawnee County, KS	1995	NA	89856	85812	4044	4.5
CN2017900000000	20	179	Sheridan County, KS	1995	NA	1510	1482	28	1.9
CN2018100000000	20	181	Sherman County, KS	1995	NA	4004	3898	106	2.6
CN2018300000000	20	183	Smith County, KS	1995	NA	2521	2443	78	3.1
CN2018500000000	20	185	Stafford County, KS	1995	NA	2472	2396	76	3.1
CN2018700000000	20	187	Stanton County, KS	1995	NA	1135	1110	25	2.2
CN2018900000000	20	189	Stevens County, KS	1995	NA	2646	2587	59	2.2
CN2019100000000	20	191	Sumner County, KS	1995	NA	12732	12061	671	5.3
CN2019300000000	20	193	Thomas County, KS	1995	NA	4732	4599	133	2.8
CN2019500000000	20	195	Trego County, KS	1995	NA	2039	1988	51	2.5
CN2019700000000	20	197	Wabaunsee County, KS	1995	NA	3459	3300	159	4.6
CN2019900000000	20	199	Wallace County, KS	1995	NA	885	866	19	2.1
CN2020100000000	20	201	Washington County, KS	1995	NA	3604	3468	136	3.8
CN2020300000000	20	203	Wichita County, KS	1995	NA	1300	1263	37	2.8
CN2020500000000	20	205	Wilson County, KS	1995	NA	5308	5054	254	4.8
CN2020700000000	20	207	Woodson County, KS	1995	NA	1659	1512	147	8.9
CN2020900000000	20	209	Wyandotte County, KS	1995	NA	75782	69627	6155	8.1
CN2100100000000	21	001	Adair County, KY	1995	NA	7947	7395	552	6.9
CN2100300000000	21	003	Allen County, KY	1995	NA	8845	8543	302	3.4
CN2100500000000	21	005	Anderson County, KY	1995	NA	8994	8713	281	3.1
CN2100700000000	21	007	Ballard County, KY	1995	NA	3974	3704	270	6.8
CN2100900000000	21	009	Barren County, KY	1995	NA	18081	17164	917	5.1
CN2101100000000	21	011	Bath County, KY	1995	NA	4931	4455	476	9.7
CN2101300000000	21	013	Bell County, KY	1995	NA	10203	9405	798	7.8
CN2101500000000	21	015	Boone County, KY	1995	NA	37803	36251	1552	4.1
CN2101700000000	21	017	Bourbon County, KY	1995	NA	9512	9224	288	3
CN2101900000000	21	019	Boyd County, KY	1995	NA	22674	20849	1825	8
CN2102100000000	21	021	Boyle County, KY	1995	NA	13164	12556	608	4.6
CN2102300000000	21	023	Bracken County, KY	1995	NA	3749	3528	221	5.9
CN2102500000000	21	025	Breathitt County, KY	1995	NA	4658	4143	515	11.1
CN2102700000000	21	027	Breckinridge County, KY	1995	NA	7687	7191	496	6.5
CN2102900000000	21	029	Bullitt County, KY	1995	NA	29752	28839	913	3.1
CN2103100000000	21	031	Butler County, KY	1995	NA	5623	5182	441	7.8
CN2103300000000	21	033	Caldwell County, KY	1995	NA	6999	6586	413	5.9
CN2103500000000	21	035	Calloway County, KY	1995	NA	16622	15949	673	4
CN2103700000000	21	037	Campbell County, KY	1995	NA	44334	42347	1987	4.5
CN2103900000000	21	039	Carlisle County, KY	1995	NA	2649	2492	157	5.9
CN2104100000000	21	041	Carroll County, KY	1995	NA	4759	4471	288	6.1
CN2104300000000	21	043	Carter County, KY	1995	NA	11337	9737	1600	14.1
CN2104500000000	21	045	Casey County, KY	1995	NA	7016	6647	369	5.3
CN2104700000000	21	047	Christian County, KY	1995	NA	25764	24362	1402	5.4
CN2104900000000	21	049	Clark County, KY	1995	NA	15180	14523	657	4.3
CN2105100000000	21	051	Clay County, KY	1995	NA	7111	6557	554	7.8
CN2105300000000	21	053	Clinton County, KY	1995	NA	4382	4024	358	8.2
CN2105500000000	21	055	Crittenden County, KY	1995	NA	4334	4003	331	7.6
CN2105700000000	21	057	Cumberland County, KY	1995	NA	2872	2559	313	10.9
CN2105900000000	21	059	Daviess County, KY	1995	NA	48785	46019	2766	5.7
CN2106100000000	21	061	Edmonson County, KY	1995	NA	4580	4259	321	7
CN2106300000000	21	063	Elliott County, KY	1995	NA	2620	2153	467	17.8
CN2106500000000	21	065	Estill County, KY	1995	NA	5911	5502	409	6.9
CN2106700000000	21	067	Fayette County, KY	1995	NA	134194	130662	3532	2.6
CN2106900000000	21	069	Fleming County, KY	1995	NA	6210	5856	354	5.7
CN2107100000000	21	071	Floyd County, KY	1995	NA	14400	12879	1521	10.6
CN2107300000000	21	073	Franklin County, KY	1995	NA	24164	23452	712	2.9
CN2107500000000	21	075	Fulton County, KY	1995	NA	3989	3792	197	4.9
CN2107700000000	21	077	Gallatin County, KY	1995	NA	3041	2864	177	5.8
CN2107900000000	21	079	Garrard County, KY	1995	NA	6358	6074	284	4.5
CN2108100000000	21	081	Grant County, KY	1995	NA	8939	8467	472	5.3
CN2108300000000	21	083	Graves County, KY	1995	NA	16522	15464	1058	6.4
CN2108500000000	21	085	Grayson County, KY	1995	NA	10755	10013	742	6.9
CN2108700000000	21	087	Green County, KY	1995	NA	5275	4890	385	7.3
CN2108900000000	21	089	Greenup County, KY	1995	NA	16299	15090	1209	7.4
CN2109100000000	21	091	Hancock County, KY	1995	NA	3462	3219	243	7
CN2109300000000	21	093	Hardin County, KY	1995	NA	35056	33007	2049	5.8
CN2109500000000	21	095	Harlan County, KY	1995	NA	10162	8502	1660	16.3
CN2109700000000	21	097	Harrison County, KY	1995	NA	7569	7167	402	5.3
CN2109900000000	21	099	Hart County, KY	1995	NA	7798	7294	504	6.5
CN2110100000000	21	101	Henderson County, KY	1995	NA	23530	22145	1385	5.9
CN2110300000000	21	103	Henry County, KY	1995	NA	7500	7174	326	4.3
CN2110500000000	21	105	Hickman County, KY	1995	NA	2491	2334	157	6.3
CN2110700000000	21	107	Hopkins County, KY	1995	NA	20413	18914	1499	7.3
CN2110900000000	21	109	Jackson County, KY	1995	NA	5351	4912	439	8.2
CN2111100000000	21	111	Jefferson County, KY	1995	NA	360502	344125	16377	4.5
CN2111300000000	21	113	Jessamine County, KY	1995	NA	18525	18079	446	2.4
CN2111500000000	21	115	Johnson County, KY	1995	NA	10331	9483	848	8.2
CN2111700000000	21	117	Kenton County, KY	1995	NA	76580	73336	3244	4.2
CN2111900000000	21	119	Knott County, KY	1995	NA	5901	5275	626	10.6
CN2112100000000	21	121	Knox County, KY	1995	NA	10783	10015	768	7.1
CN2112300000000	21	123	Larue County, KY	1995	NA	5773	5508	265	4.6
CN2112500000000	21	125	Laurel County, KY	1995	NA	21088	19770	1318	6.3
CN2112700000000	21	127	Lawrence County, KY	1995	NA	5188	4519	669	12.9
CN2112900000000	21	129	Lee County, KY	1995	NA	2494	2293	201	8.1
CN2113100000000	21	131	Leslie County, KY	1995	NA	4397	4004	393	8.9
CN2113300000000	21	133	Letcher County, KY	1995	NA	8086	7100	986	12.2
CN2113500000000	21	135	Lewis County, KY	1995	NA	5469	4867	602	11
CN2113700000000	21	137	Lincoln County, KY	1995	NA	9739	9256	483	5
CN2113900000000	21	139	Livingston County, KY	1995	NA	4758	4447	311	6.5
CN2114100000000	21	141	Logan County, KY	1995	NA	13253	12680	573	4.3
CN2114300000000	21	143	Lyon County, KY	1995	NA	3168	2952	216	6.8
CN2114500000000	21	145	McCracken County, KY	1995	NA	32767	31378	1389	4.2
CN2114700000000	21	147	McCreary County, KY	1995	NA	6308	5796	512	8.1
CN2114900000000	21	149	McLean County, KY	1995	NA	4270	3879	391	9.2
CN2115100000000	21	151	Madison County, KY	1995	NA	32851	31301	1550	4.7
CN2115300000000	21	153	Magoffin County, KY	1995	NA	4863	4119	744	15.3
CN2115500000000	21	155	Marion County, KY	1995	NA	8474	7853	621	7.3
CN2115700000000	21	157	Marshall County, KY	1995	NA	13693	12939	754	5.5
CN2115900000000	21	159	Martin County, KY	1995	NA	3466	3055	411	11.9
CN2116100000000	21	161	Mason County, KY	1995	NA	8597	8126	471	5.5
CN2116300000000	21	163	Meade County, KY	1995	NA	9782	9272	510	5.2
CN2116500000000	21	165	Menifee County, KY	1995	NA	2422	2163	259	10.7
CN2116700000000	21	167	Mercer County, KY	1995	NA	10498	10111	387	3.7
CN2116900000000	21	169	Metcalfe County, KY	1995	NA	4776	4511	265	5.5
CN2117100000000	21	171	Monroe County, KY	1995	NA	5476	5243	233	4.3
CN2117300000000	21	173	Montgomery County, KY	1995	NA	10538	9821	717	6.8
CN2117500000000	21	175	Morgan County, KY	1995	NA	4558	4068	490	10.8
CN2117700000000	21	177	Muhlenberg County, KY	1995	NA	12260	11198	1062	8.7
CN2117900000000	21	179	Nelson County, KY	1995	NA	17369	16166	1203	6.9
CN2118100000000	21	181	Nicholas County, KY	1995	NA	3350	3053	297	8.9
CN2118300000000	21	183	Ohio County, KY	1995	NA	9178	8164	1014	11
CN2118500000000	21	185	Oldham County, KY	1995	NA	21537	21046	491	2.3
CN2118700000000	21	187	Owen County, KY	1995	NA	4556	4371	185	4.1
CN2118900000000	21	189	Owsley County, KY	1995	NA	1569	1472	97	6.2
CN2119100000000	21	191	Pendleton County, KY	1995	NA	6248	5950	298	4.8
CN2119300000000	21	193	Perry County, KY	1995	NA	11679	10450	1229	10.5
CN2119500000000	21	195	Pike County, KY	1995	NA	27830	25222	2608	9.4
CN2119700000000	21	197	Powell County, KY	1995	NA	6692	6225	467	7
CN2119900000000	21	199	Pulaski County, KY	1995	NA	24103	22785	1318	5.5
CN2120100000000	21	201	Robertson County, KY	1995	NA	1005	945	60	6
CN2120300000000	21	203	Rockcastle County, KY	1995	NA	6010	5599	411	6.8
CN2120500000000	21	205	Rowan County, KY	1995	NA	9133	8575	558	6.1
CN2120700000000	21	207	Russell County, KY	1995	NA	6581	5948	633	9.6
CN2120900000000	21	209	Scott County, KY	1995	NA	14916	14499	417	2.8
CN2121100000000	21	211	Shelby County, KY	1995	NA	15979	15501	478	3
CN2121300000000	21	213	Simpson County, KY	1995	NA	8199	7792	407	5
CN2121500000000	21	215	Spencer County, KY	1995	NA	4658	4481	177	3.8
CN2121700000000	21	217	Taylor County, KY	1995	NA	11359	10847	512	4.5
CN2121900000000	21	219	Todd County, KY	1995	NA	5447	5196	251	4.6
CN2122100000000	21	221	Trigg County, KY	1995	NA	5769	5494	275	4.8
CN2122300000000	21	223	Trimble County, KY	1995	NA	3119	2994	125	4
CN2122500000000	21	225	Union County, KY	1995	NA	6649	6199	450	6.8
CN2122700000000	21	227	Warren County, KY	1995	NA	46279	44248	2031	4.4
CN2122900000000	21	229	Washington County, KY	1995	NA	5764	5543	221	3.8
CN2123100000000	21	231	Wayne County, KY	1995	NA	7758	7240	518	6.7
CN2123300000000	21	233	Webster County, KY	1995	NA	5664	5199	465	8.2
CN2123500000000	21	235	Whitley County, KY	1995	NA	13625	12742	883	6.5
CN2123700000000	21	237	Wolfe County, KY	1995	NA	3354	3095	259	7.7
CN2123900000000	21	239	Woodford County, KY	1995	NA	12216	11946	270	2.2
CN2200100000000	22	001	Acadia Parish, LA	1995	NA	22107	20525	1582	7.2
CN2200300000000	22	003	Allen Parish, LA	1995	NA	8557	7772	785	9.2
CN2200500000000	22	005	Ascension Parish, LA	1995	NA	30056	28109	1947	6.5
CN2200700000000	22	007	Assumption Parish, LA	1995	NA	9139	8405	734	8
CN2200900000000	22	009	Avoyelles Parish, LA	1995	NA	16114	14739	1375	8.5
CN2201100000000	22	011	Beauregard Parish, LA	1995	NA	12579	11676	903	7.2
CN2201300000000	22	013	Bienville Parish, LA	1995	NA	6275	5691	584	9.3
CN2201500000000	22	015	Bossier Parish, LA	1995	NA	42943	40441	2502	5.8
CN2201700000000	22	017	Caddo Parish, LA	1995	NA	115161	107619	7542	6.5
CN2201900000000	22	019	Calcasieu Parish, LA	1995	NA	84615	79517	5098	6
CN2202100000000	22	021	Caldwell Parish, LA	1995	NA	4311	3944	367	8.5
CN2202300000000	22	023	Cameron Parish, LA	1995	NA	3677	3451	226	6.1
CN2202500000000	22	025	Catahoula Parish, LA	1995	NA	5235	4728	507	9.7
CN2202700000000	22	027	Claiborne Parish, LA	1995	NA	5822	5362	460	7.9
CN2202900000000	22	029	Concordia Parish, LA	1995	NA	8253	7348	905	11
CN2203100000000	22	031	De Soto Parish, LA	1995	NA	11298	10479	819	7.2
CN2203300000000	22	033	East Baton Rouge Parish, LA	1995	NA	199990	189679	10311	5.2
CN2203500000000	22	035	East Carroll Parish, LA	1995	NA	3345	2844	501	15
CN2203700000000	22	037	East Feliciana Parish, LA	1995	NA	7635	7101	534	7
CN2203900000000	22	039	Evangeline Parish, LA	1995	NA	11738	10871	867	7.4
CN2204100000000	22	041	Franklin Parish, LA	1995	NA	10961	10051	910	8.3
CN2204300000000	22	043	Grant Parish, LA	1995	NA	6716	6100	616	9.2
CN2204500000000	22	045	Iberia Parish, LA	1995	NA	29907	27885	2022	6.8
CN2204700000000	22	047	Iberville Parish, LA	1995	NA	12354	11115	1239	10
CN2204900000000	22	049	Jackson Parish, LA	1995	NA	6308	5936	372	5.9
CN2205100000000	22	051	Jefferson Parish, LA	1995	NA	236041	220182	15859	6.7
CN2205300000000	22	053	Jefferson Davis Parish, LA	1995	NA	11833	11005	828	7
CN2205500000000	22	055	Lafayette Parish, LA	1995	NA	88962	84807	4155	4.7
CN2205700000000	22	057	Lafourche Parish, LA	1995	NA	37576	35799	1777	4.7
CN2205900000000	22	059	LaSalle Parish, LA	1995	NA	5675	5299	376	6.6
CN2206100000000	22	061	Lincoln Parish, LA	1995	NA	18228	17681	547	3
CN2206300000000	22	063	Livingston Parish, LA	1995	NA	37401	34511	2890	7.7
CN2206500000000	22	065	Madison Parish, LA	1995	NA	5607	4901	706	12.6
CN2206700000000	22	067	Morehouse Parish, LA	1995	NA	12457	11308	1149	9.2
CN2206900000000	22	069	Natchitoches Parish, LA	1995	NA	16663	15422	1241	7.4
CN2207100000000	22	071	Orleans Parish, LA	1995	NA	207117	188107	19010	9.2
CN2207300000000	22	073	Ouachita Parish, LA	1995	NA	66935	63312	3623	5.4
CN2207500000000	22	075	Plaquemines Parish, LA	1995	NA	10505	9636	869	8.3
CN2207700000000	22	077	Pointe Coupee Parish, LA	1995	NA	9325	8435	890	9.5
CN2207900000000	22	079	Rapides Parish, LA	1995	NA	57894	54325	3569	6.2
CN2208100000000	22	081	Red River Parish, LA	1995	NA	3802	3427	375	9.9
CN2208300000000	22	083	Richland Parish, LA	1995	NA	8121	7296	825	10.2
CN2208500000000	22	085	Sabine Parish, LA	1995	NA	8893	8314	579	6.5
CN2208700000000	22	087	St. Bernard Parish, LA	1995	NA	32174	29174	3000	9.3
CN2208900000000	22	089	St. Charles Parish, LA	1995	NA	22027	20287	1740	7.9
CN2209100000000	22	091	St. Helena Parish, LA	1995	NA	4010	3708	302	7.5
CN2209300000000	22	093	St. James Parish, LA	1995	NA	8742	7884	858	9.8
CN2209500000000	22	095	St. John the Baptist Parish, LA	1995	NA	19424	17414	2010	10.3
CN2209700000000	22	097	St. Landry Parish, LA	1995	NA	30300	27704	2596	8.6
CN2209900000000	22	099	St. Martin Parish, LA	1995	NA	19689	18328	1361	6.9
CN2210100000000	22	101	St. Mary Parish, LA	1995	NA	24078	21987	2091	8.7
CN2210300000000	22	103	St. Tammany Parish, LA	1995	NA	82561	77131	5430	6.6
CN2210500000000	22	105	Tangipahoa Parish, LA	1995	NA	41586	37935	3651	8.8
CN2210700000000	22	107	Tensas Parish, LA	1995	NA	3138	2869	269	8.6
CN2210900000000	22	109	Terrebonne Parish, LA	1995	NA	42397	40150	2247	5.3
CN2211100000000	22	111	Union Parish, LA	1995	NA	11027	10464	563	5.1
CN2211300000000	22	113	Vermilion Parish, LA	1995	NA	22292	20975	1317	5.9
CN2211500000000	22	115	Vernon Parish, LA	1995	NA	16935	15794	1141	6.7
CN2211700000000	22	117	Washington Parish, LA	1995	NA	16973	15575	1398	8.2
CN2211900000000	22	119	Webster Parish, LA	1995	NA	18616	16681	1935	10.4
CN2212100000000	22	121	West Baton Rouge Parish, LA	1995	NA	9528	8857	671	7
CN2212300000000	22	123	West Carroll Parish, LA	1995	NA	5252	4396	856	16.3
CN2212500000000	22	125	West Feliciana Parish, LA	1995	NA	3613	3348	265	7.3
CN2212700000000	22	127	Winn Parish, LA	1995	NA	6526	6141	385	5.9
CN2300100000000	23	001	Androscoggin County, ME	1995	NA	56922	53518	3404	6
CN2300300000000	23	003	Aroostook County, ME	1995	NA	38584	34529	4055	10.5
CN2300500000000	23	005	Cumberland County, ME	1995	NA	131033	126172	4861	3.7
CN2300700000000	23	007	Franklin County, ME	1995	NA	14989	13969	1020	6.8
CN2300900000000	23	009	Hancock County, ME	1995	NA	26468	24681	1787	6.8
CN2301100000000	23	011	Kennebec County, ME	1995	NA	59741	55677	4064	6.8
CN2301300000000	23	013	Knox County, ME	1995	NA	20245	19404	841	4.2
CN2301500000000	23	015	Lincoln County, ME	1995	NA	16657	15858	799	4.8
CN2301700000000	23	017	Oxford County, ME	1995	NA	25344	23460	1884	7.4
CN2301900000000	23	019	Penobscot County, ME	1995	NA	74131	69446	4685	6.3
CN2302100000000	23	021	Piscataquis County, ME	1995	NA	8472	7787	685	8.1
CN2302300000000	23	023	Sagadahoc County, ME	1995	NA	15855	15182	673	4.2
CN2302500000000	23	025	Somerset County, ME	1995	NA	25524	23159	2365	9.3
CN2302700000000	23	027	Waldo County, ME	1995	NA	17738	16434	1304	7.4
CN2302900000000	23	029	Washington County, ME	1995	NA	16422	14795	1627	9.9
CN2303100000000	23	031	York County, ME	1995	NA	89391	85455	3936	4.4
CN2400100000000	24	001	Allegany County, MD	1995	NA	32785	29738	3047	9.3
CN2400300000000	24	003	Anne Arundel County, MD	1995	NA	245676	235865	9811	4
CN2400500000000	24	005	Baltimore County, MD	1995	NA	388026	367570	20456	5.3
CN2400900000000	24	009	Calvert County, MD	1995	NA	34203	32832	1371	4
CN2401100000000	24	011	Caroline County, MD	1995	NA	15455	14620	835	5.4
CN2401300000000	24	013	Carroll County, MD	1995	NA	76006	72875	3131	4.1
CN2401500000000	24	015	Cecil County, MD	1995	NA	38561	35533	3028	7.9
CN2401700000000	24	017	Charles County, MD	1995	NA	58805	56581	2224	3.8
CN2401900000000	24	019	Dorchester County, MD	1995	NA	15796	14245	1551	9.8
CN2402100000000	24	021	Frederick County, MD	1995	NA	96375	92472	3903	4
CN2402300000000	24	023	Garrett County, MD	1995	NA	14029	12576	1453	10.4
CN2402500000000	24	025	Harford County, MD	1995	NA	108609	102556	6053	5.6
CN2402700000000	24	027	Howard County, MD	1995	NA	129414	125156	4258	3.3
CN2402900000000	24	029	Kent County, MD	1995	NA	10283	9605	678	6.6
CN2403100000000	24	031	Montgomery County, MD	1995	NA	462500	449093	13407	2.9
CN2403300000000	24	033	Prince George's County, MD	1995	NA	444634	423522	21112	4.7
CN2403500000000	24	035	Queen Anne's County, MD	1995	NA	19353	18483	870	4.5
CN2403700000000	24	037	St. Mary's County, MD	1995	NA	41711	39647	2064	4.9
CN2403900000000	24	039	Somerset County, MD	1995	NA	11294	10088	1206	10.7
CN2404100000000	24	041	Talbot County, MD	1995	NA	17896	17266	630	3.5
CN2404300000000	24	043	Washington County, MD	1995	NA	66460	62415	4045	6.1
CN2404500000000	24	045	Wicomico County, MD	1995	NA	45809	43085	2724	5.9
CN2404700000000	24	047	Worcester County, MD	1995	NA	24340	22017	2323	9.5
CN2451000000000	24	510	Baltimore city, MD	1995	NA	312609	286556	26053	8.3
CN2500100000000	25	001	Barnstable County, MA	1995	NA	102712	95566	7146	7
CN2500300000000	25	003	Berkshire County, MA	1995	NA	66264	62212	4052	6.1
CN2500500000000	25	005	Bristol County, MA	1995	NA	266484	245193	21291	8
CN2500700000000	25	007	Dukes County, MA	1995	NA	8740	8260	480	5.5
CN2500900000000	25	009	Essex County, MA	1995	NA	353702	334846	18856	5.3
CN2501100000000	25	011	Franklin County, MA	1995	NA	37545	35801	1744	4.6
CN2501300000000	25	013	Hampden County, MA	1995	NA	212517	198821	13696	6.4
CN2501500000000	25	015	Hampshire County, MA	1995	NA	79456	76252	3204	4
CN2501700000000	25	017	Middlesex County, MA	1995	NA	789520	755965	33555	4.3
CN2501900000000	25	019	Nantucket County/town, MA	1995	NA	5716	5570	146	2.6
CN2502100000000	25	021	Norfolk County, MA	1995	NA	354064	338865	15199	4.3
CN2502300000000	25	023	Plymouth County, MA	1995	NA	237329	223909	13420	5.7
CN2502500000000	25	025	Suffolk County, MA	1995	NA	338386	320065	18321	5.4
CN2502700000000	25	027	Worcester County, MA	1995	NA	362218	343368	18850	5.2
CN2600100000000	26	001	Alcona County, MI	1995	NA	4856	4357	499	10.3
CN2600300000000	26	003	Alger County, MI	1995	NA	4233	3859	374	8.8
CN2600500000000	26	005	Allegan County, MI	1995	NA	50869	48958	1911	3.8
CN2600700000000	26	007	Alpena County, MI	1995	NA	15288	13684	1604	10.5
CN2600900000000	26	009	Antrim County, MI	1995	NA	9369	8588	781	8.3
CN2601100000000	26	011	Arenac County, MI	1995	NA	6638	5996	642	9.7
CN2601300000000	26	013	Baraga County, MI	1995	NA	3974	3570	404	10.2
CN2601500000000	26	015	Barry County, MI	1995	NA	29359	28134	1225	4.2
CN2601700000000	26	017	Bay County, MI	1995	NA	54258	50880	3378	6.2
CN2601900000000	26	019	Benzie County, MI	1995	NA	7053	6412	641	9.1
CN2602100000000	26	021	Berrien County, MI	1995	NA	82541	78052	4489	5.4
CN2602300000000	26	023	Branch County, MI	1995	NA	19757	18839	918	4.6
CN2602500000000	26	025	Calhoun County, MI	1995	NA	66818	63203	3615	5.4
CN2602700000000	26	027	Cass County, MI	1995	NA	25716	24489	1227	4.8
CN2602900000000	26	029	Charlevoix County, MI	1995	NA	12699	11633	1066	8.4
CN2603100000000	26	031	Cheboygan County, MI	1995	NA	11900	10419	1481	12.4
CN2603300000000	26	033	Chippewa County, MI	1995	NA	17408	15711	1697	9.7
CN2603500000000	26	035	Clare County, MI	1995	NA	10311	9172	1139	11
CN2603700000000	26	037	Clinton County, MI	1995	NA	32262	31145	1117	3.5
CN2603900000000	26	039	Crawford County, MI	1995	NA	5550	5054	496	8.9
CN2604100000000	26	041	Delta County, MI	1995	NA	18014	16267	1747	9.7
CN2604300000000	26	043	Dickinson County, MI	1995	NA	13661	12717	944	6.9
CN2604500000000	26	045	Eaton County, MI	1995	NA	52853	51091	1762	3.3
CN2604700000000	26	047	Emmet County, MI	1995	NA	15918	14190	1728	10.9
CN2604900000000	26	049	Genesee County, MI	1995	NA	205030	191144	13886	6.8
CN2605100000000	26	051	Gladwin County, MI	1995	NA	8850	8049	801	9.1
CN2605300000000	26	053	Gogebic County, MI	1995	NA	8368	7526	842	10.1
CN2605500000000	26	055	Grand Traverse County, MI	1995	NA	41734	39350	2384	5.7
CN2605700000000	26	057	Gratiot County, MI	1995	NA	18887	17532	1355	7.2
CN2605900000000	26	059	Hillsdale County, MI	1995	NA	21937	20883	1054	4.8
CN2606100000000	26	061	Houghton County, MI	1995	NA	16304	15038	1266	7.8
CN2606300000000	26	063	Huron County, MI	1995	NA	17206	15770	1436	8.3
CN2606500000000	26	065	Ingham County, MI	1995	NA	149083	143381	5702	3.8
CN2606700000000	26	067	Ionia County, MI	1995	NA	26472	24843	1629	6.2
CN2606900000000	26	069	Iosco County, MI	1995	NA	11110	10074	1036	9.3
CN2607100000000	26	071	Iron County, MI	1995	NA	5499	4982	517	9.4
CN2607300000000	26	073	Isabella County, MI	1995	NA	28267	26915	1352	4.8
CN2607500000000	26	075	Jackson County, MI	1995	NA	74197	70229	3968	5.3
CN2607700000000	26	077	Kalamazoo County, MI	1995	NA	122863	118612	4251	3.5
CN2607900000000	26	079	Kalkaska County, MI	1995	NA	7155	6535	620	8.7
CN2608100000000	26	081	Kent County, MI	1995	NA	296377	285253	11124	3.8
CN2608300000000	26	083	Keweenaw County, MI	1995	NA	745	651	94	12.6
CN2608500000000	26	085	Lake County, MI	1995	NA	3143	2732	411	13.1
CN2608700000000	26	087	Lapeer County, MI	1995	NA	40360	38052	2308	5.7
CN2608900000000	26	089	Leelanau County, MI	1995	NA	10257	9685	572	5.6
CN2609100000000	26	091	Lenawee County, MI	1995	NA	45417	43091	2326	5.1
CN2609300000000	26	093	Livingston County, MI	1995	NA	71145	68712	2433	3.4
CN2609500000000	26	095	Luce County, MI	1995	NA	2587	2314	273	10.6
CN2609700000000	26	097	Mackinac County, MI	1995	NA	7259	6390	869	12
CN2609900000000	26	099	Macomb County, MI	1995	NA	411891	393063	18828	4.6
CN2610100000000	26	101	Manistee County, MI	1995	NA	10191	8996	1195	11.7
CN2610300000000	26	103	Marquette County, MI	1995	NA	32438	29842	2596	8
CN2610500000000	26	105	Mason County, MI	1995	NA	14124	12721	1403	9.9
CN2610700000000	26	107	Mecosta County, MI	1995	NA	17101	16181	920	5.4
CN2610900000000	26	109	Menominee County, MI	1995	NA	13055	12194	861	6.6
CN2611100000000	26	111	Midland County, MI	1995	NA	40669	38611	2058	5.1
CN2611300000000	26	113	Missaukee County, MI	1995	NA	6173	5647	526	8.5
CN2611500000000	26	115	Monroe County, MI	1995	NA	68251	64724	3527	5.2
CN2611700000000	26	117	Montcalm County, MI	1995	NA	24680	22820	1860	7.5
CN2611900000000	26	119	Montmorency County, MI	1995	NA	3456	2914	542	15.7
CN2612100000000	26	121	Muskegon County, MI	1995	NA	78119	73089	5030	6.4
CN2612300000000	26	123	Newaygo County, MI	1995	NA	19919	17931	1988	10
CN2612500000000	26	125	Oakland County, MI	1995	NA	634257	611547	22710	3.6
CN2612700000000	26	127	Oceana County, MI	1995	NA	12962	11479	1483	11.4
CN2612900000000	26	129	Ogemaw County, MI	1995	NA	8306	7449	857	10.3
CN2613100000000	26	131	Ontonagon County, MI	1995	NA	3863	3480	383	9.9
CN2613300000000	26	133	Osceola County, MI	1995	NA	10571	9668	903	8.5
CN2613500000000	26	135	Oscoda County, MI	1995	NA	3629	3273	356	9.8
CN2613700000000	26	137	Otsego County, MI	1995	NA	12101	11343	758	6.3
CN2613900000000	26	139	Ottawa County, MI	1995	NA	120644	116805	3839	3.2
CN2614100000000	26	141	Presque Isle County, MI	1995	NA	6264	5251	1013	16.2
CN2614300000000	26	143	Roscommon County, MI	1995	NA	8169	7319	850	10.4
CN2614500000000	26	145	Saginaw County, MI	1995	NA	98675	92743	5932	6
CN2614700000000	26	147	St. Clair County, MI	1995	NA	75037	70326	4711	6.3
CN2614900000000	26	149	St. Joseph County, MI	1995	NA	32716	31321	1395	4.3
CN2615100000000	26	151	Sanilac County, MI	1995	NA	20632	18965	1667	8.1
CN2615300000000	26	153	Schoolcraft County, MI	1995	NA	4099	3534	565	13.8
CN2615500000000	26	155	Shiawassee County, MI	1995	NA	34757	32220	2537	7.3
CN2615700000000	26	157	Tuscola County, MI	1995	NA	27149	25050	2099	7.7
CN2615900000000	26	159	Van Buren County, MI	1995	NA	35729	33372	2357	6.6
CN2616100000000	26	161	Washtenaw County, MI	1995	NA	161595	157187	4408	2.7
CN2616300000000	26	163	Wayne County, MI	1995	NA	935634	881149	54485	5.8
CN2616500000000	26	165	Wexford County, MI	1995	NA	14099	12550	1549	11
CN2700100000000	27	001	Aitkin County, MN	1995	NA	5749	5202	547	9.5
CN2700300000000	27	003	Anoka County, MN	1995	NA	166431	161267	5164	3.1
CN2700500000000	27	005	Becker County, MN	1995	NA	13008	12006	1002	7.7
CN2700700000000	27	007	Beltrami County, MN	1995	NA	18656	17421	1235	6.6
CN2700900000000	27	009	Benton County, MN	1995	NA	19354	18493	861	4.4
CN2701100000000	27	011	Big Stone County, MN	1995	NA	2793	2655	138	4.9
CN2701300000000	27	013	Blue Earth County, MN	1995	NA	32573	31510	1063	3.3
CN2701500000000	27	015	Brown County, MN	1995	NA	14961	14394	567	3.8
CN2701700000000	27	017	Carlton County, MN	1995	NA	15150	14096	1054	7
CN2701900000000	27	019	Carver County, MN	1995	NA	35224	34371	853	2.4
CN2702100000000	27	021	Cass County, MN	1995	NA	11179	10250	929	8.3
CN2702300000000	27	023	Chippewa County, MN	1995	NA	6709	6354	355	5.3
CN2702500000000	27	025	Chisago County, MN	1995	NA	19000	18133	867	4.6
CN2702700000000	27	027	Clay County, MN	1995	NA	29169	28074	1095	3.8
CN2702900000000	27	029	Clearwater County, MN	1995	NA	3951	3345	606	15.3
CN2703100000000	27	031	Cook County, MN	1995	NA	2966	2795	171	5.8
CN2703300000000	27	033	Cottonwood County, MN	1995	NA	6174	5739	435	7
CN2703500000000	27	035	Crow Wing County, MN	1995	NA	25605	23985	1620	6.3
CN2703700000000	27	037	Dakota County, MN	1995	NA	194030	189118	4912	2.5
CN2703900000000	27	039	Dodge County, MN	1995	NA	9035	8542	493	5.5
CN2704100000000	27	041	Douglas County, MN	1995	NA	16019	15314	705	4.4
CN2704300000000	27	043	Faribault County, MN	1995	NA	8264	7830	434	5.3
CN2704500000000	27	045	Fillmore County, MN	1995	NA	10117	9641	476	4.7
CN2704700000000	27	047	Freeborn County, MN	1995	NA	16253	15487	766	4.7
CN2704900000000	27	049	Goodhue County, MN	1995	NA	23550	22660	890	3.8
CN2705100000000	27	051	Grant County, MN	1995	NA	3013	2865	148	4.9
CN2705300000000	27	053	Hennepin County, MN	1995	NA	642932	624592	18340	2.9
CN2705500000000	27	055	Houston County, MN	1995	NA	10850	10462	388	3.6
CN2705700000000	27	057	Hubbard County, MN	1995	NA	7733	7198	535	6.9
CN2705900000000	27	059	Isanti County, MN	1995	NA	14666	13993	673	4.6
CN2706100000000	27	061	Itasca County, MN	1995	NA	19900	17991	1909	9.6
CN2706300000000	27	063	Jackson County, MN	1995	NA	5940	5655	285	4.8
CN2706500000000	27	065	Kanabec County, MN	1995	NA	7414	6817	597	8.1
CN2706700000000	27	067	Kandiyohi County, MN	1995	NA	20845	20103	742	3.6
CN2706900000000	27	069	Kittson County, MN	1995	NA	2453	2294	159	6.5
CN2707100000000	27	071	Koochiching County, MN	1995	NA	6326	5785	541	8.6
CN2707300000000	27	073	Lac qui Parle County, MN	1995	NA	3972	3831	141	3.5
CN2707500000000	27	075	Lake County, MN	1995	NA	5564	5270	294	5.3
CN2707700000000	27	077	Lake of the Woods County, MN	1995	NA	2425	2324	101	4.2
CN2707900000000	27	079	Le Sueur County, MN	1995	NA	13648	13034	614	4.5
CN2708100000000	27	081	Lincoln County, MN	1995	NA	3099	2939	160	5.2
CN2708300000000	27	083	Lyon County, MN	1995	NA	14882	14367	515	3.5
CN2708500000000	27	085	McLeod County, MN	1995	NA	20089	19373	716	3.6
CN2708700000000	27	087	Mahnomen County, MN	1995	NA	2490	2313	177	7.1
CN2708900000000	27	089	Marshall County, MN	1995	NA	4747	4273	474	10
CN2709100000000	27	091	Martin County, MN	1995	NA	11628	11103	525	4.5
CN2709300000000	27	093	Meeker County, MN	1995	NA	9380	8798	582	6.2
CN2709500000000	27	095	Mille Lacs County, MN	1995	NA	8962	8234	728	8.1
CN2709700000000	27	097	Morrison County, MN	1995	NA	14923	13779	1144	7.7
CN2709900000000	27	099	Mower County, MN	1995	NA	18577	17981	596	3.2
CN2710100000000	27	101	Murray County, MN	1995	NA	4411	4160	251	5.7
CN2710300000000	27	103	Nicollet County, MN	1995	NA	18037	17509	528	2.9
CN2710500000000	27	105	Nobles County, MN	1995	NA	10122	9717	405	4
CN2710700000000	27	107	Norman County, MN	1995	NA	3662	3463	199	5.4
CN2710900000000	27	109	Olmsted County, MN	1995	NA	64374	62484	1890	2.9
CN2711100000000	27	111	Otter Tail County, MN	1995	NA	26615	25135	1480	5.6
CN2711300000000	27	113	Pennington County, MN	1995	NA	7657	7185	472	6.2
CN2711500000000	27	115	Pine County, MN	1995	NA	11256	10344	912	8.1
CN2711700000000	27	117	Pipestone County, MN	1995	NA	5042	4869	173	3.4
CN2711900000000	27	119	Polk County, MN	1995	NA	16958	16094	864	5.1
CN2712100000000	27	121	Pope County, MN	1995	NA	5303	5081	222	4.2
CN2712300000000	27	123	Ramsey County, MN	1995	NA	277271	269077	8194	3
CN2712500000000	27	125	Red Lake County, MN	1995	NA	2010	1799	211	10.5
CN2712700000000	27	127	Redwood County, MN	1995	NA	8859	8587	272	3.1
CN2712900000000	27	129	Renville County, MN	1995	NA	8287	7871	416	5
CN2713100000000	27	131	Rice County, MN	1995	NA	28202	27046	1156	4.1
CN2713300000000	27	133	Rock County, MN	1995	NA	5037	4912	125	2.5
CN2713500000000	27	135	Roseau County, MN	1995	NA	8871	8540	331	3.7
CN2713700000000	27	137	St. Louis County, MN	1995	NA	100966	95194	5772	5.7
CN2713900000000	27	139	Scott County, MN	1995	NA	41133	39874	1259	3.1
CN2714100000000	27	141	Sherburne County, MN	1995	NA	28658	27517	1141	4
CN2714300000000	27	143	Sibley County, MN	1995	NA	6856	6494	362	5.3
CN2714500000000	27	145	Stearns County, MN	1995	NA	73550	70503	3047	4.1
CN2714700000000	27	147	Steele County, MN	1995	NA	18213	17508	705	3.9
CN2714900000000	27	149	Stevens County, MN	1995	NA	5358	5173	185	3.5
CN2715100000000	27	151	Swift County, MN	1995	NA	5305	5058	247	4.7
CN2715300000000	27	153	Todd County, MN	1995	NA	10259	9540	719	7
CN2715500000000	27	155	Traverse County, MN	1995	NA	1850	1760	90	4.9
CN2715700000000	27	157	Wabasha County, MN	1995	NA	11896	11404	492	4.1
CN2715900000000	27	159	Wadena County, MN	1995	NA	6262	5926	336	5.4
CN2716100000000	27	161	Waseca County, MN	1995	NA	9445	9105	340	3.6
CN2716300000000	27	163	Washington County, MN	1995	NA	103726	100986	2740	2.6
CN2716500000000	27	165	Watonwan County, MN	1995	NA	5787	5538	249	4.3
CN2716700000000	27	167	Wilkin County, MN	1995	NA	3847	3691	156	4.1
CN2716900000000	27	169	Winona County, MN	1995	NA	28090	27050	1040	3.7
CN2717100000000	27	171	Wright County, MN	1995	NA	43327	41580	1747	4
CN2717300000000	27	173	Yellow Medicine County, MN	1995	NA	5417	5141	276	5.1
CN2800100000000	28	001	Adams County, MS	1995	NA	14703	13614	1089	7.4
CN2800300000000	28	003	Alcorn County, MS	1995	NA	15573	14223	1350	8.7
CN2800500000000	28	005	Amite County, MS	1995	NA	5256	4978	278	5.3
CN2800700000000	28	007	Attala County, MS	1995	NA	7982	7374	608	7.6
CN2800900000000	28	009	Benton County, MS	1995	NA	3219	2890	329	10.2
CN2801100000000	28	011	Bolivar County, MS	1995	NA	17980	16395	1585	8.8
CN2801300000000	28	013	Calhoun County, MS	1995	NA	7124	6814	310	4.4
CN2801500000000	28	015	Carroll County, MS	1995	NA	4432	4186	246	5.6
CN2801700000000	28	017	Chickasaw County, MS	1995	NA	8491	7550	941	11.1
CN2801900000000	28	019	Choctaw County, MS	1995	NA	3554	3217	337	9.5
CN2802100000000	28	021	Claiborne County, MS	1995	NA	3812	3431	381	10
CN2802300000000	28	023	Clarke County, MS	1995	NA	8500	8042	458	5.4
CN2802500000000	28	025	Clay County, MS	1995	NA	8976	8056	920	10.2
CN2802700000000	28	027	Coahoma County, MS	1995	NA	12821	11478	1343	10.5
CN2802900000000	28	029	Copiah County, MS	1995	NA	11502	10661	841	7.3
CN2803100000000	28	031	Covington County, MS	1995	NA	8831	8381	450	5.1
CN2803300000000	28	033	DeSoto County, MS	1995	NA	44864	42971	1893	4.2
CN2803500000000	28	035	Forrest County, MS	1995	NA	33229	31739	1490	4.5
CN2803700000000	28	037	Franklin County, MS	1995	NA	3238	3025	213	6.6
CN2803900000000	28	039	George County, MS	1995	NA	8158	7357	801	9.8
CN2804100000000	28	041	Greene County, MS	1995	NA	4741	4318	423	8.9
CN2804300000000	28	043	Grenada County, MS	1995	NA	10155	9438	717	7.1
CN2804500000000	28	045	Hancock County, MS	1995	NA	16046	14966	1080	6.7
CN2804700000000	28	047	Harrison County, MS	1995	NA	81742	76428	5314	6.5
CN2804900000000	28	049	Hinds County, MS	1995	NA	127953	122262	5691	4.4
CN2805100000000	28	051	Holmes County, MS	1995	NA	7451	6525	926	12.4
CN2805300000000	28	053	Humphreys County, MS	1995	NA	4993	4399	594	11.9
CN2805500000000	28	055	Issaquena County, MS	1995	NA	779	653	126	16.2
CN2805700000000	28	057	Itawamba County, MS	1995	NA	11319	10753	566	5
CN2805900000000	28	059	Jackson County, MS	1995	NA	64770	60961	3809	5.9
CN2806100000000	28	061	Jasper County, MS	1995	NA	7649	7156	493	6.4
CN2806300000000	28	063	Jefferson County, MS	1995	NA	2502	2113	389	15.5
CN2806500000000	28	065	Jefferson Davis County, MS	1995	NA	5276	4587	689	13.1
CN2806700000000	28	067	Jones County, MS	1995	NA	29910	28691	1219	4.1
CN2806900000000	28	069	Kemper County, MS	1995	NA	4345	3993	352	8.1
CN2807100000000	28	071	Lafayette County, MS	1995	NA	16140	15722	418	2.6
CN2807300000000	28	073	Lamar County, MS	1995	NA	16005	15479	526	3.3
CN2807500000000	28	075	Lauderdale County, MS	1995	NA	35726	33764	1962	5.5
CN2807700000000	28	077	Lawrence County, MS	1995	NA	5302	4903	399	7.5
CN2807900000000	28	079	Leake County, MS	1995	NA	8841	8331	510	5.8
CN2808100000000	28	081	Lee County, MS	1995	NA	39475	37832	1643	4.2
CN2808300000000	28	083	Leflore County, MS	1995	NA	15873	14351	1522	9.6
CN2808500000000	28	085	Lincoln County, MS	1995	NA	13452	12645	807	6
CN2808700000000	28	087	Lowndes County, MS	1995	NA	27770	26231	1539	5.5
CN2808900000000	28	089	Madison County, MS	1995	NA	33053	31843	1210	3.7
CN2809100000000	28	091	Marion County, MS	1995	NA	9830	9091	739	7.5
CN2809300000000	28	093	Marshall County, MS	1995	NA	13886	12496	1390	10
CN2809500000000	28	095	Monroe County, MS	1995	NA	17131	15527	1604	9.4
CN2809700000000	28	097	Montgomery County, MS	1995	NA	5500	5127	373	6.8
CN2809900000000	28	099	Neshoba County, MS	1995	NA	15313	14710	603	3.9
CN2810100000000	28	101	Newton County, MS	1995	NA	8659	7956	703	8.1
CN2810300000000	28	103	Noxubee County, MS	1995	NA	4590	4169	421	9.2
CN2810500000000	28	105	Oktibbeha County, MS	1995	NA	19087	18508	579	3
CN2810700000000	28	107	Panola County, MS	1995	NA	13527	12357	1170	8.6
CN2810900000000	28	109	Pearl River County, MS	1995	NA	18863	17774	1089	5.8
CN2811100000000	28	111	Perry County, MS	1995	NA	4963	4576	387	7.8
CN2811300000000	28	113	Pike County, MS	1995	NA	15762	14788	974	6.2
CN2811500000000	28	115	Pontotoc County, MS	1995	NA	13158	12459	699	5.3
CN2811700000000	28	117	Prentiss County, MS	1995	NA	12270	11430	840	6.8
CN2811900000000	28	119	Quitman County, MS	1995	NA	3725	3238	487	13.1
CN2812100000000	28	121	Rankin County, MS	1995	NA	53671	52063	1608	3
CN2812300000000	28	123	Scott County, MS	1995	NA	13170	12522	648	4.9
CN2812500000000	28	125	Sharkey County, MS	1995	NA	3114	2538	576	18.5
CN2812700000000	28	127	Simpson County, MS	1995	NA	10631	10061	570	5.4
CN2812900000000	28	129	Smith County, MS	1995	NA	6161	5903	258	4.2
CN2813100000000	28	131	Stone County, MS	1995	NA	5003	4663	340	6.8
CN2813300000000	28	133	Sunflower County, MS	1995	NA	11694	10374	1320	11.3
CN2813500000000	28	135	Tallahatchie County, MS	1995	NA	5591	4935	656	11.7
CN2813700000000	28	137	Tate County, MS	1995	NA	10701	10019	682	6.4
CN2813900000000	28	139	Tippah County, MS	1995	NA	9622	9040	582	6
CN2814100000000	28	141	Tishomingo County, MS	1995	NA	9993	9294	699	7
CN2814300000000	28	143	Tunica County, MS	1995	NA	5039	4384	655	13
CN2814500000000	28	145	Union County, MS	1995	NA	12239	11571	668	5.5
CN2814700000000	28	147	Walthall County, MS	1995	NA	5829	5483	346	5.9
CN2814900000000	28	149	Warren County, MS	1995	NA	27402	25740	1662	6.1
CN2815100000000	28	151	Washington County, MS	1995	NA	29363	26380	2983	10.2
CN2815300000000	28	153	Wayne County, MS	1995	NA	9127	8467	660	7.2
CN2815500000000	28	155	Webster County, MS	1995	NA	4457	4068	389	8.7
CN2815700000000	28	157	Wilkinson County, MS	1995	NA	3600	3202	398	11.1
CN2815900000000	28	159	Winston County, MS	1995	NA	7705	7205	500	6.5
CN2816100000000	28	161	Yalobusha County, MS	1995	NA	5349	4968	381	7.1
CN2816300000000	28	163	Yazoo County, MS	1995	NA	9610	8704	906	9.4
CN2900100000000	29	001	Adair County, MO	1995	NA	14823	14396	427	2.9
CN2900300000000	29	003	Andrew County, MO	1995	NA	8143	7680	463	5.7
CN2900500000000	29	005	Atchison County, MO	1995	NA	3265	3177	88	2.7
CN2900700000000	29	007	Audrain County, MO	1995	NA	12582	12056	526	4.2
CN2900900000000	29	009	Barry County, MO	1995	NA	15188	14442	746	4.9
CN2901100000000	29	011	Barton County, MO	1995	NA	6904	6687	217	3.1
CN2901300000000	29	013	Bates County, MO	1995	NA	7528	7113	415	5.5
CN2901500000000	29	015	Benton County, MO	1995	NA	6138	5653	485	7.9
CN2901700000000	29	017	Bollinger County, MO	1995	NA	5093	4768	325	6.4
CN2901900000000	29	019	Boone County, MO	1995	NA	77406	75997	1409	1.8
CN2902100000000	29	021	Buchanan County, MO	1995	NA	42608	39500	3108	7.3
CN2902300000000	29	023	Butler County, MO	1995	NA	19540	18291	1249	6.4
CN2902500000000	29	025	Caldwell County, MO	1995	NA	3773	3578	195	5.2
CN2902700000000	29	027	Callaway County, MO	1995	NA	19645	18962	683	3.5
CN2902900000000	29	029	Camden County, MO	1995	NA	16123	15031	1092	6.8
CN2903100000000	29	031	Cape Girardeau County, MO	1995	NA	35722	34467	1255	3.5
CN2903300000000	29	033	Carroll County, MO	1995	NA	5594	5298	296	5.3
CN2903500000000	29	035	Carter County, MO	1995	NA	2634	2416	218	8.3
CN2903700000000	29	037	Cass County, MO	1995	NA	41077	39506	1571	3.8
CN2903900000000	29	039	Cedar County, MO	1995	NA	5539	5250	289	5.2
CN2904100000000	29	041	Chariton County, MO	1995	NA	4156	3889	267	6.4
CN2904300000000	29	043	Christian County, MO	1995	NA	24374	23454	920	3.8
CN2904500000000	29	045	Clark County, MO	1995	NA	3672	3498	174	4.7
CN2904700000000	29	047	Clay County, MO	1995	NA	100373	97148	3225	3.2
CN2904900000000	29	049	Clinton County, MO	1995	NA	9144	8754	390	4.3
CN2905100000000	29	051	Cole County, MO	1995	NA	38156	37227	929	2.4
CN2905300000000	29	053	Cooper County, MO	1995	NA	8497	8156	341	4
CN2905500000000	29	055	Crawford County, MO	1995	NA	10497	9787	710	6.8
CN2905700000000	29	057	Dade County, MO	1995	NA	3268	3119	149	4.6
CN2905900000000	29	059	Dallas County, MO	1995	NA	6376	5955	421	6.6
CN2906100000000	29	061	Daviess County, MO	1995	NA	3668	3478	190	5.2
CN2906300000000	29	063	DeKalb County, MO	1995	NA	4134	3932	202	4.9
CN2906500000000	29	065	Dent County, MO	1995	NA	6451	6038	413	6.4
CN2906700000000	29	067	Douglas County, MO	1995	NA	5941	5384	557	9.4
CN2906900000000	29	069	Dunklin County, MO	1995	NA	14147	13068	1079	7.6
CN2907100000000	29	071	Franklin County, MO	1995	NA	46418	43954	2464	5.3
CN2907300000000	29	073	Gasconade County, MO	1995	NA	7524	7161	363	4.8
CN2907500000000	29	075	Gentry County, MO	1995	NA	3652	3536	116	3.2
CN2907700000000	29	077	Greene County, MO	1995	NA	127742	123693	4049	3.2
CN2907900000000	29	079	Grundy County, MO	1995	NA	5334	5080	254	4.8
CN2908100000000	29	081	Harrison County, MO	1995	NA	4566	4371	195	4.3
CN2908300000000	29	083	Henry County, MO	1995	NA	10001	9299	702	7
CN2908500000000	29	085	Hickory County, MO	1995	NA	2891	2690	201	7
CN2908700000000	29	087	Holt County, MO	1995	NA	2817	2685	132	4.7
CN2908900000000	29	089	Howard County, MO	1995	NA	4952	4721	231	4.7
CN2909100000000	29	091	Howell County, MO	1995	NA	17359	16204	1155	6.7
CN2909300000000	29	093	Iron County, MO	1995	NA	4445	4016	429	9.7
CN2909500000000	29	095	Jackson County, MO	1995	NA	361952	344550	17402	4.8
CN2909700000000	29	097	Jasper County, MO	1995	NA	52074	49889	2185	4.2
CN2909900000000	29	099	Jefferson County, MO	1995	NA	100994	96134	4860	4.8
CN2910100000000	29	101	Johnson County, MO	1995	NA	22406	21782	624	2.8
CN2910300000000	29	103	Knox County, MO	1995	NA	1901	1810	91	4.8
CN2910500000000	29	105	Laclede County, MO	1995	NA	15007	13917	1090	7.3
CN2910700000000	29	107	Lafayette County, MO	1995	NA	16387	15648	739	4.5
CN2910900000000	29	109	Lawrence County, MO	1995	NA	15840	15107	733	4.6
CN2911100000000	29	111	Lewis County, MO	1995	NA	5448	5231	217	4
CN2911300000000	29	113	Lincoln County, MO	1995	NA	16942	16039	903	5.3
CN2911500000000	29	115	Linn County, MO	1995	NA	7201	6577	624	8.7
CN2911700000000	29	117	Livingston County, MO	1995	NA	7343	7041	302	4.1
CN2911900000000	29	119	McDonald County, MO	1995	NA	8154	7766	388	4.8
CN2912100000000	29	121	Macon County, MO	1995	NA	7894	7349	545	6.9
CN2912300000000	29	123	Madison County, MO	1995	NA	4677	4267	410	8.8
CN2912500000000	29	125	Maries County, MO	1995	NA	4175	3998	177	4.2
CN2912700000000	29	127	Marion County, MO	1995	NA	15467	14740	727	4.7
CN2912900000000	29	129	Mercer County, MO	1995	NA	2238	2148	90	4
CN2913100000000	29	131	Miller County, MO	1995	NA	11463	10683	780	6.8
CN2913300000000	29	133	Mississippi County, MO	1995	NA	6214	5630	584	9.4
CN2913500000000	29	135	Moniteau County, MO	1995	NA	7058	6768	290	4.1
CN2913700000000	29	137	Monroe County, MO	1995	NA	4277	4031	246	5.8
CN2913900000000	29	139	Montgomery County, MO	1995	NA	6055	5767	288	4.8
CN2914100000000	29	141	Morgan County, MO	1995	NA	8216	7700	516	6.3
CN2914300000000	29	143	New Madrid County, MO	1995	NA	8862	8192	670	7.6
CN2914500000000	29	145	Newton County, MO	1995	NA	25990	24666	1324	5.1
CN2914700000000	29	147	Nodaway County, MO	1995	NA	12256	12075	181	1.5
CN2914900000000	29	149	Oregon County, MO	1995	NA	4470	4191	279	6.2
CN2915100000000	29	151	Osage County, MO	1995	NA	7073	6872	201	2.8
CN2915300000000	29	153	Ozark County, MO	1995	NA	4117	3863	254	6.2
CN2915500000000	29	155	Pemiscot County, MO	1995	NA	8518	7482	1036	12.2
CN2915700000000	29	157	Perry County, MO	1995	NA	10296	9863	433	4.2
CN2915900000000	29	159	Pettis County, MO	1995	NA	20642	19563	1079	5.2
CN2916100000000	29	161	Phelps County, MO	1995	NA	18557	17840	717	3.9
CN2916300000000	29	163	Pike County, MO	1995	NA	7296	6711	585	8
CN2916500000000	29	165	Platte County, MO	1995	NA	41342	40173	1169	2.8
CN2916700000000	29	167	Polk County, MO	1995	NA	11403	10885	518	4.5
CN2916900000000	29	169	Pulaski County, MO	1995	NA	12375	11496	879	7.1
CN2917100000000	29	171	Putnam County, MO	1995	NA	2274	2194	80	3.5
CN2917300000000	29	173	Ralls County, MO	1995	NA	5154	4904	250	4.9
CN2917500000000	29	175	Randolph County, MO	1995	NA	10689	10013	676	6.3
CN2917700000000	29	177	Ray County, MO	1995	NA	10875	10381	494	4.5
CN2917900000000	29	179	Reynolds County, MO	1995	NA	3304	3120	184	5.6
CN2918100000000	29	181	Ripley County, MO	1995	NA	5328	4820	508	9.5
CN2918300000000	29	183	St. Charles County, MO	1995	NA	145683	140931	4752	3.3
CN2918500000000	29	185	St. Clair County, MO	1995	NA	3984	3721	263	6.6
CN2918600000000	29	186	Ste. Genevieve County, MO	1995	NA	9155	8697	458	5
CN2918700000000	29	187	St. Francois County, MO	1995	NA	23104	21346	1758	7.6
CN2918900000000	29	189	St. Louis County, MO	1995	NA	572371	551824	20547	3.6
CN2919500000000	29	195	Saline County, MO	1995	NA	12323	11811	512	4.2
CN2919700000000	29	197	Schuyler County, MO	1995	NA	2511	2395	116	4.6
CN2919900000000	29	199	Scotland County, MO	1995	NA	2282	2178	104	4.6
CN2920100000000	29	201	Scott County, MO	1995	NA	20011	18828	1183	5.9
CN2920300000000	29	203	Shannon County, MO	1995	NA	3988	3708	280	7
CN2920500000000	29	205	Shelby County, MO	1995	NA	3624	3464	160	4.4
CN2920700000000	29	207	Stoddard County, MO	1995	NA	14077	12869	1208	8.6
CN2920900000000	29	209	Stone County, MO	1995	NA	13825	12307	1518	11
CN2921100000000	29	211	Sullivan County, MO	1995	NA	3400	3249	151	4.4
CN2921300000000	29	213	Taney County, MO	1995	NA	27071	24710	2361	8.7
CN2921500000000	29	215	Texas County, MO	1995	NA	9675	8764	911	9.4
CN2921700000000	29	217	Vernon County, MO	1995	NA	9097	8700	397	4.4
CN2921900000000	29	219	Warren County, MO	1995	NA	11631	11110	521	4.5
CN2922100000000	29	221	Washington County, MO	1995	NA	8979	8093	886	9.9
CN2922300000000	29	223	Wayne County, MO	1995	NA	3861	3172	689	17.8
CN2922500000000	29	225	Webster County, MO	1995	NA	13415	12835	580	4.3
CN2922700000000	29	227	Worth County, MO	1995	NA	969	917	52	5.4
CN2922900000000	29	229	Wright County, MO	1995	NA	7812	6853	959	12.3
CN2951000000000	29	510	St. Louis city, MO	1995	NA	170317	157314	13003	7.6
CN3000100000000	30	001	Beaverhead County, MT	1995	NA	4988	4784	204	4.1
CN3000300000000	30	003	Big Horn County, MT	1995	NA	4966	4359	607	12.2
CN3000500000000	30	005	Blaine County, MT	1995	NA	2863	2595	268	9.4
CN3000700000000	30	007	Broadwater County, MT	1995	NA	1894	1792	102	5.4
CN3000900000000	30	009	Carbon County, MT	1995	NA	4313	4063	250	5.8
CN3001100000000	30	011	Carter County, MT	1995	NA	892	876	16	1.8
CN3001300000000	30	013	Cascade County, MT	1995	NA	37378	35422	1956	5.2
CN3001500000000	30	015	Chouteau County, MT	1995	NA	2668	2580	88	3.3
CN3001700000000	30	017	Custer County, MT	1995	NA	6007	5741	266	4.4
CN3001900000000	30	019	Daniels County, MT	1995	NA	1225	1192	33	2.7
CN3002100000000	30	021	Dawson County, MT	1995	NA	4822	4647	175	3.6
CN3002300000000	30	023	Deer Lodge County, MT	1995	NA	3936	3589	347	8.8
CN3002500000000	30	025	Fallon County, MT	1995	NA	1553	1503	50	3.2
CN3002700000000	30	027	Fergus County, MT	1995	NA	5968	5612	356	6
CN3002900000000	30	029	Flathead County, MT	1995	NA	36301	33463	2838	7.8
CN3003100000000	30	031	Gallatin County, MT	1995	NA	36641	35698	943	2.6
CN3003300000000	30	033	Garfield County, MT	1995	NA	895	867	28	3.1
CN3003500000000	30	035	Glacier County, MT	1995	NA	5660	4857	803	14.2
CN3003700000000	30	037	Golden Valley County, MT	1995	NA	490	454	36	7.3
CN3003900000000	30	039	Granite County, MT	1995	NA	1112	1031	81	7.3
CN3004100000000	30	041	Hill County, MT	1995	NA	9076	8546	530	5.8
CN3004300000000	30	043	Jefferson County, MT	1995	NA	4685	4475	210	4.5
CN3004500000000	30	045	Judith Basin County, MT	1995	NA	1071	1024	47	4.4
CN3004700000000	30	047	Lake County, MT	1995	NA	10429	9625	804	7.7
CN3004900000000	30	049	Lewis and Clark County, MT	1995	NA	27925	26540	1385	5
CN3005100000000	30	051	Liberty County, MT	1995	NA	1112	1085	27	2.4
CN3005300000000	30	053	Lincoln County, MT	1995	NA	7475	6401	1074	14.4
CN3005500000000	30	055	McCone County, MT	1995	NA	1179	1144	35	3
CN3005700000000	30	057	Madison County, MT	1995	NA	3538	3368	170	4.8
CN3005900000000	30	059	Meagher County, MT	1995	NA	956	900	56	5.9
CN3006100000000	30	061	Mineral County, MT	1995	NA	1711	1501	210	12.3
CN3006300000000	30	063	Missoula County, MT	1995	NA	48662	46247	2415	5
CN3006500000000	30	065	Musselshell County, MT	1995	NA	1958	1795	163	8.3
CN3006700000000	30	067	Park County, MT	1995	NA	10180	9726	454	4.5
CN3006900000000	30	069	Petroleum County, MT	1995	NA	304	291	13	4.3
CN3007100000000	30	071	Phillips County, MT	1995	NA	2478	2331	147	5.9
CN3007300000000	30	073	Pondera County, MT	1995	NA	3050	2922	128	4.2
CN3007500000000	30	075	Powder River County, MT	1995	NA	1164	1138	26	2.2
CN3007700000000	30	077	Powell County, MT	1995	NA	2388	2206	182	7.6
CN3007900000000	30	079	Prairie County, MT	1995	NA	658	629	29	4.4
CN3008100000000	30	081	Ravalli County, MT	1995	NA	15320	14393	927	6.1
CN3008300000000	30	083	Richland County, MT	1995	NA	5473	5170	303	5.5
CN3008500000000	30	085	Roosevelt County, MT	1995	NA	4164	3741	423	10.2
CN3008700000000	30	087	Rosebud County, MT	1995	NA	4756	4335	421	8.9
CN3008900000000	30	089	Sanders County, MT	1995	NA	4139	3574	565	13.7
CN3009100000000	30	091	Sheridan County, MT	1995	NA	2099	2040	59	2.8
CN3009300000000	30	093	Silver Bow County, MT	1995	NA	16973	16028	945	5.6
CN3009500000000	30	095	Stillwater County, MT	1995	NA	3768	3589	179	4.8
CN3009700000000	30	097	Sweet Grass County, MT	1995	NA	1687	1628	59	3.5
CN3009900000000	30	099	Teton County, MT	1995	NA	3040	2941	99	3.3
CN3010100000000	30	101	Toole County, MT	1995	NA	2820	2674	146	5.2
CN3010300000000	30	103	Treasure County, MT	1995	NA	434	419	15	3.5
CN3010500000000	30	105	Valley County, MT	1995	NA	4267	4085	182	4.3
CN3010700000000	30	107	Wheatland County, MT	1995	NA	1306	1242	64	4.9
CN3010900000000	30	109	Wibaux County, MT	1995	NA	572	547	25	4.4
CN3011100000000	30	111	Yellowstone County, MT	1995	NA	67788	64657	3131	4.6
CN3100100000000	31	001	Adams County, NE	1995	NA	15886	15650	236	1.5
CN3100300000000	31	003	Antelope County, NE	1995	NA	3315	3190	125	3.8
CN3100500000000	31	005	Arthur County, NE	1995	NA	211	203	8	3.8
CN3100700000000	31	007	Banner County, NE	1995	NA	421	407	14	3.3
CN3100900000000	31	009	Blaine County, NE	1995	NA	367	355	12	3.3
CN3101100000000	31	011	Boone County, NE	1995	NA	2936	2878	58	2
CN3101300000000	31	013	Box Butte County, NE	1995	NA	6335	6050	285	4.5
CN3101500000000	31	015	Boyd County, NE	1995	NA	1232	1203	29	2.4
CN3101700000000	31	017	Brown County, NE	1995	NA	1888	1813	75	4
CN3101900000000	31	019	Buffalo County, NE	1995	NA	23813	23197	616	2.6
CN3102100000000	31	021	Burt County, NE	1995	NA	3618	3477	141	3.9
CN3102300000000	31	023	Butler County, NE	1995	NA	4377	4265	112	2.6
CN3102500000000	31	025	Cass County, NE	1995	NA	11886	11546	340	2.9
CN3102700000000	31	027	Cedar County, NE	1995	NA	5207	5094	113	2.2
CN3102900000000	31	029	Chase County, NE	1995	NA	2014	1971	43	2.1
CN3103100000000	31	031	Cherry County, NE	1995	NA	3494	3418	76	2.2
CN3103300000000	31	033	Cheyenne County, NE	1995	NA	5170	5057	113	2.2
CN3103500000000	31	035	Clay County, NE	1995	NA	3517	3446	71	2
CN3103700000000	31	037	Colfax County, NE	1995	NA	4822	4726	96	2
CN3103900000000	31	039	Cuming County, NE	1995	NA	5425	5309	116	2.1
CN3104100000000	31	041	Custer County, NE	1995	NA	5788	5654	134	2.3
CN3104300000000	31	043	Dakota County, NE	1995	NA	10045	9781	264	2.6
CN3104500000000	31	045	Dawes County, NE	1995	NA	4551	4389	162	3.6
CN3104700000000	31	047	Dawson County, NE	1995	NA	13514	13071	443	3.3
CN3104900000000	31	049	Deuel County, NE	1995	NA	1023	988	35	3.4
CN3105100000000	31	051	Dixon County, NE	1995	NA	2854	2789	65	2.3
CN3105300000000	31	053	Dodge County, NE	1995	NA	18912	18364	548	2.9
CN3105500000000	31	055	Douglas County, NE	1995	NA	247074	240070	7004	2.8
CN3105700000000	31	057	Dundy County, NE	1995	NA	1220	1186	34	2.8
CN3105900000000	31	059	Fillmore County, NE	1995	NA	3357	3289	68	2
CN3106100000000	31	061	Franklin County, NE	1995	NA	1751	1720	31	1.8
CN3106300000000	31	063	Frontier County, NE	1995	NA	1639	1594	45	2.7
CN3106500000000	31	065	Furnas County, NE	1995	NA	2680	2617	63	2.4
CN3106700000000	31	067	Gage County, NE	1995	NA	11963	11688	275	2.3
CN3106900000000	31	069	Garden County, NE	1995	NA	1112	1065	47	4.2
CN3107100000000	31	071	Garfield County, NE	1995	NA	1073	1045	28	2.6
CN3107300000000	31	073	Gosper County, NE	1995	NA	1337	1304	33	2.5
CN3107500000000	31	075	Grant County, NE	1995	NA	388	381	7	1.8
CN3107700000000	31	077	Greeley County, NE	1995	NA	1563	1513	50	3.2
CN3107900000000	31	079	Hall County, NE	1995	NA	30704	30040	664	2.2
CN3108100000000	31	081	Hamilton County, NE	1995	NA	5250	5173	77	1.5
CN3108300000000	31	083	Harlan County, NE	1995	NA	1827	1793	34	1.9
CN3108500000000	31	085	Hayes County, NE	1995	NA	535	516	19	3.6
CN3108700000000	31	087	Hitchcock County, NE	1995	NA	1659	1611	48	2.9
CN3108900000000	31	089	Holt County, NE	1995	NA	6582	6405	177	2.7
CN3109100000000	31	091	Hooker County, NE	1995	NA	438	423	15	3.4
CN3109300000000	31	093	Howard County, NE	1995	NA	3432	3350	82	2.4
CN3109500000000	31	095	Jefferson County, NE	1995	NA	4247	4147	100	2.4
CN3109700000000	31	097	Johnson County, NE	1995	NA	2337	2265	72	3.1
CN3109900000000	31	099	Kearney County, NE	1995	NA	3519	3456	63	1.8
CN3110100000000	31	101	Keith County, NE	1995	NA	4551	4422	129	2.8
CN3110300000000	31	103	Keya Paha County, NE	1995	NA	517	493	24	4.6
CN3110500000000	31	105	Kimball County, NE	1995	NA	2146	2093	53	2.5
CN3110700000000	31	107	Knox County, NE	1995	NA	4679	4502	177	3.8
CN3110900000000	31	109	Lancaster County, NE	1995	NA	137009	133920	3089	2.3
CN3111100000000	31	111	Lincoln County, NE	1995	NA	18321	17556	765	4.2
CN3111300000000	31	113	Logan County, NE	1995	NA	454	443	11	2.4
CN3111500000000	31	115	Loup County, NE	1995	NA	474	464	10	2.1
CN3111700000000	31	117	McPherson County, NE	1995	NA	323	317	6	1.9
CN3111900000000	31	119	Madison County, NE	1995	NA	20034	19531	503	2.5
CN3112100000000	31	121	Merrick County, NE	1995	NA	4643	4557	86	1.9
CN3112300000000	31	123	Morrill County, NE	1995	NA	2787	2660	127	4.6
CN3112500000000	31	125	Nance County, NE	1995	NA	1948	1897	51	2.6
CN3112700000000	31	127	Nemaha County, NE	1995	NA	4008	3861	147	3.7
CN3112900000000	31	129	Nuckolls County, NE	1995	NA	2469	2404	65	2.6
CN3113100000000	31	131	Otoe County, NE	1995	NA	7746	7504	242	3.1
CN3113300000000	31	133	Pawnee County, NE	1995	NA	1500	1446	54	3.6
CN3113500000000	31	135	Perkins County, NE	1995	NA	1524	1486	38	2.5
CN3113700000000	31	137	Phelps County, NE	1995	NA	5398	5302	96	1.8
CN3113900000000	31	139	Pierce County, NE	1995	NA	4046	3952	94	2.3
CN3114100000000	31	141	Platte County, NE	1995	NA	17695	17265	430	2.4
CN3114300000000	31	143	Polk County, NE	1995	NA	2623	2570	53	2
CN3114500000000	31	145	Red Willow County, NE	1995	NA	6149	5980	169	2.7
CN3114700000000	31	147	Richardson County, NE	1995	NA	4730	4542	188	4
CN3114900000000	31	149	Rock County, NE	1995	NA	967	933	34	3.5
CN3115100000000	31	151	Saline County, NE	1995	NA	7196	7085	111	1.5
CN3115300000000	31	153	Sarpy County, NE	1995	NA	55873	54612	1261	2.3
CN3115500000000	31	155	Saunders County, NE	1995	NA	10725	10414	311	2.9
CN3115700000000	31	157	Scotts Bluff County, NE	1995	NA	18334	17475	859	4.7
CN3115900000000	31	159	Seward County, NE	1995	NA	9522	9309	213	2.2
CN3116100000000	31	161	Sheridan County, NE	1995	NA	3069	2990	79	2.6
CN3116300000000	31	163	Sherman County, NE	1995	NA	1660	1609	51	3.1
CN3116500000000	31	165	Sioux County, NE	1995	NA	828	812	16	1.9
CN3116700000000	31	167	Stanton County, NE	1995	NA	3384	3302	82	2.4
CN3116900000000	31	169	Thayer County, NE	1995	NA	3331	3262	69	2.1
CN3117100000000	31	171	Thomas County, NE	1995	NA	473	446	27	5.7
CN3117300000000	31	173	Thurston County, NE	1995	NA	2875	2684	191	6.6
CN3117500000000	31	175	Valley County, NE	1995	NA	2772	2714	58	2.1
CN3117700000000	31	177	Washington County, NE	1995	NA	10195	9981	214	2.1
CN3117900000000	31	179	Wayne County, NE	1995	NA	5952	5776	176	3
CN3118100000000	31	181	Webster County, NE	1995	NA	1851	1817	34	1.8
CN3118300000000	31	183	Wheeler County, NE	1995	NA	439	424	15	3.4
CN3118500000000	31	185	York County, NE	1995	NA	8793	8667	126	1.4
CN3200100000000	32	001	Churchill County, NV	1995	NA	8938	8302	636	7.1
CN3200300000000	32	003	Clark County, NV	1995	NA	552579	521786	30793	5.6
CN3200500000000	32	005	Douglas County, NV	1995	NA	17722	16638	1084	6.1
CN3200700000000	32	007	Elko County, NV	1995	NA	20923	19663	1260	6
CN3200900000000	32	009	Esmeralda County, NV	1995	NA	614	566	48	7.8
CN3201100000000	32	011	Eureka County, NV	1995	NA	788	717	71	9
CN3201300000000	32	013	Humboldt County, NV	1995	NA	8448	8070	378	4.5
CN3201500000000	32	015	Lander County, NV	1995	NA	3057	2770	287	9.4
CN3201700000000	32	017	Lincoln County, NV	1995	NA	1305	1145	160	12.3
CN3201900000000	32	019	Lyon County, NV	1995	NA	11516	10563	953	8.3
CN3202100000000	32	021	Mineral County, NV	1995	NA	2867	2647	220	7.7
CN3202300000000	32	023	Nye County, NV	1995	NA	12511	11943	568	4.5
CN3202700000000	32	027	Pershing County, NV	1995	NA	2171	2052	119	5.5
CN3202900000000	32	029	Storey County, NV	1995	NA	1541	1480	61	4
CN3203100000000	32	031	Washoe County, NV	1995	NA	172128	163706	8422	4.9
CN3203300000000	32	033	White Pine County, NV	1995	NA	4294	4012	282	6.6
CN3251000000000	32	510	Carson City, NV	1995	NA	22715	21132	1583	7
CN3300100000000	33	001	Belknap County, NH	1995	NA	27624	26602	1022	3.7
CN3300300000000	33	003	Carroll County, NH	1995	NA	19860	19130	730	3.7
CN3300500000000	33	005	Cheshire County, NH	1995	NA	38985	37647	1338	3.4
CN3300700000000	33	007	Coos County, NH	1995	NA	16839	15766	1073	6.4
CN3300900000000	33	009	Grafton County, NH	1995	NA	42167	40867	1300	3.1
CN3301100000000	33	011	Hillsborough County, NH	1995	NA	191641	183618	8023	4.2
CN3301300000000	33	013	Merrimack County, NH	1995	NA	71099	69125	1974	2.8
CN3301500000000	33	015	Rockingham County, NH	1995	NA	145382	138583	6799	4.7
CN3301700000000	33	017	Strafford County, NH	1995	NA	56828	54646	2182	3.8
CN3301900000000	33	019	Sullivan County, NH	1995	NA	20768	20170	598	2.9
CN3400100000000	34	001	Atlantic County, NJ	1995	NA	125536	114791	10745	8.6
CN3400300000000	34	003	Bergen County, NJ	1995	NA	437231	411953	25278	5.8
CN3400500000000	34	005	Burlington County, NJ	1995	NA	212984	202361	10623	5
CN3400700000000	34	007	Camden County, NJ	1995	NA	255240	238835	16405	6.4
CN3400900000000	34	009	Cape May County, NJ	1995	NA	46330	40718	5612	12.1
CN3401100000000	34	011	Cumberland County, NJ	1995	NA	65250	58850	6400	9.8
CN3401300000000	34	013	Essex County, NJ	1995	NA	375296	346456	28840	7.7
CN3401500000000	34	015	Gloucester County, NJ	1995	NA	126085	117836	8249	6.5
CN3401700000000	34	017	Hudson County, NJ	1995	NA	288194	261300	26894	9.3
CN3401900000000	34	019	Hunterdon County, NJ	1995	NA	63883	61848	2035	3.2
CN3402100000000	34	021	Mercer County, NJ	1995	NA	170960	161688	9272	5.4
CN3402300000000	34	023	Middlesex County, NJ	1995	NA	389026	367606	21420	5.5
CN3402500000000	34	025	Monmouth County, NJ	1995	NA	302673	286245	16428	5.4
CN3402700000000	34	027	Morris County, NJ	1995	NA	251428	240557	10871	4.3
CN3402900000000	34	029	Ocean County, NJ	1995	NA	204633	191940	12693	6.2
CN3403100000000	34	031	Passaic County, NJ	1995	NA	233137	213081	20056	8.6
CN3403300000000	34	033	Salem County, NJ	1995	NA	31552	29493	2059	6.5
CN3403500000000	34	035	Somerset County, NJ	1995	NA	153950	148134	5816	3.8
CN3403700000000	34	037	Sussex County, NJ	1995	NA	74442	70164	4278	5.7
CN3403900000000	34	039	Union County, NJ	1995	NA	263903	246636	17267	6.5
CN3404100000000	34	041	Warren County, NJ	1995	NA	49833	46985	2848	5.7
CN3500100000000	35	001	Bernalillo County, NM	1995	NA	282176	270318	11858	4.2
CN3500300000000	35	003	Catron County, NM	1995	NA	1199	1056	143	11.9
CN3500500000000	35	005	Chaves County, NM	1995	NA	25611	23452	2159	8.4
CN3500600000000	35	006	Cibola County, NM	1995	NA	10392	9325	1067	10.3
CN3500700000000	35	007	Colfax County, NM	1995	NA	6468	5953	515	8
CN3500900000000	35	009	Curry County, NM	1995	NA	19628	18558	1070	5.5
CN3501100000000	35	011	De Baca County, NM	1995	NA	892	863	29	3.3
CN3501300000000	35	013	Dona Ana County, NM	1995	NA	64596	58817	5779	8.9
CN3501500000000	35	015	Eddy County, NM	1995	NA	22953	21095	1858	8.1
CN3501700000000	35	017	Grant County, NM	1995	NA	12229	11308	921	7.5
CN3501900000000	35	019	Guadalupe County, NM	1995	NA	1899	1681	218	11.5
CN3502100000000	35	021	Harding County, NM	1995	NA	446	421	25	5.6
CN3502300000000	35	023	Hidalgo County, NM	1995	NA	2710	2567	143	5.3
CN3502500000000	35	025	Lea County, NM	1995	NA	24163	22794	1369	5.7
CN3502700000000	35	027	Lincoln County, NM	1995	NA	6933	6302	631	9.1
CN3502800000000	35	028	Los Alamos County, NM	1995	NA	10849	10623	226	2.1
CN3502900000000	35	029	Luna County, NM	1995	NA	10687	8052	2635	24.7
CN3503100000000	35	031	McKinley County, NM	1995	NA	25064	22886	2178	8.7
CN3503300000000	35	033	Mora County, NM	1995	NA	1733	1363	370	21.4
CN3503500000000	35	035	Otero County, NM	1995	NA	20670	19233	1437	7
CN3503700000000	35	037	Quay County, NM	1995	NA	4660	4380	280	6
CN3503900000000	35	039	Rio Arriba County, NM	1995	NA	17603	15414	2189	12.4
CN3504100000000	35	041	Roosevelt County, NM	1995	NA	7501	7084	417	5.6
CN3504300000000	35	043	Sandoval County, NM	1995	NA	38187	36496	1691	4.4
CN3504500000000	35	045	San Juan County, NM	1995	NA	47814	42779	5035	10.5
CN3504700000000	35	047	San Miguel County, NM	1995	NA	12461	11382	1079	8.7
CN3504900000000	35	049	Santa Fe County, NM	1995	NA	63606	60772	2834	4.5
CN3505100000000	35	051	Sierra County, NM	1995	NA	3713	3539	174	4.7
CN3505300000000	35	053	Socorro County, NM	1995	NA	6563	6020	543	8.3
CN3505500000000	35	055	Taos County, NM	1995	NA	13048	11017	2031	15.6
CN3505700000000	35	057	Torrance County, NM	1995	NA	5248	4874	374	7.1
CN3505900000000	35	059	Union County, NM	1995	NA	1917	1835	82	4.3
CN3506100000000	35	061	Valencia County, NM	1995	NA	25576	24387	1189	4.6
CN3600100000000	36	001	Albany County, NY	1995	NA	158199	151616	6583	4.2
CN3600300000000	36	003	Allegany County, NY	1995	NA	23092	21314	1778	7.7
CN3600500000000	36	005	Bronx County, NY	1995	NA	446818	403992	42826	9.6
CN3600700000000	36	007	Broome County, NY	1995	NA	98473	93242	5231	5.3
CN3600900000000	36	009	Cattaraugus County, NY	1995	NA	39575	36577	2998	7.6
CN3601100000000	36	011	Cayuga County, NY	1995	NA	37695	35341	2354	6.2
CN3601300000000	36	013	Chautauqua County, NY	1995	NA	67348	63386	3962	5.9
CN3601500000000	36	015	Chemung County, NY	1995	NA	43013	40947	2066	4.8
CN3601700000000	36	017	Chenango County, NY	1995	NA	24581	22780	1801	7.3
CN3601900000000	36	019	Clinton County, NY	1995	NA	40265	37541	2724	6.8
CN3602100000000	36	021	Columbia County, NY	1995	NA	32780	31407	1373	4.2
CN3602300000000	36	023	Cortland County, NY	1995	NA	23889	22233	1656	6.9
CN3602500000000	36	025	Delaware County, NY	1995	NA	21042	19889	1153	5.5
CN3602700000000	36	027	Dutchess County, NY	1995	NA	116064	110275	5789	5
CN3602900000000	36	029	Erie County, NY	1995	NA	466357	442040	24317	5.2
CN3603100000000	36	031	Essex County, NY	1995	NA	18044	16422	1622	9
CN3603300000000	36	033	Franklin County, NY	1995	NA	21414	19646	1768	8.3
CN3603500000000	36	035	Fulton County, NY	1995	NA	27443	25238	2205	8
CN3603700000000	36	037	Genesee County, NY	1995	NA	31890	30034	1856	5.8
CN3603900000000	36	039	Greene County, NY	1995	NA	21081	19510	1571	7.5
CN3604100000000	36	041	Hamilton County, NY	1995	NA	2508	2222	286	11.4
CN3604300000000	36	043	Herkimer County, NY	1995	NA	31301	29098	2203	7
CN3604500000000	36	045	Jefferson County, NY	1995	NA	43883	39935	3948	9
CN3604700000000	36	047	Kings County, NY	1995	NA	933276	847507	85769	9.2
CN3604900000000	36	049	Lewis County, NY	1995	NA	12576	11530	1046	8.3
CN3605100000000	36	051	Livingston County, NY	1995	NA	34026	32182	1844	5.4
CN3605300000000	36	053	Madison County, NY	1995	NA	35034	32997	2037	5.8
CN3605500000000	36	055	Monroe County, NY	1995	NA	381230	366186	15044	3.9
CN3605700000000	36	057	Montgomery County, NY	1995	NA	24126	22165	1961	8.1
CN3605900000000	36	059	Nassau County, NY	1995	NA	675786	645219	30567	4.5
CN3606100000000	36	061	New York County, NY	1995	NA	780687	726517	54170	6.9
CN3606300000000	36	063	Niagara County, NY	1995	NA	108331	101822	6509	6
CN3606500000000	36	065	Oneida County, NY	1995	NA	113289	107491	5798	5.1
CN3606700000000	36	067	Onondaga County, NY	1995	NA	234975	224231	10744	4.6
CN3606900000000	36	069	Ontario County, NY	1995	NA	52803	50172	2631	5
CN3607100000000	36	071	Orange County, NY	1995	NA	153086	145551	7535	4.9
CN3607300000000	36	073	Orleans County, NY	1995	NA	21250	19606	1644	7.7
CN3607500000000	36	075	Oswego County, NY	1995	NA	57328	52439	4889	8.5
CN3607700000000	36	077	Otsego County, NY	1995	NA	30865	29184	1681	5.4
CN3607900000000	36	079	Putnam County, NY	1995	NA	49046	47127	1919	3.9
CN3608100000000	36	081	Queens County, NY	1995	NA	946007	873978	72029	7.6
CN3608300000000	36	083	Rensselaer County, NY	1995	NA	80670	76308	4362	5.4
CN3608500000000	36	085	Richmond County, NY	1995	NA	184479	170734	13745	7.5
CN3608700000000	36	087	Rockland County, NY	1995	NA	140629	133737	6892	4.9
CN3608900000000	36	089	St. Lawrence County, NY	1995	NA	50794	46521	4273	8.4
CN3609100000000	36	091	Saratoga County, NY	1995	NA	101289	96527	4762	4.7
CN3609300000000	36	093	Schenectady County, NY	1995	NA	73895	70017	3878	5.2
CN3609500000000	36	095	Schoharie County, NY	1995	NA	15264	14324	940	6.2
CN3609700000000	36	097	Schuyler County, NY	1995	NA	8776	8246	530	6
CN3609900000000	36	099	Seneca County, NY	1995	NA	14935	14040	895	6
CN3610100000000	36	101	Steuben County, NY	1995	NA	47947	44723	3224	6.7
CN3610300000000	36	103	Suffolk County, NY	1995	NA	692879	655549	37330	5.4
CN3610500000000	36	105	Sullivan County, NY	1995	NA	32250	30211	2039	6.3
CN3610700000000	36	107	Tioga County, NY	1995	NA	25782	24325	1457	5.7
CN3610900000000	36	109	Tompkins County, NY	1995	NA	49078	47356	1722	3.5
CN3611100000000	36	111	Ulster County, NY	1995	NA	78450	74175	4275	5.4
CN3611300000000	36	113	Warren County, NY	1995	NA	32845	30516	2329	7.1
CN3611500000000	36	115	Washington County, NY	1995	NA	29826	28059	1767	5.9
CN3611700000000	36	117	Wayne County, NY	1995	NA	48621	45901	2720	5.6
CN3611900000000	36	119	Westchester County, NY	1995	NA	438004	418645	19359	4.4
CN3612100000000	36	121	Wyoming County, NY	1995	NA	21289	19848	1441	6.8
CN3612300000000	36	123	Yates County, NY	1995	NA	12947	12339	608	4.7
CN3700100000000	37	001	Alamance County, NC	1995	NA	64539	62176	2363	3.7
CN3700300000000	37	003	Alexander County, NC	1995	NA	17114	16520	594	3.5
CN3700500000000	37	005	Alleghany County, NC	1995	NA	5321	5002	319	6
CN3700700000000	37	007	Anson County, NC	1995	NA	11545	10481	1064	9.2
CN3700900000000	37	009	Ashe County, NC	1995	NA	11841	10911	930	7.9
CN3701100000000	37	011	Avery County, NC	1995	NA	7524	7066	458	6.1
CN3701300000000	37	013	Beaufort County, NC	1995	NA	20021	18371	1650	8.2
CN3701500000000	37	015	Bertie County, NC	1995	NA	9432	8791	641	6.8
CN3701700000000	37	017	Bladen County, NC	1995	NA	17795	16598	1197	6.7
CN3701900000000	37	019	Brunswick County, NC	1995	NA	29419	26885	2534	8.6
CN3702100000000	37	021	Buncombe County, NC	1995	NA	99368	95743	3625	3.6
CN3702300000000	37	023	Burke County, NC	1995	NA	44203	42169	2034	4.6
CN3702500000000	37	025	Cabarrus County, NC	1995	NA	60836	58745	2091	3.4
CN3702700000000	37	027	Caldwell County, NC	1995	NA	41526	39956	1570	3.8
CN3702900000000	37	029	Camden County, NC	1995	NA	3042	2909	133	4.4
CN3703100000000	37	031	Carteret County, NC	1995	NA	28318	26709	1609	5.7
CN3703300000000	37	033	Caswell County, NC	1995	NA	11783	11357	426	3.6
CN3703500000000	37	035	Catawba County, NC	1995	NA	75241	72063	3178	4.2
CN3703700000000	37	037	Chatham County, NC	1995	NA	24117	23466	651	2.7
CN3703900000000	37	039	Cherokee County, NC	1995	NA	9845	9228	617	6.3
CN3704100000000	37	041	Chowan County, NC	1995	NA	6760	6338	422	6.2
CN3704300000000	37	043	Clay County, NC	1995	NA	3565	3389	176	4.9
CN3704500000000	37	045	Cleveland County, NC	1995	NA	46884	44444	2440	5.2
CN3704700000000	37	047	Columbus County, NC	1995	NA	25822	24079	1743	6.8
CN3704900000000	37	049	Craven County, NC	1995	NA	35185	33344	1841	5.2
CN3705100000000	37	051	Cumberland County, NC	1995	NA	113077	107043	6034	5.3
CN3705300000000	37	053	Currituck County, NC	1995	NA	7966	7690	276	3.5
CN3705500000000	37	055	Dare County, NC	1995	NA	15999	15067	932	5.8
CN3705700000000	37	057	Davidson County, NC	1995	NA	76632	74188	2444	3.2
CN3705900000000	37	059	Davie County, NC	1995	NA	16426	15833	593	3.6
CN3706100000000	37	061	Duplin County, NC	1995	NA	22461	21227	1234	5.5
CN3706300000000	37	063	Durham County, NC	1995	NA	108662	105445	3217	3
CN3706500000000	37	065	Edgecombe County, NC	1995	NA	27524	25296	2228	8.1
CN3706700000000	37	067	Forsyth County, NC	1995	NA	151542	146603	4939	3.3
CN3706900000000	37	069	Franklin County, NC	1995	NA	21220	20329	891	4.2
CN3707100000000	37	071	Gaston County, NC	1995	NA	98403	94350	4053	4.1
CN3707300000000	37	073	Gates County, NC	1995	NA	4568	4417	151	3.3
CN3707500000000	37	075	Graham County, NC	1995	NA	4437	3813	624	14.1
CN3707700000000	37	077	Granville County, NC	1995	NA	21675	20751	924	4.3
CN3707900000000	37	079	Greene County, NC	1995	NA	8370	8005	365	4.4
CN3708100000000	37	081	Guilford County, NC	1995	NA	213738	206666	7072	3.3
CN3708300000000	37	083	Halifax County, NC	1995	NA	24100	21943	2157	9
CN3708500000000	37	085	Harnett County, NC	1995	NA	34548	33273	1275	3.7
CN3708700000000	37	087	Haywood County, NC	1995	NA	23871	22540	1331	5.6
CN3708900000000	37	089	Henderson County, NC	1995	NA	35926	34780	1146	3.2
CN3709100000000	37	091	Hertford County, NC	1995	NA	10003	9437	566	5.7
CN3709300000000	37	093	Hoke County, NC	1995	NA	10854	10136	718	6.6
CN3709500000000	37	095	Hyde County, NC	1995	NA	2892	2604	288	10
CN3709700000000	37	097	Iredell County, NC	1995	NA	57924	56009	1915	3.3
CN3709900000000	37	099	Jackson County, NC	1995	NA	14932	14096	836	5.6
CN3710100000000	37	101	Johnston County, NC	1995	NA	50833	49384	1449	2.9
CN3710300000000	37	103	Jones County, NC	1995	NA	4543	4293	250	5.5
CN3710500000000	37	105	Lee County, NC	1995	NA	25988	24777	1211	4.7
CN3710700000000	37	107	Lenoir County, NC	1995	NA	29549	27694	1855	6.3
CN3710900000000	37	109	Lincoln County, NC	1995	NA	30937	29479	1458	4.7
CN3711100000000	37	111	McDowell County, NC	1995	NA	20589	19400	1189	5.8
CN3711300000000	37	113	Macon County, NC	1995	NA	12683	12182	501	4
CN3711500000000	37	115	Madison County, NC	1995	NA	8659	8302	357	4.1
CN3711700000000	37	117	Martin County, NC	1995	NA	12992	12170	822	6.3
CN3711900000000	37	119	Mecklenburg County, NC	1995	NA	335487	325339	10148	3
CN3712100000000	37	121	Mitchell County, NC	1995	NA	7057	6529	528	7.5
CN3712300000000	37	123	Montgomery County, NC	1995	NA	11893	11096	797	6.7
CN3712500000000	37	125	Moore County, NC	1995	NA	28547	27458	1089	3.8
CN3712700000000	37	127	Nash County, NC	1995	NA	44476	42154	2322	5.2
CN3712900000000	37	129	New Hanover County, NC	1995	NA	75083	70853	4230	5.6
CN3713100000000	37	131	Northampton County, NC	1995	NA	8511	7881	630	7.4
CN3713300000000	37	133	Onslow County, NC	1995	NA	43645	41924	1721	3.9
CN3713500000000	37	135	Orange County, NC	1995	NA	60131	58985	1146	1.9
CN3713700000000	37	137	Pamlico County, NC	1995	NA	5440	5111	329	6
CN3713900000000	37	139	Pasquotank County, NC	1995	NA	14524	13816	708	4.9
CN3714100000000	37	141	Pender County, NC	1995	NA	14978	14102	876	5.8
CN3714300000000	37	143	Perquimans County, NC	1995	NA	4617	4384	233	5
CN3714500000000	37	145	Person County, NC	1995	NA	17204	16291	913	5.3
CN3714700000000	37	147	Pitt County, NC	1995	NA	63823	60794	3029	4.7
CN3714900000000	37	149	Polk County, NC	1995	NA	7608	7406	202	2.7
CN3715100000000	37	151	Randolph County, NC	1995	NA	67169	65260	1909	2.8
CN3715300000000	37	153	Richmond County, NC	1995	NA	21200	19185	2015	9.5
CN3715500000000	37	155	Robeson County, NC	1995	NA	55110	50376	4734	8.6
CN3715700000000	37	157	Rockingham County, NC	1995	NA	47625	45447	2178	4.6
CN3715900000000	37	159	Rowan County, NC	1995	NA	62466	60204	2262	3.6
CN3716100000000	37	161	Rutherford County, NC	1995	NA	30986	29206	1780	5.7
CN3716300000000	37	163	Sampson County, NC	1995	NA	23859	22493	1366	5.7
CN3716500000000	37	165	Scotland County, NC	1995	NA	17660	16418	1242	7
CN3716700000000	37	167	Stanly County, NC	1995	NA	27063	25488	1575	5.8
CN3716900000000	37	169	Stokes County, NC	1995	NA	22014	21399	615	2.8
CN3717100000000	37	171	Surry County, NC	1995	NA	36440	34679	1761	4.8
CN3717300000000	37	173	Swain County, NC	1995	NA	5963	4969	994	16.7
CN3717500000000	37	175	Transylvania County, NC	1995	NA	11118	10661	457	4.1
CN3717700000000	37	177	Tyrrell County, NC	1995	NA	1833	1647	186	10.1
CN3717900000000	37	179	Union County, NC	1995	NA	53830	52416	1414	2.6
CN3718100000000	37	181	Vance County, NC	1995	NA	19530	17912	1618	8.3
CN3718300000000	37	183	Wake County, NC	1995	NA	302960	295892	7068	2.3
CN3718500000000	37	185	Warren County, NC	1995	NA	7230	6617	613	8.5
CN3718700000000	37	187	Washington County, NC	1995	NA	6255	5607	648	10.4
CN3718900000000	37	189	Watauga County, NC	1995	NA	22635	21900	735	3.2
CN3719100000000	37	191	Wayne County, NC	1995	NA	48775	46312	2463	5
CN3719300000000	37	193	Wilkes County, NC	1995	NA	33076	31516	1560	4.7
CN3719500000000	37	195	Wilson County, NC	1995	NA	36194	33030	3164	8.7
CN3719700000000	37	197	Yadkin County, NC	1995	NA	17712	17021	691	3.9
CN3719900000000	37	199	Yancey County, NC	1995	NA	6251	5886	365	5.8
CN3800100000000	38	001	Adams County, ND	1995	NA	1492	1468	24	1.6
CN3800300000000	38	003	Barnes County, ND	1995	NA	5918	5771	147	2.5
CN3800500000000	38	005	Benson County, ND	1995	NA	2805	2518	287	10.2
CN3800700000000	38	007	Billings County, ND	1995	NA	588	572	16	2.7
CN3800900000000	38	009	Bottineau County, ND	1995	NA	3405	3315	90	2.6
CN3801100000000	38	011	Bowman County, ND	1995	NA	1836	1799	37	2
CN3801300000000	38	013	Burke County, ND	1995	NA	1082	1052	30	2.8
CN3801500000000	38	015	Burleigh County, ND	1995	NA	38355	37207	1148	3
CN3801700000000	38	017	Cass County, ND	1995	NA	67129	65820	1309	1.9
CN3801900000000	38	019	Cavalier County, ND	1995	NA	2574	2476	98	3.8
CN3802100000000	38	021	Dickey County, ND	1995	NA	2918	2855	63	2.2
CN3802300000000	38	023	Divide County, ND	1995	NA	1221	1202	19	1.6
CN3802500000000	38	025	Dunn County, ND	1995	NA	2028	1980	48	2.4
CN3802700000000	38	027	Eddy County, ND	1995	NA	1286	1211	75	5.8
CN3802900000000	38	029	Emmons County, ND	1995	NA	2156	2087	69	3.2
CN3803100000000	38	031	Foster County, ND	1995	NA	2168	2109	59	2.7
CN3803300000000	38	033	Golden Valley County, ND	1995	NA	949	921	28	3
CN3803500000000	38	035	Grand Forks County, ND	1995	NA	37564	36606	958	2.6
CN3803700000000	38	037	Grant County, ND	1995	NA	1662	1615	47	2.8
CN3803900000000	38	039	Griggs County, ND	1995	NA	1843	1810	33	1.8
CN3804100000000	38	041	Hettinger County, ND	1995	NA	1451	1408	43	3
CN3804300000000	38	043	Kidder County, ND	1995	NA	1536	1464	72	4.7
CN3804500000000	38	045	LaMoure County, ND	1995	NA	2363	2302	61	2.6
CN3804700000000	38	047	Logan County, ND	1995	NA	1253	1231	22	1.8
CN3804900000000	38	049	McHenry County, ND	1995	NA	2858	2747	111	3.9
CN3805100000000	38	051	McIntosh County, ND	1995	NA	1807	1771	36	2
CN3805300000000	38	053	McKenzie County, ND	1995	NA	3267	3178	89	2.7
CN3805500000000	38	055	McLean County, ND	1995	NA	4635	4430	205	4.4
CN3805700000000	38	057	Mercer County, ND	1995	NA	5220	4858	362	6.9
CN3805900000000	38	059	Morton County, ND	1995	NA	13452	12913	539	4
CN3806100000000	38	061	Mountrail County, ND	1995	NA	3172	2881	291	9.2
CN3806300000000	38	063	Nelson County, ND	1995	NA	1756	1693	63	3.6
CN3806500000000	38	065	Oliver County, ND	1995	NA	1180	1146	34	2.9
CN3806700000000	38	067	Pembina County, ND	1995	NA	5175	4875	300	5.8
CN3806900000000	38	069	Pierce County, ND	1995	NA	2410	2359	51	2.1
CN3807100000000	38	071	Ramsey County, ND	1995	NA	6603	6394	209	3.2
CN3807300000000	38	073	Ransom County, ND	1995	NA	2813	2760	53	1.9
CN3807500000000	38	075	Renville County, ND	1995	NA	1389	1362	27	1.9
CN3807700000000	38	077	Richland County, ND	1995	NA	9183	8898	285	3.1
CN3807900000000	38	079	Rolette County, ND	1995	NA	5805	5114	691	11.9
CN3808100000000	38	081	Sargent County, ND	1995	NA	2412	2356	56	2.3
CN3808300000000	38	083	Sheridan County, ND	1995	NA	751	733	18	2.4
CN3808500000000	38	085	Sioux County, ND	1995	NA	1646	1540	106	6.4
CN3808700000000	38	087	Slope County, ND	1995	NA	428	416	12	2.8
CN3808900000000	38	089	Stark County, ND	1995	NA	12384	11984	400	3.2
CN3809100000000	38	091	Steele County, ND	1995	NA	1129	1108	21	1.9
CN3809300000000	38	093	Stutsman County, ND	1995	NA	11355	11008	347	3.1
CN3809500000000	38	095	Towner County, ND	1995	NA	1553	1513	40	2.6
CN3809700000000	38	097	Traill County, ND	1995	NA	4028	3892	136	3.4
CN3809900000000	38	099	Walsh County, ND	1995	NA	6530	6205	325	5
CN3810100000000	38	101	Ward County, ND	1995	NA	28977	28070	907	3.1
CN3810300000000	38	103	Wells County, ND	1995	NA	2544	2439	105	4.1
CN3810500000000	38	105	Williams County, ND	1995	NA	10259	9909	350	3.4
CN3900100000000	39	001	Adams County, OH	1995	NA	11410	9957	1453	12.7
CN3900300000000	39	003	Allen County, OH	1995	NA	51156	48065	3091	6
CN3900500000000	39	005	Ashland County, OH	1995	NA	26017	24761	1256	4.8
CN3900700000000	39	007	Ashtabula County, OH	1995	NA	45561	42337	3224	7.1
CN3900900000000	39	009	Athens County, OH	1995	NA	25444	23995	1449	5.7
CN3901100000000	39	011	Auglaize County, OH	1995	NA	24018	22749	1269	5.3
CN3901300000000	39	013	Belmont County, OH	1995	NA	30867	28699	2168	7
CN3901500000000	39	015	Brown County, OH	1995	NA	18116	17016	1100	6.1
CN3901700000000	39	017	Butler County, OH	1995	NA	165393	158493	6900	4.2
CN3901900000000	39	019	Carroll County, OH	1995	NA	12807	12159	648	5.1
CN3902100000000	39	021	Champaign County, OH	1995	NA	18567	17680	887	4.8
CN3902300000000	39	023	Clark County, OH	1995	NA	69893	66692	3201	4.6
CN3902500000000	39	025	Clermont County, OH	1995	NA	86703	82838	3865	4.5
CN3902700000000	39	027	Clinton County, OH	1995	NA	22686	21642	1044	4.6
CN3902900000000	39	029	Columbiana County, OH	1995	NA	51570	48636	2934	5.7
CN3903100000000	39	031	Coshocton County, OH	1995	NA	16773	15787	986	5.9
CN3903300000000	39	033	Crawford County, OH	1995	NA	22452	21002	1450	6.5
CN3903500000000	39	035	Cuyahoga County, OH	1995	NA	678774	649052	29722	4.4
CN3903700000000	39	037	Darke County, OH	1995	NA	29164	27869	1295	4.4
CN3903900000000	39	039	Defiance County, OH	1995	NA	21056	20066	990	4.7
CN3904100000000	39	041	Delaware County, OH	1995	NA	43370	42028	1342	3.1
CN3904300000000	39	043	Erie County, OH	1995	NA	42867	40657	2210	5.2
CN3904500000000	39	045	Fairfield County, OH	1995	NA	60259	57924	2335	3.9
CN3904700000000	39	047	Fayette County, OH	1995	NA	14406	13589	817	5.7
CN3904900000000	39	049	Franklin County, OH	1995	NA	564979	547576	17403	3.1
CN3905100000000	39	051	Fulton County, OH	1995	NA	22085	20858	1227	5.6
CN3905300000000	39	053	Gallia County, OH	1995	NA	13823	12575	1248	9
CN3905500000000	39	055	Geauga County, OH	1995	NA	44408	42929	1479	3.3
CN3905700000000	39	057	Greene County, OH	1995	NA	69008	66353	2655	3.8
CN3905900000000	39	059	Guernsey County, OH	1995	NA	18296	16797	1499	8.2
CN3906100000000	39	061	Hamilton County, OH	1995	NA	431475	413203	18272	4.2
CN3906300000000	39	063	Hancock County, OH	1995	NA	39833	38361	1472	3.7
CN3906500000000	39	065	Hardin County, OH	1995	NA	15070	14311	759	5
CN3906700000000	39	067	Harrison County, OH	1995	NA	7017	6440	577	8.2
CN3906900000000	39	069	Henry County, OH	1995	NA	16089	15171	918	5.7
CN3907100000000	39	071	Highland County, OH	1995	NA	17539	16446	1093	6.2
CN3907300000000	39	073	Hocking County, OH	1995	NA	12083	11142	941	7.8
CN3907500000000	39	075	Holmes County, OH	1995	NA	17915	17325	590	3.3
CN3907700000000	39	077	Huron County, OH	1995	NA	29859	27241	2618	8.8
CN3907900000000	39	079	Jackson County, OH	1995	NA	13950	12932	1018	7.3
CN3908100000000	39	081	Jefferson County, OH	1995	NA	31055	28750	2305	7.4
CN3908300000000	39	083	Knox County, OH	1995	NA	26945	25638	1307	4.9
CN3908500000000	39	085	Lake County, OH	1995	NA	121326	116532	4794	4
CN3908700000000	39	087	Lawrence County, OH	1995	NA	25820	24081	1739	6.7
CN3908900000000	39	089	Licking County, OH	1995	NA	69486	66703	2783	4
CN3909100000000	39	091	Logan County, OH	1995	NA	24093	23075	1018	4.2
CN3909300000000	39	093	Lorain County, OH	1995	NA	138605	130761	7844	5.7
CN3909500000000	39	095	Lucas County, OH	1995	NA	225062	213130	11932	5.3
CN3909700000000	39	097	Madison County, OH	1995	NA	19787	19166	621	3.1
CN3909900000000	39	099	Mahoning County, OH	1995	NA	120037	111994	8043	6.7
CN3910100000000	39	101	Marion County, OH	1995	NA	32827	30798	2029	6.2
CN3910300000000	39	103	Medina County, OH	1995	NA	72222	69514	2708	3.7
CN3910500000000	39	105	Meigs County, OH	1995	NA	8728	7712	1016	11.6
CN3910700000000	39	107	Mercer County, OH	1995	NA	20939	18991	1948	9.3
CN3910900000000	39	109	Miami County, OH	1995	NA	49817	47917	1900	3.8
CN3911100000000	39	111	Monroe County, OH	1995	NA	6110	5499	611	10
CN3911300000000	39	113	Montgomery County, OH	1995	NA	282193	270372	11821	4.2
CN3911500000000	39	115	Morgan County, OH	1995	NA	5131	4430	701	13.7
CN3911700000000	39	117	Morrow County, OH	1995	NA	13540	12714	826	6.1
CN3911900000000	39	119	Muskingum County, OH	1995	NA	42416	39222	3194	7.5
CN3912100000000	39	121	Noble County, OH	1995	NA	5203	4768	435	8.4
CN3912300000000	39	123	Ottawa County, OH	1995	NA	19969	18568	1401	7
CN3912500000000	39	125	Paulding County, OH	1995	NA	9826	9395	431	4.4
CN3912700000000	39	127	Perry County, OH	1995	NA	14783	13474	1309	8.9
CN3912900000000	39	129	Pickaway County, OH	1995	NA	23450	22577	873	3.7
CN3913100000000	39	131	Pike County, OH	1995	NA	11016	10009	1007	9.1
CN3913300000000	39	133	Portage County, OH	1995	NA	80951	77446	3505	4.3
CN3913500000000	39	135	Preble County, OH	1995	NA	21342	20437	905	4.2
CN3913700000000	39	137	Putnam County, OH	1995	NA	19645	18742	903	4.6
CN3913900000000	39	139	Richland County, OH	1995	NA	62164	58215	3949	6.4
CN3914100000000	39	141	Ross County, OH	1995	NA	33369	31363	2006	6
CN3914300000000	39	143	Sandusky County, OH	1995	NA	31692	29902	1790	5.6
CN3914500000000	39	145	Scioto County, OH	1995	NA	32500	29213	3287	10.1
CN3914700000000	39	147	Seneca County, OH	1995	NA	29392	27620	1772	6
CN3914900000000	39	149	Shelby County, OH	1995	NA	27103	25851	1252	4.6
CN3915100000000	39	151	Stark County, OH	1995	NA	185602	176038	9564	5.2
CN3915300000000	39	153	Summit County, OH	1995	NA	275115	262112	13003	4.7
CN3915500000000	39	155	Trumbull County, OH	1995	NA	112863	105214	7649	6.8
CN3915700000000	39	157	Tuscarawas County, OH	1995	NA	44443	41926	2517	5.7
CN3915900000000	39	159	Union County, OH	1995	NA	16062	15435	627	3.9
CN3916100000000	39	161	Van Wert County, OH	1995	NA	16597	15848	749	4.5
CN3916300000000	39	163	Vinton County, OH	1995	NA	3924	3478	446	11.4
CN3916500000000	39	165	Warren County, OH	1995	NA	67278	64609	2669	4
CN3916700000000	39	167	Washington County, OH	1995	NA	31861	29800	2061	6.5
CN3916900000000	39	169	Wayne County, OH	1995	NA	56650	54574	2076	3.7
CN3917100000000	39	171	Williams County, OH	1995	NA	21987	21152	835	3.8
CN3917300000000	39	173	Wood County, OH	1995	NA	63434	60864	2570	4.1
CN3917500000000	39	175	Wyandot County, OH	1995	NA	11997	11378	619	5.2
CN4000100000000	40	001	Adair County, OK	1995	NA	9956	9454	502	5
CN4000300000000	40	003	Alfalfa County, OK	1995	NA	2619	2579	40	1.5
CN4000500000000	40	005	Atoka County, OK	1995	NA	4946	4692	254	5.1
CN4000700000000	40	007	Beaver County, OK	1995	NA	2993	2908	85	2.8
CN4000900000000	40	009	Beckham County, OK	1995	NA	9560	9079	481	5
CN4001100000000	40	011	Blaine County, OK	1995	NA	4876	4715	161	3.3
CN4001300000000	40	013	Bryan County, OK	1995	NA	13844	13284	560	4
CN4001500000000	40	015	Caddo County, OK	1995	NA	11842	11225	617	5.2
CN4001700000000	40	017	Canadian County, OK	1995	NA	41765	40690	1075	2.6
CN4001900000000	40	019	Carter County, OK	1995	NA	20914	19539	1375	6.6
CN4002100000000	40	021	Cherokee County, OK	1995	NA	16482	15614	868	5.3
CN4002300000000	40	023	Choctaw County, OK	1995	NA	5584	4980	604	10.8
CN4002500000000	40	025	Cimarron County, OK	1995	NA	1724	1682	42	2.4
CN4002700000000	40	027	Cleveland County, OK	1995	NA	100998	98173	2825	2.8
CN4002900000000	40	029	Coal County, OK	1995	NA	2722	2475	247	9.1
CN4003100000000	40	031	Comanche County, OK	1995	NA	40848	38686	2162	5.3
CN4003300000000	40	033	Cotton County, OK	1995	NA	2352	2241	111	4.7
CN4003500000000	40	035	Craig County, OK	1995	NA	6449	6253	196	3
CN4003700000000	40	037	Creek County, OK	1995	NA	30523	29075	1448	4.7
CN4003900000000	40	039	Custer County, OK	1995	NA	13265	12785	480	3.6
CN4004100000000	40	041	Delaware County, OK	1995	NA	15720	15108	612	3.9
CN4004300000000	40	043	Dewey County, OK	1995	NA	2273	2177	96	4.2
CN4004500000000	40	045	Ellis County, OK	1995	NA	1847	1776	71	3.8
CN4004700000000	40	047	Garfield County, OK	1995	NA	27138	26130	1008	3.7
CN4004900000000	40	049	Garvin County, OK	1995	NA	11030	10459	571	5.2
CN4005100000000	40	051	Grady County, OK	1995	NA	20445	19395	1050	5.1
CN4005300000000	40	053	Grant County, OK	1995	NA	2537	2467	70	2.8
CN4005500000000	40	055	Greer County, OK	1995	NA	2432	2348	84	3.5
CN4005700000000	40	057	Harmon County, OK	1995	NA	1361	1314	47	3.5
CN4005900000000	40	059	Harper County, OK	1995	NA	1922	1860	62	3.2
CN4006100000000	40	061	Haskell County, OK	1995	NA	4181	3676	505	12.1
CN4006300000000	40	063	Hughes County, OK	1995	NA	5452	4965	487	8.9
CN4006500000000	40	065	Jackson County, OK	1995	NA	11282	10676	606	5.4
CN4006700000000	40	067	Jefferson County, OK	1995	NA	3310	3146	164	5
CN4006900000000	40	069	Johnston County, OK	1995	NA	4835	4607	228	4.7
CN4007100000000	40	071	Kay County, OK	1995	NA	23022	21370	1652	7.2
CN4007300000000	40	073	Kingfisher County, OK	1995	NA	7039	6831	208	3
CN4007500000000	40	075	Kiowa County, OK	1995	NA	4764	4615	149	3.1
CN4007700000000	40	077	Latimer County, OK	1995	NA	4346	3879	467	10.7
CN4007900000000	40	079	Le Flore County, OK	1995	NA	19693	18264	1429	7.3
CN4008100000000	40	081	Lincoln County, OK	1995	NA	14820	14204	616	4.2
CN4008300000000	40	083	Logan County, OK	1995	NA	14060	13599	461	3.3
CN4008500000000	40	085	Love County, OK	1995	NA	3899	3652	247	6.3
CN4008700000000	40	087	McClain County, OK	1995	NA	12044	11619	425	3.5
CN4008900000000	40	089	McCurtain County, OK	1995	NA	14954	13583	1371	9.2
CN4009100000000	40	091	McIntosh County, OK	1995	NA	7124	6507	617	8.7
CN4009300000000	40	093	Major County, OK	1995	NA	3939	3824	115	2.9
CN4009500000000	40	095	Marshall County, OK	1995	NA	5197	4916	281	5.4
CN4009700000000	40	097	Mayes County, OK	1995	NA	15371	14576	795	5.2
CN4009900000000	40	099	Murray County, OK	1995	NA	5680	5304	376	6.6
CN4010100000000	40	101	Muskogee County, OK	1995	NA	29087	27140	1947	6.7
CN4010300000000	40	103	Noble County, OK	1995	NA	5622	5419	203	3.6
CN4010500000000	40	105	Nowata County, OK	1995	NA	3801	3561	240	6.3
CN4010700000000	40	107	Okfuskee County, OK	1995	NA	4303	4027	276	6.4
CN4010900000000	40	109	Oklahoma County, OK	1995	NA	312365	300212	12153	3.9
CN4011100000000	40	111	Okmulgee County, OK	1995	NA	14939	13379	1560	10.4
CN4011300000000	40	113	Osage County, OK	1995	NA	18986	18269	717	3.8
CN4011500000000	40	115	Ottawa County, OK	1995	NA	13399	12579	820	6.1
CN4011700000000	40	117	Pawnee County, OK	1995	NA	6594	6086	508	7.7
CN4011900000000	40	119	Payne County, OK	1995	NA	34571	33817	754	2.2
CN4012100000000	40	121	Pittsburg County, OK	1995	NA	17660	16164	1496	8.5
CN4012300000000	40	123	Pontotoc County, OK	1995	NA	16358	15288	1070	6.5
CN4012500000000	40	125	Pottawatomie County, OK	1995	NA	26774	25593	1181	4.4
CN4012700000000	40	127	Pushmataha County, OK	1995	NA	5012	4622	390	7.8
CN4012900000000	40	129	Roger Mills County, OK	1995	NA	1980	1922	58	2.9
CN4013100000000	40	131	Rogers County, OK	1995	NA	31053	29675	1378	4.4
CN4013300000000	40	133	Seminole County, OK	1995	NA	10526	9656	870	8.3
CN4013500000000	40	135	Sequoyah County, OK	1995	NA	16395	15237	1158	7.1
CN4013700000000	40	137	Stephens County, OK	1995	NA	17684	16405	1279	7.2
CN4013900000000	40	139	Texas County, OK	1995	NA	9544	9286	258	2.7
CN4014100000000	40	141	Tillman County, OK	1995	NA	4053	3833	220	5.4
CN4014300000000	40	143	Tulsa County, OK	1995	NA	274852	263907	10945	4
CN4014500000000	40	145	Wagoner County, OK	1995	NA	25835	24845	990	3.8
CN4014700000000	40	147	Washington County, OK	1995	NA	19814	18714	1100	5.6
CN4014900000000	40	149	Washita County, OK	1995	NA	5264	5092	172	3.3
CN4015100000000	40	151	Woods County, OK	1995	NA	4264	4175	89	2.1
CN4015300000000	40	153	Woodward County, OK	1995	NA	9024	8591	433	4.8
CN4100100000000	41	001	Baker County, OR	1995	NA	7499	6891	608	8.1
CN4100300000000	41	003	Benton County, OR	1995	NA	41648	40721	927	2.2
CN4100500000000	41	005	Clackamas County, OR	1995	NA	180830	174970	5860	3.2
CN4100700000000	41	007	Clatsop County, OR	1995	NA	17449	16562	887	5.1
CN4100900000000	41	009	Columbia County, OR	1995	NA	20900	19887	1013	4.8
CN4101100000000	41	011	Coos County, OR	1995	NA	27805	25734	2071	7.4
CN4101300000000	41	013	Crook County, OR	1995	NA	7877	7255	622	7.9
CN4101500000000	41	015	Curry County, OR	1995	NA	8303	7673	630	7.6
CN4101700000000	41	017	Deschutes County, OR	1995	NA	51034	47657	3377	6.6
CN4101900000000	41	019	Douglas County, OR	1995	NA	43811	40256	3555	8.1
CN4102100000000	41	021	Gilliam County, OR	1995	NA	1111	1075	36	3.2
CN4102300000000	41	023	Grant County, OR	1995	NA	4236	3797	439	10.4
CN4102500000000	41	025	Harney County, OR	1995	NA	3586	3181	405	11.3
CN4102700000000	41	027	Hood River County, OR	1995	NA	10413	9537	876	8.4
CN4102900000000	41	029	Jackson County, OR	1995	NA	83533	77996	5537	6.6
CN4103100000000	41	031	Jefferson County, OR	1995	NA	8045	7552	493	6.1
CN4103300000000	41	033	Josephine County, OR	1995	NA	28474	26067	2407	8.5
CN4103500000000	41	035	Klamath County, OR	1995	NA	28720	26579	2141	7.5
CN4103700000000	41	037	Lake County, OR	1995	NA	3752	3428	324	8.6
CN4103900000000	41	039	Lane County, OR	1995	NA	157392	149060	8332	5.3
CN4104100000000	41	041	Lincoln County, OR	1995	NA	21295	19783	1512	7.1
CN4104300000000	41	043	Linn County, OR	1995	NA	49818	46760	3058	6.1
CN4104500000000	41	045	Malheur County, OR	1995	NA	14503	13540	963	6.6
CN4104700000000	41	047	Marion County, OR	1995	NA	132256	125881	6375	4.8
CN4104900000000	41	049	Morrow County, OR	1995	NA	3881	3592	289	7.4
CN4105100000000	41	051	Multnomah County, OR	1995	NA	353176	338366	14810	4.2
CN4105300000000	41	053	Polk County, OR	1995	NA	28330	27206	1124	4
CN4105500000000	41	055	Sherman County, OR	1995	NA	905	840	65	7.2
CN4105700000000	41	057	Tillamook County, OR	1995	NA	11035	10480	555	5
CN4105900000000	41	059	Umatilla County, OR	1995	NA	32927	30624	2303	7
CN4106100000000	41	061	Union County, OR	1995	NA	12457	11665	792	6.4
CN4106300000000	41	063	Wallowa County, OR	1995	NA	3463	3092	371	10.7
CN4106500000000	41	065	Wasco County, OR	1995	NA	11455	10646	809	7.1
CN4106700000000	41	067	Washington County, OR	1995	NA	222028	215116	6912	3.1
CN4106900000000	41	069	Wheeler County, OR	1995	NA	556	516	40	7.2
CN4107100000000	41	071	Yamhill County, OR	1995	NA	38189	36678	1511	4
CN4200100000000	42	001	Adams County, PA	1995	NA	43255	41409	1846	4.3
CN4200300000000	42	003	Allegheny County, PA	1995	NA	652917	618593	34324	5.3
CN4200500000000	42	005	Armstrong County, PA	1995	NA	32370	29316	3054	9.4
CN4200700000000	42	007	Beaver County, PA	1995	NA	85164	80040	5124	6
CN4200900000000	42	009	Bedford County, PA	1995	NA	24503	22509	1994	8.1
CN4201100000000	42	011	Berks County, PA	1995	NA	179480	170968	8512	4.7
CN4201300000000	42	013	Blair County, PA	1995	NA	62254	58300	3954	6.4
CN4201500000000	42	015	Bradford County, PA	1995	NA	28645	26942	1703	5.9
CN4201700000000	42	017	Bucks County, PA	1995	NA	309080	293466	15614	5.1
CN4201900000000	42	019	Butler County, PA	1995	NA	82796	78231	4565	5.5
CN4202100000000	42	021	Cambria County, PA	1995	NA	69497	63769	5728	8.2
CN4202300000000	42	023	Cameron County, PA	1995	NA	2614	2444	170	6.5
CN4202500000000	42	025	Carbon County, PA	1995	NA	26342	24346	1996	7.6
CN4202700000000	42	027	Centre County, PA	1995	NA	63674	61556	2118	3.3
CN4202900000000	42	029	Chester County, PA	1995	NA	217026	208558	8468	3.9
CN4203100000000	42	031	Clarion County, PA	1995	NA	18388	16873	1515	8.2
CN4203300000000	42	033	Clearfield County, PA	1995	NA	37753	34531	3222	8.5
CN4203500000000	42	035	Clinton County, PA	1995	NA	17408	15720	1688	9.7
CN4203700000000	42	037	Columbia County, PA	1995	NA	32946	30520	2426	7.4
CN4203900000000	42	039	Crawford County, PA	1995	NA	41192	38546	2646	6.4
CN4204100000000	42	041	Cumberland County, PA	1995	NA	116447	112735	3712	3.2
CN4204300000000	42	043	Dauphin County, PA	1995	NA	136227	130868	5359	3.9
CN4204500000000	42	045	Delaware County, PA	1995	NA	275070	259948	15122	5.5
CN4204700000000	42	047	Elk County, PA	1995	NA	18324	17280	1044	5.7
CN4204900000000	42	049	Erie County, PA	1995	NA	140523	131552	8971	6.4
CN4205100000000	42	051	Fayette County, PA	1995	NA	57247	51752	5495	9.6
CN4205300000000	42	053	Forest County, PA	1995	NA	1837	1626	211	11.5
CN4205500000000	42	055	Franklin County, PA	1995	NA	64087	61202	2885	4.5
CN4205700000000	42	057	Fulton County, PA	1995	NA	6634	6267	367	5.5
CN4205900000000	42	059	Greene County, PA	1995	NA	15705	14078	1627	10.4
CN4206100000000	42	061	Huntingdon County, PA	1995	NA	19271	17301	1970	10.2
CN4206300000000	42	063	Indiana County, PA	1995	NA	37543	34096	3447	9.2
CN4206500000000	42	065	Jefferson County, PA	1995	NA	22040	20383	1657	7.5
CN4206700000000	42	067	Juniata County, PA	1995	NA	10096	9222	874	8.7
CN4206900000000	42	069	Lackawanna County, PA	1995	NA	106686	99417	7269	6.8
CN4207100000000	42	071	Lancaster County, PA	1995	NA	234465	226183	8282	3.5
CN4207300000000	42	073	Lawrence County, PA	1995	NA	39765	36969	2796	7
CN4207500000000	42	075	Lebanon County, PA	1995	NA	63969	61241	2728	4.3
CN4207700000000	42	077	Lehigh County, PA	1995	NA	151596	143415	8181	5.4
CN4207900000000	42	079	Luzerne County, PA	1995	NA	160197	146776	13421	8.4
CN4208100000000	42	081	Lycoming County, PA	1995	NA	57647	53436	4211	7.3
CN4208300000000	42	083	McKean County, PA	1995	NA	21633	20269	1364	6.3
CN4208500000000	42	085	Mercer County, PA	1995	NA	55405	52608	2797	5
CN4208700000000	42	087	Mifflin County, PA	1995	NA	22988	21370	1618	7
CN4208900000000	42	089	Monroe County, PA	1995	NA	49917	45615	4302	8.6
CN4209100000000	42	091	Montgomery County, PA	1995	NA	380203	363347	16856	4.4
CN4209300000000	42	093	Montour County, PA	1995	NA	8773	8461	312	3.6
CN4209500000000	42	095	Northampton County, PA	1995	NA	125796	119063	6733	5.4
CN4209700000000	42	097	Northumberland County, PA	1995	NA	44542	41419	3123	7
CN4209900000000	42	099	Perry County, PA	1995	NA	23350	22322	1028	4.4
CN4210100000000	42	101	Philadelphia County/city, PA	1995	NA	651975	601734	50241	7.7
CN4210300000000	42	103	Pike County, PA	1995	NA	16730	15726	1004	6
CN4210500000000	42	105	Potter County, PA	1995	NA	8523	7889	634	7.4
CN4210700000000	42	107	Schuylkill County, PA	1995	NA	68504	63098	5406	7.9
CN4210900000000	42	109	Snyder County, PA	1995	NA	18607	17577	1030	5.5
CN4211100000000	42	111	Somerset County, PA	1995	NA	38204	34953	3251	8.5
CN4211300000000	42	113	Sullivan County, PA	1995	NA	2695	2532	163	6
CN4211500000000	42	115	Susquehanna County, PA	1995	NA	19226	17839	1387	7.2
CN4211700000000	42	117	Tioga County, PA	1995	NA	19674	18288	1386	7
CN4211900000000	42	119	Union County, PA	1995	NA	18369	17561	808	4.4
CN4212100000000	42	121	Venango County, PA	1995	NA	25985	24085	1900	7.3
CN4212300000000	42	123	Warren County, PA	1995	NA	21925	20858	1067	4.9
CN4212500000000	42	125	Washington County, PA	1995	NA	94882	88499	6383	6.7
CN4212700000000	42	127	Wayne County, PA	1995	NA	18930	17254	1676	8.9
CN4212900000000	42	129	Westmoreland County, PA	1995	NA	180705	168675	12030	6.7
CN4213100000000	42	131	Wyoming County, PA	1995	NA	14887	13740	1147	7.7
CN4213300000000	42	133	York County, PA	1995	NA	193390	185348	8042	4.2
CN4400100000000	44	001	Bristol County, RI	1995	NA	25782	24450	1332	5.2
CN4400300000000	44	003	Kent County, RI	1995	NA	88447	82855	5592	6.3
CN4400500000000	44	005	Newport County, RI	1995	NA	39430	37049	2381	6
CN4400700000000	44	007	Providence County, RI	1995	NA	295210	275133	20077	6.8
CN4400900000000	44	009	Washington County, RI	1995	NA	62549	59592	2957	4.7
CN4500100000000	45	001	Abbeville County, SC	1995	NA	12612	11799	813	6.4
CN4500300000000	45	003	Aiken County, SC	1995	NA	64456	59711	4745	7.4
CN4500500000000	45	005	Allendale County, SC	1995	NA	4810	4374	436	9.1
CN4500700000000	45	007	Anderson County, SC	1995	NA	81308	77976	3332	4.1
CN4500900000000	45	009	Bamberg County, SC	1995	NA	7594	6847	747	9.8
CN4501100000000	45	011	Barnwell County, SC	1995	NA	11076	9866	1210	10.9
CN4501300000000	45	013	Beaufort County, SC	1995	NA	43704	42359	1345	3.1
CN4501500000000	45	015	Berkeley County, SC	1995	NA	60866	58357	2509	4.1
CN4501700000000	45	017	Calhoun County, SC	1995	NA	6484	6037	447	6.9
CN4501900000000	45	019	Charleston County, SC	1995	NA	142189	134360	7829	5.5
CN4502100000000	45	021	Cherokee County, SC	1995	NA	24494	23366	1128	4.6
CN4502300000000	45	023	Chester County, SC	1995	NA	15481	14020	1461	9.4
CN4502500000000	45	025	Chesterfield County, SC	1995	NA	20792	19256	1536	7.4
CN4502700000000	45	027	Clarendon County, SC	1995	NA	11699	10673	1026	8.8
CN4502900000000	45	029	Colleton County, SC	1995	NA	15661	14620	1041	6.6
CN4503100000000	45	031	Darlington County, SC	1995	NA	31489	28725	2764	8.8
CN4503300000000	45	033	Dillon County, SC	1995	NA	14010	12531	1479	10.6
CN4503500000000	45	035	Dorchester County, SC	1995	NA	41820	39511	2309	5.5
CN4503700000000	45	037	Edgefield County, SC	1995	NA	9187	8555	632	6.9
CN4503900000000	45	039	Fairfield County, SC	1995	NA	11018	10113	905	8.2
CN4504100000000	45	041	Florence County, SC	1995	NA	61326	57329	3997	6.5
CN4504300000000	45	043	Georgetown County, SC	1995	NA	24208	21953	2255	9.3
CN4504500000000	45	045	Greenville County, SC	1995	NA	183669	178960	4709	2.6
CN4504700000000	45	047	Greenwood County, SC	1995	NA	33166	31407	1759	5.3
CN4504900000000	45	049	Hampton County, SC	1995	NA	8271	7678	593	7.2
CN4505100000000	45	051	Horry County, SC	1995	NA	90939	86279	4660	5.1
CN4505300000000	45	053	Jasper County, SC	1995	NA	7362	7016	346	4.7
CN4505500000000	45	055	Kershaw County, SC	1995	NA	22900	21454	1446	6.3
CN4505700000000	45	057	Lancaster County, SC	1995	NA	29087	27373	1714	5.9
CN4505900000000	45	059	Laurens County, SC	1995	NA	31184	29964	1220	3.9
CN4506100000000	45	061	Lee County, SC	1995	NA	8128	7432	696	8.6
CN4506300000000	45	063	Lexington County, SC	1995	NA	109623	106254	3369	3.1
CN4506500000000	45	065	McCormick County, SC	1995	NA	4048	3667	381	9.4
CN4506700000000	45	067	Marion County, SC	1995	NA	16497	14704	1793	10.9
CN4506900000000	45	069	Marlboro County, SC	1995	NA	11805	10377	1428	12.1
CN4507100000000	45	071	Newberry County, SC	1995	NA	18128	17082	1046	5.8
CN4507300000000	45	073	Oconee County, SC	1995	NA	28340	27012	1328	4.7
CN4507500000000	45	075	Orangeburg County, SC	1995	NA	41040	37129	3911	9.5
CN4507700000000	45	077	Pickens County, SC	1995	NA	54023	51863	2160	4
CN4507900000000	45	079	Richland County, SC	1995	NA	149196	143861	5335	3.6
CN4508100000000	45	081	Saluda County, SC	1995	NA	8359	7945	414	5
CN4508300000000	45	083	Spartanburg County, SC	1995	NA	127679	122809	4870	3.8
CN4508500000000	45	085	Sumter County, SC	1995	NA	45138	42422	2716	6
CN4508700000000	45	087	Union County, SC	1995	NA	15666	14228	1438	9.2
CN4508900000000	45	089	Williamsburg County, SC	1995	NA	16422	14011	2411	14.7
CN4509100000000	45	091	York County, SC	1995	NA	80278	77306	2972	3.7
CN4600300000000	46	003	Aurora County, SD	1995	NA	1435	1391	44	3.1
CN4600500000000	46	005	Beadle County, SD	1995	NA	9615	9360	255	2.7
CN4600700000000	46	007	Bennett County, SD	1995	NA	1084	1025	59	5.4
CN4600900000000	46	009	Bon Homme County, SD	1995	NA	3187	3119	68	2.1
CN4601100000000	46	011	Brookings County, SD	1995	NA	15384	15148	236	1.5
CN4601300000000	46	013	Brown County, SD	1995	NA	20810	20389	421	2
CN4601500000000	46	015	Brule County, SD	1995	NA	2972	2846	126	4.2
CN4601700000000	46	017	Buffalo County, SD	1995	NA	815	730	85	10.4
CN4601900000000	46	019	Butte County, SD	1995	NA	3859	3713	146	3.8
CN4602100000000	46	021	Campbell County, SD	1995	NA	958	931	27	2.8
CN4602300000000	46	023	Charles Mix County, SD	1995	NA	4803	4633	170	3.5
CN4602500000000	46	025	Clark County, SD	1995	NA	1976	1899	77	3.9
CN4602700000000	46	027	Clay County, SD	1995	NA	6928	6853	75	1.1
CN4602900000000	46	029	Codington County, SD	1995	NA	14129	13689	440	3.1
CN4603100000000	46	031	Corson County, SD	1995	NA	1537	1418	119	7.7
CN4603300000000	46	033	Custer County, SD	1995	NA	3489	3320	169	4.8
CN4603500000000	46	035	Davison County, SD	1995	NA	9859	9574	285	2.9
CN4603700000000	46	037	Day County, SD	1995	NA	3093	2940	153	4.9
CN4603900000000	46	039	Deuel County, SD	1995	NA	2357	2281	76	3.2
CN4604100000000	46	041	Dewey County, SD	1995	NA	2270	1965	305	13.4
CN4604300000000	46	043	Douglas County, SD	1995	NA	1588	1533	55	3.5
CN4604500000000	46	045	Edmunds County, SD	1995	NA	2258	2222	36	1.6
CN4604700000000	46	047	Fall River County, SD	1995	NA	3572	3479	93	2.6
CN4604900000000	46	049	Faulk County, SD	1995	NA	1246	1214	32	2.6
CN4605100000000	46	051	Grant County, SD	1995	NA	4184	3988	196	4.7
CN4605300000000	46	053	Gregory County, SD	1995	NA	2665	2567	98	3.7
CN4605500000000	46	055	Haakon County, SD	1995	NA	1215	1173	42	3.5
CN4605700000000	46	057	Hamlin County, SD	1995	NA	2509	2431	78	3.1
CN4605900000000	46	059	Hand County, SD	1995	NA	2218	2156	62	2.8
CN4606100000000	46	061	Hanson County, SD	1995	NA	1648	1603	45	2.7
CN4606300000000	46	063	Harding County, SD	1995	NA	845	814	31	3.7
CN4606500000000	46	065	Hughes County, SD	1995	NA	9663	9400	263	2.7
CN4606700000000	46	067	Hutchinson County, SD	1995	NA	3954	3833	121	3.1
CN4606900000000	46	069	Hyde County, SD	1995	NA	899	862	37	4.1
CN4607100000000	46	071	Jackson County, SD	1995	NA	1112	1046	66	5.9
CN4607300000000	46	073	Jerauld County, SD	1995	NA	1138	1100	38	3.3
CN4607500000000	46	075	Jones County, SD	1995	NA	824	796	28	3.4
CN4607700000000	46	077	Kingsbury County, SD	1995	NA	2630	2534	96	3.7
CN4607900000000	46	079	Lake County, SD	1995	NA	5996	5847	149	2.5
CN4608100000000	46	081	Lawrence County, SD	1995	NA	12033	11626	407	3.4
CN4608300000000	46	083	Lincoln County, SD	1995	NA	10017	9853	164	1.6
CN4608500000000	46	085	Lyman County, SD	1995	NA	2429	2324	105	4.3
CN4608700000000	46	087	McCook County, SD	1995	NA	2575	2511	64	2.5
CN4608900000000	46	089	McPherson County, SD	1995	NA	1443	1397	46	3.2
CN4609100000000	46	091	Marshall County, SD	1995	NA	2370	2293	77	3.2
CN4609300000000	46	093	Meade County, SD	1995	NA	12114	11708	406	3.4
CN4609500000000	46	095	Mellette County, SD	1995	NA	782	739	43	5.5
CN4609700000000	46	097	Miner County, SD	1995	NA	1447	1377	70	4.8
CN4609900000000	46	099	Minnehaha County, SD	1995	NA	81370	79620	1750	2.2
CN4610100000000	46	101	Moody County, SD	1995	NA	3692	3490	202	5.5
CN4610200000000	46	102	Oglala Lakota County, SD	1995	NA	3138	2698	440	14
CN4610300000000	46	103	Pennington County, SD	1995	NA	44804	43411	1393	3.1
CN4610500000000	46	105	Perkins County, SD	1995	NA	2036	1988	48	2.4
CN4610700000000	46	107	Potter County, SD	1995	NA	1535	1477	58	3.8
CN4610900000000	46	109	Roberts County, SD	1995	NA	4865	4631	234	4.8
CN4611100000000	46	111	Sanborn County, SD	1995	NA	1459	1407	52	3.6
CN4611500000000	46	115	Spink County, SD	1995	NA	3617	3505	112	3.1
CN4611700000000	46	117	Stanley County, SD	1995	NA	1784	1724	60	3.4
CN4611900000000	46	119	Sully County, SD	1995	NA	964	931	33	3.4
CN4612100000000	46	121	Todd County, SD	1995	NA	2720	2499	221	8.1
CN4612300000000	46	123	Tripp County, SD	1995	NA	3651	3527	124	3.4
CN4612500000000	46	125	Turner County, SD	1995	NA	4217	4078	139	3.3
CN4612700000000	46	127	Union County, SD	1995	NA	6782	6536	246	3.6
CN4612900000000	46	129	Walworth County, SD	1995	NA	3132	3001	131	4.2
CN4613500000000	46	135	Yankton County, SD	1995	NA	10946	10728	218	2
CN4613700000000	46	137	Ziebach County, SD	1995	NA	722	672	50	6.9
CN4700100000000	47	001	Anderson County, TN	1995	NA	36352	34927	1425	3.9
CN4700300000000	47	003	Bedford County, TN	1995	NA	17236	16169	1067	6.2
CN4700500000000	47	005	Benton County, TN	1995	NA	7949	7397	552	6.9
CN4700700000000	47	007	Bledsoe County, TN	1995	NA	3853	3662	191	5
CN4700900000000	47	009	Blount County, TN	1995	NA	50209	47578	2631	5.2
CN4701100000000	47	011	Bradley County, TN	1995	NA	41883	39776	2107	5
CN4701300000000	47	013	Campbell County, TN	1995	NA	16592	15229	1363	8.2
CN4701500000000	47	015	Cannon County, TN	1995	NA	5113	4835	278	5.4
CN4701700000000	47	017	Carroll County, TN	1995	NA	14443	13528	915	6.3
CN4701900000000	47	019	Carter County, TN	1995	NA	26203	24744	1459	5.6
CN4702100000000	47	021	Cheatham County, TN	1995	NA	17238	16807	431	2.5
CN4702300000000	47	023	Chester County, TN	1995	NA	7452	7067	385	5.2
CN4702500000000	47	025	Claiborne County, TN	1995	NA	13041	12389	652	5
CN4702700000000	47	027	Clay County, TN	1995	NA	3885	3603	282	7.3
CN4702900000000	47	029	Cocke County, TN	1995	NA	16980	15056	1924	11.3
CN4703100000000	47	031	Coffee County, TN	1995	NA	22558	21376	1182	5.2
CN4703300000000	47	033	Crockett County, TN	1995	NA	7631	7129	502	6.6
CN4703500000000	47	035	Cumberland County, TN	1995	NA	18636	17306	1330	7.1
CN4703700000000	47	037	Davidson County, TN	1995	NA	300906	291069	9837	3.3
CN4703900000000	47	039	Decatur County, TN	1995	NA	5932	5452	480	8.1
CN4704100000000	47	041	DeKalb County, TN	1995	NA	8563	7933	630	7.4
CN4704300000000	47	043	Dickson County, TN	1995	NA	19507	18689	818	4.2
CN4704500000000	47	045	Dyer County, TN	1995	NA	18968	18002	966	5.1
CN4704700000000	47	047	Fayette County, TN	1995	NA	12249	11616	633	5.2
CN4704900000000	47	049	Fentress County, TN	1995	NA	7438	6642	796	10.7
CN4705100000000	47	051	Franklin County, TN	1995	NA	18577	17523	1054	5.7
CN4705300000000	47	053	Gibson County, TN	1995	NA	23570	22140	1430	6.1
CN4705500000000	47	055	Giles County, TN	1995	NA	16172	15393	779	4.8
CN4705700000000	47	057	Grainger County, TN	1995	NA	9762	9112	650	6.7
CN4705900000000	47	059	Greene County, TN	1995	NA	33642	30697	2945	8.8
CN4706100000000	47	061	Grundy County, TN	1995	NA	5844	5318	526	9
CN4706300000000	47	063	Hamblen County, TN	1995	NA	30605	28485	2120	6.9
CN4706500000000	47	065	Hamilton County, TN	1995	NA	150125	143329	6796	4.5
CN4706700000000	47	067	Hancock County, TN	1995	NA	2691	2520	171	6.4
CN4706900000000	47	069	Hardeman County, TN	1995	NA	9165	8313	852	9.3
CN4707100000000	47	071	Hardin County, TN	1995	NA	12428	11444	984	7.9
CN4707300000000	47	073	Hawkins County, TN	1995	NA	23502	22225	1277	5.4
CN4707500000000	47	075	Haywood County, TN	1995	NA	9033	7978	1055	11.7
CN4707700000000	47	077	Henderson County, TN	1995	NA	13482	12460	1022	7.6
CN4707900000000	47	079	Henry County, TN	1995	NA	14860	14021	839	5.6
CN4708100000000	47	081	Hickman County, TN	1995	NA	8711	8320	391	4.5
CN4708300000000	47	083	Houston County, TN	1995	NA	2993	2522	471	15.7
CN4708500000000	47	085	Humphreys County, TN	1995	NA	8352	7551	801	9.6
CN4708700000000	47	087	Jackson County, TN	1995	NA	4464	4174	290	6.5
CN4708900000000	47	089	Jefferson County, TN	1995	NA	21694	20156	1538	7.1
CN4709100000000	47	091	Johnson County, TN	1995	NA	8521	7346	1175	13.8
CN4709300000000	47	093	Knox County, TN	1995	NA	197924	191203	6721	3.4
CN4709500000000	47	095	Lake County, TN	1995	NA	2845	2679	166	5.8
CN4709700000000	47	097	Lauderdale County, TN	1995	NA	9648	8802	846	8.8
CN4709900000000	47	099	Lawrence County, TN	1995	NA	21831	19506	2325	10.6
CN4710100000000	47	101	Lewis County, TN	1995	NA	5188	4699	489	9.4
CN4710300000000	47	103	Lincoln County, TN	1995	NA	15469	14563	906	5.9
CN4710500000000	47	105	Loudon County, TN	1995	NA	19233	18463	770	4
CN4710700000000	47	107	McMinn County, TN	1995	NA	22364	20313	2051	9.2
CN4710900000000	47	109	McNairy County, TN	1995	NA	11702	10520	1182	10.1
CN4711100000000	47	111	Macon County, TN	1995	NA	9413	8593	820	8.7
CN4711300000000	47	113	Madison County, TN	1995	NA	46953	44690	2263	4.8
CN4711500000000	47	115	Marion County, TN	1995	NA	12482	11652	830	6.6
CN4711700000000	47	117	Marshall County, TN	1995	NA	12436	11688	748	6
CN4711900000000	47	119	Maury County, TN	1995	NA	36533	34409	2124	5.8
CN4712100000000	47	121	Meigs County, TN	1995	NA	4434	3971	463	10.4
CN4712300000000	47	123	Monroe County, TN	1995	NA	18081	16472	1609	8.9
CN4712500000000	47	125	Montgomery County, TN	1995	NA	52583	50603	1980	3.8
CN4712700000000	47	127	Moore County, TN	1995	NA	3010	2926	84	2.8
CN4712900000000	47	129	Morgan County, TN	1995	NA	7606	6966	640	8.4
CN4713100000000	47	131	Obion County, TN	1995	NA	14949	14116	833	5.6
CN4713300000000	47	133	Overton County, TN	1995	NA	9369	8660	709	7.6
CN4713500000000	47	135	Perry County, TN	1995	NA	3414	3203	211	6.2
CN4713700000000	47	137	Pickett County, TN	1995	NA	2278	2031	247	10.8
CN4713900000000	47	139	Polk County, TN	1995	NA	6826	6294	532	7.8
CN4714100000000	47	141	Putnam County, TN	1995	NA	30333	28854	1479	4.9
CN4714300000000	47	143	Rhea County, TN	1995	NA	12186	11077	1109	9.1
CN4714500000000	47	145	Roane County, TN	1995	NA	29055	27385	1670	5.7
CN4714700000000	47	147	Robertson County, TN	1995	NA	25484	24335	1149	4.5
CN4714900000000	47	149	Rutherford County, TN	1995	NA	83136	80270	2866	3.4
CN4715100000000	47	151	Scott County, TN	1995	NA	8690	7804	886	10.2
CN4715300000000	47	153	Sequatchie County, TN	1995	NA	4689	4410	279	6
CN4715500000000	47	155	Sevier County, TN	1995	NA	33588	30739	2849	8.5
CN4715700000000	47	157	Shelby County, TN	1995	NA	430227	409163	21064	4.9
CN4715900000000	47	159	Smith County, TN	1995	NA	9236	8792	444	4.8
CN4716100000000	47	161	Stewart County, TN	1995	NA	3985	3372	613	15.4
CN4716300000000	47	163	Sullivan County, TN	1995	NA	76249	72714	3535	4.6
CN4716500000000	47	165	Sumner County, TN	1995	NA	63743	61326	2417	3.8
CN4716700000000	47	167	Tipton County, TN	1995	NA	20087	19013	1074	5.3
CN4716900000000	47	169	Trousdale County, TN	1995	NA	2338	2128	210	9
CN4717100000000	47	171	Unicoi County, TN	1995	NA	8129	7517	612	7.5
CN4717300000000	47	173	Union County, TN	1995	NA	7411	7073	338	4.6
CN4717500000000	47	175	Van Buren County, TN	1995	NA	2475	2299	176	7.1
CN4717700000000	47	177	Warren County, TN	1995	NA	19413	18179	1234	6.4
CN4717900000000	47	179	Washington County, TN	1995	NA	51492	49424	2068	4
CN4718100000000	47	181	Wayne County, TN	1995	NA	7633	6756	877	11.5
CN4718300000000	47	183	Weakley County, TN	1995	NA	17765	17099	666	3.7
CN4718500000000	47	185	White County, TN	1995	NA	10760	10020	740	6.9
CN4718700000000	47	187	Williamson County, TN	1995	NA	55883	54724	1159	2.1
CN4718900000000	47	189	Wilson County, TN	1995	NA	42621	40967	1654	3.9
CN4800100000000	48	001	Anderson County, TX	1995	NA	20568	19473	1095	5.3
CN4800300000000	48	003	Andrews County, TX	1995	NA	5510	5220	290	5.3
CN4800500000000	48	005	Angelina County, TX	1995	NA	34320	32506	1814	5.3
CN4800700000000	48	007	Aransas County, TX	1995	NA	8861	8313	548	6.2
CN4800900000000	48	009	Archer County, TX	1995	NA	4060	3944	116	2.9
CN4801100000000	48	011	Armstrong County, TX	1995	NA	959	927	32	3.3
CN4801300000000	48	013	Atascosa County, TX	1995	NA	15505	14736	769	5
CN4801500000000	48	015	Austin County, TX	1995	NA	11326	10912	414	3.7
CN4801700000000	48	017	Bailey County, TX	1995	NA	3773	3545	228	6
CN4801900000000	48	019	Bandera County, TX	1995	NA	6700	6465	235	3.5
CN4802100000000	48	021	Bastrop County, TX	1995	NA	23198	22559	639	2.8
CN4802300000000	48	023	Baylor County, TX	1995	NA	1894	1800	94	5
CN4802500000000	48	025	Bee County, TX	1995	NA	11252	10340	912	8.1
CN4802700000000	48	027	Bell County, TX	1995	NA	89884	85443	4441	4.9
CN4802900000000	48	029	Bexar County, TX	1995	NA	635490	606201	29289	4.6
CN4803100000000	48	031	Blanco County, TX	1995	NA	3410	3327	83	2.4
CN4803300000000	48	033	Borden County, TX	1995	NA	406	395	11	2.7
CN4803500000000	48	035	Bosque County, TX	1995	NA	6282	5966	316	5
CN4803700000000	48	037	Bowie County, TX	1995	NA	39781	36426	3355	8.4
CN4803900000000	48	039	Brazoria County, TX	1995	NA	105693	97802	7891	7.5
CN4804100000000	48	041	Brazos County, TX	1995	NA	68910	66825	2085	3
CN4804300000000	48	043	Brewster County, TX	1995	NA	4691	4574	117	2.5
CN4804500000000	48	045	Briscoe County, TX	1995	NA	972	932	40	4.1
CN4804700000000	48	047	Brooks County, TX	1995	NA	3205	2763	442	13.8
CN4804900000000	48	049	Brown County, TX	1995	NA	16890	15831	1059	6.3
CN4805100000000	48	051	Burleson County, TX	1995	NA	7398	7009	389	5.3
CN4805300000000	48	053	Burnet County, TX	1995	NA	12135	11656	479	3.9
CN4805500000000	48	055	Caldwell County, TX	1995	NA	14353	13819	534	3.7
CN4805700000000	48	057	Calhoun County, TX	1995	NA	9548	8671	877	9.2
CN4805900000000	48	059	Callahan County, TX	1995	NA	6281	6026	255	4.1
CN4806100000000	48	061	Cameron County, TX	1995	NA	122700	107089	15611	12.7
CN4806300000000	48	063	Camp County, TX	1995	NA	5008	4602	406	8.1
CN4806500000000	48	065	Carson County, TX	1995	NA	3842	3699	143	3.7
CN4806700000000	48	067	Cass County, TX	1995	NA	15208	13782	1426	9.4
CN4806900000000	48	069	Castro County, TX	1995	NA	4174	3962	212	5.1
CN4807100000000	48	071	Chambers County, TX	1995	NA	10810	10205	605	5.6
CN4807300000000	48	073	Cherokee County, TX	1995	NA	20199	19132	1067	5.3
CN4807500000000	48	075	Childress County, TX	1995	NA	3357	3221	136	4.1
CN4807700000000	48	077	Clay County, TX	1995	NA	5281	5102	179	3.4
CN4807900000000	48	079	Cochran County, TX	1995	NA	1645	1540	105	6.4
CN4808100000000	48	081	Coke County, TX	1995	NA	1553	1517	36	2.3
CN4808300000000	48	083	Coleman County, TX	1995	NA	3973	3707	266	6.7
CN4808500000000	48	085	Collin County, TX	1995	NA	209814	203027	6787	3.2
CN4808700000000	48	087	Collingsworth County, TX	1995	NA	1668	1603	65	3.9
CN4808900000000	48	089	Colorado County, TX	1995	NA	8207	7929	278	3.4
CN4809100000000	48	091	Comal County, TX	1995	NA	33175	31987	1188	3.6
CN4809300000000	48	093	Comanche County, TX	1995	NA	6604	6361	243	3.7
CN4809500000000	48	095	Concho County, TX	1995	NA	1423	1392	31	2.2
CN4809700000000	48	097	Cooke County, TX	1995	NA	15584	14789	795	5.1
CN4809900000000	48	099	Coryell County, TX	1995	NA	20614	19613	1001	4.9
CN4810100000000	48	101	Cottle County, TX	1995	NA	869	814	55	6.3
CN4810300000000	48	103	Crane County, TX	1995	NA	2236	2140	96	4.3
CN4810500000000	48	105	Crockett County, TX	1995	NA	2036	1975	61	3
CN4810700000000	48	107	Crosby County, TX	1995	NA	3221	3007	214	6.6
CN4810900000000	48	109	Culberson County, TX	1995	NA	1281	1207	74	5.8
CN4811100000000	48	111	Dallam County, TX	1995	NA	3294	3183	111	3.4
CN4811300000000	48	113	Dallas County, TX	1995	NA	1136869	1078665	58204	5.1
CN4811500000000	48	115	Dawson County, TX	1995	NA	6342	5917	425	6.7
CN4811700000000	48	117	Deaf Smith County, TX	1995	NA	8741	8056	685	7.8
CN4811900000000	48	119	Delta County, TX	1995	NA	2586	2472	114	4.4
CN4812100000000	48	121	Denton County, TX	1995	NA	204323	197273	7050	3.5
CN4812300000000	48	123	DeWitt County, TX	1995	NA	8560	8119	441	5.2
CN4812500000000	48	125	Dickens County, TX	1995	NA	1102	992	110	10
CN4812700000000	48	127	Dimmit County, TX	1995	NA	3776	3149	627	16.6
CN4812900000000	48	129	Donley County, TX	1995	NA	1593	1544	49	3.1
CN4813100000000	48	131	Duval County, TX	1995	NA	4812	4154	658	13.7
CN4813300000000	48	133	Eastland County, TX	1995	NA	8160	7730	430	5.3
CN4813500000000	48	135	Ector County, TX	1995	NA	60078	55590	4488	7.5
CN4813700000000	48	137	Edwards County, TX	1995	NA	912	871	41	4.5
CN4813900000000	48	139	Ellis County, TX	1995	NA	48222	45919	2303	4.8
CN4814100000000	48	141	El Paso County, TX	1995	NA	286718	256600	30118	10.5
CN4814300000000	48	143	Erath County, TX	1995	NA	16029	15580	449	2.8
CN4814500000000	48	145	Falls County, TX	1995	NA	7588	7237	351	4.6
CN4814700000000	48	147	Fannin County, TX	1995	NA	11809	10974	835	7.1
CN4814900000000	48	149	Fayette County, TX	1995	NA	10688	10364	324	3
CN4815100000000	48	151	Fisher County, TX	1995	NA	1932	1825	107	5.5
CN4815300000000	48	153	Floyd County, TX	1995	NA	3508	3282	226	6.4
CN4815500000000	48	155	Foard County, TX	1995	NA	1031	1010	21	2
CN4815700000000	48	157	Fort Bend County, TX	1995	NA	154027	148399	5628	3.7
CN4815900000000	48	159	Franklin County, TX	1995	NA	3994	3732	262	6.6
CN4816100000000	48	161	Freestone County, TX	1995	NA	7350	6929	421	5.7
CN4816300000000	48	163	Frio County, TX	1995	NA	6621	5903	718	10.8
CN4816500000000	48	165	Gaines County, TX	1995	NA	7000	6646	354	5.1
CN4816700000000	48	167	Galveston County, TX	1995	NA	126733	117142	9591	7.6
CN4816900000000	48	169	Garza County, TX	1995	NA	2211	2081	130	5.9
CN4817100000000	48	171	Gillespie County, TX	1995	NA	9951	9780	171	1.7
CN4817300000000	48	173	Glasscock County, TX	1995	NA	633	614	19	3
CN4817500000000	48	175	Goliad County, TX	1995	NA	2736	2547	189	6.9
CN4817700000000	48	177	Gonzales County, TX	1995	NA	7516	7202	314	4.2
CN4817900000000	48	179	Gray County, TX	1995	NA	10907	10389	518	4.7
CN4818100000000	48	181	Grayson County, TX	1995	NA	48090	45637	2453	5.1
CN4818300000000	48	183	Gregg County, TX	1995	NA	57792	53379	4413	7.6
CN4818500000000	48	185	Grimes County, TX	1995	NA	8608	8142	466	5.4
CN4818700000000	48	187	Guadalupe County, TX	1995	NA	37708	36614	1094	2.9
CN4818900000000	48	189	Hale County, TX	1995	NA	17821	16721	1100	6.2
CN4819100000000	48	191	Hall County, TX	1995	NA	1786	1661	125	7
CN4819300000000	48	193	Hamilton County, TX	1995	NA	3888	3768	120	3.1
CN4819500000000	48	195	Hansford County, TX	1995	NA	2429	2353	76	3.1
CN4819700000000	48	197	Hardeman County, TX	1995	NA	2084	2006	78	3.7
CN4819900000000	48	199	Hardin County, TX	1995	NA	22191	20308	1883	8.5
CN4820100000000	48	201	Harris County, TX	1995	NA	1671553	1570944	100609	6
CN4820300000000	48	203	Harrison County, TX	1995	NA	27685	25350	2335	8.4
CN4820500000000	48	205	Hartley County, TX	1995	NA	2776	2706	70	2.5
CN4820700000000	48	207	Haskell County, TX	1995	NA	2883	2767	116	4
CN4820900000000	48	209	Hays County, TX	1995	NA	43711	42360	1351	3.1
CN4821100000000	48	211	Hemphill County, TX	1995	NA	1865	1802	63	3.4
CN4821300000000	48	213	Henderson County, TX	1995	NA	27439	25807	1632	5.9
CN4821500000000	48	215	Hidalgo County, TX	1995	NA	187787	150439	37348	19.9
CN4821700000000	48	217	Hill County, TX	1995	NA	14307	13661	646	4.5
CN4821900000000	48	219	Hockley County, TX	1995	NA	11359	10637	722	6.4
CN4822100000000	48	221	Hood County, TX	1995	NA	15000	14089	911	6.1
CN4822300000000	48	223	Hopkins County, TX	1995	NA	15936	14946	990	6.2
CN4822500000000	48	225	Houston County, TX	1995	NA	8343	7984	359	4.3
CN4822700000000	48	227	Howard County, TX	1995	NA	13907	13349	558	4
CN4822900000000	48	229	Hudspeth County, TX	1995	NA	1487	1458	29	2
CN4823100000000	48	231	Hunt County, TX	1995	NA	33609	31548	2061	6.1
CN4823300000000	48	233	Hutchinson County, TX	1995	NA	10253	9528	725	7.1
CN4823500000000	48	235	Irion County, TX	1995	NA	904	874	30	3.3
CN4823700000000	48	237	Jack County, TX	1995	NA	3304	3159	145	4.4
CN4823900000000	48	239	Jackson County, TX	1995	NA	8520	8180	340	4
CN4824100000000	48	241	Jasper County, TX	1995	NA	15653	13892	1761	11.3
CN4824300000000	48	243	Jeff Davis County, TX	1995	NA	1096	1055	41	3.7
CN4824500000000	48	245	Jefferson County, TX	1995	NA	118828	107868	10960	9.2
CN4824700000000	48	247	Jim Hogg County, TX	1995	NA	1987	1785	202	10.2
CN4824900000000	48	249	Jim Wells County, TX	1995	NA	16502	14789	1713	10.4
CN4825100000000	48	251	Johnson County, TX	1995	NA	53932	51417	2515	4.7
CN4825300000000	48	253	Jones County, TX	1995	NA	10118	9787	331	3.3
CN4825500000000	48	255	Karnes County, TX	1995	NA	5568	5186	382	6.9
CN4825700000000	48	257	Kaufman County, TX	1995	NA	28726	27460	1266	4.4
CN4825900000000	48	259	Kendall County, TX	1995	NA	10938	10722	216	2
CN4826100000000	48	261	Kenedy County, TX	1995	NA	224	218	6	2.7
CN4826300000000	48	263	Kent County, TX	1995	NA	433	422	11	2.5
CN4826500000000	48	265	Kerr County, TX	1995	NA	16947	16474	473	2.8
CN4826700000000	48	267	Kimble County, TX	1995	NA	2257	2197	60	2.7
CN4826900000000	48	269	King County, TX	1995	NA	134	126	8	6
CN4827100000000	48	271	Kinney County, TX	1995	NA	1110	1024	86	7.7
CN4827300000000	48	273	Kleberg County, TX	1995	NA	13178	12142	1036	7.9
CN4827500000000	48	275	Knox County, TX	1995	NA	2312	2216	96	4.2
CN4827700000000	48	277	Lamar County, TX	1995	NA	22008	20313	1695	7.7
CN4827900000000	48	279	Lamb County, TX	1995	NA	6821	6362	459	6.7
CN4828100000000	48	281	Lampasas County, TX	1995	NA	7194	6838	356	4.9
CN4828300000000	48	283	La Salle County, TX	1995	NA	2641	2411	230	8.7
CN4828500000000	48	285	Lavaca County, TX	1995	NA	9457	9201	256	2.7
CN4828700000000	48	287	Lee County, TX	1995	NA	7303	6976	327	4.5
CN4828900000000	48	289	Leon County, TX	1995	NA	5484	5108	376	6.9
CN4829100000000	48	291	Liberty County, TX	1995	NA	27003	24803	2200	8.1
CN4829300000000	48	293	Limestone County, TX	1995	NA	9491	8965	526	5.5
CN4829500000000	48	295	Lipscomb County, TX	1995	NA	1605	1565	40	2.5
CN4829700000000	48	297	Live Oak County, TX	1995	NA	4532	4310	222	4.9
CN4829900000000	48	299	Llano County, TX	1995	NA	4763	4604	159	3.3
CN4830100000000	48	301	Loving County, TX	1995	NA	91	82	9	9.9
CN4830300000000	48	303	Lubbock County, TX	1995	NA	120248	115360	4888	4.1
CN4830500000000	48	305	Lynn County, TX	1995	NA	3057	2947	110	3.6
CN4830700000000	48	307	McCulloch County, TX	1995	NA	3903	3650	253	6.5
CN4830900000000	48	309	McLennan County, TX	1995	NA	99332	94731	4601	4.6
CN4831100000000	48	311	McMullen County, TX	1995	NA	276	268	8	2.9
CN4831300000000	48	313	Madison County, TX	1995	NA	4156	3987	169	4.1
CN4831500000000	48	315	Marion County, TX	1995	NA	3935	3524	411	10.4
CN4831700000000	48	317	Martin County, TX	1995	NA	1889	1835	54	2.9
CN4831900000000	48	319	Mason County, TX	1995	NA	1625	1582	43	2.6
CN4832100000000	48	321	Matagorda County, TX	1995	NA	17422	14942	2480	14.2
CN4832300000000	48	323	Maverick County, TX	1995	NA	18343	12882	5461	29.8
CN4832500000000	48	325	Medina County, TX	1995	NA	14804	14210	594	4
CN4832700000000	48	327	Menard County, TX	1995	NA	1033	1013	20	1.9
CN4832900000000	48	329	Midland County, TX	1995	NA	59674	56755	2919	4.9
CN4833100000000	48	331	Milam County, TX	1995	NA	9659	9100	559	5.8
CN4833300000000	48	333	Mills County, TX	1995	NA	2241	2164	77	3.4
CN4833500000000	48	335	Mitchell County, TX	1995	NA	3323	3114	209	6.3
CN4833700000000	48	337	Montague County, TX	1995	NA	7964	7496	468	5.9
CN4833900000000	48	339	Montgomery County, TX	1995	NA	116438	111297	5141	4.4
CN4834100000000	48	341	Moore County, TX	1995	NA	9018	8656	362	4
CN4834300000000	48	343	Morris County, TX	1995	NA	5915	5323	592	10
CN4834500000000	48	345	Motley County, TX	1995	NA	715	684	31	4.3
CN4834700000000	48	347	Nacogdoches County, TX	1995	NA	27629	26289	1340	4.8
CN4834900000000	48	349	Navarro County, TX	1995	NA	21218	20057	1161	5.5
CN4835100000000	48	351	Newton County, TX	1995	NA	6282	5585	697	11.1
CN4835300000000	48	353	Nolan County, TX	1995	NA	7729	7190	539	7
CN4835500000000	48	355	Nueces County, TX	1995	NA	146376	133148	13228	9
CN4835700000000	48	357	Ochiltree County, TX	1995	NA	4409	4250	159	3.6
CN4835900000000	48	359	Oldham County, TX	1995	NA	1145	1094	51	4.5
CN4836100000000	48	361	Orange County, TX	1995	NA	41925	36705	5220	12.5
CN4836300000000	48	363	Palo Pinto County, TX	1995	NA	12698	11617	1081	8.5
CN4836500000000	48	365	Panola County, TX	1995	NA	8190	7316	874	10.7
CN4836700000000	48	367	Parker County, TX	1995	NA	36453	34809	1644	4.5
CN4836900000000	48	369	Parmer County, TX	1995	NA	4448	4274	174	3.9
CN4837100000000	48	371	Pecos County, TX	1995	NA	7164	6696	468	6.5
CN4837300000000	48	373	Polk County, TX	1995	NA	14617	13752	865	5.9
CN4837500000000	48	375	Potter County, TX	1995	NA	54375	51783	2592	4.8
CN4837700000000	48	377	Presidio County, TX	1995	NA	3623	2244	1379	38.1
CN4837900000000	48	379	Rains County, TX	1995	NA	3586	3412	174	4.9
CN4838100000000	48	381	Randall County, TX	1995	NA	56991	55350	1641	2.9
CN4838300000000	48	383	Reagan County, TX	1995	NA	2017	1941	76	3.8
CN4838500000000	48	385	Real County, TX	1995	NA	1294	1231	63	4.9
CN4838700000000	48	387	Red River County, TX	1995	NA	6191	5747	444	7.2
CN4838900000000	48	389	Reeves County, TX	1995	NA	7015	6284	731	10.4
CN4839100000000	48	391	Refugio County, TX	1995	NA	3058	2883	175	5.7
CN4839300000000	48	393	Roberts County, TX	1995	NA	519	506	13	2.5
CN4839500000000	48	395	Robertson County, TX	1995	NA	6767	6320	447	6.6
CN4839700000000	48	397	Rockwall County, TX	1995	NA	18504	17902	602	3.3
CN4839900000000	48	399	Runnels County, TX	1995	NA	5376	5183	193	3.6
CN4840100000000	48	401	Rusk County, TX	1995	NA	20164	18735	1429	7.1
CN4840300000000	48	403	Sabine County, TX	1995	NA	3747	3433	314	8.4
CN4840500000000	48	405	San Augustine County, TX	1995	NA	3228	3045	183	5.7
CN4840700000000	48	407	San Jacinto County, TX	1995	NA	7580	7237	343	4.5
CN4840900000000	48	409	San Patricio County, TX	1995	NA	28653	25849	2804	9.8
CN4841100000000	48	411	San Saba County, TX	1995	NA	2351	2262	89	3.8
CN4841300000000	48	413	Schleicher County, TX	1995	NA	1413	1344	69	4.9
CN4841500000000	48	415	Scurry County, TX	1995	NA	7919	7552	367	4.6
CN4841700000000	48	417	Shackelford County, TX	1995	NA	1462	1411	51	3.5
CN4841900000000	48	419	Shelby County, TX	1995	NA	10169	9507	662	6.5
CN4842100000000	48	421	Sherman County, TX	1995	NA	1387	1356	31	2.2
CN4842300000000	48	423	Smith County, TX	1995	NA	84926	80217	4709	5.5
CN4842500000000	48	425	Somervell County, TX	1995	NA	2227	1963	264	11.9
CN4842700000000	48	427	Starr County, TX	1995	NA	21749	15506	6243	28.7
CN4842900000000	48	429	Stephens County, TX	1995	NA	4073	3893	180	4.4
CN4843100000000	48	431	Sterling County, TX	1995	NA	659	619	40	6.1
CN4843300000000	48	433	Stonewall County, TX	1995	NA	837	804	33	3.9
CN4843500000000	48	435	Sutton County, TX	1995	NA	2168	2082	86	4
CN4843700000000	48	437	Swisher County, TX	1995	NA	4052	3855	197	4.9
CN4843900000000	48	439	Tarrant County, TX	1995	NA	713338	678383	34955	4.9
CN4844100000000	48	441	Taylor County, TX	1995	NA	59819	56723	3096	5.2
CN4844300000000	48	443	Terrell County, TX	1995	NA	592	564	28	4.7
CN4844500000000	48	445	Terry County, TX	1995	NA	6015	5571	444	7.4
CN4844700000000	48	447	Throckmorton County, TX	1995	NA	849	818	31	3.7
CN4844900000000	48	449	Titus County, TX	1995	NA	11993	11040	953	7.9
CN4845100000000	48	451	Tom Green County, TX	1995	NA	50172	48097	2075	4.1
CN4845300000000	48	453	Travis County, TX	1995	NA	417895	404744	13151	3.1
CN4845500000000	48	455	Trinity County, TX	1995	NA	4930	4652	278	5.6
CN4845700000000	48	457	Tyler County, TX	1995	NA	7502	6917	585	7.8
CN4845900000000	48	459	Upshur County, TX	1995	NA	16007	14977	1030	6.4
CN4846100000000	48	461	Upton County, TX	1995	NA	1869	1791	78	4.2
CN4846300000000	48	463	Uvalde County, TX	1995	NA	10935	9650	1285	11.8
CN4846500000000	48	465	Val Verde County, TX	1995	NA	18142	16135	2007	11.1
CN4846700000000	48	467	Van Zandt County, TX	1995	NA	19164	18394	770	4
CN4846900000000	48	469	Victoria County, TX	1995	NA	41824	39266	2558	6.1
CN4847100000000	48	471	Walker County, TX	1995	NA	22640	22086	554	2.4
CN4847300000000	48	473	Waller County, TX	1995	NA	11629	11015	614	5.3
CN4847500000000	48	475	Ward County, TX	1995	NA	4607	4294	313	6.8
CN4847700000000	48	477	Washington County, TX	1995	NA	14666	14228	438	3
CN4847900000000	48	479	Webb County, TX	1995	NA	70569	59679	10890	15.4
CN4848100000000	48	481	Wharton County, TX	1995	NA	19521	18249	1272	6.5
CN4848300000000	48	483	Wheeler County, TX	1995	NA	2820	2712	108	3.8
CN4848500000000	48	485	Wichita County, TX	1995	NA	60560	57623	2937	4.8
CN4848700000000	48	487	Wilbarger County, TX	1995	NA	7218	6957	261	3.6
CN4848900000000	48	489	Willacy County, TX	1995	NA	7667	6050	1617	21.1
CN4849100000000	48	491	Williamson County, TX	1995	NA	110528	108397	2131	1.9
CN4849300000000	48	493	Wilson County, TX	1995	NA	13215	12809	406	3.1
CN4849500000000	48	495	Winkler County, TX	1995	NA	3066	2825	241	7.9
CN4849700000000	48	497	Wise County, TX	1995	NA	19818	18982	836	4.2
CN4849900000000	48	499	Wood County, TX	1995	NA	13926	13158	768	5.5
CN4850100000000	48	501	Yoakum County, TX	1995	NA	3699	3497	202	5.5
CN4850300000000	48	503	Young County, TX	1995	NA	8749	8124	625	7.1
CN4850500000000	48	505	Zapata County, TX	1995	NA	4260	3734	526	12.3
CN4850700000000	48	507	Zavala County, TX	1995	NA	4669	3477	1192	25.5
CN4900100000000	49	001	Beaver County, UT	1995	NA	2348	2254	94	4
CN4900300000000	49	003	Box Elder County, UT	1995	NA	17833	17011	822	4.6
CN4900500000000	49	005	Cache County, UT	1995	NA	41627	40352	1275	3.1
CN4900700000000	49	007	Carbon County, UT	1995	NA	9131	8538	593	6.5
CN4900900000000	49	009	Daggett County, UT	1995	NA	447	419	28	6.3
CN4901100000000	49	011	Davis County, UT	1995	NA	105972	102394	3578	3.4
CN4901300000000	49	013	Duchesne County, UT	1995	NA	5761	5233	528	9.2
CN4901500000000	49	015	Emery County, UT	1995	NA	4228	3895	333	7.9
CN4901700000000	49	017	Garfield County, UT	1995	NA	2641	2315	326	12.3
CN4901900000000	49	019	Grand County, UT	1995	NA	4959	4630	329	6.6
CN4902100000000	49	021	Iron County, UT	1995	NA	12996	12560	436	3.4
CN4902300000000	49	023	Juab County, UT	1995	NA	3343	3181	162	4.8
CN4902500000000	49	025	Kane County, UT	1995	NA	2707	2474	233	8.6
CN4902700000000	49	027	Millard County, UT	1995	NA	4715	4488	227	4.8
CN4902900000000	49	029	Morgan County, UT	1995	NA	3398	3241	157	4.6
CN4903100000000	49	031	Piute County, UT	1995	NA	489	460	29	5.9
CN4903300000000	49	033	Rich County, UT	1995	NA	892	857	35	3.9
CN4903500000000	49	035	Salt Lake County, UT	1995	NA	454011	440443	13568	3
CN4903700000000	49	037	San Juan County, UT	1995	NA	5218	4774	444	8.5
CN4903900000000	49	039	Sanpete County, UT	1995	NA	7783	7317	466	6
CN4904100000000	49	041	Sevier County, UT	1995	NA	7634	7253	381	5
CN4904300000000	49	043	Summit County, UT	1995	NA	12056	11586	470	3.9
CN4904500000000	49	045	Tooele County, UT	1995	NA	11470	10836	634	5.5
CN4904700000000	49	047	Uintah County, UT	1995	NA	10321	9600	721	7
CN4904900000000	49	049	Utah County, UT	1995	NA	148968	144727	4241	2.8
CN4905100000000	49	051	Wasatch County, UT	1995	NA	5429	5158	271	5
CN4905300000000	49	053	Washington County, UT	1995	NA	32773	31716	1057	3.2
CN4905500000000	49	055	Wayne County, UT	1995	NA	1324	1241	83	6.3
CN4905700000000	49	057	Weber County, UT	1995	NA	92238	88347	3891	4.2
CN5000100000000	50	001	Addison County, VT	1995	NA	18507	17686	821	4.4
CN5000300000000	50	003	Bennington County, VT	1995	NA	19448	18614	834	4.3
CN5000500000000	50	005	Caledonia County, VT	1995	NA	14832	13933	899	6.1
CN5000700000000	50	007	Chittenden County, VT	1995	NA	83366	80967	2399	2.9
CN5000900000000	50	009	Essex County, VT	1995	NA	2852	2646	206	7.2
CN5001100000000	50	011	Franklin County, VT	1995	NA	22230	21174	1056	4.8
CN5001300000000	50	013	Grand Isle County, VT	1995	NA	3077	2888	189	6.1
CN5001500000000	50	015	Lamoille County, VT	1995	NA	11280	10609	671	5.9
CN5001700000000	50	017	Orange County, VT	1995	NA	15071	14518	553	3.7
CN5001900000000	50	019	Orleans County, VT	1995	NA	12532	11455	1077	8.6
CN5002100000000	50	021	Rutland County, VT	1995	NA	32167	30638	1529	4.8
CN5002300000000	50	023	Washington County, VT	1995	NA	30838	29353	1485	4.8
CN5002500000000	50	025	Windham County, VT	1995	NA	23618	22665	953	4
CN5002700000000	50	027	Windsor County, VT	1995	NA	30029	28996	1033	3.4
CN5100100000000	51	001	Accomack County, VA	1995	NA	15377	14109	1268	8.2
CN5100300000000	51	003	Albemarle County, VA	1995	NA	36834	36115	719	2
CN5100500000000	51	005	Alleghany County, VA	1995	NA	8577	8029	548	6.4
CN5100700000000	51	007	Amelia County, VA	1995	NA	4390	4162	228	5.2
CN5100900000000	51	009	Amherst County, VA	1995	NA	14904	14356	548	3.7
CN5101100000000	51	011	Appomattox County, VA	1995	NA	6027	5662	365	6.1
CN5101300000000	51	013	Arlington County, VA	1995	NA	109621	105723	3898	3.6
CN5101500000000	51	015	Augusta County, VA	1995	NA	30357	28569	1788	5.9
CN5101700000000	51	017	Bath County, VA	1995	NA	2656	2406	250	9.4
CN5101900000000	51	019	Bedford County, VA	1995	NA	31526	30548	978	3.1
CN5102100000000	51	021	Bland County, VA	1995	NA	3586	3348	238	6.6
CN5102300000000	51	023	Botetourt County, VA	1995	NA	15897	15488	409	2.6
CN5102500000000	51	025	Brunswick County, VA	1995	NA	6811	6338	473	6.9
CN5102700000000	51	027	Buchanan County, VA	1995	NA	9586	8289	1297	13.5
CN5102900000000	51	029	Buckingham County, VA	1995	NA	6298	5984	314	5
CN5103100000000	51	031	Campbell County, VA	1995	NA	26687	25619	1068	4
CN5103300000000	51	033	Caroline County, VA	1995	NA	10187	9426	761	7.5
CN5103500000000	51	035	Carroll County, VA	1995	NA	14108	13422	686	4.9
CN5103600000000	51	036	Charles City County, VA	1995	NA	3667	3454	213	5.8
CN5103700000000	51	037	Charlotte County, VA	1995	NA	5707	5294	413	7.2
CN5104100000000	51	041	Chesterfield County, VA	1995	NA	136015	131832	4183	3.1
CN5104300000000	51	043	Clarke County, VA	1995	NA	6418	6223	195	3
CN5104500000000	51	045	Craig County, VA	1995	NA	2436	2323	113	4.6
CN5104700000000	51	047	Culpeper County, VA	1995	NA	15725	15019	706	4.5
CN5104900000000	51	049	Cumberland County, VA	1995	NA	4002	3896	106	2.6
CN5105100000000	51	051	Dickenson County, VA	1995	NA	6278	5055	1223	19.5
CN5105300000000	51	053	Dinwiddie County, VA	1995	NA	11112	10614	498	4.5
CN5105700000000	51	057	Essex County, VA	1995	NA	4635	4271	364	7.9
CN5105900000000	51	059	Fairfax County, VA	1995	NA	513279	498634	14645	2.9
CN5106100000000	51	061	Fauquier County, VA	1995	NA	27102	26222	880	3.2
CN5106300000000	51	063	Floyd County, VA	1995	NA	6464	6136	328	5.1
CN5106500000000	51	065	Fluvanna County, VA	1995	NA	8037	7794	243	3
CN5106700000000	51	067	Franklin County, VA	1995	NA	22741	21511	1230	5.4
CN5106900000000	51	069	Frederick County, VA	1995	NA	29819	28517	1302	4.4
CN5107100000000	51	071	Giles County, VA	1995	NA	8461	7845	616	7.3
CN5107300000000	51	073	Gloucester County, VA	1995	NA	16774	16169	605	3.6
CN5107500000000	51	075	Goochland County, VA	1995	NA	8537	8292	245	2.9
CN5107700000000	51	077	Grayson County, VA	1995	NA	8502	8060	442	5.2
CN5107900000000	51	079	Greene County, VA	1995	NA	6736	6538	198	2.9
CN5108100000000	51	081	Greensville County, VA	1995	NA	5458	5121	337	6.2
CN5108300000000	51	083	Halifax County, VA	1995	NA	18249	16869	1380	7.6
CN5108500000000	51	085	Hanover County, VA	1995	NA	42146	41237	909	2.2
CN5108700000000	51	087	Henrico County, VA	1995	NA	134066	130121	3945	2.9
CN5108900000000	51	089	Henry County, VA	1995	NA	30191	27629	2562	8.5
CN5109100000000	51	091	Highland County, VA	1995	NA	1346	1231	115	8.5
CN5109300000000	51	093	Isle of Wight County, VA	1995	NA	14275	13554	721	5.1
CN5109500000000	51	095	James City County, VA	1995	NA	21799	21166	633	2.9
CN5109700000000	51	097	King and Queen County, VA	1995	NA	3231	3073	158	4.9
CN5109900000000	51	099	King George County, VA	1995	NA	8226	7864	362	4.4
CN5110100000000	51	101	King William County, VA	1995	NA	6572	6338	234	3.6
CN5110300000000	51	103	Lancaster County, VA	1995	NA	5271	4538	733	13.9
CN5110500000000	51	105	Lee County, VA	1995	NA	10907	9629	1278	11.7
CN5110700000000	51	107	Loudoun County, VA	1995	NA	68602	66679	1923	2.8
CN5110900000000	51	109	Louisa County, VA	1995	NA	10080	9093	987	9.8
CN5111100000000	51	111	Lunenburg County, VA	1995	NA	4969	4335	634	12.8
CN5111300000000	51	113	Madison County, VA	1995	NA	7104	6881	223	3.1
CN5111500000000	51	115	Mathews County, VA	1995	NA	4401	4240	161	3.7
CN5111700000000	51	117	Mecklenburg County, VA	1995	NA	15285	14215	1070	7
CN5111900000000	51	119	Middlesex County, VA	1995	NA	4657	4474	183	3.9
CN5112100000000	51	121	Montgomery County, VA	1995	NA	37032	35835	1197	3.2
CN5112500000000	51	125	Nelson County, VA	1995	NA	6828	6574	254	3.7
CN5112700000000	51	127	New Kent County, VA	1995	NA	6240	6046	194	3.1
CN5113100000000	51	131	Northampton County, VA	1995	NA	5724	5213	511	8.9
CN5113300000000	51	133	Northumberland County, VA	1995	NA	5268	4599	669	12.7
CN5113500000000	51	135	Nottoway County, VA	1995	NA	6565	6195	370	5.6
CN5113700000000	51	137	Orange County, VA	1995	NA	10740	10224	516	4.8
CN5113900000000	51	139	Page County, VA	1995	NA	11956	11059	897	7.5
CN5114100000000	51	141	Patrick County, VA	1995	NA	9203	8606	597	6.5
CN5114300000000	51	143	Pittsylvania County, VA	1995	NA	31895	29170	2725	8.5
CN5114500000000	51	145	Powhatan County, VA	1995	NA	9496	9247	249	2.6
CN5114700000000	51	147	Prince Edward County, VA	1995	NA	8539	8084	455	5.3
CN5114900000000	51	149	Prince George County, VA	1995	NA	12055	11579	476	3.9
CN5115300000000	51	153	Prince William County, VA	1995	NA	129613	125387	4226	3.3
CN5115500000000	51	155	Pulaski County, VA	1995	NA	17021	15963	1058	6.2
CN5115700000000	51	157	Rappahannock County, VA	1995	NA	3991	3795	196	4.9
CN5115900000000	51	159	Richmond County, VA	1995	NA	4012	3761	251	6.3
CN5116100000000	51	161	Roanoke County, VA	1995	NA	49001	47929	1072	2.2
CN5116300000000	51	163	Rockbridge County, VA	1995	NA	9667	9185	482	5
CN5116500000000	51	165	Rockingham County, VA	1995	NA	36869	35739	1130	3.1
CN5116700000000	51	167	Russell County, VA	1995	NA	14179	12615	1564	11
CN5116900000000	51	169	Scott County, VA	1995	NA	10328	9399	929	9
CN5117100000000	51	171	Shenandoah County, VA	1995	NA	17973	16930	1043	5.8
CN5117300000000	51	173	Smyth County, VA	1995	NA	17621	15900	1721	9.8
CN5117500000000	51	175	Southampton County, VA	1995	NA	7710	7376	334	4.3
CN5117700000000	51	177	Spotsylvania County, VA	1995	NA	37436	36120	1316	3.5
CN5117900000000	51	179	Stafford County, VA	1995	NA	40629	39374	1255	3.1
CN5118100000000	51	181	Surry County, VA	1995	NA	2717	2460	257	9.5
CN5118300000000	51	183	Sussex County, VA	1995	NA	5056	4739	317	6.3
CN5118500000000	51	185	Tazewell County, VA	1995	NA	20175	18096	2079	10.3
CN5118700000000	51	187	Warren County, VA	1995	NA	14911	14057	854	5.7
CN5119100000000	51	191	Washington County, VA	1995	NA	26356	24429	1927	7.3
CN5119300000000	51	193	Westmoreland County, VA	1995	NA	7412	6735	677	9.1
CN5119500000000	51	195	Wise County, VA	1995	NA	16300	13509	2791	17.1
CN5119700000000	51	197	Wythe County, VA	1995	NA	14975	13988	987	6.6
CN5119900000000	51	199	York County, VA	1995	NA	26118	25359	759	2.9
CN5151000000000	51	510	Alexandria city, VA	1995	NA	75460	72118	3342	4.4
CN5152000000000	51	520	Bristol city, VA	1995	NA	8885	8415	470	5.3
CN5153000000000	51	530	Buena Vista city, VA	1995	NA	3239	3052	187	5.8
CN5154000000000	51	540	Charlottesville city, VA	1995	NA	20128	19593	535	2.7
CN5155000000000	51	550	Chesapeake city, VA	1995	NA	97629	93736	3893	4
CN5157000000000	51	570	Colonial Heights city, VA	1995	NA	9028	8626	402	4.5
CN5158000000000	51	580	Covington city, VA	1995	NA	3352	3025	327	9.8
CN5159000000000	51	590	Danville city, VA	1995	NA	27147	24917	2230	8.2
CN5159500000000	51	595	Emporia city, VA	1995	NA	2685	2477	208	7.7
CN5160000000000	51	600	Fairfax city, VA	1995	NA	12425	12247	178	1.4
CN5161000000000	51	610	Falls Church city, VA	1995	NA	5850	5595	255	4.4
CN5162000000000	51	620	Franklin city, VA	1995	NA	3777	3578	199	5.3
CN5163000000000	51	630	Fredericksburg city, VA	1995	NA	11338	10856	482	4.3
CN5164000000000	51	640	Galax city, VA	1995	NA	3418	3285	133	3.9
CN5165000000000	51	650	Hampton city, VA	1995	NA	66873	63189	3684	5.5
CN5166000000000	51	660	Harrisonburg city, VA	1995	NA	18022	17601	421	2.3
CN5167000000000	51	670	Hopewell city, VA	1995	NA	10880	10219	661	6.1
CN5167800000000	51	678	Lexington city, VA	1995	NA	2798	2721	77	2.8
CN5168000000000	51	680	Lynchburg city, VA	1995	NA	32099	30858	1241	3.9
CN5168300000000	51	683	Manassas city, VA	1995	NA	18653	17983	670	3.6
CN5168500000000	51	685	Manassas Park city, VA	1995	NA	4035	3944	91	2.3
CN5169000000000	51	690	Martinsville city, VA	1995	NA	7558	6869	689	9.1
CN5170000000000	51	700	Newport News city, VA	1995	NA	84093	79357	4736	5.6
CN5171000000000	51	710	Norfolk city, VA	1995	NA	87680	82051	5629	6.4
CN5172000000000	51	720	Norton city, VA	1995	NA	1667	1461	206	12.4
CN5173000000000	51	730	Petersburg city, VA	1995	NA	17847	16473	1374	7.7
CN5173500000000	51	735	Poquoson city, VA	1995	NA	6097	5916	181	3
CN5174000000000	51	740	Portsmouth city, VA	1995	NA	46111	42825	3286	7.1
CN5175000000000	51	750	Radford city, VA	1995	NA	6826	6559	267	3.9
CN5176000000000	51	760	Richmond city, VA	1995	NA	100497	95089	5408	5.4
CN5177000000000	51	770	Roanoke city, VA	1995	NA	50980	49143	1837	3.6
CN5177500000000	51	775	Salem city, VA	1995	NA	13749	13399	350	2.5
CN5179000000000	51	790	Staunton city, VA	1995	NA	11317	10737	580	5.1
CN5180000000000	51	800	Suffolk city, VA	1995	NA	27064	25357	1707	6.3
CN5181000000000	51	810	Virginia Beach city, VA	1995	NA	209088	200125	8963	4.3
CN5182000000000	51	820	Waynesboro city, VA	1995	NA	8779	8332	447	5.1
CN5183000000000	51	830	Williamsburg city, VA	1995	NA	6219	5730	489	7.9
CN5184000000000	51	840	Winchester city, VA	1995	NA	13486	12823	663	4.9
CN5300100000000	53	001	Adams County, WA	1995	NA	8763	7736	1027	11.7
CN5300300000000	53	003	Asotin County, WA	1995	NA	11398	10878	520	4.6
CN5300500000000	53	005	Benton County, WA	1995	NA	72823	67077	5746	7.9
CN5300700000000	53	007	Chelan County, WA	1995	NA	34069	30453	3616	10.6
CN5300900000000	53	009	Clallam County, WA	1995	NA	24522	22311	2211	9
CN5301100000000	53	011	Clark County, WA	1995	NA	153519	146903	6616	4.3
CN5301300000000	53	013	Columbia County, WA	1995	NA	1507	1304	203	13.5
CN5301500000000	53	015	Cowlitz County, WA	1995	NA	40895	37635	3260	8
CN5301700000000	53	017	Douglas County, WA	1995	NA	18439	16977	1462	7.9
CN5301900000000	53	019	Ferry County, WA	1995	NA	2944	2534	410	13.9
CN5302100000000	53	021	Franklin County, WA	1995	NA	22910	20565	2345	10.2
CN5302300000000	53	023	Garfield County, WA	1995	NA	1038	989	49	4.7
CN5302500000000	53	025	Grant County, WA	1995	NA	34100	30599	3501	10.3
CN5302700000000	53	027	Grays Harbor County, WA	1995	NA	28206	24993	3213	11.4
CN5302900000000	53	029	Island County, WA	1995	NA	25793	24561	1232	4.8
CN5303100000000	53	031	Jefferson County, WA	1995	NA	9943	9178	765	7.7
CN5303300000000	53	033	King County, WA	1995	NA	902205	859147	43058	4.8
CN5303500000000	53	035	Kitsap County, WA	1995	NA	90890	84483	6407	7
CN5303700000000	53	037	Kittitas County, WA	1995	NA	15418	14007	1411	9.2
CN5303900000000	53	039	Klickitat County, WA	1995	NA	8855	7762	1093	12.3
CN5304100000000	53	041	Lewis County, WA	1995	NA	30064	27328	2736	9.1
CN5304300000000	53	043	Lincoln County, WA	1995	NA	4745	4441	304	6.4
CN5304500000000	53	045	Mason County, WA	1995	NA	18609	17044	1565	8.4
CN5304700000000	53	047	Okanogan County, WA	1995	NA	23220	20654	2566	11.1
CN5304900000000	53	049	Pacific County, WA	1995	NA	8372	7513	859	10.3
CN5305100000000	53	051	Pend Oreille County, WA	1995	NA	4049	3478	571	14.1
CN5305300000000	53	053	Pierce County, WA	1995	NA	318314	297459	20855	6.6
CN5305500000000	53	055	San Juan County, WA	1995	NA	5662	5269	393	6.9
CN5305700000000	53	057	Skagit County, WA	1995	NA	49565	44920	4645	9.4
CN5305900000000	53	059	Skamania County, WA	1995	NA	4151	3700	451	10.9
CN5306100000000	53	061	Snohomish County, WA	1995	NA	282245	267320	14925	5.3
CN5306300000000	53	063	Spokane County, WA	1995	NA	200396	188950	11446	5.7
CN5306500000000	53	065	Stevens County, WA	1995	NA	16843	15148	1695	10.1
CN5306700000000	53	067	Thurston County, WA	1995	NA	95128	88870	6258	6.6
CN5306900000000	53	069	Wahkiakum County, WA	1995	NA	1690	1575	115	6.8
CN5307100000000	53	071	Walla Walla County, WA	1995	NA	26276	24582	1694	6.4
CN5307300000000	53	073	Whatcom County, WA	1995	NA	79592	73508	6084	7.6
CN5307500000000	53	075	Whitman County, WA	1995	NA	18418	18004	414	2.2
CN5307700000000	53	077	Yakima County, WA	1995	NA	115764	100368	15396	13.3
CN5400100000000	54	001	Barbour County, WV	1995	NA	6361	5495	866	13.6
CN5400300000000	54	003	Berkeley County, WV	1995	NA	31993	30094	1899	5.9
CN5400500000000	54	005	Boone County, WV	1995	NA	8421	7534	887	10.5
CN5400700000000	54	007	Braxton County, WV	1995	NA	5187	4493	694	13.4
CN5400900000000	54	009	Brooke County, WV	1995	NA	11332	10640	692	6.1
CN5401100000000	54	011	Cabell County, WV	1995	NA	42446	39987	2459	5.8
CN5401300000000	54	013	Calhoun County, WV	1995	NA	2749	2114	635	23.1
CN5401500000000	54	015	Clay County, WV	1995	NA	3462	2976	486	14
CN5401700000000	54	017	Doddridge County, WV	1995	NA	3025	2774	251	8.3
CN5401900000000	54	019	Fayette County, WV	1995	NA	17868	15944	1924	10.8
CN5402100000000	54	021	Gilmer County, WV	1995	NA	2672	2385	287	10.7
CN5402300000000	54	023	Grant County, WV	1995	NA	4841	4344	497	10.3
CN5402500000000	54	025	Greenbrier County, WV	1995	NA	15140	13619	1521	10
CN5402700000000	54	027	Hampshire County, WV	1995	NA	7669	7359	310	4
CN5402900000000	54	029	Hancock County, WV	1995	NA	14959	14043	916	6.1
CN5403100000000	54	031	Hardy County, WV	1995	NA	6864	6561	303	4.4
CN5403300000000	54	033	Harrison County, WV	1995	NA	32262	29480	2782	8.6
CN5403500000000	54	035	Jackson County, WV	1995	NA	12577	11558	1019	8.1
CN5403700000000	54	037	Jefferson County, WV	1995	NA	19706	18851	855	4.3
CN5403900000000	54	039	Kanawha County, WV	1995	NA	102042	96207	5835	5.7
CN5404100000000	54	041	Lewis County, WV	1995	NA	7108	6288	820	11.5
CN5404300000000	54	043	Lincoln County, WV	1995	NA	6934	6028	906	13.1
CN5404500000000	54	045	Logan County, WV	1995	NA	14473	12706	1767	12.2
CN5404700000000	54	047	McDowell County, WV	1995	NA	8122	7110	1012	12.5
CN5404900000000	54	049	Marion County, WV	1995	NA	24174	22048	2126	8.8
CN5405100000000	54	051	Marshall County, WV	1995	NA	16041	14824	1217	7.6
CN5405300000000	54	053	Mason County, WV	1995	NA	9774	8644	1130	11.6
CN5405500000000	54	055	Mercer County, WV	1995	NA	27701	26126	1575	5.7
CN5405700000000	54	057	Mineral County, WV	1995	NA	11604	10877	727	6.3
CN5405900000000	54	059	Mingo County, WV	1995	NA	10020	8649	1371	13.7
CN5406100000000	54	061	Monongalia County, WV	1995	NA	38083	36436	1647	4.3
CN5406300000000	54	063	Monroe County, WV	1995	NA	5063	4711	352	7
CN5406500000000	54	065	Morgan County, WV	1995	NA	5889	5548	341	5.8
CN5406700000000	54	067	Nicholas County, WV	1995	NA	10242	9213	1029	10
CN5406900000000	54	069	Ohio County, WV	1995	NA	24153	22931	1222	5.1
CN5407100000000	54	071	Pendleton County, WV	1995	NA	3797	3614	183	4.8
CN5407300000000	54	073	Pleasants County, WV	1995	NA	3067	2749	318	10.4
CN5407500000000	54	075	Pocahontas County, WV	1995	NA	4273	3522	751	17.6
CN5407700000000	54	077	Preston County, WV	1995	NA	12640	11578	1062	8.4
CN5407900000000	54	079	Putnam County, WV	1995	NA	23991	22670	1321	5.5
CN5408100000000	54	081	Raleigh County, WV	1995	NA	32499	29811	2688	8.3
CN5408300000000	54	083	Randolph County, WV	1995	NA	13096	11630	1466	11.2
CN5408500000000	54	085	Ritchie County, WV	1995	NA	4291	3717	574	13.4
CN5408700000000	54	087	Roane County, WV	1995	NA	6170	5304	866	14
CN5408900000000	54	089	Summers County, WV	1995	NA	4410	3906	504	11.4
CN5409100000000	54	091	Taylor County, WV	1995	NA	6561	5940	621	9.5
CN5409300000000	54	093	Tucker County, WV	1995	NA	3819	3385	434	11.4
CN5409500000000	54	095	Tyler County, WV	1995	NA	4114	3766	348	8.5
CN5409700000000	54	097	Upshur County, WV	1995	NA	10173	8857	1316	12.9
CN5409900000000	54	099	Wayne County, WV	1995	NA	16605	15368	1237	7.4
CN5410100000000	54	101	Webster County, WV	1995	NA	3093	2685	408	13.2
CN5410300000000	54	103	Wetzel County, WV	1995	NA	7504	6656	848	11.3
CN5410500000000	54	105	Wirt County, WV	1995	NA	2088	1753	335	16
CN5410700000000	54	107	Wood County, WV	1995	NA	43483	40288	3195	7.3
CN5410900000000	54	109	Wyoming County, WV	1995	NA	7936	7075	861	10.8
CN5500100000000	55	001	Adams County, WI	1995	NA	7083	6721	362	5.1
CN5500300000000	55	003	Ashland County, WI	1995	NA	8054	7516	538	6.7
CN5500500000000	55	005	Barron County, WI	1995	NA	23682	22517	1165	4.9
CN5500700000000	55	007	Bayfield County, WI	1995	NA	7435	6928	507	6.8
CN5500900000000	55	009	Brown County, WI	1995	NA	127437	123272	4165	3.3
CN5501100000000	55	011	Buffalo County, WI	1995	NA	7812	7486	326	4.2
CN5501300000000	55	013	Burnett County, WI	1995	NA	7039	6711	328	4.7
CN5501500000000	55	015	Calumet County, WI	1995	NA	24599	23458	1141	4.6
CN5501700000000	55	017	Chippewa County, WI	1995	NA	29149	27776	1373	4.7
CN5501900000000	55	019	Clark County, WI	1995	NA	17003	15859	1144	6.7
CN5502100000000	55	021	Columbia County, WI	1995	NA	27007	25559	1448	5.4
CN5502300000000	55	023	Crawford County, WI	1995	NA	9388	8904	484	5.2
CN5502500000000	55	025	Dane County, WI	1995	NA	251226	246665	4561	1.8
CN5502700000000	55	027	Dodge County, WI	1995	NA	46308	44797	1511	3.3
CN5502900000000	55	029	Door County, WI	1995	NA	15051	14018	1033	6.9
CN5503100000000	55	031	Douglas County, WI	1995	NA	22199	20893	1306	5.9
CN5503300000000	55	033	Dunn County, WI	1995	NA	22236	21419	817	3.7
CN5503500000000	55	035	Eau Claire County, WI	1995	NA	49078	47458	1620	3.3
CN5503700000000	55	037	Florence County, WI	1995	NA	1606	1519	87	5.4
CN5503900000000	55	039	Fond du Lac County, WI	1995	NA	55438	53552	1886	3.4
CN5504100000000	55	041	Forest County, WI	1995	NA	4418	4115	303	6.9
CN5504300000000	55	043	Grant County, WI	1995	NA	25821	24575	1246	4.8
CN5504500000000	55	045	Green County, WI	1995	NA	19055	18450	605	3.2
CN5504700000000	55	047	Green Lake County, WI	1995	NA	10771	10266	505	4.7
CN5504900000000	55	049	Iowa County, WI	1995	NA	13402	12867	535	4
CN5505100000000	55	051	Iron County, WI	1995	NA	3168	2935	233	7.4
CN5505300000000	55	053	Jackson County, WI	1995	NA	9751	9231	520	5.3
CN5505500000000	55	055	Jefferson County, WI	1995	NA	41556	40194	1362	3.3
CN5505700000000	55	057	Juneau County, WI	1995	NA	11035	10325	710	6.4
CN5505900000000	55	059	Kenosha County, WI	1995	NA	76933	73965	2968	3.9
CN5506100000000	55	061	Kewaunee County, WI	1995	NA	10431	10018	413	4
CN5506300000000	55	063	La Crosse County, WI	1995	NA	60164	57891	2273	3.8
CN5506500000000	55	065	Lafayette County, WI	1995	NA	8402	8064	338	4
CN5506700000000	55	067	Langlade County, WI	1995	NA	9697	9094	603	6.2
CN5506900000000	55	069	Lincoln County, WI	1995	NA	15611	14627	984	6.3
CN5507100000000	55	071	Manitowoc County, WI	1995	NA	45450	43300	2150	4.7
CN5507300000000	55	073	Marathon County, WI	1995	NA	70781	67550	3231	4.6
CN5507500000000	55	075	Marinette County, WI	1995	NA	20158	18978	1180	5.9
CN5507700000000	55	077	Marquette County, WI	1995	NA	6824	6318	506	7.4
CN5507800000000	55	078	Menominee County, WI	1995	NA	2060	1883	177	8.6
CN5507900000000	55	079	Milwaukee County, WI	1995	NA	482595	463037	19558	4.1
CN5508100000000	55	081	Monroe County, WI	1995	NA	20056	19077	979	4.9
CN5508300000000	55	083	Oconto County, WI	1995	NA	14982	14049	933	6.2
CN5508500000000	55	085	Oneida County, WI	1995	NA	19773	18864	909	4.6
CN5508700000000	55	087	Outagamie County, WI	1995	NA	97510	94588	2922	3
CN5508900000000	55	089	Ozaukee County, WI	1995	NA	46774	45624	1150	2.5
CN5509100000000	55	091	Pepin County, WI	1995	NA	3518	3345	173	4.9
CN5509300000000	55	093	Pierce County, WI	1995	NA	19989	19355	634	3.2
CN5509500000000	55	095	Polk County, WI	1995	NA	20467	19572	895	4.4
CN5509700000000	55	097	Portage County, WI	1995	NA	36976	35252	1724	4.7
CN5509900000000	55	099	Price County, WI	1995	NA	7877	7447	430	5.5
CN5510100000000	55	101	Racine County, WI	1995	NA	93509	89344	4165	4.5
CN5510300000000	55	103	Richland County, WI	1995	NA	8873	8492	381	4.3
CN5510500000000	55	105	Rock County, WI	1995	NA	79385	76153	3232	4.1
CN5510700000000	55	107	Rusk County, WI	1995	NA	7275	6716	559	7.7
CN5510900000000	55	109	St. Croix County, WI	1995	NA	30849	29893	956	3.1
CN5511100000000	55	111	Sauk County, WI	1995	NA	32370	31064	1306	4
CN5511300000000	55	113	Sawyer County, WI	1995	NA	8908	8387	521	5.8
CN5511500000000	55	115	Shawano County, WI	1995	NA	20474	19454	1020	5
CN5511700000000	55	117	Sheboygan County, WI	1995	NA	61677	59971	1706	2.8
CN5511900000000	55	119	Taylor County, WI	1995	NA	10815	10112	703	6.5
CN5512100000000	55	121	Trempealeau County, WI	1995	NA	14371	13597	774	5.4
CN5512300000000	55	123	Vernon County, WI	1995	NA	13707	13033	674	4.9
CN5512500000000	55	125	Vilas County, WI	1995	NA	10537	10027	510	4.8
CN5512700000000	55	127	Walworth County, WI	1995	NA	51452	50101	1351	2.6
CN5512900000000	55	129	Washburn County, WI	1995	NA	7367	6867	500	6.8
CN5513100000000	55	131	Washington County, WI	1995	NA	64047	62142	1905	3
CN5513300000000	55	133	Waukesha County, WI	1995	NA	201058	195645	5413	2.7
CN5513500000000	55	135	Waupaca County, WI	1995	NA	25961	24806	1155	4.4
CN5513700000000	55	137	Waushara County, WI	1995	NA	9798	9237	561	5.7
CN5513900000000	55	139	Winnebago County, WI	1995	NA	95157	92320	2837	3
CN5514100000000	55	141	Wood County, WI	1995	NA	39781	38079	1702	4.3
CN5600100000000	56	001	Albany County, WY	1995	NA	16726	16361	365	2.2
CN5600300000000	56	003	Big Horn County, WY	1995	NA	5145	4846	299	5.8
CN5600500000000	56	005	Campbell County, WY	1995	NA	18364	17495	869	4.7
CN5600700000000	56	007	Carbon County, WY	1995	NA	8700	8240	460	5.3
CN5600900000000	56	009	Converse County, WY	1995	NA	6390	6053	337	5.3
CN5601100000000	56	011	Crook County, WY	1995	NA	3048	2923	125	4.1
CN5601300000000	56	013	Fremont County, WY	1995	NA	17547	16256	1291	7.4
CN5601500000000	56	015	Goshen County, WY	1995	NA	6438	6154	284	4.4
CN5601700000000	56	017	Hot Springs County, WY	1995	NA	2426	2311	115	4.7
CN5601900000000	56	019	Johnson County, WY	1995	NA	3590	3455	135	3.8
CN5602100000000	56	021	Laramie County, WY	1995	NA	39110	37660	1450	3.7
CN5602300000000	56	023	Lincoln County, WY	1995	NA	6379	5909	470	7.4
CN5602500000000	56	025	Natrona County, WY	1995	NA	32760	30898	1862	5.7
CN5602700000000	56	027	Niobrara County, WY	1995	NA	1235	1207	28	2.3
CN5602900000000	56	029	Park County, WY	1995	NA	15239	14607	632	4.1
CN5603100000000	56	031	Platte County, WY	1995	NA	4200	4020	180	4.3
CN5603300000000	56	033	Sheridan County, WY	1995	NA	13680	13031	649	4.7
CN5603500000000	56	035	Sublette County, WY	1995	NA	3019	2906	113	3.7
CN5603700000000	56	037	Sweetwater County, WY	1995	NA	21711	20561	1150	5.3
CN5603900000000	56	039	Teton County, WY	1995	NA	10507	10265	242	2.3
CN5604100000000	56	041	Uinta County, WY	1995	NA	10917	10182	735	6.7
CN5604300000000	56	043	Washakie County, WY	1995	NA	4831	4525	306	6.3
CN5604500000000	56	045	Weston County, WY	1995	NA	3374	3210	164	4.9
CN7200100000000	72	001	Adjuntas Municipio, PR	1995	NA	5657	4899	758	13.4
CN7200300000000	72	003	Aguada Municipio, PR	1995	NA	14230	11589	2641	18.6
CN7200500000000	72	005	Aguadilla Municipio, PR	1995	NA	21406	17631	3775	17.6
CN7200700000000	72	007	Aguas Buenas Municipio, PR	1995	NA	8628	7456	1172	13.6
CN7200900000000	72	009	Aibonito Municipio, PR	1995	NA	10734	9651	1083	10.1
CN7201100000000	72	011	Anasco Municipio, PR	1995	NA	10201	8501	1700	16.7
CN7201300000000	72	013	Arecibo Municipio, PR	1995	NA	30803	25458	5345	17.4
CN7201500000000	72	015	Arroyo Municipio, PR	1995	NA	5098	4044	1054	20.7
CN7201700000000	72	017	Barceloneta Municipio, PR	1995	NA	7493	6206	1287	17.2
CN7201900000000	72	019	Barranquitas Municipio, PR	1995	NA	7455	6478	977	13.1
CN7202100000000	72	021	Bayamon Municipio, PR	1995	NA	84461	76604	7857	9.3
CN7202300000000	72	023	Cabo Rojo Municipio, PR	1995	NA	15475	13554	1921	12.4
CN7202500000000	72	025	Caguas Municipio, PR	1995	NA	54451	47926	6525	12
CN7202700000000	72	027	Camuy Municipio, PR	1995	NA	9537	8106	1431	15
CN7202900000000	72	029	Canovanas Municipio, PR	1995	NA	16053	13861	2192	13.7
CN7203100000000	72	031	Carolina Municipio, PR	1995	NA	76187	69082	7105	9.3
CN7203300000000	72	033	Catano Municipio, PR	1995	NA	9762	8753	1009	10.3
CN7203500000000	72	035	Cayey Municipio, PR	1995	NA	16060	13647	2413	15
CN7203700000000	72	037	Ceiba Municipio, PR	1995	NA	5595	4709	886	15.8
CN7203900000000	72	039	Ciales Municipio, PR	1995	NA	5042	3511	1531	30.4
CN7204100000000	72	041	Cidra Municipio, PR	1995	NA	14342	12662	1680	11.7
CN7204300000000	72	043	Coamo Municipio, PR	1995	NA	9040	7517	1523	16.8
CN7204500000000	72	045	Comerio Municipio, PR	1995	NA	5214	4563	651	12.5
CN7204700000000	72	047	Corozal Municipio, PR	1995	NA	9560	8431	1129	11.8
CN7204900000000	72	049	Culebra Municipio, PR	1995	NA	756	721	35	4.6
CN7205100000000	72	051	Dorado Municipio, PR	1995	NA	10243	9011	1232	12
CN7205300000000	72	053	Fajardo Municipio, PR	1995	NA	13236	10790	2446	18.5
CN7205400000000	72	054	Florida Municipio, PR	1995	NA	2654	2121	533	20.1
CN7205500000000	72	055	Guanica Municipio, PR	1995	NA	5795	4473	1322	22.8
CN7205700000000	72	057	Guayama Municipio, PR	1995	NA	11176	8552	2624	23.5
CN7205900000000	72	059	Guayanilla Municipio, PR	1995	NA	7413	6098	1315	17.7
CN7206100000000	72	061	Guaynabo Municipio, PR	1995	NA	40074	37681	2393	6
CN7206300000000	72	063	Gurabo Municipio, PR	1995	NA	10472	9018	1454	13.9
CN7206500000000	72	065	Hatillo Municipio, PR	1995	NA	10969	9215	1754	16
CN7206700000000	72	067	Hormigueros Municipio, PR	1995	NA	6888	5924	964	14
CN7206900000000	72	069	Humacao Municipio, PR	1995	NA	19378	16454	2924	15.1
CN7207100000000	72	071	Isabela Municipio, PR	1995	NA	14030	11101	2929	20.9
CN7207300000000	72	073	Jayuya Municipio, PR	1995	NA	3864	3327	537	13.9
CN7207500000000	72	075	Juana Diaz Municipio, PR	1995	NA	13036	10568	2468	18.9
CN7207700000000	72	077	Juncos Municipio, PR	1995	NA	11739	10041	1698	14.5
CN7207900000000	72	079	Lajas Municipio, PR	1995	NA	8605	7308	1297	15.1
CN7208100000000	72	081	Lares Municipio, PR	1995	NA	8601	7101	1500	17.4
CN7208300000000	72	083	Las Marias Municipio, PR	1995	NA	3099	2531	568	18.3
CN7208500000000	72	085	Las Piedras Municipio, PR	1995	NA	9825	8319	1506	15.3
CN7208700000000	72	087	Loiza Municipio, PR	1995	NA	8190	7164	1026	12.5
CN7208900000000	72	089	Luquillo Municipio, PR	1995	NA	6413	5162	1251	19.5
CN7209100000000	72	091	Manati Municipio, PR	1995	NA	12980	10541	2439	18.8
CN7209300000000	72	093	Maricao Municipio, PR	1995	NA	2268	1865	403	17.8
CN7209500000000	72	095	Maunabo Municipio, PR	1995	NA	3191	2487	704	22.1
CN7209700000000	72	097	Mayaguez Municipio, PR	1995	NA	35629	30506	5123	14.4
CN7209900000000	72	099	Moca Municipio, PR	1995	NA	12141	9915	2226	18.3
CN7210100000000	72	101	Morovis Municipio, PR	1995	NA	9314	7898	1416	15.2
CN7210300000000	72	103	Naguabo Municipio, PR	1995	NA	6668	5526	1142	17.1
CN7210500000000	72	105	Naranjito Municipio, PR	1995	NA	7187	6101	1086	15.1
CN7210700000000	72	107	Orocovis Municipio, PR	1995	NA	5701	4529	1172	20.6
CN7210900000000	72	109	Patillas Municipio, PR	1995	NA	5648	4394	1254	22.2
CN7211100000000	72	111	Penuelas Municipio, PR	1995	NA	7237	5908	1329	18.4
CN7211300000000	72	113	Ponce Municipio, PR	1995	NA	59327	49832	9495	16
CN7211500000000	72	115	Quebradillas Municipio, PR	1995	NA	7662	6545	1117	14.6
CN7211700000000	72	117	Rincon Municipio, PR	1995	NA	5539	4714	825	14.9
CN7211900000000	72	119	Rio Grande Municipio, PR	1995	NA	16713	14059	2654	15.9
CN7212100000000	72	121	Sabana Grande Municipio, PR	1995	NA	8440	7182	1258	14.9
CN7212300000000	72	123	Salinas Municipio, PR	1995	NA	8183	5979	2204	26.9
CN7212500000000	72	125	San German Municipio, PR	1995	NA	13257	10974	2283	17.2
CN7212700000000	72	127	San Juan Municipio, PR	1995	NA	160114	144511	15603	9.7
CN7212900000000	72	129	San Lorenzo Municipio, PR	1995	NA	11788	9655	2133	18.1
CN7213100000000	72	131	San Sebastian Municipio, PR	1995	NA	13366	10214	3152	23.6
CN7213300000000	72	133	Santa Isabel Municipio, PR	1995	NA	5185	3742	1443	27.8
CN7213500000000	72	135	Toa Alta Municipio, PR	1995	NA	18425	16722	1703	9.2
CN7213700000000	72	137	Toa Baja Municipio, PR	1995	NA	33331	30238	3093	9.3
CN7213900000000	72	139	Trujillo Alto Municipio, PR	1995	NA	27536	25390	2146	7.8
CN7214100000000	72	141	Utuado Municipio, PR	1995	NA	7994	6882	1112	13.9
CN7214300000000	72	143	Vega Alta Municipio, PR	1995	NA	11389	9703	1686	14.8
CN7214500000000	72	145	Vega Baja Municipio, PR	1995	NA	18558	15783	2775	15
CN7214700000000	72	147	Vieques Municipio, PR	1995	NA	2512	2166	346	13.8
CN7214900000000	72	149	Villalba Municipio, PR	1995	NA	6042	4716	1326	21.9
CN7215100000000	72	151	Yabucoa Municipio, PR	1995	NA	11825	9552	2273	19.2
CN7215300000000	72	153	Yauco Municipio, PR	1995	NA	13101	10728	2373	18.1
NA	NA	NA	NA	NA	NA	NA	NA	NA	NA
SOURCE:  BLS, LAUS	NA	NA	NA	NA	NA	NA	NA	NA	NA
March 18, 2016	NA	NA	NA	NA	NA	NA	NA	NA	NA
