LAUS_CODE	STATE_FIPS	COUNTY_FIPS	COUNTY	YEAR	ESTIMATED	LABOR_FORCE	EMPLOYED	UNEMPLOYED_LEVEL	UNEMPLOYED_RATE
CN0100100000000	01	001	Autauga County, AL	2002	NA	22094	21035	1059	4.8
CN0100300000000	01	003	Baldwin County, AL	2002	NA	69169	65691	3478	5
CN0100500000000	01	005	Barbour County, AL	2002	NA	10971	10125	846	7.7
CN0100700000000	01	007	Bibb County, AL	2002	NA	8933	8309	624	7
CN0100900000000	01	009	Blount County, AL	2002	NA	25757	24366	1391	5.4
CN0101100000000	01	011	Bullock County, AL	2002	NA	3877	3483	394	10.2
CN0101300000000	01	013	Butler County, AL	2002	NA	9144	8424	720	7.9
CN0101500000000	01	015	Calhoun County, AL	2002	NA	51952	48851	3101	6
CN0101700000000	01	017	Chambers County, AL	2002	NA	17158	16010	1148	6.7
CN0101900000000	01	019	Cherokee County, AL	2002	NA	11555	11007	548	4.7
CN0102100000000	01	021	Chilton County, AL	2002	NA	19393	18403	990	5.1
CN0102300000000	01	023	Choctaw County, AL	2002	NA	5731	5224	507	8.8
CN0102500000000	01	025	Clarke County, AL	2002	NA	10718	9747	971	9.1
CN0102700000000	01	027	Clay County, AL	2002	NA	6146	5763	383	6.2
CN0102900000000	01	029	Cleburne County, AL	2002	NA	6774	6436	338	5
CN0103100000000	01	031	Coffee County, AL	2002	NA	19300	18301	999	5.2
CN0103300000000	01	033	Colbert County, AL	2002	NA	24971	22891	2080	8.3
CN0103500000000	01	035	Conecuh County, AL	2002	NA	5163	4740	423	8.2
CN0103700000000	01	037	Coosa County, AL	2002	NA	5182	4699	483	9.3
CN0103900000000	01	039	Covington County, AL	2002	NA	17095	16082	1013	5.9
CN0104100000000	01	041	Crenshaw County, AL	2002	NA	5827	5473	354	6.1
CN0104300000000	01	043	Cullman County, AL	2002	NA	37936	35655	2281	6
CN0104500000000	01	045	Dale County, AL	2002	NA	20260	19107	1153	5.7
CN0104700000000	01	047	Dallas County, AL	2002	NA	17135	15181	1954	11.4
CN0104900000000	01	049	DeKalb County, AL	2002	NA	32384	30717	1667	5.1
CN0105100000000	01	051	Elmore County, AL	2002	NA	31677	30160	1517	4.8
CN0105300000000	01	053	Escambia County, AL	2002	NA	14917	13619	1298	8.7
CN0105500000000	01	055	Etowah County, AL	2002	NA	46892	43899	2993	6.4
CN0105700000000	01	057	Fayette County, AL	2002	NA	7881	7209	672	8.5
CN0105900000000	01	059	Franklin County, AL	2002	NA	13686	12154	1532	11.2
CN0106100000000	01	061	Geneva County, AL	2002	NA	11709	11131	578	4.9
CN0106300000000	01	063	Greene County, AL	2002	NA	3522	3224	298	8.5
CN0106500000000	01	065	Hale County, AL	2002	NA	7054	6462	592	8.4
CN0106700000000	01	067	Henry County, AL	2002	NA	7530	7075	455	6
CN0106900000000	01	069	Houston County, AL	2002	NA	44752	42631	2121	4.7
CN0107100000000	01	071	Jackson County, AL	2002	NA	26798	24913	1885	7
CN0107300000000	01	073	Jefferson County, AL	2002	NA	322122	305378	16744	5.2
CN0107500000000	01	075	Lamar County, AL	2002	NA	6961	6374	587	8.4
CN0107700000000	01	077	Lauderdale County, AL	2002	NA	41969	38359	3610	8.6
CN0107900000000	01	079	Lawrence County, AL	2002	NA	16093	15001	1092	6.8
CN0108100000000	01	081	Lee County, AL	2002	NA	59209	56499	2710	4.6
CN0108300000000	01	083	Limestone County, AL	2002	NA	33129	31358	1771	5.3
CN0108500000000	01	085	Lowndes County, AL	2002	NA	5032	4584	448	8.9
CN0108700000000	01	087	Macon County, AL	2002	NA	8762	8197	565	6.4
CN0108900000000	01	089	Madison County, AL	2002	NA	149904	143021	6883	4.6
CN0109100000000	01	091	Marengo County, AL	2002	NA	8975	8404	571	6.4
CN0109300000000	01	093	Marion County, AL	2002	NA	12647	11542	1105	8.7
CN0109500000000	01	095	Marshall County, AL	2002	NA	40340	37942	2398	5.9
CN0109700000000	01	097	Mobile County, AL	2002	NA	181590	169842	11748	6.5
CN0109900000000	01	099	Monroe County, AL	2002	NA	9708	8888	820	8.4
CN0110100000000	01	101	Montgomery County, AL	2002	NA	103870	98333	5537	5.3
CN0110300000000	01	103	Morgan County, AL	2002	NA	55311	51794	3517	6.4
CN0110500000000	01	105	Perry County, AL	2002	NA	3847	3393	454	11.8
CN0110700000000	01	107	Pickens County, AL	2002	NA	8248	7569	679	8.2
CN0110900000000	01	109	Pike County, AL	2002	NA	13707	12888	819	6
CN0111100000000	01	111	Randolph County, AL	2002	NA	9682	9025	657	6.8
CN0111300000000	01	113	Russell County, AL	2002	NA	21454	19951	1503	7
CN0111500000000	01	115	St. Clair County, AL	2002	NA	31935	30304	1631	5.1
CN0111700000000	01	117	Shelby County, AL	2002	NA	85670	82640	3030	3.5
CN0111900000000	01	119	Sumter County, AL	2002	NA	5100	4642	458	9
CN0112100000000	01	121	Talladega County, AL	2002	NA	37297	34552	2745	7.4
CN0112300000000	01	123	Tallapoosa County, AL	2002	NA	18860	17377	1483	7.9
CN0112500000000	01	125	Tuscaloosa County, AL	2002	NA	81553	77763	3790	4.6
CN0112700000000	01	127	Walker County, AL	2002	NA	30684	28737	1947	6.3
CN0112900000000	01	129	Washington County, AL	2002	NA	7167	6423	744	10.4
CN0113100000000	01	131	Wilcox County, AL	2002	NA	3816	3380	436	11.4
CN0113300000000	01	133	Winston County, AL	2002	NA	10478	9561	917	8.8
CN0201300000000	02	013	Aleutians East Borough, AK	2002	NA	969	883	86	8.9
CN0201600000000	02	016	Aleutians West Census Area, AK	2002	NA	2733	2560	173	6.3
CN0202000000000	02	020	Anchorage Borough/municipality, AK	2002	NA	143887	135505	8382	5.8
CN0205000000000	02	050	Bethel Census Area, AK	2002	NA	6835	6109	726	10.6
CN0206000000000	02	060	Bristol Bay Borough, AK	2002	NA	905	844	61	6.7
CN0206800000000	02	068	Denali Borough, AK	2002	NA	1523	1411	112	7.4
CN0207000000000	02	070	Dillingham Census Area, AK	2002	NA	1930	1734	196	10.2
CN0209000000000	02	090	Fairbanks North Star Borough, AK	2002	NA	41826	39065	2761	6.6
CN0210000000000	02	100	Haines Borough, AK	2002	NA	1277	1130	147	11.5
CN0211000000000	02	110	Juneau Borough/city, AK	2002	NA	17963	16979	984	5.5
CN0212200000000	02	122	Kenai Peninsula Borough, AK	2002	NA	24790	22402	2388	9.6
CN0213000000000	02	130	Ketchikan Gateway Borough, AK	2002	NA	7768	7113	655	8.4
CN0215000000000	02	150	Kodiak Island Borough, AK	2002	NA	6294	5724	570	9.1
CN0215800000000	02	158	Kusilvak Census Area, AK	2002	NA	2486	2051	435	17.5
CN0216400000000	02	164	Lake and Peninsula Borough, AK	2002	NA	917	847	70	7.6
CN0217000000000	02	170	Matanuska-Susitna Borough, AK	2002	NA	31314	28722	2592	8.3
CN0218000000000	02	180	Nome Census Area, AK	2002	NA	3857	3470	387	10
CN0218500000000	02	185	North Slope Borough, AK	2002	NA	3765	3438	327	8.7
CN0218800000000	02	188	Northwest Arctic Borough, AK	2002	NA	3064	2712	352	11.5
CN0220100000000	02	201	Prince of Wales-Outer Ketchikan Census Area, AK	2002	NA	2352	1984	368	15.6
CN0222000000000	02	220	Sitka Borough/city, AK	2002	NA	4610	4339	271	5.9
CN0223200000000	02	232	Skagway-Hoonah-Angoon Census Area, AK	2002	NA	1797	1576	221	12.3
CN0224000000000	02	240	Southeast Fairbanks Census Area, AK	2002	NA	2266	1951	315	13.9
CN0226100000000	02	261	Valdez-Cordova Census Area, AK	2002	NA	5196	4681	515	9.9
CN0228000000000	02	280	Wrangell-Petersburg Census Area, AK	2002	NA	2993	2654	339	11.3
CN0228200000000	02	282	Yakutat Borough/city, AK	2002	NA	317	288	29	9.1
CN0229000000000	02	290	Yukon-Koyukuk Census Area, AK	2002	NA	2767	2407	360	13
CN0400100000000	04	001	Apache County, AZ	2002	NA	20401	18158	2243	11
CN0400300000000	04	003	Cochise County, AZ	2002	NA	52540	49440	3100	5.9
CN0400500000000	04	005	Coconino County, AZ	2002	NA	65749	62156	3593	5.5
CN0400700000000	04	007	Gila County, AZ	2002	NA	21006	19433	1573	7.5
CN0400900000000	04	009	Graham County, AZ	2002	NA	12103	11174	929	7.7
CN0401100000000	04	011	Greenlee County, AZ	2002	NA	3621	3349	272	7.5
CN0401200000000	04	012	La Paz County, AZ	2002	NA	7267	6768	499	6.9
CN0401300000000	04	013	Maricopa County, AZ	2002	NA	1715246	1619099	96147	5.6
CN0401500000000	04	015	Mohave County, AZ	2002	NA	77562	73185	4377	5.6
CN0401700000000	04	017	Navajo County, AZ	2002	NA	36886	33744	3142	8.5
CN0401900000000	04	019	Pima County, AZ	2002	NA	423719	399541	24178	5.7
CN0402100000000	04	021	Pinal County, AZ	2002	NA	75825	70253	5572	7.3
CN0402300000000	04	023	Santa Cruz County, AZ	2002	NA	15323	13769	1554	10.1
CN0402500000000	04	025	Yavapai County, AZ	2002	NA	83013	78534	4479	5.4
CN0402700000000	04	027	Yuma County, AZ	2002	NA	69161	57405	11756	17
CN0500100000000	05	001	Arkansas County, AR	2002	NA	10493	9841	652	6.2
CN0500300000000	05	003	Ashley County, AR	2002	NA	10205	9404	801	7.8
CN0500500000000	05	005	Baxter County, AR	2002	NA	16160	15122	1038	6.4
CN0500700000000	05	007	Benton County, AR	2002	NA	84828	82090	2738	3.2
CN0500900000000	05	009	Boone County, AR	2002	NA	16131	15219	912	5.7
CN0501100000000	05	011	Bradley County, AR	2002	NA	5440	5032	408	7.5
CN0501300000000	05	013	Calhoun County, AR	2002	NA	2574	2408	166	6.4
CN0501500000000	05	015	Carroll County, AR	2002	NA	13332	12743	589	4.4
CN0501700000000	05	017	Chicot County, AR	2002	NA	5307	4781	526	9.9
CN0501900000000	05	019	Clark County, AR	2002	NA	11247	10564	683	6.1
CN0502100000000	05	021	Clay County, AR	2002	NA	7747	7165	582	7.5
CN0502300000000	05	023	Cleburne County, AR	2002	NA	10927	10391	536	4.9
CN0502500000000	05	025	Cleveland County, AR	2002	NA	3907	3673	234	6
CN0502700000000	05	027	Columbia County, AR	2002	NA	11031	10366	665	6
CN0502900000000	05	029	Conway County, AR	2002	NA	9659	9101	558	5.8
CN0503100000000	05	031	Craighead County, AR	2002	NA	42559	40310	2249	5.3
CN0503300000000	05	033	Crawford County, AR	2002	NA	25196	23990	1206	4.8
CN0503500000000	05	035	Crittenden County, AR	2002	NA	21434	20147	1287	6
CN0503700000000	05	037	Cross County, AR	2002	NA	8601	8066	535	6.2
CN0503900000000	05	039	Dallas County, AR	2002	NA	3822	3510	312	8.2
CN0504100000000	05	041	Desha County, AR	2002	NA	6293	5734	559	8.9
CN0504300000000	05	043	Drew County, AR	2002	NA	8491	7812	679	8
CN0504500000000	05	045	Faulkner County, AR	2002	NA	46674	44285	2389	5.1
CN0504700000000	05	047	Franklin County, AR	2002	NA	8073	7680	393	4.9
CN0504900000000	05	049	Fulton County, AR	2002	NA	4851	4512	339	7
CN0505100000000	05	051	Garland County, AR	2002	NA	38420	36162	2258	5.9
CN0505300000000	05	053	Grant County, AR	2002	NA	8081	7650	431	5.3
CN0505500000000	05	055	Greene County, AR	2002	NA	17120	15959	1161	6.8
CN0505700000000	05	057	Hempstead County, AR	2002	NA	11188	10666	522	4.7
CN0505900000000	05	059	Hot Spring County, AR	2002	NA	14127	13211	916	6.5
CN0506100000000	05	061	Howard County, AR	2002	NA	6559	6199	360	5.5
CN0506300000000	05	063	Independence County, AR	2002	NA	16904	15933	971	5.7
CN0506500000000	05	065	Izard County, AR	2002	NA	5190	4810	380	7.3
CN0506700000000	05	067	Jackson County, AR	2002	NA	7760	7152	608	7.8
CN0506900000000	05	069	Jefferson County, AR	2002	NA	35641	32868	2773	7.8
CN0507100000000	05	071	Johnson County, AR	2002	NA	10480	9953	527	5
CN0507300000000	05	073	Lafayette County, AR	2002	NA	3456	3279	177	5.1
CN0507500000000	05	075	Lawrence County, AR	2002	NA	7868	7314	554	7
CN0507700000000	05	077	Lee County, AR	2002	NA	3728	3384	344	9.2
CN0507900000000	05	079	Lincoln County, AR	2002	NA	5034	4652	382	7.6
CN0508100000000	05	081	Little River County, AR	2002	NA	6506	6219	287	4.4
CN0508300000000	05	083	Logan County, AR	2002	NA	9843	9291	552	5.6
CN0508500000000	05	085	Lonoke County, AR	2002	NA	26979	25789	1190	4.4
CN0508700000000	05	087	Madison County, AR	2002	NA	7173	6917	256	3.6
CN0508900000000	05	089	Marion County, AR	2002	NA	6486	6073	413	6.4
CN0509100000000	05	091	Miller County, AR	2002	NA	18300	17421	879	4.8
CN0509300000000	05	093	Mississippi County, AR	2002	NA	21588	19029	2559	11.9
CN0509500000000	05	095	Monroe County, AR	2002	NA	4018	3725	293	7.3
CN0509700000000	05	097	Montgomery County, AR	2002	NA	4142	3912	230	5.6
CN0509900000000	05	099	Nevada County, AR	2002	NA	4580	4351	229	5
CN0510100000000	05	101	Newton County, AR	2002	NA	3606	3403	203	5.6
CN0510300000000	05	103	Ouachita County, AR	2002	NA	12261	11409	852	6.9
CN0510500000000	05	105	Perry County, AR	2002	NA	4802	4512	290	6
CN0510700000000	05	107	Phillips County, AR	2002	NA	9342	8554	788	8.4
CN0510900000000	05	109	Pike County, AR	2002	NA	5180	4892	288	5.6
CN0511100000000	05	111	Poinsett County, AR	2002	NA	11294	10451	843	7.5
CN0511300000000	05	113	Polk County, AR	2002	NA	8824	8046	778	8.8
CN0511500000000	05	115	Pope County, AR	2002	NA	26668	25272	1396	5.2
CN0511700000000	05	117	Prairie County, AR	2002	NA	4473	4242	231	5.2
CN0511900000000	05	119	Pulaski County, AR	2002	NA	182112	173090	9022	5
CN0512100000000	05	121	Randolph County, AR	2002	NA	8285	7662	623	7.5
CN0512300000000	05	123	St. Francis County, AR	2002	NA	10847	9967	880	8.1
CN0512500000000	05	125	Saline County, AR	2002	NA	43054	41176	1878	4.4
CN0512700000000	05	127	Scott County, AR	2002	NA	4866	4649	217	4.5
CN0512900000000	05	129	Searcy County, AR	2002	NA	3329	3166	163	4.9
CN0513100000000	05	131	Sebastian County, AR	2002	NA	56372	53857	2515	4.5
CN0513300000000	05	133	Sevier County, AR	2002	NA	7364	7042	322	4.4
CN0513500000000	05	135	Sharp County, AR	2002	NA	6418	5931	487	7.6
CN0513700000000	05	137	Stone County, AR	2002	NA	4501	4205	296	6.6
CN0513900000000	05	139	Union County, AR	2002	NA	21334	20122	1212	5.7
CN0514100000000	05	141	Van Buren County, AR	2002	NA	6887	6432	455	6.6
CN0514300000000	05	143	Washington County, AR	2002	NA	88671	85687	2984	3.4
CN0514500000000	05	145	White County, AR	2002	NA	30572	28732	1840	6
CN0514700000000	05	147	Woodruff County, AR	2002	NA	3991	3709	282	7.1
CN0514900000000	05	149	Yell County, AR	2002	NA	9799	9353	446	4.6
CN0600100000000	06	001	Alameda County, CA	2002	NA	771442	720116	51326	6.7
CN0600300000000	06	003	Alpine County, CA	2002	NA	562	520	42	7.5
CN0600500000000	06	005	Amador County, CA	2002	NA	16514	15569	945	5.7
CN0600700000000	06	007	Butte County, CA	2002	NA	97097	89968	7129	7.3
CN0600900000000	06	009	Calaveras County, CA	2002	NA	19681	18411	1270	6.5
CN0601100000000	06	011	Colusa County, CA	2002	NA	9396	8104	1292	13.8
CN0601300000000	06	013	Contra Costa County, CA	2002	NA	510937	481984	28953	5.7
CN0601500000000	06	015	Del Norte County, CA	2002	NA	10217	9332	885	8.7
CN0601700000000	06	017	El Dorado County, CA	2002	NA	86166	81692	4474	5.2
CN0601900000000	06	019	Fresno County, CA	2002	NA	401121	355193	45928	11.4
CN0602100000000	06	021	Glenn County, CA	2002	NA	11216	10145	1071	9.5
CN0602300000000	06	023	Humboldt County, CA	2002	NA	60748	56697	4051	6.7
CN0602500000000	06	025	Imperial County, CA	2002	NA	57222	48710	8512	14.9
CN0602700000000	06	027	Inyo County, CA	2002	NA	9205	8711	494	5.4
CN0602900000000	06	029	Kern County, CA	2002	NA	305334	275644	29690	9.7
CN0603100000000	06	031	Kings County, CA	2002	NA	51695	45685	6010	11.6
CN0603300000000	06	033	Lake County, CA	2002	NA	25694	23571	2123	8.3
CN0603500000000	06	035	Lassen County, CA	2002	NA	12193	11259	934	7.7
CN0603700000000	06	037	Los Angeles County, CA	2002	NA	4751584	4430944	320640	6.7
CN0603900000000	06	039	Madera County, CA	2002	NA	55534	49681	5853	10.5
CN0604100000000	06	041	Marin County, CA	2002	NA	134540	128032	6508	4.8
CN0604300000000	06	043	Mariposa County, CA	2002	NA	8717	8159	558	6.4
CN0604500000000	06	045	Mendocino County, CA	2002	NA	45730	42707	3023	6.6
CN0604700000000	06	047	Merced County, CA	2002	NA	95700	85269	10431	10.9
CN0604900000000	06	049	Modoc County, CA	2002	NA	4094	3775	319	7.8
CN0605100000000	06	051	Mono County, CA	2002	NA	7876	7476	400	5.1
CN0605300000000	06	053	Monterey County, CA	2002	NA	207756	189317	18439	8.9
CN0605500000000	06	055	Napa County, CA	2002	NA	71138	67927	3211	4.5
CN0605700000000	06	057	Nevada County, CA	2002	NA	48351	45812	2539	5.3
CN0605900000000	06	059	Orange County, CA	2002	NA	1524786	1449509	75277	4.9
CN0606100000000	06	061	Placer County, CA	2002	NA	146214	139052	7162	4.9
CN0606300000000	06	063	Plumas County, CA	2002	NA	10203	9352	851	8.3
CN0606500000000	06	065	Riverside County, CA	2002	NA	746343	698489	47854	6.4
CN0606700000000	06	067	Sacramento County, CA	2002	NA	642116	606097	36019	5.6
CN0606900000000	06	069	San Benito County, CA	2002	NA	26270	23954	2316	8.8
CN0607100000000	06	071	San Bernardino County, CA	2002	NA	786783	739621	47162	6
CN0607300000000	06	073	San Diego County, CA	2002	NA	1442866	1369228	73638	5.1
CN0607500000000	06	075	San Francisco County/city, CA	2002	NA	448114	417259	30855	6.9
CN0607700000000	06	077	San Joaquin County, CA	2002	NA	274127	250023	24104	8.8
CN0607900000000	06	079	San Luis Obispo County, CA	2002	NA	128360	122426	5934	4.6
CN0608100000000	06	081	San Mateo County, CA	2002	NA	377758	356509	21249	5.6
CN0608300000000	06	083	Santa Barbara County, CA	2002	NA	205148	194615	10533	5.1
CN0608500000000	06	085	Santa Clara County, CA	2002	NA	886631	813016	73615	8.3
CN0608700000000	06	087	Santa Cruz County, CA	2002	NA	147450	136639	10811	7.3
CN0608900000000	06	089	Shasta County, CA	2002	NA	81260	75490	5770	7.1
CN0609100000000	06	091	Sierra County, CA	2002	NA	1641	1500	141	8.6
CN0609300000000	06	093	Siskiyou County, CA	2002	NA	18990	17304	1686	8.9
CN0609500000000	06	095	Solano County, CA	2002	NA	202180	190547	11633	5.8
CN0609700000000	06	097	Sonoma County, CA	2002	NA	256699	243765	12934	5
CN0609900000000	06	099	Stanislaus County, CA	2002	NA	219057	198034	21023	9.6
CN0610100000000	06	101	Sutter County, CA	2002	NA	39035	34763	4272	10.9
CN0610300000000	06	103	Tehama County, CA	2002	NA	25491	23671	1820	7.1
CN0610500000000	06	105	Trinity County, CA	2002	NA	5389	4848	541	10
CN0610700000000	06	107	Tulare County, CA	2002	NA	180460	159037	21423	11.9
CN0610900000000	06	109	Tuolumne County, CA	2002	NA	24751	23121	1630	6.6
CN0611100000000	06	111	Ventura County, CA	2002	NA	406073	382801	23272	5.7
CN0611300000000	06	113	Yolo County, CA	2002	NA	90459	85056	5403	6
CN0611500000000	06	115	Yuba County, CA	2002	NA	24987	22550	2437	9.8
CN0800100000000	08	001	Adams County, CO	2002	NA	193149	181364	11785	6.1
CN0800300000000	08	003	Alamosa County, CO	2002	NA	8211	7810	401	4.9
CN0800500000000	08	005	Arapahoe County, CO	2002	NA	285222	269132	16090	5.6
CN0800700000000	08	007	Archuleta County, CO	2002	NA	5662	5361	301	5.3
CN0800900000000	08	009	Baca County, CO	2002	NA	2539	2456	83	3.3
CN0801100000000	08	011	Bent County, CO	2002	NA	2525	2361	164	6.5
CN0801300000000	08	013	Boulder County, CO	2002	NA	163623	154419	9204	5.6
CN0801400000000	08	014	Broomfield County/city, CO	2002	NA	22600	21327	1273	5.6
CN0801500000000	08	015	Chaffee County, CO	2002	NA	7827	7434	393	5
CN0801700000000	08	017	Cheyenne County, CO	2002	NA	1344	1303	41	3.1
CN0801900000000	08	019	Clear Creek County, CO	2002	NA	5984	5682	302	5
CN0802100000000	08	021	Conejos County, CO	2002	NA	3781	3520	261	6.9
CN0802300000000	08	023	Costilla County, CO	2002	NA	1352	1226	126	9.3
CN0802500000000	08	025	Crowley County, CO	2002	NA	1638	1522	116	7.1
CN0802700000000	08	027	Custer County, CO	2002	NA	2008	1924	84	4.2
CN0802900000000	08	029	Delta County, CO	2002	NA	14265	13545	720	5
CN0803100000000	08	031	Denver County/city, CO	2002	NA	299999	280297	19702	6.6
CN0803300000000	08	033	Dolores County, CO	2002	NA	990	912	78	7.9
CN0803500000000	08	035	Douglas County, CO	2002	NA	120707	114415	6292	5.2
CN0803700000000	08	037	Eagle County, CO	2002	NA	26693	25561	1132	4.2
CN0803900000000	08	039	Elbert County, CO	2002	NA	12331	11709	622	5
CN0804100000000	08	041	El Paso County, CO	2002	NA	274923	258447	16476	6
CN0804300000000	08	043	Fremont County, CO	2002	NA	18707	17481	1226	6.6
CN0804500000000	08	045	Garfield County, CO	2002	NA	26784	25594	1190	4.4
CN0804700000000	08	047	Gilpin County, CO	2002	NA	3245	3084	161	5
CN0804900000000	08	049	Grand County, CO	2002	NA	8432	8126	306	3.6
CN0805100000000	08	051	Gunnison County, CO	2002	NA	8548	8196	352	4.1
CN0805300000000	08	053	Hinsdale County, CO	2002	NA	626	603	23	3.7
CN0805500000000	08	055	Huerfano County, CO	2002	NA	3527	3276	251	7.1
CN0805700000000	08	057	Jackson County, CO	2002	NA	1094	1044	50	4.6
CN0805900000000	08	059	Jefferson County, CO	2002	NA	303309	287269	16040	5.3
CN0806100000000	08	061	Kiowa County, CO	2002	NA	959	921	38	4
CN0806300000000	08	063	Kit Carson County, CO	2002	NA	4528	4385	143	3.2
CN0806500000000	08	065	Lake County, CO	2002	NA	4010	3777	233	5.8
CN0806700000000	08	067	La Plata County, CO	2002	NA	26356	25320	1036	3.9
CN0806900000000	08	069	Larimer County, CO	2002	NA	154430	147361	7069	4.6
CN0807100000000	08	071	Las Animas County, CO	2002	NA	7824	7435	389	5
CN0807300000000	08	073	Lincoln County, CO	2002	NA	3065	2949	116	3.8
CN0807500000000	08	075	Logan County, CO	2002	NA	11206	10795	411	3.7
CN0807700000000	08	077	Mesa County, CO	2002	NA	63796	60717	3079	4.8
CN0807900000000	08	079	Mineral County, CO	2002	NA	433	414	19	4.4
CN0808100000000	08	081	Moffat County, CO	2002	NA	7665	7298	367	4.8
CN0808300000000	08	083	Montezuma County, CO	2002	NA	12435	11763	672	5.4
CN0808500000000	08	085	Montrose County, CO	2002	NA	17835	16882	953	5.3
CN0808700000000	08	087	Morgan County, CO	2002	NA	14043	13471	572	4.1
CN0808900000000	08	089	Otero County, CO	2002	NA	9549	8992	557	5.8
CN0809100000000	08	091	Ouray County, CO	2002	NA	2444	2347	97	4
CN0809300000000	08	093	Park County, CO	2002	NA	9061	8595	466	5.1
CN0809500000000	08	095	Phillips County, CO	2002	NA	2518	2439	79	3.1
CN0809700000000	08	097	Pitkin County, CO	2002	NA	10390	9921	469	4.5
CN0809900000000	08	099	Prowers County, CO	2002	NA	7575	7280	295	3.9
CN0810100000000	08	101	Pueblo County, CO	2002	NA	66093	61506	4587	6.9
CN0810300000000	08	103	Rio Blanco County, CO	2002	NA	3691	3580	111	3
CN0810500000000	08	105	Rio Grande County, CO	2002	NA	6523	6144	379	5.8
CN0810700000000	08	107	Routt County, CO	2002	NA	13995	13481	514	3.7
CN0810900000000	08	109	Saguache County, CO	2002	NA	3198	2983	215	6.7
CN0811100000000	08	111	San Juan County, CO	2002	NA	570	529	41	7.2
CN0811300000000	08	113	San Miguel County, CO	2002	NA	5043	4794	249	4.9
CN0811500000000	08	115	Sedgwick County, CO	2002	NA	1638	1582	56	3.4
CN0811700000000	08	117	Summit County, CO	2002	NA	16572	15903	669	4
CN0811900000000	08	119	Teller County, CO	2002	NA	12276	11566	710	5.8
CN0812100000000	08	121	Washington County, CO	2002	NA	2936	2838	98	3.3
CN0812300000000	08	123	Weld County, CO	2002	NA	102298	97081	5217	5.1
CN0812500000000	08	125	Yuma County, CO	2002	NA	6399	6242	157	2.5
CN0900100000000	09	001	Fairfield County, CT	2002	NA	449865	431418	18447	4.1
CN0900300000000	09	003	Hartford County, CT	2002	NA	434196	413629	20567	4.7
CN0900500000000	09	005	Litchfield County, CT	2002	NA	100878	96720	4158	4.1
CN0900700000000	09	007	Middlesex County, CT	2002	NA	87614	84370	3244	3.7
CN0900900000000	09	009	New Haven County, CT	2002	NA	423796	404024	19772	4.7
CN0901100000000	09	011	New London County, CT	2002	NA	140315	134872	5443	3.9
CN0901300000000	09	013	Tolland County, CT	2002	NA	78143	75467	2676	3.4
CN0901500000000	09	015	Windham County, CT	2002	NA	59344	56624	2720	4.6
CN1000100000000	10	001	Kent County, DE	2002	NA	65666	63071	2595	4
CN1000300000000	10	003	New Castle County, DE	2002	NA	268410	257322	11088	4.1
CN1000500000000	10	005	Sussex County, DE	2002	NA	82707	79626	3081	3.7
CN1100100000000	11	001	District of Columbia	2002	NA	306099	286496	19603	6.4
CN1200100000000	12	001	Alachua County, FL	2002	NA	118163	113387	4776	4
CN1200300000000	12	003	Baker County, FL	2002	NA	10459	9957	502	4.8
CN1200500000000	12	005	Bay County, FL	2002	NA	74110	69782	4328	5.8
CN1200700000000	12	007	Bradford County, FL	2002	NA	10960	10470	490	4.5
CN1200900000000	12	009	Brevard County, FL	2002	NA	238028	224093	13935	5.9
CN1201100000000	12	011	Broward County, FL	2002	NA	898709	844709	54000	6
CN1201300000000	12	013	Calhoun County, FL	2002	NA	5369	5085	284	5.3
CN1201500000000	12	015	Charlotte County, FL	2002	NA	59632	56180	3452	5.8
CN1201700000000	12	017	Citrus County, FL	2002	NA	46276	43120	3156	6.8
CN1201900000000	12	019	Clay County, FL	2002	NA	76705	72821	3884	5.1
CN1202100000000	12	021	Collier County, FL	2002	NA	129514	122728	6786	5.2
CN1202300000000	12	023	Columbia County, FL	2002	NA	26038	24606	1432	5.5
CN1202700000000	12	027	DeSoto County, FL	2002	NA	13495	12642	853	6.3
CN1202900000000	12	029	Dixie County, FL	2002	NA	5983	5666	317	5.3
CN1203100000000	12	031	Duval County, FL	2002	NA	409007	385707	23300	5.7
CN1203300000000	12	033	Escambia County, FL	2002	NA	129838	122747	7091	5.5
CN1203500000000	12	035	Flagler County, FL	2002	NA	23591	22158	1433	6.1
CN1203700000000	12	037	Franklin County, FL	2002	NA	4896	4649	247	5
CN1203900000000	12	039	Gadsden County, FL	2002	NA	20000	18863	1137	5.7
CN1204100000000	12	041	Gilchrist County, FL	2002	NA	6726	6390	336	5
CN1204300000000	12	043	Glades County, FL	2002	NA	4566	4290	276	6
CN1204500000000	12	045	Gulf County, FL	2002	NA	5502	5194	308	5.6
CN1204700000000	12	047	Hamilton County, FL	2002	NA	4364	4091	273	6.3
CN1204900000000	12	049	Hardee County, FL	2002	NA	10997	10184	813	7.4
CN1205100000000	12	051	Hendry County, FL	2002	NA	17318	15828	1490	8.6
CN1205300000000	12	053	Hernando County, FL	2002	NA	51545	47944	3601	7
CN1205500000000	12	055	Highlands County, FL	2002	NA	36262	33986	2276	6.3
CN1205700000000	12	057	Hillsborough County, FL	2002	NA	545558	515356	30202	5.5
CN1205900000000	12	059	Holmes County, FL	2002	NA	7660	7210	450	5.9
CN1206100000000	12	061	Indian River County, FL	2002	NA	53979	49958	4021	7.4
CN1206300000000	12	063	Jackson County, FL	2002	NA	20079	19117	962	4.8
CN1206500000000	12	065	Jefferson County, FL	2002	NA	6407	6108	299	4.7
CN1206700000000	12	067	Lafayette County, FL	2002	NA	2761	2624	137	5
CN1206900000000	12	069	Lake County, FL	2002	NA	99439	93581	5858	5.9
CN1207100000000	12	071	Lee County, FL	2002	NA	228531	217154	11377	5
CN1207300000000	12	073	Leon County, FL	2002	NA	133250	127314	5936	4.5
CN1207500000000	12	075	Levy County, FL	2002	NA	14816	13937	879	5.9
CN1207700000000	12	077	Liberty County, FL	2002	NA	2930	2796	134	4.6
CN1207900000000	12	079	Madison County, FL	2002	NA	7220	6835	385	5.3
CN1208100000000	12	081	Manatee County, FL	2002	NA	132835	125956	6879	5.2
CN1208300000000	12	083	Marion County, FL	2002	NA	111655	104907	6748	6
CN1208500000000	12	085	Martin County, FL	2002	NA	59658	56135	3523	5.9
CN1208600000000	12	086	Miami-Dade County, FL	2002	NA	1086424	1030669	55755	5.1
CN1208700000000	12	087	Monroe County, FL	2002	NA	46717	44849	1868	4
CN1208900000000	12	089	Nassau County, FL	2002	NA	30576	29053	1523	5
CN1209100000000	12	091	Okaloosa County, FL	2002	NA	85706	81940	3766	4.4
CN1209300000000	12	093	Okeechobee County, FL	2002	NA	16151	15015	1136	7
CN1209500000000	12	095	Orange County, FL	2002	NA	507357	477859	29498	5.8
CN1209700000000	12	097	Osceola County, FL	2002	NA	96824	91003	5821	6
CN1209900000000	12	099	Palm Beach County, FL	2002	NA	581208	544442	36766	6.3
CN1210100000000	12	101	Pasco County, FL	2002	NA	159092	149351	9741	6.1
CN1210300000000	12	103	Pinellas County, FL	2002	NA	465976	439107	26869	5.8
CN1210500000000	12	105	Polk County, FL	2002	NA	237919	223792	14127	5.9
CN1210700000000	12	107	Putnam County, FL	2002	NA	29725	27725	2000	6.7
CN1210900000000	12	109	St. Johns County, FL	2002	NA	70321	67123	3198	4.5
CN1211100000000	12	111	St. Lucie County, FL	2002	NA	94713	87697	7016	7.4
CN1211300000000	12	113	Santa Rosa County, FL	2002	NA	57328	54275	3053	5.3
CN1211500000000	12	115	Sarasota County, FL	2002	NA	157826	149946	7880	5
CN1211700000000	12	117	Seminole County, FL	2002	NA	213794	201686	12108	5.7
CN1211900000000	12	119	Sumter County, FL	2002	NA	18632	17514	1118	6
CN1212100000000	12	121	Suwannee County, FL	2002	NA	16028	15197	831	5.2
CN1212300000000	12	123	Taylor County, FL	2002	NA	8547	7967	580	6.8
CN1212500000000	12	125	Union County, FL	2002	NA	4819	4632	187	3.9
CN1212700000000	12	127	Volusia County, FL	2002	NA	220727	208182	12545	5.7
CN1212900000000	12	129	Wakulla County, FL	2002	NA	12712	12155	557	4.4
CN1213100000000	12	131	Walton County, FL	2002	NA	21553	20562	991	4.6
CN1213300000000	12	133	Washington County, FL	2002	NA	8906	8346	560	6.3
CN1300100000000	13	001	Appling County, GA	2002	NA	8194	7561	633	7.7
CN1300300000000	13	003	Atkinson County, GA	2002	NA	3411	3211	200	5.9
CN1300500000000	13	005	Bacon County, GA	2002	NA	4185	3923	262	6.3
CN1300700000000	13	007	Baker County, GA	2002	NA	1688	1604	84	5
CN1300900000000	13	009	Baldwin County, GA	2002	NA	19582	18624	958	4.9
CN1301100000000	13	011	Banks County, GA	2002	NA	8107	7764	343	4.2
CN1301300000000	13	013	Barrow County, GA	2002	NA	26798	25493	1305	4.9
CN1301500000000	13	015	Bartow County, GA	2002	NA	42311	39961	2350	5.6
CN1301700000000	13	017	Ben Hill County, GA	2002	NA	7890	7441	449	5.7
CN1301900000000	13	019	Berrien County, GA	2002	NA	8104	7768	336	4.1
CN1302100000000	13	021	Bibb County, GA	2002	NA	70455	66892	3563	5.1
CN1302300000000	13	023	Bleckley County, GA	2002	NA	5154	4862	292	5.7
CN1302500000000	13	025	Brantley County, GA	2002	NA	7018	6636	382	5.4
CN1302700000000	13	027	Brooks County, GA	2002	NA	7843	7479	364	4.6
CN1302900000000	13	029	Bryan County, GA	2002	NA	12545	12088	457	3.6
CN1303100000000	13	031	Bulloch County, GA	2002	NA	28170	26946	1224	4.3
CN1303300000000	13	033	Burke County, GA	2002	NA	9565	8912	653	6.8
CN1303500000000	13	035	Butts County, GA	2002	NA	9472	8946	526	5.6
CN1303700000000	13	037	Calhoun County, GA	2002	NA	2355	2190	165	7
CN1303900000000	13	039	Camden County, GA	2002	NA	18370	17546	824	4.5
CN1304300000000	13	043	Candler County, GA	2002	NA	4037	3850	187	4.6
CN1304500000000	13	045	Carroll County, GA	2002	NA	46735	44249	2486	5.3
CN1304700000000	13	047	Catoosa County, GA	2002	NA	31507	30434	1073	3.4
CN1304900000000	13	049	Charlton County, GA	2002	NA	4092	3890	202	4.9
CN1305100000000	13	051	Chatham County, GA	2002	NA	114891	109941	4950	4.3
CN1305300000000	13	053	Chattahoochee County, GA	2002	NA	2665	2433	232	8.7
CN1305500000000	13	055	Chattooga County, GA	2002	NA	11253	10780	473	4.2
CN1305700000000	13	057	Cherokee County, GA	2002	NA	88668	85028	3640	4.1
CN1305900000000	13	059	Clarke County, GA	2002	NA	55634	53411	2223	4
CN1306100000000	13	061	Clay County, GA	2002	NA	1458	1389	69	4.7
CN1306300000000	13	063	Clayton County, GA	2002	NA	130859	123136	7723	5.9
CN1306500000000	13	065	Clinch County, GA	2002	NA	2384	2248	136	5.7
CN1306700000000	13	067	Cobb County, GA	2002	NA	364098	347181	16917	4.6
CN1306900000000	13	069	Coffee County, GA	2002	NA	17052	16125	927	5.4
CN1307100000000	13	071	Colquitt County, GA	2002	NA	18327	17380	947	5.2
CN1307300000000	13	073	Columbia County, GA	2002	NA	50221	48394	1827	3.6
CN1307500000000	13	075	Cook County, GA	2002	NA	7123	6785	338	4.7
CN1307700000000	13	077	Coweta County, GA	2002	NA	50851	48573	2278	4.5
CN1307900000000	13	079	Crawford County, GA	2002	NA	5926	5640	286	4.8
CN1308100000000	13	081	Crisp County, GA	2002	NA	9502	8934	568	6
CN1308300000000	13	083	Dade County, GA	2002	NA	8105	7731	374	4.6
CN1308500000000	13	085	Dawson County, GA	2002	NA	9462	9035	427	4.5
CN1308700000000	13	087	Decatur County, GA	2002	NA	11864	11147	717	6
CN1308900000000	13	089	DeKalb County, GA	2002	NA	374102	352718	21384	5.7
CN1309100000000	13	091	Dodge County, GA	2002	NA	8569	8080	489	5.7
CN1309300000000	13	093	Dooly County, GA	2002	NA	4696	4426	270	5.7
CN1309500000000	13	095	Dougherty County, GA	2002	NA	40582	38102	2480	6.1
CN1309700000000	13	097	Douglas County, GA	2002	NA	52839	50359	2480	4.7
CN1309900000000	13	099	Early County, GA	2002	NA	5541	5240	301	5.4
CN1310100000000	13	101	Echols County, GA	2002	NA	1980	1912	68	3.4
CN1310300000000	13	103	Effingham County, GA	2002	NA	20985	20180	805	3.8
CN1310500000000	13	105	Elbert County, GA	2002	NA	10153	9558	595	5.9
CN1310700000000	13	107	Emanuel County, GA	2002	NA	9899	9352	547	5.5
CN1310900000000	13	109	Evans County, GA	2002	NA	4708	4491	217	4.6
CN1311100000000	13	111	Fannin County, GA	2002	NA	9556	9042	514	5.4
CN1311300000000	13	113	Fayette County, GA	2002	NA	49998	48185	1813	3.6
CN1311500000000	13	115	Floyd County, GA	2002	NA	46720	44377	2343	5
CN1311700000000	13	117	Forsyth County, GA	2002	NA	64342	61713	2629	4.1
CN1311900000000	13	119	Franklin County, GA	2002	NA	10141	9589	552	5.4
CN1312100000000	13	121	Fulton County, GA	2002	NA	442733	417741	24992	5.6
CN1312300000000	13	123	Gilmer County, GA	2002	NA	12154	11626	528	4.3
CN1312500000000	13	125	Glascock County, GA	2002	NA	1183	1119	64	5.4
CN1312700000000	13	127	Glynn County, GA	2002	NA	35365	33934	1431	4
CN1312900000000	13	129	Gordon County, GA	2002	NA	24258	23025	1233	5.1
CN1313100000000	13	131	Grady County, GA	2002	NA	11049	10574	475	4.3
CN1313300000000	13	133	Greene County, GA	2002	NA	6298	5720	578	9.2
CN1313500000000	13	135	Gwinnett County, GA	2002	NA	365238	348206	17032	4.7
CN1313700000000	13	137	Habersham County, GA	2002	NA	18746	17940	806	4.3
CN1313900000000	13	139	Hall County, GA	2002	NA	75653	72420	3233	4.3
CN1314100000000	13	141	Hancock County, GA	2002	NA	3380	3092	288	8.5
CN1314300000000	13	143	Haralson County, GA	2002	NA	12417	11826	591	4.8
CN1314500000000	13	145	Harris County, GA	2002	NA	13465	12967	498	3.7
CN1314700000000	13	147	Hart County, GA	2002	NA	10895	10247	648	5.9
CN1314900000000	13	149	Heard County, GA	2002	NA	5016	4738	278	5.5
CN1315100000000	13	151	Henry County, GA	2002	NA	75070	71914	3156	4.2
CN1315300000000	13	153	Houston County, GA	2002	NA	56878	54692	2186	3.8
CN1315500000000	13	155	Irwin County, GA	2002	NA	4481	4226	255	5.7
CN1315700000000	13	157	Jackson County, GA	2002	NA	21999	20857	1142	5.2
CN1315900000000	13	159	Jasper County, GA	2002	NA	5933	5651	282	4.8
CN1316100000000	13	161	Jeff Davis County, GA	2002	NA	5726	5249	477	8.3
CN1316300000000	13	163	Jefferson County, GA	2002	NA	6738	6133	605	9
CN1316500000000	13	165	Jenkins County, GA	2002	NA	3395	3165	230	6.8
CN1316700000000	13	167	Johnson County, GA	2002	NA	3654	3415	239	6.5
CN1316900000000	13	169	Jones County, GA	2002	NA	12256	11743	513	4.2
CN1317100000000	13	171	Lamar County, GA	2002	NA	7911	7416	495	6.3
CN1317300000000	13	173	Lanier County, GA	2002	NA	3429	3282	147	4.3
CN1317500000000	13	175	Laurens County, GA	2002	NA	21364	20227	1137	5.3
CN1317700000000	13	177	Lee County, GA	2002	NA	14257	13736	521	3.7
CN1317900000000	13	179	Liberty County, GA	2002	NA	20380	19191	1189	5.8
CN1318100000000	13	181	Lincoln County, GA	2002	NA	3440	3186	254	7.4
CN1318300000000	13	183	Long County, GA	2002	NA	4709	4513	196	4.2
CN1318500000000	13	185	Lowndes County, GA	2002	NA	45986	44216	1770	3.8
CN1318700000000	13	187	Lumpkin County, GA	2002	NA	11173	10702	471	4.2
CN1318900000000	13	189	McDuffie County, GA	2002	NA	10215	9499	716	7
CN1319100000000	13	191	McIntosh County, GA	2002	NA	4881	4635	246	5
CN1319300000000	13	193	Macon County, GA	2002	NA	5154	4756	398	7.7
CN1319500000000	13	195	Madison County, GA	2002	NA	14595	13982	613	4.2
CN1319700000000	13	197	Marion County, GA	2002	NA	3284	3127	157	4.8
CN1319900000000	13	199	Meriwether County, GA	2002	NA	9932	9331	601	6.1
CN1320100000000	13	201	Miller County, GA	2002	NA	3367	3216	151	4.5
CN1320500000000	13	205	Mitchell County, GA	2002	NA	9715	9152	563	5.8
CN1320700000000	13	207	Monroe County, GA	2002	NA	11756	11216	540	4.6
CN1320900000000	13	209	Montgomery County, GA	2002	NA	3780	3519	261	6.9
CN1321100000000	13	211	Morgan County, GA	2002	NA	8570	8207	363	4.2
CN1321300000000	13	213	Murray County, GA	2002	NA	20299	19401	898	4.4
CN1321500000000	13	215	Muscogee County, GA	2002	NA	82436	77880	4556	5.5
CN1321700000000	13	217	Newton County, GA	2002	NA	35675	33880	1795	5
CN1321900000000	13	219	Oconee County, GA	2002	NA	15123	14655	468	3.1
CN1322100000000	13	221	Oglethorpe County, GA	2002	NA	7030	6733	297	4.2
CN1322300000000	13	223	Paulding County, GA	2002	NA	50164	48113	2051	4.1
CN1322500000000	13	225	Peach County, GA	2002	NA	10894	10324	570	5.2
CN1322700000000	13	227	Pickens County, GA	2002	NA	13197	12646	551	4.2
CN1322900000000	13	229	Pierce County, GA	2002	NA	7547	7188	359	4.8
CN1323100000000	13	231	Pike County, GA	2002	NA	7134	6764	370	5.2
CN1323300000000	13	233	Polk County, GA	2002	NA	19003	17982	1021	5.4
CN1323500000000	13	235	Pulaski County, GA	2002	NA	4136	3900	236	5.7
CN1323700000000	13	237	Putnam County, GA	2002	NA	9237	8816	421	4.6
CN1323900000000	13	239	Quitman County, GA	2002	NA	993	930	63	6.3
CN1324100000000	13	241	Rabun County, GA	2002	NA	7049	6754	295	4.2
CN1324300000000	13	243	Randolph County, GA	2002	NA	2951	2687	264	8.9
CN1324500000000	13	245	Richmond County, GA	2002	NA	87790	82907	4883	5.6
CN1324700000000	13	247	Rockdale County, GA	2002	NA	36973	35178	1795	4.9
CN1324900000000	13	249	Schley County, GA	2002	NA	1677	1596	81	4.8
CN1325100000000	13	251	Screven County, GA	2002	NA	6415	6058	357	5.6
CN1325300000000	13	253	Seminole County, GA	2002	NA	3942	3715	227	5.8
CN1325500000000	13	255	Spalding County, GA	2002	NA	27852	26112	1740	6.2
CN1325700000000	13	257	Stephens County, GA	2002	NA	13736	13029	707	5.1
CN1325900000000	13	259	Stewart County, GA	2002	NA	1966	1844	122	6.2
CN1326100000000	13	261	Sumter County, GA	2002	NA	14675	13769	906	6.2
CN1326300000000	13	263	Talbot County, GA	2002	NA	2890	2726	164	5.7
CN1326500000000	13	265	Taliaferro County, GA	2002	NA	786	696	90	11.5
CN1326700000000	13	267	Tattnall County, GA	2002	NA	8468	8012	456	5.4
CN1326900000000	13	269	Taylor County, GA	2002	NA	3305	3108	197	6
CN1327100000000	13	271	Telfair County, GA	2002	NA	4004	3591	413	10.3
CN1327300000000	13	273	Terrell County, GA	2002	NA	4554	4219	335	7.4
CN1327500000000	13	275	Thomas County, GA	2002	NA	20947	19998	949	4.5
CN1327700000000	13	277	Tift County, GA	2002	NA	18744	17901	843	4.5
CN1327900000000	13	279	Toombs County, GA	2002	NA	11563	10716	847	7.3
CN1328100000000	13	281	Towns County, GA	2002	NA	4734	4549	185	3.9
CN1328300000000	13	283	Treutlen County, GA	2002	NA	2601	2404	197	7.6
CN1328500000000	13	285	Troup County, GA	2002	NA	29326	27699	1627	5.5
CN1328700000000	13	287	Turner County, GA	2002	NA	4713	4399	314	6.7
CN1328900000000	13	289	Twiggs County, GA	2002	NA	4606	4317	289	6.3
CN1329100000000	13	291	Union County, GA	2002	NA	8987	8587	400	4.5
CN1329300000000	13	293	Upson County, GA	2002	NA	11686	10625	1061	9.1
CN1329500000000	13	295	Walker County, GA	2002	NA	31174	29790	1384	4.4
CN1329700000000	13	297	Walton County, GA	2002	NA	34070	32581	1489	4.4
CN1329900000000	13	299	Ware County, GA	2002	NA	14747	13946	801	5.4
CN1330100000000	13	301	Warren County, GA	2002	NA	2554	2281	273	10.7
CN1330300000000	13	303	Washington County, GA	2002	NA	8274	7789	485	5.9
CN1330500000000	13	305	Wayne County, GA	2002	NA	11093	10482	611	5.5
CN1330700000000	13	307	Webster County, GA	2002	NA	1003	953	50	5
CN1330900000000	13	309	Wheeler County, GA	2002	NA	2390	2232	158	6.6
CN1331100000000	13	311	White County, GA	2002	NA	11085	10629	456	4.1
CN1331300000000	13	313	Whitfield County, GA	2002	NA	44291	42327	1964	4.4
CN1331500000000	13	315	Wilcox County, GA	2002	NA	3275	3076	199	6.1
CN1331700000000	13	317	Wilkes County, GA	2002	NA	4891	4501	390	8
CN1331900000000	13	319	Wilkinson County, GA	2002	NA	4401	4154	247	5.6
CN1332100000000	13	321	Worth County, GA	2002	NA	10034	9519	515	5.1
CN1500100000000	15	001	Hawaii County, HI	2002	NA	75449	71841	3608	4.8
CN1500300000000	15	003	Honolulu County/city, HI	2002	NA	424149	406706	17443	4.1
CN1500700000000	15	007	Kauai County, HI	2002	NA	29979	28605	1374	4.6
CN1500900000000	15	009	Maui County, HI	2002	NA	71349	68443	2906	4.1
CN1600100000000	16	001	Ada County, ID	2002	NA	175742	167437	8305	4.7
CN1600300000000	16	003	Adams County, ID	2002	NA	1874	1649	225	12
CN1600500000000	16	005	Bannock County, ID	2002	NA	38701	36417	2284	5.9
CN1600700000000	16	007	Bear Lake County, ID	2002	NA	2885	2737	148	5.1
CN1600900000000	16	009	Benewah County, ID	2002	NA	4024	3572	452	11.2
CN1601100000000	16	011	Bingham County, ID	2002	NA	20285	19350	935	4.6
CN1601300000000	16	013	Blaine County, ID	2002	NA	12917	12395	522	4
CN1601500000000	16	015	Boise County, ID	2002	NA	3457	3286	171	4.9
CN1601700000000	16	017	Bonner County, ID	2002	NA	18612	17110	1502	8.1
CN1601900000000	16	019	Bonneville County, ID	2002	NA	43647	42001	1646	3.8
CN1602100000000	16	021	Boundary County, ID	2002	NA	4056	3696	360	8.9
CN1602300000000	16	023	Butte County, ID	2002	NA	1358	1293	65	4.8
CN1602500000000	16	025	Camas County, ID	2002	NA	578	559	19	3.3
CN1602700000000	16	027	Canyon County, ID	2002	NA	70787	66409	4378	6.2
CN1602900000000	16	029	Caribou County, ID	2002	NA	3369	3144	225	6.7
CN1603100000000	16	031	Cassia County, ID	2002	NA	10340	9791	549	5.3
CN1603300000000	16	033	Clark County, ID	2002	NA	504	474	30	6
CN1603500000000	16	035	Clearwater County, ID	2002	NA	3495	3022	473	13.5
CN1603700000000	16	037	Custer County, ID	2002	NA	2562	2394	168	6.6
CN1603900000000	16	039	Elmore County, ID	2002	NA	10960	10236	724	6.6
CN1604100000000	16	041	Franklin County, ID	2002	NA	5724	5465	259	4.5
CN1604300000000	16	043	Fremont County, ID	2002	NA	5880	5608	272	4.6
CN1604500000000	16	045	Gem County, ID	2002	NA	7108	6584	524	7.4
CN1604700000000	16	047	Gooding County, ID	2002	NA	7243	6959	284	3.9
CN1604900000000	16	049	Idaho County, ID	2002	NA	7089	6476	613	8.6
CN1605100000000	16	051	Jefferson County, ID	2002	NA	9465	9084	381	4
CN1605300000000	16	053	Jerome County, ID	2002	NA	9604	9186	418	4.4
CN1605500000000	16	055	Kootenai County, ID	2002	NA	60344	56010	4334	7.2
CN1605700000000	16	057	Latah County, ID	2002	NA	16641	15871	770	4.6
CN1605900000000	16	059	Lemhi County, ID	2002	NA	3818	3528	290	7.6
CN1606100000000	16	061	Lewis County, ID	2002	NA	1753	1645	108	6.2
CN1606300000000	16	063	Lincoln County, ID	2002	NA	2293	2173	120	5.2
CN1606500000000	16	065	Madison County, ID	2002	NA	13791	13365	426	3.1
CN1606700000000	16	067	Minidoka County, ID	2002	NA	9838	9212	626	6.4
CN1606900000000	16	069	Nez Perce County, ID	2002	NA	19406	18376	1030	5.3
CN1607100000000	16	071	Oneida County, ID	2002	NA	1948	1868	80	4.1
CN1607300000000	16	073	Owyhee County, ID	2002	NA	4748	4533	215	4.5
CN1607500000000	16	075	Payette County, ID	2002	NA	10069	9222	847	8.4
CN1607700000000	16	077	Power County, ID	2002	NA	3563	3336	227	6.4
CN1607900000000	16	079	Shoshone County, ID	2002	NA	5463	4791	672	12.3
CN1608100000000	16	081	Teton County, ID	2002	NA	4023	3888	135	3.4
CN1608300000000	16	083	Twin Falls County, ID	2002	NA	35494	33960	1534	4.3
CN1608500000000	16	085	Valley County, ID	2002	NA	4014	3678	336	8.4
CN1608700000000	16	087	Washington County, ID	2002	NA	5117	4761	356	7
CN1700100000000	17	001	Adams County, IL	2002	NA	35779	34173	1606	4.5
CN1700300000000	17	003	Alexander County, IL	2002	NA	3460	3146	314	9.1
CN1700500000000	17	005	Bond County, IL	2002	NA	8230	7781	449	5.5
CN1700700000000	17	007	Boone County, IL	2002	NA	22299	20654	1645	7.4
CN1700900000000	17	009	Brown County, IL	2002	NA	3031	2924	107	3.5
CN1701100000000	17	011	Bureau County, IL	2002	NA	18366	17304	1062	5.8
CN1701300000000	17	013	Calhoun County, IL	2002	NA	2438	2286	152	6.2
CN1701500000000	17	015	Carroll County, IL	2002	NA	8268	7701	567	6.9
CN1701700000000	17	017	Cass County, IL	2002	NA	7188	6840	348	4.8
CN1701900000000	17	019	Champaign County, IL	2002	NA	99242	95219	4023	4.1
CN1702100000000	17	021	Christian County, IL	2002	NA	17149	16135	1014	5.9
CN1702300000000	17	023	Clark County, IL	2002	NA	8549	7982	567	6.6
CN1702500000000	17	025	Clay County, IL	2002	NA	6822	6382	440	6.4
CN1702700000000	17	027	Clinton County, IL	2002	NA	18044	17195	849	4.7
CN1702900000000	17	029	Coles County, IL	2002	NA	27134	25627	1507	5.6
CN1703100000000	17	031	Cook County, IL	2002	NA	2633014	2431773	201241	7.6
CN1703300000000	17	033	Crawford County, IL	2002	NA	9335	8745	590	6.3
CN1703500000000	17	035	Cumberland County, IL	2002	NA	5674	5319	355	6.3
CN1703700000000	17	037	DeKalb County, IL	2002	NA	50787	48143	2644	5.2
CN1703900000000	17	039	De Witt County, IL	2002	NA	8373	7841	532	6.4
CN1704100000000	17	041	Douglas County, IL	2002	NA	10601	10096	505	4.8
CN1704300000000	17	043	DuPage County, IL	2002	NA	517534	488180	29354	5.7
CN1704500000000	17	045	Edgar County, IL	2002	NA	9786	9217	569	5.8
CN1704700000000	17	047	Edwards County, IL	2002	NA	3498	3327	171	4.9
CN1704900000000	17	049	Effingham County, IL	2002	NA	17658	16725	933	5.3
CN1705100000000	17	051	Fayette County, IL	2002	NA	9835	9166	669	6.8
CN1705300000000	17	053	Ford County, IL	2002	NA	7217	6888	329	4.6
CN1705500000000	17	055	Franklin County, IL	2002	NA	16985	15657	1328	7.8
CN1705700000000	17	057	Fulton County, IL	2002	NA	17351	16194	1157	6.7
CN1705900000000	17	059	Gallatin County, IL	2002	NA	2732	2537	195	7.1
CN1706100000000	17	061	Greene County, IL	2002	NA	6983	6576	407	5.8
CN1706300000000	17	063	Grundy County, IL	2002	NA	20857	19285	1572	7.5
CN1706500000000	17	065	Hamilton County, IL	2002	NA	3990	3745	245	6.1
CN1706700000000	17	067	Hancock County, IL	2002	NA	10512	9913	599	5.7
CN1706900000000	17	069	Hardin County, IL	2002	NA	1930	1781	149	7.7
CN1707100000000	17	071	Henderson County, IL	2002	NA	4089	3830	259	6.3
CN1707300000000	17	073	Henry County, IL	2002	NA	26087	24678	1409	5.4
CN1707500000000	17	075	Iroquois County, IL	2002	NA	15830	14914	916	5.8
CN1707700000000	17	077	Jackson County, IL	2002	NA	30563	29106	1457	4.8
CN1707900000000	17	079	Jasper County, IL	2002	NA	5223	4935	288	5.5
CN1708100000000	17	081	Jefferson County, IL	2002	NA	19475	18360	1115	5.7
CN1708300000000	17	083	Jersey County, IL	2002	NA	11046	10446	600	5.4
CN1708500000000	17	085	Jo Daviess County, IL	2002	NA	12561	11963	598	4.8
CN1708700000000	17	087	Johnson County, IL	2002	NA	5005	4720	285	5.7
CN1708900000000	17	089	Kane County, IL	2002	NA	232350	217927	14423	6.2
CN1709100000000	17	091	Kankakee County, IL	2002	NA	51698	48376	3322	6.4
CN1709300000000	17	093	Kendall County, IL	2002	NA	34833	32870	1963	5.6
CN1709500000000	17	095	Knox County, IL	2002	NA	26568	24734	1834	6.9
CN1709700000000	17	097	Lake County, IL	2002	NA	339373	321542	17831	5.3
CN1709900000000	17	099	LaSalle County, IL	2002	NA	55065	51232	3833	7
CN1710100000000	17	101	Lawrence County, IL	2002	NA	8233	7799	434	5.3
CN1710300000000	17	103	Lee County, IL	2002	NA	17317	16390	927	5.4
CN1710500000000	17	105	Livingston County, IL	2002	NA	18933	17958	975	5.1
CN1710700000000	17	107	Logan County, IL	2002	NA	14133	13353	780	5.5
CN1710900000000	17	109	McDonough County, IL	2002	NA	16536	15748	788	4.8
CN1711100000000	17	111	McHenry County, IL	2002	NA	154970	146051	8919	5.8
CN1711300000000	17	113	McLean County, IL	2002	NA	86495	83348	3147	3.6
CN1711500000000	17	115	Macon County, IL	2002	NA	52545	48539	4006	7.6
CN1711700000000	17	117	Macoupin County, IL	2002	NA	23908	22556	1352	5.7
CN1711900000000	17	119	Madison County, IL	2002	NA	130915	123800	7115	5.4
CN1712100000000	17	121	Marion County, IL	2002	NA	18750	17173	1577	8.4
CN1712300000000	17	123	Marshall County, IL	2002	NA	6812	6404	408	6
CN1712500000000	17	125	Mason County, IL	2002	NA	7893	7344	549	7
CN1712700000000	17	127	Massac County, IL	2002	NA	7172	6743	429	6
CN1712900000000	17	129	Menard County, IL	2002	NA	6878	6584	294	4.3
CN1713100000000	17	131	Mercer County, IL	2002	NA	8606	8038	568	6.6
CN1713300000000	17	133	Monroe County, IL	2002	NA	15848	15204	644	4.1
CN1713500000000	17	135	Montgomery County, IL	2002	NA	13459	12525	934	6.9
CN1713700000000	17	137	Morgan County, IL	2002	NA	17920	17015	905	5.1
CN1713900000000	17	139	Moultrie County, IL	2002	NA	7360	6974	386	5.2
CN1714100000000	17	141	Ogle County, IL	2002	NA	25707	24162	1545	6
CN1714300000000	17	143	Peoria County, IL	2002	NA	88873	83775	5098	5.7
CN1714500000000	17	145	Perry County, IL	2002	NA	10323	9585	738	7.1
CN1714700000000	17	147	Piatt County, IL	2002	NA	8915	8499	416	4.7
CN1714900000000	17	149	Pike County, IL	2002	NA	8539	8062	477	5.6
CN1715100000000	17	151	Pope County, IL	2002	NA	1983	1843	140	7.1
CN1715300000000	17	153	Pulaski County, IL	2002	NA	3032	2801	231	7.6
CN1715500000000	17	155	Putnam County, IL	2002	NA	3113	2870	243	7.8
CN1715700000000	17	157	Randolph County, IL	2002	NA	15403	14566	837	5.4
CN1715900000000	17	159	Richland County, IL	2002	NA	7471	7043	428	5.7
CN1716100000000	17	161	Rock Island County, IL	2002	NA	74830	70840	3990	5.3
CN1716300000000	17	163	St. Clair County, IL	2002	NA	117891	110542	7349	6.2
CN1716500000000	17	165	Saline County, IL	2002	NA	11703	10915	788	6.7
CN1716700000000	17	167	Sangamon County, IL	2002	NA	104225	99509	4716	4.5
CN1716900000000	17	169	Schuyler County, IL	2002	NA	4228	4040	188	4.4
CN1717100000000	17	171	Scott County, IL	2002	NA	2853	2693	160	5.6
CN1717300000000	17	173	Shelby County, IL	2002	NA	11439	10767	672	5.9
CN1717500000000	17	175	Stark County, IL	2002	NA	2795	2590	205	7.3
CN1717700000000	17	177	Stephenson County, IL	2002	NA	25277	23706	1571	6.2
CN1717900000000	17	179	Tazewell County, IL	2002	NA	65499	62114	3385	5.2
CN1718100000000	17	181	Union County, IL	2002	NA	8277	7709	568	6.9
CN1718300000000	17	183	Vermilion County, IL	2002	NA	37305	34600	2705	7.3
CN1718500000000	17	185	Wabash County, IL	2002	NA	6710	6353	357	5.3
CN1718700000000	17	187	Warren County, IL	2002	NA	9445	8922	523	5.5
CN1718900000000	17	189	Washington County, IL	2002	NA	8405	8018	387	4.6
CN1719100000000	17	191	Wayne County, IL	2002	NA	8026	7587	439	5.5
CN1719300000000	17	193	White County, IL	2002	NA	7808	7414	394	5
CN1719500000000	17	195	Whiteside County, IL	2002	NA	29317	27421	1896	6.5
CN1719700000000	17	197	Will County, IL	2002	NA	295338	276216	19122	6.5
CN1719900000000	17	199	Williamson County, IL	2002	NA	30393	28676	1717	5.6
CN1720100000000	17	201	Winnebago County, IL	2002	NA	140569	130715	9854	7
CN1720300000000	17	203	Woodford County, IL	2002	NA	18458	17714	744	4
CN1800100000000	18	001	Adams County, IN	2002	NA	15885	15151	734	4.6
CN1800300000000	18	003	Allen County, IN	2002	NA	176968	168157	8811	5
CN1800500000000	18	005	Bartholomew County, IN	2002	NA	35917	34195	1722	4.8
CN1800700000000	18	007	Benton County, IN	2002	NA	4900	4653	247	5
CN1800900000000	18	009	Blackford County, IN	2002	NA	7020	6577	443	6.3
CN1801100000000	18	011	Boone County, IN	2002	NA	25483	24513	970	3.8
CN1801300000000	18	013	Brown County, IN	2002	NA	8085	7683	402	5
CN1801500000000	18	015	Carroll County, IN	2002	NA	10863	10338	525	4.8
CN1801700000000	18	017	Cass County, IN	2002	NA	20592	19405	1187	5.8
CN1801900000000	18	019	Clark County, IN	2002	NA	52321	49569	2752	5.3
CN1802100000000	18	021	Clay County, IN	2002	NA	13144	12343	801	6.1
CN1802300000000	18	023	Clinton County, IN	2002	NA	16670	15879	791	4.7
CN1802500000000	18	025	Crawford County, IN	2002	NA	5337	4959	378	7.1
CN1802700000000	18	027	Daviess County, IN	2002	NA	14096	13486	610	4.3
CN1802900000000	18	029	Dearborn County, IN	2002	NA	25254	23940	1314	5.2
CN1803100000000	18	031	Decatur County, IN	2002	NA	13429	12915	514	3.8
CN1803300000000	18	033	DeKalb County, IN	2002	NA	21807	20623	1184	5.4
CN1803500000000	18	035	Delaware County, IN	2002	NA	59148	55635	3513	5.9
CN1803700000000	18	037	Dubois County, IN	2002	NA	22106	21277	829	3.8
CN1803900000000	18	039	Elkhart County, IN	2002	NA	94888	90372	4516	4.8
CN1804100000000	18	041	Fayette County, IN	2002	NA	11928	11024	904	7.6
CN1804300000000	18	043	Floyd County, IN	2002	NA	37662	35834	1828	4.9
CN1804500000000	18	045	Fountain County, IN	2002	NA	8514	8004	510	6
CN1804700000000	18	047	Franklin County, IN	2002	NA	11646	10980	666	5.7
CN1804900000000	18	049	Fulton County, IN	2002	NA	10440	9800	640	6.1
CN1805100000000	18	051	Gibson County, IN	2002	NA	17271	16510	761	4.4
CN1805300000000	18	053	Grant County, IN	2002	NA	34986	32702	2284	6.5
CN1805500000000	18	055	Greene County, IN	2002	NA	16421	15434	987	6
CN1805700000000	18	057	Hamilton County, IN	2002	NA	113436	109722	3714	3.3
CN1805900000000	18	059	Hancock County, IN	2002	NA	31996	30726	1270	4
CN1806100000000	18	061	Harrison County, IN	2002	NA	18778	17891	887	4.7
CN1806300000000	18	063	Hendricks County, IN	2002	NA	63082	60699	2383	3.8
CN1806500000000	18	065	Henry County, IN	2002	NA	23366	21909	1457	6.2
CN1806700000000	18	067	Howard County, IN	2002	NA	40867	38490	2377	5.8
CN1806900000000	18	069	Huntington County, IN	2002	NA	20669	19604	1065	5.2
CN1807100000000	18	071	Jackson County, IN	2002	NA	22048	20966	1082	4.9
CN1807300000000	18	073	Jasper County, IN	2002	NA	15042	14186	856	5.7
CN1807500000000	18	075	Jay County, IN	2002	NA	10851	10190	661	6.1
CN1807700000000	18	077	Jefferson County, IN	2002	NA	16732	15892	840	5
CN1807900000000	18	079	Jennings County, IN	2002	NA	13536	12669	867	6.4
CN1808100000000	18	081	Johnson County, IN	2002	NA	66700	64093	2607	3.9
CN1808300000000	18	083	Knox County, IN	2002	NA	19715	18847	868	4.4
CN1808500000000	18	085	Kosciusko County, IN	2002	NA	39254	37407	1847	4.7
CN1808700000000	18	087	LaGrange County, IN	2002	NA	16587	15802	785	4.7
CN1808900000000	18	089	Lake County, IN	2002	NA	228389	213640	14749	6.5
CN1809100000000	18	091	LaPorte County, IN	2002	NA	54189	50476	3713	6.9
CN1809300000000	18	093	Lawrence County, IN	2002	NA	23083	21337	1746	7.6
CN1809500000000	18	095	Madison County, IN	2002	NA	64092	60358	3734	5.8
CN1809700000000	18	097	Marion County, IN	2002	NA	462330	438222	24108	5.2
CN1809900000000	18	099	Marshall County, IN	2002	NA	22309	21169	1140	5.1
CN1810100000000	18	101	Martin County, IN	2002	NA	5219	4943	276	5.3
CN1810300000000	18	103	Miami County, IN	2002	NA	17474	16391	1083	6.2
CN1810500000000	18	105	Monroe County, IN	2002	NA	65423	62563	2860	4.4
CN1810700000000	18	107	Montgomery County, IN	2002	NA	19530	18700	830	4.2
CN1810900000000	18	109	Morgan County, IN	2002	NA	36515	34806	1709	4.7
CN1811100000000	18	111	Newton County, IN	2002	NA	7227	6827	400	5.5
CN1811300000000	18	113	Noble County, IN	2002	NA	23729	22370	1359	5.7
CN1811500000000	18	115	Ohio County, IN	2002	NA	3051	2919	132	4.3
CN1811700000000	18	117	Orange County, IN	2002	NA	9361	8631	730	7.8
CN1811900000000	18	119	Owen County, IN	2002	NA	11504	10842	662	5.8
CN1812100000000	18	121	Parke County, IN	2002	NA	8044	7603	441	5.5
CN1812300000000	18	123	Perry County, IN	2002	NA	9439	8946	493	5.2
CN1812500000000	18	125	Pike County, IN	2002	NA	6347	6029	318	5
CN1812700000000	18	127	Porter County, IN	2002	NA	79613	75632	3981	5
CN1812900000000	18	129	Posey County, IN	2002	NA	14260	13635	625	4.4
CN1813100000000	18	131	Pulaski County, IN	2002	NA	6822	6429	393	5.8
CN1813300000000	18	133	Putnam County, IN	2002	NA	17424	16542	882	5.1
CN1813500000000	18	135	Randolph County, IN	2002	NA	13777	12959	818	5.9
CN1813700000000	18	137	Ripley County, IN	2002	NA	14065	13454	611	4.3
CN1813900000000	18	139	Rush County, IN	2002	NA	9538	9105	433	4.5
CN1814100000000	18	141	St. Joseph County, IN	2002	NA	133666	126501	7165	5.4
CN1814300000000	18	143	Scott County, IN	2002	NA	11095	10413	682	6.1
CN1814500000000	18	145	Shelby County, IN	2002	NA	23881	22736	1145	4.8
CN1814700000000	18	147	Spencer County, IN	2002	NA	10634	10131	503	4.7
CN1814900000000	18	149	Starke County, IN	2002	NA	10658	9865	793	7.4
CN1815100000000	18	151	Steuben County, IN	2002	NA	17218	16106	1112	6.5
CN1815300000000	18	153	Sullivan County, IN	2002	NA	9357	8797	560	6
CN1815500000000	18	155	Switzerland County, IN	2002	NA	5742	5469	273	4.8
CN1815700000000	18	157	Tippecanoe County, IN	2002	NA	80106	76661	3445	4.3
CN1815900000000	18	159	Tipton County, IN	2002	NA	8558	8120	438	5.1
CN1816100000000	18	161	Union County, IN	2002	NA	3716	3521	195	5.2
CN1816300000000	18	163	Vanderburgh County, IN	2002	NA	92594	88365	4229	4.6
CN1816500000000	18	165	Vermillion County, IN	2002	NA	8194	7675	519	6.3
CN1816700000000	18	167	Vigo County, IN	2002	NA	51329	48320	3009	5.9
CN1816900000000	18	169	Wabash County, IN	2002	NA	17832	16878	954	5.3
CN1817100000000	18	171	Warren County, IN	2002	NA	4643	4404	239	5.1
CN1817300000000	18	173	Warrick County, IN	2002	NA	29662	28486	1176	4
CN1817500000000	18	175	Washington County, IN	2002	NA	14047	13259	788	5.6
CN1817700000000	18	177	Wayne County, IN	2002	NA	34971	32860	2111	6
CN1817900000000	18	179	Wells County, IN	2002	NA	14834	14205	629	4.2
CN1818100000000	18	181	White County, IN	2002	NA	12881	11973	908	7
CN1818300000000	18	183	Whitley County, IN	2002	NA	17367	16495	872	5
CN1900100000000	19	001	Adair County, IA	2002	NA	4451	4288	163	3.7
CN1900300000000	19	003	Adams County, IA	2002	NA	2182	2079	103	4.7
CN1900500000000	19	005	Allamakee County, IA	2002	NA	8401	8018	383	4.6
CN1900700000000	19	007	Appanoose County, IA	2002	NA	6541	6199	342	5.2
CN1900900000000	19	009	Audubon County, IA	2002	NA	3393	3262	131	3.9
CN1901100000000	19	011	Benton County, IA	2002	NA	14416	13800	616	4.3
CN1901300000000	19	013	Black Hawk County, IA	2002	NA	71734	68864	2870	4
CN1901500000000	19	015	Boone County, IA	2002	NA	15173	14687	486	3.2
CN1901700000000	19	017	Bremer County, IA	2002	NA	13487	13035	452	3.4
CN1901900000000	19	019	Buchanan County, IA	2002	NA	10888	10397	491	4.5
CN1902100000000	19	021	Buena Vista County, IA	2002	NA	10650	10309	341	3.2
CN1902300000000	19	023	Butler County, IA	2002	NA	8266	7890	376	4.5
CN1902500000000	19	025	Calhoun County, IA	2002	NA	5268	5079	189	3.6
CN1902700000000	19	027	Carroll County, IA	2002	NA	12287	11930	357	2.9
CN1902900000000	19	029	Cass County, IA	2002	NA	7731	7381	350	4.5
CN1903100000000	19	031	Cedar County, IA	2002	NA	10618	10241	377	3.6
CN1903300000000	19	033	Cerro Gordo County, IA	2002	NA	25646	24589	1057	4.1
CN1903500000000	19	035	Cherokee County, IA	2002	NA	6968	6683	285	4.1
CN1903700000000	19	037	Chickasaw County, IA	2002	NA	6500	6150	350	5.4
CN1903900000000	19	039	Clarke County, IA	2002	NA	5020	4755	265	5.3
CN1904100000000	19	041	Clay County, IA	2002	NA	9792	9418	374	3.8
CN1904300000000	19	043	Clayton County, IA	2002	NA	9943	9379	564	5.7
CN1904500000000	19	045	Clinton County, IA	2002	NA	26893	25464	1429	5.3
CN1904700000000	19	047	Crawford County, IA	2002	NA	8944	8602	342	3.8
CN1904900000000	19	049	Dallas County, IA	2002	NA	26053	25293	760	2.9
CN1905100000000	19	051	Davis County, IA	2002	NA	4302	4094	208	4.8
CN1905300000000	19	053	Decatur County, IA	2002	NA	4379	4189	190	4.3
CN1905500000000	19	055	Delaware County, IA	2002	NA	10368	9851	517	5
CN1905700000000	19	057	Des Moines County, IA	2002	NA	21992	20681	1311	6
CN1905900000000	19	059	Dickinson County, IA	2002	NA	9824	9459	365	3.7
CN1906100000000	19	061	Dubuque County, IA	2002	NA	48870	46908	1962	4
CN1906300000000	19	063	Emmet County, IA	2002	NA	6086	5814	272	4.5
CN1906500000000	19	065	Fayette County, IA	2002	NA	11178	10638	540	4.8
CN1906700000000	19	067	Floyd County, IA	2002	NA	8685	8272	413	4.8
CN1906900000000	19	069	Franklin County, IA	2002	NA	5676	5436	240	4.2
CN1907100000000	19	071	Fremont County, IA	2002	NA	4604	4480	124	2.7
CN1907300000000	19	073	Greene County, IA	2002	NA	5011	4822	189	3.8
CN1907500000000	19	075	Grundy County, IA	2002	NA	6864	6645	219	3.2
CN1907700000000	19	077	Guthrie County, IA	2002	NA	6164	5949	215	3.5
CN1907900000000	19	079	Hamilton County, IA	2002	NA	8797	8505	292	3.3
CN1908100000000	19	081	Hancock County, IA	2002	NA	6388	6205	183	2.9
CN1908300000000	19	083	Hardin County, IA	2002	NA	9663	9255	408	4.2
CN1908500000000	19	085	Harrison County, IA	2002	NA	8216	7915	301	3.7
CN1908700000000	19	087	Henry County, IA	2002	NA	10420	9885	535	5.1
CN1908900000000	19	089	Howard County, IA	2002	NA	5253	5038	215	4.1
CN1909100000000	19	091	Humboldt County, IA	2002	NA	5327	5136	191	3.6
CN1909300000000	19	093	Ida County, IA	2002	NA	4010	3878	132	3.3
CN1909500000000	19	095	Iowa County, IA	2002	NA	8968	8661	307	3.4
CN1909700000000	19	097	Jackson County, IA	2002	NA	11614	11009	605	5.2
CN1909900000000	19	099	Jasper County, IA	2002	NA	20578	19727	851	4.1
CN1910100000000	19	101	Jefferson County, IA	2002	NA	8621	8132	489	5.7
CN1910300000000	19	103	Johnson County, IA	2002	NA	72569	70596	1973	2.7
CN1910500000000	19	105	Jones County, IA	2002	NA	10665	10170	495	4.6
CN1910700000000	19	107	Keokuk County, IA	2002	NA	6151	5875	276	4.5
CN1910900000000	19	109	Kossuth County, IA	2002	NA	9051	8727	324	3.6
CN1911100000000	19	111	Lee County, IA	2002	NA	18092	16737	1355	7.5
CN1911300000000	19	113	Linn County, IA	2002	NA	115368	110206	5162	4.5
CN1911500000000	19	115	Louisa County, IA	2002	NA	6340	6048	292	4.6
CN1911700000000	19	117	Lucas County, IA	2002	NA	4872	4653	219	4.5
CN1911900000000	19	119	Lyon County, IA	2002	NA	6509	6292	217	3.3
CN1912100000000	19	121	Madison County, IA	2002	NA	7992	7662	330	4.1
CN1912300000000	19	123	Mahaska County, IA	2002	NA	11635	11117	518	4.5
CN1912500000000	19	125	Marion County, IA	2002	NA	17588	16826	762	4.3
CN1912700000000	19	127	Marshall County, IA	2002	NA	20927	20075	852	4.1
CN1912900000000	19	129	Mills County, IA	2002	NA	8162	7938	224	2.7
CN1913100000000	19	131	Mitchell County, IA	2002	NA	5482	5286	196	3.6
CN1913300000000	19	133	Monona County, IA	2002	NA	5039	4823	216	4.3
CN1913500000000	19	135	Monroe County, IA	2002	NA	3743	3558	185	4.9
CN1913700000000	19	137	Montgomery County, IA	2002	NA	5807	5495	312	5.4
CN1913900000000	19	139	Muscatine County, IA	2002	NA	22578	21660	918	4.1
CN1914100000000	19	141	O'Brien County, IA	2002	NA	7790	7544	246	3.2
CN1914300000000	19	143	Osceola County, IA	2002	NA	3569	3459	110	3.1
CN1914500000000	19	145	Page County, IA	2002	NA	7596	7232	364	4.8
CN1914700000000	19	147	Palo Alto County, IA	2002	NA	5151	4964	187	3.6
CN1914900000000	19	149	Plymouth County, IA	2002	NA	13854	13383	471	3.4
CN1915100000000	19	151	Pocahontas County, IA	2002	NA	4168	3982	186	4.5
CN1915300000000	19	153	Polk County, IA	2002	NA	226066	217763	8303	3.7
CN1915500000000	19	155	Pottawattamie County, IA	2002	NA	49379	47728	1651	3.3
CN1915700000000	19	157	Poweshiek County, IA	2002	NA	10829	10391	438	4
CN1915900000000	19	159	Ringgold County, IA	2002	NA	2614	2516	98	3.7
CN1916100000000	19	161	Sac County, IA	2002	NA	5985	5778	207	3.5
CN1916300000000	19	163	Scott County, IA	2002	NA	87483	83445	4038	4.6
CN1916500000000	19	165	Shelby County, IA	2002	NA	7128	6888	240	3.4
CN1916700000000	19	167	Sioux County, IA	2002	NA	18018	17517	501	2.8
CN1916900000000	19	169	Story County, IA	2002	NA	47937	46712	1225	2.6
CN1917100000000	19	171	Tama County, IA	2002	NA	9215	8821	394	4.3
CN1917300000000	19	173	Taylor County, IA	2002	NA	3349	3217	132	3.9
CN1917500000000	19	175	Union County, IA	2002	NA	6519	6194	325	5
CN1917700000000	19	177	Van Buren County, IA	2002	NA	3899	3683	216	5.5
CN1917900000000	19	179	Wapello County, IA	2002	NA	19097	18051	1046	5.5
CN1918100000000	19	181	Warren County, IA	2002	NA	24452	23673	779	3.2
CN1918300000000	19	183	Washington County, IA	2002	NA	12198	11798	400	3.3
CN1918500000000	19	185	Wayne County, IA	2002	NA	3322	3183	139	4.2
CN1918700000000	19	187	Webster County, IA	2002	NA	20047	19214	833	4.2
CN1918900000000	19	189	Winnebago County, IA	2002	NA	6335	6138	197	3.1
CN1919100000000	19	191	Winneshiek County, IA	2002	NA	12505	12046	459	3.7
CN1919300000000	19	193	Woodbury County, IA	2002	NA	56018	53873	2145	3.8
CN1919500000000	19	195	Worth County, IA	2002	NA	4465	4280	185	4.1
CN1919700000000	19	197	Wright County, IA	2002	NA	7259	6970	289	4
CN2000100000000	20	001	Allen County, KS	2002	NA	6939	6569	370	5.3
CN2000300000000	20	003	Anderson County, KS	2002	NA	4130	3911	219	5.3
CN2000500000000	20	005	Atchison County, KS	2002	NA	8136	7698	438	5.4
CN2000700000000	20	007	Barber County, KS	2002	NA	2520	2432	88	3.5
CN2000900000000	20	009	Barton County, KS	2002	NA	14614	14032	582	4
CN2001100000000	20	011	Bourbon County, KS	2002	NA	8247	7850	397	4.8
CN2001300000000	20	013	Brown County, KS	2002	NA	5215	4935	280	5.4
CN2001500000000	20	015	Butler County, KS	2002	NA	30926	29189	1737	5.6
CN2001700000000	20	017	Chase County, KS	2002	NA	1626	1555	71	4.4
CN2001900000000	20	019	Chautauqua County, KS	2002	NA	1932	1828	104	5.4
CN2002100000000	20	021	Cherokee County, KS	2002	NA	10468	9749	719	6.9
CN2002300000000	20	023	Cheyenne County, KS	2002	NA	1534	1485	49	3.2
CN2002500000000	20	025	Clark County, KS	2002	NA	1214	1175	39	3.2
CN2002700000000	20	027	Clay County, KS	2002	NA	4504	4315	189	4.2
CN2002900000000	20	029	Cloud County, KS	2002	NA	5253	5055	198	3.8
CN2003100000000	20	031	Coffey County, KS	2002	NA	4766	4481	285	6
CN2003300000000	20	033	Comanche County, KS	2002	NA	1035	1007	28	2.7
CN2003500000000	20	035	Cowley County, KS	2002	NA	18578	17353	1225	6.6
CN2003700000000	20	037	Crawford County, KS	2002	NA	19097	18119	978	5.1
CN2003900000000	20	039	Decatur County, KS	2002	NA	1830	1777	53	2.9
CN2004100000000	20	041	Dickinson County, KS	2002	NA	10036	9615	421	4.2
CN2004300000000	20	043	Doniphan County, KS	2002	NA	4328	3915	413	9.5
CN2004500000000	20	045	Douglas County, KS	2002	NA	59207	56951	2256	3.8
CN2004700000000	20	047	Edwards County, KS	2002	NA	1687	1629	58	3.4
CN2004900000000	20	049	Elk County, KS	2002	NA	1421	1339	82	5.8
CN2005100000000	20	051	Ellis County, KS	2002	NA	16031	15544	487	3
CN2005300000000	20	053	Ellsworth County, KS	2002	NA	3119	2994	125	4
CN2005500000000	20	055	Finney County, KS	2002	NA	17897	17216	681	3.8
CN2005700000000	20	057	Ford County, KS	2002	NA	16091	15600	491	3.1
CN2005900000000	20	059	Franklin County, KS	2002	NA	13184	12474	710	5.4
CN2006100000000	20	061	Geary County, KS	2002	NA	10963	10301	662	6
CN2006300000000	20	063	Gove County, KS	2002	NA	1588	1541	47	3
CN2006500000000	20	065	Graham County, KS	2002	NA	1418	1371	47	3.3
CN2006700000000	20	067	Grant County, KS	2002	NA	3723	3600	123	3.3
CN2006900000000	20	069	Gray County, KS	2002	NA	3117	3021	96	3.1
CN2007100000000	20	071	Greeley County, KS	2002	NA	773	749	24	3.1
CN2007300000000	20	073	Greenwood County, KS	2002	NA	3600	3388	212	5.9
CN2007500000000	20	075	Hamilton County, KS	2002	NA	1261	1220	41	3.3
CN2007700000000	20	077	Harper County, KS	2002	NA	3189	3067	122	3.8
CN2007900000000	20	079	Harvey County, KS	2002	NA	17627	16884	743	4.2
CN2008100000000	20	081	Haskell County, KS	2002	NA	2120	2059	61	2.9
CN2008300000000	20	083	Hodgeman County, KS	2002	NA	956	922	34	3.6
CN2008500000000	20	085	Jackson County, KS	2002	NA	6875	6534	341	5
CN2008700000000	20	087	Jefferson County, KS	2002	NA	10065	9592	473	4.7
CN2008900000000	20	089	Jewell County, KS	2002	NA	1984	1926	58	2.9
CN2009100000000	20	091	Johnson County, KS	2002	NA	267927	255226	12701	4.7
CN2009300000000	20	093	Kearny County, KS	2002	NA	1929	1865	64	3.3
CN2009500000000	20	095	Kingman County, KS	2002	NA	4195	3995	200	4.8
CN2009700000000	20	097	Kiowa County, KS	2002	NA	1464	1409	55	3.8
CN2009900000000	20	099	Labette County, KS	2002	NA	10796	10150	646	6
CN2010100000000	20	101	Lane County, KS	2002	NA	1125	1080	45	4
CN2010300000000	20	103	Leavenworth County, KS	2002	NA	31427	29589	1838	5.8
CN2010500000000	20	105	Lincoln County, KS	2002	NA	1875	1795	80	4.3
CN2010700000000	20	107	Linn County, KS	2002	NA	4640	4353	287	6.2
CN2010900000000	20	109	Logan County, KS	2002	NA	1556	1500	56	3.6
CN2011100000000	20	111	Lyon County, KS	2002	NA	18966	18146	820	4.3
CN2011300000000	20	113	McPherson County, KS	2002	NA	15589	15065	524	3.4
CN2011500000000	20	115	Marion County, KS	2002	NA	6554	6301	253	3.9
CN2011700000000	20	117	Marshall County, KS	2002	NA	5674	5450	224	3.9
CN2011900000000	20	119	Meade County, KS	2002	NA	2160	2094	66	3.1
CN2012100000000	20	121	Miami County, KS	2002	NA	15081	14386	695	4.6
CN2012300000000	20	123	Mitchell County, KS	2002	NA	3322	3202	120	3.6
CN2012500000000	20	125	Montgomery County, KS	2002	NA	16239	15164	1075	6.6
CN2012700000000	20	127	Morris County, KS	2002	NA	3074	2955	119	3.9
CN2012900000000	20	129	Morton County, KS	2002	NA	1597	1547	50	3.1
CN2013100000000	20	131	Nemaha County, KS	2002	NA	5086	4908	178	3.5
CN2013300000000	20	133	Neosho County, KS	2002	NA	8420	8011	409	4.9
CN2013500000000	20	135	Ness County, KS	2002	NA	1720	1669	51	3
CN2013700000000	20	137	Norton County, KS	2002	NA	2618	2523	95	3.6
CN2013900000000	20	139	Osage County, KS	2002	NA	9007	8548	459	5.1
CN2014100000000	20	141	Osborne County, KS	2002	NA	2264	2191	73	3.2
CN2014300000000	20	143	Ottawa County, KS	2002	NA	3332	3200	132	4
CN2014500000000	20	145	Pawnee County, KS	2002	NA	3425	3313	112	3.3
CN2014700000000	20	147	Phillips County, KS	2002	NA	3147	3052	95	3
CN2014900000000	20	149	Pottawatomie County, KS	2002	NA	9526	9123	403	4.2
CN2015100000000	20	151	Pratt County, KS	2002	NA	5387	5218	169	3.1
CN2015300000000	20	153	Rawlins County, KS	2002	NA	1352	1303	49	3.6
CN2015500000000	20	155	Reno County, KS	2002	NA	32592	31077	1515	4.6
CN2015700000000	20	157	Republic County, KS	2002	NA	2918	2808	110	3.8
CN2015900000000	20	159	Rice County, KS	2002	NA	5390	5177	213	4
CN2016100000000	20	161	Riley County, KS	2002	NA	30623	29566	1057	3.5
CN2016300000000	20	163	Rooks County, KS	2002	NA	2735	2637	98	3.6
CN2016500000000	20	165	Rush County, KS	2002	NA	1690	1627	63	3.7
CN2016700000000	20	167	Russell County, KS	2002	NA	3268	3122	146	4.5
CN2016900000000	20	169	Saline County, KS	2002	NA	29762	28557	1205	4
CN2017100000000	20	171	Scott County, KS	2002	NA	2937	2862	75	2.6
CN2017300000000	20	173	Sedgwick County, KS	2002	NA	241458	227267	14191	5.9
CN2017500000000	20	175	Seward County, KS	2002	NA	10284	9874	410	4
CN2017700000000	20	177	Shawnee County, KS	2002	NA	93158	88896	4262	4.6
CN2017900000000	20	179	Sheridan County, KS	2002	NA	1466	1422	44	3
CN2018100000000	20	181	Sherman County, KS	2002	NA	3744	3632	112	3
CN2018300000000	20	183	Smith County, KS	2002	NA	2258	2191	67	3
CN2018500000000	20	185	Stafford County, KS	2002	NA	2191	2097	94	4.3
CN2018700000000	20	187	Stanton County, KS	2002	NA	1148	1115	33	2.9
CN2018900000000	20	189	Stevens County, KS	2002	NA	2379	2296	83	3.5
CN2019100000000	20	191	Sumner County, KS	2002	NA	12718	11816	902	7.1
CN2019300000000	20	193	Thomas County, KS	2002	NA	4173	4039	134	3.2
CN2019500000000	20	195	Trego County, KS	2002	NA	1667	1612	55	3.3
CN2019700000000	20	197	Wabaunsee County, KS	2002	NA	3733	3592	141	3.8
CN2019900000000	20	199	Wallace County, KS	2002	NA	939	914	25	2.7
CN2020100000000	20	201	Washington County, KS	2002	NA	3316	3195	121	3.6
CN2020300000000	20	203	Wichita County, KS	2002	NA	1228	1189	39	3.2
CN2020500000000	20	205	Wilson County, KS	2002	NA	4817	4590	227	4.7
CN2020700000000	20	207	Woodson County, KS	2002	NA	1710	1604	106	6.2
CN2020900000000	20	209	Wyandotte County, KS	2002	NA	73426	66539	6887	9.4
CN2100100000000	21	001	Adair County, KY	2002	NA	8666	8198	468	5.4
CN2100300000000	21	003	Allen County, KY	2002	NA	8646	8105	541	6.3
CN2100500000000	21	005	Anderson County, KY	2002	NA	10207	9703	504	4.9
CN2100700000000	21	007	Ballard County, KY	2002	NA	4099	3807	292	7.1
CN2100900000000	21	009	Barren County, KY	2002	NA	19201	18298	903	4.7
CN2101100000000	21	011	Bath County, KY	2002	NA	4989	4620	369	7.4
CN2101300000000	21	013	Bell County, KY	2002	NA	9521	8701	820	8.6
CN2101500000000	21	015	Boone County, KY	2002	NA	51447	49341	2106	4.1
CN2101700000000	21	017	Bourbon County, KY	2002	NA	9776	9245	531	5.4
CN2101900000000	21	019	Boyd County, KY	2002	NA	21859	20486	1373	6.3
CN2102100000000	21	021	Boyle County, KY	2002	NA	13285	12447	838	6.3
CN2102300000000	21	023	Bracken County, KY	2002	NA	4180	3968	212	5.1
CN2102500000000	21	025	Breathitt County, KY	2002	NA	5386	4960	426	7.9
CN2102700000000	21	027	Breckinridge County, KY	2002	NA	8865	8273	592	6.7
CN2102900000000	21	029	Bullitt County, KY	2002	NA	33232	31514	1718	5.2
CN2103100000000	21	031	Butler County, KY	2002	NA	6492	5968	524	8.1
CN2103300000000	21	033	Caldwell County, KY	2002	NA	6313	5991	322	5.1
CN2103500000000	21	035	Calloway County, KY	2002	NA	16697	15511	1186	7.1
CN2103700000000	21	037	Campbell County, KY	2002	NA	45203	43242	1961	4.3
CN2103900000000	21	039	Carlisle County, KY	2002	NA	2367	2209	158	6.7
CN2104100000000	21	041	Carroll County, KY	2002	NA	5157	4784	373	7.2
CN2104300000000	21	043	Carter County, KY	2002	NA	12690	11527	1163	9.2
CN2104500000000	21	045	Casey County, KY	2002	NA	7254	6773	481	6.6
CN2104700000000	21	047	Christian County, KY	2002	NA	26065	24523	1542	5.9
CN2104900000000	21	049	Clark County, KY	2002	NA	16670	15743	927	5.6
CN2105100000000	21	051	Clay County, KY	2002	NA	7174	6422	752	10.5
CN2105300000000	21	053	Clinton County, KY	2002	NA	4686	4282	404	8.6
CN2105500000000	21	055	Crittenden County, KY	2002	NA	4216	3977	239	5.7
CN2105700000000	21	057	Cumberland County, KY	2002	NA	3216	3035	181	5.6
CN2105900000000	21	059	Daviess County, KY	2002	NA	45642	43133	2509	5.5
CN2106100000000	21	061	Edmonson County, KY	2002	NA	5085	4726	359	7.1
CN2106300000000	21	063	Elliott County, KY	2002	NA	2635	2411	224	8.5
CN2106500000000	21	065	Estill County, KY	2002	NA	6024	5636	388	6.4
CN2106700000000	21	067	Fayette County, KY	2002	NA	145076	138928	6148	4.2
CN2106900000000	21	069	Fleming County, KY	2002	NA	6700	6333	367	5.5
CN2107100000000	21	071	Floyd County, KY	2002	NA	14197	13191	1006	7.1
CN2107300000000	21	073	Franklin County, KY	2002	NA	24991	23926	1065	4.3
CN2107500000000	21	075	Fulton County, KY	2002	NA	3160	2942	218	6.9
CN2107700000000	21	077	Gallatin County, KY	2002	NA	3818	3602	216	5.7
CN2107900000000	21	079	Garrard County, KY	2002	NA	7383	6980	403	5.5
CN2108100000000	21	081	Grant County, KY	2002	NA	11847	11205	642	5.4
CN2108300000000	21	083	Graves County, KY	2002	NA	16934	15754	1180	7
CN2108500000000	21	085	Grayson County, KY	2002	NA	11588	10651	937	8.1
CN2108700000000	21	087	Green County, KY	2002	NA	5562	5267	295	5.3
CN2108900000000	21	089	Greenup County, KY	2002	NA	16054	15074	980	6.1
CN2109100000000	21	091	Hancock County, KY	2002	NA	4075	3825	250	6.1
CN2109300000000	21	093	Hardin County, KY	2002	NA	43572	41066	2506	5.8
CN2109500000000	21	095	Harlan County, KY	2002	NA	10171	9271	900	8.8
CN2109700000000	21	097	Harrison County, KY	2002	NA	9119	8614	505	5.5
CN2109900000000	21	099	Hart County, KY	2002	NA	7800	7383	417	5.3
CN2110100000000	21	101	Henderson County, KY	2002	NA	23124	21894	1230	5.3
CN2110300000000	21	103	Henry County, KY	2002	NA	7514	7186	328	4.4
CN2110500000000	21	105	Hickman County, KY	2002	NA	2339	2183	156	6.7
CN2110700000000	21	107	Hopkins County, KY	2002	NA	21368	20171	1197	5.6
CN2110900000000	21	109	Jackson County, KY	2002	NA	4852	4480	372	7.7
CN2111100000000	21	111	Jefferson County, KY	2002	NA	348839	329254	19585	5.6
CN2111300000000	21	113	Jessamine County, KY	2002	NA	20684	19806	878	4.2
CN2111500000000	21	115	Johnson County, KY	2002	NA	9492	8903	589	6.2
CN2111700000000	21	117	Kenton County, KY	2002	NA	80903	77416	3487	4.3
CN2111900000000	21	119	Knott County, KY	2002	NA	5823	5429	394	6.8
CN2112100000000	21	121	Knox County, KY	2002	NA	11434	10636	798	7
CN2112300000000	21	123	Larue County, KY	2002	NA	6425	6079	346	5.4
CN2112500000000	21	125	Laurel County, KY	2002	NA	24906	23441	1465	5.9
CN2112700000000	21	127	Lawrence County, KY	2002	NA	5673	5226	447	7.9
CN2112900000000	21	129	Lee County, KY	2002	NA	2615	2418	197	7.5
CN2113100000000	21	131	Leslie County, KY	2002	NA	3830	3506	324	8.5
CN2113300000000	21	133	Letcher County, KY	2002	NA	8836	8106	730	8.3
CN2113500000000	21	135	Lewis County, KY	2002	NA	5413	4995	418	7.7
CN2113700000000	21	137	Lincoln County, KY	2002	NA	11005	10243	762	6.9
CN2113900000000	21	139	Livingston County, KY	2002	NA	4880	4561	319	6.5
CN2114100000000	21	141	Logan County, KY	2002	NA	12744	11901	843	6.6
CN2114300000000	21	143	Lyon County, KY	2002	NA	3389	3163	226	6.7
CN2114500000000	21	145	McCracken County, KY	2002	NA	31124	29271	1853	6
CN2114700000000	21	147	McCreary County, KY	2002	NA	6084	5506	578	9.5
CN2114900000000	21	149	McLean County, KY	2002	NA	4629	4334	295	6.4
CN2115100000000	21	151	Madison County, KY	2002	NA	37890	35916	1974	5.2
CN2115300000000	21	153	Magoffin County, KY	2002	NA	4514	4005	509	11.3
CN2115500000000	21	155	Marion County, KY	2002	NA	8953	8498	455	5.1
CN2115700000000	21	157	Marshall County, KY	2002	NA	14579	13488	1091	7.5
CN2115900000000	21	159	Martin County, KY	2002	NA	3817	3545	272	7.1
CN2116100000000	21	161	Mason County, KY	2002	NA	8432	7995	437	5.2
CN2116300000000	21	163	Meade County, KY	2002	NA	11596	10920	676	5.8
CN2116500000000	21	165	Menifee County, KY	2002	NA	2620	2407	213	8.1
CN2116700000000	21	167	Mercer County, KY	2002	NA	10534	9959	575	5.5
CN2116900000000	21	169	Metcalfe County, KY	2002	NA	4517	4287	230	5.1
CN2117100000000	21	171	Monroe County, KY	2002	NA	5217	4874	343	6.6
CN2117300000000	21	173	Montgomery County, KY	2002	NA	11411	10673	738	6.5
CN2117500000000	21	175	Morgan County, KY	2002	NA	5152	4686	466	9
CN2117700000000	21	177	Muhlenberg County, KY	2002	NA	13186	12137	1049	8
CN2117900000000	21	179	Nelson County, KY	2002	NA	19437	18290	1147	5.9
CN2118100000000	21	181	Nicholas County, KY	2002	NA	3181	2960	221	6.9
CN2118300000000	21	183	Ohio County, KY	2002	NA	10811	10051	760	7
CN2118500000000	21	185	Oldham County, KY	2002	NA	23928	22963	965	4
CN2118700000000	21	187	Owen County, KY	2002	NA	5075	4838	237	4.7
CN2118900000000	21	189	Owsley County, KY	2002	NA	1605	1498	107	6.7
CN2119100000000	21	191	Pendleton County, KY	2002	NA	7164	6812	352	4.9
CN2119300000000	21	193	Perry County, KY	2002	NA	10411	9590	821	7.9
CN2119500000000	21	195	Pike County, KY	2002	NA	25028	23333	1695	6.8
CN2119700000000	21	197	Powell County, KY	2002	NA	5731	5329	402	7
CN2119900000000	21	199	Pulaski County, KY	2002	NA	26218	24345	1873	7.1
CN2120100000000	21	201	Robertson County, KY	2002	NA	1070	1015	55	5.1
CN2120300000000	21	203	Rockcastle County, KY	2002	NA	7038	6635	403	5.7
CN2120500000000	21	205	Rowan County, KY	2002	NA	11221	10576	645	5.7
CN2120700000000	21	207	Russell County, KY	2002	NA	7685	7095	590	7.7
CN2120900000000	21	209	Scott County, KY	2002	NA	18820	17917	903	4.8
CN2121100000000	21	211	Shelby County, KY	2002	NA	18310	17449	861	4.7
CN2121300000000	21	213	Simpson County, KY	2002	NA	8322	7839	483	5.8
CN2121500000000	21	215	Spencer County, KY	2002	NA	7028	6735	293	4.2
CN2121700000000	21	217	Taylor County, KY	2002	NA	11994	11358	636	5.3
CN2121900000000	21	219	Todd County, KY	2002	NA	5791	5499	292	5
CN2122100000000	21	221	Trigg County, KY	2002	NA	6005	5615	390	6.5
CN2122300000000	21	223	Trimble County, KY	2002	NA	4116	3916	200	4.9
CN2122500000000	21	225	Union County, KY	2002	NA	7585	7194	391	5.2
CN2122700000000	21	227	Warren County, KY	2002	NA	50382	47836	2546	5.1
CN2122900000000	21	229	Washington County, KY	2002	NA	5282	4974	308	5.8
CN2123100000000	21	231	Wayne County, KY	2002	NA	8687	8123	564	6.5
CN2123300000000	21	233	Webster County, KY	2002	NA	6715	6372	343	5.1
CN2123500000000	21	235	Whitley County, KY	2002	NA	14578	13554	1024	7
CN2123700000000	21	237	Wolfe County, KY	2002	NA	2414	2215	199	8.2
CN2123900000000	21	239	Woodford County, KY	2002	NA	13063	12541	522	4
CN2200100000000	22	001	Acadia Parish, LA	2002	NA	23645	22159	1486	6.3
CN2200300000000	22	003	Allen Parish, LA	2002	NA	8695	7988	707	8.1
CN2200500000000	22	005	Ascension Parish, LA	2002	NA	39392	36846	2546	6.5
CN2200700000000	22	007	Assumption Parish, LA	2002	NA	10471	9803	668	6.4
CN2200900000000	22	009	Avoyelles Parish, LA	2002	NA	15689	14547	1142	7.3
CN2201100000000	22	011	Beauregard Parish, LA	2002	NA	13869	12947	922	6.6
CN2201300000000	22	013	Bienville Parish, LA	2002	NA	5933	5418	515	8.7
CN2201500000000	22	015	Bossier Parish, LA	2002	NA	46638	43786	2852	6.1
CN2201700000000	22	017	Caddo Parish, LA	2002	NA	111295	103628	7667	6.9
CN2201900000000	22	019	Calcasieu Parish, LA	2002	NA	84457	79566	4891	5.8
CN2202100000000	22	021	Caldwell Parish, LA	2002	NA	4411	4055	356	8.1
CN2202300000000	22	023	Cameron Parish, LA	2002	NA	4329	4097	232	5.4
CN2202500000000	22	025	Catahoula Parish, LA	2002	NA	4053	3658	395	9.7
CN2202700000000	22	027	Claiborne Parish, LA	2002	NA	6728	6253	475	7.1
CN2202900000000	22	029	Concordia Parish, LA	2002	NA	7497	6742	755	10.1
CN2203100000000	22	031	De Soto Parish, LA	2002	NA	10705	9787	918	8.6
CN2203300000000	22	033	East Baton Rouge Parish, LA	2002	NA	199040	188157	10883	5.5
CN2203500000000	22	035	East Carroll Parish, LA	2002	NA	3079	2709	370	12
CN2203700000000	22	037	East Feliciana Parish, LA	2002	NA	7924	7382	542	6.8
CN2203900000000	22	039	Evangeline Parish, LA	2002	NA	11971	11095	876	7.3
CN2204100000000	22	041	Franklin Parish, LA	2002	NA	7947	7129	818	10.3
CN2204300000000	22	043	Grant Parish, LA	2002	NA	7912	7364	548	6.9
CN2204500000000	22	045	Iberia Parish, LA	2002	NA	30521	28460	2061	6.8
CN2204700000000	22	047	Iberville Parish, LA	2002	NA	12160	11159	1001	8.2
CN2204900000000	22	049	Jackson Parish, LA	2002	NA	6540	6114	426	6.5
CN2205100000000	22	051	Jefferson Parish, LA	2002	NA	223118	211580	11538	5.2
CN2205300000000	22	053	Jefferson Davis Parish, LA	2002	NA	13024	12266	758	5.8
CN2205500000000	22	055	Lafayette Parish, LA	2002	NA	98002	93450	4552	4.6
CN2205700000000	22	057	Lafourche Parish, LA	2002	NA	42817	40796	2021	4.7
CN2205900000000	22	059	LaSalle Parish, LA	2002	NA	6038	5566	472	7.8
CN2206100000000	22	061	Lincoln Parish, LA	2002	NA	18551	17327	1224	6.6
CN2206300000000	22	063	Livingston Parish, LA	2002	NA	46225	43308	2917	6.3
CN2206500000000	22	065	Madison Parish, LA	2002	NA	5014	4492	522	10.4
CN2206700000000	22	067	Morehouse Parish, LA	2002	NA	12439	11357	1082	8.7
CN2206900000000	22	069	Natchitoches Parish, LA	2002	NA	16508	15336	1172	7.1
CN2207100000000	22	071	Orleans Parish, LA	2002	NA	200243	187637	12606	6.3
CN2207300000000	22	073	Ouachita Parish, LA	2002	NA	71186	67387	3799	5.3
CN2207500000000	22	075	Plaquemines Parish, LA	2002	NA	10904	10219	685	6.3
CN2207700000000	22	077	Pointe Coupee Parish, LA	2002	NA	9334	8680	654	7
CN2207900000000	22	079	Rapides Parish, LA	2002	NA	55821	52407	3414	6.1
CN2208100000000	22	081	Red River Parish, LA	2002	NA	3632	3331	301	8.3
CN2208300000000	22	083	Richland Parish, LA	2002	NA	8391	7698	693	8.3
CN2208500000000	22	085	Sabine Parish, LA	2002	NA	9249	8532	717	7.8
CN2208700000000	22	087	St. Bernard Parish, LA	2002	NA	30933	29041	1892	6.1
CN2208900000000	22	089	St. Charles Parish, LA	2002	NA	23495	22163	1332	5.7
CN2209100000000	22	091	St. Helena Parish, LA	2002	NA	3892	3636	256	6.6
CN2209300000000	22	093	St. James Parish, LA	2002	NA	8683	7887	796	9.2
CN2209500000000	22	095	St. John the Baptist Parish, LA	2002	NA	19834	18415	1419	7.2
CN2209700000000	22	097	St. Landry Parish, LA	2002	NA	32921	30552	2369	7.2
CN2209900000000	22	099	St. Martin Parish, LA	2002	NA	21797	20311	1486	6.8
CN2210100000000	22	101	St. Mary Parish, LA	2002	NA	21993	20311	1682	7.6
CN2210300000000	22	103	St. Tammany Parish, LA	2002	NA	98187	93287	4900	5
CN2210500000000	22	105	Tangipahoa Parish, LA	2002	NA	45405	42221	3184	7
CN2210700000000	22	107	Tensas Parish, LA	2002	NA	2307	2106	201	8.7
CN2210900000000	22	109	Terrebonne Parish, LA	2002	NA	47735	45417	2318	4.9
CN2211100000000	22	111	Union Parish, LA	2002	NA	10416	9756	660	6.3
CN2211300000000	22	113	Vermilion Parish, LA	2002	NA	22803	21259	1544	6.8
CN2211500000000	22	115	Vernon Parish, LA	2002	NA	18379	17147	1232	6.7
CN2211700000000	22	117	Washington Parish, LA	2002	NA	16711	15467	1244	7.4
CN2211900000000	22	119	Webster Parish, LA	2002	NA	17977	16528	1449	8.1
CN2212100000000	22	121	West Baton Rouge Parish, LA	2002	NA	9880	9286	594	6
CN2212300000000	22	123	West Carroll Parish, LA	2002	NA	4775	4238	537	11.2
CN2212500000000	22	125	West Feliciana Parish, LA	2002	NA	4657	4310	347	7.5
CN2212700000000	22	127	Winn Parish, LA	2002	NA	6056	5596	460	7.6
CN2300100000000	23	001	Androscoggin County, ME	2002	NA	55568	53142	2426	4.4
CN2300300000000	23	003	Aroostook County, ME	2002	NA	34026	32268	1758	5.2
CN2300500000000	23	005	Cumberland County, ME	2002	NA	149285	144479	4806	3.2
CN2300700000000	23	007	Franklin County, ME	2002	NA	14210	13487	723	5.1
CN2300900000000	23	009	Hancock County, ME	2002	NA	28867	27624	1243	4.3
CN2301100000000	23	011	Kennebec County, ME	2002	NA	60453	57881	2572	4.3
CN2301300000000	23	013	Knox County, ME	2002	NA	21076	20380	696	3.3
CN2301500000000	23	015	Lincoln County, ME	2002	NA	17556	16929	627	3.6
CN2301700000000	23	017	Oxford County, ME	2002	NA	27419	25918	1501	5.5
CN2301900000000	23	019	Penobscot County, ME	2002	NA	76195	72681	3514	4.6
CN2302100000000	23	021	Piscataquis County, ME	2002	NA	7477	6960	517	6.9
CN2302300000000	23	023	Sagadahoc County, ME	2002	NA	18064	17431	633	3.5
CN2302500000000	23	025	Somerset County, ME	2002	NA	24438	22730	1708	7
CN2302700000000	23	027	Waldo County, ME	2002	NA	19311	18380	931	4.8
CN2302900000000	23	029	Washington County, ME	2002	NA	15201	14021	1180	7.8
CN2303100000000	23	031	York County, ME	2002	NA	106088	101626	4462	4.2
CN2400100000000	24	001	Allegany County, MD	2002	NA	33406	31346	2060	6.2
CN2400300000000	24	003	Anne Arundel County, MD	2002	NA	272721	262101	10620	3.9
CN2400500000000	24	005	Baltimore County, MD	2002	NA	414450	395451	18999	4.6
CN2400900000000	24	009	Calvert County, MD	2002	NA	42746	41271	1475	3.5
CN2401100000000	24	011	Caroline County, MD	2002	NA	15867	15144	723	4.6
CN2401300000000	24	013	Carroll County, MD	2002	NA	87782	84643	3139	3.6
CN2401500000000	24	015	Cecil County, MD	2002	NA	46977	44878	2099	4.5
CN2401700000000	24	017	Charles County, MD	2002	NA	67837	65463	2374	3.5
CN2401900000000	24	019	Dorchester County, MD	2002	NA	16353	15292	1061	6.5
CN2402100000000	24	021	Frederick County, MD	2002	NA	115010	111058	3952	3.4
CN2402300000000	24	023	Garrett County, MD	2002	NA	15522	14681	841	5.4
CN2402500000000	24	025	Harford County, MD	2002	NA	123984	118753	5231	4.2
CN2402700000000	24	027	Howard County, MD	2002	NA	150300	145126	5174	3.4
CN2402900000000	24	029	Kent County, MD	2002	NA	10805	10326	479	4.4
CN2403100000000	24	031	Montgomery County, MD	2002	NA	497631	480430	17201	3.5
CN2403300000000	24	033	Prince George's County, MD	2002	NA	437903	416730	21173	4.8
CN2403500000000	24	035	Queen Anne's County, MD	2002	NA	23714	22860	854	3.6
CN2403700000000	24	037	St. Mary's County, MD	2002	NA	47500	45788	1712	3.6
CN2403900000000	24	039	Somerset County, MD	2002	NA	11097	10356	741	6.7
CN2404100000000	24	041	Talbot County, MD	2002	NA	18652	17950	702	3.8
CN2404300000000	24	043	Washington County, MD	2002	NA	67872	64562	3310	4.9
CN2404500000000	24	045	Wicomico County, MD	2002	NA	48421	46098	2323	4.8
CN2404700000000	24	047	Worcester County, MD	2002	NA	28258	26485	1773	6.3
CN2451000000000	24	510	Baltimore city, MD	2002	NA	275146	255706	19440	7.1
CN2500100000000	25	001	Barnstable County, MA	2002	NA	118913	113334	5579	4.7
CN2500300000000	25	003	Berkshire County, MA	2002	NA	72848	69539	3309	4.5
CN2500500000000	25	005	Bristol County, MA	2002	NA	286122	268636	17486	6.1
CN2500700000000	25	007	Dukes County, MA	2002	NA	10656	10250	406	3.8
CN2500900000000	25	009	Essex County, MA	2002	NA	382262	359698	22564	5.9
CN2501100000000	25	011	Franklin County, MA	2002	NA	39977	38382	1595	4
CN2501300000000	25	013	Hampden County, MA	2002	NA	225050	212197	12853	5.7
CN2501500000000	25	015	Hampshire County, MA	2002	NA	87352	84240	3112	3.6
CN2501700000000	25	017	Middlesex County, MA	2002	NA	829752	788436	41316	5
CN2501900000000	25	019	Nantucket County/town, MA	2002	NA	7486	7341	145	1.9
CN2502100000000	25	021	Norfolk County, MA	2002	NA	360650	343935	16715	4.6
CN2502300000000	25	023	Plymouth County, MA	2002	NA	257513	244983	12530	4.9
CN2502500000000	25	025	Suffolk County, MA	2002	NA	352511	331632	20879	5.9
CN2502700000000	25	027	Worcester County, MA	2002	NA	399985	377483	22502	5.6
CN2600100000000	26	001	Alcona County, MI	2002	NA	4150	3701	449	10.8
CN2600300000000	26	003	Alger County, MI	2002	NA	4400	4082	318	7.2
CN2600500000000	26	005	Allegan County, MI	2002	NA	55028	51890	3138	5.7
CN2600700000000	26	007	Alpena County, MI	2002	NA	15197	13883	1314	8.6
CN2600900000000	26	009	Antrim County, MI	2002	NA	11613	10773	840	7.2
CN2601100000000	26	011	Arenac County, MI	2002	NA	7511	6827	684	9.1
CN2601300000000	26	013	Baraga County, MI	2002	NA	3842	3466	376	9.8
CN2601500000000	26	015	Barry County, MI	2002	NA	29836	28195	1641	5.5
CN2601700000000	26	017	Bay County, MI	2002	NA	54971	51280	3691	6.7
CN2601900000000	26	019	Benzie County, MI	2002	NA	8415	7828	587	7
CN2602100000000	26	021	Berrien County, MI	2002	NA	78891	73886	5005	6.3
CN2602300000000	26	023	Branch County, MI	2002	NA	22805	21410	1395	6.1
CN2602500000000	26	025	Calhoun County, MI	2002	NA	70021	65736	4285	6.1
CN2602700000000	26	027	Cass County, MI	2002	NA	26152	24866	1286	4.9
CN2602900000000	26	029	Charlevoix County, MI	2002	NA	13704	12704	1000	7.3
CN2603100000000	26	031	Cheboygan County, MI	2002	NA	12588	11260	1328	10.5
CN2603300000000	26	033	Chippewa County, MI	2002	NA	17009	15632	1377	8.1
CN2603500000000	26	035	Clare County, MI	2002	NA	12761	11718	1043	8.2
CN2603700000000	26	037	Clinton County, MI	2002	NA	35806	34384	1422	4
CN2603900000000	26	039	Crawford County, MI	2002	NA	6628	6164	464	7
CN2604100000000	26	041	Delta County, MI	2002	NA	19714	18237	1477	7.5
CN2604300000000	26	043	Dickinson County, MI	2002	NA	14096	13230	866	6.1
CN2604500000000	26	045	Eaton County, MI	2002	NA	57481	55075	2406	4.2
CN2604700000000	26	047	Emmet County, MI	2002	NA	18419	17085	1334	7.2
CN2604900000000	26	049	Genesee County, MI	2002	NA	210306	194623	15683	7.5
CN2605100000000	26	051	Gladwin County, MI	2002	NA	10978	10067	911	8.3
CN2605300000000	26	053	Gogebic County, MI	2002	NA	7849	7230	619	7.9
CN2605500000000	26	055	Grand Traverse County, MI	2002	NA	45544	42943	2601	5.7
CN2605700000000	26	057	Gratiot County, MI	2002	NA	19325	18133	1192	6.2
CN2605900000000	26	059	Hillsdale County, MI	2002	NA	23093	21637	1456	6.3
CN2606100000000	26	061	Houghton County, MI	2002	NA	16873	15701	1172	6.9
CN2606300000000	26	063	Huron County, MI	2002	NA	16880	15387	1493	8.8
CN2606500000000	26	065	Ingham County, MI	2002	NA	152030	144855	7175	4.7
CN2606700000000	26	067	Ionia County, MI	2002	NA	29655	27764	1891	6.4
CN2606900000000	26	069	Iosco County, MI	2002	NA	10729	9639	1090	10.2
CN2607100000000	26	071	Iron County, MI	2002	NA	5690	5278	412	7.2
CN2607300000000	26	073	Isabella County, MI	2002	NA	34953	33403	1550	4.4
CN2607500000000	26	075	Jackson County, MI	2002	NA	78003	72768	5235	6.7
CN2607700000000	26	077	Kalamazoo County, MI	2002	NA	129610	123404	6206	4.8
CN2607900000000	26	079	Kalkaska County, MI	2002	NA	8478	7816	662	7.8
CN2608100000000	26	081	Kent County, MI	2002	NA	314301	294931	19370	6.2
CN2608300000000	26	083	Keweenaw County, MI	2002	NA	1027	934	93	9.1
CN2608500000000	26	085	Lake County, MI	2002	NA	4463	4078	385	8.6
CN2608700000000	26	087	Lapeer County, MI	2002	NA	45325	41930	3395	7.5
CN2608900000000	26	089	Leelanau County, MI	2002	NA	10984	10451	533	4.9
CN2609100000000	26	091	Lenawee County, MI	2002	NA	50606	47409	3197	6.3
CN2609300000000	26	093	Livingston County, MI	2002	NA	90513	86477	4036	4.5
CN2609500000000	26	095	Luce County, MI	2002	NA	2894	2678	216	7.5
CN2609700000000	26	097	Mackinac County, MI	2002	NA	6623	5996	627	9.5
CN2609900000000	26	099	Macomb County, MI	2002	NA	422480	396836	25644	6.1
CN2610100000000	26	101	Manistee County, MI	2002	NA	11914	11000	914	7.7
CN2610300000000	26	103	Marquette County, MI	2002	NA	33653	31306	2347	7
CN2610500000000	26	105	Mason County, MI	2002	NA	15363	13628	1735	11.3
CN2610700000000	26	107	Mecosta County, MI	2002	NA	19079	17904	1175	6.2
CN2610900000000	26	109	Menominee County, MI	2002	NA	13083	12260	823	6.3
CN2611100000000	26	111	Midland County, MI	2002	NA	41753	39455	2298	5.5
CN2611300000000	26	113	Missaukee County, MI	2002	NA	6716	6220	496	7.4
CN2611500000000	26	115	Monroe County, MI	2002	NA	76747	72714	4033	5.3
CN2611700000000	26	117	Montcalm County, MI	2002	NA	29244	27030	2214	7.6
CN2611900000000	26	119	Montmorency County, MI	2002	NA	4241	3781	460	10.8
CN2612100000000	26	121	Muskegon County, MI	2002	NA	85594	78772	6822	8
CN2612300000000	26	123	Newaygo County, MI	2002	NA	22830	20992	1838	8.1
CN2612500000000	26	125	Oakland County, MI	2002	NA	646548	613059	33489	5.2
CN2612700000000	26	127	Oceana County, MI	2002	NA	13422	12255	1167	8.7
CN2612900000000	26	129	Ogemaw County, MI	2002	NA	9665	8852	813	8.4
CN2613100000000	26	131	Ontonagon County, MI	2002	NA	3499	3234	265	7.6
CN2613300000000	26	133	Osceola County, MI	2002	NA	10945	10174	771	7
CN2613500000000	26	135	Oscoda County, MI	2002	NA	3766	3350	416	11
CN2613700000000	26	137	Otsego County, MI	2002	NA	12229	11317	912	7.5
CN2613900000000	26	139	Ottawa County, MI	2002	NA	130590	123438	7152	5.5
CN2614100000000	26	141	Presque Isle County, MI	2002	NA	6465	5783	682	10.5
CN2614300000000	26	143	Roscommon County, MI	2002	NA	10452	9630	822	7.9
CN2614500000000	26	145	Saginaw County, MI	2002	NA	97718	90666	7052	7.2
CN2614700000000	26	147	St. Clair County, MI	2002	NA	84944	78702	6242	7.3
CN2614900000000	26	149	St. Joseph County, MI	2002	NA	30516	28518	1998	6.5
CN2615100000000	26	151	Sanilac County, MI	2002	NA	21614	19843	1771	8.2
CN2615300000000	26	153	Schoolcraft County, MI	2002	NA	3837	3448	389	10.1
CN2615500000000	26	155	Shiawassee County, MI	2002	NA	35554	33207	2347	6.6
CN2615700000000	26	157	Tuscola County, MI	2002	NA	28867	26543	2324	8.1
CN2615900000000	26	159	Van Buren County, MI	2002	NA	39170	36707	2463	6.3
CN2616100000000	26	161	Washtenaw County, MI	2002	NA	185034	178274	6760	3.7
CN2616300000000	26	163	Wayne County, MI	2002	NA	917251	851213	66038	7.2
CN2616500000000	26	165	Wexford County, MI	2002	NA	14595	13447	1148	7.9
CN2700100000000	27	001	Aitkin County, MN	2002	NA	7475	6986	489	6.5
CN2700300000000	27	003	Anoka County, MN	2002	NA	183612	175519	8093	4.4
CN2700500000000	27	005	Becker County, MN	2002	NA	16370	15478	892	5.4
CN2700700000000	27	007	Beltrami County, MN	2002	NA	21326	20292	1034	4.8
CN2700900000000	27	009	Benton County, MN	2002	NA	21600	20512	1088	5
CN2701100000000	27	011	Big Stone County, MN	2002	NA	2879	2757	122	4.2
CN2701300000000	27	013	Blue Earth County, MN	2002	NA	35086	33840	1246	3.6
CN2701500000000	27	015	Brown County, MN	2002	NA	15379	14675	704	4.6
CN2701700000000	27	017	Carlton County, MN	2002	NA	16322	15313	1009	6.2
CN2701900000000	27	019	Carver County, MN	2002	NA	43612	41845	1767	4.1
CN2702100000000	27	021	Cass County, MN	2002	NA	13986	13141	845	6
CN2702300000000	27	023	Chippewa County, MN	2002	NA	7410	7065	345	4.7
CN2702500000000	27	025	Chisago County, MN	2002	NA	24887	23558	1329	5.3
CN2702700000000	27	027	Clay County, MN	2002	NA	28843	27827	1016	3.5
CN2702900000000	27	029	Clearwater County, MN	2002	NA	4303	3857	446	10.4
CN2703100000000	27	031	Cook County, MN	2002	NA	3182	3029	153	4.8
CN2703300000000	27	033	Cottonwood County, MN	2002	NA	6458	6188	270	4.2
CN2703500000000	27	035	Crow Wing County, MN	2002	NA	30945	29322	1623	5.2
CN2703700000000	27	037	Dakota County, MN	2002	NA	221067	212363	8704	3.9
CN2703900000000	27	039	Dodge County, MN	2002	NA	10736	10312	424	3.9
CN2704100000000	27	041	Douglas County, MN	2002	NA	19327	18615	712	3.7
CN2704300000000	27	043	Faribault County, MN	2002	NA	8841	8463	378	4.3
CN2704500000000	27	045	Fillmore County, MN	2002	NA	11889	11389	500	4.2
CN2704700000000	27	047	Freeborn County, MN	2002	NA	17180	16342	838	4.9
CN2704900000000	27	049	Goodhue County, MN	2002	NA	25665	24519	1146	4.5
CN2705100000000	27	051	Grant County, MN	2002	NA	3313	3108	205	6.2
CN2705300000000	27	053	Hennepin County, MN	2002	NA	661528	632374	29154	4.4
CN2705500000000	27	055	Houston County, MN	2002	NA	11210	10668	542	4.8
CN2705700000000	27	057	Hubbard County, MN	2002	NA	9753	9245	508	5.2
CN2705900000000	27	059	Isanti County, MN	2002	NA	19113	18121	992	5.2
CN2706100000000	27	061	Itasca County, MN	2002	NA	22623	21215	1408	6.2
CN2706300000000	27	063	Jackson County, MN	2002	NA	6507	6270	237	3.6
CN2706500000000	27	065	Kanabec County, MN	2002	NA	7988	7400	588	7.4
CN2706700000000	27	067	Kandiyohi County, MN	2002	NA	23388	22433	955	4.1
CN2706900000000	27	069	Kittson County, MN	2002	NA	2625	2470	155	5.9
CN2707100000000	27	071	Koochiching County, MN	2002	NA	7251	6815	436	6
CN2707300000000	27	073	Lac qui Parle County, MN	2002	NA	4174	4019	155	3.7
CN2707500000000	27	075	Lake County, MN	2002	NA	6114	5820	294	4.8
CN2707700000000	27	077	Lake of the Woods County, MN	2002	NA	2355	2246	109	4.6
CN2707900000000	27	079	Le Sueur County, MN	2002	NA	15035	14145	890	5.9
CN2708100000000	27	081	Lincoln County, MN	2002	NA	3425	3298	127	3.7
CN2708300000000	27	083	Lyon County, MN	2002	NA	14507	13942	565	3.9
CN2708500000000	27	085	McLeod County, MN	2002	NA	20160	19296	864	4.3
CN2708700000000	27	087	Mahnomen County, MN	2002	NA	2771	2608	163	5.9
CN2708900000000	27	089	Marshall County, MN	2002	NA	5275	4868	407	7.7
CN2709100000000	27	091	Martin County, MN	2002	NA	12066	11585	481	4
CN2709300000000	27	093	Meeker County, MN	2002	NA	12622	11972	650	5.1
CN2709500000000	27	095	Mille Lacs County, MN	2002	NA	12006	11240	766	6.4
CN2709700000000	27	097	Morrison County, MN	2002	NA	17320	16329	991	5.7
CN2709900000000	27	099	Mower County, MN	2002	NA	20412	19601	811	4
CN2710100000000	27	101	Murray County, MN	2002	NA	5499	5290	209	3.8
CN2710300000000	27	103	Nicollet County, MN	2002	NA	18862	18191	671	3.6
CN2710500000000	27	105	Nobles County, MN	2002	NA	11285	10912	373	3.3
CN2710700000000	27	107	Norman County, MN	2002	NA	3767	3587	180	4.8
CN2710900000000	27	109	Olmsted County, MN	2002	NA	75905	72983	2922	3.8
CN2711100000000	27	111	Otter Tail County, MN	2002	NA	29785	28288	1497	5
CN2711300000000	27	113	Pennington County, MN	2002	NA	7902	7441	461	5.8
CN2711500000000	27	115	Pine County, MN	2002	NA	14551	13615	936	6.4
CN2711700000000	27	117	Pipestone County, MN	2002	NA	5483	5307	176	3.2
CN2711900000000	27	119	Polk County, MN	2002	NA	16231	15322	909	5.6
CN2712100000000	27	121	Pope County, MN	2002	NA	6053	5818	235	3.9
CN2712300000000	27	123	Ramsey County, MN	2002	NA	282104	269783	12321	4.4
CN2712500000000	27	125	Red Lake County, MN	2002	NA	2213	2028	185	8.4
CN2712700000000	27	127	Redwood County, MN	2002	NA	8834	8478	356	4
CN2712900000000	27	129	Renville County, MN	2002	NA	9070	8627	443	4.9
CN2713100000000	27	131	Rice County, MN	2002	NA	32960	31478	1482	4.5
CN2713300000000	27	133	Rock County, MN	2002	NA	5357	5194	163	3
CN2713500000000	27	135	Roseau County, MN	2002	NA	9843	9326	517	5.3
CN2713700000000	27	137	St. Louis County, MN	2002	NA	103270	97438	5832	5.6
CN2713900000000	27	139	Scott County, MN	2002	NA	61168	58653	2515	4.1
CN2714100000000	27	141	Sherburne County, MN	2002	NA	41524	39552	1972	4.7
CN2714300000000	27	143	Sibley County, MN	2002	NA	9038	8643	395	4.4
CN2714500000000	27	145	Stearns County, MN	2002	NA	79745	76257	3488	4.4
CN2714700000000	27	147	Steele County, MN	2002	NA	19534	18659	875	4.5
CN2714900000000	27	149	Stevens County, MN	2002	NA	5793	5580	213	3.7
CN2715100000000	27	151	Swift County, MN	2002	NA	5617	5344	273	4.9
CN2715300000000	27	153	Todd County, MN	2002	NA	12849	12222	627	4.9
CN2715500000000	27	155	Traverse County, MN	2002	NA	1931	1847	84	4.4
CN2715700000000	27	157	Wabasha County, MN	2002	NA	12571	12094	477	3.8
CN2715900000000	27	159	Wadena County, MN	2002	NA	6674	6265	409	6.1
CN2716100000000	27	161	Waseca County, MN	2002	NA	10674	10182	492	4.6
CN2716300000000	27	163	Washington County, MN	2002	NA	120946	116297	4649	3.8
CN2716500000000	27	165	Watonwan County, MN	2002	NA	6058	5816	242	4
CN2716700000000	27	167	Wilkin County, MN	2002	NA	3761	3616	145	3.9
CN2716900000000	27	169	Winona County, MN	2002	NA	28712	27543	1169	4.1
CN2717100000000	27	171	Wright County, MN	2002	NA	56431	53694	2737	4.9
CN2717300000000	27	173	Yellow Medicine County, MN	2002	NA	5690	5422	268	4.7
CN2800100000000	28	001	Adams County, MS	2002	NA	13887	12869	1018	7.3
CN2800300000000	28	003	Alcorn County, MS	2002	NA	15970	14709	1261	7.9
CN2800500000000	28	005	Amite County, MS	2002	NA	5233	4879	354	6.8
CN2800700000000	28	007	Attala County, MS	2002	NA	8759	8120	639	7.3
CN2800900000000	28	009	Benton County, MS	2002	NA	2987	2654	333	11.1
CN2801100000000	28	011	Bolivar County, MS	2002	NA	15839	14272	1567	9.9
CN2801300000000	28	013	Calhoun County, MS	2002	NA	6577	6073	504	7.7
CN2801500000000	28	015	Carroll County, MS	2002	NA	5021	4670	351	7
CN2801700000000	28	017	Chickasaw County, MS	2002	NA	8014	7235	779	9.7
CN2801900000000	28	019	Choctaw County, MS	2002	NA	3666	3225	441	12
CN2802100000000	28	021	Claiborne County, MS	2002	NA	4083	3685	398	9.7
CN2802300000000	28	023	Clarke County, MS	2002	NA	7641	6596	1045	13.7
CN2802500000000	28	025	Clay County, MS	2002	NA	9525	8643	882	9.3
CN2802700000000	28	027	Coahoma County, MS	2002	NA	11546	10533	1013	8.8
CN2802900000000	28	029	Copiah County, MS	2002	NA	12100	11245	855	7.1
CN2803100000000	28	031	Covington County, MS	2002	NA	8387	7894	493	5.9
CN2803300000000	28	033	DeSoto County, MS	2002	NA	62029	59762	2267	3.7
CN2803500000000	28	035	Forrest County, MS	2002	NA	34761	32801	1960	5.6
CN2803700000000	28	037	Franklin County, MS	2002	NA	3279	3003	276	8.4
CN2803900000000	28	039	George County, MS	2002	NA	8192	7441	751	9.2
CN2804100000000	28	041	Greene County, MS	2002	NA	4835	4398	437	9
CN2804300000000	28	043	Grenada County, MS	2002	NA	9854	9191	663	6.7
CN2804500000000	28	045	Hancock County, MS	2002	NA	19765	18705	1060	5.4
CN2804700000000	28	047	Harrison County, MS	2002	NA	89472	84673	4799	5.4
CN2804900000000	28	049	Hinds County, MS	2002	NA	119845	112967	6878	5.7
CN2805100000000	28	051	Holmes County, MS	2002	NA	6900	6086	814	11.8
CN2805300000000	28	053	Humphreys County, MS	2002	NA	4452	4005	447	10
CN2805500000000	28	055	Issaquena County, MS	2002	NA	836	739	97	11.6
CN2805700000000	28	057	Itawamba County, MS	2002	NA	10511	9865	646	6.1
CN2805900000000	28	059	Jackson County, MS	2002	NA	59517	55452	4065	6.8
CN2806100000000	28	061	Jasper County, MS	2002	NA	7190	6614	576	8
CN2806300000000	28	063	Jefferson County, MS	2002	NA	2922	2570	352	12
CN2806500000000	28	065	Jefferson Davis County, MS	2002	NA	5229	4824	405	7.7
CN2806700000000	28	067	Jones County, MS	2002	NA	28419	26858	1561	5.5
CN2806900000000	28	069	Kemper County, MS	2002	NA	4274	3870	404	9.5
CN2807100000000	28	071	Lafayette County, MS	2002	NA	19957	18985	972	4.9
CN2807300000000	28	073	Lamar County, MS	2002	NA	20489	19581	908	4.4
CN2807500000000	28	075	Lauderdale County, MS	2002	NA	32954	30801	2153	6.5
CN2807700000000	28	077	Lawrence County, MS	2002	NA	5278	4905	373	7.1
CN2807900000000	28	079	Leake County, MS	2002	NA	9982	9363	619	6.2
CN2808100000000	28	081	Lee County, MS	2002	NA	38235	35943	2292	6
CN2808300000000	28	083	Leflore County, MS	2002	NA	14330	12936	1394	9.7
CN2808500000000	28	085	Lincoln County, MS	2002	NA	14198	13187	1011	7.1
CN2808700000000	28	087	Lowndes County, MS	2002	NA	26152	23995	2157	8.2
CN2808900000000	28	089	Madison County, MS	2002	NA	40177	38252	1925	4.8
CN2809100000000	28	091	Marion County, MS	2002	NA	10238	9631	607	5.9
CN2809300000000	28	093	Marshall County, MS	2002	NA	15178	13964	1214	8
CN2809500000000	28	095	Monroe County, MS	2002	NA	16640	15277	1363	8.2
CN2809700000000	28	097	Montgomery County, MS	2002	NA	4962	4406	556	11.2
CN2809900000000	28	099	Neshoba County, MS	2002	NA	14264	13330	934	6.5
CN2810100000000	28	101	Newton County, MS	2002	NA	9667	9016	651	6.7
CN2810300000000	28	103	Noxubee County, MS	2002	NA	4532	4100	432	9.5
CN2810500000000	28	105	Oktibbeha County, MS	2002	NA	20038	18902	1136	5.7
CN2810700000000	28	107	Panola County, MS	2002	NA	14478	13275	1203	8.3
CN2810900000000	28	109	Pearl River County, MS	2002	NA	21320	20161	1159	5.4
CN2811100000000	28	111	Perry County, MS	2002	NA	5143	4771	372	7.2
CN2811300000000	28	113	Pike County, MS	2002	NA	15187	14046	1141	7.5
CN2811500000000	28	115	Pontotoc County, MS	2002	NA	13052	12310	742	5.7
CN2811700000000	28	117	Prentiss County, MS	2002	NA	12003	11264	739	6.2
CN2811900000000	28	119	Quitman County, MS	2002	NA	4049	3707	342	8.4
CN2812100000000	28	121	Rankin County, MS	2002	NA	65323	62576	2747	4.2
CN2812300000000	28	123	Scott County, MS	2002	NA	12498	11725	773	6.2
CN2812500000000	28	125	Sharkey County, MS	2002	NA	2628	2362	266	10.1
CN2812700000000	28	127	Simpson County, MS	2002	NA	11714	11055	659	5.6
CN2812900000000	28	129	Smith County, MS	2002	NA	7242	6859	383	5.3
CN2813100000000	28	131	Stone County, MS	2002	NA	6625	6253	372	5.6
CN2813300000000	28	133	Sunflower County, MS	2002	NA	11598	10376	1222	10.5
CN2813500000000	28	135	Tallahatchie County, MS	2002	NA	5723	5185	538	9.4
CN2813700000000	28	137	Tate County, MS	2002	NA	11420	10793	627	5.5
CN2813900000000	28	139	Tippah County, MS	2002	NA	9212	8517	695	7.5
CN2814100000000	28	141	Tishomingo County, MS	2002	NA	8636	7790	846	9.8
CN2814300000000	28	143	Tunica County, MS	2002	NA	4120	3827	293	7.1
CN2814500000000	28	145	Union County, MS	2002	NA	11810	11046	764	6.5
CN2814700000000	28	147	Walthall County, MS	2002	NA	5924	5477	447	7.5
CN2814900000000	28	149	Warren County, MS	2002	NA	23250	21803	1447	6.2
CN2815100000000	28	151	Washington County, MS	2002	NA	24613	22050	2563	10.4
CN2815300000000	28	153	Wayne County, MS	2002	NA	8551	7787	764	8.9
CN2815500000000	28	155	Webster County, MS	2002	NA	3778	3168	610	16.1
CN2815700000000	28	157	Wilkinson County, MS	2002	NA	3367	3068	299	8.9
CN2815900000000	28	159	Winston County, MS	2002	NA	7926	7149	777	9.8
CN2816100000000	28	161	Yalobusha County, MS	2002	NA	5575	5187	388	7
CN2816300000000	28	163	Yazoo County, MS	2002	NA	10684	9905	779	7.3
CN2900100000000	29	001	Adair County, MO	2002	NA	13384	12800	584	4.4
CN2900300000000	29	003	Andrew County, MO	2002	NA	9193	8741	452	4.9
CN2900500000000	29	005	Atchison County, MO	2002	NA	3389	3258	131	3.9
CN2900700000000	29	007	Audrain County, MO	2002	NA	12456	11772	684	5.5
CN2900900000000	29	009	Barry County, MO	2002	NA	17460	16621	839	4.8
CN2901100000000	29	011	Barton County, MO	2002	NA	6770	6474	296	4.4
CN2901300000000	29	013	Bates County, MO	2002	NA	8117	7637	480	5.9
CN2901500000000	29	015	Benton County, MO	2002	NA	8097	7564	533	6.6
CN2901700000000	29	017	Bollinger County, MO	2002	NA	6290	5888	402	6.4
CN2901900000000	29	019	Boone County, MO	2002	NA	81917	79083	2834	3.5
CN2902100000000	29	021	Buchanan County, MO	2002	NA	43536	41009	2527	5.8
CN2902300000000	29	023	Butler County, MO	2002	NA	20564	19431	1133	5.5
CN2902500000000	29	025	Caldwell County, MO	2002	NA	4406	4166	240	5.4
CN2902700000000	29	027	Callaway County, MO	2002	NA	22369	21373	996	4.5
CN2902900000000	29	029	Camden County, MO	2002	NA	20304	19120	1184	5.8
CN2903100000000	29	031	Cape Girardeau County, MO	2002	NA	39782	38102	1680	4.2
CN2903300000000	29	033	Carroll County, MO	2002	NA	5188	4906	282	5.4
CN2903500000000	29	035	Carter County, MO	2002	NA	2809	2620	189	6.7
CN2903700000000	29	037	Cass County, MO	2002	NA	46234	44094	2140	4.6
CN2903900000000	29	039	Cedar County, MO	2002	NA	6183	5813	370	6
CN2904100000000	29	041	Chariton County, MO	2002	NA	4376	4101	275	6.3
CN2904300000000	29	043	Christian County, MO	2002	NA	33289	31676	1613	4.8
CN2904500000000	29	045	Clark County, MO	2002	NA	3724	3485	239	6.4
CN2904700000000	29	047	Clay County, MO	2002	NA	108253	103560	4693	4.3
CN2904900000000	29	049	Clinton County, MO	2002	NA	10061	9538	523	5.2
CN2905100000000	29	051	Cole County, MO	2002	NA	39590	38046	1544	3.9
CN2905300000000	29	053	Cooper County, MO	2002	NA	8844	8424	420	4.7
CN2905500000000	29	055	Crawford County, MO	2002	NA	11813	11112	701	5.9
CN2905700000000	29	057	Dade County, MO	2002	NA	3877	3686	191	4.9
CN2905900000000	29	059	Dallas County, MO	2002	NA	7299	6867	432	5.9
CN2906100000000	29	061	Daviess County, MO	2002	NA	4011	3813	198	4.9
CN2906300000000	29	063	DeKalb County, MO	2002	NA	5072	4765	307	6.1
CN2906500000000	29	065	Dent County, MO	2002	NA	6728	6306	422	6.3
CN2906700000000	29	067	Douglas County, MO	2002	NA	6038	5519	519	8.6
CN2906900000000	29	069	Dunklin County, MO	2002	NA	14995	13952	1043	7
CN2907100000000	29	071	Franklin County, MO	2002	NA	52344	49445	2899	5.5
CN2907300000000	29	073	Gasconade County, MO	2002	NA	7822	7379	443	5.7
CN2907500000000	29	075	Gentry County, MO	2002	NA	3396	3227	169	5
CN2907700000000	29	077	Greene County, MO	2002	NA	134152	128066	6086	4.5
CN2907900000000	29	079	Grundy County, MO	2002	NA	5172	4901	271	5.2
CN2908100000000	29	081	Harrison County, MO	2002	NA	4488	4263	225	5
CN2908300000000	29	083	Henry County, MO	2002	NA	11081	10435	646	5.8
CN2908500000000	29	085	Hickory County, MO	2002	NA	3375	3140	235	7
CN2908700000000	29	087	Holt County, MO	2002	NA	2728	2603	125	4.6
CN2908900000000	29	089	Howard County, MO	2002	NA	5398	5153	245	4.5
CN2909100000000	29	091	Howell County, MO	2002	NA	19209	18250	959	5
CN2909300000000	29	093	Iron County, MO	2002	NA	5073	4662	411	8.1
CN2909500000000	29	095	Jackson County, MO	2002	NA	344703	323714	20989	6.1
CN2909700000000	29	097	Jasper County, MO	2002	NA	53777	50948	2829	5.3
CN2909900000000	29	099	Jefferson County, MO	2002	NA	113736	107781	5955	5.2
CN2910100000000	29	101	Johnson County, MO	2002	NA	24883	23734	1149	4.6
CN2910300000000	29	103	Knox County, MO	2002	NA	2164	2067	97	4.5
CN2910500000000	29	105	Laclede County, MO	2002	NA	16915	15938	977	5.8
CN2910700000000	29	107	Lafayette County, MO	2002	NA	17109	16239	870	5.1
CN2910900000000	29	109	Lawrence County, MO	2002	NA	18445	17543	902	4.9
CN2911100000000	29	111	Lewis County, MO	2002	NA	5757	5470	287	5
CN2911300000000	29	113	Lincoln County, MO	2002	NA	22467	21245	1222	5.4
CN2911500000000	29	115	Linn County, MO	2002	NA	7164	6658	506	7.1
CN2911700000000	29	117	Livingston County, MO	2002	NA	7550	7216	334	4.4
CN2911900000000	29	119	McDonald County, MO	2002	NA	11549	10962	587	5.1
CN2912100000000	29	121	Macon County, MO	2002	NA	8299	7831	468	5.6
CN2912300000000	29	123	Madison County, MO	2002	NA	5778	5367	411	7.1
CN2912500000000	29	125	Maries County, MO	2002	NA	4807	4547	260	5.4
CN2912700000000	29	127	Marion County, MO	2002	NA	14749	13950	799	5.4
CN2912900000000	29	129	Mercer County, MO	2002	NA	1836	1746	90	4.9
CN2913100000000	29	131	Miller County, MO	2002	NA	12856	12020	836	6.5
CN2913300000000	29	133	Mississippi County, MO	2002	NA	6017	5555	462	7.7
CN2913500000000	29	135	Moniteau County, MO	2002	NA	7504	7124	380	5.1
CN2913700000000	29	137	Monroe County, MO	2002	NA	4572	4318	254	5.6
CN2913900000000	29	139	Montgomery County, MO	2002	NA	6486	6143	343	5.3
CN2914100000000	29	141	Morgan County, MO	2002	NA	9523	8886	637	6.7
CN2914300000000	29	143	New Madrid County, MO	2002	NA	9026	8306	720	8
CN2914500000000	29	145	Newton County, MO	2002	NA	27231	25624	1607	5.9
CN2914700000000	29	147	Nodaway County, MO	2002	NA	12144	11718	426	3.5
CN2914900000000	29	149	Oregon County, MO	2002	NA	4330	4091	239	5.5
CN2915100000000	29	151	Osage County, MO	2002	NA	7330	6938	392	5.3
CN2915300000000	29	153	Ozark County, MO	2002	NA	4486	4207	279	6.2
CN2915500000000	29	155	Pemiscot County, MO	2002	NA	8393	7682	711	8.5
CN2915700000000	29	157	Perry County, MO	2002	NA	10047	9635	412	4.1
CN2915900000000	29	159	Pettis County, MO	2002	NA	20955	19693	1262	6
CN2916100000000	29	161	Phelps County, MO	2002	NA	21581	20645	936	4.3
CN2916300000000	29	163	Pike County, MO	2002	NA	9030	8562	468	5.2
CN2916500000000	29	165	Platte County, MO	2002	NA	46127	44158	1969	4.3
CN2916700000000	29	167	Polk County, MO	2002	NA	13461	12781	680	5.1
CN2916900000000	29	169	Pulaski County, MO	2002	NA	16700	15803	897	5.4
CN2917100000000	29	171	Putnam County, MO	2002	NA	2448	2334	114	4.7
CN2917300000000	29	173	Ralls County, MO	2002	NA	5672	5373	299	5.3
CN2917500000000	29	175	Randolph County, MO	2002	NA	12870	12184	686	5.3
CN2917700000000	29	177	Ray County, MO	2002	NA	11898	11318	580	4.9
CN2917900000000	29	179	Reynolds County, MO	2002	NA	2553	2343	210	8.2
CN2918100000000	29	181	Ripley County, MO	2002	NA	6113	5722	391	6.4
CN2918300000000	29	183	St. Charles County, MO	2002	NA	176480	169069	7411	4.2
CN2918500000000	29	185	St. Clair County, MO	2002	NA	4531	4260	271	6
CN2918600000000	29	186	Ste. Genevieve County, MO	2002	NA	9525	9025	500	5.2
CN2918700000000	29	187	St. Francois County, MO	2002	NA	26904	25060	1844	6.9
CN2918900000000	29	189	St. Louis County, MO	2002	NA	556350	528985	27365	4.9
CN2919500000000	29	195	Saline County, MO	2002	NA	11947	11259	688	5.8
CN2919700000000	29	197	Schuyler County, MO	2002	NA	2196	2071	125	5.7
CN2919900000000	29	199	Scotland County, MO	2002	NA	2514	2401	113	4.5
CN2920100000000	29	201	Scott County, MO	2002	NA	20847	19683	1164	5.6
CN2920300000000	29	203	Shannon County, MO	2002	NA	4038	3764	274	6.8
CN2920500000000	29	205	Shelby County, MO	2002	NA	3250	3070	180	5.5
CN2920700000000	29	207	Stoddard County, MO	2002	NA	15373	14434	939	6.1
CN2920900000000	29	209	Stone County, MO	2002	NA	15479	14152	1327	8.6
CN2921100000000	29	211	Sullivan County, MO	2002	NA	3683	3496	187	5.1
CN2921300000000	29	213	Taney County, MO	2002	NA	24724	22479	2245	9.1
CN2921500000000	29	215	Texas County, MO	2002	NA	10872	10164	708	6.5
CN2921700000000	29	217	Vernon County, MO	2002	NA	10516	9984	532	5.1
CN2921900000000	29	219	Warren County, MO	2002	NA	14371	13609	762	5.3
CN2922100000000	29	221	Washington County, MO	2002	NA	10132	9268	864	8.5
CN2922300000000	29	223	Wayne County, MO	2002	NA	5736	5291	445	7.8
CN2922500000000	29	225	Webster County, MO	2002	NA	15957	15060	897	5.6
CN2922700000000	29	227	Worth County, MO	2002	NA	1210	1157	53	4.4
CN2922900000000	29	229	Wright County, MO	2002	NA	8216	7654	562	6.8
CN2951000000000	29	510	St. Louis city, MO	2002	NA	164366	151110	13256	8.1
CN3000100000000	30	001	Beaverhead County, MT	2002	NA	5136	4948	188	3.7
CN3000300000000	30	003	Big Horn County, MT	2002	NA	4905	4388	517	10.5
CN3000500000000	30	005	Blaine County, MT	2002	NA	2768	2635	133	4.8
CN3000700000000	30	007	Broadwater County, MT	2002	NA	2213	2125	88	4
CN3000900000000	30	009	Carbon County, MT	2002	NA	5198	5006	192	3.7
CN3001100000000	30	011	Carter County, MT	2002	NA	658	637	21	3.2
CN3001300000000	30	013	Cascade County, MT	2002	NA	38055	36457	1598	4.2
CN3001500000000	30	015	Chouteau County, MT	2002	NA	2468	2383	85	3.4
CN3001700000000	30	017	Custer County, MT	2002	NA	5717	5505	212	3.7
CN3001900000000	30	019	Daniels County, MT	2002	NA	880	842	38	4.3
CN3002100000000	30	021	Dawson County, MT	2002	NA	4321	4176	145	3.4
CN3002300000000	30	023	Deer Lodge County, MT	2002	NA	4242	3991	251	5.9
CN3002500000000	30	025	Fallon County, MT	2002	NA	1568	1518	50	3.2
CN3002700000000	30	027	Fergus County, MT	2002	NA	5858	5588	270	4.6
CN3002900000000	30	029	Flathead County, MT	2002	NA	39966	37942	2024	5.1
CN3003100000000	30	031	Gallatin County, MT	2002	NA	42029	40621	1408	3.4
CN3003300000000	30	033	Garfield County, MT	2002	NA	622	600	22	3.5
CN3003500000000	30	035	Glacier County, MT	2002	NA	5572	5197	375	6.7
CN3003700000000	30	037	Golden Valley County, MT	2002	NA	436	415	21	4.8
CN3003900000000	30	039	Granite County, MT	2002	NA	1288	1214	74	5.7
CN3004100000000	30	041	Hill County, MT	2002	NA	7845	7527	318	4.1
CN3004300000000	30	043	Jefferson County, MT	2002	NA	5347	5121	226	4.2
CN3004500000000	30	045	Judith Basin County, MT	2002	NA	1074	1022	52	4.8
CN3004700000000	30	047	Lake County, MT	2002	NA	11505	10751	754	6.6
CN3004900000000	30	049	Lewis and Clark County, MT	2002	NA	30495	29301	1194	3.9
CN3005100000000	30	051	Liberty County, MT	2002	NA	833	800	33	4
CN3005300000000	30	053	Lincoln County, MT	2002	NA	7545	6874	671	8.9
CN3005500000000	30	055	McCone County, MT	2002	NA	994	968	26	2.6
CN3005700000000	30	057	Madison County, MT	2002	NA	3316	3169	147	4.4
CN3005900000000	30	059	Meagher County, MT	2002	NA	885	836	49	5.5
CN3006100000000	30	061	Mineral County, MT	2002	NA	1901	1774	127	6.7
CN3006300000000	30	063	Missoula County, MT	2002	NA	55994	53842	2152	3.8
CN3006500000000	30	065	Musselshell County, MT	2002	NA	2057	1932	125	6.1
CN3006700000000	30	067	Park County, MT	2002	NA	8638	8251	387	4.5
CN3006900000000	30	069	Petroleum County, MT	2002	NA	197	186	11	5.6
CN3007100000000	30	071	Phillips County, MT	2002	NA	2106	2014	92	4.4
CN3007300000000	30	073	Pondera County, MT	2002	NA	2751	2629	122	4.4
CN3007500000000	30	075	Powder River County, MT	2002	NA	887	855	32	3.6
CN3007700000000	30	077	Powell County, MT	2002	NA	2758	2589	169	6.1
CN3007900000000	30	079	Prairie County, MT	2002	NA	565	537	28	5
CN3008100000000	30	081	Ravalli County, MT	2002	NA	17494	16599	895	5.1
CN3008300000000	30	083	Richland County, MT	2002	NA	4785	4549	236	4.9
CN3008500000000	30	085	Roosevelt County, MT	2002	NA	4071	3837	234	5.7
CN3008700000000	30	087	Rosebud County, MT	2002	NA	4006	3779	227	5.7
CN3008900000000	30	089	Sanders County, MT	2002	NA	4400	4088	312	7.1
CN3009100000000	30	091	Sheridan County, MT	2002	NA	1831	1758	73	4
CN3009300000000	30	093	Silver Bow County, MT	2002	NA	17014	16160	854	5
CN3009500000000	30	095	Stillwater County, MT	2002	NA	4481	4301	180	4
CN3009700000000	30	097	Sweet Grass County, MT	2002	NA	2136	2072	64	3
CN3009900000000	30	099	Teton County, MT	2002	NA	2902	2793	109	3.8
CN3010100000000	30	101	Toole County, MT	2002	NA	2346	2264	82	3.5
CN3010300000000	30	103	Treasure County, MT	2002	NA	400	384	16	4
CN3010500000000	30	105	Valley County, MT	2002	NA	3683	3536	147	4
CN3010700000000	30	107	Wheatland County, MT	2002	NA	1009	958	51	5.1
CN3010900000000	30	109	Wibaux County, MT	2002	NA	504	485	19	3.8
CN3011100000000	30	111	Yellowstone County, MT	2002	NA	74555	71916	2639	3.5
CN3100100000000	31	001	Adams County, NE	2002	NA	16962	16357	605	3.6
CN3100300000000	31	003	Antelope County, NE	2002	NA	3916	3795	121	3.1
CN3100500000000	31	005	Arthur County, NE	2002	NA	243	232	11	4.5
CN3100700000000	31	007	Banner County, NE	2002	NA	397	386	11	2.8
CN3100900000000	31	009	Blaine County, NE	2002	NA	289	279	10	3.5
CN3101100000000	31	011	Boone County, NE	2002	NA	3249	3151	98	3
CN3101300000000	31	013	Box Butte County, NE	2002	NA	5702	5433	269	4.7
CN3101500000000	31	015	Boyd County, NE	2002	NA	1262	1218	44	3.5
CN3101700000000	31	017	Brown County, NE	2002	NA	1898	1832	66	3.5
CN3101900000000	31	019	Buffalo County, NE	2002	NA	26103	25438	665	2.5
CN3102100000000	31	021	Burt County, NE	2002	NA	4054	3861	193	4.8
CN3102300000000	31	023	Butler County, NE	2002	NA	4644	4456	188	4
CN3102500000000	31	025	Cass County, NE	2002	NA	13695	13204	491	3.6
CN3102700000000	31	027	Cedar County, NE	2002	NA	5070	4939	131	2.6
CN3102900000000	31	029	Chase County, NE	2002	NA	2094	2041	53	2.5
CN3103100000000	31	031	Cherry County, NE	2002	NA	3554	3456	98	2.8
CN3103300000000	31	033	Cheyenne County, NE	2002	NA	4864	4707	157	3.2
CN3103500000000	31	035	Clay County, NE	2002	NA	3427	3300	127	3.7
CN3103700000000	31	037	Colfax County, NE	2002	NA	5953	5780	173	2.9
CN3103900000000	31	039	Cuming County, NE	2002	NA	5548	5406	142	2.6
CN3104100000000	31	041	Custer County, NE	2002	NA	6467	6298	169	2.6
CN3104300000000	31	043	Dakota County, NE	2002	NA	10748	10282	466	4.3
CN3104500000000	31	045	Dawes County, NE	2002	NA	5027	4879	148	2.9
CN3104700000000	31	047	Dawson County, NE	2002	NA	12329	11850	479	3.9
CN3104900000000	31	049	Deuel County, NE	2002	NA	1121	1092	29	2.6
CN3105100000000	31	051	Dixon County, NE	2002	NA	3197	3101	96	3
CN3105300000000	31	053	Dodge County, NE	2002	NA	19523	18669	854	4.4
CN3105500000000	31	055	Douglas County, NE	2002	NA	261768	250512	11256	4.3
CN3105700000000	31	057	Dundy County, NE	2002	NA	1228	1183	45	3.7
CN3105900000000	31	059	Fillmore County, NE	2002	NA	3440	3321	119	3.5
CN3106100000000	31	061	Franklin County, NE	2002	NA	1888	1821	67	3.5
CN3106300000000	31	063	Frontier County, NE	2002	NA	1804	1761	43	2.4
CN3106500000000	31	065	Furnas County, NE	2002	NA	2568	2485	83	3.2
CN3106700000000	31	067	Gage County, NE	2002	NA	12948	12467	481	3.7
CN3106900000000	31	069	Garden County, NE	2002	NA	1111	1073	38	3.4
CN3107100000000	31	071	Garfield County, NE	2002	NA	1051	1021	30	2.9
CN3107300000000	31	073	Gosper County, NE	2002	NA	1099	1066	33	3
CN3107500000000	31	075	Grant County, NE	2002	NA	415	404	11	2.7
CN3107700000000	31	077	Greeley County, NE	2002	NA	1416	1366	50	3.5
CN3107900000000	31	079	Hall County, NE	2002	NA	28910	27783	1127	3.9
CN3108100000000	31	081	Hamilton County, NE	2002	NA	5274	5117	157	3
CN3108300000000	31	083	Harlan County, NE	2002	NA	1902	1845	57	3
CN3108500000000	31	085	Hayes County, NE	2002	NA	580	562	18	3.1
CN3108700000000	31	087	Hitchcock County, NE	2002	NA	1506	1458	48	3.2
CN3108900000000	31	089	Holt County, NE	2002	NA	6208	6027	181	2.9
CN3109100000000	31	091	Hooker County, NE	2002	NA	416	402	14	3.4
CN3109300000000	31	093	Howard County, NE	2002	NA	3524	3398	126	3.6
CN3109500000000	31	095	Jefferson County, NE	2002	NA	4347	4152	195	4.5
CN3109700000000	31	097	Johnson County, NE	2002	NA	2887	2802	85	2.9
CN3109900000000	31	099	Kearney County, NE	2002	NA	3857	3751	106	2.7
CN3110100000000	31	101	Keith County, NE	2002	NA	5049	4887	162	3.2
CN3110300000000	31	103	Keya Paha County, NE	2002	NA	443	426	17	3.8
CN3110500000000	31	105	Kimball County, NE	2002	NA	2111	2056	55	2.6
CN3110700000000	31	107	Knox County, NE	2002	NA	4786	4624	162	3.4
CN3110900000000	31	109	Lancaster County, NE	2002	NA	151376	146551	4825	3.2
CN3111100000000	31	111	Lincoln County, NE	2002	NA	19872	19218	654	3.3
CN3111300000000	31	113	Logan County, NE	2002	NA	442	431	11	2.5
CN3111500000000	31	115	Loup County, NE	2002	NA	335	323	12	3.6
CN3111700000000	31	117	McPherson County, NE	2002	NA	305	300	5	1.6
CN3111900000000	31	119	Madison County, NE	2002	NA	19147	18398	749	3.9
CN3112100000000	31	121	Merrick County, NE	2002	NA	4230	4073	157	3.7
CN3112300000000	31	123	Morrill County, NE	2002	NA	2839	2722	117	4.1
CN3112500000000	31	125	Nance County, NE	2002	NA	2079	1988	91	4.4
CN3112700000000	31	127	Nemaha County, NE	2002	NA	3649	3492	157	4.3
CN3112900000000	31	129	Nuckolls County, NE	2002	NA	2477	2403	74	3
CN3113100000000	31	131	Otoe County, NE	2002	NA	8546	8218	328	3.8
CN3113300000000	31	133	Pawnee County, NE	2002	NA	1640	1580	60	3.7
CN3113500000000	31	135	Perkins County, NE	2002	NA	1701	1659	42	2.5
CN3113700000000	31	137	Phelps County, NE	2002	NA	5364	5210	154	2.9
CN3113900000000	31	139	Pierce County, NE	2002	NA	4052	3907	145	3.6
CN3114100000000	31	141	Platte County, NE	2002	NA	17185	16448	737	4.3
CN3114300000000	31	143	Polk County, NE	2002	NA	3046	2950	96	3.2
CN3114500000000	31	145	Red Willow County, NE	2002	NA	6068	5888	180	3
CN3114700000000	31	147	Richardson County, NE	2002	NA	4554	4292	262	5.8
CN3114900000000	31	149	Rock County, NE	2002	NA	1025	997	28	2.7
CN3115100000000	31	151	Saline County, NE	2002	NA	8116	7876	240	3
CN3115300000000	31	153	Sarpy County, NE	2002	NA	68647	66531	2116	3.1
CN3115500000000	31	155	Saunders County, NE	2002	NA	11000	10606	394	3.6
CN3115700000000	31	157	Scotts Bluff County, NE	2002	NA	18786	17959	827	4.4
CN3115900000000	31	159	Seward County, NE	2002	NA	9226	8953	273	3
CN3116100000000	31	161	Sheridan County, NE	2002	NA	3242	3154	88	2.7
CN3116300000000	31	163	Sherman County, NE	2002	NA	1874	1819	55	2.9
CN3116500000000	31	165	Sioux County, NE	2002	NA	789	769	20	2.5
CN3116700000000	31	167	Stanton County, NE	2002	NA	3483	3376	107	3.1
CN3116900000000	31	169	Thayer County, NE	2002	NA	2974	2873	101	3.4
CN3117100000000	31	171	Thomas County, NE	2002	NA	413	396	17	4.1
CN3117300000000	31	173	Thurston County, NE	2002	NA	2818	2621	197	7
CN3117500000000	31	175	Valley County, NE	2002	NA	2540	2468	72	2.8
CN3117700000000	31	177	Washington County, NE	2002	NA	11052	10734	318	2.9
CN3117900000000	31	179	Wayne County, NE	2002	NA	5464	5309	155	2.8
CN3118100000000	31	181	Webster County, NE	2002	NA	2028	1957	71	3.5
CN3118300000000	31	183	Wheeler County, NE	2002	NA	504	493	11	2.2
CN3118500000000	31	185	York County, NE	2002	NA	7477	7255	222	3
CN3200100000000	32	001	Churchill County, NV	2002	NA	12365	11740	625	5.1
CN3200300000000	32	003	Clark County, NV	2002	NA	782858	737054	45804	5.9
CN3200500000000	32	005	Douglas County, NV	2002	NA	21943	20848	1095	5
CN3200700000000	32	007	Elko County, NV	2002	NA	23378	22310	1068	4.6
CN3200900000000	32	009	Esmeralda County, NV	2002	NA	489	455	34	7
CN3201100000000	32	011	Eureka County, NV	2002	NA	772	736	36	4.7
CN3201300000000	32	013	Humboldt County, NV	2002	NA	7434	7026	408	5.5
CN3201500000000	32	015	Lander County, NV	2002	NA	2626	2465	161	6.1
CN3201700000000	32	017	Lincoln County, NV	2002	NA	1787	1701	86	4.8
CN3201900000000	32	019	Lyon County, NV	2002	NA	19874	18733	1141	5.7
CN3202100000000	32	021	Mineral County, NV	2002	NA	2183	2054	129	5.9
CN3202300000000	32	023	Nye County, NV	2002	NA	15002	13904	1098	7.3
CN3202700000000	32	027	Pershing County, NV	2002	NA	2612	2487	125	4.8
CN3202900000000	32	029	Storey County, NV	2002	NA	1972	1895	77	3.9
CN3203100000000	32	031	Washoe County, NV	2002	NA	203150	193205	9945	4.9
CN3203300000000	32	033	White Pine County, NV	2002	NA	3839	3683	156	4.1
CN3251000000000	32	510	Carson City, NV	2002	NA	27386	25826	1560	5.7
CN3300100000000	33	001	Belknap County, NH	2002	NA	31665	30440	1225	3.9
CN3300300000000	33	003	Carroll County, NH	2002	NA	24243	23377	866	3.6
CN3300500000000	33	005	Cheshire County, NH	2002	NA	40336	38920	1416	3.5
CN3300700000000	33	007	Coos County, NH	2002	NA	16787	15674	1113	6.6
CN3300900000000	33	009	Grafton County, NH	2002	NA	45439	44107	1332	2.9
CN3301100000000	33	011	Hillsborough County, NH	2002	NA	216674	206322	10352	4.8
CN3301300000000	33	013	Merrimack County, NH	2002	NA	77022	74390	2632	3.4
CN3301500000000	33	015	Rockingham County, NH	2002	NA	165148	156129	9019	5.5
CN3301700000000	33	017	Strafford County, NH	2002	NA	63503	60744	2759	4.3
CN3301900000000	33	019	Sullivan County, NH	2002	NA	21460	20780	680	3.2
CN3400100000000	34	001	Atlantic County, NJ	2002	NA	131104	123275	7829	6
CN3400300000000	34	003	Bergen County, NJ	2002	NA	463722	440386	23336	5
CN3400500000000	34	005	Burlington County, NJ	2002	NA	228538	217515	11023	4.8
CN3400700000000	34	007	Camden County, NJ	2002	NA	257000	241969	15031	5.8
CN3400900000000	34	009	Cape May County, NJ	2002	NA	55335	50941	4394	7.9
CN3401100000000	34	011	Cumberland County, NJ	2002	NA	66370	61368	5002	7.5
CN3401300000000	34	013	Essex County, NJ	2002	NA	369274	342684	26590	7.2
CN3401500000000	34	015	Gloucester County, NJ	2002	NA	138982	131717	7265	5.2
CN3401700000000	34	017	Hudson County, NJ	2002	NA	294514	272037	22477	7.6
CN3401900000000	34	019	Hunterdon County, NJ	2002	NA	69785	66914	2871	4.1
CN3402100000000	34	021	Mercer County, NJ	2002	NA	185688	175918	9770	5.3
CN3402300000000	34	023	Middlesex County, NJ	2002	NA	411362	388343	23019	5.6
CN3402500000000	34	025	Monmouth County, NJ	2002	NA	323900	306893	17007	5.3
CN3402700000000	34	027	Morris County, NJ	2002	NA	264023	251933	12090	4.6
CN3402900000000	34	029	Ocean County, NJ	2002	NA	242110	228926	13184	5.4
CN3403100000000	34	031	Passaic County, NJ	2002	NA	235505	218974	16531	7
CN3403300000000	34	033	Salem County, NJ	2002	NA	31017	29212	1805	5.8
CN3403500000000	34	035	Somerset County, NJ	2002	NA	170716	162628	8088	4.7
CN3403700000000	34	037	Sussex County, NJ	2002	NA	81456	77459	3997	4.9
CN3403900000000	34	039	Union County, NJ	2002	NA	268151	251193	16958	6.3
CN3404100000000	34	041	Warren County, NJ	2002	NA	57690	54892	2798	4.9
CN3500100000000	35	001	Bernalillo County, NM	2002	NA	294256	279753	14503	4.9
CN3500300000000	35	003	Catron County, NM	2002	NA	1426	1337	89	6.2
CN3500500000000	35	005	Chaves County, NM	2002	NA	25737	24062	1675	6.5
CN3500600000000	35	006	Cibola County, NM	2002	NA	10868	10171	697	6.4
CN3500700000000	35	007	Colfax County, NM	2002	NA	6953	6577	376	5.4
CN3500900000000	35	009	Curry County, NM	2002	NA	19418	18495	923	4.8
CN3501100000000	35	011	De Baca County, NM	2002	NA	885	840	45	5.1
CN3501300000000	35	013	Dona Ana County, NM	2002	NA	79390	74431	4959	6.2
CN3501500000000	35	015	Eddy County, NM	2002	NA	23970	22566	1404	5.9
CN3501700000000	35	017	Grant County, NM	2002	NA	12745	11483	1262	9.9
CN3501900000000	35	019	Guadalupe County, NM	2002	NA	1709	1577	132	7.7
CN3502100000000	35	021	Harding County, NM	2002	NA	421	404	17	4
CN3502300000000	35	023	Hidalgo County, NM	2002	NA	2391	2284	107	4.5
CN3502500000000	35	025	Lea County, NM	2002	NA	23382	22121	1261	5.4
CN3502700000000	35	027	Lincoln County, NM	2002	NA	10312	9894	418	4.1
CN3502800000000	35	028	Los Alamos County, NM	2002	NA	10923	10665	258	2.4
CN3502900000000	35	029	Luna County, NM	2002	NA	11171	9495	1676	15
CN3503100000000	35	031	McKinley County, NM	2002	NA	25458	23890	1568	6.2
CN3503300000000	35	033	Mora County, NM	2002	NA	2067	1855	212	10.3
CN3503500000000	35	035	Otero County, NM	2002	NA	24860	23448	1412	5.7
CN3503700000000	35	037	Quay County, NM	2002	NA	4016	3797	219	5.5
CN3503900000000	35	039	Rio Arriba County, NM	2002	NA	19771	18479	1292	6.5
CN3504100000000	35	041	Roosevelt County, NM	2002	NA	9088	8710	378	4.2
CN3504300000000	35	043	Sandoval County, NM	2002	NA	45921	43186	2735	6
CN3504500000000	35	045	San Juan County, NM	2002	NA	51233	48081	3152	6.2
CN3504700000000	35	047	San Miguel County, NM	2002	NA	13381	12550	831	6.2
CN3504900000000	35	049	Santa Fe County, NM	2002	NA	71984	69164	2820	3.9
CN3505100000000	35	051	Sierra County, NM	2002	NA	5370	5081	289	5.4
CN3505300000000	35	053	Socorro County, NM	2002	NA	8541	8109	432	5.1
CN3505500000000	35	055	Taos County, NM	2002	NA	16937	15811	1126	6.6
CN3505700000000	35	057	Torrance County, NM	2002	NA	7312	6950	362	5
CN3505900000000	35	059	Union County, NM	2002	NA	2007	1934	73	3.6
CN3506100000000	35	061	Valencia County, NM	2002	NA	30596	28890	1706	5.6
CN3600100000000	36	001	Albany County, NY	2002	NA	157694	151536	6158	3.9
CN3600300000000	36	003	Allegany County, NY	2002	NA	23449	22192	1257	5.4
CN3600500000000	36	005	Bronx County, NY	2002	NA	496904	448504	48400	9.7
CN3600700000000	36	007	Broome County, NY	2002	NA	98781	93088	5693	5.8
CN3600900000000	36	009	Cattaraugus County, NY	2002	NA	41755	39427	2328	5.6
CN3601100000000	36	011	Cayuga County, NY	2002	NA	41229	39259	1970	4.8
CN3601300000000	36	013	Chautauqua County, NY	2002	NA	67431	63701	3730	5.5
CN3601500000000	36	015	Chemung County, NY	2002	NA	42269	39575	2694	6.4
CN3601700000000	36	017	Chenango County, NY	2002	NA	24619	23259	1360	5.5
CN3601900000000	36	019	Clinton County, NY	2002	NA	39657	37549	2108	5.3
CN3602100000000	36	021	Columbia County, NY	2002	NA	31297	29967	1330	4.2
CN3602300000000	36	023	Cortland County, NY	2002	NA	24628	23173	1455	5.9
CN3602500000000	36	025	Delaware County, NY	2002	NA	23068	21978	1090	4.7
CN3602700000000	36	027	Dutchess County, NY	2002	NA	143262	137292	5970	4.2
CN3602900000000	36	029	Erie County, NY	2002	NA	470145	444923	25222	5.4
CN3603100000000	36	031	Essex County, NY	2002	NA	18782	17820	962	5.1
CN3603300000000	36	033	Franklin County, NY	2002	NA	22271	20924	1347	6
CN3603500000000	36	035	Fulton County, NY	2002	NA	26914	25584	1330	4.9
CN3603700000000	36	037	Genesee County, NY	2002	NA	33100	31361	1739	5.3
CN3603900000000	36	039	Greene County, NY	2002	NA	23732	22576	1156	4.9
CN3604100000000	36	041	Hamilton County, NY	2002	NA	2915	2769	146	5
CN3604300000000	36	043	Herkimer County, NY	2002	NA	31435	29755	1680	5.3
CN3604500000000	36	045	Jefferson County, NY	2002	NA	45880	42806	3074	6.7
CN3604700000000	36	047	Kings County, NY	2002	NA	1047209	956631	90578	8.6
CN3604900000000	36	049	Lewis County, NY	2002	NA	12627	11841	786	6.2
CN3605100000000	36	051	Livingston County, NY	2002	NA	32834	30974	1860	5.7
CN3605300000000	36	053	Madison County, NY	2002	NA	35418	33564	1854	5.2
CN3605500000000	36	055	Monroe County, NY	2002	NA	375754	355873	19881	5.3
CN3605700000000	36	057	Montgomery County, NY	2002	NA	24006	22647	1359	5.7
CN3605900000000	36	059	Nassau County, NY	2002	NA	681687	650420	31267	4.6
CN3606100000000	36	061	New York County, NY	2002	NA	871108	804781	66327	7.6
CN3606300000000	36	063	Niagara County, NY	2002	NA	111168	104185	6983	6.3
CN3606500000000	36	065	Oneida County, NY	2002	NA	110986	105157	5829	5.3
CN3606700000000	36	067	Onondaga County, NY	2002	NA	231850	220581	11269	4.9
CN3606900000000	36	069	Ontario County, NY	2002	NA	55033	52216	2817	5.1
CN3607100000000	36	071	Orange County, NY	2002	NA	169020	161741	7279	4.3
CN3607300000000	36	073	Orleans County, NY	2002	NA	19938	18683	1255	6.3
CN3607500000000	36	075	Oswego County, NY	2002	NA	59302	55523	3779	6.4
CN3607700000000	36	077	Otsego County, NY	2002	NA	31281	29826	1455	4.7
CN3607900000000	36	079	Putnam County, NY	2002	NA	53815	51696	2119	3.9
CN3608100000000	36	081	Queens County, NY	2002	NA	1065959	990084	75875	7.1
CN3608300000000	36	083	Rensselaer County, NY	2002	NA	82208	78493	3715	4.5
CN3608500000000	36	085	Richmond County, NY	2002	NA	220908	205571	15337	6.9
CN3608700000000	36	087	Rockland County, NY	2002	NA	147190	140806	6384	4.3
CN3608900000000	36	089	St. Lawrence County, NY	2002	NA	49830	46562	3268	6.6
CN3609100000000	36	091	Saratoga County, NY	2002	NA	115221	110821	4400	3.8
CN3609300000000	36	093	Schenectady County, NY	2002	NA	73836	70800	3036	4.1
CN3609500000000	36	095	Schoharie County, NY	2002	NA	15565	14690	875	5.6
CN3609700000000	36	097	Schuyler County, NY	2002	NA	9644	8976	668	6.9
CN3609900000000	36	099	Seneca County, NY	2002	NA	17066	16148	918	5.4
CN3610100000000	36	101	Steuben County, NY	2002	NA	47105	43780	3325	7.1
CN3610300000000	36	103	Suffolk County, NY	2002	NA	754013	718973	35040	4.6
CN3610500000000	36	105	Sullivan County, NY	2002	NA	34326	32623	1703	5
CN3610700000000	36	107	Tioga County, NY	2002	NA	26729	25272	1457	5.5
CN3610900000000	36	109	Tompkins County, NY	2002	NA	52573	50444	2129	4
CN3611100000000	36	111	Ulster County, NY	2002	NA	90790	86817	3973	4.4
CN3611300000000	36	113	Warren County, NY	2002	NA	33753	32083	1670	4.9
CN3611500000000	36	115	Washington County, NY	2002	NA	30422	29030	1392	4.6
CN3611700000000	36	117	Wayne County, NY	2002	NA	49096	46035	3061	6.2
CN3611900000000	36	119	Westchester County, NY	2002	NA	471246	450012	21234	4.5
CN3612100000000	36	121	Wyoming County, NY	2002	NA	21206	20000	1206	5.7
CN3612300000000	36	123	Yates County, NY	2002	NA	12584	11975	609	4.8
CN3700100000000	37	001	Alamance County, NC	2002	NA	69095	64121	4974	7.2
CN3700300000000	37	003	Alexander County, NC	2002	NA	18664	17350	1314	7
CN3700500000000	37	005	Alleghany County, NC	2002	NA	4856	4415	441	9.1
CN3700700000000	37	007	Anson County, NC	2002	NA	11052	10037	1015	9.2
CN3700900000000	37	009	Ashe County, NC	2002	NA	12614	11554	1060	8.4
CN3701100000000	37	011	Avery County, NC	2002	NA	7614	7114	500	6.6
CN3701300000000	37	013	Beaufort County, NC	2002	NA	19627	17850	1777	9.1
CN3701500000000	37	015	Bertie County, NC	2002	NA	8142	7484	658	8.1
CN3701700000000	37	017	Bladen County, NC	2002	NA	14745	13320	1425	9.7
CN3701900000000	37	019	Brunswick County, NC	2002	NA	37530	34932	2598	6.9
CN3702100000000	37	021	Buncombe County, NC	2002	NA	110381	104785	5596	5.1
CN3702300000000	37	023	Burke County, NC	2002	NA	43575	40163	3412	7.8
CN3702500000000	37	025	Cabarrus County, NC	2002	NA	75089	70926	4163	5.5
CN3702700000000	37	027	Caldwell County, NC	2002	NA	40861	37608	3253	8
CN3702900000000	37	029	Camden County, NC	2002	NA	3531	3373	158	4.5
CN3703100000000	37	031	Carteret County, NC	2002	NA	30009	28238	1771	5.9
CN3703300000000	37	033	Caswell County, NC	2002	NA	10907	10027	880	8.1
CN3703500000000	37	035	Catawba County, NC	2002	NA	78762	72180	6582	8.4
CN3703700000000	37	037	Chatham County, NC	2002	NA	28975	27430	1545	5.3
CN3703900000000	37	039	Cherokee County, NC	2002	NA	9978	8953	1025	10.3
CN3704100000000	37	041	Chowan County, NC	2002	NA	6340	5959	381	6
CN3704300000000	37	043	Clay County, NC	2002	NA	4059	3825	234	5.8
CN3704500000000	37	045	Cleveland County, NC	2002	NA	48708	43774	4934	10.1
CN3704700000000	37	047	Columbus County, NC	2002	NA	22787	20754	2033	8.9
CN3704900000000	37	049	Craven County, NC	2002	NA	38597	36259	2338	6.1
CN3705100000000	37	051	Cumberland County, NC	2002	NA	120118	111941	8177	6.8
CN3705300000000	37	053	Currituck County, NC	2002	NA	9973	9677	296	3
CN3705500000000	37	055	Dare County, NC	2002	NA	20752	19607	1145	5.5
CN3705700000000	37	057	Davidson County, NC	2002	NA	79070	73840	5230	6.6
CN3705900000000	37	059	Davie County, NC	2002	NA	19041	17946	1095	5.8
CN3706100000000	37	061	Duplin County, NC	2002	NA	22905	21206	1699	7.4
CN3706300000000	37	063	Durham County, NC	2002	NA	127381	119893	7488	5.9
CN3706500000000	37	065	Edgecombe County, NC	2002	NA	25140	22399	2741	10.9
CN3706700000000	37	067	Forsyth County, NC	2002	NA	165168	155740	9428	5.7
CN3706900000000	37	069	Franklin County, NC	2002	NA	25022	23389	1633	6.5
CN3707100000000	37	071	Gaston County, NC	2002	NA	99633	91974	7659	7.7
CN3707300000000	37	073	Gates County, NC	2002	NA	4671	4466	205	4.4
CN3707500000000	37	075	Graham County, NC	2002	NA	3826	3452	374	9.8
CN3707700000000	37	077	Granville County, NC	2002	NA	24007	22259	1748	7.3
CN3707900000000	37	079	Greene County, NC	2002	NA	8516	7893	623	7.3
CN3708100000000	37	081	Guilford County, NC	2002	NA	236931	221976	14955	6.3
CN3708300000000	37	083	Halifax County, NC	2002	NA	22413	20112	2301	10.3
CN3708500000000	37	085	Harnett County, NC	2002	NA	42989	39790	3199	7.4
CN3708700000000	37	087	Haywood County, NC	2002	NA	26718	24998	1720	6.4
CN3708900000000	37	089	Henderson County, NC	2002	NA	43999	41708	2291	5.2
CN3709100000000	37	091	Hertford County, NC	2002	NA	9434	8759	675	7.2
CN3709300000000	37	093	Hoke County, NC	2002	NA	15403	14220	1183	7.7
CN3709500000000	37	095	Hyde County, NC	2002	NA	2725	2522	203	7.4
CN3709700000000	37	097	Iredell County, NC	2002	NA	66827	62402	4425	6.6
CN3709900000000	37	099	Jackson County, NC	2002	NA	18936	18002	934	4.9
CN3710100000000	37	101	Johnston County, NC	2002	NA	66208	62490	3718	5.6
CN3710300000000	37	103	Jones County, NC	2002	NA	4659	4341	318	6.8
CN3710500000000	37	105	Lee County, NC	2002	NA	25021	23115	1906	7.6
CN3710700000000	37	107	Lenoir County, NC	2002	NA	26786	24506	2280	8.5
CN3710900000000	37	109	Lincoln County, NC	2002	NA	35393	32876	2517	7.1
CN3711100000000	37	111	McDowell County, NC	2002	NA	21430	19673	1757	8.2
CN3711300000000	37	113	Macon County, NC	2002	NA	14995	14192	803	5.4
CN3711500000000	37	115	Madison County, NC	2002	NA	9596	9022	574	6
CN3711700000000	37	117	Martin County, NC	2002	NA	11885	11113	772	6.5
CN3711900000000	37	119	Mecklenburg County, NC	2002	NA	411447	387468	23979	5.8
CN3712100000000	37	121	Mitchell County, NC	2002	NA	7708	6940	768	10
CN3712300000000	37	123	Montgomery County, NC	2002	NA	12674	11649	1025	8.1
CN3712500000000	37	125	Moore County, NC	2002	NA	34908	32663	2245	6.4
CN3712700000000	37	127	Nash County, NC	2002	NA	43696	40241	3455	7.9
CN3712900000000	37	129	New Hanover County, NC	2002	NA	89692	84052	5640	6.3
CN3713100000000	37	131	Northampton County, NC	2002	NA	8497	7703	794	9.3
CN3713300000000	37	133	Onslow County, NC	2002	NA	53487	50020	3467	6.5
CN3713500000000	37	135	Orange County, NC	2002	NA	64853	62057	2796	4.3
CN3713700000000	37	137	Pamlico County, NC	2002	NA	5409	5101	308	5.7
CN3713900000000	37	139	Pasquotank County, NC	2002	NA	15682	14816	866	5.5
CN3714100000000	37	141	Pender County, NC	2002	NA	20239	18689	1550	7.7
CN3714300000000	37	143	Perquimans County, NC	2002	NA	4838	4568	270	5.6
CN3714500000000	37	145	Person County, NC	2002	NA	18692	17279	1413	7.6
CN3714700000000	37	147	Pitt County, NC	2002	NA	68699	64183	4516	6.6
CN3714900000000	37	149	Polk County, NC	2002	NA	8637	8186	451	5.2
CN3715100000000	37	151	Randolph County, NC	2002	NA	73512	68830	4682	6.4
CN3715300000000	37	153	Richmond County, NC	2002	NA	20485	18321	2164	10.6
CN3715500000000	37	155	Robeson County, NC	2002	NA	52036	46982	5054	9.7
CN3715700000000	37	157	Rockingham County, NC	2002	NA	46461	42758	3703	8
CN3715900000000	37	159	Rowan County, NC	2002	NA	65564	61406	4158	6.3
CN3716100000000	37	161	Rutherford County, NC	2002	NA	30583	27725	2858	9.3
CN3716300000000	37	163	Sampson County, NC	2002	NA	29312	27325	1987	6.8
CN3716500000000	37	165	Scotland County, NC	2002	NA	15858	14304	1554	9.8
CN3716700000000	37	167	Stanly County, NC	2002	NA	29181	27087	2094	7.2
CN3716900000000	37	169	Stokes County, NC	2002	NA	23949	22502	1447	6
CN3717100000000	37	171	Surry County, NC	2002	NA	36054	33235	2819	7.8
CN3717300000000	37	173	Swain County, NC	2002	NA	6601	6038	563	8.5
CN3717500000000	37	175	Transylvania County, NC	2002	NA	13171	12215	956	7.3
CN3717700000000	37	177	Tyrrell County, NC	2002	NA	2013	1843	170	8.4
CN3717900000000	37	179	Union County, NC	2002	NA	73564	69684	3880	5.3
CN3718100000000	37	181	Vance County, NC	2002	NA	19986	17985	2001	10
CN3718300000000	37	183	Wake County, NC	2002	NA	377841	356450	21391	5.7
CN3718500000000	37	185	Warren County, NC	2002	NA	7933	7217	716	9
CN3718700000000	37	187	Washington County, NC	2002	NA	5986	5508	478	8
CN3718900000000	37	189	Watauga County, NC	2002	NA	22191	21193	998	4.5
CN3719100000000	37	191	Wayne County, NC	2002	NA	50607	47381	3226	6.4
CN3719300000000	37	193	Wilkes County, NC	2002	NA	33240	30459	2781	8.4
CN3719500000000	37	195	Wilson County, NC	2002	NA	37990	35085	2905	7.6
CN3719700000000	37	197	Yadkin County, NC	2002	NA	19385	18247	1138	5.9
CN3719900000000	37	199	Yancey County, NC	2002	NA	7983	7242	741	9.3
CN3800100000000	38	001	Adams County, ND	2002	NA	1229	1186	43	3.5
CN3800300000000	38	003	Barnes County, ND	2002	NA	5995	5789	206	3.4
CN3800500000000	38	005	Benson County, ND	2002	NA	2668	2510	158	5.9
CN3800700000000	38	007	Billings County, ND	2002	NA	504	490	14	2.8
CN3800900000000	38	009	Bottineau County, ND	2002	NA	3588	3426	162	4.5
CN3801100000000	38	011	Bowman County, ND	2002	NA	1707	1665	42	2.5
CN3801300000000	38	013	Burke County, ND	2002	NA	1012	975	37	3.7
CN3801500000000	38	015	Burleigh County, ND	2002	NA	40736	39457	1279	3.1
CN3801700000000	38	017	Cass County, ND	2002	NA	75982	73836	2146	2.8
CN3801900000000	38	019	Cavalier County, ND	2002	NA	2239	2152	87	3.9
CN3802100000000	38	021	Dickey County, ND	2002	NA	2878	2793	85	3
CN3802300000000	38	023	Divide County, ND	2002	NA	1033	996	37	3.6
CN3802500000000	38	025	Dunn County, ND	2002	NA	1749	1678	71	4.1
CN3802700000000	38	027	Eddy County, ND	2002	NA	1369	1297	72	5.3
CN3802900000000	38	029	Emmons County, ND	2002	NA	2017	1903	114	5.7
CN3803100000000	38	031	Foster County, ND	2002	NA	1833	1768	65	3.5
CN3803300000000	38	033	Golden Valley County, ND	2002	NA	901	876	25	2.8
CN3803500000000	38	035	Grand Forks County, ND	2002	NA	35780	34481	1299	3.6
CN3803700000000	38	037	Grant County, ND	2002	NA	1320	1270	50	3.8
CN3803900000000	38	039	Griggs County, ND	2002	NA	1321	1276	45	3.4
CN3804100000000	38	041	Hettinger County, ND	2002	NA	1244	1196	48	3.9
CN3804300000000	38	043	Kidder County, ND	2002	NA	1249	1176	73	5.8
CN3804500000000	38	045	LaMoure County, ND	2002	NA	2262	2183	79	3.5
CN3804700000000	38	047	Logan County, ND	2002	NA	966	931	35	3.6
CN3804900000000	38	049	McHenry County, ND	2002	NA	2780	2604	176	6.3
CN3805100000000	38	051	McIntosh County, ND	2002	NA	1487	1439	48	3.2
CN3805300000000	38	053	McKenzie County, ND	2002	NA	2652	2548	104	3.9
CN3805500000000	38	055	McLean County, ND	2002	NA	4598	4340	258	5.6
CN3805700000000	38	057	Mercer County, ND	2002	NA	4602	4386	216	4.7
CN3805900000000	38	059	Morton County, ND	2002	NA	13739	13210	529	3.9
CN3806100000000	38	061	Mountrail County, ND	2002	NA	2918	2757	161	5.5
CN3806300000000	38	063	Nelson County, ND	2002	NA	1691	1616	75	4.4
CN3806500000000	38	065	Oliver County, ND	2002	NA	1075	1026	49	4.6
CN3806700000000	38	067	Pembina County, ND	2002	NA	4192	3934	258	6.2
CN3806900000000	38	069	Pierce County, ND	2002	NA	1937	1842	95	4.9
CN3807100000000	38	071	Ramsey County, ND	2002	NA	6102	5861	241	3.9
CN3807300000000	38	073	Ransom County, ND	2002	NA	2981	2896	85	2.9
CN3807500000000	38	075	Renville County, ND	2002	NA	1298	1258	40	3.1
CN3807700000000	38	077	Richland County, ND	2002	NA	9238	8906	332	3.6
CN3807900000000	38	079	Rolette County, ND	2002	NA	5492	4826	666	12.1
CN3808100000000	38	081	Sargent County, ND	2002	NA	2112	2038	74	3.5
CN3808300000000	38	083	Sheridan County, ND	2002	NA	714	669	45	6.3
CN3808500000000	38	085	Sioux County, ND	2002	NA	1345	1273	72	5.4
CN3808700000000	38	087	Slope County, ND	2002	NA	457	447	10	2.2
CN3808900000000	38	089	Stark County, ND	2002	NA	12622	12185	437	3.5
CN3809100000000	38	091	Steele County, ND	2002	NA	1151	1124	27	2.3
CN3809300000000	38	093	Stutsman County, ND	2002	NA	11608	11212	396	3.4
CN3809500000000	38	095	Towner County, ND	2002	NA	1343	1292	51	3.8
CN3809700000000	38	097	Traill County, ND	2002	NA	4116	3950	166	4
CN3809900000000	38	099	Walsh County, ND	2002	NA	6066	5800	266	4.4
CN3810100000000	38	101	Ward County, ND	2002	NA	27584	26515	1069	3.9
CN3810300000000	38	103	Wells County, ND	2002	NA	2285	2178	107	4.7
CN3810500000000	38	105	Williams County, ND	2002	NA	10873	10520	353	3.2
CN3900100000000	39	001	Adams County, OH	2002	NA	12624	11392	1232	9.8
CN3900300000000	39	003	Allen County, OH	2002	NA	52181	48800	3381	6.5
CN3900500000000	39	005	Ashland County, OH	2002	NA	27296	25568	1728	6.3
CN3900700000000	39	007	Ashtabula County, OH	2002	NA	50788	46989	3799	7.5
CN3900900000000	39	009	Athens County, OH	2002	NA	29016	27213	1803	6.2
CN3901100000000	39	011	Auglaize County, OH	2002	NA	25050	23570	1480	5.9
CN3901300000000	39	013	Belmont County, OH	2002	NA	31827	29613	2214	7
CN3901500000000	39	015	Brown County, OH	2002	NA	21318	19817	1501	7
CN3901700000000	39	017	Butler County, OH	2002	NA	178459	168895	9564	5.4
CN3901900000000	39	019	Carroll County, OH	2002	NA	14445	13467	978	6.8
CN3902100000000	39	021	Champaign County, OH	2002	NA	20624	19327	1297	6.3
CN3902300000000	39	023	Clark County, OH	2002	NA	72346	67210	5136	7.1
CN3902500000000	39	025	Clermont County, OH	2002	NA	99069	93608	5461	5.5
CN3902700000000	39	027	Clinton County, OH	2002	NA	21743	20636	1107	5.1
CN3902900000000	39	029	Columbiana County, OH	2002	NA	54061	50301	3760	7
CN3903100000000	39	031	Coshocton County, OH	2002	NA	17821	16649	1172	6.6
CN3903300000000	39	033	Crawford County, OH	2002	NA	23148	21454	1694	7.3
CN3903500000000	39	035	Cuyahoga County, OH	2002	NA	677818	642765	35053	5.2
CN3903700000000	39	037	Darke County, OH	2002	NA	28488	26701	1787	6.3
CN3903900000000	39	039	Defiance County, OH	2002	NA	20822	19598	1224	5.9
CN3904100000000	39	041	Delaware County, OH	2002	NA	71808	68823	2985	4.2
CN3904300000000	39	043	Erie County, OH	2002	NA	43308	40806	2502	5.8
CN3904500000000	39	045	Fairfield County, OH	2002	NA	69222	65610	3612	5.2
CN3904700000000	39	047	Fayette County, OH	2002	NA	15445	14559	886	5.7
CN3904900000000	39	049	Franklin County, OH	2002	NA	604280	573565	30715	5.1
CN3905100000000	39	051	Fulton County, OH	2002	NA	22680	21324	1356	6
CN3905300000000	39	053	Gallia County, OH	2002	NA	14044	13015	1029	7.3
CN3905500000000	39	055	Geauga County, OH	2002	NA	49223	47329	1894	3.8
CN3905700000000	39	057	Greene County, OH	2002	NA	76970	73003	3967	5.2
CN3905900000000	39	059	Guernsey County, OH	2002	NA	19638	18326	1312	6.7
CN3906100000000	39	061	Hamilton County, OH	2002	NA	426298	402965	23333	5.5
CN3906300000000	39	063	Hancock County, OH	2002	NA	39380	37587	1793	4.6
CN3906500000000	39	065	Hardin County, OH	2002	NA	15608	14679	929	6
CN3906700000000	39	067	Harrison County, OH	2002	NA	7485	6966	519	6.9
CN3906900000000	39	069	Henry County, OH	2002	NA	15580	14627	953	6.1
CN3907100000000	39	071	Highland County, OH	2002	NA	20017	18802	1215	6.1
CN3907300000000	39	073	Hocking County, OH	2002	NA	13585	12731	854	6.3
CN3907500000000	39	075	Holmes County, OH	2002	NA	18290	17583	707	3.9
CN3907700000000	39	077	Huron County, OH	2002	NA	30519	28301	2218	7.3
CN3907900000000	39	079	Jackson County, OH	2002	NA	14967	13790	1177	7.9
CN3908100000000	39	081	Jefferson County, OH	2002	NA	32200	29992	2208	6.9
CN3908300000000	39	083	Knox County, OH	2002	NA	28491	26937	1554	5.5
CN3908500000000	39	085	Lake County, OH	2002	NA	129724	123699	6025	4.6
CN3908700000000	39	087	Lawrence County, OH	2002	NA	26987	25176	1811	6.7
CN3908900000000	39	089	Licking County, OH	2002	NA	79159	75021	4138	5.2
CN3909100000000	39	091	Logan County, OH	2002	NA	24451	23107	1344	5.5
CN3909300000000	39	093	Lorain County, OH	2002	NA	148862	141188	7674	5.2
CN3909500000000	39	095	Lucas County, OH	2002	NA	226970	211179	15791	7
CN3909700000000	39	097	Madison County, OH	2002	NA	19547	18533	1014	5.2
CN3909900000000	39	099	Mahoning County, OH	2002	NA	118781	110247	8534	7.2
CN3910100000000	39	101	Marion County, OH	2002	NA	32328	30456	1872	5.8
CN3910300000000	39	103	Medina County, OH	2002	NA	87628	83959	3669	4.2
CN3910500000000	39	105	Meigs County, OH	2002	NA	9524	8658	866	9.1
CN3910700000000	39	107	Mercer County, OH	2002	NA	22104	20944	1160	5.2
CN3910900000000	39	109	Miami County, OH	2002	NA	54558	51463	3095	5.7
CN3911100000000	39	111	Monroe County, OH	2002	NA	6112	5630	482	7.9
CN3911300000000	39	113	Montgomery County, OH	2002	NA	278053	261155	16898	6.1
CN3911500000000	39	115	Morgan County, OH	2002	NA	6652	6052	600	9
CN3911700000000	39	117	Morrow County, OH	2002	NA	17138	16194	944	5.5
CN3911900000000	39	119	Muskingum County, OH	2002	NA	42146	39275	2871	6.8
CN3912100000000	39	121	Noble County, OH	2002	NA	5810	5382	428	7.4
CN3912300000000	39	123	Ottawa County, OH	2002	NA	21408	19833	1575	7.4
CN3912500000000	39	125	Paulding County, OH	2002	NA	10697	10101	596	5.6
CN3912700000000	39	127	Perry County, OH	2002	NA	16741	15574	1167	7
CN3912900000000	39	129	Pickaway County, OH	2002	NA	23598	22136	1462	6.2
CN3913100000000	39	131	Pike County, OH	2002	NA	11409	10323	1086	9.5
CN3913300000000	39	133	Portage County, OH	2002	NA	85504	80762	4742	5.5
CN3913500000000	39	135	Preble County, OH	2002	NA	22160	20797	1363	6.2
CN3913700000000	39	137	Putnam County, OH	2002	NA	18048	17197	851	4.7
CN3913900000000	39	139	Richland County, OH	2002	NA	63964	59599	4365	6.8
CN3914100000000	39	141	Ross County, OH	2002	NA	34172	31846	2326	6.8
CN3914300000000	39	143	Sandusky County, OH	2002	NA	33220	31234	1986	6
CN3914500000000	39	145	Scioto County, OH	2002	NA	33267	30526	2741	8.2
CN3914700000000	39	147	Seneca County, OH	2002	NA	30589	28478	2111	6.9
CN3914900000000	39	149	Shelby County, OH	2002	NA	26415	24982	1433	5.4
CN3915100000000	39	151	Stark County, OH	2002	NA	193399	181803	11596	6
CN3915300000000	39	153	Summit County, OH	2002	NA	282591	265385	17206	6.1
CN3915500000000	39	155	Trumbull County, OH	2002	NA	107011	99507	7504	7
CN3915700000000	39	157	Tuscarawas County, OH	2002	NA	46661	43952	2709	5.8
CN3915900000000	39	159	Union County, OH	2002	NA	23160	22166	994	4.3
CN3916100000000	39	161	Van Wert County, OH	2002	NA	15227	14328	899	5.9
CN3916300000000	39	163	Vinton County, OH	2002	NA	5814	5310	504	8.7
CN3916500000000	39	165	Warren County, OH	2002	NA	91391	87054	4337	4.7
CN3916700000000	39	167	Washington County, OH	2002	NA	32310	30419	1891	5.9
CN3916900000000	39	169	Wayne County, OH	2002	NA	60089	57073	3016	5
CN3917100000000	39	171	Williams County, OH	2002	NA	20284	18986	1298	6.4
CN3917300000000	39	173	Wood County, OH	2002	NA	66409	62850	3559	5.4
CN3917500000000	39	175	Wyandot County, OH	2002	NA	12936	12218	718	5.6
CN4000100000000	40	001	Adair County, OK	2002	NA	9191	8746	445	4.8
CN4000300000000	40	003	Alfalfa County, OK	2002	NA	2507	2421	86	3.4
CN4000500000000	40	005	Atoka County, OK	2002	NA	5410	5145	265	4.9
CN4000700000000	40	007	Beaver County, OK	2002	NA	2946	2847	99	3.4
CN4000900000000	40	009	Beckham County, OK	2002	NA	8932	8562	370	4.1
CN4001100000000	40	011	Blaine County, OK	2002	NA	4662	4447	215	4.6
CN4001300000000	40	013	Bryan County, OK	2002	NA	17951	17278	673	3.7
CN4001500000000	40	015	Caddo County, OK	2002	NA	12293	11717	576	4.7
CN4001700000000	40	017	Canadian County, OK	2002	NA	48400	46379	2021	4.2
CN4001900000000	40	019	Carter County, OK	2002	NA	21815	20785	1030	4.7
CN4002100000000	40	021	Cherokee County, OK	2002	NA	19785	19004	781	3.9
CN4002300000000	40	023	Choctaw County, OK	2002	NA	6527	6121	406	6.2
CN4002500000000	40	025	Cimarron County, OK	2002	NA	1473	1419	54	3.7
CN4002700000000	40	027	Cleveland County, OK	2002	NA	115109	110940	4169	3.6
CN4002900000000	40	029	Coal County, OK	2002	NA	2495	2336	159	6.4
CN4003100000000	40	031	Comanche County, OK	2002	NA	44118	42333	1785	4
CN4003300000000	40	033	Cotton County, OK	2002	NA	2802	2683	119	4.2
CN4003500000000	40	035	Craig County, OK	2002	NA	6651	6314	337	5.1
CN4003700000000	40	037	Creek County, OK	2002	NA	32480	30751	1729	5.3
CN4003900000000	40	039	Custer County, OK	2002	NA	12928	12486	442	3.4
CN4004100000000	40	041	Delaware County, OK	2002	NA	16579	15778	801	4.8
CN4004300000000	40	043	Dewey County, OK	2002	NA	2349	2263	86	3.7
CN4004500000000	40	045	Ellis County, OK	2002	NA	2098	2027	71	3.4
CN4004700000000	40	047	Garfield County, OK	2002	NA	27684	26718	966	3.5
CN4004900000000	40	049	Garvin County, OK	2002	NA	12972	12368	604	4.7
CN4005100000000	40	051	Grady County, OK	2002	NA	22541	21640	901	4
CN4005300000000	40	053	Grant County, OK	2002	NA	2559	2472	87	3.4
CN4005500000000	40	055	Greer County, OK	2002	NA	2268	2153	115	5.1
CN4005700000000	40	057	Harmon County, OK	2002	NA	1421	1362	59	4.2
CN4005900000000	40	059	Harper County, OK	2002	NA	1918	1856	62	3.2
CN4006100000000	40	061	Haskell County, OK	2002	NA	5596	5296	300	5.4
CN4006300000000	40	063	Hughes County, OK	2002	NA	5298	4924	374	7.1
CN4006500000000	40	065	Jackson County, OK	2002	NA	12106	11676	430	3.6
CN4006700000000	40	067	Jefferson County, OK	2002	NA	2492	2346	146	5.9
CN4006900000000	40	069	Johnston County, OK	2002	NA	4511	4303	208	4.6
CN4007100000000	40	071	Kay County, OK	2002	NA	22949	21660	1289	5.6
CN4007300000000	40	073	Kingfisher County, OK	2002	NA	7273	7042	231	3.2
CN4007500000000	40	075	Kiowa County, OK	2002	NA	4567	4396	171	3.7
CN4007700000000	40	077	Latimer County, OK	2002	NA	4078	3791	287	7
CN4007900000000	40	079	Le Flore County, OK	2002	NA	21187	19920	1267	6
CN4008100000000	40	081	Lincoln County, OK	2002	NA	15043	14315	728	4.8
CN4008300000000	40	083	Logan County, OK	2002	NA	17397	16805	592	3.4
CN4008500000000	40	085	Love County, OK	2002	NA	4363	4175	188	4.3
CN4008700000000	40	087	McClain County, OK	2002	NA	14025	13420	605	4.3
CN4008900000000	40	089	McCurtain County, OK	2002	NA	14927	13948	979	6.6
CN4009100000000	40	091	McIntosh County, OK	2002	NA	8087	7584	503	6.2
CN4009300000000	40	093	Major County, OK	2002	NA	3770	3648	122	3.2
CN4009500000000	40	095	Marshall County, OK	2002	NA	5781	5510	271	4.7
CN4009700000000	40	097	Mayes County, OK	2002	NA	16826	15678	1148	6.8
CN4009900000000	40	099	Murray County, OK	2002	NA	5992	5701	291	4.9
CN4010100000000	40	101	Muskogee County, OK	2002	NA	30037	28483	1554	5.2
CN4010300000000	40	103	Noble County, OK	2002	NA	5379	5139	240	4.5
CN4010500000000	40	105	Nowata County, OK	2002	NA	4912	4637	275	5.6
CN4010700000000	40	107	Okfuskee County, OK	2002	NA	4816	4544	272	5.6
CN4010900000000	40	109	Oklahoma County, OK	2002	NA	333340	317810	15530	4.7
CN4011100000000	40	111	Okmulgee County, OK	2002	NA	16999	16014	985	5.8
CN4011300000000	40	113	Osage County, OK	2002	NA	21074	20010	1064	5
CN4011500000000	40	115	Ottawa County, OK	2002	NA	15092	14050	1042	6.9
CN4011700000000	40	117	Pawnee County, OK	2002	NA	7962	7526	436	5.5
CN4011900000000	40	119	Payne County, OK	2002	NA	34813	33622	1191	3.4
CN4012100000000	40	121	Pittsburg County, OK	2002	NA	18540	17431	1109	6
CN4012300000000	40	123	Pontotoc County, OK	2002	NA	16837	16039	798	4.7
CN4012500000000	40	125	Pottawatomie County, OK	2002	NA	29975	28515	1460	4.9
CN4012700000000	40	127	Pushmataha County, OK	2002	NA	4753	4423	330	6.9
CN4012900000000	40	129	Roger Mills County, OK	2002	NA	1828	1770	58	3.2
CN4013100000000	40	131	Rogers County, OK	2002	NA	37929	36248	1681	4.4
CN4013300000000	40	133	Seminole County, OK	2002	NA	10605	9889	716	6.8
CN4013500000000	40	135	Sequoyah County, OK	2002	NA	17681	16614	1067	6
CN4013700000000	40	137	Stephens County, OK	2002	NA	19444	18511	933	4.8
CN4013900000000	40	139	Texas County, OK	2002	NA	10343	10007	336	3.2
CN4014100000000	40	141	Tillman County, OK	2002	NA	3805	3649	156	4.1
CN4014300000000	40	143	Tulsa County, OK	2002	NA	299478	285118	14360	4.8
CN4014500000000	40	145	Wagoner County, OK	2002	NA	30709	29432	1277	4.2
CN4014700000000	40	147	Washington County, OK	2002	NA	23195	22202	993	4.3
CN4014900000000	40	149	Washita County, OK	2002	NA	5777	5572	205	3.5
CN4015100000000	40	151	Woods County, OK	2002	NA	4631	4261	370	8
CN4015300000000	40	153	Woodward County, OK	2002	NA	9490	9104	386	4.1
CN4100100000000	41	001	Baker County, OR	2002	NA	7361	6696	665	9
CN4100300000000	41	003	Benton County, OR	2002	NA	41998	39782	2216	5.3
CN4100500000000	41	005	Clackamas County, OR	2002	NA	188872	175866	13006	6.9
CN4100700000000	41	007	Clatsop County, OR	2002	NA	18088	16841	1247	6.9
CN4100900000000	41	009	Columbia County, OR	2002	NA	22969	20814	2155	9.4
CN4101100000000	41	011	Coos County, OR	2002	NA	27412	25005	2407	8.8
CN4101300000000	41	013	Crook County, OR	2002	NA	8773	7963	810	9.2
CN4101500000000	41	015	Curry County, OR	2002	NA	8816	8109	707	8
CN4101700000000	41	017	Deschutes County, OR	2002	NA	65462	60414	5048	7.7
CN4101900000000	41	019	Douglas County, OR	2002	NA	47019	42873	4146	8.8
CN4102100000000	41	021	Gilliam County, OR	2002	NA	1060	991	69	6.5
CN4102300000000	41	023	Grant County, OR	2002	NA	3745	3394	351	9.4
CN4102500000000	41	025	Harney County, OR	2002	NA	3597	3252	345	9.6
CN4102700000000	41	027	Hood River County, OR	2002	NA	12035	11051	984	8.2
CN4102900000000	41	029	Jackson County, OR	2002	NA	93388	86458	6930	7.4
CN4103100000000	41	031	Jefferson County, OR	2002	NA	8781	8185	596	6.8
CN4103300000000	41	033	Josephine County, OR	2002	NA	32391	29559	2832	8.7
CN4103500000000	41	035	Klamath County, OR	2002	NA	29668	27018	2650	8.9
CN4103700000000	41	037	Lake County, OR	2002	NA	3515	3205	310	8.8
CN4103900000000	41	039	Lane County, OR	2002	NA	172011	159826	12185	7.1
CN4104100000000	41	041	Lincoln County, OR	2002	NA	21423	19698	1725	8.1
CN4104300000000	41	043	Linn County, OR	2002	NA	52444	47729	4715	9
CN4104500000000	41	045	Malheur County, OR	2002	NA	12968	11810	1158	8.9
CN4104700000000	41	047	Marion County, OR	2002	NA	146636	136029	10607	7.2
CN4104900000000	41	049	Morrow County, OR	2002	NA	5790	5353	437	7.5
CN4105100000000	41	051	Multnomah County, OR	2002	NA	377757	347528	30229	8
CN4105300000000	41	053	Polk County, OR	2002	NA	33632	31520	2112	6.3
CN4105500000000	41	055	Sherman County, OR	2002	NA	916	824	92	10
CN4105700000000	41	057	Tillamook County, OR	2002	NA	12049	11245	804	6.7
CN4105900000000	41	059	Umatilla County, OR	2002	NA	37609	34719	2890	7.7
CN4106100000000	41	061	Union County, OR	2002	NA	12332	11536	796	6.5
CN4106300000000	41	063	Wallowa County, OR	2002	NA	3668	3356	312	8.5
CN4106500000000	41	065	Wasco County, OR	2002	NA	12711	11565	1146	9
CN4106700000000	41	067	Washington County, OR	2002	NA	264155	246005	18150	6.9
CN4106900000000	41	069	Wheeler County, OR	2002	NA	728	672	56	7.7
CN4107100000000	41	071	Yamhill County, OR	2002	NA	43546	40347	3199	7.3
CN4200100000000	42	001	Adams County, PA	2002	NA	52239	50051	2188	4.2
CN4200300000000	42	003	Allegheny County, PA	2002	NA	644104	609509	34595	5.4
CN4200500000000	42	005	Armstrong County, PA	2002	NA	33608	31344	2264	6.7
CN4200700000000	42	007	Beaver County, PA	2002	NA	90479	84939	5540	6.1
CN4200900000000	42	009	Bedford County, PA	2002	NA	24816	22940	1876	7.6
CN4201100000000	42	011	Berks County, PA	2002	NA	198134	186317	11817	6
CN4201300000000	42	013	Blair County, PA	2002	NA	64530	60686	3844	6
CN4201500000000	42	015	Bradford County, PA	2002	NA	32797	31062	1735	5.3
CN4201700000000	42	017	Bucks County, PA	2002	NA	339091	322654	16437	4.8
CN4201900000000	42	019	Butler County, PA	2002	NA	93084	88058	5026	5.4
CN4202100000000	42	021	Cambria County, PA	2002	NA	66242	61516	4726	7.1
CN4202300000000	42	023	Cameron County, PA	2002	NA	2595	2387	208	8
CN4202500000000	42	025	Carbon County, PA	2002	NA	29788	27742	2046	6.9
CN4202700000000	42	027	Centre County, PA	2002	NA	72043	68966	3077	4.3
CN4202900000000	42	029	Chester County, PA	2002	NA	245876	235797	10079	4.1
CN4203100000000	42	031	Clarion County, PA	2002	NA	19935	18897	1038	5.2
CN4203300000000	42	033	Clearfield County, PA	2002	NA	41257	38235	3022	7.3
CN4203500000000	42	035	Clinton County, PA	2002	NA	19175	17701	1474	7.7
CN4203700000000	42	037	Columbia County, PA	2002	NA	32719	30649	2070	6.3
CN4203900000000	42	039	Crawford County, PA	2002	NA	43385	40351	3034	7
CN4204100000000	42	041	Cumberland County, PA	2002	NA	118149	113143	5006	4.2
CN4204300000000	42	043	Dauphin County, PA	2002	NA	134983	128348	6635	4.9
CN4204500000000	42	045	Delaware County, PA	2002	NA	281187	266962	14225	5.1
CN4204700000000	42	047	Elk County, PA	2002	NA	17632	16442	1190	6.7
CN4204900000000	42	049	Erie County, PA	2002	NA	140848	131361	9487	6.7
CN4205100000000	42	051	Fayette County, PA	2002	NA	65406	60736	4670	7.1
CN4205300000000	42	053	Forest County, PA	2002	NA	2276	1963	313	13.8
CN4205500000000	42	055	Franklin County, PA	2002	NA	69217	65935	3282	4.7
CN4205700000000	42	057	Fulton County, PA	2002	NA	7344	6860	484	6.6
CN4205900000000	42	059	Greene County, PA	2002	NA	17287	16205	1082	6.3
CN4206100000000	42	061	Huntingdon County, PA	2002	NA	21994	20136	1858	8.4
CN4206300000000	42	063	Indiana County, PA	2002	NA	43716	41030	2686	6.1
CN4206500000000	42	065	Jefferson County, PA	2002	NA	21887	20524	1363	6.2
CN4206700000000	42	067	Juniata County, PA	2002	NA	12105	11491	614	5.1
CN4206900000000	42	069	Lackawanna County, PA	2002	NA	104136	97782	6354	6.1
CN4207100000000	42	071	Lancaster County, PA	2002	NA	260329	250063	10266	3.9
CN4207300000000	42	073	Lawrence County, PA	2002	NA	44311	41529	2782	6.3
CN4207500000000	42	075	Lebanon County, PA	2002	NA	66956	64115	2841	4.2
CN4207700000000	42	077	Lehigh County, PA	2002	NA	167288	157815	9473	5.7
CN4207900000000	42	079	Luzerne County, PA	2002	NA	155322	145166	10156	6.5
CN4208100000000	42	081	Lycoming County, PA	2002	NA	59609	55892	3717	6.2
CN4208300000000	42	083	McKean County, PA	2002	NA	22060	20733	1327	6
CN4208500000000	42	085	Mercer County, PA	2002	NA	55552	52388	3164	5.7
CN4208700000000	42	087	Mifflin County, PA	2002	NA	22457	20762	1695	7.5
CN4208900000000	42	089	Monroe County, PA	2002	NA	73770	69496	4274	5.8
CN4209100000000	42	091	Montgomery County, PA	2002	NA	422025	402460	19565	4.6
CN4209300000000	42	093	Montour County, PA	2002	NA	8754	8320	434	5
CN4209500000000	42	095	Northampton County, PA	2002	NA	142811	135199	7612	5.3
CN4209700000000	42	097	Northumberland County, PA	2002	NA	45747	42715	3032	6.6
CN4209900000000	42	099	Perry County, PA	2002	NA	24013	22813	1200	5
CN4210100000000	42	101	Philadelphia County/city, PA	2002	NA	635301	588476	46825	7.4
CN4210300000000	42	103	Pike County, PA	2002	NA	23104	21802	1302	5.6
CN4210500000000	42	105	Potter County, PA	2002	NA	9340	8806	534	5.7
CN4210700000000	42	107	Schuylkill County, PA	2002	NA	70070	65188	4882	7
CN4210900000000	42	109	Snyder County, PA	2002	NA	19616	18666	950	4.8
CN4211100000000	42	111	Somerset County, PA	2002	NA	38434	35814	2620	6.8
CN4211300000000	42	113	Sullivan County, PA	2002	NA	3195	3006	189	5.9
CN4211500000000	42	115	Susquehanna County, PA	2002	NA	21766	20404	1362	6.3
CN4211700000000	42	117	Tioga County, PA	2002	NA	20798	19447	1351	6.5
CN4211900000000	42	119	Union County, PA	2002	NA	17837	16830	1007	5.6
CN4212100000000	42	121	Venango County, PA	2002	NA	26239	24709	1530	5.8
CN4212300000000	42	123	Warren County, PA	2002	NA	22549	21237	1312	5.8
CN4212500000000	42	125	Washington County, PA	2002	NA	101245	95140	6105	6
CN4212700000000	42	127	Wayne County, PA	2002	NA	23874	22645	1229	5.1
CN4212900000000	42	129	Westmoreland County, PA	2002	NA	185039	174201	10838	5.9
CN4213100000000	42	131	Wyoming County, PA	2002	NA	13928	13087	841	6
CN4213300000000	42	133	York County, PA	2002	NA	211241	200966	10275	4.9
CN4400100000000	44	001	Bristol County, RI	2002	NA	27363	26199	1164	4.3
CN4400300000000	44	003	Kent County, RI	2002	NA	93567	89213	4354	4.7
CN4400500000000	44	005	Newport County, RI	2002	NA	44629	42682	1947	4.4
CN4400700000000	44	007	Providence County, RI	2002	NA	314031	296897	17134	5.5
CN4400900000000	44	009	Washington County, RI	2002	NA	70664	67840	2824	4
CN4500100000000	45	001	Abbeville County, SC	2002	NA	11796	10889	907	7.7
CN4500300000000	45	003	Aiken County, SC	2002	NA	69172	65765	3407	4.9
CN4500500000000	45	005	Allendale County, SC	2002	NA	3494	3248	246	7
CN4500700000000	45	007	Anderson County, SC	2002	NA	81853	76794	5059	6.2
CN4500900000000	45	009	Bamberg County, SC	2002	NA	6322	5898	424	6.7
CN4501100000000	45	011	Barnwell County, SC	2002	NA	9659	8904	755	7.8
CN4501300000000	45	013	Beaufort County, SC	2002	NA	53591	51399	2192	4.1
CN4501500000000	45	015	Berkeley County, SC	2002	NA	65449	62601	2848	4.4
CN4501700000000	45	017	Calhoun County, SC	2002	NA	6949	6515	434	6.2
CN4501900000000	45	019	Charleston County, SC	2002	NA	153406	146447	6959	4.5
CN4502100000000	45	021	Cherokee County, SC	2002	NA	24253	22294	1959	8.1
CN4502300000000	45	023	Chester County, SC	2002	NA	15654	14123	1531	9.8
CN4502500000000	45	025	Chesterfield County, SC	2002	NA	18431	17020	1411	7.7
CN4502700000000	45	027	Clarendon County, SC	2002	NA	12600	11647	953	7.6
CN4502900000000	45	029	Colleton County, SC	2002	NA	15881	14943	938	5.9
CN4503100000000	45	031	Darlington County, SC	2002	NA	30773	28675	2098	6.8
CN4503300000000	45	033	Dillon County, SC	2002	NA	12912	11898	1014	7.9
CN4503500000000	45	035	Dorchester County, SC	2002	NA	48526	46477	2049	4.2
CN4503700000000	45	037	Edgefield County, SC	2002	NA	10262	9763	499	4.9
CN4503900000000	45	039	Fairfield County, SC	2002	NA	11120	10192	928	8.3
CN4504100000000	45	041	Florence County, SC	2002	NA	59452	55634	3818	6.4
CN4504300000000	45	043	Georgetown County, SC	2002	NA	26137	24025	2112	8.1
CN4504500000000	45	045	Greenville County, SC	2002	NA	199133	189682	9451	4.7
CN4504700000000	45	047	Greenwood County, SC	2002	NA	31573	28807	2766	8.8
CN4504900000000	45	049	Hampton County, SC	2002	NA	8125	7537	588	7.2
CN4505100000000	45	051	Horry County, SC	2002	NA	105925	100570	5355	5.1
CN4505300000000	45	053	Jasper County, SC	2002	NA	9322	8859	463	5
CN4505500000000	45	055	Kershaw County, SC	2002	NA	26958	25356	1602	5.9
CN4505700000000	45	057	Lancaster County, SC	2002	NA	29531	27634	1897	6.4
CN4505900000000	45	059	Laurens County, SC	2002	NA	33249	30764	2485	7.5
CN4506100000000	45	061	Lee County, SC	2002	NA	8078	7488	590	7.3
CN4506300000000	45	063	Lexington County, SC	2002	NA	117552	113019	4533	3.9
CN4506500000000	45	065	McCormick County, SC	2002	NA	3617	3229	388	10.7
CN4506700000000	45	067	Marion County, SC	2002	NA	13939	12438	1501	10.8
CN4506900000000	45	069	Marlboro County, SC	2002	NA	12076	10893	1183	9.8
CN4507100000000	45	071	Newberry County, SC	2002	NA	16989	15768	1221	7.2
CN4507300000000	45	073	Oconee County, SC	2002	NA	31581	29506	2075	6.6
CN4507500000000	45	075	Orangeburg County, SC	2002	NA	39789	36375	3414	8.6
CN4507700000000	45	077	Pickens County, SC	2002	NA	55530	52296	3234	5.8
CN4507900000000	45	079	Richland County, SC	2002	NA	159948	152549	7399	4.6
CN4508100000000	45	081	Saluda County, SC	2002	NA	9128	8609	519	5.7
CN4508300000000	45	083	Spartanburg County, SC	2002	NA	127656	119279	8377	6.6
CN4508500000000	45	085	Sumter County, SC	2002	NA	42808	39779	3029	7.1
CN4508700000000	45	087	Union County, SC	2002	NA	13569	12174	1395	10.3
CN4508900000000	45	089	Williamsburg County, SC	2002	NA	14823	13256	1567	10.6
CN4509100000000	45	091	York County, SC	2002	NA	90543	84806	5737	6.3
CN4600300000000	46	003	Aurora County, SD	2002	NA	1514	1460	54	3.6
CN4600500000000	46	005	Beadle County, SD	2002	NA	9137	8786	351	3.8
CN4600700000000	46	007	Bennett County, SD	2002	NA	1424	1365	59	4.1
CN4600900000000	46	009	Bon Homme County, SD	2002	NA	3391	3278	113	3.3
CN4601100000000	46	011	Brookings County, SD	2002	NA	17000	16527	473	2.8
CN4601300000000	46	013	Brown County, SD	2002	NA	20238	19615	623	3.1
CN4601500000000	46	015	Brule County, SD	2002	NA	2875	2803	72	2.5
CN4601700000000	46	017	Buffalo County, SD	2002	NA	541	498	43	7.9
CN4601900000000	46	019	Butte County, SD	2002	NA	4981	4828	153	3.1
CN4602100000000	46	021	Campbell County, SD	2002	NA	912	881	31	3.4
CN4602300000000	46	023	Charles Mix County, SD	2002	NA	4336	4207	129	3
CN4602500000000	46	025	Clark County, SD	2002	NA	1946	1842	104	5.3
CN4602700000000	46	027	Clay County, SD	2002	NA	6998	6782	216	3.1
CN4602900000000	46	029	Codington County, SD	2002	NA	15438	14865	573	3.7
CN4603100000000	46	031	Corson County, SD	2002	NA	1422	1344	78	5.5
CN4603300000000	46	033	Custer County, SD	2002	NA	4528	4379	149	3.3
CN4603500000000	46	035	Davison County, SD	2002	NA	10775	10484	291	2.7
CN4603700000000	46	037	Day County, SD	2002	NA	3071	2911	160	5.2
CN4603900000000	46	039	Deuel County, SD	2002	NA	2560	2461	99	3.9
CN4604100000000	46	041	Dewey County, SD	2002	NA	2559	2357	202	7.9
CN4604300000000	46	043	Douglas County, SD	2002	NA	1765	1718	47	2.7
CN4604500000000	46	045	Edmunds County, SD	2002	NA	2101	2032	69	3.3
CN4604700000000	46	047	Fall River County, SD	2002	NA	3703	3561	142	3.8
CN4604900000000	46	049	Faulk County, SD	2002	NA	1180	1147	33	2.8
CN4605100000000	46	051	Grant County, SD	2002	NA	4247	4095	152	3.6
CN4605300000000	46	053	Gregory County, SD	2002	NA	2503	2418	85	3.4
CN4605500000000	46	055	Haakon County, SD	2002	NA	1259	1231	28	2.2
CN4605700000000	46	057	Hamlin County, SD	2002	NA	2792	2696	96	3.4
CN4605900000000	46	059	Hand County, SD	2002	NA	1960	1903	57	2.9
CN4606100000000	46	061	Hanson County, SD	2002	NA	1774	1728	46	2.6
CN4606300000000	46	063	Harding County, SD	2002	NA	795	775	20	2.5
CN4606500000000	46	065	Hughes County, SD	2002	NA	9833	9607	226	2.3
CN4606700000000	46	067	Hutchinson County, SD	2002	NA	3892	3757	135	3.5
CN4606900000000	46	069	Hyde County, SD	2002	NA	807	784	23	2.9
CN4607100000000	46	071	Jackson County, SD	2002	NA	1219	1161	58	4.8
CN4607300000000	46	073	Jerauld County, SD	2002	NA	1233	1195	38	3.1
CN4607500000000	46	075	Jones County, SD	2002	NA	767	753	14	1.8
CN4607700000000	46	077	Kingsbury County, SD	2002	NA	3133	3032	101	3.2
CN4607900000000	46	079	Lake County, SD	2002	NA	6751	6537	214	3.2
CN4608100000000	46	081	Lawrence County, SD	2002	NA	12334	11988	346	2.8
CN4608300000000	46	083	Lincoln County, SD	2002	NA	16319	15955	364	2.2
CN4608500000000	46	085	Lyman County, SD	2002	NA	2003	1917	86	4.3
CN4608700000000	46	087	McCook County, SD	2002	NA	2978	2882	96	3.2
CN4608900000000	46	089	McPherson County, SD	2002	NA	1300	1259	41	3.2
CN4609100000000	46	091	Marshall County, SD	2002	NA	2031	1912	119	5.9
CN4609300000000	46	093	Meade County, SD	2002	NA	12538	12179	359	2.9
CN4609500000000	46	095	Mellette County, SD	2002	NA	921	880	41	4.5
CN4609700000000	46	097	Miner County, SD	2002	NA	1204	1144	60	5
CN4609900000000	46	099	Minnehaha County, SD	2002	NA	90941	88471	2470	2.7
CN4610100000000	46	101	Moody County, SD	2002	NA	3844	3671	173	4.5
CN4610200000000	46	102	Oglala Lakota County, SD	2002	NA	3779	3504	275	7.3
CN4610300000000	46	103	Pennington County, SD	2002	NA	50650	49139	1511	3
CN4610500000000	46	105	Perkins County, SD	2002	NA	1813	1758	55	3
CN4610700000000	46	107	Potter County, SD	2002	NA	1423	1377	46	3.2
CN4610900000000	46	109	Roberts County, SD	2002	NA	4516	4296	220	4.9
CN4611100000000	46	111	Sanborn County, SD	2002	NA	1549	1507	42	2.7
CN4611500000000	46	115	Spink County, SD	2002	NA	3367	3249	118	3.5
CN4611700000000	46	117	Stanley County, SD	2002	NA	1851	1808	43	2.3
CN4611900000000	46	119	Sully County, SD	2002	NA	977	957	20	2
CN4612100000000	46	121	Todd County, SD	2002	NA	3324	3141	183	5.5
CN4612300000000	46	123	Tripp County, SD	2002	NA	3190	3065	125	3.9
CN4612500000000	46	125	Turner County, SD	2002	NA	4636	4505	131	2.8
CN4612700000000	46	127	Union County, SD	2002	NA	7415	7131	284	3.8
CN4612900000000	46	129	Walworth County, SD	2002	NA	2756	2650	106	3.8
CN4613500000000	46	135	Yankton County, SD	2002	NA	11636	11278	358	3.1
CN4613700000000	46	137	Ziebach County, SD	2002	NA	874	819	55	6.3
CN4700100000000	47	001	Anderson County, TN	2002	NA	35157	33519	1638	4.7
CN4700300000000	47	003	Bedford County, TN	2002	NA	20238	19147	1091	5.4
CN4700500000000	47	005	Benton County, TN	2002	NA	7072	6558	514	7.3
CN4700700000000	47	007	Bledsoe County, TN	2002	NA	5159	4864	295	5.7
CN4700900000000	47	009	Blount County, TN	2002	NA	57735	55291	2444	4.2
CN4701100000000	47	011	Bradley County, TN	2002	NA	45475	43273	2202	4.8
CN4701300000000	47	013	Campbell County, TN	2002	NA	16516	15440	1076	6.5
CN4701500000000	47	015	Cannon County, TN	2002	NA	6387	6094	293	4.6
CN4701700000000	47	017	Carroll County, TN	2002	NA	14025	12758	1267	9
CN4701900000000	47	019	Carter County, TN	2002	NA	28096	26287	1809	6.4
CN4702100000000	47	021	Cheatham County, TN	2002	NA	19866	19082	784	3.9
CN4702300000000	47	023	Chester County, TN	2002	NA	7650	7172	478	6.2
CN4702500000000	47	025	Claiborne County, TN	2002	NA	12862	12150	712	5.5
CN4702700000000	47	027	Clay County, TN	2002	NA	3796	3525	271	7.1
CN4702900000000	47	029	Cocke County, TN	2002	NA	15683	14504	1179	7.5
CN4703100000000	47	031	Coffee County, TN	2002	NA	25140	23914	1226	4.9
CN4703300000000	47	033	Crockett County, TN	2002	NA	7041	6542	499	7.1
CN4703500000000	47	035	Cumberland County, TN	2002	NA	22381	21015	1366	6.1
CN4703700000000	47	037	Davidson County, TN	2002	NA	305801	292721	13080	4.3
CN4703900000000	47	039	Decatur County, TN	2002	NA	5552	5107	445	8
CN4704100000000	47	041	DeKalb County, TN	2002	NA	9208	8747	461	5
CN4704300000000	47	043	Dickson County, TN	2002	NA	22436	21354	1082	4.8
CN4704500000000	47	045	Dyer County, TN	2002	NA	17474	16268	1206	6.9
CN4704700000000	47	047	Fayette County, TN	2002	NA	14979	14074	905	6
CN4704900000000	47	049	Fentress County, TN	2002	NA	7047	6519	528	7.5
CN4705100000000	47	051	Franklin County, TN	2002	NA	19987	19035	952	4.8
CN4705300000000	47	053	Gibson County, TN	2002	NA	22311	20592	1719	7.7
CN4705500000000	47	055	Giles County, TN	2002	NA	14694	13598	1096	7.5
CN4705700000000	47	057	Grainger County, TN	2002	NA	10082	9331	751	7.4
CN4705900000000	47	059	Greene County, TN	2002	NA	31448	29380	2068	6.6
CN4706100000000	47	061	Grundy County, TN	2002	NA	5766	5389	377	6.5
CN4706300000000	47	063	Hamblen County, TN	2002	NA	29800	28060	1740	5.8
CN4706500000000	47	065	Hamilton County, TN	2002	NA	160193	153346	6847	4.3
CN4706700000000	47	067	Hancock County, TN	2002	NA	2617	2415	202	7.7
CN4706900000000	47	069	Hardeman County, TN	2002	NA	11324	10483	841	7.4
CN4707100000000	47	071	Hardin County, TN	2002	NA	11699	10830	869	7.4
CN4707300000000	47	073	Hawkins County, TN	2002	NA	25454	24017	1437	5.6
CN4707500000000	47	075	Haywood County, TN	2002	NA	9660	8885	775	8
CN4707700000000	47	077	Henderson County, TN	2002	NA	12764	11748	1016	8
CN4707900000000	47	079	Henry County, TN	2002	NA	14786	13818	968	6.5
CN4708100000000	47	081	Hickman County, TN	2002	NA	10108	9512	596	5.9
CN4708300000000	47	083	Houston County, TN	2002	NA	3741	3469	272	7.3
CN4708500000000	47	085	Humphreys County, TN	2002	NA	8922	8339	583	6.5
CN4708700000000	47	087	Jackson County, TN	2002	NA	5146	4794	352	6.8
CN4708900000000	47	089	Jefferson County, TN	2002	NA	23213	21752	1461	6.3
CN4709100000000	47	091	Johnson County, TN	2002	NA	7023	6434	589	8.4
CN4709300000000	47	093	Knox County, TN	2002	NA	212552	204944	7608	3.6
CN4709500000000	47	095	Lake County, TN	2002	NA	2761	2575	186	6.7
CN4709700000000	47	097	Lauderdale County, TN	2002	NA	10705	9829	876	8.2
CN4709900000000	47	099	Lawrence County, TN	2002	NA	18763	17153	1610	8.6
CN4710100000000	47	101	Lewis County, TN	2002	NA	5405	5025	380	7
CN4710300000000	47	103	Lincoln County, TN	2002	NA	16316	15588	728	4.5
CN4710500000000	47	105	Loudon County, TN	2002	NA	21095	20085	1010	4.8
CN4710700000000	47	107	McMinn County, TN	2002	NA	23791	22013	1778	7.5
CN4710900000000	47	109	McNairy County, TN	2002	NA	12291	11509	782	6.4
CN4711100000000	47	111	Macon County, TN	2002	NA	10364	9794	570	5.5
CN4711300000000	47	113	Madison County, TN	2002	NA	46411	43710	2701	5.8
CN4711500000000	47	115	Marion County, TN	2002	NA	13162	12343	819	6.2
CN4711700000000	47	117	Marshall County, TN	2002	NA	14138	13396	742	5.2
CN4711900000000	47	119	Maury County, TN	2002	NA	37218	35452	1766	4.7
CN4712100000000	47	121	Meigs County, TN	2002	NA	4904	4519	385	7.9
CN4712300000000	47	123	Monroe County, TN	2002	NA	17575	16190	1385	7.9
CN4712500000000	47	125	Montgomery County, TN	2002	NA	61720	58579	3141	5.1
CN4712700000000	47	127	Moore County, TN	2002	NA	3137	3027	110	3.5
CN4712900000000	47	129	Morgan County, TN	2002	NA	8237	7474	763	9.3
CN4713100000000	47	131	Obion County, TN	2002	NA	16968	16132	836	4.9
CN4713300000000	47	133	Overton County, TN	2002	NA	9697	9082	615	6.3
CN4713500000000	47	135	Perry County, TN	2002	NA	3255	3022	233	7.2
CN4713700000000	47	137	Pickett County, TN	2002	NA	2091	1893	198	9.5
CN4713900000000	47	139	Polk County, TN	2002	NA	7407	6979	428	5.8
CN4714100000000	47	141	Putnam County, TN	2002	NA	32793	31034	1759	5.4
CN4714300000000	47	143	Rhea County, TN	2002	NA	13057	12312	745	5.7
CN4714500000000	47	145	Roane County, TN	2002	NA	25754	24372	1382	5.4
CN4714700000000	47	147	Robertson County, TN	2002	NA	30635	29128	1507	4.9
CN4714900000000	47	149	Rutherford County, TN	2002	NA	108226	103794	4432	4.1
CN4715100000000	47	151	Scott County, TN	2002	NA	8646	7730	916	10.6
CN4715300000000	47	153	Sequatchie County, TN	2002	NA	5517	5245	272	4.9
CN4715500000000	47	155	Sevier County, TN	2002	NA	41529	39098	2431	5.9
CN4715700000000	47	157	Shelby County, TN	2002	NA	440141	417056	23085	5.2
CN4715900000000	47	159	Smith County, TN	2002	NA	8956	8506	450	5
CN4716100000000	47	161	Stewart County, TN	2002	NA	5824	5453	371	6.4
CN4716300000000	47	163	Sullivan County, TN	2002	NA	74132	70323	3809	5.1
CN4716500000000	47	165	Sumner County, TN	2002	NA	72648	69388	3260	4.5
CN4716700000000	47	167	Tipton County, TN	2002	NA	26076	24647	1429	5.5
CN4716900000000	47	169	Trousdale County, TN	2002	NA	3571	3390	181	5.1
CN4717100000000	47	171	Unicoi County, TN	2002	NA	8265	7705	560	6.8
CN4717300000000	47	173	Union County, TN	2002	NA	8695	8292	403	4.6
CN4717500000000	47	175	Van Buren County, TN	2002	NA	2552	2377	175	6.9
CN4717700000000	47	177	Warren County, TN	2002	NA	19613	18345	1268	6.5
CN4717900000000	47	179	Washington County, TN	2002	NA	56485	53481	3004	5.3
CN4718100000000	47	181	Wayne County, TN	2002	NA	6853	6252	601	8.8
CN4718300000000	47	183	Weakley County, TN	2002	NA	17218	16156	1062	6.2
CN4718500000000	47	185	White County, TN	2002	NA	10655	9956	699	6.6
CN4718700000000	47	187	Williamson County, TN	2002	NA	73732	71214	2518	3.4
CN4718900000000	47	189	Wilson County, TN	2002	NA	51549	49364	2185	4.2
CN4800100000000	48	001	Anderson County, TX	2002	NA	20036	18533	1503	7.5
CN4800300000000	48	003	Andrews County, TX	2002	NA	5864	5542	322	5.5
CN4800500000000	48	005	Angelina County, TX	2002	NA	39305	36729	2576	6.6
CN4800700000000	48	007	Aransas County, TX	2002	NA	10242	9523	719	7
CN4800900000000	48	009	Archer County, TX	2002	NA	5123	4918	205	4
CN4801100000000	48	011	Armstrong County, TX	2002	NA	1083	1034	49	4.5
CN4801300000000	48	013	Atascosa County, TX	2002	NA	18371	17273	1098	6
CN4801500000000	48	015	Austin County, TX	2002	NA	12397	11744	653	5.3
CN4801700000000	48	017	Bailey County, TX	2002	NA	3362	3179	183	5.4
CN4801900000000	48	019	Bandera County, TX	2002	NA	9295	8822	473	5.1
CN4802100000000	48	021	Bastrop County, TX	2002	NA	31618	29625	1993	6.3
CN4802300000000	48	023	Baylor County, TX	2002	NA	1869	1755	114	6.1
CN4802500000000	48	025	Bee County, TX	2002	NA	11444	10625	819	7.2
CN4802700000000	48	027	Bell County, TX	2002	NA	107065	100809	6256	5.8
CN4802900000000	48	029	Bexar County, TX	2002	NA	688385	648499	39886	5.8
CN4803100000000	48	031	Blanco County, TX	2002	NA	4507	4290	217	4.8
CN4803300000000	48	033	Borden County, TX	2002	NA	438	421	17	3.9
CN4803500000000	48	035	Bosque County, TX	2002	NA	8050	7543	507	6.3
CN4803700000000	48	037	Bowie County, TX	2002	NA	41530	39016	2514	6.1
CN4803900000000	48	039	Brazoria County, TX	2002	NA	126398	118357	8041	6.4
CN4804100000000	48	041	Brazos County, TX	2002	NA	82544	78955	3589	4.3
CN4804300000000	48	043	Brewster County, TX	2002	NA	4843	4610	233	4.8
CN4804500000000	48	045	Briscoe County, TX	2002	NA	853	810	43	5
CN4804700000000	48	047	Brooks County, TX	2002	NA	3199	2955	244	7.6
CN4804900000000	48	049	Brown County, TX	2002	NA	18196	17129	1067	5.9
CN4805100000000	48	051	Burleson County, TX	2002	NA	8196	7766	430	5.2
CN4805300000000	48	053	Burnet County, TX	2002	NA	19172	18148	1024	5.3
CN4805500000000	48	055	Caldwell County, TX	2002	NA	15619	14567	1052	6.7
CN4805700000000	48	057	Calhoun County, TX	2002	NA	9300	8588	712	7.7
CN4805900000000	48	059	Callahan County, TX	2002	NA	6507	6182	325	5
CN4806100000000	48	061	Cameron County, TX	2002	NA	138349	125902	12447	9
CN4806300000000	48	063	Camp County, TX	2002	NA	5514	5148	366	6.6
CN4806500000000	48	065	Carson County, TX	2002	NA	3471	3312	159	4.6
CN4806700000000	48	067	Cass County, TX	2002	NA	13742	12633	1109	8.1
CN4806900000000	48	069	Castro County, TX	2002	NA	3691	3514	177	4.8
CN4807100000000	48	071	Chambers County, TX	2002	NA	13484	12781	703	5.2
CN4807300000000	48	073	Cherokee County, TX	2002	NA	21010	19787	1223	5.8
CN4807500000000	48	075	Childress County, TX	2002	NA	3158	2973	185	5.9
CN4807700000000	48	077	Clay County, TX	2002	NA	6337	6042	295	4.7
CN4807900000000	48	079	Cochran County, TX	2002	NA	1573	1464	109	6.9
CN4808100000000	48	081	Coke County, TX	2002	NA	1605	1516	89	5.5
CN4808300000000	48	083	Coleman County, TX	2002	NA	4351	4064	287	6.6
CN4808500000000	48	085	Collin County, TX	2002	NA	331175	311011	20164	6.1
CN4808700000000	48	087	Collingsworth County, TX	2002	NA	1658	1587	71	4.3
CN4808900000000	48	089	Colorado County, TX	2002	NA	10038	9532	506	5
CN4809100000000	48	091	Comal County, TX	2002	NA	43962	41461	2501	5.7
CN4809300000000	48	093	Comanche County, TX	2002	NA	6926	6608	318	4.6
CN4809500000000	48	095	Concho County, TX	2002	NA	1393	1309	84	6
CN4809700000000	48	097	Cooke County, TX	2002	NA	18283	17220	1063	5.8
CN4809900000000	48	099	Coryell County, TX	2002	NA	24480	22791	1689	6.9
CN4810100000000	48	101	Cottle County, TX	2002	NA	936	887	49	5.2
CN4810300000000	48	103	Crane County, TX	2002	NA	1573	1457	116	7.4
CN4810500000000	48	105	Crockett County, TX	2002	NA	2110	2016	94	4.5
CN4810700000000	48	107	Crosby County, TX	2002	NA	2955	2792	163	5.5
CN4810900000000	48	109	Culberson County, TX	2002	NA	1607	1511	96	6
CN4811100000000	48	111	Dallam County, TX	2002	NA	3325	3201	124	3.7
CN4811300000000	48	113	Dallas County, TX	2002	NA	1181082	1093896	87186	7.4
CN4811500000000	48	115	Dawson County, TX	2002	NA	5425	5041	384	7.1
CN4811700000000	48	117	Deaf Smith County, TX	2002	NA	8025	7553	472	5.9
CN4811900000000	48	119	Delta County, TX	2002	NA	2479	2322	157	6.3
CN4812100000000	48	121	Denton County, TX	2002	NA	285634	271418	14216	5
CN4812300000000	48	123	DeWitt County, TX	2002	NA	9268	8736	532	5.7
CN4812500000000	48	125	Dickens County, TX	2002	NA	1157	1094	63	5.4
CN4812700000000	48	127	Dimmit County, TX	2002	NA	4028	3657	371	9.2
CN4812900000000	48	129	Donley County, TX	2002	NA	1929	1834	95	4.9
CN4813100000000	48	131	Duval County, TX	2002	NA	5073	4606	467	9.2
CN4813300000000	48	133	Eastland County, TX	2002	NA	8736	8218	518	5.9
CN4813500000000	48	135	Ector County, TX	2002	NA	59540	55636	3904	6.6
CN4813700000000	48	137	Edwards County, TX	2002	NA	1073	1018	55	5.1
CN4813900000000	48	139	Ellis County, TX	2002	NA	61738	58172	3566	5.8
CN4814100000000	48	141	El Paso County, TX	2002	NA	283402	260275	23127	8.2
CN4814300000000	48	143	Erath County, TX	2002	NA	17124	16328	796	4.6
CN4814500000000	48	145	Falls County, TX	2002	NA	7355	6905	450	6.1
CN4814700000000	48	147	Fannin County, TX	2002	NA	14024	12929	1095	7.8
CN4814900000000	48	149	Fayette County, TX	2002	NA	12085	11547	538	4.5
CN4815100000000	48	151	Fisher County, TX	2002	NA	2137	2018	119	5.6
CN4815300000000	48	153	Floyd County, TX	2002	NA	3476	3247	229	6.6
CN4815500000000	48	155	Foard County, TX	2002	NA	769	726	43	5.6
CN4815700000000	48	157	Fort Bend County, TX	2002	NA	205912	195257	10655	5.2
CN4815900000000	48	159	Franklin County, TX	2002	NA	4961	4723	238	4.8
CN4816100000000	48	161	Freestone County, TX	2002	NA	9191	8663	528	5.7
CN4816300000000	48	163	Frio County, TX	2002	NA	6297	5810	487	7.7
CN4816500000000	48	165	Gaines County, TX	2002	NA	6425	6113	312	4.9
CN4816700000000	48	167	Galveston County, TX	2002	NA	133025	124370	8655	6.5
CN4816900000000	48	169	Garza County, TX	2002	NA	2215	2096	119	5.4
CN4817100000000	48	171	Gillespie County, TX	2002	NA	11255	10795	460	4.1
CN4817300000000	48	173	Glasscock County, TX	2002	NA	691	665	26	3.8
CN4817500000000	48	175	Goliad County, TX	2002	NA	3340	3166	174	5.2
CN4817700000000	48	177	Gonzales County, TX	2002	NA	9520	9048	472	5
CN4817900000000	48	179	Gray County, TX	2002	NA	10149	9530	619	6.1
CN4818100000000	48	181	Grayson County, TX	2002	NA	56497	52744	3753	6.6
CN4818300000000	48	183	Gregg County, TX	2002	NA	56805	52820	3985	7
CN4818500000000	48	185	Grimes County, TX	2002	NA	9971	9207	764	7.7
CN4818700000000	48	187	Guadalupe County, TX	2002	NA	48040	45513	2527	5.3
CN4818900000000	48	189	Hale County, TX	2002	NA	16914	15960	954	5.6
CN4819100000000	48	191	Hall County, TX	2002	NA	1688	1584	104	6.2
CN4819300000000	48	193	Hamilton County, TX	2002	NA	4309	4120	189	4.4
CN4819500000000	48	195	Hansford County, TX	2002	NA	2759	2660	99	3.6
CN4819700000000	48	197	Hardeman County, TX	2002	NA	2383	2253	130	5.5
CN4819900000000	48	199	Hardin County, TX	2002	NA	24035	22278	1757	7.3
CN4820100000000	48	201	Harris County, TX	2002	NA	1790572	1680755	109817	6.1
CN4820300000000	48	203	Harrison County, TX	2002	NA	29994	28004	1990	6.6
CN4820500000000	48	205	Hartley County, TX	2002	NA	2325	2239	86	3.7
CN4820700000000	48	207	Haskell County, TX	2002	NA	2939	2787	152	5.2
CN4820900000000	48	209	Hays County, TX	2002	NA	61060	57727	3333	5.5
CN4821100000000	48	211	Hemphill County, TX	2002	NA	2122	2054	68	3.2
CN4821300000000	48	213	Henderson County, TX	2002	NA	33746	31790	1956	5.8
CN4821500000000	48	215	Hidalgo County, TX	2002	NA	231099	206937	24162	10.5
CN4821700000000	48	217	Hill County, TX	2002	NA	15364	14335	1029	6.7
CN4821900000000	48	219	Hockley County, TX	2002	NA	11104	10539	565	5.1
CN4822100000000	48	221	Hood County, TX	2002	NA	21741	20485	1256	5.8
CN4822300000000	48	223	Hopkins County, TX	2002	NA	16604	15709	895	5.4
CN4822500000000	48	225	Houston County, TX	2002	NA	9289	8678	611	6.6
CN4822700000000	48	227	Howard County, TX	2002	NA	14235	13336	899	6.3
CN4822900000000	48	229	Hudspeth County, TX	2002	NA	1291	1192	99	7.7
CN4823100000000	48	231	Hunt County, TX	2002	NA	38691	36270	2421	6.3
CN4823300000000	48	233	Hutchinson County, TX	2002	NA	11093	10362	731	6.6
CN4823500000000	48	235	Irion County, TX	2002	NA	958	924	34	3.5
CN4823700000000	48	237	Jack County, TX	2002	NA	4096	3899	197	4.8
CN4823900000000	48	239	Jackson County, TX	2002	NA	6724	6326	398	5.9
CN4824100000000	48	241	Jasper County, TX	2002	NA	15899	14418	1481	9.3
CN4824300000000	48	243	Jeff Davis County, TX	2002	NA	1276	1218	58	4.5
CN4824500000000	48	245	Jefferson County, TX	2002	NA	112675	103864	8811	7.8
CN4824700000000	48	247	Jim Hogg County, TX	2002	NA	2370	2222	148	6.2
CN4824900000000	48	249	Jim Wells County, TX	2002	NA	18034	16747	1287	7.1
CN4825100000000	48	251	Johnson County, TX	2002	NA	68760	64616	4144	6
CN4825300000000	48	253	Jones County, TX	2002	NA	7845	7355	490	6.2
CN4825500000000	48	255	Karnes County, TX	2002	NA	5455	5076	379	6.9
CN4825700000000	48	257	Kaufman County, TX	2002	NA	39580	36645	2935	7.4
CN4825900000000	48	259	Kendall County, TX	2002	NA	12856	12226	630	4.9
CN4826100000000	48	261	Kenedy County, TX	2002	NA	215	205	10	4.7
CN4826300000000	48	263	Kent County, TX	2002	NA	440	422	18	4.1
CN4826500000000	48	265	Kerr County, TX	2002	NA	19957	18931	1026	5.1
CN4826700000000	48	267	Kimble County, TX	2002	NA	2226	2134	92	4.1
CN4826900000000	48	269	King County, TX	2002	NA	247	240	7	2.8
CN4827100000000	48	271	Kinney County, TX	2002	NA	1341	1234	107	8
CN4827300000000	48	273	Kleberg County, TX	2002	NA	14518	13603	915	6.3
CN4827500000000	48	275	Knox County, TX	2002	NA	1864	1769	95	5.1
CN4827700000000	48	277	Lamar County, TX	2002	NA	23468	21846	1622	6.9
CN4827900000000	48	279	Lamb County, TX	2002	NA	7167	6775	392	5.5
CN4828100000000	48	281	Lampasas County, TX	2002	NA	9319	8837	482	5.2
CN4828300000000	48	283	La Salle County, TX	2002	NA	2257	2067	190	8.4
CN4828500000000	48	285	Lavaca County, TX	2002	NA	9480	9084	396	4.2
CN4828700000000	48	287	Lee County, TX	2002	NA	8523	8095	428	5
CN4828900000000	48	289	Leon County, TX	2002	NA	7321	6821	500	6.8
CN4829100000000	48	291	Liberty County, TX	2002	NA	31719	29117	2602	8.2
CN4829300000000	48	293	Limestone County, TX	2002	NA	10132	9559	573	5.7
CN4829500000000	48	295	Lipscomb County, TX	2002	NA	1480	1417	63	4.3
CN4829700000000	48	297	Live Oak County, TX	2002	NA	4946	4680	266	5.4
CN4829900000000	48	299	Llano County, TX	2002	NA	7728	7284	444	5.7
CN4830100000000	48	301	Loving County, TX	2002	NA	48	45	3	6.3
CN4830300000000	48	303	Lubbock County, TX	2002	NA	132892	127084	5808	4.4
CN4830500000000	48	305	Lynn County, TX	2002	NA	3020	2871	149	4.9
CN4830700000000	48	307	McCulloch County, TX	2002	NA	3637	3434	203	5.6
CN4830900000000	48	309	McLennan County, TX	2002	NA	106240	100218	6022	5.7
CN4831100000000	48	311	McMullen County, TX	2002	NA	434	415	19	4.4
CN4831300000000	48	313	Madison County, TX	2002	NA	5001	4703	298	6
CN4831500000000	48	315	Marion County, TX	2002	NA	4714	4365	349	7.4
CN4831700000000	48	317	Martin County, TX	2002	NA	2220	2116	104	4.7
CN4831900000000	48	319	Mason County, TX	2002	NA	2237	2158	79	3.5
CN4832100000000	48	321	Matagorda County, TX	2002	NA	17118	15546	1572	9.2
CN4832300000000	48	323	Maverick County, TX	2002	NA	17294	13909	3385	19.6
CN4832500000000	48	325	Medina County, TX	2002	NA	18599	17615	984	5.3
CN4832700000000	48	327	Menard County, TX	2002	NA	1134	1077	57	5
CN4832900000000	48	329	Midland County, TX	2002	NA	61211	58259	2952	4.8
CN4833100000000	48	331	Milam County, TX	2002	NA	11885	11160	725	6.1
CN4833300000000	48	333	Mills County, TX	2002	NA	2520	2410	110	4.4
CN4833500000000	48	335	Mitchell County, TX	2002	NA	3430	3178	252	7.3
CN4833700000000	48	337	Montague County, TX	2002	NA	9166	8620	546	6
CN4833900000000	48	339	Montgomery County, TX	2002	NA	168171	159597	8574	5.1
CN4834100000000	48	341	Moore County, TX	2002	NA	10199	9785	414	4.1
CN4834300000000	48	343	Morris County, TX	2002	NA	5996	5424	572	9.5
CN4834500000000	48	345	Motley County, TX	2002	NA	683	655	28	4.1
CN4834700000000	48	347	Nacogdoches County, TX	2002	NA	30134	28474	1660	5.5
CN4834900000000	48	349	Navarro County, TX	2002	NA	21879	20382	1497	6.8
CN4835100000000	48	351	Newton County, TX	2002	NA	6058	5348	710	11.7
CN4835300000000	48	353	Nolan County, TX	2002	NA	7384	6978	406	5.5
CN4835500000000	48	355	Nueces County, TX	2002	NA	151976	142724	9252	6.1
CN4835700000000	48	357	Ochiltree County, TX	2002	NA	4712	4525	187	4
CN4835900000000	48	359	Oldham County, TX	2002	NA	1182	1135	47	4
CN4836100000000	48	361	Orange County, TX	2002	NA	40921	37417	3504	8.6
CN4836300000000	48	363	Palo Pinto County, TX	2002	NA	13195	12393	802	6.1
CN4836500000000	48	365	Panola County, TX	2002	NA	10848	10110	738	6.8
CN4836700000000	48	367	Parker County, TX	2002	NA	47674	45164	2510	5.3
CN4836900000000	48	369	Parmer County, TX	2002	NA	4652	4463	189	4.1
CN4837100000000	48	371	Pecos County, TX	2002	NA	7172	6716	456	6.4
CN4837300000000	48	373	Polk County, TX	2002	NA	16544	15253	1291	7.8
CN4837500000000	48	375	Potter County, TX	2002	NA	54822	51334	3488	6.4
CN4837700000000	48	377	Presidio County, TX	2002	NA	3419	2881	538	15.7
CN4837900000000	48	379	Rains County, TX	2002	NA	4484	4185	299	6.7
CN4838100000000	48	381	Randall County, TX	2002	NA	61981	60125	1856	3
CN4838300000000	48	383	Reagan County, TX	2002	NA	1607	1539	68	4.2
CN4838500000000	48	385	Real County, TX	2002	NA	1335	1246	89	6.7
CN4838700000000	48	387	Red River County, TX	2002	NA	6448	5935	513	8
CN4838900000000	48	389	Reeves County, TX	2002	NA	5050	4340	710	14.1
CN4839100000000	48	391	Refugio County, TX	2002	NA	3677	3488	189	5.1
CN4839300000000	48	393	Roberts County, TX	2002	NA	523	506	17	3.3
CN4839500000000	48	395	Robertson County, TX	2002	NA	7241	6832	409	5.6
CN4839700000000	48	397	Rockwall County, TX	2002	NA	27265	25726	1539	5.6
CN4839900000000	48	399	Runnels County, TX	2002	NA	5178	4926	252	4.9
CN4840100000000	48	401	Rusk County, TX	2002	NA	21384	19981	1403	6.6
CN4840300000000	48	403	Sabine County, TX	2002	NA	3758	3276	482	12.8
CN4840500000000	48	405	San Augustine County, TX	2002	NA	3826	3553	273	7.1
CN4840700000000	48	407	San Jacinto County, TX	2002	NA	9726	9110	616	6.3
CN4840900000000	48	409	San Patricio County, TX	2002	NA	28216	26298	1918	6.8
CN4841100000000	48	411	San Saba County, TX	2002	NA	2764	2629	135	4.9
CN4841300000000	48	413	Schleicher County, TX	2002	NA	1430	1362	68	4.8
CN4841500000000	48	415	Scurry County, TX	2002	NA	7037	6599	438	6.2
CN4841700000000	48	417	Shackelford County, TX	2002	NA	1868	1792	76	4.1
CN4841900000000	48	419	Shelby County, TX	2002	NA	11980	11161	819	6.8
CN4842100000000	48	421	Sherman County, TX	2002	NA	1709	1651	58	3.4
CN4842300000000	48	423	Smith County, TX	2002	NA	89929	84889	5040	5.6
CN4842500000000	48	425	Somervell County, TX	2002	NA	3641	3435	206	5.7
CN4842700000000	48	427	Starr County, TX	2002	NA	19937	16620	3317	16.6
CN4842900000000	48	429	Stephens County, TX	2002	NA	4341	4061	280	6.5
CN4843100000000	48	431	Sterling County, TX	2002	NA	840	808	32	3.8
CN4843300000000	48	433	Stonewall County, TX	2002	NA	848	812	36	4.2
CN4843500000000	48	435	Sutton County, TX	2002	NA	2382	2291	91	3.8
CN4843700000000	48	437	Swisher County, TX	2002	NA	3917	3730	187	4.8
CN4843900000000	48	439	Tarrant County, TX	2002	NA	815484	766183	49301	6
CN4844100000000	48	441	Taylor County, TX	2002	NA	63354	60223	3131	4.9
CN4844300000000	48	443	Terrell County, TX	2002	NA	494	465	29	5.9
CN4844500000000	48	445	Terry County, TX	2002	NA	5583	5257	326	5.8
CN4844700000000	48	447	Throckmorton County, TX	2002	NA	1000	958	42	4.2
CN4844900000000	48	449	Titus County, TX	2002	NA	13950	13182	768	5.5
CN4845100000000	48	451	Tom Green County, TX	2002	NA	52183	49684	2499	4.8
CN4845300000000	48	453	Travis County, TX	2002	NA	490142	460978	29164	6
CN4845500000000	48	455	Trinity County, TX	2002	NA	5707	5309	398	7
CN4845700000000	48	457	Tyler County, TX	2002	NA	8407	7641	766	9.1
CN4845900000000	48	459	Upshur County, TX	2002	NA	17228	16135	1093	6.3
CN4846100000000	48	461	Upton County, TX	2002	NA	1529	1445	84	5.5
CN4846300000000	48	463	Uvalde County, TX	2002	NA	11695	10833	862	7.4
CN4846500000000	48	465	Val Verde County, TX	2002	NA	18864	17517	1347	7.1
CN4846700000000	48	467	Van Zandt County, TX	2002	NA	24207	22795	1412	5.8
CN4846900000000	48	469	Victoria County, TX	2002	NA	43407	40989	2418	5.6
CN4847100000000	48	471	Walker County, TX	2002	NA	25569	24081	1488	5.8
CN4847300000000	48	473	Waller County, TX	2002	NA	15833	14898	935	5.9
CN4847500000000	48	475	Ward County, TX	2002	NA	4398	4062	336	7.6
CN4847700000000	48	477	Washington County, TX	2002	NA	15545	14836	709	4.6
CN4847900000000	48	479	Webb County, TX	2002	NA	78022	72359	5663	7.3
CN4848100000000	48	481	Wharton County, TX	2002	NA	20639	19444	1195	5.8
CN4848300000000	48	483	Wheeler County, TX	2002	NA	2759	2633	126	4.6
CN4848500000000	48	485	Wichita County, TX	2002	NA	62819	59108	3711	5.9
CN4848700000000	48	487	Wilbarger County, TX	2002	NA	7427	7081	346	4.7
CN4848900000000	48	489	Willacy County, TX	2002	NA	7278	6362	916	12.6
CN4849100000000	48	491	Williamson County, TX	2002	NA	159667	150689	8978	5.6
CN4849300000000	48	493	Wilson County, TX	2002	NA	16403	15544	859	5.2
CN4849500000000	48	495	Winkler County, TX	2002	NA	2995	2734	261	8.7
CN4849700000000	48	497	Wise County, TX	2002	NA	26364	24943	1421	5.4
CN4849900000000	48	499	Wood County, TX	2002	NA	16943	15857	1086	6.4
CN4850100000000	48	501	Yoakum County, TX	2002	NA	3289	3111	178	5.4
CN4850300000000	48	503	Young County, TX	2002	NA	8910	8388	522	5.9
CN4850500000000	48	505	Zapata County, TX	2002	NA	4461	4072	389	8.7
CN4850700000000	48	507	Zavala County, TX	2002	NA	3929	3362	567	14.4
CN4900100000000	49	001	Beaver County, UT	2002	NA	3093	2949	144	4.7
CN4900300000000	49	003	Box Elder County, UT	2002	NA	21085	19898	1187	5.6
CN4900500000000	49	005	Cache County, UT	2002	NA	52540	50331	2209	4.2
CN4900700000000	49	007	Carbon County, UT	2002	NA	9439	8778	661	7
CN4900900000000	49	009	Daggett County, UT	2002	NA	509	484	25	4.9
CN4901100000000	49	011	Davis County, UT	2002	NA	124888	118588	6300	5
CN4901300000000	49	013	Duchesne County, UT	2002	NA	7013	6540	473	6.7
CN4901500000000	49	015	Emery County, UT	2002	NA	4793	4451	342	7.1
CN4901700000000	49	017	Garfield County, UT	2002	NA	2593	2350	243	9.4
CN4901900000000	49	019	Grand County, UT	2002	NA	4799	4437	362	7.5
CN4902100000000	49	021	Iron County, UT	2002	NA	17734	16799	935	5.3
CN4902300000000	49	023	Juab County, UT	2002	NA	3691	3416	275	7.5
CN4902500000000	49	025	Kane County, UT	2002	NA	2982	2823	159	5.3
CN4902700000000	49	027	Millard County, UT	2002	NA	6163	5881	282	4.6
CN4902900000000	49	029	Morgan County, UT	2002	NA	3549	3359	190	5.4
CN4903100000000	49	031	Piute County, UT	2002	NA	749	702	47	6.3
CN4903300000000	49	033	Rich County, UT	2002	NA	1257	1206	51	4.1
CN4903500000000	49	035	Salt Lake County, UT	2002	NA	495252	465786	29466	5.9
CN4903700000000	49	037	San Juan County, UT	2002	NA	4777	4367	410	8.6
CN4903900000000	49	039	Sanpete County, UT	2002	NA	10202	9533	669	6.6
CN4904100000000	49	041	Sevier County, UT	2002	NA	8859	8354	505	5.7
CN4904300000000	49	043	Summit County, UT	2002	NA	19446	18173	1273	6.5
CN4904500000000	49	045	Tooele County, UT	2002	NA	22322	20907	1415	6.3
CN4904700000000	49	047	Uintah County, UT	2002	NA	12619	11857	762	6
CN4904900000000	49	049	Utah County, UT	2002	NA	186116	175244	10872	5.8
CN4905100000000	49	051	Wasatch County, UT	2002	NA	8228	7708	520	6.3
CN4905300000000	49	053	Washington County, UT	2002	NA	44723	42371	2352	5.3
CN4905500000000	49	055	Wayne County, UT	2002	NA	1438	1346	92	6.4
CN4905700000000	49	057	Weber County, UT	2002	NA	103897	97432	6465	6.2
CN5000100000000	50	001	Addison County, VT	2002	NA	20757	20015	742	3.6
CN5000300000000	50	003	Bennington County, VT	2002	NA	20168	19227	941	4.7
CN5000500000000	50	005	Caledonia County, VT	2002	NA	15954	15165	789	4.9
CN5000700000000	50	007	Chittenden County, VT	2002	NA	86110	83091	3019	3.5
CN5000900000000	50	009	Essex County, VT	2002	NA	3286	3105	181	5.5
CN5001100000000	50	011	Franklin County, VT	2002	NA	25102	24042	1060	4.2
CN5001300000000	50	013	Grand Isle County, VT	2002	NA	3985	3790	195	4.9
CN5001500000000	50	015	Lamoille County, VT	2002	NA	13810	13230	580	4.2
CN5001700000000	50	017	Orange County, VT	2002	NA	16134	15531	603	3.7
CN5001900000000	50	019	Orleans County, VT	2002	NA	13567	12739	828	6.1
CN5002100000000	50	021	Rutland County, VT	2002	NA	34535	33128	1407	4.1
CN5002300000000	50	023	Washington County, VT	2002	NA	33464	32054	1410	4.2
CN5002500000000	50	025	Windham County, VT	2002	NA	24705	23874	831	3.4
CN5002700000000	50	027	Windsor County, VT	2002	NA	31546	30437	1109	3.5
CN5100100000000	51	001	Accomack County, VA	2002	NA	19016	18222	794	4.2
CN5100300000000	51	003	Albemarle County, VA	2002	NA	44322	42928	1394	3.1
CN5100500000000	51	005	Alleghany County, VA	2002	NA	8026	7600	426	5.3
CN5100700000000	51	007	Amelia County, VA	2002	NA	5997	5765	232	3.9
CN5100900000000	51	009	Amherst County, VA	2002	NA	15200	14365	835	5.5
CN5101100000000	51	011	Appomattox County, VA	2002	NA	6707	6324	383	5.7
CN5101300000000	51	013	Arlington County, VA	2002	NA	121119	117495	3624	3
CN5101500000000	51	015	Augusta County, VA	2002	NA	35520	34269	1251	3.5
CN5101700000000	51	017	Bath County, VA	2002	NA	2803	2679	124	4.4
CN5101900000000	51	019	Bedford County, VA	2002	NA	34735	33115	1620	4.7
CN5102100000000	51	021	Bland County, VA	2002	NA	3016	2856	160	5.3
CN5102300000000	51	023	Botetourt County, VA	2002	NA	17118	16491	627	3.7
CN5102500000000	51	025	Brunswick County, VA	2002	NA	6826	6389	437	6.4
CN5102700000000	51	027	Buchanan County, VA	2002	NA	8983	8344	639	7.1
CN5102900000000	51	029	Buckingham County, VA	2002	NA	6229	5988	241	3.9
CN5103100000000	51	031	Campbell County, VA	2002	NA	26392	24876	1516	5.7
CN5103300000000	51	033	Caroline County, VA	2002	NA	11285	10799	486	4.3
CN5103500000000	51	035	Carroll County, VA	2002	NA	14782	13802	980	6.6
CN5103600000000	51	036	Charles City County, VA	2002	NA	3725	3530	195	5.2
CN5103700000000	51	037	Charlotte County, VA	2002	NA	5542	5127	415	7.5
CN5104100000000	51	041	Chesterfield County, VA	2002	NA	147501	142446	5055	3.4
CN5104300000000	51	043	Clarke County, VA	2002	NA	7068	6853	215	3
CN5104500000000	51	045	Craig County, VA	2002	NA	2534	2431	103	4.1
CN5104700000000	51	047	Culpeper County, VA	2002	NA	17557	16890	667	3.8
CN5104900000000	51	049	Cumberland County, VA	2002	NA	4237	4081	156	3.7
CN5105100000000	51	051	Dickenson County, VA	2002	NA	5650	5206	444	7.9
CN5105300000000	51	053	Dinwiddie County, VA	2002	NA	12074	11590	484	4
CN5105700000000	51	057	Essex County, VA	2002	NA	5335	5098	237	4.4
CN5105900000000	51	059	Fairfax County, VA	2002	NA	552845	534079	18766	3.4
CN5106100000000	51	061	Fauquier County, VA	2002	NA	31829	30844	985	3.1
CN5106300000000	51	063	Floyd County, VA	2002	NA	6765	6467	298	4.4
CN5106500000000	51	065	Fluvanna County, VA	2002	NA	11234	10872	362	3.2
CN5106700000000	51	067	Franklin County, VA	2002	NA	25501	24169	1332	5.2
CN5106900000000	51	069	Frederick County, VA	2002	NA	34573	33371	1202	3.5
CN5107100000000	51	071	Giles County, VA	2002	NA	8016	7531	485	6.1
CN5107300000000	51	073	Gloucester County, VA	2002	NA	18590	18000	590	3.2
CN5107500000000	51	075	Goochland County, VA	2002	NA	9334	9019	315	3.4
CN5107700000000	51	077	Grayson County, VA	2002	NA	8005	7364	641	8
CN5107900000000	51	079	Greene County, VA	2002	NA	8896	8581	315	3.5
CN5108100000000	51	081	Greensville County, VA	2002	NA	4014	3828	186	4.6
CN5108300000000	51	083	Halifax County, VA	2002	NA	16758	15035	1723	10.3
CN5108500000000	51	085	Hanover County, VA	2002	NA	50099	48448	1651	3.3
CN5108700000000	51	087	Henrico County, VA	2002	NA	148325	142853	5472	3.7
CN5108900000000	51	089	Henry County, VA	2002	NA	28242	25380	2862	10.1
CN5109100000000	51	091	Highland County, VA	2002	NA	1122	1078	44	3.9
CN5109300000000	51	093	Isle of Wight County, VA	2002	NA	15846	15292	554	3.5
CN5109500000000	51	095	James City County, VA	2002	NA	25386	24546	840	3.3
CN5109700000000	51	097	King and Queen County, VA	2002	NA	3143	3004	139	4.4
CN5109900000000	51	099	King George County, VA	2002	NA	8813	8536	277	3.1
CN5110100000000	51	101	King William County, VA	2002	NA	7343	7075	268	3.6
CN5110300000000	51	103	Lancaster County, VA	2002	NA	5168	4836	332	6.4
CN5110500000000	51	105	Lee County, VA	2002	NA	9504	8958	546	5.7
CN5110700000000	51	107	Loudoun County, VA	2002	NA	116388	112030	4358	3.7
CN5110900000000	51	109	Louisa County, VA	2002	NA	13603	13007	596	4.4
CN5111100000000	51	111	Lunenburg County, VA	2002	NA	5466	5159	307	5.6
CN5111300000000	51	113	Madison County, VA	2002	NA	6987	6686	301	4.3
CN5111500000000	51	115	Mathews County, VA	2002	NA	4424	4247	177	4
CN5111700000000	51	117	Mecklenburg County, VA	2002	NA	14088	12646	1442	10.2
CN5111900000000	51	119	Middlesex County, VA	2002	NA	4738	4581	157	3.3
CN5112100000000	51	121	Montgomery County, VA	2002	NA	41353	39695	1658	4
CN5112500000000	51	125	Nelson County, VA	2002	NA	7102	6843	259	3.6
CN5112700000000	51	127	New Kent County, VA	2002	NA	7718	7437	281	3.6
CN5113100000000	51	131	Northampton County, VA	2002	NA	5876	5576	300	5.1
CN5113300000000	51	133	Northumberland County, VA	2002	NA	5577	5243	334	6
CN5113500000000	51	135	Nottoway County, VA	2002	NA	6351	6071	280	4.4
CN5113700000000	51	137	Orange County, VA	2002	NA	13287	12688	599	4.5
CN5113900000000	51	139	Page County, VA	2002	NA	12294	11535	759	6.2
CN5114100000000	51	141	Patrick County, VA	2002	NA	9601	8790	811	8.4
CN5114300000000	51	143	Pittsylvania County, VA	2002	NA	32838	30524	2314	7
CN5114500000000	51	145	Powhatan County, VA	2002	NA	12114	11732	382	3.2
CN5114700000000	51	147	Prince Edward County, VA	2002	NA	8266	7779	487	5.9
CN5114900000000	51	149	Prince George County, VA	2002	NA	14114	13568	546	3.9
CN5115300000000	51	153	Prince William County, VA	2002	NA	166146	160457	5689	3.4
CN5115500000000	51	155	Pulaski County, VA	2002	NA	17566	16452	1114	6.3
CN5115700000000	51	157	Rappahannock County, VA	2002	NA	3728	3601	127	3.4
CN5115900000000	51	159	Richmond County, VA	2002	NA	3508	3308	200	5.7
CN5116100000000	51	161	Roanoke County, VA	2002	NA	47125	45587	1538	3.3
CN5116300000000	51	163	Rockbridge County, VA	2002	NA	11029	10644	385	3.5
CN5116500000000	51	165	Rockingham County, VA	2002	NA	37652	36334	1318	3.5
CN5116700000000	51	167	Russell County, VA	2002	NA	12140	11369	771	6.4
CN5116900000000	51	169	Scott County, VA	2002	NA	9816	9292	524	5.3
CN5117100000000	51	171	Shenandoah County, VA	2002	NA	19057	18460	597	3.1
CN5117300000000	51	173	Smyth County, VA	2002	NA	15475	14223	1252	8.1
CN5117500000000	51	175	Southampton County, VA	2002	NA	7436	7124	312	4.2
CN5117700000000	51	177	Spotsylvania County, VA	2002	NA	53322	51777	1545	2.9
CN5117900000000	51	179	Stafford County, VA	2002	NA	53202	51592	1610	3
CN5118100000000	51	181	Surry County, VA	2002	NA	3558	3397	161	4.5
CN5118300000000	51	183	Sussex County, VA	2002	NA	4385	4130	255	5.8
CN5118500000000	51	185	Tazewell County, VA	2002	NA	20101	18936	1165	5.8
CN5118700000000	51	187	Warren County, VA	2002	NA	17082	16400	682	4
CN5119100000000	51	191	Washington County, VA	2002	NA	25931	24351	1580	6.1
CN5119300000000	51	193	Westmoreland County, VA	2002	NA	7875	7500	375	4.8
CN5119500000000	51	195	Wise County, VA	2002	NA	16917	15915	1002	5.9
CN5119700000000	51	197	Wythe County, VA	2002	NA	14333	13432	901	6.3
CN5119900000000	51	199	York County, VA	2002	NA	28920	28027	893	3.1
CN5151000000000	51	510	Alexandria city, VA	2002	NA	83146	80282	2864	3.4
CN5152000000000	51	520	Bristol city, VA	2002	NA	7573	7195	378	5
CN5153000000000	51	530	Buena Vista city, VA	2002	NA	3331	3179	152	4.6
CN5154000000000	51	540	Charlottesville city, VA	2002	NA	19644	18879	765	3.9
CN5155000000000	51	550	Chesapeake city, VA	2002	NA	103352	99526	3826	3.7
CN5157000000000	51	570	Colonial Heights city, VA	2002	NA	8770	8389	381	4.3
CN5158000000000	51	580	Covington city, VA	2002	NA	3066	2874	192	6.3
CN5159000000000	51	590	Danville city, VA	2002	NA	21686	19811	1875	8.6
CN5159500000000	51	595	Emporia city, VA	2002	NA	2399	2276	123	5.1
CN5160000000000	51	600	Fairfax city, VA	2002	NA	12338	12066	272	2.2
CN5161000000000	51	610	Falls Church city, VA	2002	NA	6203	5992	211	3.4
CN5162000000000	51	620	Franklin city, VA	2002	NA	3535	3364	171	4.8
CN5163000000000	51	630	Fredericksburg city, VA	2002	NA	10712	10127	585	5.5
CN5164000000000	51	640	Galax city, VA	2002	NA	3268	3005	263	8
CN5165000000000	51	650	Hampton city, VA	2002	NA	65854	62648	3206	4.9
CN5166000000000	51	660	Harrisonburg city, VA	2002	NA	20386	19632	754	3.7
CN5167000000000	51	670	Hopewell city, VA	2002	NA	10108	9481	627	6.2
CN5167800000000	51	678	Lexington city, VA	2002	NA	2362	2230	132	5.6
CN5168000000000	51	680	Lynchburg city, VA	2002	NA	30328	28540	1788	5.9
CN5168300000000	51	683	Manassas city, VA	2002	NA	19862	19002	860	4.3
CN5168500000000	51	685	Manassas Park city, VA	2002	NA	6015	5848	167	2.8
CN5169000000000	51	690	Martinsville city, VA	2002	NA	6508	5688	820	12.6
CN5170000000000	51	700	Newport News city, VA	2002	NA	85247	81335	3912	4.6
CN5171000000000	51	710	Norfolk city, VA	2002	NA	98076	93011	5065	5.2
CN5172000000000	51	720	Norton city, VA	2002	NA	1581	1503	78	4.9
CN5173000000000	51	730	Petersburg city, VA	2002	NA	14076	13021	1055	7.5
CN5173500000000	51	735	Poquoson city, VA	2002	NA	5978	5813	165	2.8
CN5174000000000	51	740	Portsmouth city, VA	2002	NA	43884	41552	2332	5.3
CN5175000000000	51	750	Radford city, VA	2002	NA	7358	6972	386	5.2
CN5176000000000	51	760	Richmond city, VA	2002	NA	96296	90760	5536	5.7
CN5177000000000	51	770	Roanoke city, VA	2002	NA	47115	44769	2346	5
CN5177500000000	51	775	Salem city, VA	2002	NA	13234	12724	510	3.9
CN5179000000000	51	790	Staunton city, VA	2002	NA	11750	11296	454	3.9
CN5180000000000	51	800	Suffolk city, VA	2002	NA	33002	31575	1427	4.3
CN5181000000000	51	810	Virginia Beach city, VA	2002	NA	213845	206207	7638	3.6
CN5182000000000	51	820	Waynesboro city, VA	2002	NA	9559	9104	455	4.8
CN5183000000000	51	830	Williamsburg city, VA	2002	NA	4636	4298	338	7.3
CN5184000000000	51	840	Winchester city, VA	2002	NA	13248	12722	526	4
CN5300100000000	53	001	Adams County, WA	2002	NA	8166	7418	748	9.2
CN5300300000000	53	003	Asotin County, WA	2002	NA	10172	9458	714	7
CN5300500000000	53	005	Benton County, WA	2002	NA	79974	74913	5061	6.3
CN5300700000000	53	007	Chelan County, WA	2002	NA	35643	32523	3120	8.8
CN5300900000000	53	009	Clallam County, WA	2002	NA	26463	24143	2320	8.8
CN5301100000000	53	011	Clark County, WA	2002	NA	185358	168119	17239	9.3
CN5301300000000	53	013	Columbia County, WA	2002	NA	1668	1496	172	10.3
CN5301500000000	53	015	Cowlitz County, WA	2002	NA	42346	37775	4571	10.8
CN5301700000000	53	017	Douglas County, WA	2002	NA	17691	16338	1353	7.6
CN5301900000000	53	019	Ferry County, WA	2002	NA	2948	2632	316	10.7
CN5302100000000	53	021	Franklin County, WA	2002	NA	24536	22408	2128	8.7
CN5302300000000	53	023	Garfield County, WA	2002	NA	1061	993	68	6.4
CN5302500000000	53	025	Grant County, WA	2002	NA	36076	32615	3461	9.6
CN5302700000000	53	027	Grays Harbor County, WA	2002	NA	28968	26201	2767	9.6
CN5302900000000	53	029	Island County, WA	2002	NA	30155	27909	2246	7.4
CN5303100000000	53	031	Jefferson County, WA	2002	NA	12356	11381	975	7.9
CN5303300000000	53	033	King County, WA	2002	NA	983366	922965	60401	6.1
CN5303500000000	53	035	Kitsap County, WA	2002	NA	110392	102875	7517	6.8
CN5303700000000	53	037	Kittitas County, WA	2002	NA	17902	16593	1309	7.3
CN5303900000000	53	039	Klickitat County, WA	2002	NA	9501	8407	1094	11.5
CN5304100000000	53	041	Lewis County, WA	2002	NA	29495	26731	2764	9.4
CN5304300000000	53	043	Lincoln County, WA	2002	NA	4594	4273	321	7
CN5304500000000	53	045	Mason County, WA	2002	NA	21634	19804	1830	8.5
CN5304700000000	53	047	Okanogan County, WA	2002	NA	18649	16749	1900	10.2
CN5304900000000	53	049	Pacific County, WA	2002	NA	8649	7843	806	9.3
CN5305100000000	53	051	Pend Oreille County, WA	2002	NA	4660	4203	457	9.8
CN5305300000000	53	053	Pierce County, WA	2002	NA	343525	315545	27980	8.1
CN5305500000000	53	055	San Juan County, WA	2002	NA	7559	7111	448	5.9
CN5305700000000	53	057	Skagit County, WA	2002	NA	52144	47785	4359	8.4
CN5305900000000	53	059	Skamania County, WA	2002	NA	4718	4243	475	10.1
CN5306100000000	53	061	Snohomish County, WA	2002	NA	332439	308928	23511	7.1
CN5306300000000	53	063	Spokane County, WA	2002	NA	210686	194342	16344	7.8
CN5306500000000	53	065	Stevens County, WA	2002	NA	17399	15635	1764	10.1
CN5306700000000	53	067	Thurston County, WA	2002	NA	111009	103746	7263	6.5
CN5306900000000	53	069	Wahkiakum County, WA	2002	NA	1547	1389	158	10.2
CN5307100000000	53	071	Walla Walla County, WA	2002	NA	28118	26152	1966	7
CN5307300000000	53	073	Whatcom County, WA	2002	NA	90836	84489	6347	7
CN5307500000000	53	075	Whitman County, WA	2002	NA	18992	18063	929	4.9
CN5307700000000	53	077	Yakima County, WA	2002	NA	111441	100568	10873	9.8
CN5400100000000	54	001	Barbour County, WV	2002	NA	6792	6298	494	7.3
CN5400300000000	54	003	Berkeley County, WV	2002	NA	40631	38721	1910	4.7
CN5400500000000	54	005	Boone County, WV	2002	NA	9796	9051	745	7.6
CN5400700000000	54	007	Braxton County, WV	2002	NA	5917	5467	450	7.6
CN5400900000000	54	009	Brooke County, WV	2002	NA	11494	10813	681	5.9
CN5401100000000	54	011	Cabell County, WV	2002	NA	44051	41730	2321	5.3
CN5401300000000	54	013	Calhoun County, WV	2002	NA	2909	2591	318	10.9
CN5401500000000	54	015	Clay County, WV	2002	NA	3674	3300	374	10.2
CN5401700000000	54	017	Doddridge County, WV	2002	NA	2917	2724	193	6.6
CN5401900000000	54	019	Fayette County, WV	2002	NA	18452	17102	1350	7.3
CN5402100000000	54	021	Gilmer County, WV	2002	NA	2950	2748	202	6.8
CN5402300000000	54	023	Grant County, WV	2002	NA	5390	5046	344	6.4
CN5402500000000	54	025	Greenbrier County, WV	2002	NA	15122	14114	1008	6.7
CN5402700000000	54	027	Hampshire County, WV	2002	NA	9110	8682	428	4.7
CN5402900000000	54	029	Hancock County, WV	2002	NA	15119	14316	803	5.3
CN5403100000000	54	031	Hardy County, WV	2002	NA	6974	6687	287	4.1
CN5403300000000	54	033	Harrison County, WV	2002	NA	30788	28971	1817	5.9
CN5403500000000	54	035	Jackson County, WV	2002	NA	12253	11463	790	6.4
CN5403700000000	54	037	Jefferson County, WV	2002	NA	23249	22338	911	3.9
CN5403900000000	54	039	Kanawha County, WV	2002	NA	94366	89369	4997	5.3
CN5404100000000	54	041	Lewis County, WV	2002	NA	7363	6874	489	6.6
CN5404300000000	54	043	Lincoln County, WV	2002	NA	8155	7482	673	8.3
CN5404500000000	54	045	Logan County, WV	2002	NA	13299	12305	994	7.5
CN5404700000000	54	047	McDowell County, WV	2002	NA	7018	6335	683	9.7
CN5404900000000	54	049	Marion County, WV	2002	NA	25596	24051	1545	6
CN5405100000000	54	051	Marshall County, WV	2002	NA	15397	14370	1027	6.7
CN5405300000000	54	053	Mason County, WV	2002	NA	10547	9661	886	8.4
CN5405500000000	54	055	Mercer County, WV	2002	NA	25512	24086	1426	5.6
CN5405700000000	54	057	Mineral County, WV	2002	NA	12928	12072	856	6.6
CN5405900000000	54	059	Mingo County, WV	2002	NA	8725	7972	753	8.6
CN5406100000000	54	061	Monongalia County, WV	2002	NA	41728	39901	1827	4.4
CN5406300000000	54	063	Monroe County, WV	2002	NA	5842	5550	292	5
CN5406500000000	54	065	Morgan County, WV	2002	NA	7116	6801	315	4.4
CN5406700000000	54	067	Nicholas County, WV	2002	NA	10741	9966	775	7.2
CN5406900000000	54	069	Ohio County, WV	2002	NA	21439	20333	1106	5.2
CN5407100000000	54	071	Pendleton County, WV	2002	NA	3791	3616	175	4.6
CN5407300000000	54	073	Pleasants County, WV	2002	NA	3337	3104	233	7
CN5407500000000	54	075	Pocahontas County, WV	2002	NA	3996	3720	276	6.9
CN5407700000000	54	077	Preston County, WV	2002	NA	13651	12804	847	6.2
CN5407900000000	54	079	Putnam County, WV	2002	NA	26113	24815	1298	5
CN5408100000000	54	081	Raleigh County, WV	2002	NA	32381	30493	1888	5.8
CN5408300000000	54	083	Randolph County, WV	2002	NA	12717	11871	846	6.7
CN5408500000000	54	085	Ritchie County, WV	2002	NA	4548	4223	325	7.1
CN5408700000000	54	087	Roane County, WV	2002	NA	5697	5186	511	9
CN5408900000000	54	089	Summers County, WV	2002	NA	4792	4444	348	7.3
CN5409100000000	54	091	Taylor County, WV	2002	NA	6942	6537	405	5.8
CN5409300000000	54	093	Tucker County, WV	2002	NA	3264	3008	256	7.8
CN5409500000000	54	095	Tyler County, WV	2002	NA	3790	3533	257	6.8
CN5409700000000	54	097	Upshur County, WV	2002	NA	10692	10010	682	6.4
CN5409900000000	54	099	Wayne County, WV	2002	NA	17532	16423	1109	6.3
CN5410100000000	54	101	Webster County, WV	2002	NA	3276	3056	220	6.7
CN5410300000000	54	103	Wetzel County, WV	2002	NA	6812	6261	551	8.1
CN5410500000000	54	105	Wirt County, WV	2002	NA	2543	2340	203	8
CN5410700000000	54	107	Wood County, WV	2002	NA	42016	39645	2371	5.6
CN5410900000000	54	109	Wyoming County, WV	2002	NA	8757	8174	583	6.7
CN5500100000000	55	001	Adams County, WI	2002	NA	9197	8659	538	5.8
CN5500300000000	55	003	Ashland County, WI	2002	NA	9265	8578	687	7.4
CN5500500000000	55	005	Barron County, WI	2002	NA	25464	24080	1384	5.4
CN5500700000000	55	007	Bayfield County, WI	2002	NA	8021	7509	512	6.4
CN5500900000000	55	009	Brown County, WI	2002	NA	133858	127065	6793	5.1
CN5501100000000	55	011	Buffalo County, WI	2002	NA	8227	7816	411	5
CN5501300000000	55	013	Burnett County, WI	2002	NA	8190	7708	482	5.9
CN5501500000000	55	015	Calumet County, WI	2002	NA	24840	23574	1266	5.1
CN5501700000000	55	017	Chippewa County, WI	2002	NA	30982	28971	2011	6.5
CN5501900000000	55	019	Clark County, WI	2002	NA	17897	16826	1071	6
CN5502100000000	55	021	Columbia County, WI	2002	NA	30848	29252	1596	5.2
CN5502300000000	55	023	Crawford County, WI	2002	NA	9296	8777	519	5.6
CN5502500000000	55	025	Dane County, WI	2002	NA	277232	267716	9516	3.4
CN5502700000000	55	027	Dodge County, WI	2002	NA	46599	43996	2603	5.6
CN5502900000000	55	029	Door County, WI	2002	NA	17217	16319	898	5.2
CN5503100000000	55	031	Douglas County, WI	2002	NA	22815	21448	1367	6
CN5503300000000	55	033	Dunn County, WI	2002	NA	23252	22141	1111	4.8
CN5503500000000	55	035	Eau Claire County, WI	2002	NA	54007	51533	2474	4.6
CN5503700000000	55	037	Florence County, WI	2002	NA	2739	2566	173	6.3
CN5503900000000	55	039	Fond du Lac County, WI	2002	NA	57002	54166	2836	5
CN5504100000000	55	041	Forest County, WI	2002	NA	4948	4597	351	7.1
CN5504300000000	55	043	Grant County, WI	2002	NA	28151	26785	1366	4.9
CN5504500000000	55	045	Green County, WI	2002	NA	20117	19105	1012	5
CN5504700000000	55	047	Green Lake County, WI	2002	NA	10903	10197	706	6.5
CN5504900000000	55	049	Iowa County, WI	2002	NA	14044	13461	583	4.2
CN5505100000000	55	051	Iron County, WI	2002	NA	3361	3054	307	9.1
CN5505300000000	55	053	Jackson County, WI	2002	NA	9887	9285	602	6.1
CN5505500000000	55	055	Jefferson County, WI	2002	NA	42605	40546	2059	4.8
CN5505700000000	55	057	Juneau County, WI	2002	NA	13057	12097	960	7.4
CN5505900000000	55	059	Kenosha County, WI	2002	NA	81472	76542	4930	6.1
CN5506100000000	55	061	Kewaunee County, WI	2002	NA	11814	11209	605	5.1
CN5506300000000	55	063	La Crosse County, WI	2002	NA	62409	59665	2744	4.4
CN5506500000000	55	065	Lafayette County, WI	2002	NA	9333	8850	483	5.2
CN5506700000000	55	067	Langlade County, WI	2002	NA	11267	10508	759	6.7
CN5506900000000	55	069	Lincoln County, WI	2002	NA	16242	15244	998	6.1
CN5507100000000	55	071	Manitowoc County, WI	2002	NA	46286	43453	2833	6.1
CN5507300000000	55	073	Marathon County, WI	2002	NA	73381	69869	3512	4.8
CN5507500000000	55	075	Marinette County, WI	2002	NA	22868	21320	1548	6.8
CN5507700000000	55	077	Marquette County, WI	2002	NA	7804	7227	577	7.4
CN5507800000000	55	078	Menominee County, WI	2002	NA	1725	1509	216	12.5
CN5507900000000	55	079	Milwaukee County, WI	2002	NA	468210	436967	31243	6.7
CN5508100000000	55	081	Monroe County, WI	2002	NA	22555	21439	1116	4.9
CN5508300000000	55	083	Oconto County, WI	2002	NA	19987	18729	1258	6.3
CN5508500000000	55	085	Oneida County, WI	2002	NA	20422	19070	1352	6.6
CN5508700000000	55	087	Outagamie County, WI	2002	NA	94587	89461	5126	5.4
CN5508900000000	55	089	Ozaukee County, WI	2002	NA	47522	45424	2098	4.4
CN5509100000000	55	091	Pepin County, WI	2002	NA	4010	3806	204	5.1
CN5509300000000	55	093	Pierce County, WI	2002	NA	22724	21757	967	4.3
CN5509500000000	55	095	Polk County, WI	2002	NA	23507	22044	1463	6.2
CN5509700000000	55	097	Portage County, WI	2002	NA	39640	37669	1971	5
CN5509900000000	55	099	Price County, WI	2002	NA	8445	8001	444	5.3
CN5510100000000	55	101	Racine County, WI	2002	NA	99437	92990	6447	6.5
CN5510300000000	55	103	Richland County, WI	2002	NA	9896	9439	457	4.6
CN5510500000000	55	105	Rock County, WI	2002	NA	82531	77440	5091	6.2
CN5510700000000	55	107	Rusk County, WI	2002	NA	7937	7405	532	6.7
CN5510900000000	55	109	St. Croix County, WI	2002	NA	40631	38359	2272	5.6
CN5511100000000	55	111	Sauk County, WI	2002	NA	34171	32627	1544	4.5
CN5511300000000	55	113	Sawyer County, WI	2002	NA	9200	8623	577	6.3
CN5511500000000	55	115	Shawano County, WI	2002	NA	22572	21348	1224	5.4
CN5511700000000	55	117	Sheboygan County, WI	2002	NA	64264	61141	3123	4.9
CN5511900000000	55	119	Taylor County, WI	2002	NA	11209	10610	599	5.3
CN5512100000000	55	121	Trempealeau County, WI	2002	NA	15816	14942	874	5.5
CN5512300000000	55	123	Vernon County, WI	2002	NA	14859	14062	797	5.4
CN5512500000000	55	125	Vilas County, WI	2002	NA	11736	11029	707	6
CN5512700000000	55	127	Walworth County, WI	2002	NA	55579	52860	2719	4.9
CN5512900000000	55	129	Washburn County, WI	2002	NA	8132	7571	561	6.9
CN5513100000000	55	131	Washington County, WI	2002	NA	70495	67068	3427	4.9
CN5513300000000	55	133	Waukesha County, WI	2002	NA	211632	201776	9856	4.7
CN5513500000000	55	135	Waupaca County, WI	2002	NA	28291	26772	1519	5.4
CN5513700000000	55	137	Waushara County, WI	2002	NA	12414	11636	778	6.3
CN5513900000000	55	139	Winnebago County, WI	2002	NA	92228	87665	4563	4.9
CN5514100000000	55	141	Wood County, WI	2002	NA	41067	38674	2393	5.8
CN5600100000000	56	001	Albany County, WY	2002	NA	18358	17754	604	3.3
CN5600300000000	56	003	Big Horn County, WY	2002	NA	5164	4892	272	5.3
CN5600500000000	56	005	Campbell County, WY	2002	NA	22090	21434	656	3
CN5600700000000	56	007	Carbon County, WY	2002	NA	7789	7439	350	4.5
CN5600900000000	56	009	Converse County, WY	2002	NA	6271	6010	261	4.2
CN5601100000000	56	011	Crook County, WY	2002	NA	3074	2963	111	3.6
CN5601300000000	56	013	Fremont County, WY	2002	NA	18147	17197	950	5.2
CN5601500000000	56	015	Goshen County, WY	2002	NA	5943	5694	249	4.2
CN5601700000000	56	017	Hot Springs County, WY	2002	NA	2525	2408	117	4.6
CN5601900000000	56	019	Johnson County, WY	2002	NA	3575	3436	139	3.9
CN5602100000000	56	021	Laramie County, WY	2002	NA	40826	39131	1695	4.2
CN5602300000000	56	023	Lincoln County, WY	2002	NA	7488	7147	341	4.6
CN5602500000000	56	025	Natrona County, WY	2002	NA	37441	35925	1516	4
CN5602700000000	56	027	Niobrara County, WY	2002	NA	1150	1098	52	4.5
CN5602900000000	56	029	Park County, WY	2002	NA	14284	13650	634	4.4
CN5603100000000	56	031	Platte County, WY	2002	NA	4122	3930	192	4.7
CN5603300000000	56	033	Sheridan County, WY	2002	NA	14897	14301	596	4
CN5603500000000	56	035	Sublette County, WY	2002	NA	3880	3769	111	2.9
CN5603700000000	56	037	Sweetwater County, WY	2002	NA	20176	19350	826	4.1
CN5603900000000	56	039	Teton County, WY	2002	NA	13791	13378	413	3
CN5604100000000	56	041	Uinta County, WY	2002	NA	11086	10617	469	4.2
CN5604300000000	56	043	Washakie County, WY	2002	NA	4158	3949	209	5
CN5604500000000	56	045	Weston County, WY	2002	NA	3311	3178	133	4
CN7200100000000	72	001	Adjuntas Municipio, PR	2002	NA	5226	4496	730	14
CN7200300000000	72	003	Aguada Municipio, PR	2002	NA	14574	12388	2186	15
CN7200500000000	72	005	Aguadilla Municipio, PR	2002	NA	20841	17647	3194	15.3
CN7200700000000	72	007	Aguas Buenas Municipio, PR	2002	NA	9164	7949	1215	13.3
CN7200900000000	72	009	Aibonito Municipio, PR	2002	NA	7834	6712	1122	14.3
CN7201100000000	72	011	Anasco Municipio, PR	2002	NA	10245	8588	1657	16.2
CN7201300000000	72	013	Arecibo Municipio, PR	2002	NA	33347	28829	4518	13.5
CN7201500000000	72	015	Arroyo Municipio, PR	2002	NA	5319	4410	909	17.1
CN7201700000000	72	017	Barceloneta Municipio, PR	2002	NA	7230	6092	1138	15.7
CN7201900000000	72	019	Barranquitas Municipio, PR	2002	NA	7505	6515	990	13.2
CN7202100000000	72	021	Bayamon Municipio, PR	2002	NA	83557	75836	7721	9.2
CN7202300000000	72	023	Cabo Rojo Municipio, PR	2002	NA	18111	16084	2027	11.2
CN7202500000000	72	025	Caguas Municipio, PR	2002	NA	53701	47596	6105	11.4
CN7202700000000	72	027	Camuy Municipio, PR	2002	NA	12751	10689	2062	16.2
CN7202900000000	72	029	Canovanas Municipio, PR	2002	NA	13873	11873	2000	14.4
CN7203100000000	72	031	Carolina Municipio, PR	2002	NA	77334	69980	7354	9.5
CN7203300000000	72	033	Catano Municipio, PR	2002	NA	8603	7592	1011	11.8
CN7203500000000	72	035	Cayey Municipio, PR	2002	NA	15810	13707	2103	13.3
CN7203700000000	72	037	Ceiba Municipio, PR	2002	NA	5782	4943	839	14.5
CN7203900000000	72	039	Ciales Municipio, PR	2002	NA	5187	4239	948	18.3
CN7204100000000	72	041	Cidra Municipio, PR	2002	NA	14483	12744	1739	12
CN7204300000000	72	043	Coamo Municipio, PR	2002	NA	11642	10053	1589	13.6
CN7204500000000	72	045	Comerio Municipio, PR	2002	NA	4994	4165	829	16.6
CN7204700000000	72	047	Corozal Municipio, PR	2002	NA	10113	8950	1163	11.5
CN7204900000000	72	049	Culebra Municipio, PR	2002	NA	854	798	56	6.6
CN7205100000000	72	051	Dorado Municipio, PR	2002	NA	12231	11047	1184	9.7
CN7205300000000	72	053	Fajardo Municipio, PR	2002	NA	14460	12191	2269	15.7
CN7205400000000	72	054	Florida Municipio, PR	2002	NA	3727	3127	600	16.1
CN7205500000000	72	055	Guanica Municipio, PR	2002	NA	6111	4981	1130	18.5
CN7205700000000	72	057	Guayama Municipio, PR	2002	NA	13714	11448	2266	16.5
CN7205900000000	72	059	Guayanilla Municipio, PR	2002	NA	6483	5379	1104	17
CN7206100000000	72	061	Guaynabo Municipio, PR	2002	NA	43753	40786	2967	6.8
CN7206300000000	72	063	Gurabo Municipio, PR	2002	NA	14108	12552	1556	11
CN7206500000000	72	065	Hatillo Municipio, PR	2002	NA	12315	10590	1725	14
CN7206700000000	72	067	Hormigueros Municipio, PR	2002	NA	6445	5701	744	11.5
CN7206900000000	72	069	Humacao Municipio, PR	2002	NA	20431	17442	2989	14.6
CN7207100000000	72	071	Isabela Municipio, PR	2002	NA	14683	12433	2250	15.3
CN7207300000000	72	073	Jayuya Municipio, PR	2002	NA	4635	4024	611	13.2
CN7207500000000	72	075	Juana Diaz Municipio, PR	2002	NA	15200	13060	2140	14.1
CN7207700000000	72	077	Juncos Municipio, PR	2002	NA	12266	10652	1614	13.2
CN7207900000000	72	079	Lajas Municipio, PR	2002	NA	8178	6996	1182	14.5
CN7208100000000	72	081	Lares Municipio, PR	2002	NA	10875	9221	1654	15.2
CN7208300000000	72	083	Las Marias Municipio, PR	2002	NA	3782	3215	567	15
CN7208500000000	72	085	Las Piedras Municipio, PR	2002	NA	11899	10228	1671	14
CN7208700000000	72	087	Loiza Municipio, PR	2002	NA	8644	7420	1224	14.2
CN7208900000000	72	089	Luquillo Municipio, PR	2002	NA	6926	5632	1294	18.7
CN7209100000000	72	091	Manati Municipio, PR	2002	NA	14244	12040	2204	15.5
CN7209300000000	72	093	Maricao Municipio, PR	2002	NA	2077	1776	301	14.5
CN7209500000000	72	095	Maunabo Municipio, PR	2002	NA	3687	2971	716	19.4
CN7209700000000	72	097	Mayaguez Municipio, PR	2002	NA	32089	27140	4949	15.4
CN7209900000000	72	099	Moca Municipio, PR	2002	NA	13906	11753	2153	15.5
CN7210100000000	72	101	Morovis Municipio, PR	2002	NA	8772	7440	1332	15.2
CN7210300000000	72	103	Naguabo Municipio, PR	2002	NA	7494	6240	1254	16.7
CN7210500000000	72	105	Naranjito Municipio, PR	2002	NA	8508	7531	977	11.5
CN7210700000000	72	107	Orocovis Municipio, PR	2002	NA	5391	4493	898	16.7
CN7210900000000	72	109	Patillas Municipio, PR	2002	NA	5683	4683	1000	17.6
CN7211100000000	72	111	Penuelas Municipio, PR	2002	NA	8115	6759	1356	16.7
CN7211300000000	72	113	Ponce Municipio, PR	2002	NA	59299	51749	7550	12.7
CN7211500000000	72	115	Quebradillas Municipio, PR	2002	NA	8808	7179	1629	18.5
CN7211700000000	72	117	Rincon Municipio, PR	2002	NA	5073	4319	754	14.9
CN7211900000000	72	119	Rio Grande Municipio, PR	2002	NA	17392	15117	2275	13.1
CN7212100000000	72	121	Sabana Grande Municipio, PR	2002	NA	8589	7322	1267	14.8
CN7212300000000	72	123	Salinas Municipio, PR	2002	NA	8924	7365	1559	17.5
CN7212500000000	72	125	San German Municipio, PR	2002	NA	12309	10501	1808	14.7
CN7212700000000	72	127	San Juan Municipio, PR	2002	NA	173005	158038	14967	8.7
CN7212900000000	72	129	San Lorenzo Municipio, PR	2002	NA	13636	11981	1655	12.1
CN7213100000000	72	131	San Sebastian Municipio, PR	2002	NA	14740	12137	2603	17.7
CN7213300000000	72	133	Santa Isabel Municipio, PR	2002	NA	8313	7188	1125	13.5
CN7213500000000	72	135	Toa Alta Municipio, PR	2002	NA	25633	23467	2166	8.5
CN7213700000000	72	137	Toa Baja Municipio, PR	2002	NA	35388	32132	3256	9.2
CN7213900000000	72	139	Trujillo Alto Municipio, PR	2002	NA	32320	29716	2604	8.1
CN7214100000000	72	141	Utuado Municipio, PR	2002	NA	9713	8152	1561	16.1
CN7214300000000	72	143	Vega Alta Municipio, PR	2002	NA	12075	10711	1364	11.3
CN7214500000000	72	145	Vega Baja Municipio, PR	2002	NA	20219	17614	2605	12.9
CN7214700000000	72	147	Vieques Municipio, PR	2002	NA	2625	2159	466	17.8
CN7214900000000	72	149	Villalba Municipio, PR	2002	NA	8100	6820	1280	15.8
CN7215100000000	72	151	Yabucoa Municipio, PR	2002	NA	11187	8961	2226	19.9
CN7215300000000	72	153	Yauco Municipio, PR	2002	NA	15116	13006	2110	14
NA	NA	NA	NA	NA	NA	NA	NA	NA	NA
SOURCE:  BLS, LAUS	NA	NA	NA	NA	NA	NA	NA	NA	NA
March 18, 2016	NA	NA	NA	NA	NA	NA	NA	NA	NA
