LAUS_CODE	STATE_FIPS	COUNTY_FIPS	COUNTY	YEAR	ESTIMATED	LABOR_FORCE	EMPLOYED	UNEMPLOYED_LEVEL	UNEMPLOYED_RATE
CN0100100000000	01	001	Autauga County, AL	1992	NA	17656	16500	1156	6.5
CN0100300000000	01	003	Baldwin County, AL	1992	NA	52209	48921	3288	6.3
CN0100500000000	01	005	Barbour County, AL	1992	NA	11613	10358	1255	10.8
CN0100700000000	01	007	Bibb County, AL	1992	NA	7990	7101	889	11.1
CN0100900000000	01	009	Blount County, AL	1992	NA	19553	18334	1219	6.2
CN0101100000000	01	011	Bullock County, AL	1992	NA	4303	3658	645	15
CN0101300000000	01	013	Butler County, AL	1992	NA	8921	7832	1089	12.2
CN0101500000000	01	015	Calhoun County, AL	1992	NA	53226	48479	4747	8.9
CN0101700000000	01	017	Chambers County, AL	1992	NA	17252	15875	1377	8
CN0101900000000	01	019	Cherokee County, AL	1992	NA	9569	8886	683	7.1
CN0102100000000	01	021	Chilton County, AL	1992	NA	15686	14102	1584	10.1
CN0102300000000	01	023	Choctaw County, AL	1992	NA	6992	6187	805	11.5
CN0102500000000	01	025	Clarke County, AL	1992	NA	12872	11193	1679	13
CN0102700000000	01	027	Clay County, AL	1992	NA	6468	6025	443	6.8
CN0102900000000	01	029	Cleburne County, AL	1992	NA	7099	6632	467	6.6
CN0103100000000	01	031	Coffee County, AL	1992	NA	19862	18664	1198	6
CN0103300000000	01	033	Colbert County, AL	1992	NA	25225	23001	2224	8.8
CN0103500000000	01	035	Conecuh County, AL	1992	NA	6097	5285	812	13.3
CN0103700000000	01	037	Coosa County, AL	1992	NA	5042	4745	297	5.9
CN0103900000000	01	039	Covington County, AL	1992	NA	16914	15098	1816	10.7
CN0104100000000	01	041	Crenshaw County, AL	1992	NA	6200	5650	550	8.9
CN0104300000000	01	043	Cullman County, AL	1992	NA	34510	32048	2462	7.1
CN0104500000000	01	045	Dale County, AL	1992	NA	20809	19357	1452	7
CN0104700000000	01	047	Dallas County, AL	1992	NA	20259	17465	2794	13.8
CN0104900000000	01	049	DeKalb County, AL	1992	NA	28276	26277	1999	7.1
CN0105100000000	01	051	Elmore County, AL	1992	NA	23837	22300	1537	6.4
CN0105300000000	01	053	Escambia County, AL	1992	NA	15799	13888	1911	12.1
CN0105500000000	01	055	Etowah County, AL	1992	NA	46582	42464	4118	8.8
CN0105700000000	01	057	Fayette County, AL	1992	NA	8645	7883	762	8.8
CN0105900000000	01	059	Franklin County, AL	1992	NA	14938	13724	1214	8.1
CN0106100000000	01	061	Geneva County, AL	1992	NA	11970	11372	598	5
CN0106300000000	01	063	Greene County, AL	1992	NA	3804	3285	519	13.6
CN0106500000000	01	065	Hale County, AL	1992	NA	6425	5762	663	10.3
CN0106700000000	01	067	Henry County, AL	1992	NA	6762	6231	531	7.9
CN0106900000000	01	069	Houston County, AL	1992	NA	41933	39596	2337	5.6
CN0107100000000	01	071	Jackson County, AL	1992	NA	24958	22261	2697	10.8
CN0107300000000	01	073	Jefferson County, AL	1992	NA	316293	297078	19215	6.1
CN0107500000000	01	075	Lamar County, AL	1992	NA	7767	7025	742	9.6
CN0107700000000	01	077	Lauderdale County, AL	1992	NA	39371	36606	2765	7
CN0107900000000	01	079	Lawrence County, AL	1992	NA	15236	13662	1574	10.3
CN0108100000000	01	081	Lee County, AL	1992	NA	43974	41500	2474	5.6
CN0108300000000	01	083	Limestone County, AL	1992	NA	27329	25399	1930	7.1
CN0108500000000	01	085	Lowndes County, AL	1992	NA	4455	3669	786	17.6
CN0108700000000	01	087	Macon County, AL	1992	NA	8889	8027	862	9.7
CN0108900000000	01	089	Madison County, AL	1992	NA	131327	124709	6618	5
CN0109100000000	01	091	Marengo County, AL	1992	NA	10724	9629	1095	10.2
CN0109300000000	01	093	Marion County, AL	1992	NA	14165	12884	1281	9
CN0109500000000	01	095	Marshall County, AL	1992	NA	35799	32722	3077	8.6
CN0109700000000	01	097	Mobile County, AL	1992	NA	182397	167362	15035	8.2
CN0109900000000	01	099	Monroe County, AL	1992	NA	10685	8659	2026	19
CN0110100000000	01	101	Montgomery County, AL	1992	NA	102742	96270	6472	6.3
CN0110300000000	01	103	Morgan County, AL	1992	NA	50944	47010	3934	7.7
CN0110500000000	01	105	Perry County, AL	1992	NA	4906	4231	675	13.8
CN0110700000000	01	107	Pickens County, AL	1992	NA	9052	8061	991	10.9
CN0110900000000	01	109	Pike County, AL	1992	NA	12427	11474	953	7.7
CN0111100000000	01	111	Randolph County, AL	1992	NA	9659	8915	744	7.7
CN0111300000000	01	113	Russell County, AL	1992	NA	21785	20035	1750	8
CN0111500000000	01	115	St. Clair County, AL	1992	NA	25075	23353	1722	6.9
CN0111700000000	01	117	Shelby County, AL	1992	NA	57415	55039	2376	4.1
CN0111900000000	01	119	Sumter County, AL	1992	NA	6125	5346	779	12.7
CN0112100000000	01	121	Talladega County, AL	1992	NA	34786	31305	3481	10
CN0112300000000	01	123	Tallapoosa County, AL	1992	NA	19431	18433	998	5.1
CN0112500000000	01	125	Tuscaloosa County, AL	1992	NA	70606	66411	4195	5.9
CN0112700000000	01	127	Walker County, AL	1992	NA	30465	26697	3768	12.4
CN0112900000000	01	129	Washington County, AL	1992	NA	6430	5336	1094	17
CN0113100000000	01	131	Wilcox County, AL	1992	NA	4079	3346	733	18
CN0113300000000	01	133	Winston County, AL	1992	NA	10927	9895	1032	9.4
CN0201300000000	02	013	Aleutians East Borough, AK	1992	NA	1590	1567	23	1.4
CN0201600000000	02	016	Aleutians West Census Area, AK	1992	NA	3900	3858	42	1.1
CN0202000000000	02	020	Anchorage Borough/municipality, AK	1992	NA	127755	118683	9072	7.1
CN0205000000000	02	050	Bethel Census Area, AK	1992	NA	5154	4705	449	8.7
CN0206000000000	02	060	Bristol Bay Borough, AK	1992	NA	616	581	35	5.7
CN0206800000000	02	068	Denali Borough, AK	1992	NA	1048	947	101	9.6
CN0207000000000	02	070	Dillingham Census Area, AK	1992	NA	1571	1443	128	8.1
CN0209000000000	02	090	Fairbanks North Star Borough, AK	1992	NA	38900	35210	3690	9.5
CN0210000000000	02	100	Haines Borough, AK	1992	NA	1117	983	134	12
CN0211000000000	02	110	Juneau Borough/city, AK	1992	NA	16101	14996	1105	6.9
CN0212200000000	02	122	Kenai Peninsula Borough, AK	1992	NA	20178	17166	3012	14.9
CN0213000000000	02	130	Ketchikan Gateway Borough, AK	1992	NA	7654	6947	707	9.2
CN0215000000000	02	150	Kodiak Island Borough, AK	1992	NA	6917	6203	714	10.3
CN0215800000000	02	158	Kusilvak Census Area, AK	1992	NA	1712	1528	184	10.7
CN0216400000000	02	164	Lake and Peninsula Borough, AK	1992	NA	568	518	50	8.8
CN0217000000000	02	170	Matanuska-Susitna Borough, AK	1992	NA	21128	18365	2763	13.1
CN0218000000000	02	180	Nome Census Area, AK	1992	NA	3157	2763	394	12.5
CN0218500000000	02	185	North Slope Borough, AK	1992	NA	2850	2729	121	4.2
CN0218800000000	02	188	Northwest Arctic Borough, AK	1992	NA	2175	1733	442	20.3
CN0220100000000	02	201	Prince of Wales-Outer Ketchikan Census Area, AK	1992	NA	2984	2617	367	12.3
CN0222000000000	02	220	Sitka Borough/city, AK	1992	NA	4627	4356	271	5.9
CN0223200000000	02	232	Skagway-Hoonah-Angoon Census Area, AK	1992	NA	2502	2238	264	10.6
CN0224000000000	02	240	Southeast Fairbanks Census Area, AK	1992	NA	2222	1936	286	12.9
CN0226100000000	02	261	Valdez-Cordova Census Area, AK	1992	NA	5086	4568	518	10.2
CN0228000000000	02	280	Wrangell-Petersburg Census Area, AK	1992	NA	3637	3283	354	9.7
CN0229000000000	02	290	Yukon-Koyukuk Census Area, AK	1992	NA	2071	1703	368	17.8
CN0400100000000	04	001	Apache County, AZ	1992	NA	18713	15684	3029	16.2
CN0400300000000	04	003	Cochise County, AZ	1992	NA	39068	35363	3705	9.5
CN0400500000000	04	005	Coconino County, AZ	1992	NA	52622	47735	4887	9.3
CN0400700000000	04	007	Gila County, AZ	1992	NA	16881	15014	1867	11.1
CN0400900000000	04	009	Graham County, AZ	1992	NA	9842	8847	995	10.1
CN0401100000000	04	011	Greenlee County, AZ	1992	NA	3932	3536	396	10.1
CN0401200000000	04	012	La Paz County, AZ	1992	NA	5456	4697	759	13.9
CN0401300000000	04	013	Maricopa County, AZ	1992	NA	1146457	1072627	73830	6.4
CN0401500000000	04	015	Mohave County, AZ	1992	NA	48572	43988	4584	9.4
CN0401700000000	04	017	Navajo County, AZ	1992	NA	28203	23895	4308	15.3
CN0401900000000	04	019	Pima County, AZ	1992	NA	337137	318843	18294	5.4
CN0402100000000	04	021	Pinal County, AZ	1992	NA	46757	42690	4067	8.7
CN0402300000000	04	023	Santa Cruz County, AZ	1992	NA	13645	11271	2374	17.4
CN0402500000000	04	025	Yavapai County, AZ	1992	NA	51585	47910	3675	7.1
CN0402700000000	04	027	Yuma County, AZ	1992	NA	54736	40228	14508	26.5
CN0500100000000	05	001	Arkansas County, AR	1992	NA	10337	9641	696	6.7
CN0500300000000	05	003	Ashley County, AR	1992	NA	11132	10306	826	7.4
CN0500500000000	05	005	Baxter County, AR	1992	NA	12481	11834	647	5.2
CN0500700000000	05	007	Benton County, AR	1992	NA	52118	50393	1725	3.3
CN0500900000000	05	009	Boone County, AR	1992	NA	14041	13278	763	5.4
CN0501100000000	05	011	Bradley County, AR	1992	NA	5016	4502	514	10.2
CN0501300000000	05	013	Calhoun County, AR	1992	NA	2414	2168	246	10.2
CN0501500000000	05	015	Carroll County, AR	1992	NA	11065	10433	632	5.7
CN0501700000000	05	017	Chicot County, AR	1992	NA	6319	5629	690	10.9
CN0501900000000	05	019	Clark County, AR	1992	NA	10404	9913	491	4.7
CN0502100000000	05	021	Clay County, AR	1992	NA	8151	7475	676	8.3
CN0502300000000	05	023	Cleburne County, AR	1992	NA	8794	7872	922	10.5
CN0502500000000	05	025	Cleveland County, AR	1992	NA	3885	3616	269	6.9
CN0502700000000	05	027	Columbia County, AR	1992	NA	11818	10933	885	7.5
CN0502900000000	05	029	Conway County, AR	1992	NA	9516	8712	804	8.4
CN0503100000000	05	031	Craighead County, AR	1992	NA	37903	35541	2362	6.2
CN0503300000000	05	033	Crawford County, AR	1992	NA	21514	19734	1780	8.3
CN0503500000000	05	035	Crittenden County, AR	1992	NA	21819	20125	1694	7.8
CN0503700000000	05	037	Cross County, AR	1992	NA	8829	8042	787	8.9
CN0503900000000	05	039	Dallas County, AR	1992	NA	3969	3647	322	8.1
CN0504100000000	05	041	Desha County, AR	1992	NA	7000	6212	788	11.3
CN0504300000000	05	043	Drew County, AR	1992	NA	9028	8322	706	7.8
CN0504500000000	05	045	Faulkner County, AR	1992	NA	34197	31626	2571	7.5
CN0504700000000	05	047	Franklin County, AR	1992	NA	7326	6833	493	6.7
CN0504900000000	05	049	Fulton County, AR	1992	NA	4257	4018	239	5.6
CN0505100000000	05	051	Garland County, AR	1992	NA	33498	30677	2821	8.4
CN0505300000000	05	053	Grant County, AR	1992	NA	7118	6606	512	7.2
CN0505500000000	05	055	Greene County, AR	1992	NA	15907	14827	1080	6.8
CN0505700000000	05	057	Hempstead County, AR	1992	NA	10610	9849	761	7.2
CN0505900000000	05	059	Hot Spring County, AR	1992	NA	11586	10443	1143	9.9
CN0506100000000	05	061	Howard County, AR	1992	NA	6571	6140	431	6.6
CN0506300000000	05	063	Independence County, AR	1992	NA	16098	15017	1081	6.7
CN0506500000000	05	065	Izard County, AR	1992	NA	4227	3842	385	9.1
CN0506700000000	05	067	Jackson County, AR	1992	NA	8341	7292	1049	12.6
CN0506900000000	05	069	Jefferson County, AR	1992	NA	38036	33807	4229	11.1
CN0507100000000	05	071	Johnson County, AR	1992	NA	8476	7951	525	6.2
CN0507300000000	05	073	Lafayette County, AR	1992	NA	3581	3266	315	8.8
CN0507500000000	05	075	Lawrence County, AR	1992	NA	7661	7010	651	8.5
CN0507700000000	05	077	Lee County, AR	1992	NA	4720	4110	610	12.9
CN0507900000000	05	079	Lincoln County, AR	1992	NA	5052	4556	496	9.8
CN0508100000000	05	081	Little River County, AR	1992	NA	5650	5104	546	9.7
CN0508300000000	05	083	Logan County, AR	1992	NA	9753	9087	666	6.8
CN0508500000000	05	085	Lonoke County, AR	1992	NA	20312	19212	1100	5.4
CN0508700000000	05	087	Madison County, AR	1992	NA	6810	6497	313	4.6
CN0508900000000	05	089	Marion County, AR	1992	NA	5091	4829	262	5.1
CN0509100000000	05	091	Miller County, AR	1992	NA	17067	15768	1299	7.6
CN0509300000000	05	093	Mississippi County, AR	1992	NA	26805	23986	2819	10.5
CN0509500000000	05	095	Monroe County, AR	1992	NA	4413	3902	511	11.6
CN0509700000000	05	097	Montgomery County, AR	1992	NA	3639	3464	175	4.8
CN0509900000000	05	099	Nevada County, AR	1992	NA	4568	4260	308	6.7
CN0510100000000	05	101	Newton County, AR	1992	NA	2853	2677	176	6.2
CN0510300000000	05	103	Ouachita County, AR	1992	NA	13082	11577	1505	11.5
CN0510500000000	05	105	Perry County, AR	1992	NA	3657	3278	379	10.4
CN0510700000000	05	107	Phillips County, AR	1992	NA	10878	9692	1186	10.9
CN0510900000000	05	109	Pike County, AR	1992	NA	4561	4193	368	8.1
CN0511100000000	05	111	Poinsett County, AR	1992	NA	10874	10022	852	7.8
CN0511300000000	05	113	Polk County, AR	1992	NA	7715	7244	471	6.1
CN0511500000000	05	115	Pope County, AR	1992	NA	25085	23589	1496	6
CN0511700000000	05	117	Prairie County, AR	1992	NA	3977	3443	534	13.4
CN0511900000000	05	119	Pulaski County, AR	1992	NA	189270	178500	10770	5.7
CN0512100000000	05	121	Randolph County, AR	1992	NA	7272	6512	760	10.5
CN0512300000000	05	123	St. Francis County, AR	1992	NA	11671	10289	1382	11.8
CN0512500000000	05	125	Saline County, AR	1992	NA	35245	33149	2096	5.9
CN0512700000000	05	127	Scott County, AR	1992	NA	4865	4667	198	4.1
CN0512900000000	05	129	Searcy County, AR	1992	NA	3019	2778	241	8
CN0513100000000	05	131	Sebastian County, AR	1992	NA	53052	49245	3807	7.2
CN0513300000000	05	133	Sevier County, AR	1992	NA	6970	6550	420	6
CN0513500000000	05	135	Sharp County, AR	1992	NA	5441	5016	425	7.8
CN0513700000000	05	137	Stone County, AR	1992	NA	4585	4277	308	6.7
CN0513900000000	05	139	Union County, AR	1992	NA	21034	19492	1542	7.3
CN0514100000000	05	141	Van Buren County, AR	1992	NA	5818	5246	572	9.8
CN0514300000000	05	143	Washington County, AR	1992	NA	64071	61685	2386	3.7
CN0514500000000	05	145	White County, AR	1992	NA	27624	25128	2496	9
CN0514700000000	05	147	Woodruff County, AR	1992	NA	4010	3435	575	14.3
CN0514900000000	05	149	Yell County, AR	1992	NA	8984	8519	465	5.2
CN0600100000000	06	001	Alameda County, CA	1992	NA	677362	633098	44264	6.5
CN0600300000000	06	003	Alpine County, CA	1992	NA	347	290	57	16.4
CN0600500000000	06	005	Amador County, CA	1992	NA	12715	11552	1163	9.1
CN0600700000000	06	007	Butte County, CA	1992	NA	81986	72333	9653	11.8
CN0600900000000	06	009	Calaveras County, CA	1992	NA	15028	13233	1795	11.9
CN0601100000000	06	011	Colusa County, CA	1992	NA	8222	6454	1768	21.5
CN0601300000000	06	013	Contra Costa County, CA	1992	NA	442248	413319	28929	6.5
CN0601500000000	06	015	Del Norte County, CA	1992	NA	9844	8329	1515	15.4
CN0601700000000	06	017	El Dorado County, CA	1992	NA	67263	61568	5695	8.5
CN0601900000000	06	019	Fresno County, CA	1992	NA	352625	298060	54565	15.5
CN0602100000000	06	021	Glenn County, CA	1992	NA	11395	9245	2150	18.9
CN0602300000000	06	023	Humboldt County, CA	1992	NA	58927	53065	5862	9.9
CN0602500000000	06	025	Imperial County, CA	1992	NA	53870	37337	16533	30.7
CN0602700000000	06	027	Inyo County, CA	1992	NA	7166	6345	821	11.5
CN0602900000000	06	029	Kern County, CA	1992	NA	272911	230201	42710	15.6
CN0603100000000	06	031	Kings County, CA	1992	NA	40595	34444	6151	15.2
CN0603300000000	06	033	Lake County, CA	1992	NA	22342	19483	2859	12.8
CN0603500000000	06	035	Lassen County, CA	1992	NA	10771	9545	1226	11.4
CN0603700000000	06	037	Los Angeles County, CA	1992	NA	4441197	4002563	438634	9.9
CN0603900000000	06	039	Madera County, CA	1992	NA	46867	39072	7795	16.6
CN0604100000000	06	041	Marin County, CA	1992	NA	130537	123977	6560	5
CN0604300000000	06	043	Mariposa County, CA	1992	NA	7163	6539	624	8.7
CN0604500000000	06	045	Mendocino County, CA	1992	NA	39784	34920	4864	12.2
CN0604700000000	06	047	Merced County, CA	1992	NA	82987	68637	14350	17.3
CN0604900000000	06	049	Modoc County, CA	1992	NA	4011	3500	511	12.7
CN0605100000000	06	051	Mono County, CA	1992	NA	5819	5206	613	10.5
CN0605300000000	06	053	Monterey County, CA	1992	NA	177112	155240	21872	12.3
CN0605500000000	06	055	Napa County, CA	1992	NA	57546	53426	4120	7.2
CN0605700000000	06	057	Nevada County, CA	1992	NA	39597	36263	3334	8.4
CN0605900000000	06	059	Orange County, CA	1992	NA	1331315	1242865	88450	6.6
CN0606100000000	06	061	Placer County, CA	1992	NA	93474	85610	7864	8.4
CN0606300000000	06	063	Plumas County, CA	1992	NA	9677	8331	1346	13.9
CN0606500000000	06	065	Riverside County, CA	1992	NA	576178	508164	68014	11.8
CN0606700000000	06	067	Sacramento County, CA	1992	NA	529085	485492	43593	8.2
CN0606900000000	06	069	San Benito County, CA	1992	NA	21899	18119	3780	17.3
CN0607100000000	06	071	San Bernardino County, CA	1992	NA	668755	604814	63941	9.6
CN0607300000000	06	073	San Diego County, CA	1992	NA	1213964	1126344	87620	7.2
CN0607500000000	06	075	San Francisco County/city, CA	1992	NA	404975	377432	27543	6.8
CN0607700000000	06	077	San Joaquin County, CA	1992	NA	239435	205764	33671	14.1
CN0607900000000	06	079	San Luis Obispo County, CA	1992	NA	99632	92215	7417	7.4
CN0608100000000	06	081	San Mateo County, CA	1992	NA	368319	349639	18680	5.1
CN0608300000000	06	083	Santa Barbara County, CA	1992	NA	193117	178836	14281	7.4
CN0608500000000	06	085	Santa Clara County, CA	1992	NA	847030	789295	57735	6.8
CN0608700000000	06	087	Santa Cruz County, CA	1992	NA	139029	125610	13419	9.7
CN0608900000000	06	089	Shasta County, CA	1992	NA	72896	63400	9496	13
CN0609100000000	06	091	Sierra County, CA	1992	NA	1710	1520	190	11.1
CN0609300000000	06	093	Siskiyou County, CA	1992	NA	19400	16368	3032	15.6
CN0609500000000	06	095	Solano County, CA	1992	NA	173207	160491	12716	7.3
CN0609700000000	06	097	Sonoma County, CA	1992	NA	217280	202024	15256	7
CN0609900000000	06	099	Stanislaus County, CA	1992	NA	191747	160303	31444	16.4
CN0610100000000	06	101	Sutter County, CA	1992	NA	34109	27441	6668	19.5
CN0610300000000	06	103	Tehama County, CA	1992	NA	23026	20081	2945	12.8
CN0610500000000	06	105	Trinity County, CA	1992	NA	5266	4384	882	16.7
CN0610700000000	06	107	Tulare County, CA	1992	NA	154121	127292	26829	17.4
CN0610900000000	06	109	Tuolumne County, CA	1992	NA	20757	18426	2331	11.2
CN0611100000000	06	111	Ventura County, CA	1992	NA	373120	339796	33324	8.9
CN0611300000000	06	113	Yolo County, CA	1992	NA	81882	75147	6735	8.2
CN0611500000000	06	115	Yuba County, CA	1992	NA	22358	18496	3862	17.3
CN0800100000000	08	001	Adams County, CO	1992	NA	145671	137195	8476	5.8
CN0800300000000	08	003	Alamosa County, CO	1992	NA	6960	6394	566	8.1
CN0800500000000	08	005	Arapahoe County, CO	1992	NA	237574	226500	11074	4.7
CN0800700000000	08	007	Archuleta County, CO	1992	NA	2816	2583	233	8.3
CN0800900000000	08	009	Baca County, CO	1992	NA	2049	1979	70	3.4
CN0801100000000	08	011	Bent County, CO	1992	NA	2064	1945	119	5.8
CN0801300000000	08	013	Boulder County, CO	1992	NA	132545	125927	6618	5
CN0801400000000	08	014	Broomfield County/city, CO	1992	NA	15021	14454	567	3.8
CN0801500000000	08	015	Chaffee County, CO	1992	NA	6143	5720	423	6.9
CN0801700000000	08	017	Cheyenne County, CO	1992	NA	1241	1196	45	3.6
CN0801900000000	08	019	Clear Creek County, CO	1992	NA	4624	4377	247	5.3
CN0802100000000	08	021	Conejos County, CO	1992	NA	3129	2743	386	12.3
CN0802300000000	08	023	Costilla County, CO	1992	NA	1602	1439	163	10.2
CN0802500000000	08	025	Crowley County, CO	1992	NA	1157	1086	71	6.1
CN0802700000000	08	027	Custer County, CO	1992	NA	1141	1065	76	6.7
CN0802900000000	08	029	Delta County, CO	1992	NA	8741	7948	793	9.1
CN0803100000000	08	031	Denver County/city, CO	1992	NA	258573	241441	17132	6.6
CN0803300000000	08	033	Dolores County, CO	1992	NA	723	605	118	16.3
CN0803500000000	08	035	Douglas County, CO	1992	NA	41535	39944	1591	3.8
CN0803700000000	08	037	Eagle County, CO	1992	NA	14070	13131	939	6.7
CN0803900000000	08	039	Elbert County, CO	1992	NA	6239	5891	348	5.6
CN0804100000000	08	041	El Paso County, CO	1992	NA	199311	185087	14224	7.1
CN0804300000000	08	043	Fremont County, CO	1992	NA	14288	13040	1248	8.7
CN0804500000000	08	045	Garfield County, CO	1992	NA	17149	15627	1522	8.9
CN0804700000000	08	047	Gilpin County, CO	1992	NA	2815	2676	139	4.9
CN0804900000000	08	049	Grand County, CO	1992	NA	4676	4398	278	5.9
CN0805100000000	08	051	Gunnison County, CO	1992	NA	6402	5895	507	7.9
CN0805300000000	08	053	Hinsdale County, CO	1992	NA	466	435	31	6.7
CN0805500000000	08	055	Huerfano County, CO	1992	NA	2626	2367	259	9.9
CN0805700000000	08	057	Jackson County, CO	1992	NA	966	904	62	6.4
CN0805900000000	08	059	Jefferson County, CO	1992	NA	261372	249252	12120	4.6
CN0806100000000	08	061	Kiowa County, CO	1992	NA	815	778	37	4.5
CN0806300000000	08	063	Kit Carson County, CO	1992	NA	3259	3114	145	4.4
CN0806500000000	08	065	Lake County, CO	1992	NA	2962	2658	304	10.3
CN0806700000000	08	067	La Plata County, CO	1992	NA	19230	17919	1311	6.8
CN0806900000000	08	069	Larimer County, CO	1992	NA	109692	104070	5622	5.1
CN0807100000000	08	071	Las Animas County, CO	1992	NA	5522	4939	583	10.6
CN0807300000000	08	073	Lincoln County, CO	1992	NA	2519	2414	105	4.2
CN0807500000000	08	075	Logan County, CO	1992	NA	8405	7948	457	5.4
CN0807700000000	08	077	Mesa County, CO	1992	NA	48028	44268	3760	7.8
CN0807900000000	08	079	Mineral County, CO	1992	NA	355	330	25	7
CN0808100000000	08	081	Moffat County, CO	1992	NA	6180	5657	523	8.5
CN0808300000000	08	083	Montezuma County, CO	1992	NA	9938	8964	974	9.8
CN0808500000000	08	085	Montrose County, CO	1992	NA	12462	11463	999	8
CN0808700000000	08	087	Morgan County, CO	1992	NA	11261	10684	577	5.1
CN0808900000000	08	089	Otero County, CO	1992	NA	8355	7734	621	7.4
CN0809100000000	08	091	Ouray County, CO	1992	NA	1314	1213	101	7.7
CN0809300000000	08	093	Park County, CO	1992	NA	4939	4603	336	6.8
CN0809500000000	08	095	Phillips County, CO	1992	NA	1728	1667	61	3.5
CN0809700000000	08	097	Pitkin County, CO	1992	NA	7921	7230	691	8.7
CN0809900000000	08	099	Prowers County, CO	1992	NA	5939	5568	371	6.2
CN0810100000000	08	101	Pueblo County, CO	1992	NA	53061	48116	4945	9.3
CN0810300000000	08	103	Rio Blanco County, CO	1992	NA	3507	3288	219	6.2
CN0810500000000	08	105	Rio Grande County, CO	1992	NA	5059	4441	618	12.2
CN0810700000000	08	107	Routt County, CO	1992	NA	8871	8259	612	6.9
CN0810900000000	08	109	Saguache County, CO	1992	NA	2359	2037	322	13.6
CN0811100000000	08	111	San Juan County, CO	1992	NA	366	238	128	35
CN0811300000000	08	113	San Miguel County, CO	1992	NA	3179	2954	225	7.1
CN0811500000000	08	115	Sedgwick County, CO	1992	NA	1197	1149	48	4
CN0811700000000	08	117	Summit County, CO	1992	NA	9053	8544	509	5.6
CN0811900000000	08	119	Teller County, CO	1992	NA	8806	8183	623	7.1
CN0812100000000	08	121	Washington County, CO	1992	NA	2162	2081	81	3.7
CN0812300000000	08	123	Weld County, CO	1992	NA	69238	65221	4017	5.8
CN0812500000000	08	125	Yuma County, CO	1992	NA	3885	3742	143	3.7
CN0900100000000	09	001	Fairfield County, CT	1992	NA	464254	432653	31601	6.8
CN0900300000000	09	003	Hartford County, CT	1992	NA	466018	428530	37488	8
CN0900500000000	09	005	Litchfield County, CT	1992	NA	106372	98626	7746	7.3
CN0900700000000	09	007	Middlesex County, CT	1992	NA	84110	78527	5583	6.6
CN0900900000000	09	009	New Haven County, CT	1992	NA	442805	406889	35916	8.1
CN0901100000000	09	011	New London County, CT	1992	NA	132576	123074	9502	7.2
CN0901300000000	09	013	Tolland County, CT	1992	NA	74557	69633	4924	6.6
CN0901500000000	09	015	Windham County, CT	1992	NA	57016	51753	5263	9.2
CN1000100000000	10	001	Kent County, DE	1992	NA	64691	60978	3713	5.7
CN1000300000000	10	003	New Castle County, DE	1992	NA	237745	224483	13262	5.6
CN1000500000000	10	005	Sussex County, DE	1992	NA	64727	61793	2934	4.5
CN1100100000000	11	001	District of Columbia	1992	NA	317226	289953	27273	8.6
CN1200100000000	12	001	Alachua County, FL	1992	NA	96854	92189	4665	4.8
CN1200300000000	12	003	Baker County, FL	1992	NA	8851	7882	969	10.9
CN1200500000000	12	005	Bay County, FL	1992	NA	63884	57890	5994	9.4
CN1200700000000	12	007	Bradford County, FL	1992	NA	9775	9118	657	6.7
CN1200900000000	12	009	Brevard County, FL	1992	NA	212127	195009	17118	8.1
CN1201100000000	12	011	Broward County, FL	1992	NA	696196	635594	60602	8.7
CN1201300000000	12	013	Calhoun County, FL	1992	NA	4664	4259	405	8.7
CN1201500000000	12	015	Charlotte County, FL	1992	NA	44736	41364	3372	7.5
CN1201700000000	12	017	Citrus County, FL	1992	NA	33972	30658	3314	9.8
CN1201900000000	12	019	Clay County, FL	1992	NA	56869	53641	3228	5.7
CN1202100000000	12	021	Collier County, FL	1992	NA	77383	69876	7507	9.7
CN1202300000000	12	023	Columbia County, FL	1992	NA	21266	19075	2191	10.3
CN1202700000000	12	027	DeSoto County, FL	1992	NA	10162	9126	1036	10.2
CN1202900000000	12	029	Dixie County, FL	1992	NA	3853	3456	397	10.3
CN1203100000000	12	031	Duval County, FL	1992	NA	360777	335439	25338	7
CN1203300000000	12	033	Escambia County, FL	1992	NA	123747	116654	7093	5.7
CN1203500000000	12	035	Flagler County, FL	1992	NA	13058	12050	1008	7.7
CN1203700000000	12	037	Franklin County, FL	1992	NA	4423	4145	278	6.3
CN1203900000000	12	039	Gadsden County, FL	1992	NA	18796	17433	1363	7.3
CN1204100000000	12	041	Gilchrist County, FL	1992	NA	4112	3822	290	7.1
CN1204300000000	12	043	Glades County, FL	1992	NA	3467	3057	410	11.8
CN1204500000000	12	045	Gulf County, FL	1992	NA	5543	5072	471	8.5
CN1204700000000	12	047	Hamilton County, FL	1992	NA	4148	3604	544	13.1
CN1204900000000	12	049	Hardee County, FL	1992	NA	9809	8327	1482	15.1
CN1205100000000	12	051	Hendry County, FL	1992	NA	15534	13016	2518	16.2
CN1205300000000	12	053	Hernando County, FL	1992	NA	38813	35156	3657	9.4
CN1205500000000	12	055	Highlands County, FL	1992	NA	27273	24385	2888	10.6
CN1205700000000	12	057	Hillsborough County, FL	1992	NA	468484	434253	34231	7.3
CN1205900000000	12	059	Holmes County, FL	1992	NA	6464	5931	533	8.2
CN1206100000000	12	061	Indian River County, FL	1992	NA	40347	34904	5443	13.5
CN1206300000000	12	063	Jackson County, FL	1992	NA	19949	18538	1411	7.1
CN1206500000000	12	065	Jefferson County, FL	1992	NA	5712	5389	323	5.7
CN1206700000000	12	067	Lafayette County, FL	1992	NA	2322	2180	142	6.1
CN1206900000000	12	069	Lake County, FL	1992	NA	69338	63202	6136	8.8
CN1207100000000	12	071	Lee County, FL	1992	NA	162840	150465	12375	7.6
CN1207300000000	12	073	Leon County, FL	1992	NA	118350	113672	4678	4
CN1207500000000	12	075	Levy County, FL	1992	NA	11067	10201	866	7.8
CN1207700000000	12	077	Liberty County, FL	1992	NA	2373	2260	113	4.8
CN1207900000000	12	079	Madison County, FL	1992	NA	6897	6350	547	7.9
CN1208100000000	12	081	Manatee County, FL	1992	NA	103517	97122	6395	6.2
CN1208300000000	12	083	Marion County, FL	1992	NA	87751	80063	7688	8.8
CN1208500000000	12	085	Martin County, FL	1992	NA	45471	40387	5084	11.2
CN1208600000000	12	086	Miami-Dade County, FL	1992	NA	981643	891791	89852	9.2
CN1208700000000	12	087	Monroe County, FL	1992	NA	41644	39666	1978	4.7
CN1208900000000	12	089	Nassau County, FL	1992	NA	23871	22078	1793	7.5
CN1209100000000	12	091	Okaloosa County, FL	1992	NA	69408	65040	4368	6.3
CN1209300000000	12	093	Okeechobee County, FL	1992	NA	14774	13040	1734	11.7
CN1209500000000	12	095	Orange County, FL	1992	NA	408186	377161	31025	7.6
CN1209700000000	12	097	Osceola County, FL	1992	NA	64431	59283	5148	8
CN1209900000000	12	099	Palm Beach County, FL	1992	NA	449398	401802	47596	10.6
CN1210100000000	12	101	Pasco County, FL	1992	NA	112108	102367	9741	8.7
CN1210300000000	12	103	Pinellas County, FL	1992	NA	426341	397552	28789	6.8
CN1210500000000	12	105	Polk County, FL	1992	NA	199736	177485	22251	11.1
CN1210700000000	12	107	Putnam County, FL	1992	NA	29235	26644	2591	8.9
CN1210900000000	12	109	St. Johns County, FL	1992	NA	46355	43418	2937	6.3
CN1211100000000	12	111	St. Lucie County, FL	1992	NA	73992	61999	11993	16.2
CN1211300000000	12	113	Santa Rosa County, FL	1992	NA	42569	40256	2313	5.4
CN1211500000000	12	115	Sarasota County, FL	1992	NA	133207	125766	7441	5.6
CN1211700000000	12	117	Seminole County, FL	1992	NA	179469	166500	12969	7.2
CN1211900000000	12	119	Sumter County, FL	1992	NA	12309	11273	1036	8.4
CN1212100000000	12	121	Suwannee County, FL	1992	NA	12618	11367	1251	9.9
CN1212300000000	12	123	Taylor County, FL	1992	NA	8000	6955	1045	13.1
CN1212500000000	12	125	Union County, FL	1992	NA	3833	3615	218	5.7
CN1212700000000	12	127	Volusia County, FL	1992	NA	172929	159410	13519	7.8
CN1212900000000	12	129	Wakulla County, FL	1992	NA	8608	8167	441	5.1
CN1213100000000	12	131	Walton County, FL	1992	NA	13561	12824	737	5.4
CN1213300000000	12	133	Washington County, FL	1992	NA	7914	7297	617	7.8
CN1300100000000	13	001	Appling County, GA	1992	NA	7951	6949	1002	12.6
CN1300300000000	13	003	Atkinson County, GA	1992	NA	2699	2448	251	9.3
CN1300500000000	13	005	Bacon County, GA	1992	NA	4544	4144	400	8.8
CN1300700000000	13	007	Baker County, GA	1992	NA	1489	1209	280	18.8
CN1300900000000	13	009	Baldwin County, GA	1992	NA	17003	16008	995	5.9
CN1301100000000	13	011	Banks County, GA	1992	NA	5922	5558	364	6.1
CN1301300000000	13	013	Barrow County, GA	1992	NA	15782	14537	1245	7.9
CN1301500000000	13	015	Bartow County, GA	1992	NA	30780	28263	2517	8.2
CN1301700000000	13	017	Ben Hill County, GA	1992	NA	7517	6995	522	6.9
CN1301900000000	13	019	Berrien County, GA	1992	NA	6599	6094	505	7.7
CN1302100000000	13	021	Bibb County, GA	1992	NA	69456	64834	4622	6.7
CN1302300000000	13	023	Bleckley County, GA	1992	NA	5049	4783	266	5.3
CN1302500000000	13	025	Brantley County, GA	1992	NA	4722	4217	505	10.7
CN1302700000000	13	027	Brooks County, GA	1992	NA	6497	6181	316	4.9
CN1302900000000	13	029	Bryan County, GA	1992	NA	7950	7505	445	5.6
CN1303100000000	13	031	Bulloch County, GA	1992	NA	20650	19661	989	4.8
CN1303300000000	13	033	Burke County, GA	1992	NA	8548	7209	1339	15.7
CN1303500000000	13	035	Butts County, GA	1992	NA	6845	6196	649	9.5
CN1303700000000	13	037	Calhoun County, GA	1992	NA	2172	1891	281	12.9
CN1303900000000	13	039	Camden County, GA	1992	NA	14395	13568	827	5.7
CN1304300000000	13	043	Candler County, GA	1992	NA	3609	3381	228	6.3
CN1304500000000	13	045	Carroll County, GA	1992	NA	37011	34356	2655	7.2
CN1304700000000	13	047	Catoosa County, GA	1992	NA	22447	21109	1338	6
CN1304900000000	13	049	Charlton County, GA	1992	NA	3800	3548	252	6.6
CN1305100000000	13	051	Chatham County, GA	1992	NA	103638	96720	6918	6.7
CN1305300000000	13	053	Chattahoochee County, GA	1992	NA	2136	1914	222	10.4
CN1305500000000	13	055	Chattooga County, GA	1992	NA	11451	10490	961	8.4
CN1305700000000	13	057	Cherokee County, GA	1992	NA	55881	52987	2894	5.2
CN1305900000000	13	059	Clarke County, GA	1992	NA	42290	40254	2036	4.8
CN1306100000000	13	061	Clay County, GA	1992	NA	1512	1399	113	7.5
CN1306300000000	13	063	Clayton County, GA	1992	NA	104800	97216	7584	7.2
CN1306500000000	13	065	Clinch County, GA	1992	NA	3135	2937	198	6.3
CN1306700000000	13	067	Cobb County, GA	1992	NA	277476	261929	15547	5.6
CN1306900000000	13	069	Coffee County, GA	1992	NA	14965	13855	1110	7.4
CN1307100000000	13	071	Colquitt County, GA	1992	NA	16645	15522	1123	6.7
CN1307300000000	13	073	Columbia County, GA	1992	NA	35811	34021	1790	5
CN1307500000000	13	075	Cook County, GA	1992	NA	6587	6102	485	7.4
CN1307700000000	13	077	Coweta County, GA	1992	NA	30081	27909	2172	7.2
CN1307900000000	13	079	Crawford County, GA	1992	NA	4698	4316	382	8.1
CN1308100000000	13	081	Crisp County, GA	1992	NA	9052	8217	835	9.2
CN1308300000000	13	083	Dade County, GA	1992	NA	6384	5962	422	6.6
CN1308500000000	13	085	Dawson County, GA	1992	NA	6301	5920	381	6
CN1308700000000	13	087	Decatur County, GA	1992	NA	11120	9981	1139	10.2
CN1308900000000	13	089	DeKalb County, GA	1992	NA	320792	299717	21075	6.6
CN1309100000000	13	091	Dodge County, GA	1992	NA	8584	7947	637	7.4
CN1309300000000	13	093	Dooly County, GA	1992	NA	4117	3773	344	8.4
CN1309500000000	13	095	Dougherty County, GA	1992	NA	43491	39028	4463	10.3
CN1309700000000	13	097	Douglas County, GA	1992	NA	40944	38454	2490	6.1
CN1309900000000	13	099	Early County, GA	1992	NA	5421	4823	598	11
CN1310100000000	13	101	Echols County, GA	1992	NA	1010	954	56	5.5
CN1310300000000	13	103	Effingham County, GA	1992	NA	13156	12331	825	6.3
CN1310500000000	13	105	Elbert County, GA	1992	NA	8996	7877	1119	12.4
CN1310700000000	13	107	Emanuel County, GA	1992	NA	8713	7693	1020	11.7
CN1310900000000	13	109	Evans County, GA	1992	NA	4053	3757	296	7.3
CN1311100000000	13	111	Fannin County, GA	1992	NA	7836	7189	647	8.3
CN1311300000000	13	113	Fayette County, GA	1992	NA	35996	34482	1514	4.2
CN1311500000000	13	115	Floyd County, GA	1992	NA	43478	40398	3080	7.1
CN1311700000000	13	117	Forsyth County, GA	1992	NA	27003	25524	1479	5.5
CN1311900000000	13	119	Franklin County, GA	1992	NA	8498	7706	792	9.3
CN1312100000000	13	121	Fulton County, GA	1992	NA	343922	318585	25337	7.4
CN1312300000000	13	123	Gilmer County, GA	1992	NA	6606	5966	640	9.7
CN1312500000000	13	125	Glascock County, GA	1992	NA	1235	1161	74	6
CN1312700000000	13	127	Glynn County, GA	1992	NA	31615	29939	1676	5.3
CN1312900000000	13	129	Gordon County, GA	1992	NA	19363	17784	1579	8.2
CN1313100000000	13	131	Grady County, GA	1992	NA	9795	9023	772	7.9
CN1313300000000	13	133	Greene County, GA	1992	NA	5223	4694	529	10.1
CN1313500000000	13	135	Gwinnett County, GA	1992	NA	230946	218860	12086	5.2
CN1313700000000	13	137	Habersham County, GA	1992	NA	14322	13574	748	5.2
CN1313900000000	13	139	Hall County, GA	1992	NA	55890	52556	3334	6
CN1314100000000	13	141	Hancock County, GA	1992	NA	3594	3158	436	12.1
CN1314300000000	13	143	Haralson County, GA	1992	NA	9613	8401	1212	12.6
CN1314500000000	13	145	Harris County, GA	1992	NA	8644	8132	512	5.9
CN1314700000000	13	147	Hart County, GA	1992	NA	9473	8613	860	9.1
CN1314900000000	13	149	Heard County, GA	1992	NA	4119	3738	381	9.2
CN1315100000000	13	151	Henry County, GA	1992	NA	35625	33713	1912	5.4
CN1315300000000	13	153	Houston County, GA	1992	NA	44110	41506	2604	5.9
CN1315500000000	13	155	Irwin County, GA	1992	NA	3913	3683	230	5.9
CN1315700000000	13	157	Jackson County, GA	1992	NA	15656	14491	1165	7.4
CN1315900000000	13	159	Jasper County, GA	1992	NA	3824	3484	340	8.9
CN1316100000000	13	161	Jeff Davis County, GA	1992	NA	5870	5336	534	9.1
CN1316300000000	13	163	Jefferson County, GA	1992	NA	7709	7049	660	8.6
CN1316500000000	13	165	Jenkins County, GA	1992	NA	3882	3640	242	6.2
CN1316700000000	13	167	Johnson County, GA	1992	NA	3709	3431	278	7.5
CN1316900000000	13	169	Jones County, GA	1992	NA	10665	10111	554	5.2
CN1317100000000	13	171	Lamar County, GA	1992	NA	6204	5774	430	6.9
CN1317300000000	13	173	Lanier County, GA	1992	NA	2626	2481	145	5.5
CN1317500000000	13	175	Laurens County, GA	1992	NA	19853	18694	1159	5.8
CN1317700000000	13	177	Lee County, GA	1992	NA	8366	7783	583	7
CN1317900000000	13	179	Liberty County, GA	1992	NA	14501	13265	1236	8.5
CN1318100000000	13	181	Lincoln County, GA	1992	NA	3711	3462	249	6.7
CN1318300000000	13	183	Long County, GA	1992	NA	2499	2402	97	3.9
CN1318500000000	13	185	Lowndes County, GA	1992	NA	35339	33170	2169	6.1
CN1318700000000	13	187	Lumpkin County, GA	1992	NA	7688	7282	406	5.3
CN1318900000000	13	189	McDuffie County, GA	1992	NA	9416	8705	711	7.6
CN1319100000000	13	191	McIntosh County, GA	1992	NA	3490	3227	263	7.5
CN1319300000000	13	193	Macon County, GA	1992	NA	6002	5169	833	13.9
CN1319500000000	13	195	Madison County, GA	1992	NA	11394	10638	756	6.6
CN1319700000000	13	197	Marion County, GA	1992	NA	2405	2214	191	7.9
CN1319900000000	13	199	Meriwether County, GA	1992	NA	9400	8352	1048	11.1
CN1320100000000	13	201	Miller County, GA	1992	NA	2897	2601	296	10.2
CN1320500000000	13	205	Mitchell County, GA	1992	NA	9275	8193	1082	11.7
CN1320700000000	13	207	Monroe County, GA	1992	NA	7766	7187	579	7.5
CN1320900000000	13	209	Montgomery County, GA	1992	NA	3473	3140	333	9.6
CN1321100000000	13	211	Morgan County, GA	1992	NA	6051	5578	473	7.8
CN1321300000000	13	213	Murray County, GA	1992	NA	16108	14883	1225	7.6
CN1321500000000	13	215	Muscogee County, GA	1992	NA	77622	72008	5614	7.2
CN1321700000000	13	217	Newton County, GA	1992	NA	21503	19898	1605	7.5
CN1321900000000	13	219	Oconee County, GA	1992	NA	9716	9320	396	4.1
CN1322100000000	13	221	Oglethorpe County, GA	1992	NA	4963	4595	368	7.4
CN1322300000000	13	223	Paulding County, GA	1992	NA	24420	22890	1530	6.3
CN1322500000000	13	225	Peach County, GA	1992	NA	9785	8927	858	8.8
CN1322700000000	13	227	Pickens County, GA	1992	NA	7658	7068	590	7.7
CN1322900000000	13	229	Pierce County, GA	1992	NA	6969	6431	538	7.7
CN1323100000000	13	231	Pike County, GA	1992	NA	5425	5097	328	6
CN1323300000000	13	233	Polk County, GA	1992	NA	15715	13782	1933	12.3
CN1323500000000	13	235	Pulaski County, GA	1992	NA	4032	3799	233	5.8
CN1323700000000	13	237	Putnam County, GA	1992	NA	7222	6857	365	5.1
CN1323900000000	13	239	Quitman County, GA	1992	NA	945	854	91	9.6
CN1324100000000	13	241	Rabun County, GA	1992	NA	5735	5172	563	9.8
CN1324300000000	13	243	Randolph County, GA	1992	NA	3115	2827	288	9.2
CN1324500000000	13	245	Richmond County, GA	1992	NA	87385	79921	7464	8.5
CN1324700000000	13	247	Rockdale County, GA	1992	NA	31801	30076	1725	5.4
CN1324900000000	13	249	Schley County, GA	1992	NA	1441	1309	132	9.2
CN1325100000000	13	251	Screven County, GA	1992	NA	6639	6012	627	9.4
CN1325300000000	13	253	Seminole County, GA	1992	NA	4449	3973	476	10.7
CN1325500000000	13	255	Spalding County, GA	1992	NA	26958	25061	1897	7
CN1325700000000	13	257	Stephens County, GA	1992	NA	12349	11446	903	7.3
CN1325900000000	13	259	Stewart County, GA	1992	NA	2179	1976	203	9.3
CN1326100000000	13	261	Sumter County, GA	1992	NA	13930	12562	1368	9.8
CN1326300000000	13	263	Talbot County, GA	1992	NA	2642	2398	244	9.2
CN1326500000000	13	265	Taliaferro County, GA	1992	NA	720	658	62	8.6
CN1326700000000	13	267	Tattnall County, GA	1992	NA	6913	6437	476	6.9
CN1326900000000	13	269	Taylor County, GA	1992	NA	3389	3102	287	8.5
CN1327100000000	13	271	Telfair County, GA	1992	NA	4921	4425	496	10.1
CN1327300000000	13	273	Terrell County, GA	1992	NA	4798	4343	455	9.5
CN1327500000000	13	275	Thomas County, GA	1992	NA	18302	16973	1329	7.3
CN1327700000000	13	277	Tift County, GA	1992	NA	17947	16610	1337	7.4
CN1327900000000	13	279	Toombs County, GA	1992	NA	11248	10161	1087	9.7
CN1328100000000	13	281	Towns County, GA	1992	NA	2629	2441	188	7.2
CN1328300000000	13	283	Treutlen County, GA	1992	NA	2757	2418	339	12.3
CN1328500000000	13	285	Troup County, GA	1992	NA	26071	23449	2622	10.1
CN1328700000000	13	287	Turner County, GA	1992	NA	3862	3528	334	8.6
CN1328900000000	13	289	Twiggs County, GA	1992	NA	3900	3632	268	6.9
CN1329100000000	13	291	Union County, GA	1992	NA	5966	5566	400	6.7
CN1329300000000	13	293	Upson County, GA	1992	NA	12732	12018	714	5.6
CN1329500000000	13	295	Walker County, GA	1992	NA	29595	27114	2481	8.4
CN1329700000000	13	297	Walton County, GA	1992	NA	20034	18514	1520	7.6
CN1329900000000	13	299	Ware County, GA	1992	NA	14879	13746	1133	7.6
CN1330100000000	13	301	Warren County, GA	1992	NA	2620	2364	256	9.8
CN1330300000000	13	303	Washington County, GA	1992	NA	8824	8337	487	5.5
CN1330500000000	13	305	Wayne County, GA	1992	NA	11184	10022	1162	10.4
CN1330700000000	13	307	Webster County, GA	1992	NA	1103	1019	84	7.6
CN1330900000000	13	309	Wheeler County, GA	1992	NA	1988	1808	180	9.1
CN1331100000000	13	311	White County, GA	1992	NA	7867	7429	438	5.6
CN1331300000000	13	313	Whitfield County, GA	1992	NA	41697	39093	2604	6.2
CN1331500000000	13	315	Wilcox County, GA	1992	NA	2955	2732	223	7.5
CN1331700000000	13	317	Wilkes County, GA	1992	NA	5160	4871	289	5.6
CN1331900000000	13	319	Wilkinson County, GA	1992	NA	4538	4278	260	5.7
CN1332100000000	13	321	Worth County, GA	1992	NA	9233	8500	733	7.9
CN1500100000000	15	001	Hawaii County, HI	1992	NA	65215	60220	4995	7.7
CN1500300000000	15	003	Honolulu County/city, HI	1992	NA	423845	411820	12025	2.8
CN1500700000000	15	007	Kauai County, HI	1992	NA	29396	26489	2907	9.9
CN1500900000000	15	009	Maui County, HI	1992	NA	65796	60406	5390	8.2
CN1600100000000	16	001	Ada County, ID	1992	NA	122338	117231	5107	4.2
CN1600300000000	16	003	Adams County, ID	1992	NA	1663	1437	226	13.6
CN1600500000000	16	005	Bannock County, ID	1992	NA	31541	29230	2311	7.3
CN1600700000000	16	007	Bear Lake County, ID	1992	NA	2603	2468	135	5.2
CN1600900000000	16	009	Benewah County, ID	1992	NA	3744	3324	420	11.2
CN1601100000000	16	011	Bingham County, ID	1992	NA	19771	18567	1204	6.1
CN1601300000000	16	013	Blaine County, ID	1992	NA	8729	8095	634	7.3
CN1601500000000	16	015	Boise County, ID	1992	NA	1863	1723	140	7.5
CN1601700000000	16	017	Bonner County, ID	1992	NA	13517	12169	1348	10
CN1601900000000	16	019	Bonneville County, ID	1992	NA	42112	40121	1991	4.7
CN1602100000000	16	021	Boundary County, ID	1992	NA	3732	3380	352	9.4
CN1602300000000	16	023	Butte County, ID	1992	NA	1530	1421	109	7.1
CN1602500000000	16	025	Camas County, ID	1992	NA	464	437	27	5.8
CN1602700000000	16	027	Canyon County, ID	1992	NA	46443	43387	3056	6.6
CN1602900000000	16	029	Caribou County, ID	1992	NA	3330	3114	216	6.5
CN1603100000000	16	031	Cassia County, ID	1992	NA	9012	8292	720	8
CN1603300000000	16	033	Clark County, ID	1992	NA	637	609	28	4.4
CN1603500000000	16	035	Clearwater County, ID	1992	NA	4051	3438	613	15.1
CN1603700000000	16	037	Custer County, ID	1992	NA	1996	1808	188	9.4
CN1603900000000	16	039	Elmore County, ID	1992	NA	7947	7403	544	6.8
CN1604100000000	16	041	Franklin County, ID	1992	NA	4093	3951	142	3.5
CN1604300000000	16	043	Fremont County, ID	1992	NA	5212	4779	433	8.3
CN1604500000000	16	045	Gem County, ID	1992	NA	5415	4981	434	8
CN1604700000000	16	047	Gooding County, ID	1992	NA	5500	5226	274	5
CN1604900000000	16	049	Idaho County, ID	1992	NA	6441	5697	744	11.6
CN1605100000000	16	051	Jefferson County, ID	1992	NA	8693	8177	516	5.9
CN1605300000000	16	053	Jerome County, ID	1992	NA	7384	6910	474	6.4
CN1605500000000	16	055	Kootenai County, ID	1992	NA	39537	36465	3072	7.8
CN1605700000000	16	057	Latah County, ID	1992	NA	14095	13577	518	3.7
CN1605900000000	16	059	Lemhi County, ID	1992	NA	3349	2999	350	10.5
CN1606100000000	16	061	Lewis County, ID	1992	NA	1515	1419	96	6.3
CN1606300000000	16	063	Lincoln County, ID	1992	NA	1966	1839	127	6.5
CN1606500000000	16	065	Madison County, ID	1992	NA	8782	8531	251	2.9
CN1606700000000	16	067	Minidoka County, ID	1992	NA	9696	8873	823	8.5
CN1606900000000	16	069	Nez Perce County, ID	1992	NA	20732	19827	905	4.4
CN1607100000000	16	071	Oneida County, ID	1992	NA	1422	1353	69	4.9
CN1607300000000	16	073	Owyhee County, ID	1992	NA	4177	3942	235	5.6
CN1607500000000	16	075	Payette County, ID	1992	NA	8918	8036	882	9.9
CN1607700000000	16	077	Power County, ID	1992	NA	3348	3106	242	7.2
CN1607900000000	16	079	Shoshone County, ID	1992	NA	6608	5564	1044	15.8
CN1608100000000	16	081	Teton County, ID	1992	NA	2119	2036	83	3.9
CN1608300000000	16	083	Twin Falls County, ID	1992	NA	27318	25429	1889	6.9
CN1608500000000	16	085	Valley County, ID	1992	NA	3702	3330	372	10
CN1608700000000	16	087	Washington County, ID	1992	NA	4082	3672	410	10
CN1700100000000	17	001	Adams County, IL	1992	NA	34640	32289	2351	6.8
CN1700300000000	17	003	Alexander County, IL	1992	NA	4195	3710	485	11.6
CN1700500000000	17	005	Bond County, IL	1992	NA	7556	6926	630	8.3
CN1700700000000	17	007	Boone County, IL	1992	NA	18750	16759	1991	10.6
CN1700900000000	17	009	Brown County, IL	1992	NA	2488	2334	154	6.2
CN1701100000000	17	011	Bureau County, IL	1992	NA	18383	17183	1200	6.5
CN1701300000000	17	013	Calhoun County, IL	1992	NA	2723	2461	262	9.6
CN1701500000000	17	015	Carroll County, IL	1992	NA	8487	7940	547	6.4
CN1701700000000	17	017	Cass County, IL	1992	NA	7177	6600	577	8
CN1701900000000	17	019	Champaign County, IL	1992	NA	95418	91666	3752	3.9
CN1702100000000	17	021	Christian County, IL	1992	NA	18411	16972	1439	7.8
CN1702300000000	17	023	Clark County, IL	1992	NA	9347	8687	660	7.1
CN1702500000000	17	025	Clay County, IL	1992	NA	7009	6395	614	8.8
CN1702700000000	17	027	Clinton County, IL	1992	NA	16700	15584	1116	6.7
CN1702900000000	17	029	Coles County, IL	1992	NA	26748	25145	1603	6
CN1703100000000	17	031	Cook County, IL	1992	NA	2623242	2390292	232950	8.9
CN1703300000000	17	033	Crawford County, IL	1992	NA	10010	9229	781	7.8
CN1703500000000	17	035	Cumberland County, IL	1992	NA	5369	4924	445	8.3
CN1703700000000	17	037	DeKalb County, IL	1992	NA	43318	40426	2892	6.7
CN1703900000000	17	039	De Witt County, IL	1992	NA	8968	8327	641	7.1
CN1704100000000	17	041	Douglas County, IL	1992	NA	10529	9792	737	7
CN1704300000000	17	043	DuPage County, IL	1992	NA	470571	443352	27219	5.8
CN1704500000000	17	045	Edgar County, IL	1992	NA	9034	8245	789	8.7
CN1704700000000	17	047	Edwards County, IL	1992	NA	3688	3413	275	7.5
CN1704900000000	17	049	Effingham County, IL	1992	NA	17299	15751	1548	8.9
CN1705100000000	17	051	Fayette County, IL	1992	NA	10184	9255	929	9.1
CN1705300000000	17	053	Ford County, IL	1992	NA	7085	6684	401	5.7
CN1705500000000	17	055	Franklin County, IL	1992	NA	16871	14654	2217	13.1
CN1705700000000	17	057	Fulton County, IL	1992	NA	14842	13245	1597	10.8
CN1705900000000	17	059	Gallatin County, IL	1992	NA	3057	2686	371	12.1
CN1706100000000	17	061	Greene County, IL	1992	NA	7009	6541	468	6.7
CN1706300000000	17	063	Grundy County, IL	1992	NA	17667	15562	2105	11.9
CN1706500000000	17	065	Hamilton County, IL	1992	NA	3660	3215	445	12.2
CN1706700000000	17	067	Hancock County, IL	1992	NA	10937	10200	737	6.7
CN1706900000000	17	069	Hardin County, IL	1992	NA	1987	1822	165	8.3
CN1707100000000	17	071	Henderson County, IL	1992	NA	4740	4450	290	6.1
CN1707300000000	17	073	Henry County, IL	1992	NA	26627	24744	1883	7.1
CN1707500000000	17	075	Iroquois County, IL	1992	NA	16940	15944	996	5.9
CN1707700000000	17	077	Jackson County, IL	1992	NA	29879	27662	2217	7.4
CN1707900000000	17	079	Jasper County, IL	1992	NA	4947	4593	354	7.2
CN1708100000000	17	081	Jefferson County, IL	1992	NA	17791	15797	1994	11.2
CN1708300000000	17	083	Jersey County, IL	1992	NA	10301	9579	722	7
CN1708500000000	17	085	Jo Daviess County, IL	1992	NA	11892	11271	621	5.2
CN1708700000000	17	087	Johnson County, IL	1992	NA	4337	3840	497	11.5
CN1708900000000	17	089	Kane County, IL	1992	NA	181681	166407	15274	8.4
CN1709100000000	17	091	Kankakee County, IL	1992	NA	49997	45828	4169	8.3
CN1709300000000	17	093	Kendall County, IL	1992	NA	22863	21392	1471	6.4
CN1709500000000	17	095	Knox County, IL	1992	NA	29797	27788	2009	6.7
CN1709700000000	17	097	Lake County, IL	1992	NA	291994	276566	15428	5.3
CN1709900000000	17	099	LaSalle County, IL	1992	NA	54473	49132	5341	9.8
CN1710100000000	17	101	Lawrence County, IL	1992	NA	7212	6540	672	9.3
CN1710300000000	17	103	Lee County, IL	1992	NA	16847	15787	1060	6.3
CN1710500000000	17	105	Livingston County, IL	1992	NA	20001	19011	990	4.9
CN1710700000000	17	107	Logan County, IL	1992	NA	13838	12891	947	6.8
CN1710900000000	17	109	McDonough County, IL	1992	NA	18375	17720	655	3.6
CN1711100000000	17	111	McHenry County, IL	1992	NA	110699	102679	8020	7.2
CN1711300000000	17	113	McLean County, IL	1992	NA	77678	74633	3045	3.9
CN1711500000000	17	115	Macon County, IL	1992	NA	61691	56300	5391	8.7
CN1711700000000	17	117	Macoupin County, IL	1992	NA	23495	21618	1877	8
CN1711900000000	17	119	Madison County, IL	1992	NA	127195	117795	9400	7.4
CN1712100000000	17	121	Marion County, IL	1992	NA	20780	18678	2102	10.1
CN1712300000000	17	123	Marshall County, IL	1992	NA	6988	6564	424	6.1
CN1712500000000	17	125	Mason County, IL	1992	NA	7850	6999	851	10.8
CN1712700000000	17	127	Massac County, IL	1992	NA	6999	6395	604	8.6
CN1712900000000	17	129	Menard County, IL	1992	NA	6160	5860	300	4.9
CN1713100000000	17	131	Mercer County, IL	1992	NA	8598	7857	741	8.6
CN1713300000000	17	133	Monroe County, IL	1992	NA	12504	11684	820	6.6
CN1713500000000	17	135	Montgomery County, IL	1992	NA	15017	13743	1274	8.5
CN1713700000000	17	137	Morgan County, IL	1992	NA	18786	17696	1090	5.8
CN1713900000000	17	139	Moultrie County, IL	1992	NA	7594	7083	511	6.7
CN1714100000000	17	141	Ogle County, IL	1992	NA	25866	24135	1731	6.7
CN1714300000000	17	143	Peoria County, IL	1992	NA	93080	86615	6465	6.9
CN1714500000000	17	145	Perry County, IL	1992	NA	8521	7155	1366	16
CN1714700000000	17	147	Piatt County, IL	1992	NA	8810	8215	595	6.8
CN1714900000000	17	149	Pike County, IL	1992	NA	8678	8014	664	7.7
CN1715100000000	17	151	Pope County, IL	1992	NA	1673	1478	195	11.7
CN1715300000000	17	153	Pulaski County, IL	1992	NA	2988	2626	362	12.1
CN1715500000000	17	155	Putnam County, IL	1992	NA	3042	2807	235	7.7
CN1715700000000	17	157	Randolph County, IL	1992	NA	15729	14133	1596	10.1
CN1715900000000	17	159	Richland County, IL	1992	NA	9155	8626	529	5.8
CN1716100000000	17	161	Rock Island County, IL	1992	NA	76468	70909	5559	7.3
CN1716300000000	17	163	St. Clair County, IL	1992	NA	118055	108302	9753	8.3
CN1716500000000	17	165	Saline County, IL	1992	NA	11115	9795	1320	11.9
CN1716700000000	17	167	Sangamon County, IL	1992	NA	104739	99609	5130	4.9
CN1716900000000	17	169	Schuyler County, IL	1992	NA	3851	3572	279	7.2
CN1717100000000	17	171	Scott County, IL	1992	NA	2855	2634	221	7.7
CN1717300000000	17	173	Shelby County, IL	1992	NA	11045	10165	880	8
CN1717500000000	17	175	Stark County, IL	1992	NA	3055	2808	247	8.1
CN1717700000000	17	177	Stephenson County, IL	1992	NA	26345	24407	1938	7.4
CN1717900000000	17	179	Tazewell County, IL	1992	NA	66495	61912	4583	6.9
CN1718100000000	17	181	Union County, IL	1992	NA	8333	7364	969	11.6
CN1718300000000	17	183	Vermilion County, IL	1992	NA	41977	37769	4208	10
CN1718500000000	17	185	Wabash County, IL	1992	NA	6050	5339	711	11.8
CN1718700000000	17	187	Warren County, IL	1992	NA	10115	9562	553	5.5
CN1718900000000	17	189	Washington County, IL	1992	NA	7522	7025	497	6.6
CN1719100000000	17	191	Wayne County, IL	1992	NA	8332	7584	748	9
CN1719300000000	17	193	White County, IL	1992	NA	7861	7188	673	8.6
CN1719500000000	17	195	Whiteside County, IL	1992	NA	31714	29778	1936	6.1
CN1719700000000	17	197	Will County, IL	1992	NA	195838	178664	17174	8.8
CN1719900000000	17	199	Williamson County, IL	1992	NA	27256	24352	2904	10.7
CN1720100000000	17	201	Winnebago County, IL	1992	NA	144149	132665	11484	8
CN1720300000000	17	203	Woodford County, IL	1992	NA	17288	16544	744	4.3
CN1800100000000	18	001	Adams County, IN	1992	NA	15351	14228	1123	7.3
CN1800300000000	18	003	Allen County, IN	1992	NA	163856	153471	10385	6.3
CN1800500000000	18	005	Bartholomew County, IN	1992	NA	34666	32817	1849	5.3
CN1800700000000	18	007	Benton County, IN	1992	NA	4782	4539	243	5.1
CN1800900000000	18	009	Blackford County, IN	1992	NA	6245	5487	758	12.1
CN1801100000000	18	011	Boone County, IN	1992	NA	20907	20068	839	4
CN1801300000000	18	013	Brown County, IN	1992	NA	7438	7163	275	3.7
CN1801500000000	18	015	Carroll County, IN	1992	NA	10654	10137	517	4.9
CN1801700000000	18	017	Cass County, IN	1992	NA	18883	17511	1372	7.3
CN1801900000000	18	019	Clark County, IN	1992	NA	46736	43837	2899	6.2
CN1802100000000	18	021	Clay County, IN	1992	NA	11803	10925	878	7.4
CN1802300000000	18	023	Clinton County, IN	1992	NA	14662	13976	686	4.7
CN1802500000000	18	025	Crawford County, IN	1992	NA	4496	3979	517	11.5
CN1802700000000	18	027	Daviess County, IN	1992	NA	12724	12008	716	5.6
CN1802900000000	18	029	Dearborn County, IN	1992	NA	20138	18379	1759	8.7
CN1803100000000	18	031	Decatur County, IN	1992	NA	12877	12251	626	4.9
CN1803300000000	18	033	DeKalb County, IN	1992	NA	19609	18310	1299	6.6
CN1803500000000	18	035	Delaware County, IN	1992	NA	61762	57233	4529	7.3
CN1803700000000	18	037	Dubois County, IN	1992	NA	20697	19927	770	3.7
CN1803900000000	18	039	Elkhart County, IN	1992	NA	84420	79490	4930	5.8
CN1804100000000	18	041	Fayette County, IN	1992	NA	12665	10856	1809	14.3
CN1804300000000	18	043	Floyd County, IN	1992	NA	33838	32060	1778	5.3
CN1804500000000	18	045	Fountain County, IN	1992	NA	8475	7672	803	9.5
CN1804700000000	18	047	Franklin County, IN	1992	NA	9825	8942	883	9
CN1804900000000	18	049	Fulton County, IN	1992	NA	9484	8837	647	6.8
CN1805100000000	18	051	Gibson County, IN	1992	NA	16374	15140	1234	7.5
CN1805300000000	18	053	Grant County, IN	1992	NA	35943	32563	3380	9.4
CN1805500000000	18	055	Greene County, IN	1992	NA	14841	13376	1465	9.9
CN1805700000000	18	057	Hamilton County, IN	1992	NA	65640	63881	1759	2.7
CN1805900000000	18	059	Hancock County, IN	1992	NA	24940	23867	1073	4.3
CN1806100000000	18	061	Harrison County, IN	1992	NA	15340	14512	828	5.4
CN1806300000000	18	063	Hendricks County, IN	1992	NA	41651	40321	1330	3.2
CN1806500000000	18	065	Henry County, IN	1992	NA	23860	21376	2484	10.4
CN1806700000000	18	067	Howard County, IN	1992	NA	40711	37794	2917	7.2
CN1806900000000	18	069	Huntington County, IN	1992	NA	18920	17713	1207	6.4
CN1807100000000	18	071	Jackson County, IN	1992	NA	19626	18268	1358	6.9
CN1807300000000	18	073	Jasper County, IN	1992	NA	12175	11220	955	7.8
CN1807500000000	18	075	Jay County, IN	1992	NA	11072	9991	1081	9.8
CN1807700000000	18	077	Jefferson County, IN	1992	NA	14656	13624	1032	7
CN1807900000000	18	079	Jennings County, IN	1992	NA	11992	11265	727	6.1
CN1808100000000	18	081	Johnson County, IN	1992	NA	49972	47971	2001	4
CN1808300000000	18	083	Knox County, IN	1992	NA	18648	17642	1006	5.4
CN1808500000000	18	085	Kosciusko County, IN	1992	NA	34909	33099	1810	5.2
CN1808700000000	18	087	LaGrange County, IN	1992	NA	14217	13335	882	6.2
CN1808900000000	18	089	Lake County, IN	1992	NA	224492	205006	19486	8.7
CN1809100000000	18	091	LaPorte County, IN	1992	NA	52473	48830	3643	6.9
CN1809300000000	18	093	Lawrence County, IN	1992	NA	21808	19574	2234	10.2
CN1809500000000	18	095	Madison County, IN	1992	NA	63830	58900	4930	7.7
CN1809700000000	18	097	Marion County, IN	1992	NA	429239	404860	24379	5.7
CN1809900000000	18	099	Marshall County, IN	1992	NA	23007	21673	1334	5.8
CN1810100000000	18	101	Martin County, IN	1992	NA	5021	4650	371	7.4
CN1810300000000	18	103	Miami County, IN	1992	NA	16028	14724	1304	8.1
CN1810500000000	18	105	Monroe County, IN	1992	NA	55034	52696	2338	4.2
CN1810700000000	18	107	Montgomery County, IN	1992	NA	18497	17853	644	3.5
CN1810900000000	18	109	Morgan County, IN	1992	NA	30210	28430	1780	5.9
CN1811100000000	18	111	Newton County, IN	1992	NA	6637	6222	415	6.3
CN1811300000000	18	113	Noble County, IN	1992	NA	20960	19487	1473	7
CN1811500000000	18	115	Ohio County, IN	1992	NA	2550	2342	208	8.2
CN1811700000000	18	117	Orange County, IN	1992	NA	8822	7676	1146	13
CN1811900000000	18	119	Owen County, IN	1992	NA	8972	8329	643	7.2
CN1812100000000	18	121	Parke County, IN	1992	NA	7303	6770	533	7.3
CN1812300000000	18	123	Perry County, IN	1992	NA	8843	8001	842	9.5
CN1812500000000	18	125	Pike County, IN	1992	NA	5983	5492	491	8.2
CN1812700000000	18	127	Porter County, IN	1992	NA	67957	64127	3830	5.6
CN1812900000000	18	129	Posey County, IN	1992	NA	12743	12075	668	5.2
CN1813100000000	18	131	Pulaski County, IN	1992	NA	5925	5443	482	8.1
CN1813300000000	18	133	Putnam County, IN	1992	NA	14999	14280	719	4.8
CN1813500000000	18	135	Randolph County, IN	1992	NA	12011	10368	1643	13.7
CN1813700000000	18	137	Ripley County, IN	1992	NA	12348	11352	996	8.1
CN1813900000000	18	139	Rush County, IN	1992	NA	9031	8333	698	7.7
CN1814100000000	18	141	St. Joseph County, IN	1992	NA	125095	116383	8712	7
CN1814300000000	18	143	Scott County, IN	1992	NA	9635	8992	643	6.7
CN1814500000000	18	145	Shelby County, IN	1992	NA	21290	20090	1200	5.6
CN1814700000000	18	147	Spencer County, IN	1992	NA	9557	8730	827	8.7
CN1814900000000	18	149	Starke County, IN	1992	NA	10342	9409	933	9
CN1815100000000	18	151	Steuben County, IN	1992	NA	15517	14602	915	5.9
CN1815300000000	18	153	Sullivan County, IN	1992	NA	8982	8092	890	9.9
CN1815500000000	18	155	Switzerland County, IN	1992	NA	3943	3558	385	9.8
CN1815700000000	18	157	Tippecanoe County, IN	1992	NA	65911	63521	2390	3.6
CN1815900000000	18	159	Tipton County, IN	1992	NA	8365	7809	556	6.6
CN1816100000000	18	161	Union County, IN	1992	NA	3503	3175	328	9.4
CN1816300000000	18	163	Vanderburgh County, IN	1992	NA	84946	79089	5857	6.9
CN1816500000000	18	165	Vermillion County, IN	1992	NA	7724	7047	677	8.8
CN1816700000000	18	167	Vigo County, IN	1992	NA	51136	47711	3425	6.7
CN1816900000000	18	169	Wabash County, IN	1992	NA	17887	16388	1499	8.4
CN1817100000000	18	171	Warren County, IN	1992	NA	3791	3527	264	7
CN1817300000000	18	173	Warrick County, IN	1992	NA	24139	22740	1399	5.8
CN1817500000000	18	175	Washington County, IN	1992	NA	10756	9731	1025	9.5
CN1817700000000	18	177	Wayne County, IN	1992	NA	36220	31726	4494	12.4
CN1817900000000	18	179	Wells County, IN	1992	NA	13684	12937	747	5.5
CN1818100000000	18	181	White County, IN	1992	NA	12829	11972	857	6.7
CN1818300000000	18	183	Whitley County, IN	1992	NA	14936	14030	906	6.1
CN1900100000000	19	001	Adair County, IA	1992	NA	4186	4050	136	3.2
CN1900300000000	19	003	Adams County, IA	1992	NA	2410	2320	90	3.7
CN1900500000000	19	005	Allamakee County, IA	1992	NA	7403	6988	415	5.6
CN1900700000000	19	007	Appanoose County, IA	1992	NA	6702	6308	394	5.9
CN1900900000000	19	009	Audubon County, IA	1992	NA	3822	3717	105	2.7
CN1901100000000	19	011	Benton County, IA	1992	NA	11331	10809	522	4.6
CN1901300000000	19	013	Black Hawk County, IA	1992	NA	66131	62132	3999	6
CN1901500000000	19	015	Boone County, IA	1992	NA	13032	12498	534	4.1
CN1901700000000	19	017	Bremer County, IA	1992	NA	12285	11748	537	4.4
CN1901900000000	19	019	Buchanan County, IA	1992	NA	10016	9407	609	6.1
CN1902100000000	19	021	Buena Vista County, IA	1992	NA	10803	10532	271	2.5
CN1902300000000	19	023	Butler County, IA	1992	NA	7879	7378	501	6.4
CN1902500000000	19	025	Calhoun County, IA	1992	NA	5190	5017	173	3.3
CN1902700000000	19	027	Carroll County, IA	1992	NA	11573	11232	341	2.9
CN1902900000000	19	029	Cass County, IA	1992	NA	7717	7337	380	4.9
CN1903100000000	19	031	Cedar County, IA	1992	NA	9304	8973	331	3.6
CN1903300000000	19	033	Cerro Gordo County, IA	1992	NA	25493	24024	1469	5.8
CN1903500000000	19	035	Cherokee County, IA	1992	NA	6960	6750	210	3
CN1903700000000	19	037	Chickasaw County, IA	1992	NA	7259	6791	468	6.4
CN1903900000000	19	039	Clarke County, IA	1992	NA	4213	3933	280	6.6
CN1904100000000	19	041	Clay County, IA	1992	NA	9073	8799	274	3
CN1904300000000	19	043	Clayton County, IA	1992	NA	9614	9055	559	5.8
CN1904500000000	19	045	Clinton County, IA	1992	NA	27001	25479	1522	5.6
CN1904700000000	19	047	Crawford County, IA	1992	NA	8664	8317	347	4
CN1904900000000	19	049	Dallas County, IA	1992	NA	17075	16484	591	3.5
CN1905100000000	19	051	Davis County, IA	1992	NA	4099	3889	210	5.1
CN1905300000000	19	053	Decatur County, IA	1992	NA	3886	3611	275	7.1
CN1905500000000	19	055	Delaware County, IA	1992	NA	9063	8580	483	5.3
CN1905700000000	19	057	Des Moines County, IA	1992	NA	23040	21674	1366	5.9
CN1905900000000	19	059	Dickinson County, IA	1992	NA	8860	8565	295	3.3
CN1906100000000	19	061	Dubuque County, IA	1992	NA	48345	45851	2494	5.2
CN1906300000000	19	063	Emmet County, IA	1992	NA	5766	5461	305	5.3
CN1906500000000	19	065	Fayette County, IA	1992	NA	10650	10092	558	5.2
CN1906700000000	19	067	Floyd County, IA	1992	NA	8745	8175	570	6.5
CN1906900000000	19	069	Franklin County, IA	1992	NA	5838	5597	241	4.1
CN1907100000000	19	071	Fremont County, IA	1992	NA	3818	3611	207	5.4
CN1907300000000	19	073	Greene County, IA	1992	NA	5241	5030	211	4
CN1907500000000	19	075	Grundy County, IA	1992	NA	6034	5819	215	3.6
CN1907700000000	19	077	Guthrie County, IA	1992	NA	5640	5409	231	4.1
CN1907900000000	19	079	Hamilton County, IA	1992	NA	8757	8347	410	4.7
CN1908100000000	19	081	Hancock County, IA	1992	NA	5920	5603	317	5.4
CN1908300000000	19	083	Hardin County, IA	1992	NA	9484	9012	472	5
CN1908500000000	19	085	Harrison County, IA	1992	NA	7426	7022	404	5.4
CN1908700000000	19	087	Henry County, IA	1992	NA	10531	10072	459	4.4
CN1908900000000	19	089	Howard County, IA	1992	NA	4893	4692	201	4.1
CN1909100000000	19	091	Humboldt County, IA	1992	NA	5145	4979	166	3.2
CN1909300000000	19	093	Ida County, IA	1992	NA	3851	3750	101	2.6
CN1909500000000	19	095	Iowa County, IA	1992	NA	9021	8806	215	2.4
CN1909700000000	19	097	Jackson County, IA	1992	NA	10602	9946	656	6.2
CN1909900000000	19	099	Jasper County, IA	1992	NA	17999	17319	680	3.8
CN1910100000000	19	101	Jefferson County, IA	1992	NA	9000	8538	462	5.1
CN1910300000000	19	103	Johnson County, IA	1992	NA	60313	58449	1864	3.1
CN1910500000000	19	105	Jones County, IA	1992	NA	9564	9027	537	5.6
CN1910700000000	19	107	Keokuk County, IA	1992	NA	5225	4922	303	5.8
CN1910900000000	19	109	Kossuth County, IA	1992	NA	8961	8544	417	4.7
CN1911100000000	19	111	Lee County, IA	1992	NA	19558	18049	1509	7.7
CN1911300000000	19	113	Linn County, IA	1992	NA	99951	95936	4015	4
CN1911500000000	19	115	Louisa County, IA	1992	NA	6360	6010	350	5.5
CN1911700000000	19	117	Lucas County, IA	1992	NA	4425	4141	284	6.4
CN1911900000000	19	119	Lyon County, IA	1992	NA	5908	5762	146	2.5
CN1912100000000	19	121	Madison County, IA	1992	NA	6477	6145	332	5.1
CN1912300000000	19	123	Mahaska County, IA	1992	NA	10822	10402	420	3.9
CN1912500000000	19	125	Marion County, IA	1992	NA	16402	15844	558	3.4
CN1912700000000	19	127	Marshall County, IA	1992	NA	20248	19467	781	3.9
CN1912900000000	19	129	Mills County, IA	1992	NA	6606	6341	265	4
CN1913100000000	19	131	Mitchell County, IA	1992	NA	5298	5099	199	3.8
CN1913300000000	19	133	Monona County, IA	1992	NA	4820	4613	207	4.3
CN1913500000000	19	135	Monroe County, IA	1992	NA	3942	3737	205	5.2
CN1913700000000	19	137	Montgomery County, IA	1992	NA	5994	5711	283	4.7
CN1913900000000	19	139	Muscatine County, IA	1992	NA	21466	20321	1145	5.3
CN1914100000000	19	141	O'Brien County, IA	1992	NA	7650	7433	217	2.8
CN1914300000000	19	143	Osceola County, IA	1992	NA	3706	3584	122	3.3
CN1914500000000	19	145	Page County, IA	1992	NA	8561	8098	463	5.4
CN1914700000000	19	147	Palo Alto County, IA	1992	NA	5232	5075	157	3
CN1914900000000	19	149	Plymouth County, IA	1992	NA	12610	12171	439	3.5
CN1915100000000	19	151	Pocahontas County, IA	1992	NA	4335	4187	148	3.4
CN1915300000000	19	153	Polk County, IA	1992	NA	200241	193212	7029	3.5
CN1915500000000	19	155	Pottawattamie County, IA	1992	NA	44972	42839	2133	4.7
CN1915700000000	19	157	Poweshiek County, IA	1992	NA	10170	9730	440	4.3
CN1915900000000	19	159	Ringgold County, IA	1992	NA	2701	2598	103	3.8
CN1916100000000	19	161	Sac County, IA	1992	NA	6072	5893	179	2.9
CN1916300000000	19	163	Scott County, IA	1992	NA	83315	78779	4536	5.4
CN1916500000000	19	165	Shelby County, IA	1992	NA	6718	6365	353	5.3
CN1916700000000	19	167	Sioux County, IA	1992	NA	16137	15694	443	2.7
CN1916900000000	19	169	Story County, IA	1992	NA	43054	41500	1554	3.6
CN1917100000000	19	171	Tama County, IA	1992	NA	8165	7733	432	5.3
CN1917300000000	19	173	Taylor County, IA	1992	NA	3222	3079	143	4.4
CN1917500000000	19	175	Union County, IA	1992	NA	6319	6051	268	4.2
CN1917700000000	19	177	Van Buren County, IA	1992	NA	3838	3645	193	5
CN1917900000000	19	179	Wapello County, IA	1992	NA	17879	16703	1176	6.6
CN1918100000000	19	181	Warren County, IA	1992	NA	21529	20861	668	3.1
CN1918300000000	19	183	Washington County, IA	1992	NA	10963	10584	379	3.5
CN1918500000000	19	185	Wayne County, IA	1992	NA	3311	3139	172	5.2
CN1918700000000	19	187	Webster County, IA	1992	NA	19864	18756	1108	5.6
CN1918900000000	19	189	Winnebago County, IA	1992	NA	6375	6145	230	3.6
CN1919100000000	19	191	Winneshiek County, IA	1992	NA	11760	11103	657	5.6
CN1919300000000	19	193	Woodbury County, IA	1992	NA	52830	50682	2148	4.1
CN1919500000000	19	195	Worth County, IA	1992	NA	3940	3749	191	4.8
CN1919700000000	19	197	Wright County, IA	1992	NA	7209	6889	320	4.4
CN2000100000000	20	001	Allen County, KS	1992	NA	6638	6296	342	5.2
CN2000300000000	20	003	Anderson County, KS	1992	NA	3874	3616	258	6.7
CN2000500000000	20	005	Atchison County, KS	1992	NA	8325	7778	547	6.6
CN2000700000000	20	007	Barber County, KS	1992	NA	2771	2694	77	2.8
CN2000900000000	20	009	Barton County, KS	1992	NA	15415	14781	634	4.1
CN2001100000000	20	011	Bourbon County, KS	1992	NA	6805	6419	386	5.7
CN2001300000000	20	013	Brown County, KS	1992	NA	4867	4603	264	5.4
CN2001500000000	20	015	Butler County, KS	1992	NA	27683	26538	1145	4.1
CN2001700000000	20	017	Chase County, KS	1992	NA	1427	1360	67	4.7
CN2001900000000	20	019	Chautauqua County, KS	1992	NA	1769	1648	121	6.8
CN2002100000000	20	021	Cherokee County, KS	1992	NA	9906	9113	793	8
CN2002300000000	20	023	Cheyenne County, KS	1992	NA	1511	1485	26	1.7
CN2002500000000	20	025	Clark County, KS	1992	NA	1271	1252	19	1.5
CN2002700000000	20	027	Clay County, KS	1992	NA	4672	4503	169	3.6
CN2002900000000	20	029	Cloud County, KS	1992	NA	5329	5179	150	2.8
CN2003100000000	20	031	Coffey County, KS	1992	NA	4213	3942	271	6.4
CN2003300000000	20	033	Comanche County, KS	1992	NA	1061	1050	11	1
CN2003500000000	20	035	Cowley County, KS	1992	NA	18122	17148	974	5.4
CN2003700000000	20	037	Crawford County, KS	1992	NA	16640	15742	898	5.4
CN2003900000000	20	039	Decatur County, KS	1992	NA	1969	1925	44	2.2
CN2004100000000	20	041	Dickinson County, KS	1992	NA	9929	9571	358	3.6
CN2004300000000	20	043	Doniphan County, KS	1992	NA	3762	3525	237	6.3
CN2004500000000	20	045	Douglas County, KS	1992	NA	47768	45723	2045	4.3
CN2004700000000	20	047	Edwards County, KS	1992	NA	1803	1746	57	3.2
CN2004900000000	20	049	Elk County, KS	1992	NA	1498	1427	71	4.7
CN2005100000000	20	051	Ellis County, KS	1992	NA	15189	14633	556	3.7
CN2005300000000	20	053	Ellsworth County, KS	1992	NA	2925	2815	110	3.8
CN2005500000000	20	055	Finney County, KS	1992	NA	18781	18118	663	3.5
CN2005700000000	20	057	Ford County, KS	1992	NA	14263	13804	459	3.2
CN2005900000000	20	059	Franklin County, KS	1992	NA	11667	11005	662	5.7
CN2006100000000	20	061	Geary County, KS	1992	NA	11755	10965	790	6.7
CN2006300000000	20	063	Gove County, KS	1992	NA	1474	1445	29	2
CN2006500000000	20	065	Graham County, KS	1992	NA	1703	1660	43	2.5
CN2006700000000	20	067	Grant County, KS	1992	NA	3755	3649	106	2.8
CN2006900000000	20	069	Gray County, KS	1992	NA	2648	2580	68	2.6
CN2007100000000	20	071	Greeley County, KS	1992	NA	863	837	26	3
CN2007300000000	20	073	Greenwood County, KS	1992	NA	3561	3374	187	5.3
CN2007500000000	20	075	Hamilton County, KS	1992	NA	1235	1212	23	1.9
CN2007700000000	20	077	Harper County, KS	1992	NA	3147	3033	114	3.6
CN2007900000000	20	079	Harvey County, KS	1992	NA	16429	15753	676	4.1
CN2008100000000	20	081	Haskell County, KS	1992	NA	1953	1910	43	2.2
CN2008300000000	20	083	Hodgeman County, KS	1992	NA	945	928	17	1.8
CN2008500000000	20	085	Jackson County, KS	1992	NA	5928	5594	334	5.6
CN2008700000000	20	087	Jefferson County, KS	1992	NA	8850	8426	424	4.8
CN2008900000000	20	089	Jewell County, KS	1992	NA	2112	2074	38	1.8
CN2009100000000	20	091	Johnson County, KS	1992	NA	220417	213471	6946	3.2
CN2009300000000	20	093	Kearny County, KS	1992	NA	2094	2035	59	2.8
CN2009500000000	20	095	Kingman County, KS	1992	NA	3983	3809	174	4.4
CN2009700000000	20	097	Kiowa County, KS	1992	NA	1725	1682	43	2.5
CN2009900000000	20	099	Labette County, KS	1992	NA	11317	10324	993	8.8
CN2010100000000	20	101	Lane County, KS	1992	NA	1098	1083	15	1.4
CN2010300000000	20	103	Leavenworth County, KS	1992	NA	26326	24947	1379	5.2
CN2010500000000	20	105	Lincoln County, KS	1992	NA	1847	1785	62	3.4
CN2010700000000	20	107	Linn County, KS	1992	NA	3355	3021	334	10
CN2010900000000	20	109	Logan County, KS	1992	NA	1599	1538	61	3.8
CN2011100000000	20	111	Lyon County, KS	1992	NA	19193	18353	840	4.4
CN2011300000000	20	113	McPherson County, KS	1992	NA	14735	14298	437	3
CN2011500000000	20	115	Marion County, KS	1992	NA	6626	6426	200	3
CN2011700000000	20	117	Marshall County, KS	1992	NA	5502	5369	133	2.4
CN2011900000000	20	119	Meade County, KS	1992	NA	2128	2079	49	2.3
CN2012100000000	20	121	Miami County, KS	1992	NA	12404	11742	662	5.3
CN2012300000000	20	123	Mitchell County, KS	1992	NA	3596	3481	115	3.2
CN2012500000000	20	125	Montgomery County, KS	1992	NA	17860	16693	1167	6.5
CN2012700000000	20	127	Morris County, KS	1992	NA	2984	2846	138	4.6
CN2012900000000	20	129	Morton County, KS	1992	NA	1653	1597	56	3.4
CN2013100000000	20	131	Nemaha County, KS	1992	NA	5394	5271	123	2.3
CN2013300000000	20	133	Neosho County, KS	1992	NA	8731	8299	432	4.9
CN2013500000000	20	135	Ness County, KS	1992	NA	1979	1928	51	2.6
CN2013700000000	20	137	Norton County, KS	1992	NA	2860	2809	51	1.8
CN2013900000000	20	139	Osage County, KS	1992	NA	7748	7228	520	6.7
CN2014100000000	20	141	Osborne County, KS	1992	NA	2530	2474	56	2.2
CN2014300000000	20	143	Ottawa County, KS	1992	NA	2820	2728	92	3.3
CN2014500000000	20	145	Pawnee County, KS	1992	NA	3906	3790	116	3
CN2014700000000	20	147	Phillips County, KS	1992	NA	3173	3100	73	2.3
CN2014900000000	20	149	Pottawatomie County, KS	1992	NA	8846	8475	371	4.2
CN2015100000000	20	151	Pratt County, KS	1992	NA	4933	4786	147	3
CN2015300000000	20	153	Rawlins County, KS	1992	NA	1621	1591	30	1.9
CN2015500000000	20	155	Reno County, KS	1992	NA	31399	29870	1529	4.9
CN2015700000000	20	157	Republic County, KS	1992	NA	3330	3281	49	1.5
CN2015900000000	20	159	Rice County, KS	1992	NA	5018	4789	229	4.6
CN2016100000000	20	161	Riley County, KS	1992	NA	28863	27631	1232	4.3
CN2016300000000	20	163	Rooks County, KS	1992	NA	2864	2773	91	3.2
CN2016500000000	20	165	Rush County, KS	1992	NA	1893	1837	56	3
CN2016700000000	20	167	Russell County, KS	1992	NA	3863	3738	125	3.2
CN2016900000000	20	169	Saline County, KS	1992	NA	28697	27659	1038	3.6
CN2017100000000	20	171	Scott County, KS	1992	NA	2714	2645	69	2.5
CN2017300000000	20	173	Sedgwick County, KS	1992	NA	223556	213566	9990	4.5
CN2017500000000	20	175	Seward County, KS	1992	NA	9918	9492	426	4.3
CN2017700000000	20	177	Shawnee County, KS	1992	NA	87840	83789	4051	4.6
CN2017900000000	20	179	Sheridan County, KS	1992	NA	1475	1448	27	1.8
CN2018100000000	20	181	Sherman County, KS	1992	NA	3693	3593	100	2.7
CN2018300000000	20	183	Smith County, KS	1992	NA	2450	2403	47	1.9
CN2018500000000	20	185	Stafford County, KS	1992	NA	2421	2355	66	2.7
CN2018700000000	20	187	Stanton County, KS	1992	NA	1067	1043	24	2.2
CN2018900000000	20	189	Stevens County, KS	1992	NA	2490	2414	76	3.1
CN2019100000000	20	191	Sumner County, KS	1992	NA	12540	11849	691	5.5
CN2019300000000	20	193	Thomas County, KS	1992	NA	4382	4275	107	2.4
CN2019500000000	20	195	Trego County, KS	1992	NA	1838	1799	39	2.1
CN2019700000000	20	197	Wabaunsee County, KS	1992	NA	3358	3196	162	4.8
CN2019900000000	20	199	Wallace County, KS	1992	NA	817	800	17	2.1
CN2020100000000	20	201	Washington County, KS	1992	NA	3608	3490	118	3.3
CN2020300000000	20	203	Wichita County, KS	1992	NA	1260	1234	26	2.1
CN2020500000000	20	205	Wilson County, KS	1992	NA	4724	4448	276	5.8
CN2020700000000	20	207	Woodson County, KS	1992	NA	1837	1747	90	4.9
CN2020900000000	20	209	Wyandotte County, KS	1992	NA	77728	71092	6636	8.5
CN2100100000000	21	001	Adair County, KY	1992	NA	7586	7046	540	7.1
CN2100300000000	21	003	Allen County, KY	1992	NA	7164	6664	500	7
CN2100500000000	21	005	Anderson County, KY	1992	NA	8399	8054	345	4.1
CN2100700000000	21	007	Ballard County, KY	1992	NA	3853	3471	382	9.9
CN2100900000000	21	009	Barren County, KY	1992	NA	16956	15849	1107	6.5
CN2101100000000	21	011	Bath County, KY	1992	NA	4567	4047	520	11.4
CN2101300000000	21	013	Bell County, KY	1992	NA	10321	9087	1234	12
CN2101500000000	21	015	Boone County, KY	1992	NA	33952	32001	1951	5.7
CN2101700000000	21	017	Bourbon County, KY	1992	NA	9405	8971	434	4.6
CN2101900000000	21	019	Boyd County, KY	1992	NA	23052	20803	2249	9.8
CN2102100000000	21	021	Boyle County, KY	1992	NA	12892	12098	794	6.2
CN2102300000000	21	023	Bracken County, KY	1992	NA	3590	3288	302	8.4
CN2102500000000	21	025	Breathitt County, KY	1992	NA	5026	4314	712	14.2
CN2102700000000	21	027	Breckinridge County, KY	1992	NA	7312	6718	594	8.1
CN2102900000000	21	029	Bullitt County, KY	1992	NA	26565	25434	1131	4.3
CN2103100000000	21	031	Butler County, KY	1992	NA	5492	5038	454	8.3
CN2103300000000	21	033	Caldwell County, KY	1992	NA	6255	5503	752	12
CN2103500000000	21	035	Calloway County, KY	1992	NA	15929	15053	876	5.5
CN2103700000000	21	037	Campbell County, KY	1992	NA	43360	40595	2765	6.4
CN2103900000000	21	039	Carlisle County, KY	1992	NA	2597	2380	217	8.4
CN2104100000000	21	041	Carroll County, KY	1992	NA	4497	4283	214	4.8
CN2104300000000	21	043	Carter County, KY	1992	NA	10909	9216	1693	15.5
CN2104500000000	21	045	Casey County, KY	1992	NA	6987	6519	468	6.7
CN2104700000000	21	047	Christian County, KY	1992	NA	22559	21243	1316	5.8
CN2104900000000	21	049	Clark County, KY	1992	NA	14564	13694	870	6
CN2105100000000	21	051	Clay County, KY	1992	NA	6858	6160	698	10.2
CN2105300000000	21	053	Clinton County, KY	1992	NA	4473	3990	483	10.8
CN2105500000000	21	055	Crittenden County, KY	1992	NA	3850	3492	358	9.3
CN2105700000000	21	057	Cumberland County, KY	1992	NA	2971	2621	350	11.8
CN2105900000000	21	059	Daviess County, KY	1992	NA	45012	41721	3291	7.3
CN2106100000000	21	061	Edmonson County, KY	1992	NA	4581	4019	562	12.3
CN2106300000000	21	063	Elliott County, KY	1992	NA	2411	1999	412	17.1
CN2106500000000	21	065	Estill County, KY	1992	NA	5753	5202	551	9.6
CN2106700000000	21	067	Fayette County, KY	1992	NA	128105	123382	4723	3.7
CN2106900000000	21	069	Fleming County, KY	1992	NA	6103	5682	421	6.9
CN2107100000000	21	071	Floyd County, KY	1992	NA	15051	13404	1647	10.9
CN2107300000000	21	073	Franklin County, KY	1992	NA	24232	23293	939	3.9
CN2107500000000	21	075	Fulton County, KY	1992	NA	3668	3347	321	8.8
CN2107700000000	21	077	Gallatin County, KY	1992	NA	2770	2583	187	6.8
CN2107900000000	21	079	Garrard County, KY	1992	NA	6052	5645	407	6.7
CN2108100000000	21	081	Grant County, KY	1992	NA	8196	7516	680	8.3
CN2108300000000	21	083	Graves County, KY	1992	NA	15703	14577	1126	7.2
CN2108500000000	21	085	Grayson County, KY	1992	NA	10025	9199	826	8.2
CN2108700000000	21	087	Green County, KY	1992	NA	5243	4957	286	5.5
CN2108900000000	21	089	Greenup County, KY	1992	NA	16494	14845	1649	10
CN2109100000000	21	091	Hancock County, KY	1992	NA	3407	3043	364	10.7
CN2109300000000	21	093	Hardin County, KY	1992	NA	34459	32014	2445	7.1
CN2109500000000	21	095	Harlan County, KY	1992	NA	11026	9292	1734	15.7
CN2109700000000	21	097	Harrison County, KY	1992	NA	7583	7096	487	6.4
CN2109900000000	21	099	Hart County, KY	1992	NA	7198	6700	498	6.9
CN2110100000000	21	101	Henderson County, KY	1992	NA	22316	20758	1558	7
CN2110300000000	21	103	Henry County, KY	1992	NA	7077	6767	310	4.4
CN2110500000000	21	105	Hickman County, KY	1992	NA	2529	2373	156	6.2
CN2110700000000	21	107	Hopkins County, KY	1992	NA	20876	18826	2050	9.8
CN2110900000000	21	109	Jackson County, KY	1992	NA	4545	4076	469	10.3
CN2111100000000	21	111	Jefferson County, KY	1992	NA	351830	332202	19628	5.6
CN2111300000000	21	113	Jessamine County, KY	1992	NA	17094	16410	684	4
CN2111500000000	21	115	Johnson County, KY	1992	NA	9472	8671	801	8.5
CN2111700000000	21	117	Kenton County, KY	1992	NA	75418	70967	4451	5.9
CN2111900000000	21	119	Knott County, KY	1992	NA	5803	5079	724	12.5
CN2112100000000	21	121	Knox County, KY	1992	NA	10302	9335	967	9.4
CN2112300000000	21	123	Larue County, KY	1992	NA	5793	5461	332	5.7
CN2112500000000	21	125	Laurel County, KY	1992	NA	19450	17839	1611	8.3
CN2112700000000	21	127	Lawrence County, KY	1992	NA	4831	4183	648	13.4
CN2112900000000	21	129	Lee County, KY	1992	NA	2377	2111	266	11.2
CN2113100000000	21	131	Leslie County, KY	1992	NA	4344	3927	417	9.6
CN2113300000000	21	133	Letcher County, KY	1992	NA	8678	7183	1495	17.2
CN2113500000000	21	135	Lewis County, KY	1992	NA	5710	4847	863	15.1
CN2113700000000	21	137	Lincoln County, KY	1992	NA	9384	8753	631	6.7
CN2113900000000	21	139	Livingston County, KY	1992	NA	4665	4223	442	9.5
CN2114100000000	21	141	Logan County, KY	1992	NA	12313	11637	676	5.5
CN2114300000000	21	143	Lyon County, KY	1992	NA	2890	2658	232	8
CN2114500000000	21	145	McCracken County, KY	1992	NA	31654	30030	1624	5.1
CN2114700000000	21	147	McCreary County, KY	1992	NA	5625	4909	716	12.7
CN2114900000000	21	149	McLean County, KY	1992	NA	4272	3704	568	13.3
CN2115100000000	21	151	Madison County, KY	1992	NA	29939	28646	1293	4.3
CN2115300000000	21	153	Magoffin County, KY	1992	NA	4352	3651	701	16.1
CN2115500000000	21	155	Marion County, KY	1992	NA	8406	7810	596	7.1
CN2115700000000	21	157	Marshall County, KY	1992	NA	13120	12011	1109	8.5
CN2115900000000	21	159	Martin County, KY	1992	NA	3683	3297	386	10.5
CN2116100000000	21	161	Mason County, KY	1992	NA	8310	7737	573	6.9
CN2116300000000	21	163	Meade County, KY	1992	NA	9229	8631	598	6.5
CN2116500000000	21	165	Menifee County, KY	1992	NA	2209	1917	292	13.2
CN2116700000000	21	167	Mercer County, KY	1992	NA	9991	9211	780	7.8
CN2116900000000	21	169	Metcalfe County, KY	1992	NA	4501	4182	319	7.1
CN2117100000000	21	171	Monroe County, KY	1992	NA	4929	4675	254	5.2
CN2117300000000	21	173	Montgomery County, KY	1992	NA	9693	8817	876	9
CN2117500000000	21	175	Morgan County, KY	1992	NA	4388	3834	554	12.6
CN2117700000000	21	177	Muhlenberg County, KY	1992	NA	11874	10405	1469	12.4
CN2117900000000	21	179	Nelson County, KY	1992	NA	15679	14417	1262	8
CN2118100000000	21	181	Nicholas County, KY	1992	NA	3540	3335	205	5.8
CN2118300000000	21	183	Ohio County, KY	1992	NA	9095	8040	1055	11.6
CN2118500000000	21	185	Oldham County, KY	1992	NA	18635	18072	563	3
CN2118700000000	21	187	Owen County, KY	1992	NA	4450	4252	198	4.4
CN2118900000000	21	189	Owsley County, KY	1992	NA	1530	1403	127	8.3
CN2119100000000	21	191	Pendleton County, KY	1992	NA	5968	5512	456	7.6
CN2119300000000	21	193	Perry County, KY	1992	NA	11287	10043	1244	11
CN2119500000000	21	195	Pike County, KY	1992	NA	26821	23631	3190	11.9
CN2119700000000	21	197	Powell County, KY	1992	NA	5784	5233	551	9.5
CN2119900000000	21	199	Pulaski County, KY	1992	NA	23160	21196	1964	8.5
CN2120100000000	21	201	Robertson County, KY	1992	NA	941	874	67	7.1
CN2120300000000	21	203	Rockcastle County, KY	1992	NA	5812	5261	551	9.5
CN2120500000000	21	205	Rowan County, KY	1992	NA	8972	8288	684	7.6
CN2120700000000	21	207	Russell County, KY	1992	NA	6816	6034	782	11.5
CN2120900000000	21	209	Scott County, KY	1992	NA	13290	12729	561	4.2
CN2121100000000	21	211	Shelby County, KY	1992	NA	14402	13970	432	3
CN2121300000000	21	213	Simpson County, KY	1992	NA	7920	7366	554	7
CN2121500000000	21	215	Spencer County, KY	1992	NA	3833	3718	115	3
CN2121700000000	21	217	Taylor County, KY	1992	NA	11214	10665	549	4.9
CN2121900000000	21	219	Todd County, KY	1992	NA	5169	4903	266	5.1
CN2122100000000	21	221	Trigg County, KY	1992	NA	5463	5144	319	5.8
CN2122300000000	21	223	Trimble County, KY	1992	NA	2858	2711	147	5.1
CN2122500000000	21	225	Union County, KY	1992	NA	7214	6591	623	8.6
CN2122700000000	21	227	Warren County, KY	1992	NA	44250	41764	2486	5.6
CN2122900000000	21	229	Washington County, KY	1992	NA	5174	4922	252	4.9
CN2123100000000	21	231	Wayne County, KY	1992	NA	7222	6564	658	9.1
CN2123300000000	21	233	Webster County, KY	1992	NA	5965	5274	691	11.6
CN2123500000000	21	235	Whitley County, KY	1992	NA	13067	11834	1233	9.4
CN2123700000000	21	237	Wolfe County, KY	1992	NA	2976	2678	298	10
CN2123900000000	21	239	Woodford County, KY	1992	NA	11467	11115	352	3.1
CN2200100000000	22	001	Acadia Parish, LA	1992	NA	22166	20162	2004	9
CN2200300000000	22	003	Allen Parish, LA	1992	NA	8179	7266	913	11.2
CN2200500000000	22	005	Ascension Parish, LA	1992	NA	28437	26562	1875	6.6
CN2200700000000	22	007	Assumption Parish, LA	1992	NA	9038	8121	917	10.1
CN2200900000000	22	009	Avoyelles Parish, LA	1992	NA	14586	12839	1747	12
CN2201100000000	22	011	Beauregard Parish, LA	1992	NA	12160	11074	1086	8.9
CN2201300000000	22	013	Bienville Parish, LA	1992	NA	6448	5951	497	7.7
CN2201500000000	22	015	Bossier Parish, LA	1992	NA	40836	38297	2539	6.2
CN2201700000000	22	017	Caddo Parish, LA	1992	NA	114306	106978	7328	6.4
CN2201900000000	22	019	Calcasieu Parish, LA	1992	NA	82399	75891	6508	7.9
CN2202100000000	22	021	Caldwell Parish, LA	1992	NA	4046	3654	392	9.7
CN2202300000000	22	023	Cameron Parish, LA	1992	NA	3819	3524	295	7.7
CN2202500000000	22	025	Catahoula Parish, LA	1992	NA	4897	4349	548	11.2
CN2202700000000	22	027	Claiborne Parish, LA	1992	NA	6103	5570	533	8.7
CN2202900000000	22	029	Concordia Parish, LA	1992	NA	8629	7511	1118	13
CN2203100000000	22	031	De Soto Parish, LA	1992	NA	10220	9098	1122	11
CN2203300000000	22	033	East Baton Rouge Parish, LA	1992	NA	202034	192360	9674	4.8
CN2203500000000	22	035	East Carroll Parish, LA	1992	NA	3621	3067	554	15.3
CN2203700000000	22	037	East Feliciana Parish, LA	1992	NA	7468	6983	485	6.5
CN2203900000000	22	039	Evangeline Parish, LA	1992	NA	12432	11233	1199	9.6
CN2204100000000	22	041	Franklin Parish, LA	1992	NA	10512	9351	1161	11
CN2204300000000	22	043	Grant Parish, LA	1992	NA	6988	6310	678	9.7
CN2204500000000	22	045	Iberia Parish, LA	1992	NA	30197	27310	2887	9.6
CN2204700000000	22	047	Iberville Parish, LA	1992	NA	13553	12224	1329	9.8
CN2204900000000	22	049	Jackson Parish, LA	1992	NA	6454	6088	366	5.7
CN2205100000000	22	051	Jefferson Parish, LA	1992	NA	232539	212874	19665	8.5
CN2205300000000	22	053	Jefferson Davis Parish, LA	1992	NA	12486	11156	1330	10.7
CN2205500000000	22	055	Lafayette Parish, LA	1992	NA	85829	80589	5240	6.1
CN2205700000000	22	057	Lafourche Parish, LA	1992	NA	36410	34113	2297	6.3
CN2205900000000	22	059	LaSalle Parish, LA	1992	NA	6260	5770	490	7.8
CN2206100000000	22	061	Lincoln Parish, LA	1992	NA	18954	18446	508	2.7
CN2206300000000	22	063	Livingston Parish, LA	1992	NA	35045	32477	2568	7.3
CN2206500000000	22	065	Madison Parish, LA	1992	NA	4964	4351	613	12.3
CN2206700000000	22	067	Morehouse Parish, LA	1992	NA	13226	12006	1220	9.2
CN2206900000000	22	069	Natchitoches Parish, LA	1992	NA	15955	14672	1283	8
CN2207100000000	22	071	Orleans Parish, LA	1992	NA	204982	184792	20190	9.8
CN2207300000000	22	073	Ouachita Parish, LA	1992	NA	66911	63114	3797	5.7
CN2207500000000	22	075	Plaquemines Parish, LA	1992	NA	10515	9364	1151	10.9
CN2207700000000	22	077	Pointe Coupee Parish, LA	1992	NA	9194	8303	891	9.7
CN2207900000000	22	079	Rapides Parish, LA	1992	NA	56250	52595	3655	6.5
CN2208100000000	22	081	Red River Parish, LA	1992	NA	3769	3368	401	10.6
CN2208300000000	22	083	Richland Parish, LA	1992	NA	8710	7716	994	11.4
CN2208500000000	22	085	Sabine Parish, LA	1992	NA	9256	8554	702	7.6
CN2208700000000	22	087	St. Bernard Parish, LA	1992	NA	31338	28078	3260	10.4
CN2208900000000	22	089	St. Charles Parish, LA	1992	NA	20810	18653	2157	10.4
CN2209100000000	22	091	St. Helena Parish, LA	1992	NA	3855	3588	267	6.9
CN2209300000000	22	093	St. James Parish, LA	1992	NA	8794	7933	861	9.8
CN2209500000000	22	095	St. John the Baptist Parish, LA	1992	NA	18625	16508	2117	11.4
CN2209700000000	22	097	St. Landry Parish, LA	1992	NA	30269	27124	3145	10.4
CN2209900000000	22	099	St. Martin Parish, LA	1992	NA	19413	17807	1606	8.3
CN2210100000000	22	101	St. Mary Parish, LA	1992	NA	24752	21600	3152	12.7
CN2210300000000	22	103	St. Tammany Parish, LA	1992	NA	73287	66949	6338	8.6
CN2210500000000	22	105	Tangipahoa Parish, LA	1992	NA	37945	34480	3465	9.1
CN2210700000000	22	107	Tensas Parish, LA	1992	NA	2994	2752	242	8.1
CN2210900000000	22	109	Terrebonne Parish, LA	1992	NA	41684	38217	3467	8.3
CN2211100000000	22	111	Union Parish, LA	1992	NA	9643	8980	663	6.9
CN2211300000000	22	113	Vermilion Parish, LA	1992	NA	21315	19177	2138	10
CN2211500000000	22	115	Vernon Parish, LA	1992	NA	16680	15413	1267	7.6
CN2211700000000	22	117	Washington Parish, LA	1992	NA	16433	14709	1724	10.5
CN2211900000000	22	119	Webster Parish, LA	1992	NA	18063	16256	1807	10
CN2212100000000	22	121	West Baton Rouge Parish, LA	1992	NA	9436	8822	614	6.5
CN2212300000000	22	123	West Carroll Parish, LA	1992	NA	5487	4609	878	16
CN2212500000000	22	125	West Feliciana Parish, LA	1992	NA	4146	3905	241	5.8
CN2212700000000	22	127	Winn Parish, LA	1992	NA	6078	5749	329	5.4
CN2300100000000	23	001	Androscoggin County, ME	1992	NA	56685	51829	4856	8.6
CN2300300000000	23	003	Aroostook County, ME	1992	NA	41171	36939	4232	10.3
CN2300500000000	23	005	Cumberland County, ME	1992	NA	132937	125605	7332	5.5
CN2300700000000	23	007	Franklin County, ME	1992	NA	15038	13816	1222	8.1
CN2300900000000	23	009	Hancock County, ME	1992	NA	25761	23821	1940	7.5
CN2301100000000	23	011	Kennebec County, ME	1992	NA	61380	56994	4386	7.1
CN2301300000000	23	013	Knox County, ME	1992	NA	18613	17438	1175	6.3
CN2301500000000	23	015	Lincoln County, ME	1992	NA	16252	15300	952	5.9
CN2301700000000	23	017	Oxford County, ME	1992	NA	25872	23636	2236	8.6
CN2301900000000	23	019	Penobscot County, ME	1992	NA	75427	70068	5359	7.1
CN2302100000000	23	021	Piscataquis County, ME	1992	NA	8762	7982	780	8.9
CN2302300000000	23	023	Sagadahoc County, ME	1992	NA	16331	15451	880	5.4
CN2302500000000	23	025	Somerset County, ME	1992	NA	26375	23775	2600	9.9
CN2302700000000	23	027	Waldo County, ME	1992	NA	16938	15457	1481	8.7
CN2302900000000	23	029	Washington County, ME	1992	NA	16626	14970	1656	10
CN2303100000000	23	031	York County, ME	1992	NA	90295	84251	6044	6.7
CN2400100000000	24	001	Allegany County, MD	1992	NA	33178	28683	4495	13.5
CN2400300000000	24	003	Anne Arundel County, MD	1992	NA	234856	221325	13531	5.8
CN2400500000000	24	005	Baltimore County, MD	1992	NA	384778	357202	27576	7.2
CN2400900000000	24	009	Calvert County, MD	1992	NA	30805	28996	1809	5.9
CN2401100000000	24	011	Caroline County, MD	1992	NA	14820	13571	1249	8.4
CN2401300000000	24	013	Carroll County, MD	1992	NA	70896	66666	4230	6
CN2401500000000	24	015	Cecil County, MD	1992	NA	36485	32559	3926	10.8
CN2401700000000	24	017	Charles County, MD	1992	NA	56748	53556	3192	5.6
CN2401900000000	24	019	Dorchester County, MD	1992	NA	15117	13181	1936	12.8
CN2402100000000	24	021	Frederick County, MD	1992	NA	88752	83759	4993	5.6
CN2402300000000	24	023	Garrett County, MD	1992	NA	13633	11777	1856	13.6
CN2402500000000	24	025	Harford County, MD	1992	NA	103334	95852	7482	7.2
CN2402700000000	24	027	Howard County, MD	1992	NA	117383	112356	5027	4.3
CN2402900000000	24	029	Kent County, MD	1992	NA	9676	8884	792	8.2
CN2403100000000	24	031	Montgomery County, MD	1992	NA	449828	433162	16666	3.7
CN2403300000000	24	033	Prince George's County, MD	1992	NA	437449	412276	25173	5.8
CN2403500000000	24	035	Queen Anne's County, MD	1992	NA	18574	17328	1246	6.7
CN2403700000000	24	037	St. Mary's County, MD	1992	NA	39489	36826	2663	6.7
CN2403900000000	24	039	Somerset County, MD	1992	NA	11141	9774	1367	12.3
CN2404100000000	24	041	Talbot County, MD	1992	NA	16984	16086	898	5.3
CN2404300000000	24	043	Washington County, MD	1992	NA	64044	58032	6012	9.4
CN2404500000000	24	045	Wicomico County, MD	1992	NA	45996	41882	4114	8.9
CN2404700000000	24	047	Worcester County, MD	1992	NA	23192	20477	2715	11.7
CN2451000000000	24	510	Baltimore city, MD	1992	NA	334196	297002	37194	11.1
CN2500100000000	25	001	Barnstable County, MA	1992	NA	97556	87507	10049	10.3
CN2500300000000	25	003	Berkshire County, MA	1992	NA	68515	61510	7005	10.2
CN2500500000000	25	005	Bristol County, MA	1992	NA	264455	233850	30605	11.6
CN2500700000000	25	007	Dukes County, MA	1992	NA	7514	6945	569	7.6
CN2500900000000	25	009	Essex County, MA	1992	NA	349336	318433	30903	8.8
CN2501100000000	25	011	Franklin County, MA	1992	NA	36983	34128	2855	7.7
CN2501300000000	25	013	Hampden County, MA	1992	NA	219797	199858	19939	9.1
CN2501500000000	25	015	Hampshire County, MA	1992	NA	78992	73825	5167	6.5
CN2501700000000	25	017	Middlesex County, MA	1992	NA	787340	730903	56437	7.2
CN2501900000000	25	019	Nantucket County/town, MA	1992	NA	4966	4742	224	4.5
CN2502100000000	25	021	Norfolk County, MA	1992	NA	342195	318041	24154	7.1
CN2502300000000	25	023	Plymouth County, MA	1992	NA	228026	205941	22085	9.7
CN2502500000000	25	025	Suffolk County, MA	1992	NA	333538	306170	27368	8.2
CN2502700000000	25	027	Worcester County, MA	1992	NA	361815	330175	31640	8.7
CN2600100000000	26	001	Alcona County, MI	1992	NA	4134	3476	658	15.9
CN2600300000000	26	003	Alger County, MI	1992	NA	3957	3513	444	11.2
CN2600500000000	26	005	Allegan County, MI	1992	NA	46233	43032	3201	6.9
CN2600700000000	26	007	Alpena County, MI	1992	NA	14845	12802	2043	13.8
CN2600900000000	26	009	Antrim County, MI	1992	NA	8990	7845	1145	12.7
CN2601100000000	26	011	Arenac County, MI	1992	NA	6217	5520	697	11.2
CN2601300000000	26	013	Baraga County, MI	1992	NA	3249	2764	485	14.9
CN2601500000000	26	015	Barry County, MI	1992	NA	25416	23439	1977	7.8
CN2601700000000	26	017	Bay County, MI	1992	NA	54375	49333	5042	9.3
CN2601900000000	26	019	Benzie County, MI	1992	NA	6320	5576	744	11.8
CN2602100000000	26	021	Berrien County, MI	1992	NA	80590	73545	7045	8.7
CN2602300000000	26	023	Branch County, MI	1992	NA	19270	17493	1777	9.2
CN2602500000000	26	025	Calhoun County, MI	1992	NA	64405	59690	4715	7.3
CN2602700000000	26	027	Cass County, MI	1992	NA	24257	22429	1828	7.5
CN2602900000000	26	029	Charlevoix County, MI	1992	NA	12014	10422	1592	13.3
CN2603100000000	26	031	Cheboygan County, MI	1992	NA	10749	9272	1477	13.7
CN2603300000000	26	033	Chippewa County, MI	1992	NA	15676	13708	1968	12.6
CN2603500000000	26	035	Clare County, MI	1992	NA	9855	8567	1288	13.1
CN2603700000000	26	037	Clinton County, MI	1992	NA	31282	29537	1745	5.6
CN2603900000000	26	039	Crawford County, MI	1992	NA	5614	5069	545	9.7
CN2604100000000	26	041	Delta County, MI	1992	NA	17630	15222	2408	13.7
CN2604300000000	26	043	Dickinson County, MI	1992	NA	12966	11715	1251	9.6
CN2604500000000	26	045	Eaton County, MI	1992	NA	51311	48551	2760	5.4
CN2604700000000	26	047	Emmet County, MI	1992	NA	15042	13115	1927	12.8
CN2604900000000	26	049	Genesee County, MI	1992	NA	198509	174737	23772	12
CN2605100000000	26	051	Gladwin County, MI	1992	NA	8226	7105	1121	13.6
CN2605300000000	26	053	Gogebic County, MI	1992	NA	7833	7068	765	9.8
CN2605500000000	26	055	Grand Traverse County, MI	1992	NA	38539	35426	3113	8.1
CN2605700000000	26	057	Gratiot County, MI	1992	NA	18210	16487	1723	9.5
CN2605900000000	26	059	Hillsdale County, MI	1992	NA	20978	19209	1769	8.4
CN2606100000000	26	061	Houghton County, MI	1992	NA	15186	13714	1472	9.7
CN2606300000000	26	063	Huron County, MI	1992	NA	15768	13830	1938	12.3
CN2606500000000	26	065	Ingham County, MI	1992	NA	147441	138795	8646	5.9
CN2606700000000	26	067	Ionia County, MI	1992	NA	26178	23714	2464	9.4
CN2606900000000	26	069	Iosco County, MI	1992	NA	11486	10203	1283	11.2
CN2607100000000	26	071	Iron County, MI	1992	NA	5407	4792	615	11.4
CN2607300000000	26	073	Isabella County, MI	1992	NA	25608	23729	1879	7.3
CN2607500000000	26	075	Jackson County, MI	1992	NA	71334	64522	6812	9.5
CN2607700000000	26	077	Kalamazoo County, MI	1992	NA	118859	112332	6527	5.5
CN2607900000000	26	079	Kalkaska County, MI	1992	NA	6587	5814	773	11.7
CN2608100000000	26	081	Kent County, MI	1992	NA	273206	252839	20367	7.5
CN2608300000000	26	083	Keweenaw County, MI	1992	NA	640	532	108	16.9
CN2608500000000	26	085	Lake County, MI	1992	NA	3070	2646	424	13.8
CN2608700000000	26	087	Lapeer County, MI	1992	NA	39143	34480	4663	11.9
CN2608900000000	26	089	Leelanau County, MI	1992	NA	9460	8734	726	7.7
CN2609100000000	26	091	Lenawee County, MI	1992	NA	45105	41564	3541	7.9
CN2609300000000	26	093	Livingston County, MI	1992	NA	67420	63268	4152	6.2
CN2609500000000	26	095	Luce County, MI	1992	NA	2376	1999	377	15.9
CN2609700000000	26	097	Mackinac County, MI	1992	NA	6443	5411	1032	16
CN2609900000000	26	099	Macomb County, MI	1992	NA	402350	366791	35559	8.8
CN2610100000000	26	101	Manistee County, MI	1992	NA	9753	8390	1363	14
CN2610300000000	26	103	Marquette County, MI	1992	NA	33068	30344	2724	8.2
CN2610500000000	26	105	Mason County, MI	1992	NA	13463	11819	1644	12.2
CN2610700000000	26	107	Mecosta County, MI	1992	NA	16346	14960	1386	8.5
CN2610900000000	26	109	Menominee County, MI	1992	NA	12536	11482	1054	8.4
CN2611100000000	26	111	Midland County, MI	1992	NA	39091	36306	2785	7.1
CN2611300000000	26	113	Missaukee County, MI	1992	NA	5547	5008	539	9.7
CN2611500000000	26	115	Monroe County, MI	1992	NA	66399	60139	6260	9.4
CN2611700000000	26	117	Montcalm County, MI	1992	NA	23394	20468	2926	12.5
CN2611900000000	26	119	Montmorency County, MI	1992	NA	3541	2868	673	19
CN2612100000000	26	121	Muskegon County, MI	1992	NA	74671	66506	8165	10.9
CN2612300000000	26	123	Newaygo County, MI	1992	NA	18540	16312	2228	12
CN2612500000000	26	125	Oakland County, MI	1992	NA	619725	573564	46161	7.4
CN2612700000000	26	127	Oceana County, MI	1992	NA	11530	9903	1627	14.1
CN2612900000000	26	129	Ogemaw County, MI	1992	NA	7497	6571	926	12.4
CN2613100000000	26	131	Ontonagon County, MI	1992	NA	4020	3612	408	10.1
CN2613300000000	26	133	Osceola County, MI	1992	NA	9484	8513	971	10.2
CN2613500000000	26	135	Oscoda County, MI	1992	NA	3168	2855	313	9.9
CN2613700000000	26	137	Otsego County, MI	1992	NA	10283	9327	956	9.3
CN2613900000000	26	139	Ottawa County, MI	1992	NA	107368	100823	6545	6.1
CN2614100000000	26	141	Presque Isle County, MI	1992	NA	6267	5243	1024	16.3
CN2614300000000	26	143	Roscommon County, MI	1992	NA	7436	6578	858	11.5
CN2614500000000	26	145	Saginaw County, MI	1992	NA	97781	89546	8235	8.4
CN2614700000000	26	147	St. Clair County, MI	1992	NA	74340	66091	8249	11.1
CN2614900000000	26	149	St. Joseph County, MI	1992	NA	29662	26965	2697	9.1
CN2615100000000	26	151	Sanilac County, MI	1992	NA	18775	16389	2386	12.7
CN2615300000000	26	153	Schoolcraft County, MI	1992	NA	3911	3327	584	14.9
CN2615500000000	26	155	Shiawassee County, MI	1992	NA	34941	30898	4043	11.6
CN2615700000000	26	157	Tuscola County, MI	1992	NA	26364	23471	2893	11
CN2615900000000	26	159	Van Buren County, MI	1992	NA	34259	30992	3267	9.5
CN2616100000000	26	161	Washtenaw County, MI	1992	NA	161343	153354	7989	5
CN2616300000000	26	163	Wayne County, MI	1992	NA	951152	849122	102030	10.7
CN2616500000000	26	165	Wexford County, MI	1992	NA	12855	11128	1727	13.4
CN2700100000000	27	001	Aitkin County, MN	1992	NA	5363	4725	638	11.9
CN2700300000000	27	003	Anoka County, MN	1992	NA	152933	145630	7303	4.8
CN2700500000000	27	005	Becker County, MN	1992	NA	12689	11263	1426	11.2
CN2700700000000	27	007	Beltrami County, MN	1992	NA	16604	15293	1311	7.9
CN2700900000000	27	009	Benton County, MN	1992	NA	17998	17005	993	5.5
CN2701100000000	27	011	Big Stone County, MN	1992	NA	2824	2681	143	5.1
CN2701300000000	27	013	Blue Earth County, MN	1992	NA	30856	29721	1135	3.7
CN2701500000000	27	015	Brown County, MN	1992	NA	14236	13520	716	5
CN2701700000000	27	017	Carlton County, MN	1992	NA	14481	13230	1251	8.6
CN2701900000000	27	019	Carver County, MN	1992	NA	30318	29136	1182	3.9
CN2702100000000	27	021	Cass County, MN	1992	NA	9848	8856	992	10.1
CN2702300000000	27	023	Chippewa County, MN	1992	NA	6152	5741	411	6.7
CN2702500000000	27	025	Chisago County, MN	1992	NA	16473	15352	1121	6.8
CN2702700000000	27	027	Clay County, MN	1992	NA	27859	26756	1103	4
CN2702900000000	27	029	Clearwater County, MN	1992	NA	3711	3044	667	18
CN2703100000000	27	031	Cook County, MN	1992	NA	2671	2501	170	6.4
CN2703300000000	27	033	Cottonwood County, MN	1992	NA	5899	5452	447	7.6
CN2703500000000	27	035	Crow Wing County, MN	1992	NA	22806	21025	1781	7.8
CN2703700000000	27	037	Dakota County, MN	1992	NA	177435	170271	7164	4
CN2703900000000	27	039	Dodge County, MN	1992	NA	8363	7872	491	5.9
CN2704100000000	27	041	Douglas County, MN	1992	NA	14655	13795	860	5.9
CN2704300000000	27	043	Faribault County, MN	1992	NA	8134	7664	470	5.8
CN2704500000000	27	045	Fillmore County, MN	1992	NA	10065	9515	550	5.5
CN2704700000000	27	047	Freeborn County, MN	1992	NA	17125	16378	747	4.4
CN2704900000000	27	049	Goodhue County, MN	1992	NA	23028	22132	896	3.9
CN2705100000000	27	051	Grant County, MN	1992	NA	2811	2625	186	6.6
CN2705300000000	27	053	Hennepin County, MN	1992	NA	621237	594348	26889	4.3
CN2705500000000	27	055	Houston County, MN	1992	NA	10173	9770	403	4
CN2705700000000	27	057	Hubbard County, MN	1992	NA	7059	6391	668	9.5
CN2705900000000	27	059	Isanti County, MN	1992	NA	13657	12743	914	6.7
CN2706100000000	27	061	Itasca County, MN	1992	NA	19052	16853	2199	11.5
CN2706300000000	27	063	Jackson County, MN	1992	NA	5345	5064	281	5.3
CN2706500000000	27	065	Kanabec County, MN	1992	NA	6772	6091	681	10.1
CN2706700000000	27	067	Kandiyohi County, MN	1992	NA	19322	18349	973	5
CN2706900000000	27	069	Kittson County, MN	1992	NA	2511	2312	199	7.9
CN2707100000000	27	071	Koochiching County, MN	1992	NA	6703	6004	699	10.4
CN2707300000000	27	073	Lac qui Parle County, MN	1992	NA	3911	3731	180	4.6
CN2707500000000	27	075	Lake County, MN	1992	NA	5559	5013	546	9.8
CN2707700000000	27	077	Lake of the Woods County, MN	1992	NA	2223	2100	123	5.5
CN2707900000000	27	079	Le Sueur County, MN	1992	NA	12683	11907	776	6.1
CN2708100000000	27	081	Lincoln County, MN	1992	NA	3050	2920	130	4.3
CN2708300000000	27	083	Lyon County, MN	1992	NA	14058	13546	512	3.6
CN2708500000000	27	085	McLeod County, MN	1992	NA	18941	17959	982	5.2
CN2708700000000	27	087	Mahnomen County, MN	1992	NA	2649	2419	230	8.7
CN2708900000000	27	089	Marshall County, MN	1992	NA	4770	4133	637	13.4
CN2709100000000	27	091	Martin County, MN	1992	NA	11662	10979	683	5.9
CN2709300000000	27	093	Meeker County, MN	1992	NA	9631	8798	833	8.6
CN2709500000000	27	095	Mille Lacs County, MN	1992	NA	9983	9197	786	7.9
CN2709700000000	27	097	Morrison County, MN	1992	NA	14268	12927	1341	9.4
CN2709900000000	27	099	Mower County, MN	1992	NA	18283	17615	668	3.7
CN2710100000000	27	101	Murray County, MN	1992	NA	4496	4229	267	5.9
CN2710300000000	27	103	Nicollet County, MN	1992	NA	16564	16007	557	3.4
CN2710500000000	27	105	Nobles County, MN	1992	NA	9965	9571	394	4
CN2710700000000	27	107	Norman County, MN	1992	NA	3479	3219	260	7.5
CN2710900000000	27	109	Olmsted County, MN	1992	NA	64346	62473	1873	2.9
CN2711100000000	27	111	Otter Tail County, MN	1992	NA	25088	23361	1727	6.9
CN2711300000000	27	113	Pennington County, MN	1992	NA	6968	6308	660	9.5
CN2711500000000	27	115	Pine County, MN	1992	NA	10532	9457	1075	10.2
CN2711700000000	27	117	Pipestone County, MN	1992	NA	4855	4626	229	4.7
CN2711900000000	27	119	Polk County, MN	1992	NA	15902	14937	965	6.1
CN2712100000000	27	121	Pope County, MN	1992	NA	5160	4872	288	5.6
CN2712300000000	27	123	Ramsey County, MN	1992	NA	272507	260625	11882	4.4
CN2712500000000	27	125	Red Lake County, MN	1992	NA	2069	1733	336	16.2
CN2712700000000	27	127	Redwood County, MN	1992	NA	9574	9222	352	3.7
CN2712900000000	27	129	Renville County, MN	1992	NA	8052	7514	538	6.7
CN2713100000000	27	131	Rice County, MN	1992	NA	28000	26431	1569	5.6
CN2713300000000	27	133	Rock County, MN	1992	NA	4668	4531	137	2.9
CN2713500000000	27	135	Roseau County, MN	1992	NA	8126	7756	370	4.6
CN2713700000000	27	137	St. Louis County, MN	1992	NA	98520	91030	7490	7.6
CN2713900000000	27	139	Scott County, MN	1992	NA	35821	34145	1676	4.7
CN2714100000000	27	141	Sherburne County, MN	1992	NA	24416	23018	1398	5.7
CN2714300000000	27	143	Sibley County, MN	1992	NA	6741	6298	443	6.6
CN2714500000000	27	145	Stearns County, MN	1992	NA	68686	65220	3466	5
CN2714700000000	27	147	Steele County, MN	1992	NA	16991	16196	795	4.7
CN2714900000000	27	149	Stevens County, MN	1992	NA	5125	4911	214	4.2
CN2715100000000	27	151	Swift County, MN	1992	NA	4756	4447	309	6.5
CN2715300000000	27	153	Todd County, MN	1992	NA	10202	9357	845	8.3
CN2715500000000	27	155	Traverse County, MN	1992	NA	1764	1669	95	5.4
CN2715700000000	27	157	Wabasha County, MN	1992	NA	10900	10379	521	4.8
CN2715900000000	27	159	Wadena County, MN	1992	NA	5819	5408	411	7.1
CN2716100000000	27	161	Waseca County, MN	1992	NA	9170	8707	463	5
CN2716300000000	27	163	Washington County, MN	1992	NA	89385	85714	3671	4.1
CN2716500000000	27	165	Watonwan County, MN	1992	NA	5856	5588	268	4.6
CN2716700000000	27	167	Wilkin County, MN	1992	NA	3602	3461	141	3.9
CN2716900000000	27	169	Winona County, MN	1992	NA	26564	25240	1324	5
CN2717100000000	27	171	Wright County, MN	1992	NA	39404	37064	2340	5.9
CN2717300000000	27	173	Yellow Medicine County, MN	1992	NA	5489	5190	299	5.4
CN2800100000000	28	001	Adams County, MS	1992	NA	14671	13491	1180	8
CN2800300000000	28	003	Alcorn County, MS	1992	NA	15551	14152	1399	9
CN2800500000000	28	005	Amite County, MS	1992	NA	5048	4693	355	7
CN2800700000000	28	007	Attala County, MS	1992	NA	7696	6789	907	11.8
CN2800900000000	28	009	Benton County, MS	1992	NA	3124	2850	274	8.8
CN2801100000000	28	011	Bolivar County, MS	1992	NA	17803	16208	1595	9
CN2801300000000	28	013	Calhoun County, MS	1992	NA	7255	6787	468	6.5
CN2801500000000	28	015	Carroll County, MS	1992	NA	4094	3810	284	6.9
CN2801700000000	28	017	Chickasaw County, MS	1992	NA	9059	8162	897	9.9
CN2801900000000	28	019	Choctaw County, MS	1992	NA	3409	2997	412	12.1
CN2802100000000	28	021	Claiborne County, MS	1992	NA	4021	3408	613	15.2
CN2802300000000	28	023	Clarke County, MS	1992	NA	8175	7480	695	8.5
CN2802500000000	28	025	Clay County, MS	1992	NA	9771	8754	1017	10.4
CN2802700000000	28	027	Coahoma County, MS	1992	NA	11808	10501	1307	11.1
CN2802900000000	28	029	Copiah County, MS	1992	NA	11207	10039	1168	10.4
CN2803100000000	28	031	Covington County, MS	1992	NA	7381	6749	632	8.6
CN2803300000000	28	033	DeSoto County, MS	1992	NA	38555	36302	2253	5.8
CN2803500000000	28	035	Forrest County, MS	1992	NA	31147	28868	2279	7.3
CN2803700000000	28	037	Franklin County, MS	1992	NA	3196	2923	273	8.5
CN2803900000000	28	039	George County, MS	1992	NA	7556	6499	1057	14
CN2804100000000	28	041	Greene County, MS	1992	NA	4560	4007	553	12.1
CN2804300000000	28	043	Grenada County, MS	1992	NA	9905	9062	843	8.5
CN2804500000000	28	045	Hancock County, MS	1992	NA	13593	12574	1019	7.5
CN2804700000000	28	047	Harrison County, MS	1992	NA	75234	69726	5508	7.3
CN2804900000000	28	049	Hinds County, MS	1992	NA	126324	118558	7766	6.1
CN2805100000000	28	051	Holmes County, MS	1992	NA	6889	6024	865	12.6
CN2805300000000	28	053	Humphreys County, MS	1992	NA	5326	4852	474	8.9
CN2805500000000	28	055	Issaquena County, MS	1992	NA	882	767	115	13
CN2805700000000	28	057	Itawamba County, MS	1992	NA	10590	9933	657	6.2
CN2805900000000	28	059	Jackson County, MS	1992	NA	58420	54325	4095	7
CN2806100000000	28	061	Jasper County, MS	1992	NA	7425	6526	899	12.1
CN2806300000000	28	063	Jefferson County, MS	1992	NA	2469	1950	519	21
CN2806500000000	28	065	Jefferson Davis County, MS	1992	NA	5169	4378	791	15.3
CN2806700000000	28	067	Jones County, MS	1992	NA	28252	26115	2137	7.6
CN2806900000000	28	069	Kemper County, MS	1992	NA	4167	3707	460	11
CN2807100000000	28	071	Lafayette County, MS	1992	NA	15391	14473	918	6
CN2807300000000	28	073	Lamar County, MS	1992	NA	14373	13503	870	6.1
CN2807500000000	28	075	Lauderdale County, MS	1992	NA	34233	31761	2472	7.2
CN2807700000000	28	077	Lawrence County, MS	1992	NA	5499	4941	558	10.1
CN2807900000000	28	079	Leake County, MS	1992	NA	8344	7696	648	7.8
CN2808100000000	28	081	Lee County, MS	1992	NA	36405	34140	2265	6.2
CN2808300000000	28	083	Leflore County, MS	1992	NA	15547	14006	1541	9.9
CN2808500000000	28	085	Lincoln County, MS	1992	NA	13071	11757	1314	10.1
CN2808700000000	28	087	Lowndes County, MS	1992	NA	26738	24604	2134	8
CN2808900000000	28	089	Madison County, MS	1992	NA	28228	26719	1509	5.3
CN2809100000000	28	091	Marion County, MS	1992	NA	10259	9083	1176	11.5
CN2809300000000	28	093	Marshall County, MS	1992	NA	13577	11996	1581	11.6
CN2809500000000	28	095	Monroe County, MS	1992	NA	16664	15228	1436	8.6
CN2809700000000	28	097	Montgomery County, MS	1992	NA	5337	4934	403	7.6
CN2809900000000	28	099	Neshoba County, MS	1992	NA	12598	11835	763	6.1
CN2810100000000	28	101	Newton County, MS	1992	NA	9068	8367	701	7.7
CN2810300000000	28	103	Noxubee County, MS	1992	NA	4461	3974	487	10.9
CN2810500000000	28	105	Oktibbeha County, MS	1992	NA	18748	17358	1390	7.4
CN2810700000000	28	107	Panola County, MS	1992	NA	13459	11864	1595	11.9
CN2810900000000	28	109	Pearl River County, MS	1992	NA	17220	15712	1508	8.8
CN2811100000000	28	111	Perry County, MS	1992	NA	4299	3762	537	12.5
CN2811300000000	28	113	Pike County, MS	1992	NA	15298	13814	1484	9.7
CN2811500000000	28	115	Pontotoc County, MS	1992	NA	12190	11355	835	6.8
CN2811700000000	28	117	Prentiss County, MS	1992	NA	11690	10821	869	7.4
CN2811900000000	28	119	Quitman County, MS	1992	NA	4269	3747	522	12.2
CN2812100000000	28	121	Rankin County, MS	1992	NA	48111	46079	2032	4.2
CN2812300000000	28	123	Scott County, MS	1992	NA	12590	11962	628	5
CN2812500000000	28	125	Sharkey County, MS	1992	NA	3112	2713	399	12.8
CN2812700000000	28	127	Simpson County, MS	1992	NA	10489	9883	606	5.8
CN2812900000000	28	129	Smith County, MS	1992	NA	6249	5830	419	6.7
CN2813100000000	28	131	Stone County, MS	1992	NA	5095	4565	530	10.4
CN2813300000000	28	133	Sunflower County, MS	1992	NA	12335	10935	1400	11.3
CN2813500000000	28	135	Tallahatchie County, MS	1992	NA	5865	5214	651	11.1
CN2813700000000	28	137	Tate County, MS	1992	NA	10333	9388	945	9.1
CN2813900000000	28	139	Tippah County, MS	1992	NA	9328	8566	762	8.2
CN2814100000000	28	141	Tishomingo County, MS	1992	NA	10365	9529	836	8.1
CN2814300000000	28	143	Tunica County, MS	1992	NA	3017	2611	406	13.5
CN2814500000000	28	145	Union County, MS	1992	NA	11582	10888	694	6
CN2814700000000	28	147	Walthall County, MS	1992	NA	5594	5034	560	10
CN2814900000000	28	149	Warren County, MS	1992	NA	22708	20751	1957	8.6
CN2815100000000	28	151	Washington County, MS	1992	NA	27700	24313	3387	12.2
CN2815300000000	28	153	Wayne County, MS	1992	NA	8898	7860	1038	11.7
CN2815500000000	28	155	Webster County, MS	1992	NA	4471	4064	407	9.1
CN2815700000000	28	157	Wilkinson County, MS	1992	NA	3369	2960	409	12.1
CN2815900000000	28	159	Winston County, MS	1992	NA	8055	6787	1268	15.7
CN2816100000000	28	161	Yalobusha County, MS	1992	NA	5070	4561	509	10
CN2816300000000	28	163	Yazoo County, MS	1992	NA	9466	8634	832	8.8
CN2900100000000	29	001	Adair County, MO	1992	NA	13498	13128	370	2.7
CN2900300000000	29	003	Andrew County, MO	1992	NA	7535	7098	437	5.8
CN2900500000000	29	005	Atchison County, MO	1992	NA	2955	2816	139	4.7
CN2900700000000	29	007	Audrain County, MO	1992	NA	11543	10859	684	5.9
CN2900900000000	29	009	Barry County, MO	1992	NA	13370	12535	835	6.2
CN2901100000000	29	011	Barton County, MO	1992	NA	6105	5890	215	3.5
CN2901300000000	29	013	Bates County, MO	1992	NA	7323	6811	512	7
CN2901500000000	29	015	Benton County, MO	1992	NA	5634	5074	560	9.9
CN2901700000000	29	017	Bollinger County, MO	1992	NA	4705	4278	427	9.1
CN2901900000000	29	019	Boone County, MO	1992	NA	70812	68933	1879	2.7
CN2902100000000	29	021	Buchanan County, MO	1992	NA	41019	37864	3155	7.7
CN2902300000000	29	023	Butler County, MO	1992	NA	17600	16139	1461	8.3
CN2902500000000	29	025	Caldwell County, MO	1992	NA	3615	3334	281	7.8
CN2902700000000	29	027	Callaway County, MO	1992	NA	17851	16936	915	5.1
CN2902900000000	29	029	Camden County, MO	1992	NA	13607	12407	1200	8.8
CN2903100000000	29	031	Cape Girardeau County, MO	1992	NA	33274	31397	1877	5.6
CN2903300000000	29	033	Carroll County, MO	1992	NA	4992	4642	350	7
CN2903500000000	29	035	Carter County, MO	1992	NA	2281	2052	229	10
CN2903700000000	29	037	Cass County, MO	1992	NA	35806	33820	1986	5.5
CN2903900000000	29	039	Cedar County, MO	1992	NA	5196	4875	321	6.2
CN2904100000000	29	041	Chariton County, MO	1992	NA	4167	3846	321	7.7
CN2904300000000	29	043	Christian County, MO	1992	NA	19186	18266	920	4.8
CN2904500000000	29	045	Clark County, MO	1992	NA	3619	3400	219	6.1
CN2904700000000	29	047	Clay County, MO	1992	NA	90304	86508	3796	4.2
CN2904900000000	29	049	Clinton County, MO	1992	NA	8325	7866	459	5.5
CN2905100000000	29	051	Cole County, MO	1992	NA	34927	33656	1271	3.6
CN2905300000000	29	053	Cooper County, MO	1992	NA	8317	7862	455	5.5
CN2905500000000	29	055	Crawford County, MO	1992	NA	9732	8710	1022	10.5
CN2905700000000	29	057	Dade County, MO	1992	NA	3171	2969	202	6.4
CN2905900000000	29	059	Dallas County, MO	1992	NA	5783	5260	523	9
CN2906100000000	29	061	Daviess County, MO	1992	NA	3267	3008	259	7.9
CN2906300000000	29	063	DeKalb County, MO	1992	NA	3690	3444	246	6.7
CN2906500000000	29	065	Dent County, MO	1992	NA	5996	5449	547	9.1
CN2906700000000	29	067	Douglas County, MO	1992	NA	5330	4932	398	7.5
CN2906900000000	29	069	Dunklin County, MO	1992	NA	13329	11974	1355	10.2
CN2907100000000	29	071	Franklin County, MO	1992	NA	42923	39378	3545	8.3
CN2907300000000	29	073	Gasconade County, MO	1992	NA	7175	6475	700	9.8
CN2907500000000	29	075	Gentry County, MO	1992	NA	3247	3123	124	3.8
CN2907700000000	29	077	Greene County, MO	1992	NA	114827	109226	5601	4.9
CN2907900000000	29	079	Grundy County, MO	1992	NA	4932	4695	237	4.8
CN2908100000000	29	081	Harrison County, MO	1992	NA	4060	3886	174	4.3
CN2908300000000	29	083	Henry County, MO	1992	NA	9395	8586	809	8.6
CN2908500000000	29	085	Hickory County, MO	1992	NA	2668	2434	234	8.8
CN2908700000000	29	087	Holt County, MO	1992	NA	2853	2708	145	5.1
CN2908900000000	29	089	Howard County, MO	1992	NA	4709	4490	219	4.7
CN2909100000000	29	091	Howell County, MO	1992	NA	15359	14281	1078	7
CN2909300000000	29	093	Iron County, MO	1992	NA	4174	3630	544	13
CN2909500000000	29	095	Jackson County, MO	1992	NA	338546	318099	20447	6
CN2909700000000	29	097	Jasper County, MO	1992	NA	47461	44852	2609	5.5
CN2909900000000	29	099	Jefferson County, MO	1992	NA	93057	86536	6521	7
CN2910100000000	29	101	Johnson County, MO	1992	NA	20830	19915	915	4.4
CN2910300000000	29	103	Knox County, MO	1992	NA	1949	1851	98	5
CN2910500000000	29	105	Laclede County, MO	1992	NA	12970	11765	1205	9.3
CN2910700000000	29	107	Lafayette County, MO	1992	NA	15105	14273	832	5.5
CN2910900000000	29	109	Lawrence County, MO	1992	NA	14788	13832	956	6.5
CN2911100000000	29	111	Lewis County, MO	1992	NA	4839	4543	296	6.1
CN2911300000000	29	113	Lincoln County, MO	1992	NA	15058	13901	1157	7.7
CN2911500000000	29	115	Linn County, MO	1992	NA	6654	6049	605	9.1
CN2911700000000	29	117	Livingston County, MO	1992	NA	6861	6573	288	4.2
CN2911900000000	29	119	McDonald County, MO	1992	NA	6918	6401	517	7.5
CN2912100000000	29	121	Macon County, MO	1992	NA	7434	6944	490	6.6
CN2912300000000	29	123	Madison County, MO	1992	NA	4637	3858	779	16.8
CN2912500000000	29	125	Maries County, MO	1992	NA	4164	3787	377	9.1
CN2912700000000	29	127	Marion County, MO	1992	NA	14449	13607	842	5.8
CN2912900000000	29	129	Mercer County, MO	1992	NA	1712	1639	73	4.3
CN2913100000000	29	131	Miller County, MO	1992	NA	10423	9369	1054	10.1
CN2913300000000	29	133	Mississippi County, MO	1992	NA	6155	5390	765	12.4
CN2913500000000	29	135	Moniteau County, MO	1992	NA	6566	6096	470	7.2
CN2913700000000	29	137	Monroe County, MO	1992	NA	4314	4079	235	5.4
CN2913900000000	29	139	Montgomery County, MO	1992	NA	5542	5162	380	6.9
CN2914100000000	29	141	Morgan County, MO	1992	NA	7456	6809	647	8.7
CN2914300000000	29	143	New Madrid County, MO	1992	NA	8503	7685	818	9.6
CN2914500000000	29	145	Newton County, MO	1992	NA	24195	22482	1713	7.1
CN2914700000000	29	147	Nodaway County, MO	1992	NA	11992	11719	273	2.3
CN2914900000000	29	149	Oregon County, MO	1992	NA	3984	3682	302	7.6
CN2915100000000	29	151	Osage County, MO	1992	NA	6590	6297	293	4.4
CN2915300000000	29	153	Ozark County, MO	1992	NA	3693	3450	243	6.6
CN2915500000000	29	155	Pemiscot County, MO	1992	NA	7934	7016	918	11.6
CN2915700000000	29	157	Perry County, MO	1992	NA	9527	9070	457	4.8
CN2915900000000	29	159	Pettis County, MO	1992	NA	18530	17050	1480	8
CN2916100000000	29	161	Phelps County, MO	1992	NA	17444	16404	1040	6
CN2916300000000	29	163	Pike County, MO	1992	NA	7145	6609	536	7.5
CN2916500000000	29	165	Platte County, MO	1992	NA	36335	34972	1363	3.8
CN2916700000000	29	167	Polk County, MO	1992	NA	10336	9694	642	6.2
CN2916900000000	29	169	Pulaski County, MO	1992	NA	13028	11740	1288	9.9
CN2917100000000	29	171	Putnam County, MO	1992	NA	1989	1913	76	3.8
CN2917300000000	29	173	Ralls County, MO	1992	NA	4621	4387	234	5.1
CN2917500000000	29	175	Randolph County, MO	1992	NA	10254	9503	751	7.3
CN2917700000000	29	177	Ray County, MO	1992	NA	10103	9499	604	6
CN2917900000000	29	179	Reynolds County, MO	1992	NA	2895	2629	266	9.2
CN2918100000000	29	181	Ripley County, MO	1992	NA	4469	4031	438	9.8
CN2918300000000	29	183	St. Charles County, MO	1992	NA	127404	120689	6715	5.3
CN2918500000000	29	185	St. Clair County, MO	1992	NA	3590	3307	283	7.9
CN2918600000000	29	186	Ste. Genevieve County, MO	1992	NA	8252	7722	530	6.4
CN2918700000000	29	187	St. Francois County, MO	1992	NA	20714	18542	2172	10.5
CN2918900000000	29	189	St. Louis County, MO	1992	NA	543770	517556	26214	4.8
CN2919500000000	29	195	Saline County, MO	1992	NA	10785	9962	823	7.6
CN2919700000000	29	197	Schuyler County, MO	1992	NA	2206	2110	96	4.4
CN2919900000000	29	199	Scotland County, MO	1992	NA	2310	2228	82	3.5
CN2920100000000	29	201	Scott County, MO	1992	NA	18745	17266	1479	7.9
CN2920300000000	29	203	Shannon County, MO	1992	NA	3673	3337	336	9.1
CN2920500000000	29	205	Shelby County, MO	1992	NA	3221	3058	163	5.1
CN2920700000000	29	207	Stoddard County, MO	1992	NA	13088	11648	1440	11
CN2920900000000	29	209	Stone County, MO	1992	NA	11461	10374	1087	9.5
CN2921100000000	29	211	Sullivan County, MO	1992	NA	2824	2718	106	3.8
CN2921300000000	29	213	Taney County, MO	1992	NA	18799	16985	1814	9.6
CN2921500000000	29	215	Texas County, MO	1992	NA	9193	8206	987	10.7
CN2921700000000	29	217	Vernon County, MO	1992	NA	8365	7899	466	5.6
CN2921900000000	29	219	Warren County, MO	1992	NA	10399	9632	767	7.4
CN2922100000000	29	221	Washington County, MO	1992	NA	8213	7080	1133	13.8
CN2922300000000	29	223	Wayne County, MO	1992	NA	4164	3501	663	15.9
CN2922500000000	29	225	Webster County, MO	1992	NA	11456	10728	728	6.4
CN2922700000000	29	227	Worth County, MO	1992	NA	969	921	48	5
CN2922900000000	29	229	Wright County, MO	1992	NA	7536	6911	625	8.3
CN2951000000000	29	510	St. Louis city, MO	1992	NA	174381	158721	15660	9
CN3000100000000	30	001	Beaverhead County, MT	1992	NA	4464	4199	265	5.9
CN3000300000000	30	003	Big Horn County, MT	1992	NA	5103	4361	742	14.5
CN3000500000000	30	005	Blaine County, MT	1992	NA	2833	2611	222	7.8
CN3000700000000	30	007	Broadwater County, MT	1992	NA	1821	1731	90	4.9
CN3000900000000	30	009	Carbon County, MT	1992	NA	3896	3692	204	5.2
CN3001100000000	30	011	Carter County, MT	1992	NA	936	921	15	1.6
CN3001300000000	30	013	Cascade County, MT	1992	NA	36495	34228	2267	6.2
CN3001500000000	30	015	Chouteau County, MT	1992	NA	2634	2564	70	2.7
CN3001700000000	30	017	Custer County, MT	1992	NA	5985	5669	316	5.3
CN3001900000000	30	019	Daniels County, MT	1992	NA	1114	1089	25	2.2
CN3002100000000	30	021	Dawson County, MT	1992	NA	4758	4571	187	3.9
CN3002300000000	30	023	Deer Lodge County, MT	1992	NA	4134	3685	449	10.9
CN3002500000000	30	025	Fallon County, MT	1992	NA	1539	1489	50	3.2
CN3002700000000	30	027	Fergus County, MT	1992	NA	5815	5446	369	6.3
CN3002900000000	30	029	Flathead County, MT	1992	NA	32265	29632	2633	8.2
CN3003100000000	30	031	Gallatin County, MT	1992	NA	31671	29993	1678	5.3
CN3003300000000	30	033	Garfield County, MT	1992	NA	925	908	17	1.8
CN3003500000000	30	035	Glacier County, MT	1992	NA	5548	4780	768	13.8
CN3003700000000	30	037	Golden Valley County, MT	1992	NA	485	444	41	8.5
CN3003900000000	30	039	Granite County, MT	1992	NA	1287	1182	105	8.2
CN3004100000000	30	041	Hill County, MT	1992	NA	8480	7932	548	6.5
CN3004300000000	30	043	Jefferson County, MT	1992	NA	4181	3960	221	5.3
CN3004500000000	30	045	Judith Basin County, MT	1992	NA	1144	1091	53	4.6
CN3004700000000	30	047	Lake County, MT	1992	NA	10102	9206	896	8.9
CN3004900000000	30	049	Lewis and Clark County, MT	1992	NA	26242	24808	1434	5.5
CN3005100000000	30	051	Liberty County, MT	1992	NA	1010	986	24	2.4
CN3005300000000	30	053	Lincoln County, MT	1992	NA	8041	6895	1146	14.3
CN3005500000000	30	055	McCone County, MT	1992	NA	1223	1183	40	3.3
CN3005700000000	30	057	Madison County, MT	1992	NA	3346	3186	160	4.8
CN3005900000000	30	059	Meagher County, MT	1992	NA	927	879	48	5.2
CN3006100000000	30	061	Mineral County, MT	1992	NA	1714	1535	179	10.4
CN3006300000000	30	063	Missoula County, MT	1992	NA	45298	42337	2961	6.5
CN3006500000000	30	065	Musselshell County, MT	1992	NA	1798	1666	132	7.3
CN3006700000000	30	067	Park County, MT	1992	NA	8300	7803	497	6
CN3006900000000	30	069	Petroleum County, MT	1992	NA	311	292	19	6.1
CN3007100000000	30	071	Phillips County, MT	1992	NA	2440	2308	132	5.4
CN3007300000000	30	073	Pondera County, MT	1992	NA	2992	2848	144	4.8
CN3007500000000	30	075	Powder River County, MT	1992	NA	1213	1178	35	2.9
CN3007700000000	30	077	Powell County, MT	1992	NA	2614	2432	182	7
CN3007900000000	30	079	Prairie County, MT	1992	NA	697	669	28	4
CN3008100000000	30	081	Ravalli County, MT	1992	NA	13096	11905	1191	9.1
CN3008300000000	30	083	Richland County, MT	1992	NA	5406	5006	400	7.4
CN3008500000000	30	085	Roosevelt County, MT	1992	NA	4404	3873	531	12.1
CN3008700000000	30	087	Rosebud County, MT	1992	NA	4885	4482	403	8.2
CN3008900000000	30	089	Sanders County, MT	1992	NA	3746	3262	484	12.9
CN3009100000000	30	091	Sheridan County, MT	1992	NA	2138	2084	54	2.5
CN3009300000000	30	093	Silver Bow County, MT	1992	NA	16469	15169	1300	7.9
CN3009500000000	30	095	Stillwater County, MT	1992	NA	3251	3046	205	6.3
CN3009700000000	30	097	Sweet Grass County, MT	1992	NA	1608	1560	48	3
CN3009900000000	30	099	Teton County, MT	1992	NA	2885	2792	93	3.2
CN3010100000000	30	101	Toole County, MT	1992	NA	2738	2637	101	3.7
CN3010300000000	30	103	Treasure County, MT	1992	NA	540	507	33	6.1
CN3010500000000	30	105	Valley County, MT	1992	NA	4244	4015	229	5.4
CN3010700000000	30	107	Wheatland County, MT	1992	NA	1180	1138	42	3.6
CN3010900000000	30	109	Wibaux County, MT	1992	NA	536	506	30	5.6
CN3011100000000	30	111	Yellowstone County, MT	1992	NA	64563	61020	3543	5.5
CN3100100000000	31	001	Adams County, NE	1992	NA	15459	15170	289	1.9
CN3100300000000	31	003	Antelope County, NE	1992	NA	3325	3241	84	2.5
CN3100500000000	31	005	Arthur County, NE	1992	NA	224	219	5	2.2
CN3100700000000	31	007	Banner County, NE	1992	NA	421	414	7	1.7
CN3100900000000	31	009	Blaine County, NE	1992	NA	366	352	14	3.8
CN3101100000000	31	011	Boone County, NE	1992	NA	2999	2937	62	2.1
CN3101300000000	31	013	Box Butte County, NE	1992	NA	6209	6000	209	3.4
CN3101500000000	31	015	Boyd County, NE	1992	NA	1218	1196	22	1.8
CN3101700000000	31	017	Brown County, NE	1992	NA	1766	1711	55	3.1
CN3101900000000	31	019	Buffalo County, NE	1992	NA	22206	21587	619	2.8
CN3102100000000	31	021	Burt County, NE	1992	NA	3516	3371	145	4.1
CN3102300000000	31	023	Butler County, NE	1992	NA	4064	3944	120	3
CN3102500000000	31	025	Cass County, NE	1992	NA	10873	10502	371	3.4
CN3102700000000	31	027	Cedar County, NE	1992	NA	4970	4882	88	1.8
CN3102900000000	31	029	Chase County, NE	1992	NA	1924	1885	39	2
CN3103100000000	31	031	Cherry County, NE	1992	NA	3257	3194	63	1.9
CN3103300000000	31	033	Cheyenne County, NE	1992	NA	4839	4740	99	2
CN3103500000000	31	035	Clay County, NE	1992	NA	3429	3359	70	2
CN3103700000000	31	037	Colfax County, NE	1992	NA	4653	4584	69	1.5
CN3103900000000	31	039	Cuming County, NE	1992	NA	5073	4962	111	2.2
CN3104100000000	31	041	Custer County, NE	1992	NA	5745	5593	152	2.6
CN3104300000000	31	043	Dakota County, NE	1992	NA	9089	8800	289	3.2
CN3104500000000	31	045	Dawes County, NE	1992	NA	4282	4140	142	3.3
CN3104700000000	31	047	Dawson County, NE	1992	NA	12681	12237	444	3.5
CN3104900000000	31	049	Deuel County, NE	1992	NA	1088	1059	29	2.7
CN3105100000000	31	051	Dixon County, NE	1992	NA	3066	2988	78	2.5
CN3105300000000	31	053	Dodge County, NE	1992	NA	17964	17369	595	3.3
CN3105500000000	31	055	Douglas County, NE	1992	NA	229983	222470	7513	3.3
CN3105700000000	31	057	Dundy County, NE	1992	NA	1242	1223	19	1.5
CN3105900000000	31	059	Fillmore County, NE	1992	NA	3379	3313	66	2
CN3106100000000	31	061	Franklin County, NE	1992	NA	1715	1674	41	2.4
CN3106300000000	31	063	Frontier County, NE	1992	NA	1502	1470	32	2.1
CN3106500000000	31	065	Furnas County, NE	1992	NA	2539	2498	41	1.6
CN3106700000000	31	067	Gage County, NE	1992	NA	11697	11424	273	2.3
CN3106900000000	31	069	Garden County, NE	1992	NA	1117	1097	20	1.8
CN3107100000000	31	071	Garfield County, NE	1992	NA	1059	1021	38	3.6
CN3107300000000	31	073	Gosper County, NE	1992	NA	1215	1190	25	2.1
CN3107500000000	31	075	Grant County, NE	1992	NA	387	382	5	1.3
CN3107700000000	31	077	Greeley County, NE	1992	NA	1510	1459	51	3.4
CN3107900000000	31	079	Hall County, NE	1992	NA	28746	27967	779	2.7
CN3108100000000	31	081	Hamilton County, NE	1992	NA	4941	4853	88	1.8
CN3108300000000	31	083	Harlan County, NE	1992	NA	1796	1752	44	2.4
CN3108500000000	31	085	Hayes County, NE	1992	NA	538	527	11	2
CN3108700000000	31	087	Hitchcock County, NE	1992	NA	1633	1595	38	2.3
CN3108900000000	31	089	Holt County, NE	1992	NA	6063	5907	156	2.6
CN3109100000000	31	091	Hooker County, NE	1992	NA	375	366	9	2.4
CN3109300000000	31	093	Howard County, NE	1992	NA	3231	3148	83	2.6
CN3109500000000	31	095	Jefferson County, NE	1992	NA	4303	4202	101	2.3
CN3109700000000	31	097	Johnson County, NE	1992	NA	2356	2291	65	2.8
CN3109900000000	31	099	Kearney County, NE	1992	NA	3372	3310	62	1.8
CN3110100000000	31	101	Keith County, NE	1992	NA	4388	4266	122	2.8
CN3110300000000	31	103	Keya Paha County, NE	1992	NA	497	485	12	2.4
CN3110500000000	31	105	Kimball County, NE	1992	NA	2101	2047	54	2.6
CN3110700000000	31	107	Knox County, NE	1992	NA	4423	4289	134	3
CN3110900000000	31	109	Lancaster County, NE	1992	NA	128656	125335	3321	2.6
CN3111100000000	31	111	Lincoln County, NE	1992	NA	17432	16871	561	3.2
CN3111300000000	31	113	Logan County, NE	1992	NA	436	428	8	1.8
CN3111500000000	31	115	Loup County, NE	1992	NA	459	449	10	2.2
CN3111700000000	31	117	McPherson County, NE	1992	NA	298	292	6	2
CN3111900000000	31	119	Madison County, NE	1992	NA	17561	17109	452	2.6
CN3112100000000	31	121	Merrick County, NE	1992	NA	4466	4373	93	2.1
CN3112300000000	31	123	Morrill County, NE	1992	NA	2757	2639	118	4.3
CN3112500000000	31	125	Nance County, NE	1992	NA	2023	1975	48	2.4
CN3112700000000	31	127	Nemaha County, NE	1992	NA	3523	3350	173	4.9
CN3112900000000	31	129	Nuckolls County, NE	1992	NA	2482	2438	44	1.8
CN3113100000000	31	131	Otoe County, NE	1992	NA	7356	7092	264	3.6
CN3113300000000	31	133	Pawnee County, NE	1992	NA	1497	1464	33	2.2
CN3113500000000	31	135	Perkins County, NE	1992	NA	1455	1420	35	2.4
CN3113700000000	31	137	Phelps County, NE	1992	NA	5223	5151	72	1.4
CN3113900000000	31	139	Pierce County, NE	1992	NA	3639	3563	76	2.1
CN3114100000000	31	141	Platte County, NE	1992	NA	16134	15740	394	2.4
CN3114300000000	31	143	Polk County, NE	1992	NA	2608	2563	45	1.7
CN3114500000000	31	145	Red Willow County, NE	1992	NA	5873	5715	158	2.7
CN3114700000000	31	147	Richardson County, NE	1992	NA	4690	4496	194	4.1
CN3114900000000	31	149	Rock County, NE	1992	NA	1001	976	25	2.5
CN3115100000000	31	151	Saline County, NE	1992	NA	6760	6652	108	1.6
CN3115300000000	31	153	Sarpy County, NE	1992	NA	50564	49161	1403	2.8
CN3115500000000	31	155	Saunders County, NE	1992	NA	10187	9899	288	2.8
CN3115700000000	31	157	Scotts Bluff County, NE	1992	NA	18486	17673	813	4.4
CN3115900000000	31	159	Seward County, NE	1992	NA	8874	8643	231	2.6
CN3116100000000	31	161	Sheridan County, NE	1992	NA	3023	2951	72	2.4
CN3116300000000	31	163	Sherman County, NE	1992	NA	1627	1579	48	3
CN3116500000000	31	165	Sioux County, NE	1992	NA	807	796	11	1.4
CN3116700000000	31	167	Stanton County, NE	1992	NA	3066	2987	79	2.6
CN3116900000000	31	169	Thayer County, NE	1992	NA	3200	3135	65	2
CN3117100000000	31	171	Thomas County, NE	1992	NA	406	390	16	3.9
CN3117300000000	31	173	Thurston County, NE	1992	NA	2583	2378	205	7.9
CN3117500000000	31	175	Valley County, NE	1992	NA	2765	2705	60	2.2
CN3117700000000	31	177	Washington County, NE	1992	NA	9211	8986	225	2.4
CN3117900000000	31	179	Wayne County, NE	1992	NA	5527	5371	156	2.8
CN3118100000000	31	181	Webster County, NE	1992	NA	1839	1806	33	1.8
CN3118300000000	31	183	Wheeler County, NE	1992	NA	446	437	9	2
CN3118500000000	31	185	York County, NE	1992	NA	7860	7740	120	1.5
CN3200100000000	32	001	Churchill County, NV	1992	NA	8315	7668	647	7.8
CN3200300000000	32	003	Clark County, NV	1992	NA	461336	430649	30687	6.7
CN3200500000000	32	005	Douglas County, NV	1992	NA	16074	15022	1052	6.5
CN3200700000000	32	007	Elko County, NV	1992	NA	19513	18382	1131	5.8
CN3200900000000	32	009	Esmeralda County, NV	1992	NA	748	688	60	8
CN3201100000000	32	011	Eureka County, NV	1992	NA	864	815	49	5.7
CN3201300000000	32	013	Humboldt County, NV	1992	NA	7826	7382	444	5.7
CN3201500000000	32	015	Lander County, NV	1992	NA	3204	2951	253	7.9
CN3201700000000	32	017	Lincoln County, NV	1992	NA	1507	1363	144	9.6
CN3201900000000	32	019	Lyon County, NV	1992	NA	10089	9128	961	9.5
CN3202100000000	32	021	Mineral County, NV	1992	NA	3255	3084	171	5.3
CN3202300000000	32	023	Nye County, NV	1992	NA	9824	9259	565	5.8
CN3202700000000	32	027	Pershing County, NV	1992	NA	2176	2040	136	6.3
CN3202900000000	32	029	Storey County, NV	1992	NA	1383	1325	58	4.2
CN3203100000000	32	031	Washoe County, NV	1992	NA	160397	150415	9982	6.2
CN3203300000000	32	033	White Pine County, NV	1992	NA	3729	3365	364	9.8
CN3251000000000	32	510	Carson City, NV	1992	NA	21667	19691	1976	9.1
CN3300100000000	33	001	Belknap County, NH	1992	NA	26340	24271	2069	7.9
CN3300300000000	33	003	Carroll County, NH	1992	NA	18817	17649	1168	6.2
CN3300500000000	33	005	Cheshire County, NH	1992	NA	38261	36023	2238	5.8
CN3300700000000	33	007	Coos County, NH	1992	NA	17612	15776	1836	10.4
CN3300900000000	33	009	Grafton County, NH	1992	NA	40134	37820	2314	5.8
CN3301100000000	33	011	Hillsborough County, NH	1992	NA	189976	176078	13898	7.3
CN3301300000000	33	013	Merrimack County, NH	1992	NA	66163	62089	4074	6.2
CN3301500000000	33	015	Rockingham County, NH	1992	NA	140584	128854	11730	8.3
CN3301700000000	33	017	Strafford County, NH	1992	NA	56788	52744	4044	7.1
CN3301900000000	33	019	Sullivan County, NH	1992	NA	19452	18118	1334	6.9
CN3400100000000	34	001	Atlantic County, NJ	1992	NA	123730	111078	12652	10.2
CN3400300000000	34	003	Bergen County, NJ	1992	NA	433587	402494	31093	7.2
CN3400500000000	34	005	Burlington County, NJ	1992	NA	208260	192194	16066	7.7
CN3400700000000	34	007	Camden County, NJ	1992	NA	258186	234548	23638	9.2
CN3400900000000	34	009	Cape May County, NJ	1992	NA	45705	39740	5965	13.1
CN3401100000000	34	011	Cumberland County, NJ	1992	NA	66235	58252	7983	12.1
CN3401300000000	34	013	Essex County, NJ	1992	NA	387749	349255	38494	9.9
CN3401500000000	34	015	Gloucester County, NJ	1992	NA	123488	112725	10763	8.7
CN3401700000000	34	017	Hudson County, NJ	1992	NA	282861	251436	31425	11.1
CN3401900000000	34	019	Hunterdon County, NJ	1992	NA	60983	57930	3053	5
CN3402100000000	34	021	Mercer County, NJ	1992	NA	172332	161074	11258	6.5
CN3402300000000	34	023	Middlesex County, NJ	1992	NA	378894	350407	28487	7.5
CN3402500000000	34	025	Monmouth County, NJ	1992	NA	289938	268680	21258	7.3
CN3402700000000	34	027	Morris County, NJ	1992	NA	244927	229705	15222	6.2
CN3402900000000	34	029	Ocean County, NJ	1992	NA	192619	176779	15840	8.2
CN3403100000000	34	031	Passaic County, NJ	1992	NA	231257	207031	24226	10.5
CN3403300000000	34	033	Salem County, NJ	1992	NA	31655	28999	2656	8.4
CN3403500000000	34	035	Somerset County, NJ	1992	NA	143488	136132	7356	5.1
CN3403700000000	34	037	Sussex County, NJ	1992	NA	72776	67035	5741	7.9
CN3403900000000	34	039	Union County, NJ	1992	NA	266198	243167	23031	8.7
CN3404100000000	34	041	Warren County, NJ	1992	NA	49039	45250	3789	7.7
CN3500100000000	35	001	Bernalillo County, NM	1992	NA	259590	246487	13103	5
CN3500300000000	35	003	Catron County, NM	1992	NA	1175	1044	131	11.1
CN3500500000000	35	005	Chaves County, NM	1992	NA	25184	22273	2911	11.6
CN3500600000000	35	006	Cibola County, NM	1992	NA	9427	8177	1250	13.3
CN3500700000000	35	007	Colfax County, NM	1992	NA	6178	5589	589	9.5
CN3500900000000	35	009	Curry County, NM	1992	NA	19299	18190	1109	5.7
CN3501100000000	35	011	De Baca County, NM	1992	NA	910	849	61	6.7
CN3501300000000	35	013	Dona Ana County, NM	1992	NA	61379	56468	4911	8
CN3501500000000	35	015	Eddy County, NM	1992	NA	23135	21357	1778	7.7
CN3501700000000	35	017	Grant County, NM	1992	NA	11221	9979	1242	11.1
CN3501900000000	35	019	Guadalupe County, NM	1992	NA	1774	1559	215	12.1
CN3502100000000	35	021	Harding County, NM	1992	NA	458	435	23	5
CN3502300000000	35	023	Hidalgo County, NM	1992	NA	2747	2590	157	5.7
CN3502500000000	35	025	Lea County, NM	1992	NA	24655	23059	1596	6.5
CN3502700000000	35	027	Lincoln County, NM	1992	NA	6436	5982	454	7.1
CN3502800000000	35	028	Los Alamos County, NM	1992	NA	10913	10754	159	1.5
CN3502900000000	35	029	Luna County, NM	1992	NA	8811	7368	1443	16.4
CN3503100000000	35	031	McKinley County, NM	1992	NA	23553	21656	1897	8.1
CN3503300000000	35	033	Mora County, NM	1992	NA	1554	1187	367	23.6
CN3503500000000	35	035	Otero County, NM	1992	NA	20092	18337	1755	8.7
CN3503700000000	35	037	Quay County, NM	1992	NA	4829	4534	295	6.1
CN3503900000000	35	039	Rio Arriba County, NM	1992	NA	15458	13117	2341	15.1
CN3504100000000	35	041	Roosevelt County, NM	1992	NA	7355	6980	375	5.1
CN3504300000000	35	043	Sandoval County, NM	1992	NA	31755	30043	1712	5.4
CN3504500000000	35	045	San Juan County, NM	1992	NA	43651	38614	5037	11.5
CN3504700000000	35	047	San Miguel County, NM	1992	NA	11098	9861	1237	11.1
CN3504900000000	35	049	Santa Fe County, NM	1992	NA	59343	56948	2395	4
CN3505100000000	35	051	Sierra County, NM	1992	NA	3498	3303	195	5.6
CN3505300000000	35	053	Socorro County, NM	1992	NA	6868	6291	577	8.4
CN3505500000000	35	055	Taos County, NM	1992	NA	12157	9951	2206	18.1
CN3505700000000	35	057	Torrance County, NM	1992	NA	4712	4235	477	10.1
CN3505900000000	35	059	Union County, NM	1992	NA	1852	1768	84	4.5
CN3506100000000	35	061	Valencia County, NM	1992	NA	20817	19614	1203	5.8
CN3600100000000	36	001	Albany County, NY	1992	NA	156841	149015	7826	5
CN3600300000000	36	003	Allegany County, NY	1992	NA	23075	20864	2211	9.6
CN3600500000000	36	005	Bronx County, NY	1992	NA	456018	396095	59923	13.1
CN3600700000000	36	007	Broome County, NY	1992	NA	104576	97542	7034	6.7
CN3600900000000	36	009	Cattaraugus County, NY	1992	NA	39490	35560	3930	10
CN3601100000000	36	011	Cayuga County, NY	1992	NA	38626	35547	3079	8
CN3601300000000	36	013	Chautauqua County, NY	1992	NA	68133	62513	5620	8.2
CN3601500000000	36	015	Chemung County, NY	1992	NA	43315	40364	2951	6.8
CN3601700000000	36	017	Chenango County, NY	1992	NA	25080	23139	1941	7.7
CN3601900000000	36	019	Clinton County, NY	1992	NA	40493	36909	3584	8.9
CN3602100000000	36	021	Columbia County, NY	1992	NA	31452	29647	1805	5.7
CN3602300000000	36	023	Cortland County, NY	1992	NA	25008	22973	2035	8.1
CN3602500000000	36	025	Delaware County, NY	1992	NA	21191	19542	1649	7.8
CN3602700000000	36	027	Dutchess County, NY	1992	NA	126135	117716	8419	6.7
CN3602900000000	36	029	Erie County, NY	1992	NA	476542	441881	34661	7.3
CN3603100000000	36	031	Essex County, NY	1992	NA	18701	16406	2295	12.3
CN3603300000000	36	033	Franklin County, NY	1992	NA	21370	19141	2229	10.4
CN3603500000000	36	035	Fulton County, NY	1992	NA	26987	24290	2697	10
CN3603700000000	36	037	Genesee County, NY	1992	NA	32133	29565	2568	8
CN3603900000000	36	039	Greene County, NY	1992	NA	21622	19701	1921	8.9
CN3604100000000	36	041	Hamilton County, NY	1992	NA	2860	2523	337	11.8
CN3604300000000	36	043	Herkimer County, NY	1992	NA	30306	27651	2655	8.8
CN3604500000000	36	045	Jefferson County, NY	1992	NA	46657	41029	5628	12.1
CN3604700000000	36	047	Kings County, NY	1992	NA	947537	832521	115016	12.1
CN3604900000000	36	049	Lewis County, NY	1992	NA	12747	11345	1402	11
CN3605100000000	36	051	Livingston County, NY	1992	NA	33254	31028	2226	6.7
CN3605300000000	36	053	Madison County, NY	1992	NA	35846	33079	2767	7.7
CN3605500000000	36	055	Monroe County, NY	1992	NA	381241	362665	18576	4.9
CN3605700000000	36	057	Montgomery County, NY	1992	NA	24645	22202	2443	9.9
CN3605900000000	36	059	Nassau County, NY	1992	NA	682060	634021	48039	7
CN3606100000000	36	061	New York County, NY	1992	NA	767623	695237	72386	9.4
CN3606300000000	36	063	Niagara County, NY	1992	NA	109517	100364	9153	8.4
CN3606500000000	36	065	Oneida County, NY	1992	NA	114191	106250	7941	7
CN3606700000000	36	067	Onondaga County, NY	1992	NA	243036	227293	15743	6.5
CN3606900000000	36	069	Ontario County, NY	1992	NA	52174	48969	3205	6.1
CN3607100000000	36	071	Orange County, NY	1992	NA	154908	144891	10017	6.5
CN3607300000000	36	073	Orleans County, NY	1992	NA	20608	18850	1758	8.5
CN3607500000000	36	075	Oswego County, NY	1992	NA	58273	52244	6029	10.3
CN3607700000000	36	077	Otsego County, NY	1992	NA	31239	29068	2171	6.9
CN3607900000000	36	079	Putnam County, NY	1992	NA	48520	45596	2924	6
CN3608100000000	36	081	Queens County, NY	1992	NA	949368	848915	100453	10.6
CN3608300000000	36	083	Rensselaer County, NY	1992	NA	82102	76869	5233	6.4
CN3608500000000	36	085	Richmond County, NY	1992	NA	183318	165170	18148	9.9
CN3608700000000	36	087	Rockland County, NY	1992	NA	142117	132981	9136	6.4
CN3608900000000	36	089	St. Lawrence County, NY	1992	NA	51773	46679	5094	9.8
CN3609100000000	36	091	Saratoga County, NY	1992	NA	99307	93485	5822	5.9
CN3609300000000	36	093	Schenectady County, NY	1992	NA	75631	70879	4752	6.3
CN3609500000000	36	095	Schoharie County, NY	1992	NA	15709	14392	1317	8.4
CN3609700000000	36	097	Schuyler County, NY	1992	NA	9119	8336	783	8.6
CN3609900000000	36	099	Seneca County, NY	1992	NA	16831	15730	1101	6.5
CN3610100000000	36	101	Steuben County, NY	1992	NA	48738	44823	3915	8
CN3610300000000	36	103	Suffolk County, NY	1992	NA	696219	639404	56815	8.2
CN3610500000000	36	105	Sullivan County, NY	1992	NA	33681	30627	3054	9.1
CN3610700000000	36	107	Tioga County, NY	1992	NA	26485	24728	1757	6.6
CN3610900000000	36	109	Tompkins County, NY	1992	NA	48329	46072	2257	4.7
CN3611100000000	36	111	Ulster County, NY	1992	NA	84122	78521	5601	6.7
CN3611300000000	36	113	Warren County, NY	1992	NA	31941	28905	3036	9.5
CN3611500000000	36	115	Washington County, NY	1992	NA	29147	26802	2345	8
CN3611700000000	36	117	Wayne County, NY	1992	NA	47638	44163	3475	7.3
CN3611900000000	36	119	Westchester County, NY	1992	NA	453727	425595	28132	6.2
CN3612100000000	36	121	Wyoming County, NY	1992	NA	20278	18499	1779	8.8
CN3612300000000	36	123	Yates County, NY	1992	NA	11632	10795	837	7.2
CN3700100000000	37	001	Alamance County, NC	1992	NA	62656	59341	3315	5.3
CN3700300000000	37	003	Alexander County, NC	1992	NA	16386	15688	698	4.3
CN3700500000000	37	005	Alleghany County, NC	1992	NA	5075	4737	338	6.7
CN3700700000000	37	007	Anson County, NC	1992	NA	12412	10686	1726	13.9
CN3700900000000	37	009	Ashe County, NC	1992	NA	11620	10559	1061	9.1
CN3701100000000	37	011	Avery County, NC	1992	NA	7355	6642	713	9.7
CN3701300000000	37	013	Beaufort County, NC	1992	NA	20716	18906	1810	8.7
CN3701500000000	37	015	Bertie County, NC	1992	NA	9282	8632	650	7
CN3701700000000	37	017	Bladen County, NC	1992	NA	14376	12698	1678	11.7
CN3701900000000	37	019	Brunswick County, NC	1992	NA	27201	24219	2982	11
CN3702100000000	37	021	Buncombe County, NC	1992	NA	96743	91545	5198	5.4
CN3702300000000	37	023	Burke County, NC	1992	NA	43225	40770	2455	5.7
CN3702500000000	37	025	Cabarrus County, NC	1992	NA	57157	53794	3363	5.9
CN3702700000000	37	027	Caldwell County, NC	1992	NA	41055	38993	2062	5
CN3702900000000	37	029	Camden County, NC	1992	NA	2840	2693	147	5.2
CN3703100000000	37	031	Carteret County, NC	1992	NA	27324	25639	1685	6.2
CN3703300000000	37	033	Caswell County, NC	1992	NA	11164	10556	608	5.4
CN3703500000000	37	035	Catawba County, NC	1992	NA	73934	69473	4461	6
CN3703700000000	37	037	Chatham County, NC	1992	NA	22994	22111	883	3.8
CN3703900000000	37	039	Cherokee County, NC	1992	NA	9204	8162	1042	11.3
CN3704100000000	37	041	Chowan County, NC	1992	NA	6597	6176	421	6.4
CN3704300000000	37	043	Clay County, NC	1992	NA	3181	2923	258	8.1
CN3704500000000	37	045	Cleveland County, NC	1992	NA	46259	42843	3416	7.4
CN3704700000000	37	047	Columbus County, NC	1992	NA	25043	22534	2509	10
CN3704900000000	37	049	Craven County, NC	1992	NA	35442	33188	2254	6.4
CN3705100000000	37	051	Cumberland County, NC	1992	NA	109565	103209	6356	5.8
CN3705300000000	37	053	Currituck County, NC	1992	NA	7219	6963	256	3.5
CN3705500000000	37	055	Dare County, NC	1992	NA	14973	13807	1166	7.8
CN3705700000000	37	057	Davidson County, NC	1992	NA	75045	70283	4762	6.3
CN3705900000000	37	059	Davie County, NC	1992	NA	15613	14965	648	4.2
CN3706100000000	37	061	Duplin County, NC	1992	NA	21108	19157	1951	9.2
CN3706300000000	37	063	Durham County, NC	1992	NA	106053	101784	4269	4
CN3706500000000	37	065	Edgecombe County, NC	1992	NA	28482	26089	2393	8.4
CN3706700000000	37	067	Forsyth County, NC	1992	NA	146680	139225	7455	5.1
CN3706900000000	37	069	Franklin County, NC	1992	NA	19949	18611	1338	6.7
CN3707100000000	37	071	Gaston County, NC	1992	NA	96571	89887	6684	6.9
CN3707300000000	37	073	Gates County, NC	1992	NA	4291	4096	195	4.5
CN3707500000000	37	075	Graham County, NC	1992	NA	4099	3383	716	17.5
CN3707700000000	37	077	Granville County, NC	1992	NA	20871	19666	1205	5.8
CN3707900000000	37	079	Greene County, NC	1992	NA	7781	7386	395	5.1
CN3708100000000	37	081	Guilford County, NC	1992	NA	205669	194760	10909	5.3
CN3708300000000	37	083	Halifax County, NC	1992	NA	25147	22957	2190	8.7
CN3708500000000	37	085	Harnett County, NC	1992	NA	31866	29900	1966	6.2
CN3708700000000	37	087	Haywood County, NC	1992	NA	24287	22704	1583	6.5
CN3708900000000	37	089	Henderson County, NC	1992	NA	33129	31496	1633	4.9
CN3709100000000	37	091	Hertford County, NC	1992	NA	10522	9517	1005	9.6
CN3709300000000	37	093	Hoke County, NC	1992	NA	10057	9223	834	8.3
CN3709500000000	37	095	Hyde County, NC	1992	NA	2891	2600	291	10.1
CN3709700000000	37	097	Iredell County, NC	1992	NA	54707	51808	2899	5.3
CN3709900000000	37	099	Jackson County, NC	1992	NA	14274	13258	1016	7.1
CN3710100000000	37	101	Johnston County, NC	1992	NA	47286	44847	2439	5.2
CN3710300000000	37	103	Jones County, NC	1992	NA	4535	4261	274	6
CN3710500000000	37	105	Lee County, NC	1992	NA	23555	21978	1577	6.7
CN3710700000000	37	107	Lenoir County, NC	1992	NA	29439	27387	2052	7
CN3710900000000	37	109	Lincoln County, NC	1992	NA	28688	27075	1613	5.6
CN3711100000000	37	111	McDowell County, NC	1992	NA	19441	17926	1515	7.8
CN3711300000000	37	113	Macon County, NC	1992	NA	11919	11126	793	6.7
CN3711500000000	37	115	Madison County, NC	1992	NA	8546	8027	519	6.1
CN3711700000000	37	117	Martin County, NC	1992	NA	13566	12597	969	7.1
CN3711900000000	37	119	Mecklenburg County, NC	1992	NA	307186	291556	15630	5.1
CN3712100000000	37	121	Mitchell County, NC	1992	NA	7191	6485	706	9.8
CN3712300000000	37	123	Montgomery County, NC	1992	NA	12392	11180	1212	9.8
CN3712500000000	37	125	Moore County, NC	1992	NA	28631	26617	2014	7
CN3712700000000	37	127	Nash County, NC	1992	NA	43609	40389	3220	7.4
CN3712900000000	37	129	New Hanover County, NC	1992	NA	70335	65144	5191	7.4
CN3713100000000	37	131	Northampton County, NC	1992	NA	9029	8318	711	7.9
CN3713300000000	37	133	Onslow County, NC	1992	NA	41762	39721	2041	4.9
CN3713500000000	37	135	Orange County, NC	1992	NA	56166	54584	1582	2.8
CN3713700000000	37	137	Pamlico County, NC	1992	NA	5273	4972	301	5.7
CN3713900000000	37	139	Pasquotank County, NC	1992	NA	13572	12795	777	5.7
CN3714100000000	37	141	Pender County, NC	1992	NA	15289	13916	1373	9
CN3714300000000	37	143	Perquimans County, NC	1992	NA	4399	4138	261	5.9
CN3714500000000	37	145	Person County, NC	1992	NA	16435	14816	1619	9.9
CN3714700000000	37	147	Pitt County, NC	1992	NA	58229	54554	3675	6.3
CN3714900000000	37	149	Polk County, NC	1992	NA	7369	7093	276	3.7
CN3715100000000	37	151	Randolph County, NC	1992	NA	64683	61887	2796	4.3
CN3715300000000	37	153	Richmond County, NC	1992	NA	21927	19978	1949	8.9
CN3715500000000	37	155	Robeson County, NC	1992	NA	53893	48305	5588	10.4
CN3715700000000	37	157	Rockingham County, NC	1992	NA	47412	43818	3594	7.6
CN3715900000000	37	159	Rowan County, NC	1992	NA	58909	55687	3222	5.5
CN3716100000000	37	161	Rutherford County, NC	1992	NA	30714	28782	1932	6.3
CN3716300000000	37	163	Sampson County, NC	1992	NA	23784	22171	1613	6.8
CN3716500000000	37	165	Scotland County, NC	1992	NA	17227	15336	1891	11
CN3716700000000	37	167	Stanly County, NC	1992	NA	28407	26644	1763	6.2
CN3716900000000	37	169	Stokes County, NC	1992	NA	20750	19884	866	4.2
CN3717100000000	37	171	Surry County, NC	1992	NA	35341	33283	2058	5.8
CN3717300000000	37	173	Swain County, NC	1992	NA	6350	5223	1127	17.7
CN3717500000000	37	175	Transylvania County, NC	1992	NA	11992	11340	652	5.4
CN3717700000000	37	177	Tyrrell County, NC	1992	NA	1957	1667	290	14.8
CN3717900000000	37	179	Union County, NC	1992	NA	48319	45733	2586	5.4
CN3718100000000	37	181	Vance County, NC	1992	NA	20625	18665	1960	9.5
CN3718300000000	37	183	Wake County, NC	1992	NA	272810	263297	9513	3.5
CN3718500000000	37	185	Warren County, NC	1992	NA	7645	6884	761	10
CN3718700000000	37	187	Washington County, NC	1992	NA	6213	5707	506	8.1
CN3718900000000	37	189	Watauga County, NC	1992	NA	20825	20086	739	3.5
CN3719100000000	37	191	Wayne County, NC	1992	NA	47748	44382	3366	7
CN3719300000000	37	193	Wilkes County, NC	1992	NA	32829	31187	1642	5
CN3719500000000	37	195	Wilson County, NC	1992	NA	36435	32561	3874	10.6
CN3719700000000	37	197	Yadkin County, NC	1992	NA	16586	15838	748	4.5
CN3719900000000	37	199	Yancey County, NC	1992	NA	6631	6002	629	9.5
CN3800100000000	38	001	Adams County, ND	1992	NA	1530	1495	35	2.3
CN3800300000000	38	003	Barnes County, ND	1992	NA	5444	5238	206	3.8
CN3800500000000	38	005	Benson County, ND	1992	NA	2753	2372	381	13.8
CN3800700000000	38	007	Billings County, ND	1992	NA	570	538	32	5.6
CN3800900000000	38	009	Bottineau County, ND	1992	NA	3363	3213	150	4.5
CN3801100000000	38	011	Bowman County, ND	1992	NA	1814	1729	85	4.7
CN3801300000000	38	013	Burke County, ND	1992	NA	1098	1051	47	4.3
CN3801500000000	38	015	Burleigh County, ND	1992	NA	35402	33941	1461	4.1
CN3801700000000	38	017	Cass County, ND	1992	NA	61570	59623	1947	3.2
CN3801900000000	38	019	Cavalier County, ND	1992	NA	2522	2416	106	4.2
CN3802100000000	38	021	Dickey County, ND	1992	NA	2767	2684	83	3
CN3802300000000	38	023	Divide County, ND	1992	NA	1138	1118	20	1.8
CN3802500000000	38	025	Dunn County, ND	1992	NA	1847	1772	75	4.1
CN3802700000000	38	027	Eddy County, ND	1992	NA	1241	1104	137	11
CN3802900000000	38	029	Emmons County, ND	1992	NA	2077	1970	107	5.2
CN3803100000000	38	031	Foster County, ND	1992	NA	1906	1817	89	4.7
CN3803300000000	38	033	Golden Valley County, ND	1992	NA	883	842	41	4.6
CN3803500000000	38	035	Grand Forks County, ND	1992	NA	34195	32992	1203	3.5
CN3803700000000	38	037	Grant County, ND	1992	NA	1513	1459	54	3.6
CN3803900000000	38	039	Griggs County, ND	1992	NA	1439	1386	53	3.7
CN3804100000000	38	041	Hettinger County, ND	1992	NA	1383	1321	62	4.5
CN3804300000000	38	043	Kidder County, ND	1992	NA	1454	1362	92	6.3
CN3804500000000	38	045	LaMoure County, ND	1992	NA	2285	2228	57	2.5
CN3804700000000	38	047	Logan County, ND	1992	NA	1181	1152	29	2.5
CN3804900000000	38	049	McHenry County, ND	1992	NA	2701	2533	168	6.2
CN3805100000000	38	051	McIntosh County, ND	1992	NA	1718	1682	36	2.1
CN3805300000000	38	053	McKenzie County, ND	1992	NA	2883	2747	136	4.7
CN3805500000000	38	055	McLean County, ND	1992	NA	4536	4207	329	7.3
CN3805700000000	38	057	Mercer County, ND	1992	NA	4871	4422	449	9.2
CN3805900000000	38	059	Morton County, ND	1992	NA	12537	11817	720	5.7
CN3806100000000	38	061	Mountrail County, ND	1992	NA	2991	2723	268	9
CN3806300000000	38	063	Nelson County, ND	1992	NA	1689	1620	69	4.1
CN3806500000000	38	065	Oliver County, ND	1992	NA	1120	1057	63	5.6
CN3806700000000	38	067	Pembina County, ND	1992	NA	4790	4396	394	8.2
CN3806900000000	38	069	Pierce County, ND	1992	NA	2243	2165	78	3.5
CN3807100000000	38	071	Ramsey County, ND	1992	NA	6308	6033	275	4.4
CN3807300000000	38	073	Ransom County, ND	1992	NA	2588	2504	84	3.2
CN3807500000000	38	075	Renville County, ND	1992	NA	1329	1285	44	3.3
CN3807700000000	38	077	Richland County, ND	1992	NA	8368	8028	340	4.1
CN3807900000000	38	079	Rolette County, ND	1992	NA	4737	3990	747	15.8
CN3808100000000	38	081	Sargent County, ND	1992	NA	2108	2033	75	3.6
CN3808300000000	38	083	Sheridan County, ND	1992	NA	707	673	34	4.8
CN3808500000000	38	085	Sioux County, ND	1992	NA	1381	1043	338	24.5
CN3808700000000	38	087	Slope County, ND	1992	NA	427	407	20	4.7
CN3808900000000	38	089	Stark County, ND	1992	NA	11839	11163	676	5.7
CN3809100000000	38	091	Steele County, ND	1992	NA	1025	1000	25	2.4
CN3809300000000	38	093	Stutsman County, ND	1992	NA	10929	10470	459	4.2
CN3809500000000	38	095	Towner County, ND	1992	NA	1537	1491	46	3
CN3809700000000	38	097	Traill County, ND	1992	NA	3765	3608	157	4.2
CN3809900000000	38	099	Walsh County, ND	1992	NA	6397	6060	337	5.3
CN3810100000000	38	101	Ward County, ND	1992	NA	26487	25198	1289	4.9
CN3810300000000	38	103	Wells County, ND	1992	NA	2472	2273	199	8.1
CN3810500000000	38	105	Williams County, ND	1992	NA	10072	9489	583	5.8
CN3900100000000	39	001	Adams County, OH	1992	NA	10607	9031	1576	14.9
CN3900300000000	39	003	Allen County, OH	1992	NA	52130	47787	4343	8.3
CN3900500000000	39	005	Ashland County, OH	1992	NA	25593	23821	1772	6.9
CN3900700000000	39	007	Ashtabula County, OH	1992	NA	45954	41229	4725	10.3
CN3900900000000	39	009	Athens County, OH	1992	NA	24960	23178	1782	7.1
CN3901100000000	39	011	Auglaize County, OH	1992	NA	23645	22024	1621	6.9
CN3901300000000	39	013	Belmont County, OH	1992	NA	30444	27877	2567	8.4
CN3901500000000	39	015	Brown County, OH	1992	NA	17518	15943	1575	9
CN3901700000000	39	017	Butler County, OH	1992	NA	155506	144982	10524	6.8
CN3901900000000	39	019	Carroll County, OH	1992	NA	12819	11548	1271	9.9
CN3902100000000	39	021	Champaign County, OH	1992	NA	19472	18085	1387	7.1
CN3902300000000	39	023	Clark County, OH	1992	NA	70671	65224	5447	7.7
CN3902500000000	39	025	Clermont County, OH	1992	NA	83684	78133	5551	6.6
CN3902700000000	39	027	Clinton County, OH	1992	NA	19526	18070	1456	7.5
CN3902900000000	39	029	Columbiana County, OH	1992	NA	51132	46228	4904	9.6
CN3903100000000	39	031	Coshocton County, OH	1992	NA	16472	15088	1384	8.4
CN3903300000000	39	033	Crawford County, OH	1992	NA	22684	20209	2475	10.9
CN3903500000000	39	035	Cuyahoga County, OH	1992	NA	679623	630146	49477	7.3
CN3903700000000	39	037	Darke County, OH	1992	NA	27872	25661	2211	7.9
CN3903900000000	39	039	Defiance County, OH	1992	NA	19290	17832	1458	7.6
CN3904100000000	39	041	Delaware County, OH	1992	NA	38831	36911	1920	4.9
CN3904300000000	39	043	Erie County, OH	1992	NA	43124	39615	3509	8.1
CN3904500000000	39	045	Fairfield County, OH	1992	NA	55979	52566	3413	6.1
CN3904700000000	39	047	Fayette County, OH	1992	NA	13727	12594	1133	8.3
CN3904900000000	39	049	Franklin County, OH	1992	NA	548803	522945	25858	4.7
CN3905100000000	39	051	Fulton County, OH	1992	NA	21279	19288	1991	9.4
CN3905300000000	39	053	Gallia County, OH	1992	NA	13494	12105	1389	10.3
CN3905500000000	39	055	Geauga County, OH	1992	NA	43421	40901	2520	5.8
CN3905700000000	39	057	Greene County, OH	1992	NA	68062	64150	3912	5.7
CN3905900000000	39	059	Guernsey County, OH	1992	NA	19462	16490	2972	15.3
CN3906100000000	39	061	Hamilton County, OH	1992	NA	442285	416995	25290	5.7
CN3906300000000	39	063	Hancock County, OH	1992	NA	37909	35566	2343	6.2
CN3906500000000	39	065	Hardin County, OH	1992	NA	14504	13130	1374	9.5
CN3906700000000	39	067	Harrison County, OH	1992	NA	6949	6269	680	9.8
CN3906900000000	39	069	Henry County, OH	1992	NA	16274	14916	1358	8.3
CN3907100000000	39	071	Highland County, OH	1992	NA	17030	15427	1603	9.4
CN3907300000000	39	073	Hocking County, OH	1992	NA	11864	10640	1224	10.3
CN3907500000000	39	075	Holmes County, OH	1992	NA	15348	14599	749	4.9
CN3907700000000	39	077	Huron County, OH	1992	NA	30030	26100	3930	13.1
CN3907900000000	39	079	Jackson County, OH	1992	NA	13375	12130	1245	9.3
CN3908100000000	39	081	Jefferson County, OH	1992	NA	32419	29419	3000	9.3
CN3908300000000	39	083	Knox County, OH	1992	NA	24890	23219	1671	6.7
CN3908500000000	39	085	Lake County, OH	1992	NA	120369	111626	8743	7.3
CN3908700000000	39	087	Lawrence County, OH	1992	NA	25698	23697	2001	7.8
CN3908900000000	39	089	Licking County, OH	1992	NA	66849	62746	4103	6.1
CN3909100000000	39	091	Logan County, OH	1992	NA	22364	20722	1642	7.3
CN3909300000000	39	093	Lorain County, OH	1992	NA	136991	124878	12113	8.8
CN3909500000000	39	095	Lucas County, OH	1992	NA	224831	205228	19603	8.7
CN3909700000000	39	097	Madison County, OH	1992	NA	18790	17720	1070	5.7
CN3909900000000	39	099	Mahoning County, OH	1992	NA	120444	108993	11451	9.5
CN3910100000000	39	101	Marion County, OH	1992	NA	31725	29054	2671	8.4
CN3910300000000	39	103	Medina County, OH	1992	NA	67958	63436	4522	6.7
CN3910500000000	39	105	Meigs County, OH	1992	NA	8812	7703	1109	12.6
CN3910700000000	39	107	Mercer County, OH	1992	NA	20279	18548	1731	8.5
CN3910900000000	39	109	Miami County, OH	1992	NA	49213	45847	3366	6.8
CN3911100000000	39	111	Monroe County, OH	1992	NA	6313	5545	768	12.2
CN3911300000000	39	113	Montgomery County, OH	1992	NA	286106	267475	18631	6.5
CN3911500000000	39	115	Morgan County, OH	1992	NA	5744	4993	751	13.1
CN3911700000000	39	117	Morrow County, OH	1992	NA	13442	12246	1196	8.9
CN3911900000000	39	119	Muskingum County, OH	1992	NA	40761	36568	4193	10.3
CN3912100000000	39	121	Noble County, OH	1992	NA	5209	4608	601	11.5
CN3912300000000	39	123	Ottawa County, OH	1992	NA	21341	18810	2531	11.9
CN3912500000000	39	125	Paulding County, OH	1992	NA	9046	8405	641	7.1
CN3912700000000	39	127	Perry County, OH	1992	NA	14381	12485	1896	13.2
CN3912900000000	39	129	Pickaway County, OH	1992	NA	22446	21076	1370	6.1
CN3913100000000	39	131	Pike County, OH	1992	NA	10117	8919	1198	11.8
CN3913300000000	39	133	Portage County, OH	1992	NA	78615	73036	5579	7.1
CN3913500000000	39	135	Preble County, OH	1992	NA	19938	18316	1622	8.1
CN3913700000000	39	137	Putnam County, OH	1992	NA	17643	16337	1306	7.4
CN3913900000000	39	139	Richland County, OH	1992	NA	61165	55499	5666	9.3
CN3914100000000	39	141	Ross County, OH	1992	NA	31644	28694	2950	9.3
CN3914300000000	39	143	Sandusky County, OH	1992	NA	31932	28837	3095	9.7
CN3914500000000	39	145	Scioto County, OH	1992	NA	31714	28000	3714	11.7
CN3914700000000	39	147	Seneca County, OH	1992	NA	29988	27187	2801	9.3
CN3914900000000	39	149	Shelby County, OH	1992	NA	26397	24182	2215	8.4
CN3915100000000	39	151	Stark County, OH	1992	NA	187087	172101	14986	8
CN3915300000000	39	153	Summit County, OH	1992	NA	266822	248035	18787	7
CN3915500000000	39	155	Trumbull County, OH	1992	NA	113376	101747	11629	10.3
CN3915700000000	39	157	Tuscarawas County, OH	1992	NA	43365	39395	3970	9.2
CN3915900000000	39	159	Union County, OH	1992	NA	16185	15124	1061	6.6
CN3916100000000	39	161	Van Wert County, OH	1992	NA	16237	15176	1061	6.5
CN3916300000000	39	163	Vinton County, OH	1992	NA	3984	3449	535	13.4
CN3916500000000	39	165	Warren County, OH	1992	NA	62665	58772	3893	6.2
CN3916700000000	39	167	Washington County, OH	1992	NA	31515	28922	2593	8.2
CN3916900000000	39	169	Wayne County, OH	1992	NA	52241	48824	3417	6.5
CN3917100000000	39	171	Williams County, OH	1992	NA	20993	19284	1709	8.1
CN3917300000000	39	173	Wood County, OH	1992	NA	60425	56437	3988	6.6
CN3917500000000	39	175	Wyandot County, OH	1992	NA	11440	10352	1088	9.5
CN4000100000000	40	001	Adair County, OK	1992	NA	9511	8978	533	5.6
CN4000300000000	40	003	Alfalfa County, OK	1992	NA	2680	2620	60	2.2
CN4000500000000	40	005	Atoka County, OK	1992	NA	4741	4416	325	6.9
CN4000700000000	40	007	Beaver County, OK	1992	NA	2911	2808	103	3.5
CN4000900000000	40	009	Beckham County, OK	1992	NA	8804	8156	648	7.4
CN4001100000000	40	011	Blaine County, OK	1992	NA	4827	4524	303	6.3
CN4001300000000	40	013	Bryan County, OK	1992	NA	13351	12525	826	6.2
CN4001500000000	40	015	Caddo County, OK	1992	NA	12050	11253	797	6.6
CN4001700000000	40	017	Canadian County, OK	1992	NA	39447	37743	1704	4.3
CN4001900000000	40	019	Carter County, OK	1992	NA	19729	18454	1275	6.5
CN4002100000000	40	021	Cherokee County, OK	1992	NA	16029	14880	1149	7.2
CN4002300000000	40	023	Choctaw County, OK	1992	NA	5907	5137	770	13
CN4002500000000	40	025	Cimarron County, OK	1992	NA	1855	1813	42	2.3
CN4002700000000	40	027	Cleveland County, OK	1992	NA	94500	90983	3517	3.7
CN4002900000000	40	029	Coal County, OK	1992	NA	2450	2174	276	11.3
CN4003100000000	40	031	Comanche County, OK	1992	NA	42806	40346	2460	5.7
CN4003300000000	40	033	Cotton County, OK	1992	NA	2288	2158	130	5.7
CN4003500000000	40	035	Craig County, OK	1992	NA	6566	6209	357	5.4
CN4003700000000	40	037	Creek County, OK	1992	NA	29553	27640	1913	6.5
CN4003900000000	40	039	Custer County, OK	1992	NA	13587	12894	693	5.1
CN4004100000000	40	041	Delaware County, OK	1992	NA	13087	12290	797	6.1
CN4004300000000	40	043	Dewey County, OK	1992	NA	2436	2340	96	3.9
CN4004500000000	40	045	Ellis County, OK	1992	NA	1903	1788	115	6
CN4004700000000	40	047	Garfield County, OK	1992	NA	26504	25513	991	3.7
CN4004900000000	40	049	Garvin County, OK	1992	NA	11260	10345	915	8.1
CN4005100000000	40	051	Grady County, OK	1992	NA	18961	17762	1199	6.3
CN4005300000000	40	053	Grant County, OK	1992	NA	2526	2462	64	2.5
CN4005500000000	40	055	Greer County, OK	1992	NA	2269	2201	68	3
CN4005700000000	40	057	Harmon County, OK	1992	NA	1415	1351	64	4.5
CN4005900000000	40	059	Harper County, OK	1992	NA	2051	1997	54	2.6
CN4006100000000	40	061	Haskell County, OK	1992	NA	4340	3675	665	15.3
CN4006300000000	40	063	Hughes County, OK	1992	NA	5449	4745	704	12.9
CN4006500000000	40	065	Jackson County, OK	1992	NA	10155	9621	534	5.3
CN4006700000000	40	067	Jefferson County, OK	1992	NA	3107	2899	208	6.7
CN4006900000000	40	069	Johnston County, OK	1992	NA	4201	3952	249	5.9
CN4007100000000	40	071	Kay County, OK	1992	NA	23863	22421	1442	6
CN4007300000000	40	073	Kingfisher County, OK	1992	NA	6468	6175	293	4.5
CN4007500000000	40	075	Kiowa County, OK	1992	NA	4817	4634	183	3.8
CN4007700000000	40	077	Latimer County, OK	1992	NA	4107	3501	606	14.8
CN4007900000000	40	079	Le Flore County, OK	1992	NA	17722	15872	1850	10.4
CN4008100000000	40	081	Lincoln County, OK	1992	NA	14133	13304	829	5.9
CN4008300000000	40	083	Logan County, OK	1992	NA	13260	12689	571	4.3
CN4008500000000	40	085	Love County, OK	1992	NA	3727	3529	198	5.3
CN4008700000000	40	087	McClain County, OK	1992	NA	11101	10575	526	4.7
CN4008900000000	40	089	McCurtain County, OK	1992	NA	14692	13438	1254	8.5
CN4009100000000	40	091	McIntosh County, OK	1992	NA	6608	6044	564	8.5
CN4009300000000	40	093	Major County, OK	1992	NA	3751	3607	144	3.8
CN4009500000000	40	095	Marshall County, OK	1992	NA	4892	4592	300	6.1
CN4009700000000	40	097	Mayes County, OK	1992	NA	14451	13129	1322	9.1
CN4009900000000	40	099	Murray County, OK	1992	NA	5718	5098	620	10.8
CN4010100000000	40	101	Muskogee County, OK	1992	NA	29150	26968	2182	7.5
CN4010300000000	40	103	Noble County, OK	1992	NA	5197	4978	219	4.2
CN4010500000000	40	105	Nowata County, OK	1992	NA	4214	3922	292	6.9
CN4010700000000	40	107	Okfuskee County, OK	1992	NA	4557	4159	398	8.7
CN4010900000000	40	109	Oklahoma County, OK	1992	NA	304810	287191	17619	5.8
CN4011100000000	40	111	Okmulgee County, OK	1992	NA	14757	13184	1573	10.7
CN4011300000000	40	113	Osage County, OK	1992	NA	18824	17901	923	4.9
CN4011500000000	40	115	Ottawa County, OK	1992	NA	12933	11866	1067	8.3
CN4011700000000	40	117	Pawnee County, OK	1992	NA	6799	6155	644	9.5
CN4011900000000	40	119	Payne County, OK	1992	NA	32684	31717	967	3
CN4012100000000	40	121	Pittsburg County, OK	1992	NA	17959	15874	2085	11.6
CN4012300000000	40	123	Pontotoc County, OK	1992	NA	15823	14671	1152	7.3
CN4012500000000	40	125	Pottawatomie County, OK	1992	NA	26046	24431	1615	6.2
CN4012700000000	40	127	Pushmataha County, OK	1992	NA	4571	4167	404	8.8
CN4012900000000	40	129	Roger Mills County, OK	1992	NA	1998	1915	83	4.2
CN4013100000000	40	131	Rogers County, OK	1992	NA	29225	27260	1965	6.7
CN4013300000000	40	133	Seminole County, OK	1992	NA	10763	9698	1065	9.9
CN4013500000000	40	135	Sequoyah County, OK	1992	NA	15539	14267	1272	8.2
CN4013700000000	40	137	Stephens County, OK	1992	NA	18748	17369	1379	7.4
CN4013900000000	40	139	Texas County, OK	1992	NA	8545	8244	301	3.5
CN4014100000000	40	141	Tillman County, OK	1992	NA	4309	4021	288	6.7
CN4014300000000	40	143	Tulsa County, OK	1992	NA	271512	256839	14673	5.4
CN4014500000000	40	145	Wagoner County, OK	1992	NA	24579	23149	1430	5.8
CN4014700000000	40	147	Washington County, OK	1992	NA	22540	21058	1482	6.6
CN4014900000000	40	149	Washita County, OK	1992	NA	5233	4996	237	4.5
CN4015100000000	40	151	Woods County, OK	1992	NA	4381	4289	92	2.1
CN4015300000000	40	153	Woodward County, OK	1992	NA	8828	8249	579	6.6
CN4100100000000	41	001	Baker County, OR	1992	NA	7224	6526	698	9.7
CN4100300000000	41	003	Benton County, OR	1992	NA	36454	34958	1496	4.1
CN4100500000000	41	005	Clackamas County, OR	1992	NA	164626	155485	9141	5.6
CN4100700000000	41	007	Clatsop County, OR	1992	NA	16741	15313	1428	8.5
CN4100900000000	41	009	Columbia County, OR	1992	NA	19581	17738	1843	9.4
CN4101100000000	41	011	Coos County, OR	1992	NA	27392	24406	2986	10.9
CN4101300000000	41	013	Crook County, OR	1992	NA	7350	6726	624	8.5
CN4101500000000	41	015	Curry County, OR	1992	NA	8128	7390	738	9.1
CN4101700000000	41	017	Deschutes County, OR	1992	NA	44646	40958	3688	8.3
CN4101900000000	41	019	Douglas County, OR	1992	NA	42740	37621	5119	12
CN4102100000000	41	021	Gilliam County, OR	1992	NA	1119	1074	45	4
CN4102300000000	41	023	Grant County, OR	1992	NA	4428	3951	477	10.8
CN4102500000000	41	025	Harney County, OR	1992	NA	3684	3319	365	9.9
CN4102700000000	41	027	Hood River County, OR	1992	NA	9610	8615	995	10.4
CN4102900000000	41	029	Jackson County, OR	1992	NA	77105	70700	6405	8.3
CN4103100000000	41	031	Jefferson County, OR	1992	NA	7271	6657	614	8.4
CN4103300000000	41	033	Josephine County, OR	1992	NA	27324	24603	2721	10
CN4103500000000	41	035	Klamath County, OR	1992	NA	28065	25199	2866	10.2
CN4103700000000	41	037	Lake County, OR	1992	NA	3779	3447	332	8.8
CN4103900000000	41	039	Lane County, OR	1992	NA	147107	136257	10850	7.4
CN4104100000000	41	041	Lincoln County, OR	1992	NA	20542	19062	1480	7.2
CN4104300000000	41	043	Linn County, OR	1992	NA	45140	40737	4403	9.8
CN4104500000000	41	045	Malheur County, OR	1992	NA	14602	13367	1235	8.5
CN4104700000000	41	047	Marion County, OR	1992	NA	122439	113921	8518	7
CN4104900000000	41	049	Morrow County, OR	1992	NA	3821	3417	404	10.6
CN4105100000000	41	051	Multnomah County, OR	1992	NA	336459	312504	23955	7.1
CN4105300000000	41	053	Polk County, OR	1992	NA	25870	24329	1541	6
CN4105500000000	41	055	Sherman County, OR	1992	NA	1002	915	87	8.7
CN4105700000000	41	057	Tillamook County, OR	1992	NA	10191	9487	704	6.9
CN4105900000000	41	059	Umatilla County, OR	1992	NA	30977	28179	2798	9
CN4106100000000	41	061	Union County, OR	1992	NA	12076	11072	1004	8.3
CN4106300000000	41	063	Wallowa County, OR	1992	NA	3686	3312	374	10.1
CN4106500000000	41	065	Wasco County, OR	1992	NA	11572	10521	1051	9.1
CN4106700000000	41	067	Washington County, OR	1992	NA	197219	185535	11684	5.9
CN4106900000000	41	069	Wheeler County, OR	1992	NA	524	474	50	9.5
CN4107100000000	41	071	Yamhill County, OR	1992	NA	34107	31755	2352	6.9
CN4200100000000	42	001	Adams County, PA	1992	NA	42712	40187	2525	5.9
CN4200300000000	42	003	Allegheny County, PA	1992	NA	661966	620541	41425	6.3
CN4200500000000	42	005	Armstrong County, PA	1992	NA	31973	28483	3490	10.9
CN4200700000000	42	007	Beaver County, PA	1992	NA	85592	78882	6710	7.8
CN4200900000000	42	009	Bedford County, PA	1992	NA	23347	20792	2555	10.9
CN4201100000000	42	011	Berks County, PA	1992	NA	178842	166872	11970	6.7
CN4201300000000	42	013	Blair County, PA	1992	NA	62214	56595	5619	9
CN4201500000000	42	015	Bradford County, PA	1992	NA	27775	25582	2193	7.9
CN4201700000000	42	017	Bucks County, PA	1992	NA	305522	282942	22580	7.4
CN4201900000000	42	019	Butler County, PA	1992	NA	78378	72895	5483	7
CN4202100000000	42	021	Cambria County, PA	1992	NA	69811	62114	7697	11
CN4202300000000	42	023	Cameron County, PA	1992	NA	2504	2250	254	10.1
CN4202500000000	42	025	Carbon County, PA	1992	NA	27152	24223	2929	10.8
CN4202700000000	42	027	Centre County, PA	1992	NA	62439	59591	2848	4.6
CN4202900000000	42	029	Chester County, PA	1992	NA	210119	198881	11238	5.3
CN4203100000000	42	031	Clarion County, PA	1992	NA	18602	16872	1730	9.3
CN4203300000000	42	033	Clearfield County, PA	1992	NA	36122	32198	3924	10.9
CN4203500000000	42	035	Clinton County, PA	1992	NA	17678	15930	1748	9.9
CN4203700000000	42	037	Columbia County, PA	1992	NA	32340	29317	3023	9.3
CN4203900000000	42	039	Crawford County, PA	1992	NA	39952	36198	3754	9.4
CN4204100000000	42	041	Cumberland County, PA	1992	NA	112492	107556	4936	4.4
CN4204300000000	42	043	Dauphin County, PA	1992	NA	132694	125609	7085	5.3
CN4204500000000	42	045	Delaware County, PA	1992	NA	278996	259430	19566	7
CN4204700000000	42	047	Elk County, PA	1992	NA	16872	15638	1234	7.3
CN4204900000000	42	049	Erie County, PA	1992	NA	139077	128331	10746	7.7
CN4205100000000	42	051	Fayette County, PA	1992	NA	56913	50867	6046	10.6
CN4205300000000	42	053	Forest County, PA	1992	NA	2046	1783	263	12.9
CN4205500000000	42	055	Franklin County, PA	1992	NA	62431	58694	3737	6
CN4205700000000	42	057	Fulton County, PA	1992	NA	6546	6027	519	7.9
CN4205900000000	42	059	Greene County, PA	1992	NA	15650	13774	1876	12
CN4206100000000	42	061	Huntingdon County, PA	1992	NA	19908	17273	2635	13.2
CN4206300000000	42	063	Indiana County, PA	1992	NA	38355	34096	4259	11.1
CN4206500000000	42	065	Jefferson County, PA	1992	NA	21390	19184	2206	10.3
CN4206700000000	42	067	Juniata County, PA	1992	NA	10421	9129	1292	12.4
CN4206900000000	42	069	Lackawanna County, PA	1992	NA	107201	97610	9591	8.9
CN4207100000000	42	071	Lancaster County, PA	1992	NA	228543	217617	10926	4.8
CN4207300000000	42	073	Lawrence County, PA	1992	NA	41506	37165	4341	10.5
CN4207500000000	42	075	Lebanon County, PA	1992	NA	62644	59283	3361	5.4
CN4207700000000	42	077	Lehigh County, PA	1992	NA	154353	143488	10865	7
CN4207900000000	42	079	Luzerne County, PA	1992	NA	161432	144693	16739	10.4
CN4208100000000	42	081	Lycoming County, PA	1992	NA	58137	53125	5012	8.6
CN4208300000000	42	083	McKean County, PA	1992	NA	21324	19388	1936	9.1
CN4208500000000	42	085	Mercer County, PA	1992	NA	56530	51372	5158	9.1
CN4208700000000	42	087	Mifflin County, PA	1992	NA	22746	20358	2388	10.5
CN4208900000000	42	089	Monroe County, PA	1992	NA	48937	43578	5359	11
CN4209100000000	42	091	Montgomery County, PA	1992	NA	378695	354952	23743	6.3
CN4209300000000	42	093	Montour County, PA	1992	NA	8920	8395	525	5.9
CN4209500000000	42	095	Northampton County, PA	1992	NA	127049	117573	9476	7.5
CN4209700000000	42	097	Northumberland County, PA	1992	NA	45680	41307	4373	9.6
CN4209900000000	42	099	Perry County, PA	1992	NA	22599	21165	1434	6.3
CN4210100000000	42	101	Philadelphia County/city, PA	1992	NA	685029	620597	64432	9.4
CN4210300000000	42	103	Pike County, PA	1992	NA	15536	14226	1310	8.4
CN4210500000000	42	105	Potter County, PA	1992	NA	7964	7156	808	10.1
CN4210700000000	42	107	Schuylkill County, PA	1992	NA	70832	63957	6875	9.7
CN4210900000000	42	109	Snyder County, PA	1992	NA	18771	17405	1366	7.3
CN4211100000000	42	111	Somerset County, PA	1992	NA	36503	32880	3623	9.9
CN4211300000000	42	113	Sullivan County, PA	1992	NA	2577	2295	282	10.9
CN4211500000000	42	115	Susquehanna County, PA	1992	NA	18823	17013	1810	9.6
CN4211700000000	42	117	Tioga County, PA	1992	NA	18677	17235	1442	7.7
CN4211900000000	42	119	Union County, PA	1992	NA	16948	15771	1177	6.9
CN4212100000000	42	121	Venango County, PA	1992	NA	25459	23061	2398	9.4
CN4212300000000	42	123	Warren County, PA	1992	NA	22700	20918	1782	7.9
CN4212500000000	42	125	Washington County, PA	1992	NA	93811	86701	7110	7.6
CN4212700000000	42	127	Wayne County, PA	1992	NA	19352	17298	2054	10.6
CN4212900000000	42	129	Westmoreland County, PA	1992	NA	178202	164553	13649	7.7
CN4213100000000	42	131	Wyoming County, PA	1992	NA	14681	13158	1523	10.4
CN4213300000000	42	133	York County, PA	1992	NA	190170	178142	12028	6.3
CN4400100000000	44	001	Bristol County, RI	1992	NA	26653	24217	2436	9.1
CN4400300000000	44	003	Kent County, RI	1992	NA	90105	82158	7947	8.8
CN4400500000000	44	005	Newport County, RI	1992	NA	42714	39089	3625	8.5
CN4400700000000	44	007	Providence County, RI	1992	NA	306450	277743	28707	9.4
CN4400900000000	44	009	Washington County, RI	1992	NA	60735	56697	4038	6.6
CN4500100000000	45	001	Abbeville County, SC	1992	NA	11969	11063	906	7.6
CN4500300000000	45	003	Aiken County, SC	1992	NA	62353	58237	4116	6.6
CN4500500000000	45	005	Allendale County, SC	1992	NA	4874	4303	571	11.7
CN4500700000000	45	007	Anderson County, SC	1992	NA	76690	72209	4481	5.8
CN4500900000000	45	009	Bamberg County, SC	1992	NA	7625	6849	776	10.2
CN4501100000000	45	011	Barnwell County, SC	1992	NA	10310	9002	1308	12.7
CN4501300000000	45	013	Beaufort County, SC	1992	NA	38031	36272	1759	4.6
CN4501500000000	45	015	Berkeley County, SC	1992	NA	58927	55616	3311	5.6
CN4501700000000	45	017	Calhoun County, SC	1992	NA	6215	5770	445	7.2
CN4501900000000	45	019	Charleston County, SC	1992	NA	146754	137856	8898	6.1
CN4502100000000	45	021	Cherokee County, SC	1992	NA	23270	21799	1471	6.3
CN4502300000000	45	023	Chester County, SC	1992	NA	16104	14190	1914	11.9
CN4502500000000	45	025	Chesterfield County, SC	1992	NA	19756	18503	1253	6.3
CN4502700000000	45	027	Clarendon County, SC	1992	NA	11858	10420	1438	12.1
CN4502900000000	45	029	Colleton County, SC	1992	NA	15754	14025	1729	11
CN4503100000000	45	031	Darlington County, SC	1992	NA	31803	28762	3041	9.6
CN4503300000000	45	033	Dillon County, SC	1992	NA	12955	11576	1379	10.6
CN4503500000000	45	035	Dorchester County, SC	1992	NA	40684	38572	2112	5.2
CN4503700000000	45	037	Edgefield County, SC	1992	NA	8950	8383	567	6.3
CN4503900000000	45	039	Fairfield County, SC	1992	NA	10859	9748	1111	10.2
CN4504100000000	45	041	Florence County, SC	1992	NA	59200	54850	4350	7.3
CN4504300000000	45	043	Georgetown County, SC	1992	NA	22187	19900	2287	10.3
CN4504500000000	45	045	Greenville County, SC	1992	NA	175962	166367	9595	5.5
CN4504700000000	45	047	Greenwood County, SC	1992	NA	31064	28924	2140	6.9
CN4504900000000	45	049	Hampton County, SC	1992	NA	7823	7104	719	9.2
CN4505100000000	45	051	Horry County, SC	1992	NA	80930	74380	6550	8.1
CN4505300000000	45	053	Jasper County, SC	1992	NA	6682	6339	343	5.1
CN4505500000000	45	055	Kershaw County, SC	1992	NA	23661	21470	2191	9.3
CN4505700000000	45	057	Lancaster County, SC	1992	NA	29056	26357	2699	9.3
CN4505900000000	45	059	Laurens County, SC	1992	NA	29916	28102	1814	6.1
CN4506100000000	45	061	Lee County, SC	1992	NA	8250	7469	781	9.5
CN4506300000000	45	063	Lexington County, SC	1992	NA	99495	95040	4455	4.5
CN4506500000000	45	065	McCormick County, SC	1992	NA	3707	3352	355	9.6
CN4506700000000	45	067	Marion County, SC	1992	NA	16689	14576	2113	12.7
CN4506900000000	45	069	Marlboro County, SC	1992	NA	12588	11295	1293	10.3
CN4507100000000	45	071	Newberry County, SC	1992	NA	17427	16060	1367	7.8
CN4507300000000	45	073	Oconee County, SC	1992	NA	29136	26691	2445	8.4
CN4507500000000	45	075	Orangeburg County, SC	1992	NA	40069	36246	3823	9.5
CN4507700000000	45	077	Pickens County, SC	1992	NA	50952	48251	2701	5.3
CN4507900000000	45	079	Richland County, SC	1992	NA	148979	141170	7809	5.2
CN4508100000000	45	081	Saluda County, SC	1992	NA	8485	7969	516	6.1
CN4508300000000	45	083	Spartanburg County, SC	1992	NA	121089	114938	6151	5.1
CN4508500000000	45	085	Sumter County, SC	1992	NA	42597	39119	3478	8.2
CN4508700000000	45	087	Union County, SC	1992	NA	15905	14541	1364	8.6
CN4508900000000	45	089	Williamsburg County, SC	1992	NA	16449	14819	1630	9.9
CN4509100000000	45	091	York County, SC	1992	NA	75225	70412	4813	6.4
CN4600300000000	46	003	Aurora County, SD	1992	NA	1370	1326	44	3.2
CN4600500000000	46	005	Beadle County, SD	1992	NA	9082	8809	273	3
CN4600700000000	46	007	Bennett County, SD	1992	NA	1147	1088	59	5.1
CN4600900000000	46	009	Bon Homme County, SD	1992	NA	3045	2967	78	2.6
CN4601100000000	46	011	Brookings County, SD	1992	NA	13968	13712	256	1.8
CN4601300000000	46	013	Brown County, SD	1992	NA	19304	18802	502	2.6
CN4601500000000	46	015	Brule County, SD	1992	NA	2751	2662	89	3.2
CN4601700000000	46	017	Buffalo County, SD	1992	NA	596	540	56	9.4
CN4601900000000	46	019	Butte County, SD	1992	NA	3598	3432	166	4.6
CN4602100000000	46	021	Campbell County, SD	1992	NA	923	900	23	2.5
CN4602300000000	46	023	Charles Mix County, SD	1992	NA	4413	4242	171	3.9
CN4602500000000	46	025	Clark County, SD	1992	NA	1924	1836	88	4.6
CN4602700000000	46	027	Clay County, SD	1992	NA	6678	6598	80	1.2
CN4602900000000	46	029	Codington County, SD	1992	NA	12599	12137	462	3.7
CN4603100000000	46	031	Corson County, SD	1992	NA	1748	1340	408	23.3
CN4603300000000	46	033	Custer County, SD	1992	NA	3658	3534	124	3.4
CN4603500000000	46	035	Davison County, SD	1992	NA	8995	8728	267	3
CN4603700000000	46	037	Day County, SD	1992	NA	3070	2936	134	4.4
CN4603900000000	46	039	Deuel County, SD	1992	NA	2225	2133	92	4.1
CN4604100000000	46	041	Dewey County, SD	1992	NA	2106	1846	260	12.3
CN4604300000000	46	043	Douglas County, SD	1992	NA	1536	1499	37	2.4
CN4604500000000	46	045	Edmunds County, SD	1992	NA	2071	2030	41	2
CN4604700000000	46	047	Fall River County, SD	1992	NA	3339	3213	126	3.8
CN4604900000000	46	049	Faulk County, SD	1992	NA	1227	1205	22	1.8
CN4605100000000	46	051	Grant County, SD	1992	NA	4206	3953	253	6
CN4605300000000	46	053	Gregory County, SD	1992	NA	2458	2381	77	3.1
CN4605500000000	46	055	Haakon County, SD	1992	NA	1154	1111	43	3.7
CN4605700000000	46	057	Hamlin County, SD	1992	NA	2260	2166	94	4.2
CN4605900000000	46	059	Hand County, SD	1992	NA	2072	2008	64	3.1
CN4606100000000	46	061	Hanson County, SD	1992	NA	1513	1478	35	2.3
CN4606300000000	46	063	Harding County, SD	1992	NA	856	817	39	4.6
CN4606500000000	46	065	Hughes County, SD	1992	NA	8996	8760	236	2.6
CN4606700000000	46	067	Hutchinson County, SD	1992	NA	3928	3823	105	2.7
CN4606900000000	46	069	Hyde County, SD	1992	NA	813	795	18	2.2
CN4607100000000	46	071	Jackson County, SD	1992	NA	1179	1130	49	4.2
CN4607300000000	46	073	Jerauld County, SD	1992	NA	1050	1026	24	2.3
CN4607500000000	46	075	Jones County, SD	1992	NA	741	710	31	4.2
CN4607700000000	46	077	Kingsbury County, SD	1992	NA	2700	2578	122	4.5
CN4607900000000	46	079	Lake County, SD	1992	NA	5535	5375	160	2.9
CN4608100000000	46	081	Lawrence County, SD	1992	NA	11924	11563	361	3
CN4608300000000	46	083	Lincoln County, SD	1992	NA	8359	8169	190	2.3
CN4608500000000	46	085	Lyman County, SD	1992	NA	2031	1956	75	3.7
CN4608700000000	46	087	McCook County, SD	1992	NA	2738	2638	100	3.7
CN4608900000000	46	089	McPherson County, SD	1992	NA	1479	1449	30	2
CN4609100000000	46	091	Marshall County, SD	1992	NA	2171	2101	70	3.2
CN4609300000000	46	093	Meade County, SD	1992	NA	10255	9863	392	3.8
CN4609500000000	46	095	Mellette County, SD	1992	NA	800	753	47	5.9
CN4609700000000	46	097	Miner County, SD	1992	NA	1427	1360	67	4.7
CN4609900000000	46	099	Minnehaha County, SD	1992	NA	71605	69863	1742	2.4
CN4610100000000	46	101	Moody County, SD	1992	NA	3396	3202	194	5.7
CN4610200000000	46	102	Oglala Lakota County, SD	1992	NA	2549	2171	378	14.8
CN4610300000000	46	103	Pennington County, SD	1992	NA	41851	40471	1380	3.3
CN4610500000000	46	105	Perkins County, SD	1992	NA	2056	2005	51	2.5
CN4610700000000	46	107	Potter County, SD	1992	NA	1566	1501	65	4.2
CN4610900000000	46	109	Roberts County, SD	1992	NA	4829	4566	263	5.4
CN4611100000000	46	111	Sanborn County, SD	1992	NA	1282	1248	34	2.7
CN4611500000000	46	115	Spink County, SD	1992	NA	3444	3340	104	3
CN4611700000000	46	117	Stanley County, SD	1992	NA	1483	1429	54	3.6
CN4611900000000	46	119	Sully County, SD	1992	NA	901	871	30	3.3
CN4612100000000	46	121	Todd County, SD	1992	NA	2498	2284	214	8.6
CN4612300000000	46	123	Tripp County, SD	1992	NA	3315	3217	98	3
CN4612500000000	46	125	Turner County, SD	1992	NA	3686	3576	110	3
CN4612700000000	46	127	Union County, SD	1992	NA	6165	5904	261	4.2
CN4612900000000	46	129	Walworth County, SD	1992	NA	2960	2873	87	2.9
CN4613500000000	46	135	Yankton County, SD	1992	NA	10381	10181	200	1.9
CN4613700000000	46	137	Ziebach County, SD	1992	NA	782	734	48	6.1
CN4700100000000	47	001	Anderson County, TN	1992	NA	34646	32759	1887	5.4
CN4700300000000	47	003	Bedford County, TN	1992	NA	15687	14524	1163	7.4
CN4700500000000	47	005	Benton County, TN	1992	NA	7079	6491	588	8.3
CN4700700000000	47	007	Bledsoe County, TN	1992	NA	3447	3153	294	8.5
CN4700900000000	47	009	Blount County, TN	1992	NA	44836	42187	2649	5.9
CN4701100000000	47	011	Bradley County, TN	1992	NA	38245	35634	2611	6.8
CN4701300000000	47	013	Campbell County, TN	1992	NA	15171	13031	2140	14.1
CN4701500000000	47	015	Cannon County, TN	1992	NA	5452	5143	309	5.7
CN4701700000000	47	017	Carroll County, TN	1992	NA	13520	12495	1025	7.6
CN4701900000000	47	019	Carter County, TN	1992	NA	24875	23194	1681	6.8
CN4702100000000	47	021	Cheatham County, TN	1992	NA	14618	13897	721	4.9
CN4702300000000	47	023	Chester County, TN	1992	NA	5790	5461	329	5.7
CN4702500000000	47	025	Claiborne County, TN	1992	NA	11641	10897	744	6.4
CN4702700000000	47	027	Clay County, TN	1992	NA	3561	3294	267	7.5
CN4702900000000	47	029	Cocke County, TN	1992	NA	14860	12892	1968	13.2
CN4703100000000	47	031	Coffee County, TN	1992	NA	19510	18324	1186	6.1
CN4703300000000	47	033	Crockett County, TN	1992	NA	7066	6613	453	6.4
CN4703500000000	47	035	Cumberland County, TN	1992	NA	16492	14997	1495	9.1
CN4703700000000	47	037	Davidson County, TN	1992	NA	275249	261922	13327	4.8
CN4703900000000	47	039	Decatur County, TN	1992	NA	4812	4288	524	10.9
CN4704100000000	47	041	DeKalb County, TN	1992	NA	7604	7036	568	7.5
CN4704300000000	47	043	Dickson County, TN	1992	NA	17417	16312	1105	6.3
CN4704500000000	47	045	Dyer County, TN	1992	NA	16775	15350	1425	8.5
CN4704700000000	47	047	Fayette County, TN	1992	NA	11415	10453	962	8.4
CN4704900000000	47	049	Fentress County, TN	1992	NA	6971	6248	723	10.4
CN4705100000000	47	051	Franklin County, TN	1992	NA	16338	15331	1007	6.2
CN4705300000000	47	053	Gibson County, TN	1992	NA	21961	20166	1795	8.2
CN4705500000000	47	055	Giles County, TN	1992	NA	13097	12153	944	7.2
CN4705700000000	47	057	Grainger County, TN	1992	NA	8515	7864	651	7.6
CN4705900000000	47	059	Greene County, TN	1992	NA	28221	24846	3375	12
CN4706100000000	47	061	Grundy County, TN	1992	NA	4976	4319	657	13.2
CN4706300000000	47	063	Hamblen County, TN	1992	NA	27248	25107	2141	7.9
CN4706500000000	47	065	Hamilton County, TN	1992	NA	141829	133904	7925	5.6
CN4706700000000	47	067	Hancock County, TN	1992	NA	2345	2159	186	7.9
CN4706900000000	47	069	Hardeman County, TN	1992	NA	9437	8618	819	8.7
CN4707100000000	47	071	Hardin County, TN	1992	NA	10727	9554	1173	10.9
CN4707300000000	47	073	Hawkins County, TN	1992	NA	21616	20310	1306	6
CN4707500000000	47	075	Haywood County, TN	1992	NA	8727	7635	1092	12.5
CN4707700000000	47	077	Henderson County, TN	1992	NA	11353	10415	938	8.3
CN4707900000000	47	079	Henry County, TN	1992	NA	13246	12264	982	7.4
CN4708100000000	47	081	Hickman County, TN	1992	NA	8003	7348	655	8.2
CN4708300000000	47	083	Houston County, TN	1992	NA	3244	2801	443	13.7
CN4708500000000	47	085	Humphreys County, TN	1992	NA	6609	5725	884	13.4
CN4708700000000	47	087	Jackson County, TN	1992	NA	4104	3766	338	8.2
CN4708900000000	47	089	Jefferson County, TN	1992	NA	17935	16333	1602	8.9
CN4709100000000	47	091	Johnson County, TN	1992	NA	7119	6509	610	8.6
CN4709300000000	47	093	Knox County, TN	1992	NA	182982	174615	8367	4.6
CN4709500000000	47	095	Lake County, TN	1992	NA	2696	2508	188	7
CN4709700000000	47	097	Lauderdale County, TN	1992	NA	9394	8473	921	9.8
CN4709900000000	47	099	Lawrence County, TN	1992	NA	19623	18086	1537	7.8
CN4710100000000	47	101	Lewis County, TN	1992	NA	4557	4218	339	7.4
CN4710300000000	47	103	Lincoln County, TN	1992	NA	14358	13500	858	6
CN4710500000000	47	105	Loudon County, TN	1992	NA	17148	16171	977	5.7
CN4710700000000	47	107	McMinn County, TN	1992	NA	20182	18286	1896	9.4
CN4710900000000	47	109	McNairy County, TN	1992	NA	11147	10198	949	8.5
CN4711100000000	47	111	Macon County, TN	1992	NA	8626	8095	531	6.2
CN4711300000000	47	113	Madison County, TN	1992	NA	40021	37563	2458	6.1
CN4711500000000	47	115	Marion County, TN	1992	NA	11644	10623	1021	8.8
CN4711700000000	47	117	Marshall County, TN	1992	NA	11619	10921	698	6
CN4711900000000	47	119	Maury County, TN	1992	NA	31061	28438	2623	8.4
CN4712100000000	47	121	Meigs County, TN	1992	NA	3925	3396	529	13.5
CN4712300000000	47	123	Monroe County, TN	1992	NA	13827	12286	1541	11.1
CN4712500000000	47	125	Montgomery County, TN	1992	NA	41922	39305	2617	6.2
CN4712700000000	47	127	Moore County, TN	1992	NA	2646	2523	123	4.6
CN4712900000000	47	129	Morgan County, TN	1992	NA	6913	6216	697	10.1
CN4713100000000	47	131	Obion County, TN	1992	NA	14274	12902	1372	9.6
CN4713300000000	47	133	Overton County, TN	1992	NA	8601	7844	757	8.8
CN4713500000000	47	135	Perry County, TN	1992	NA	2894	2621	273	9.4
CN4713700000000	47	137	Pickett County, TN	1992	NA	2030	1876	154	7.6
CN4713900000000	47	139	Polk County, TN	1992	NA	6311	5676	635	10.1
CN4714100000000	47	141	Putnam County, TN	1992	NA	26871	24997	1874	7
CN4714300000000	47	143	Rhea County, TN	1992	NA	10459	9380	1079	10.3
CN4714500000000	47	145	Roane County, TN	1992	NA	20475	18722	1753	8.6
CN4714700000000	47	147	Robertson County, TN	1992	NA	21935	20511	1424	6.5
CN4714900000000	47	149	Rutherford County, TN	1992	NA	67967	64683	3284	4.8
CN4715100000000	47	151	Scott County, TN	1992	NA	7701	6476	1225	15.9
CN4715300000000	47	153	Sequatchie County, TN	1992	NA	4450	4018	432	9.7
CN4715500000000	47	155	Sevier County, TN	1992	NA	29672	26844	2828	9.5
CN4715700000000	47	157	Shelby County, TN	1992	NA	396267	373133	23134	5.8
CN4715900000000	47	159	Smith County, TN	1992	NA	7782	7331	451	5.8
CN4716100000000	47	161	Stewart County, TN	1992	NA	4092	3675	417	10.2
CN4716300000000	47	163	Sullivan County, TN	1992	NA	71815	68151	3664	5.1
CN4716500000000	47	165	Sumner County, TN	1992	NA	56062	52495	3567	6.4
CN4716700000000	47	167	Tipton County, TN	1992	NA	17196	15955	1241	7.2
CN4716900000000	47	169	Trousdale County, TN	1992	NA	2718	2481	237	8.7
CN4717100000000	47	171	Unicoi County, TN	1992	NA	7930	7096	834	10.5
CN4717300000000	47	173	Union County, TN	1992	NA	6510	6203	307	4.7
CN4717500000000	47	175	Van Buren County, TN	1992	NA	2294	2092	202	8.8
CN4717700000000	47	177	Warren County, TN	1992	NA	17807	16323	1484	8.3
CN4717900000000	47	179	Washington County, TN	1992	NA	47822	45218	2604	5.4
CN4718100000000	47	181	Wayne County, TN	1992	NA	7426	6839	587	7.9
CN4718300000000	47	183	Weakley County, TN	1992	NA	17609	16816	793	4.5
CN4718500000000	47	185	White County, TN	1992	NA	9936	8931	1005	10.1
CN4718700000000	47	187	Williamson County, TN	1992	NA	45742	44004	1738	3.8
CN4718900000000	47	189	Wilson County, TN	1992	NA	36863	34929	1934	5.2
CN4800100000000	48	001	Anderson County, TX	1992	NA	18588	17171	1417	7.6
CN4800300000000	48	003	Andrews County, TX	1992	NA	6342	5831	511	8.1
CN4800500000000	48	005	Angelina County, TX	1992	NA	33659	31101	2558	7.6
CN4800700000000	48	007	Aransas County, TX	1992	NA	7864	7388	476	6.1
CN4800900000000	48	009	Archer County, TX	1992	NA	3761	3616	145	3.9
CN4801100000000	48	011	Armstrong County, TX	1992	NA	1073	1030	43	4
CN4801300000000	48	013	Atascosa County, TX	1992	NA	14287	13090	1197	8.4
CN4801500000000	48	015	Austin County, TX	1992	NA	9679	9268	411	4.2
CN4801700000000	48	017	Bailey County, TX	1992	NA	3807	3560	247	6.5
CN4801900000000	48	019	Bandera County, TX	1992	NA	6375	6167	208	3.3
CN4802100000000	48	021	Bastrop County, TX	1992	NA	19711	18834	877	4.4
CN4802300000000	48	023	Baylor County, TX	1992	NA	1853	1781	72	3.9
CN4802500000000	48	025	Bee County, TX	1992	NA	9477	8439	1038	11
CN4802700000000	48	027	Bell County, TX	1992	NA	79657	74111	5546	7
CN4802900000000	48	029	Bexar County, TX	1992	NA	588301	550605	37696	6.4
CN4803100000000	48	031	Blanco County, TX	1992	NA	2985	2868	117	3.9
CN4803300000000	48	033	Borden County, TX	1992	NA	382	365	17	4.5
CN4803500000000	48	035	Bosque County, TX	1992	NA	6057	5711	346	5.7
CN4803700000000	48	037	Bowie County, TX	1992	NA	39496	35771	3725	9.4
CN4803900000000	48	039	Brazoria County, TX	1992	NA	102909	95570	7339	7.1
CN4804100000000	48	041	Brazos County, TX	1992	NA	64214	62350	1864	2.9
CN4804300000000	48	043	Brewster County, TX	1992	NA	4234	4141	93	2.2
CN4804500000000	48	045	Briscoe County, TX	1992	NA	978	938	40	4.1
CN4804700000000	48	047	Brooks County, TX	1992	NA	3055	2665	390	12.8
CN4804900000000	48	049	Brown County, TX	1992	NA	15584	14170	1414	9.1
CN4805100000000	48	051	Burleson County, TX	1992	NA	6997	6619	378	5.4
CN4805300000000	48	053	Burnet County, TX	1992	NA	9681	9039	642	6.6
CN4805500000000	48	055	Caldwell County, TX	1992	NA	12206	11660	546	4.5
CN4805700000000	48	057	Calhoun County, TX	1992	NA	10004	9201	803	8
CN4805900000000	48	059	Callahan County, TX	1992	NA	5527	5235	292	5.3
CN4806100000000	48	061	Cameron County, TX	1992	NA	113741	97092	16649	14.6
CN4806300000000	48	063	Camp County, TX	1992	NA	4961	4360	601	12.1
CN4806500000000	48	065	Carson County, TX	1992	NA	3395	3218	177	5.2
CN4806700000000	48	067	Cass County, TX	1992	NA	14454	12622	1832	12.7
CN4806900000000	48	069	Castro County, TX	1992	NA	4077	3804	273	6.7
CN4807100000000	48	071	Chambers County, TX	1992	NA	9999	9385	614	6.1
CN4807300000000	48	073	Cherokee County, TX	1992	NA	18907	17522	1385	7.3
CN4807500000000	48	075	Childress County, TX	1992	NA	3052	2838	214	7
CN4807700000000	48	077	Clay County, TX	1992	NA	4718	4488	230	4.9
CN4807900000000	48	079	Cochran County, TX	1992	NA	1895	1747	148	7.8
CN4808100000000	48	081	Coke County, TX	1992	NA	1413	1356	57	4
CN4808300000000	48	083	Coleman County, TX	1992	NA	3670	3378	292	8
CN4808500000000	48	085	Collin County, TX	1992	NA	173527	164507	9020	5.2
CN4808700000000	48	087	Collingsworth County, TX	1992	NA	1780	1695	85	4.8
CN4808900000000	48	089	Colorado County, TX	1992	NA	8382	7993	389	4.6
CN4809100000000	48	091	Comal County, TX	1992	NA	27901	26404	1497	5.4
CN4809300000000	48	093	Comanche County, TX	1992	NA	6301	5984	317	5
CN4809500000000	48	095	Concho County, TX	1992	NA	1461	1413	48	3.3
CN4809700000000	48	097	Cooke County, TX	1992	NA	15480	14510	970	6.3
CN4809900000000	48	099	Coryell County, TX	1992	NA	18310	17177	1133	6.2
CN4810100000000	48	101	Cottle County, TX	1992	NA	919	852	67	7.3
CN4810300000000	48	103	Crane County, TX	1992	NA	2269	2093	176	7.8
CN4810500000000	48	105	Crockett County, TX	1992	NA	1945	1795	150	7.7
CN4810700000000	48	107	Crosby County, TX	1992	NA	3294	3032	262	8
CN4810900000000	48	109	Culberson County, TX	1992	NA	1540	1425	115	7.5
CN4811100000000	48	111	Dallam County, TX	1992	NA	2865	2763	102	3.6
CN4811300000000	48	113	Dallas County, TX	1992	NA	1096470	1015638	80832	7.4
CN4811500000000	48	115	Dawson County, TX	1992	NA	5903	5481	422	7.1
CN4811700000000	48	117	Deaf Smith County, TX	1992	NA	9170	8378	792	8.6
CN4811900000000	48	119	Delta County, TX	1992	NA	2100	1955	145	6.9
CN4812100000000	48	121	Denton County, TX	1992	NA	178464	169325	9139	5.1
CN4812300000000	48	123	DeWitt County, TX	1992	NA	8087	7603	484	6
CN4812500000000	48	125	Dickens County, TX	1992	NA	1037	974	63	6.1
CN4812700000000	48	127	Dimmit County, TX	1992	NA	4150	3324	826	19.9
CN4812900000000	48	129	Donley County, TX	1992	NA	1571	1499	72	4.6
CN4813100000000	48	131	Duval County, TX	1992	NA	4490	3837	653	14.5
CN4813300000000	48	133	Eastland County, TX	1992	NA	7855	7310	545	6.9
CN4813500000000	48	135	Ector County, TX	1992	NA	59985	54169	5816	9.7
CN4813700000000	48	137	Edwards County, TX	1992	NA	913	851	62	6.8
CN4813900000000	48	139	Ellis County, TX	1992	NA	45070	41800	3270	7.3
CN4814100000000	48	141	El Paso County, TX	1992	NA	273016	241250	31766	11.6
CN4814300000000	48	143	Erath County, TX	1992	NA	14261	13641	620	4.3
CN4814500000000	48	145	Falls County, TX	1992	NA	7211	6843	368	5.1
CN4814700000000	48	147	Fannin County, TX	1992	NA	11327	10333	994	8.8
CN4814900000000	48	149	Fayette County, TX	1992	NA	10285	9977	308	3
CN4815100000000	48	151	Fisher County, TX	1992	NA	2026	1879	147	7.3
CN4815300000000	48	153	Floyd County, TX	1992	NA	3774	3500	274	7.3
CN4815500000000	48	155	Foard County, TX	1992	NA	964	953	11	1.1
CN4815700000000	48	157	Fort Bend County, TX	1992	NA	134974	128738	6236	4.6
CN4815900000000	48	159	Franklin County, TX	1992	NA	3608	3283	325	9
CN4816100000000	48	161	Freestone County, TX	1992	NA	7486	6985	501	6.7
CN4816300000000	48	163	Frio County, TX	1992	NA	7623	6523	1100	14.4
CN4816500000000	48	165	Gaines County, TX	1992	NA	6801	6434	367	5.4
CN4816700000000	48	167	Galveston County, TX	1992	NA	121668	110833	10835	8.9
CN4816900000000	48	169	Garza County, TX	1992	NA	2527	2391	136	5.4
CN4817100000000	48	171	Gillespie County, TX	1992	NA	9096	8870	226	2.5
CN4817300000000	48	173	Glasscock County, TX	1992	NA	614	594	20	3.3
CN4817500000000	48	175	Goliad County, TX	1992	NA	2747	2587	160	5.8
CN4817700000000	48	177	Gonzales County, TX	1992	NA	7855	7430	425	5.4
CN4817900000000	48	179	Gray County, TX	1992	NA	11023	10319	704	6.4
CN4818100000000	48	181	Grayson County, TX	1992	NA	46042	42366	3676	8
CN4818300000000	48	183	Gregg County, TX	1992	NA	56413	50682	5731	10.2
CN4818500000000	48	185	Grimes County, TX	1992	NA	7941	7465	476	6
CN4818700000000	48	187	Guadalupe County, TX	1992	NA	33500	32094	1406	4.2
CN4818900000000	48	189	Hale County, TX	1992	NA	17255	16154	1101	6.4
CN4819100000000	48	191	Hall County, TX	1992	NA	2012	1855	157	7.8
CN4819300000000	48	193	Hamilton County, TX	1992	NA	3600	3473	127	3.5
CN4819500000000	48	195	Hansford County, TX	1992	NA	2655	2559	96	3.6
CN4819700000000	48	197	Hardeman County, TX	1992	NA	2102	1997	105	5
CN4819900000000	48	199	Hardin County, TX	1992	NA	21131	19527	1604	7.6
CN4820100000000	48	201	Harris County, TX	1992	NA	1618174	1499537	118637	7.3
CN4820300000000	48	203	Harrison County, TX	1992	NA	26565	23919	2646	10
CN4820500000000	48	205	Hartley County, TX	1992	NA	1968	1921	47	2.4
CN4820700000000	48	207	Haskell County, TX	1992	NA	2970	2842	128	4.3
CN4820900000000	48	209	Hays County, TX	1992	NA	35972	34596	1376	3.8
CN4821100000000	48	211	Hemphill County, TX	1992	NA	1900	1803	97	5.1
CN4821300000000	48	213	Henderson County, TX	1992	NA	25648	23412	2236	8.7
CN4821500000000	48	215	Hidalgo County, TX	1992	NA	172500	133971	38529	22.3
CN4821700000000	48	217	Hill County, TX	1992	NA	12974	11778	1196	9.2
CN4821900000000	48	219	Hockley County, TX	1992	NA	11558	10859	699	6
CN4822100000000	48	221	Hood County, TX	1992	NA	13933	12768	1165	8.4
CN4822300000000	48	223	Hopkins County, TX	1992	NA	15005	13773	1232	8.2
CN4822500000000	48	225	Houston County, TX	1992	NA	8528	8058	470	5.5
CN4822700000000	48	227	Howard County, TX	1992	NA	14181	13242	939	6.6
CN4822900000000	48	229	Hudspeth County, TX	1992	NA	1227	1189	38	3.1
CN4823100000000	48	231	Hunt County, TX	1992	NA	32737	29879	2858	8.7
CN4823300000000	48	233	Hutchinson County, TX	1992	NA	11137	10243	894	8
CN4823500000000	48	235	Irion County, TX	1992	NA	949	909	40	4.2
CN4823700000000	48	237	Jack County, TX	1992	NA	3228	3046	182	5.6
CN4823900000000	48	239	Jackson County, TX	1992	NA	5854	5531	323	5.5
CN4824100000000	48	241	Jasper County, TX	1992	NA	13827	12189	1638	11.8
CN4824300000000	48	243	Jeff Davis County, TX	1992	NA	1008	963	45	4.5
CN4824500000000	48	245	Jefferson County, TX	1992	NA	121346	110681	10665	8.8
CN4824700000000	48	247	Jim Hogg County, TX	1992	NA	2071	1807	264	12.7
CN4824900000000	48	249	Jim Wells County, TX	1992	NA	15911	13861	2050	12.9
CN4825100000000	48	251	Johnson County, TX	1992	NA	49951	46943	3008	6
CN4825300000000	48	253	Jones County, TX	1992	NA	8073	7600	473	5.9
CN4825500000000	48	255	Karnes County, TX	1992	NA	5110	4756	354	6.9
CN4825700000000	48	257	Kaufman County, TX	1992	NA	25709	24147	1562	6.1
CN4825900000000	48	259	Kendall County, TX	1992	NA	8273	8074	199	2.4
CN4826100000000	48	261	Kenedy County, TX	1992	NA	219	217	2	0.9
CN4826300000000	48	263	Kent County, TX	1992	NA	472	453	19	4
CN4826500000000	48	265	Kerr County, TX	1992	NA	16202	15515	687	4.2
CN4826700000000	48	267	Kimble County, TX	1992	NA	2205	2138	67	3
CN4826900000000	48	269	King County, TX	1992	NA	137	133	4	2.9
CN4827100000000	48	271	Kinney County, TX	1992	NA	1181	1067	114	9.7
CN4827300000000	48	273	Kleberg County, TX	1992	NA	13104	12087	1017	7.8
CN4827500000000	48	275	Knox County, TX	1992	NA	2467	2367	100	4.1
CN4827700000000	48	277	Lamar County, TX	1992	NA	21160	19274	1886	8.9
CN4827900000000	48	279	Lamb County, TX	1992	NA	6546	6074	472	7.2
CN4828100000000	48	281	Lampasas County, TX	1992	NA	6350	5909	441	6.9
CN4828300000000	48	283	La Salle County, TX	1992	NA	2505	2255	250	10
CN4828500000000	48	285	Lavaca County, TX	1992	NA	8780	8542	238	2.7
CN4828700000000	48	287	Lee County, TX	1992	NA	6886	6613	273	4
CN4828900000000	48	289	Leon County, TX	1992	NA	5263	4820	443	8.4
CN4829100000000	48	291	Liberty County, TX	1992	NA	24348	21746	2602	10.7
CN4829300000000	48	293	Limestone County, TX	1992	NA	9283	8755	528	5.7
CN4829500000000	48	295	Lipscomb County, TX	1992	NA	1403	1338	65	4.6
CN4829700000000	48	297	Live Oak County, TX	1992	NA	4862	4610	252	5.2
CN4829900000000	48	299	Llano County, TX	1992	NA	4296	4096	200	4.7
CN4830100000000	48	301	Loving County, TX	1992	NA	79	75	4	5.1
CN4830300000000	48	303	Lubbock County, TX	1992	NA	115847	109227	6620	5.7
CN4830500000000	48	305	Lynn County, TX	1992	NA	2872	2737	135	4.7
CN4830700000000	48	307	McCulloch County, TX	1992	NA	3496	3215	281	8
CN4830900000000	48	309	McLennan County, TX	1992	NA	94608	88306	6302	6.7
CN4831100000000	48	311	McMullen County, TX	1992	NA	336	330	6	1.8
CN4831300000000	48	313	Madison County, TX	1992	NA	4081	3939	142	3.5
CN4831500000000	48	315	Marion County, TX	1992	NA	3885	3378	507	13.1
CN4831700000000	48	317	Martin County, TX	1992	NA	1848	1797	51	2.8
CN4831900000000	48	319	Mason County, TX	1992	NA	1578	1516	62	3.9
CN4832100000000	48	321	Matagorda County, TX	1992	NA	18065	15301	2764	15.3
CN4832300000000	48	323	Maverick County, TX	1992	NA	17015	11200	5815	34.2
CN4832500000000	48	325	Medina County, TX	1992	NA	12197	11436	761	6.2
CN4832700000000	48	327	Menard County, TX	1992	NA	1010	963	47	4.7
CN4832900000000	48	329	Midland County, TX	1992	NA	57851	53703	4148	7.2
CN4833100000000	48	331	Milam County, TX	1992	NA	10353	9800	553	5.3
CN4833300000000	48	333	Mills County, TX	1992	NA	2114	2045	69	3.3
CN4833500000000	48	335	Mitchell County, TX	1992	NA	3293	2952	341	10.4
CN4833700000000	48	337	Montague County, TX	1992	NA	7850	7284	566	7.2
CN4833900000000	48	339	Montgomery County, TX	1992	NA	102526	95983	6543	6.4
CN4834100000000	48	341	Moore County, TX	1992	NA	8600	8268	332	3.9
CN4834300000000	48	343	Morris County, TX	1992	NA	6006	5185	821	13.7
CN4834500000000	48	345	Motley County, TX	1992	NA	799	763	36	4.5
CN4834700000000	48	347	Nacogdoches County, TX	1992	NA	26303	24707	1596	6.1
CN4834900000000	48	349	Navarro County, TX	1992	NA	19193	17734	1459	7.6
CN4835100000000	48	351	Newton County, TX	1992	NA	5399	4754	645	11.9
CN4835300000000	48	353	Nolan County, TX	1992	NA	7861	7206	655	8.3
CN4835500000000	48	355	Nueces County, TX	1992	NA	143144	129330	13814	9.7
CN4835700000000	48	357	Ochiltree County, TX	1992	NA	4431	4127	304	6.9
CN4835900000000	48	359	Oldham County, TX	1992	NA	1157	1084	73	6.3
CN4836100000000	48	361	Orange County, TX	1992	NA	42089	37258	4831	11.5
CN4836300000000	48	363	Palo Pinto County, TX	1992	NA	11867	10723	1144	9.6
CN4836500000000	48	365	Panola County, TX	1992	NA	8087	7158	929	11.5
CN4836700000000	48	367	Parker County, TX	1992	NA	33745	31555	2190	6.5
CN4836900000000	48	369	Parmer County, TX	1992	NA	4325	4127	198	4.6
CN4837100000000	48	371	Pecos County, TX	1992	NA	6679	5992	687	10.3
CN4837300000000	48	373	Polk County, TX	1992	NA	13065	11919	1146	8.8
CN4837500000000	48	375	Potter County, TX	1992	NA	48972	45884	3088	6.3
CN4837700000000	48	377	Presidio County, TX	1992	NA	3198	2201	997	31.2
CN4837900000000	48	379	Rains County, TX	1992	NA	3136	2923	213	6.8
CN4838100000000	48	381	Randall County, TX	1992	NA	52271	50392	1879	3.6
CN4838300000000	48	383	Reagan County, TX	1992	NA	1987	1877	110	5.5
CN4838500000000	48	385	Real County, TX	1992	NA	1089	999	90	8.3
CN4838700000000	48	387	Red River County, TX	1992	NA	5957	5427	530	8.9
CN4838900000000	48	389	Reeves County, TX	1992	NA	6917	5888	1029	14.9
CN4839100000000	48	391	Refugio County, TX	1992	NA	3318	3129	189	5.7
CN4839300000000	48	393	Roberts County, TX	1992	NA	561	532	29	5.2
CN4839500000000	48	395	Robertson County, TX	1992	NA	6718	6230	488	7.3
CN4839700000000	48	397	Rockwall County, TX	1992	NA	16153	15345	808	5
CN4839900000000	48	399	Runnels County, TX	1992	NA	5320	5074	246	4.6
CN4840100000000	48	401	Rusk County, TX	1992	NA	21570	19872	1698	7.9
CN4840300000000	48	403	Sabine County, TX	1992	NA	3509	3118	391	11.1
CN4840500000000	48	405	San Augustine County, TX	1992	NA	3442	3211	231	6.7
CN4840700000000	48	407	San Jacinto County, TX	1992	NA	7175	6720	455	6.3
CN4840900000000	48	409	San Patricio County, TX	1992	NA	27015	23762	3253	12
CN4841100000000	48	411	San Saba County, TX	1992	NA	2169	2022	147	6.8
CN4841300000000	48	413	Schleicher County, TX	1992	NA	1330	1222	108	8.1
CN4841500000000	48	415	Scurry County, TX	1992	NA	8163	7495	668	8.2
CN4841700000000	48	417	Shackelford County, TX	1992	NA	1481	1422	59	4
CN4841900000000	48	419	Shelby County, TX	1992	NA	9380	8562	818	8.7
CN4842100000000	48	421	Sherman County, TX	1992	NA	1380	1341	39	2.8
CN4842300000000	48	423	Smith County, TX	1992	NA	79106	73521	5585	7.1
CN4842500000000	48	425	Somervell County, TX	1992	NA	3650	3398	252	6.9
CN4842700000000	48	427	Starr County, TX	1992	NA	19183	12676	6507	33.9
CN4842900000000	48	429	Stephens County, TX	1992	NA	3762	3547	215	5.7
CN4843100000000	48	431	Sterling County, TX	1992	NA	739	722	17	2.3
CN4843300000000	48	433	Stonewall County, TX	1992	NA	905	764	141	15.6
CN4843500000000	48	435	Sutton County, TX	1992	NA	2152	1981	171	7.9
CN4843700000000	48	437	Swisher County, TX	1992	NA	4041	3820	221	5.5
CN4843900000000	48	439	Tarrant County, TX	1992	NA	682332	633647	48685	7.1
CN4844100000000	48	441	Taylor County, TX	1992	NA	57487	54336	3151	5.5
CN4844300000000	48	443	Terrell County, TX	1992	NA	636	597	39	6.1
CN4844500000000	48	445	Terry County, TX	1992	NA	6077	5560	517	8.5
CN4844700000000	48	447	Throckmorton County, TX	1992	NA	927	907	20	2.2
CN4844900000000	48	449	Titus County, TX	1992	NA	11958	10798	1160	9.7
CN4845100000000	48	451	Tom Green County, TX	1992	NA	48694	46193	2501	5.1
CN4845300000000	48	453	Travis County, TX	1992	NA	362733	346538	16195	4.5
CN4845500000000	48	455	Trinity County, TX	1992	NA	4837	4563	274	5.7
CN4845700000000	48	457	Tyler County, TX	1992	NA	6833	6205	628	9.2
CN4845900000000	48	459	Upshur County, TX	1992	NA	14992	13770	1222	8.2
CN4846100000000	48	461	Upton County, TX	1992	NA	1932	1813	119	6.2
CN4846300000000	48	463	Uvalde County, TX	1992	NA	10315	8834	1481	14.4
CN4846500000000	48	465	Val Verde County, TX	1992	NA	17195	14696	2499	14.5
CN4846700000000	48	467	Van Zandt County, TX	1992	NA	17791	16556	1235	6.9
CN4846900000000	48	469	Victoria County, TX	1992	NA	39963	37551	2412	6
CN4847100000000	48	471	Walker County, TX	1992	NA	20608	19925	683	3.3
CN4847300000000	48	473	Waller County, TX	1992	NA	10975	10410	565	5.1
CN4847500000000	48	475	Ward County, TX	1992	NA	4990	4483	507	10.2
CN4847700000000	48	477	Washington County, TX	1992	NA	13382	12981	401	3
CN4847900000000	48	479	Webb County, TX	1992	NA	61563	54800	6763	11
CN4848100000000	48	481	Wharton County, TX	1992	NA	19580	18268	1312	6.7
CN4848300000000	48	483	Wheeler County, TX	1992	NA	2761	2589	172	6.2
CN4848500000000	48	485	Wichita County, TX	1992	NA	56658	52881	3777	6.7
CN4848700000000	48	487	Wilbarger County, TX	1992	NA	7322	6956	366	5
CN4848900000000	48	489	Willacy County, TX	1992	NA	7527	5914	1613	21.4
CN4849100000000	48	491	Williamson County, TX	1992	NA	87099	84365	2734	3.1
CN4849300000000	48	493	Wilson County, TX	1992	NA	11078	10581	497	4.5
CN4849500000000	48	495	Winkler County, TX	1992	NA	3564	3198	366	10.3
CN4849700000000	48	497	Wise County, TX	1992	NA	17416	16325	1091	6.3
CN4849900000000	48	499	Wood County, TX	1992	NA	13898	12950	948	6.8
CN4850100000000	48	501	Yoakum County, TX	1992	NA	3959	3678	281	7.1
CN4850300000000	48	503	Young County, TX	1992	NA	8846	8158	688	7.8
CN4850500000000	48	505	Zapata County, TX	1992	NA	3473	2853	620	17.9
CN4850700000000	48	507	Zavala County, TX	1992	NA	4805	3556	1249	26
CN4900100000000	49	001	Beaver County, UT	1992	NA	2040	1939	101	5
CN4900300000000	49	003	Box Elder County, UT	1992	NA	16116	15273	843	5.2
CN4900500000000	49	005	Cache County, UT	1992	NA	36328	35005	1323	3.6
CN4900700000000	49	007	Carbon County, UT	1992	NA	8993	8149	844	9.4
CN4900900000000	49	009	Daggett County, UT	1992	NA	405	386	19	4.7
CN4901100000000	49	011	Davis County, UT	1992	NA	94265	90165	4100	4.3
CN4901300000000	49	013	Duchesne County, UT	1992	NA	5449	4975	474	8.7
CN4901500000000	49	015	Emery County, UT	1992	NA	4491	4096	395	8.8
CN4901700000000	49	017	Garfield County, UT	1992	NA	2269	1961	308	13.6
CN4901900000000	49	019	Grand County, UT	1992	NA	4079	3779	300	7.4
CN4902100000000	49	021	Iron County, UT	1992	NA	10178	9787	391	3.8
CN4902300000000	49	023	Juab County, UT	1992	NA	3143	2913	230	7.3
CN4902500000000	49	025	Kane County, UT	1992	NA	2865	2647	218	7.6
CN4902700000000	49	027	Millard County, UT	1992	NA	4688	4401	287	6.1
CN4902900000000	49	029	Morgan County, UT	1992	NA	2932	2779	153	5.2
CN4903100000000	49	031	Piute County, UT	1992	NA	465	432	33	7.1
CN4903300000000	49	033	Rich County, UT	1992	NA	761	733	28	3.7
CN4903500000000	49	035	Salt Lake County, UT	1992	NA	399276	381651	17625	4.4
CN4903700000000	49	037	San Juan County, UT	1992	NA	4459	4012	447	10
CN4903900000000	49	039	Sanpete County, UT	1992	NA	6852	6218	634	9.3
CN4904100000000	49	041	Sevier County, UT	1992	NA	6684	6217	467	7
CN4904300000000	49	043	Summit County, UT	1992	NA	9309	8681	628	6.7
CN4904500000000	49	045	Tooele County, UT	1992	NA	12657	11876	781	6.2
CN4904700000000	49	047	Uintah County, UT	1992	NA	9771	9045	726	7.4
CN4904900000000	49	049	Utah County, UT	1992	NA	128210	122880	5330	4.2
CN4905100000000	49	051	Wasatch County, UT	1992	NA	4834	4468	366	7.6
CN4905300000000	49	053	Washington County, UT	1992	NA	22935	21952	983	4.3
CN4905500000000	49	055	Wayne County, UT	1992	NA	1055	970	85	8.1
CN4905700000000	49	057	Weber County, UT	1992	NA	83340	78378	4962	6
CN5000100000000	50	001	Addison County, VT	1992	NA	18401	17144	1257	6.8
CN5000300000000	50	003	Bennington County, VT	1992	NA	18558	17460	1098	5.9
CN5000500000000	50	005	Caledonia County, VT	1992	NA	14943	13913	1030	6.9
CN5000700000000	50	007	Chittenden County, VT	1992	NA	78485	75072	3413	4.3
CN5000900000000	50	009	Essex County, VT	1992	NA	2854	2617	237	8.3
CN5001100000000	50	011	Franklin County, VT	1992	NA	21513	20093	1420	6.6
CN5001300000000	50	013	Grand Isle County, VT	1992	NA	2949	2710	239	8.1
CN5001500000000	50	015	Lamoille County, VT	1992	NA	10747	9846	901	8.4
CN5001700000000	50	017	Orange County, VT	1992	NA	14047	13313	734	5.2
CN5001900000000	50	019	Orleans County, VT	1992	NA	12109	10910	1199	9.9
CN5002100000000	50	021	Rutland County, VT	1992	NA	32170	29787	2383	7.4
CN5002300000000	50	023	Washington County, VT	1992	NA	29531	27507	2024	6.9
CN5002500000000	50	025	Windham County, VT	1992	NA	22356	21155	1201	5.4
CN5002700000000	50	027	Windsor County, VT	1992	NA	28904	27276	1628	5.6
CN5100100000000	51	001	Accomack County, VA	1992	NA	15722	14257	1465	9.3
CN5100300000000	51	003	Albemarle County, VA	1992	NA	36323	34935	1388	3.8
CN5100500000000	51	005	Alleghany County, VA	1992	NA	8007	7251	756	9.4
CN5100700000000	51	007	Amelia County, VA	1992	NA	4553	4175	378	8.3
CN5100900000000	51	009	Amherst County, VA	1992	NA	14846	13888	958	6.5
CN5101100000000	51	011	Appomattox County, VA	1992	NA	6792	6170	622	9.2
CN5101300000000	51	013	Arlington County, VA	1992	NA	109801	105014	4787	4.4
CN5101500000000	51	015	Augusta County, VA	1992	NA	30364	28554	1810	6
CN5101700000000	51	017	Bath County, VA	1992	NA	2893	2564	329	11.4
CN5101900000000	51	019	Bedford County, VA	1992	NA	30182	28505	1677	5.6
CN5102100000000	51	021	Bland County, VA	1992	NA	3680	3444	236	6.4
CN5102300000000	51	023	Botetourt County, VA	1992	NA	14764	13936	828	5.6
CN5102500000000	51	025	Brunswick County, VA	1992	NA	7558	6777	781	10.3
CN5102700000000	51	027	Buchanan County, VA	1992	NA	11595	9732	1863	16.1
CN5102900000000	51	029	Buckingham County, VA	1992	NA	5753	5344	409	7.1
CN5103100000000	51	031	Campbell County, VA	1992	NA	27053	25212	1841	6.8
CN5103300000000	51	033	Caroline County, VA	1992	NA	10754	9508	1246	11.6
CN5103500000000	51	035	Carroll County, VA	1992	NA	14651	13457	1194	8.1
CN5103600000000	51	036	Charles City County, VA	1992	NA	3564	3215	349	9.8
CN5103700000000	51	037	Charlotte County, VA	1992	NA	6024	5377	647	10.7
CN5104100000000	51	041	Chesterfield County, VA	1992	NA	130074	123622	6452	5
CN5104300000000	51	043	Clarke County, VA	1992	NA	6394	6063	331	5.2
CN5104500000000	51	045	Craig County, VA	1992	NA	3380	3214	166	4.9
CN5104700000000	51	047	Culpeper County, VA	1992	NA	15087	14025	1062	7
CN5104900000000	51	049	Cumberland County, VA	1992	NA	4302	3991	311	7.2
CN5105100000000	51	051	Dickenson County, VA	1992	NA	6443	5307	1136	17.6
CN5105300000000	51	053	Dinwiddie County, VA	1992	NA	11276	10397	879	7.8
CN5105700000000	51	057	Essex County, VA	1992	NA	4750	4378	372	7.8
CN5105900000000	51	059	Fairfax County, VA	1992	NA	501227	482515	18712	3.7
CN5106100000000	51	061	Fauquier County, VA	1992	NA	27633	26234	1399	5.1
CN5106300000000	51	063	Floyd County, VA	1992	NA	6513	5918	595	9.1
CN5106500000000	51	065	Fluvanna County, VA	1992	NA	7160	6771	389	5.4
CN5106700000000	51	067	Franklin County, VA	1992	NA	21785	20488	1297	6
CN5106900000000	51	069	Frederick County, VA	1992	NA	28684	26544	2140	7.5
CN5107100000000	51	071	Giles County, VA	1992	NA	8519	7790	729	8.6
CN5107300000000	51	073	Gloucester County, VA	1992	NA	16109	15334	775	4.8
CN5107500000000	51	075	Goochland County, VA	1992	NA	7979	7505	474	5.9
CN5107700000000	51	077	Grayson County, VA	1992	NA	8836	8204	632	7.2
CN5107900000000	51	079	Greene County, VA	1992	NA	6326	5922	404	6.4
CN5108100000000	51	081	Greensville County, VA	1992	NA	5403	5019	384	7.1
CN5108300000000	51	083	Halifax County, VA	1992	NA	19088	17485	1603	8.4
CN5108500000000	51	085	Hanover County, VA	1992	NA	38651	36810	1841	4.8
CN5108700000000	51	087	Henrico County, VA	1992	NA	132617	125627	6990	5.3
CN5108900000000	51	089	Henry County, VA	1992	NA	31489	29294	2195	7
CN5109100000000	51	091	Highland County, VA	1992	NA	1329	1269	60	4.5
CN5109300000000	51	093	Isle of Wight County, VA	1992	NA	13840	12828	1012	7.3
CN5109500000000	51	095	James City County, VA	1992	NA	20514	19858	656	3.2
CN5109700000000	51	097	King and Queen County, VA	1992	NA	3349	3118	231	6.9
CN5109900000000	51	099	King George County, VA	1992	NA	7540	6931	609	8.1
CN5110100000000	51	101	King William County, VA	1992	NA	6553	6214	339	5.2
CN5110300000000	51	103	Lancaster County, VA	1992	NA	5467	4630	837	15.3
CN5110500000000	51	105	Lee County, VA	1992	NA	10100	8633	1467	14.5
CN5110700000000	51	107	Loudoun County, VA	1992	NA	56955	54629	2326	4.1
CN5110900000000	51	109	Louisa County, VA	1992	NA	10937	9773	1164	10.6
CN5111100000000	51	111	Lunenburg County, VA	1992	NA	5232	4592	640	12.2
CN5111300000000	51	113	Madison County, VA	1992	NA	6629	6296	333	5
CN5111500000000	51	115	Mathews County, VA	1992	NA	4283	4091	192	4.5
CN5111700000000	51	117	Mecklenburg County, VA	1992	NA	15049	13680	1369	9.1
CN5111900000000	51	119	Middlesex County, VA	1992	NA	4296	4081	215	5
CN5112100000000	51	121	Montgomery County, VA	1992	NA	36955	34952	2003	5.4
CN5112500000000	51	125	Nelson County, VA	1992	NA	6912	6392	520	7.5
CN5112700000000	51	127	New Kent County, VA	1992	NA	5932	5601	331	5.6
CN5113100000000	51	131	Northampton County, VA	1992	NA	5827	5287	540	9.3
CN5113300000000	51	133	Northumberland County, VA	1992	NA	5459	4724	735	13.5
CN5113500000000	51	135	Nottoway County, VA	1992	NA	6662	6218	444	6.7
CN5113700000000	51	137	Orange County, VA	1992	NA	10944	10048	896	8.2
CN5113900000000	51	139	Page County, VA	1992	NA	11907	10612	1295	10.9
CN5114100000000	51	141	Patrick County, VA	1992	NA	9392	8939	453	4.8
CN5114300000000	51	143	Pittsylvania County, VA	1992	NA	30990	28541	2449	7.9
CN5114500000000	51	145	Powhatan County, VA	1992	NA	8290	7912	378	4.6
CN5114700000000	51	147	Prince Edward County, VA	1992	NA	8727	7826	901	10.3
CN5114900000000	51	149	Prince George County, VA	1992	NA	12031	11273	758	6.3
CN5115300000000	51	153	Prince William County, VA	1992	NA	124687	118864	5823	4.7
CN5115500000000	51	155	Pulaski County, VA	1992	NA	17563	15843	1720	9.8
CN5115700000000	51	157	Rappahannock County, VA	1992	NA	4169	3851	318	7.6
CN5115900000000	51	159	Richmond County, VA	1992	NA	3813	3440	373	9.8
CN5116100000000	51	161	Roanoke County, VA	1992	NA	47405	45477	1928	4.1
CN5116300000000	51	163	Rockbridge County, VA	1992	NA	10091	9127	964	9.6
CN5116500000000	51	165	Rockingham County, VA	1992	NA	35349	33525	1824	5.2
CN5116700000000	51	167	Russell County, VA	1992	NA	12710	11096	1614	12.7
CN5116900000000	51	169	Scott County, VA	1992	NA	10235	9344	891	8.7
CN5117100000000	51	171	Shenandoah County, VA	1992	NA	17760	16640	1120	6.3
CN5117300000000	51	173	Smyth County, VA	1992	NA	18343	15924	2419	13.2
CN5117500000000	51	175	Southampton County, VA	1992	NA	7886	7363	523	6.6
CN5117700000000	51	177	Spotsylvania County, VA	1992	NA	34788	32675	2113	6.1
CN5117900000000	51	179	Stafford County, VA	1992	NA	36144	34235	1909	5.3
CN5118100000000	51	181	Surry County, VA	1992	NA	3255	2830	425	13.1
CN5118300000000	51	183	Sussex County, VA	1992	NA	5051	4496	555	11
CN5118500000000	51	185	Tazewell County, VA	1992	NA	21046	18176	2870	13.6
CN5118700000000	51	187	Warren County, VA	1992	NA	15094	13485	1609	10.7
CN5119100000000	51	191	Washington County, VA	1992	NA	25645	23629	2016	7.9
CN5119300000000	51	193	Westmoreland County, VA	1992	NA	7968	6993	975	12.2
CN5119500000000	51	195	Wise County, VA	1992	NA	16625	14060	2565	15.4
CN5119700000000	51	197	Wythe County, VA	1992	NA	14292	12823	1469	10.3
CN5119900000000	51	199	York County, VA	1992	NA	23155	22215	940	4.1
CN5151000000000	51	510	Alexandria city, VA	1992	NA	77524	72691	4833	6.2
CN5152000000000	51	520	Bristol city, VA	1992	NA	8797	8121	676	7.7
CN5153000000000	51	530	Buena Vista city, VA	1992	NA	3398	3017	381	11.2
CN5154000000000	51	540	Charlottesville city, VA	1992	NA	20190	19229	961	4.8
CN5155000000000	51	550	Chesapeake city, VA	1992	NA	87887	83014	4873	5.5
CN5157000000000	51	570	Colonial Heights city, VA	1992	NA	8980	8326	654	7.3
CN5158000000000	51	580	Covington city, VA	1992	NA	3088	2648	440	14.2
CN5159000000000	51	590	Danville city, VA	1992	NA	27172	24171	3001	11
CN5159500000000	51	595	Emporia city, VA	1992	NA	2593	2336	257	9.9
CN5160000000000	51	600	Fairfax city, VA	1992	NA	12558	12280	278	2.2
CN5161000000000	51	610	Falls Church city, VA	1992	NA	5869	5555	314	5.4
CN5162000000000	51	620	Franklin city, VA	1992	NA	3774	3547	227	6
CN5163000000000	51	630	Fredericksburg city, VA	1992	NA	10622	9674	948	8.9
CN5164000000000	51	640	Galax city, VA	1992	NA	3516	3290	226	6.4
CN5165000000000	51	650	Hampton city, VA	1992	NA	67557	62826	4731	7
CN5166000000000	51	660	Harrisonburg city, VA	1992	NA	16978	16373	605	3.6
CN5167000000000	51	670	Hopewell city, VA	1992	NA	11434	10223	1211	10.6
CN5167800000000	51	678	Lexington city, VA	1992	NA	2830	2677	153	5.4
CN5168000000000	51	680	Lynchburg city, VA	1992	NA	32575	30442	2133	6.5
CN5168300000000	51	683	Manassas city, VA	1992	NA	17876	16829	1047	5.9
CN5168500000000	51	685	Manassas Park city, VA	1992	NA	3890	3740	150	3.9
CN5169000000000	51	690	Martinsville city, VA	1992	NA	7890	7231	659	8.4
CN5170000000000	51	700	Newport News city, VA	1992	NA	85652	79798	5854	6.8
CN5171000000000	51	710	Norfolk city, VA	1992	NA	97657	90654	7003	7.2
CN5172000000000	51	720	Norton city, VA	1992	NA	1697	1548	149	8.8
CN5173000000000	51	730	Petersburg city, VA	1992	NA	17811	15683	2128	11.9
CN5173500000000	51	735	Poquoson city, VA	1992	NA	5800	5591	209	3.6
CN5174000000000	51	740	Portsmouth city, VA	1992	NA	48217	44176	4041	8.4
CN5175000000000	51	750	Radford city, VA	1992	NA	7162	6680	482	6.7
CN5176000000000	51	760	Richmond city, VA	1992	NA	103928	94459	9469	9.1
CN5177000000000	51	770	Roanoke city, VA	1992	NA	51134	47530	3604	7
CN5177500000000	51	775	Salem city, VA	1992	NA	13329	12653	676	5.1
CN5179000000000	51	790	Staunton city, VA	1992	NA	11562	10902	660	5.7
CN5180000000000	51	800	Suffolk city, VA	1992	NA	25940	23945	1995	7.7
CN5181000000000	51	810	Virginia Beach city, VA	1992	NA	205487	194794	10693	5.2
CN5182000000000	51	820	Waynesboro city, VA	1992	NA	9227	8431	796	8.6
CN5183000000000	51	830	Williamsburg city, VA	1992	NA	5985	5216	769	12.8
CN5184000000000	51	840	Winchester city, VA	1992	NA	12938	11689	1249	9.7
CN5300100000000	53	001	Adams County, WA	1992	NA	8066	6902	1164	14.4
CN5300300000000	53	003	Asotin County, WA	1992	NA	9936	9397	539	5.4
CN5300500000000	53	005	Benton County, WA	1992	NA	64837	60014	4823	7.4
CN5300700000000	53	007	Chelan County, WA	1992	NA	32290	28613	3677	11.4
CN5300900000000	53	009	Clallam County, WA	1992	NA	23253	21200	2053	8.8
CN5301100000000	53	011	Clark County, WA	1992	NA	131295	122125	9170	7
CN5301300000000	53	013	Columbia County, WA	1992	NA	1415	1207	208	14.7
CN5301500000000	53	015	Cowlitz County, WA	1992	NA	37991	33930	4061	10.7
CN5301700000000	53	017	Douglas County, WA	1992	NA	16766	15285	1481	8.8
CN5301900000000	53	019	Ferry County, WA	1992	NA	2843	2429	414	14.6
CN5302100000000	53	021	Franklin County, WA	1992	NA	20530	18159	2371	11.5
CN5302300000000	53	023	Garfield County, WA	1992	NA	1050	1014	36	3.4
CN5302500000000	53	025	Grant County, WA	1992	NA	29928	26563	3365	11.2
CN5302700000000	53	027	Grays Harbor County, WA	1992	NA	27952	24501	3451	12.3
CN5302900000000	53	029	Island County, WA	1992	NA	24022	22593	1429	5.9
CN5303100000000	53	031	Jefferson County, WA	1992	NA	8591	7817	774	9
CN5303300000000	53	033	King County, WA	1992	NA	893454	842280	51174	5.7
CN5303500000000	53	035	Kitsap County, WA	1992	NA	88021	82664	5357	6.1
CN5303700000000	53	037	Kittitas County, WA	1992	NA	13553	11819	1734	12.8
CN5303900000000	53	039	Klickitat County, WA	1992	NA	8076	6945	1131	14
CN5304100000000	53	041	Lewis County, WA	1992	NA	27374	24322	3052	11.1
CN5304300000000	53	043	Lincoln County, WA	1992	NA	4259	4034	225	5.3
CN5304500000000	53	045	Mason County, WA	1992	NA	15954	14589	1365	8.6
CN5304700000000	53	047	Okanogan County, WA	1992	NA	20893	18443	2450	11.7
CN5304900000000	53	049	Pacific County, WA	1992	NA	7835	6984	851	10.9
CN5305100000000	53	051	Pend Oreille County, WA	1992	NA	3658	3127	531	14.5
CN5305300000000	53	053	Pierce County, WA	1992	NA	286417	264846	21571	7.5
CN5305500000000	53	055	San Juan County, WA	1992	NA	5364	5033	331	6.2
CN5305700000000	53	057	Skagit County, WA	1992	NA	42093	37748	4345	10.3
CN5305900000000	53	059	Skamania County, WA	1992	NA	3784	3091	693	18.3
CN5306100000000	53	061	Snohomish County, WA	1992	NA	269062	252230	16832	6.3
CN5306300000000	53	063	Spokane County, WA	1992	NA	180122	167774	12348	6.9
CN5306500000000	53	065	Stevens County, WA	1992	NA	14667	12999	1668	11.4
CN5306700000000	53	067	Thurston County, WA	1992	NA	85744	80007	5737	6.7
CN5306900000000	53	069	Wahkiakum County, WA	1992	NA	1552	1442	110	7.1
CN5307100000000	53	071	Walla Walla County, WA	1992	NA	24440	22466	1974	8.1
CN5307300000000	53	073	Whatcom County, WA	1992	NA	72942	67303	5639	7.7
CN5307500000000	53	075	Whitman County, WA	1992	NA	17272	16864	408	2.4
CN5307700000000	53	077	Yakima County, WA	1992	NA	108512	93722	14790	13.6
CN5400100000000	54	001	Barbour County, WV	1992	NA	6205	5137	1068	17.2
CN5400300000000	54	003	Berkeley County, WV	1992	NA	30627	27700	2927	9.6
CN5400500000000	54	005	Boone County, WV	1992	NA	9219	7789	1430	15.5
CN5400700000000	54	007	Braxton County, WV	1992	NA	5119	4062	1057	20.6
CN5400900000000	54	009	Brooke County, WV	1992	NA	11883	10491	1392	11.7
CN5401100000000	54	011	Cabell County, WV	1992	NA	43548	39345	4203	9.7
CN5401300000000	54	013	Calhoun County, WV	1992	NA	3096	2467	629	20.3
CN5401500000000	54	015	Clay County, WV	1992	NA	3115	2518	597	19.2
CN5401700000000	54	017	Doddridge County, WV	1992	NA	2851	2566	285	10
CN5401900000000	54	019	Fayette County, WV	1992	NA	17271	14739	2532	14.7
CN5402100000000	54	021	Gilmer County, WV	1992	NA	2810	2449	361	12.8
CN5402300000000	54	023	Grant County, WV	1992	NA	5288	4743	545	10.3
CN5402500000000	54	025	Greenbrier County, WV	1992	NA	15069	13210	1859	12.3
CN5402700000000	54	027	Hampshire County, WV	1992	NA	7601	6786	815	10.7
CN5402900000000	54	029	Hancock County, WV	1992	NA	15744	14041	1703	10.8
CN5403100000000	54	031	Hardy County, WV	1992	NA	5577	5199	378	6.8
CN5403300000000	54	033	Harrison County, WV	1992	NA	31253	27758	3495	11.2
CN5403500000000	54	035	Jackson County, WV	1992	NA	12797	11206	1591	12.4
CN5403700000000	54	037	Jefferson County, WV	1992	NA	19372	17501	1871	9.7
CN5403900000000	54	039	Kanawha County, WV	1992	NA	99203	90595	8608	8.7
CN5404100000000	54	041	Lewis County, WV	1992	NA	7330	6349	981	13.4
CN5404300000000	54	043	Lincoln County, WV	1992	NA	7273	6092	1181	16.2
CN5404500000000	54	045	Logan County, WV	1992	NA	14763	12719	2044	13.8
CN5404700000000	54	047	McDowell County, WV	1992	NA	8732	7334	1398	16
CN5404900000000	54	049	Marion County, WV	1992	NA	24695	21030	3665	14.8
CN5405100000000	54	051	Marshall County, WV	1992	NA	16318	14345	1973	12.1
CN5405300000000	54	053	Mason County, WV	1992	NA	10125	8472	1653	16.3
CN5405500000000	54	055	Mercer County, WV	1992	NA	28049	25188	2861	10.2
CN5405700000000	54	057	Mineral County, WV	1992	NA	11529	10405	1124	9.7
CN5405900000000	54	059	Mingo County, WV	1992	NA	10528	9194	1334	12.7
CN5406100000000	54	061	Monongalia County, WV	1992	NA	37836	34816	3020	8
CN5406300000000	54	063	Monroe County, WV	1992	NA	4924	4467	457	9.3
CN5406500000000	54	065	Morgan County, WV	1992	NA	5833	5371	462	7.9
CN5406700000000	54	067	Nicholas County, WV	1992	NA	10526	8883	1643	15.6
CN5406900000000	54	069	Ohio County, WV	1992	NA	24107	22063	2044	8.5
CN5407100000000	54	071	Pendleton County, WV	1992	NA	3619	3441	178	4.9
CN5407300000000	54	073	Pleasants County, WV	1992	NA	3324	2903	421	12.7
CN5407500000000	54	075	Pocahontas County, WV	1992	NA	4108	3522	586	14.3
CN5407700000000	54	077	Preston County, WV	1992	NA	12564	10986	1578	12.6
CN5407900000000	54	079	Putnam County, WV	1992	NA	21678	19662	2016	9.3
CN5408100000000	54	081	Raleigh County, WV	1992	NA	30455	26642	3813	12.5
CN5408300000000	54	083	Randolph County, WV	1992	NA	12503	10884	1619	12.9
CN5408500000000	54	085	Ritchie County, WV	1992	NA	4458	3809	649	14.6
CN5408700000000	54	087	Roane County, WV	1992	NA	6071	5028	1043	17.2
CN5408900000000	54	089	Summers County, WV	1992	NA	4591	3954	637	13.9
CN5409100000000	54	091	Taylor County, WV	1992	NA	6306	5558	748	11.9
CN5409300000000	54	093	Tucker County, WV	1992	NA	3607	3112	495	13.7
CN5409500000000	54	095	Tyler County, WV	1992	NA	4042	3615	427	10.6
CN5409700000000	54	097	Upshur County, WV	1992	NA	9763	8458	1305	13.4
CN5409900000000	54	099	Wayne County, WV	1992	NA	16833	14963	1870	11.1
CN5410100000000	54	101	Webster County, WV	1992	NA	3294	2660	634	19.2
CN5410300000000	54	103	Wetzel County, WV	1992	NA	7693	6628	1065	13.8
CN5410500000000	54	105	Wirt County, WV	1992	NA	2054	1724	330	16.1
CN5410700000000	54	107	Wood County, WV	1992	NA	42994	38867	4127	9.6
CN5410900000000	54	109	Wyoming County, WV	1992	NA	8719	7327	1392	16
CN5500100000000	55	001	Adams County, WI	1992	NA	6842	6384	458	6.7
CN5500300000000	55	003	Ashland County, WI	1992	NA	7774	7131	643	8.3
CN5500500000000	55	005	Barron County, WI	1992	NA	21880	20429	1451	6.6
CN5500700000000	55	007	Bayfield County, WI	1992	NA	6846	6325	521	7.6
CN5500900000000	55	009	Brown County, WI	1992	NA	113925	109029	4896	4.3
CN5501100000000	55	011	Buffalo County, WI	1992	NA	7220	6790	430	6
CN5501300000000	55	013	Burnett County, WI	1992	NA	6009	5581	428	7.1
CN5501500000000	55	015	Calumet County, WI	1992	NA	22340	21135	1205	5.4
CN5501700000000	55	017	Chippewa County, WI	1992	NA	26837	25127	1710	6.4
CN5501900000000	55	019	Clark County, WI	1992	NA	15435	14203	1232	8
CN5502100000000	55	021	Columbia County, WI	1992	NA	26018	24455	1563	6
CN5502300000000	55	023	Crawford County, WI	1992	NA	8708	8156	552	6.3
CN5502500000000	55	025	Dane County, WI	1992	NA	230150	225190	4960	2.2
CN5502700000000	55	027	Dodge County, WI	1992	NA	40590	38262	2328	5.7
CN5502900000000	55	029	Door County, WI	1992	NA	14721	13585	1136	7.7
CN5503100000000	55	031	Douglas County, WI	1992	NA	20917	19287	1630	7.8
CN5503300000000	55	033	Dunn County, WI	1992	NA	18857	17791	1066	5.7
CN5503500000000	55	035	Eau Claire County, WI	1992	NA	45407	42781	2626	5.8
CN5503700000000	55	037	Florence County, WI	1992	NA	1521	1352	169	11.1
CN5503900000000	55	039	Fond du Lac County, WI	1992	NA	52173	49871	2302	4.4
CN5504100000000	55	041	Forest County, WI	1992	NA	4245	3928	317	7.5
CN5504300000000	55	043	Grant County, WI	1992	NA	25239	23869	1370	5.4
CN5504500000000	55	045	Green County, WI	1992	NA	18198	17383	815	4.5
CN5504700000000	55	047	Green Lake County, WI	1992	NA	10126	9553	573	5.7
CN5504900000000	55	049	Iowa County, WI	1992	NA	12627	12057	570	4.5
CN5505100000000	55	051	Iron County, WI	1992	NA	3180	2908	272	8.6
CN5505300000000	55	053	Jackson County, WI	1992	NA	8664	8030	634	7.3
CN5505500000000	55	055	Jefferson County, WI	1992	NA	37990	36057	1933	5.1
CN5505700000000	55	057	Juneau County, WI	1992	NA	10745	9900	845	7.9
CN5505900000000	55	059	Kenosha County, WI	1992	NA	71052	66783	4269	6
CN5506100000000	55	061	Kewaunee County, WI	1992	NA	10424	9746	678	6.5
CN5506300000000	55	063	La Crosse County, WI	1992	NA	55404	52972	2432	4.4
CN5506500000000	55	065	Lafayette County, WI	1992	NA	8396	7961	435	5.2
CN5506700000000	55	067	Langlade County, WI	1992	NA	9232	8594	638	6.9
CN5506900000000	55	069	Lincoln County, WI	1992	NA	14484	13549	935	6.5
CN5507100000000	55	071	Manitowoc County, WI	1992	NA	41611	39236	2375	5.7
CN5507300000000	55	073	Marathon County, WI	1992	NA	65274	61714	3560	5.5
CN5507500000000	55	075	Marinette County, WI	1992	NA	19703	18078	1625	8.2
CN5507700000000	55	077	Marquette County, WI	1992	NA	6322	5879	443	7
CN5507800000000	55	078	Menominee County, WI	1992	NA	1747	1571	176	10.1
CN5507900000000	55	079	Milwaukee County, WI	1992	NA	474721	450445	24276	5.1
CN5508100000000	55	081	Monroe County, WI	1992	NA	18795	17505	1290	6.9
CN5508300000000	55	083	Oconto County, WI	1992	NA	14265	13039	1226	8.6
CN5508500000000	55	085	Oneida County, WI	1992	NA	17333	16472	861	5
CN5508700000000	55	087	Outagamie County, WI	1992	NA	88894	85631	3263	3.7
CN5508900000000	55	089	Ozaukee County, WI	1992	NA	43020	41377	1643	3.8
CN5509100000000	55	091	Pepin County, WI	1992	NA	3373	3153	220	6.5
CN5509300000000	55	093	Pierce County, WI	1992	NA	18863	17789	1074	5.7
CN5509500000000	55	095	Polk County, WI	1992	NA	18147	16727	1420	7.8
CN5509700000000	55	097	Portage County, WI	1992	NA	36469	34781	1688	4.6
CN5509900000000	55	099	Price County, WI	1992	NA	7594	7119	475	6.3
CN5510100000000	55	101	Racine County, WI	1992	NA	91399	84928	6471	7.1
CN5510300000000	55	103	Richland County, WI	1992	NA	8271	7718	553	6.7
CN5510500000000	55	105	Rock County, WI	1992	NA	74837	68815	6022	8
CN5510700000000	55	107	Rusk County, WI	1992	NA	6849	6155	694	10.1
CN5510900000000	55	109	St. Croix County, WI	1992	NA	28661	27048	1613	5.6
CN5511100000000	55	111	Sauk County, WI	1992	NA	27409	25823	1586	5.8
CN5511300000000	55	113	Sawyer County, WI	1992	NA	7448	6805	643	8.6
CN5511500000000	55	115	Shawano County, WI	1992	NA	17882	16718	1164	6.5
CN5511700000000	55	117	Sheboygan County, WI	1992	NA	56327	53907	2420	4.3
CN5511900000000	55	119	Taylor County, WI	1992	NA	10023	9263	760	7.6
CN5512100000000	55	121	Trempealeau County, WI	1992	NA	13508	12363	1145	8.5
CN5512300000000	55	123	Vernon County, WI	1992	NA	12586	11807	779	6.2
CN5512500000000	55	125	Vilas County, WI	1992	NA	8901	8446	455	5.1
CN5512700000000	55	127	Walworth County, WI	1992	NA	45313	43556	1757	3.9
CN5512900000000	55	129	Washburn County, WI	1992	NA	6786	6251	535	7.9
CN5513100000000	55	131	Washington County, WI	1992	NA	57355	54592	2763	4.8
CN5513300000000	55	133	Waukesha County, WI	1992	NA	182470	175054	7416	4.1
CN5513500000000	55	135	Waupaca County, WI	1992	NA	24299	23107	1192	4.9
CN5513700000000	55	137	Waushara County, WI	1992	NA	9281	8632	649	7
CN5513900000000	55	139	Winnebago County, WI	1992	NA	88428	85452	2976	3.4
CN5514100000000	55	141	Wood County, WI	1992	NA	38821	36665	2156	5.6
CN5600100000000	56	001	Albany County, WY	1992	NA	15976	15517	459	2.9
CN5600300000000	56	003	Big Horn County, WY	1992	NA	4824	4498	326	6.8
CN5600500000000	56	005	Campbell County, WY	1992	NA	16741	15797	944	5.6
CN5600700000000	56	007	Carbon County, WY	1992	NA	8315	7828	487	5.9
CN5600900000000	56	009	Converse County, WY	1992	NA	5996	5648	348	5.8
CN5601100000000	56	011	Crook County, WY	1992	NA	2752	2664	88	3.2
CN5601300000000	56	013	Fremont County, WY	1992	NA	16097	14880	1217	7.6
CN5601500000000	56	015	Goshen County, WY	1992	NA	6050	5771	279	4.6
CN5601700000000	56	017	Hot Springs County, WY	1992	NA	2443	2309	134	5.5
CN5601900000000	56	019	Johnson County, WY	1992	NA	3295	3104	191	5.8
CN5602100000000	56	021	Laramie County, WY	1992	NA	37132	35571	1561	4.2
CN5602300000000	56	023	Lincoln County, WY	1992	NA	6323	5819	504	8
CN5602500000000	56	025	Natrona County, WY	1992	NA	31202	28921	2281	7.3
CN5602700000000	56	027	Niobrara County, WY	1992	NA	1153	1098	55	4.8
CN5602900000000	56	029	Park County, WY	1992	NA	13332	12764	568	4.3
CN5603100000000	56	031	Platte County, WY	1992	NA	3915	3693	222	5.7
CN5603300000000	56	033	Sheridan County, WY	1992	NA	12527	11804	723	5.8
CN5603500000000	56	035	Sublette County, WY	1992	NA	2782	2690	92	3.3
CN5603700000000	56	037	Sweetwater County, WY	1992	NA	21109	19797	1312	6.2
CN5603900000000	56	039	Teton County, WY	1992	NA	8981	8724	257	2.9
CN5604100000000	56	041	Uinta County, WY	1992	NA	10252	9394	858	8.4
CN5604300000000	56	043	Washakie County, WY	1992	NA	4450	4186	264	5.9
CN5604500000000	56	045	Weston County, WY	1992	NA	3212	3027	185	5.8
CN7200100000000	72	001	Adjuntas Municipio, PR	1992	NA	5323	4406	917	17.2
CN7200300000000	72	003	Aguada Municipio, PR	1992	NA	14615	11340	3275	22.4
CN7200500000000	72	005	Aguadilla Municipio, PR	1992	NA	20895	16269	4626	22.1
CN7200700000000	72	007	Aguas Buenas Municipio, PR	1992	NA	7732	6208	1524	19.7
CN7200900000000	72	009	Aibonito Municipio, PR	1992	NA	9572	8128	1444	15.1
CN7201100000000	72	011	Anasco Municipio, PR	1992	NA	9984	7801	2183	21.9
CN7201300000000	72	013	Arecibo Municipio, PR	1992	NA	29010	23337	5673	19.6
CN7201500000000	72	015	Arroyo Municipio, PR	1992	NA	4873	3815	1058	21.7
CN7201700000000	72	017	Barceloneta Municipio, PR	1992	NA	6498	5012	1486	22.9
CN7201900000000	72	019	Barranquitas Municipio, PR	1992	NA	6873	5889	984	14.3
CN7202100000000	72	021	Bayamon Municipio, PR	1992	NA	80796	71066	9730	12
CN7202300000000	72	023	Cabo Rojo Municipio, PR	1992	NA	13785	11269	2516	18.3
CN7202500000000	72	025	Caguas Municipio, PR	1992	NA	52845	45075	7770	14.7
CN7202700000000	72	027	Camuy Municipio, PR	1992	NA	9049	7225	1824	20.2
CN7202900000000	72	029	Canovanas Municipio, PR	1992	NA	12383	10104	2279	18.4
CN7203100000000	72	031	Carolina Municipio, PR	1992	NA	71968	63972	7996	11.1
CN7203300000000	72	033	Catano Municipio, PR	1992	NA	10434	9030	1404	13.5
CN7203500000000	72	035	Cayey Municipio, PR	1992	NA	15308	12414	2894	18.9
CN7203700000000	72	037	Ceiba Municipio, PR	1992	NA	5238	4304	934	17.8
CN7203900000000	72	039	Ciales Municipio, PR	1992	NA	5249	4117	1132	21.6
CN7204100000000	72	041	Cidra Municipio, PR	1992	NA	11583	9728	1855	16
CN7204300000000	72	043	Coamo Municipio, PR	1992	NA	8860	6898	1962	22.1
CN7204500000000	72	045	Comerio Municipio, PR	1992	NA	5511	4446	1065	19.3
CN7204700000000	72	047	Corozal Municipio, PR	1992	NA	9097	7592	1505	16.5
CN7204900000000	72	049	Culebra Municipio, PR	1992	NA	773	728	45	5.8
CN7205100000000	72	051	Dorado Municipio, PR	1992	NA	9924	8408	1516	15.3
CN7205300000000	72	053	Fajardo Municipio, PR	1992	NA	12916	10253	2663	20.6
CN7205400000000	72	054	Florida Municipio, PR	1992	NA	2727	2053	674	24.7
CN7205500000000	72	055	Guanica Municipio, PR	1992	NA	5621	4096	1525	27.1
CN7205700000000	72	057	Guayama Municipio, PR	1992	NA	10664	8190	2474	23.2
CN7205900000000	72	059	Guayanilla Municipio, PR	1992	NA	6569	4865	1704	25.9
CN7206100000000	72	061	Guaynabo Municipio, PR	1992	NA	35738	32833	2905	8.1
CN7206300000000	72	063	Gurabo Municipio, PR	1992	NA	9995	8259	1736	17.4
CN7206500000000	72	065	Hatillo Municipio, PR	1992	NA	9880	7841	2039	20.6
CN7206700000000	72	067	Hormigueros Municipio, PR	1992	NA	6449	5335	1114	17.3
CN7206900000000	72	069	Humacao Municipio, PR	1992	NA	18596	15099	3497	18.8
CN7207100000000	72	071	Isabela Municipio, PR	1992	NA	12155	9338	2817	23.2
CN7207300000000	72	073	Jayuya Municipio, PR	1992	NA	3880	3287	593	15.3
CN7207500000000	72	075	Juana Diaz Municipio, PR	1992	NA	12612	9775	2837	22.5
CN7207700000000	72	077	Juncos Municipio, PR	1992	NA	9303	7506	1797	19.3
CN7207900000000	72	079	Lajas Municipio, PR	1992	NA	8938	7171	1767	19.8
CN7208100000000	72	081	Lares Municipio, PR	1992	NA	7587	5911	1676	22.1
CN7208300000000	72	083	Las Marias Municipio, PR	1992	NA	3937	3381	556	14.1
CN7208500000000	72	085	Las Piedras Municipio, PR	1992	NA	8901	7357	1544	17.3
CN7208700000000	72	087	Loiza Municipio, PR	1992	NA	8406	7146	1260	15
CN7208900000000	72	089	Luquillo Municipio, PR	1992	NA	6582	4844	1738	26.4
CN7209100000000	72	091	Manati Municipio, PR	1992	NA	12689	9993	2696	21.2
CN7209300000000	72	093	Maricao Municipio, PR	1992	NA	2219	1899	320	14.4
CN7209500000000	72	095	Maunabo Municipio, PR	1992	NA	3009	2221	788	26.2
CN7209700000000	72	097	Mayaguez Municipio, PR	1992	NA	35505	29636	5869	16.5
CN7209900000000	72	099	Moca Municipio, PR	1992	NA	11839	9331	2508	21.2
CN7210100000000	72	101	Morovis Municipio, PR	1992	NA	7650	6030	1620	21.2
CN7210300000000	72	103	Naguabo Municipio, PR	1992	NA	6489	5097	1392	21.5
CN7210500000000	72	105	Naranjito Municipio, PR	1992	NA	6923	5601	1322	19.1
CN7210700000000	72	107	Orocovis Municipio, PR	1992	NA	5793	4536	1257	21.7
CN7210900000000	72	109	Patillas Municipio, PR	1992	NA	5511	3984	1527	27.7
CN7211100000000	72	111	Penuelas Municipio, PR	1992	NA	6717	5026	1691	25.2
CN7211300000000	72	113	Ponce Municipio, PR	1992	NA	58761	47707	11054	18.8
CN7211500000000	72	115	Quebradillas Municipio, PR	1992	NA	8803	7581	1222	13.9
CN7211700000000	72	117	Rincon Municipio, PR	1992	NA	5550	4688	862	15.5
CN7211900000000	72	119	Rio Grande Municipio, PR	1992	NA	15787	12813	2974	18.8
CN7212100000000	72	121	Sabana Grande Municipio, PR	1992	NA	8045	6642	1403	17.4
CN7212300000000	72	123	Salinas Municipio, PR	1992	NA	7993	5715	2278	28.5
CN7212500000000	72	125	San German Municipio, PR	1992	NA	12778	10215	2563	20.1
CN7212700000000	72	127	San Juan Municipio, PR	1992	NA	158895	140696	18199	11.5
CN7212900000000	72	129	San Lorenzo Municipio, PR	1992	NA	11605	9207	2398	20.7
CN7213100000000	72	131	San Sebastian Municipio, PR	1992	NA	12006	8481	3525	29.4
CN7213300000000	72	133	Santa Isabel Municipio, PR	1992	NA	5475	3632	1843	33.7
CN7213500000000	72	135	Toa Alta Municipio, PR	1992	NA	15313	12984	2329	15.2
CN7213700000000	72	137	Toa Baja Municipio, PR	1992	NA	32073	28915	3158	9.8
CN7213900000000	72	139	Trujillo Alto Municipio, PR	1992	NA	23241	20908	2333	10
CN7214100000000	72	141	Utuado Municipio, PR	1992	NA	8404	6844	1560	18.6
CN7214300000000	72	143	Vega Alta Municipio, PR	1992	NA	10796	9055	1741	16.1
CN7214500000000	72	145	Vega Baja Municipio, PR	1992	NA	17593	14276	3317	18.9
CN7214700000000	72	147	Vieques Municipio, PR	1992	NA	2784	2129	655	23.5
CN7214900000000	72	149	Villalba Municipio, PR	1992	NA	6294	4580	1714	27.2
CN7215100000000	72	151	Yabucoa Municipio, PR	1992	NA	11105	8276	2829	25.5
CN7215300000000	72	153	Yauco Municipio, PR	1992	NA	12932	10143	2789	21.6
NA	NA	NA	NA	NA	NA	NA	NA	NA	NA
SOURCE:  BLS, LAUS	NA	NA	NA	NA	NA	NA	NA	NA	NA
March 18, 2016	NA	NA	NA	NA	NA	NA	NA	NA	NA
