LAUS_CODE	STATE_FIPS	COUNTY_FIPS	COUNTY	YEAR	ESTIMATED	LABOR_FORCE	EMPLOYED	UNEMPLOYED_LEVEL	UNEMPLOYED_RATE
CN0100100000000	01	001	Autauga County, AL	2000	NA	21720	20846	874	4
CN0100300000000	01	003	Baldwin County, AL	2000	NA	69533	66971	2562	3.7
CN0100500000000	01	005	Barbour County, AL	2000	NA	11373	10748	625	5.5
CN0100700000000	01	007	Bibb County, AL	2000	NA	8565	8111	454	5.3
CN0100900000000	01	009	Blount County, AL	2000	NA	25106	24231	875	3.5
CN0101100000000	01	011	Bullock County, AL	2000	NA	3971	3635	336	8.5
CN0101300000000	01	013	Butler County, AL	2000	NA	9156	8445	711	7.8
CN0101500000000	01	015	Calhoun County, AL	2000	NA	52896	50223	2673	5.1
CN0101700000000	01	017	Chambers County, AL	2000	NA	17373	16610	763	4.4
CN0101900000000	01	019	Cherokee County, AL	2000	NA	11304	10797	507	4.5
CN0102100000000	01	021	Chilton County, AL	2000	NA	19475	18641	834	4.3
CN0102300000000	01	023	Choctaw County, AL	2000	NA	6184	5781	403	6.5
CN0102500000000	01	025	Clarke County, AL	2000	NA	11597	10750	847	7.3
CN0102700000000	01	027	Clay County, AL	2000	NA	6565	6163	402	6.1
CN0102900000000	01	029	Cleburne County, AL	2000	NA	6958	6676	282	4.1
CN0103100000000	01	031	Coffee County, AL	2000	NA	19902	18748	1154	5.8
CN0103300000000	01	033	Colbert County, AL	2000	NA	25950	24511	1439	5.5
CN0103500000000	01	035	Conecuh County, AL	2000	NA	5483	5127	356	6.5
CN0103700000000	01	037	Coosa County, AL	2000	NA	5295	5009	286	5.4
CN0103900000000	01	039	Covington County, AL	2000	NA	17316	16124	1192	6.9
CN0104100000000	01	041	Crenshaw County, AL	2000	NA	6115	5766	349	5.7
CN0104300000000	01	043	Cullman County, AL	2000	NA	38647	37053	1594	4.1
CN0104500000000	01	045	Dale County, AL	2000	NA	20785	19702	1083	5.2
CN0104700000000	01	047	Dallas County, AL	2000	NA	17823	16389	1434	8
CN0104900000000	01	049	DeKalb County, AL	2000	NA	32308	31009	1299	4
CN0105100000000	01	051	Elmore County, AL	2000	NA	30995	29767	1228	4
CN0105300000000	01	053	Escambia County, AL	2000	NA	16092	15257	835	5.2
CN0105500000000	01	055	Etowah County, AL	2000	NA	48177	45380	2797	5.8
CN0105700000000	01	057	Fayette County, AL	2000	NA	8276	7792	484	5.8
CN0105900000000	01	059	Franklin County, AL	2000	NA	14629	13674	955	6.5
CN0106100000000	01	061	Geneva County, AL	2000	NA	12180	11562	618	5.1
CN0106300000000	01	063	Greene County, AL	2000	NA	3510	3271	239	6.8
CN0106500000000	01	065	Hale County, AL	2000	NA	6976	6557	419	6
CN0106700000000	01	067	Henry County, AL	2000	NA	7634	7259	375	4.9
CN0106900000000	01	069	Houston County, AL	2000	NA	45170	43186	1984	4.4
CN0107100000000	01	071	Jackson County, AL	2000	NA	27899	26454	1445	5.2
CN0107300000000	01	073	Jefferson County, AL	2000	NA	329015	315985	13030	4
CN0107500000000	01	075	Lamar County, AL	2000	NA	7446	6929	517	6.9
CN0107700000000	01	077	Lauderdale County, AL	2000	NA	43446	41285	2161	5
CN0107900000000	01	079	Lawrence County, AL	2000	NA	16573	15749	824	5
CN0108100000000	01	081	Lee County, AL	2000	NA	58023	55711	2312	4
CN0108300000000	01	083	Limestone County, AL	2000	NA	32829	31583	1246	3.8
CN0108500000000	01	085	Lowndes County, AL	2000	NA	5052	4704	348	6.9
CN0108700000000	01	087	Macon County, AL	2000	NA	9080	8556	524	5.8
CN0108900000000	01	089	Madison County, AL	2000	NA	148675	143415	5260	3.5
CN0109100000000	01	091	Marengo County, AL	2000	NA	9012	8543	469	5.2
CN0109300000000	01	093	Marion County, AL	2000	NA	14205	13260	945	6.7
CN0109500000000	01	095	Marshall County, AL	2000	NA	40543	38605	1938	4.8
CN0109700000000	01	097	Mobile County, AL	2000	NA	184951	175846	9105	4.9
CN0109900000000	01	099	Monroe County, AL	2000	NA	10273	9612	661	6.4
CN0110100000000	01	101	Montgomery County, AL	2000	NA	105729	101315	4414	4.2
CN0110300000000	01	103	Morgan County, AL	2000	NA	56248	53884	2364	4.2
CN0110500000000	01	105	Perry County, AL	2000	NA	4103	3725	378	9.2
CN0110700000000	01	107	Pickens County, AL	2000	NA	8597	7952	645	7.5
CN0110900000000	01	109	Pike County, AL	2000	NA	14060	13285	775	5.5
CN0111100000000	01	111	Randolph County, AL	2000	NA	9961	9478	483	4.8
CN0111300000000	01	113	Russell County, AL	2000	NA	21998	20984	1014	4.6
CN0111500000000	01	115	St. Clair County, AL	2000	NA	31353	30179	1174	3.7
CN0111700000000	01	117	Shelby County, AL	2000	NA	82280	80035	2245	2.7
CN0111900000000	01	119	Sumter County, AL	2000	NA	5381	4893	488	9.1
CN0112100000000	01	121	Talladega County, AL	2000	NA	35593	33753	1840	5.2
CN0112300000000	01	123	Tallapoosa County, AL	2000	NA	19358	18412	946	4.9
CN0112500000000	01	125	Tuscaloosa County, AL	2000	NA	81655	78451	3204	3.9
CN0112700000000	01	127	Walker County, AL	2000	NA	31502	29674	1828	5.8
CN0112900000000	01	129	Washington County, AL	2000	NA	7728	7200	528	6.8
CN0113100000000	01	131	Wilcox County, AL	2000	NA	3939	3595	344	8.7
CN0113300000000	01	133	Winston County, AL	2000	NA	11687	10776	911	7.8
CN0201300000000	02	013	Aleutians East Borough, AK	2000	NA	940	858	82	8.7
CN0201600000000	02	016	Aleutians West Census Area, AK	2000	NA	2735	2592	143	5.2
CN0202000000000	02	020	Anchorage Borough/municipality, AK	2000	NA	140602	133453	7149	5.1
CN0205000000000	02	050	Bethel Census Area, AK	2000	NA	6401	5824	577	9
CN0206000000000	02	060	Bristol Bay Borough, AK	2000	NA	925	866	59	6.4
CN0206800000000	02	068	Denali Borough, AK	2000	NA	1342	1244	98	7.3
CN0207000000000	02	070	Dillingham Census Area, AK	2000	NA	1963	1818	145	7.4
CN0209000000000	02	090	Fairbanks North Star Borough, AK	2000	NA	41013	38486	2527	6.2
CN0210000000000	02	100	Haines Borough, AK	2000	NA	1397	1284	113	8.1
CN0211000000000	02	110	Juneau Borough/city, AK	2000	NA	18021	17177	844	4.7
CN0212200000000	02	122	Kenai Peninsula Borough, AK	2000	NA	24598	22567	2031	8.3
CN0213000000000	02	130	Ketchikan Gateway Borough, AK	2000	NA	8294	7772	522	6.3
CN0215000000000	02	150	Kodiak Island Borough, AK	2000	NA	6544	5996	548	8.4
CN0215800000000	02	158	Kusilvak Census Area, AK	2000	NA	2237	1894	343	15.3
CN0216400000000	02	164	Lake and Peninsula Borough, AK	2000	NA	1036	982	54	5.2
CN0217000000000	02	170	Matanuska-Susitna Borough, AK	2000	NA	28873	26751	2122	7.3
CN0218000000000	02	180	Nome Census Area, AK	2000	NA	3703	3343	360	9.7
CN0218500000000	02	185	North Slope Borough, AK	2000	NA	3404	3116	288	8.5
CN0218800000000	02	188	Northwest Arctic Borough, AK	2000	NA	2946	2678	268	9.1
CN0220100000000	02	201	Prince of Wales-Outer Ketchikan Census Area, AK	2000	NA	2667	2286	381	14.3
CN0222000000000	02	220	Sitka Borough/city, AK	2000	NA	4454	4239	215	4.8
CN0223200000000	02	232	Skagway-Hoonah-Angoon Census Area, AK	2000	NA	1831	1649	182	9.9
CN0224000000000	02	240	Southeast Fairbanks Census Area, AK	2000	NA	2270	1988	282	12.4
CN0226100000000	02	261	Valdez-Cordova Census Area, AK	2000	NA	5224	4824	400	7.7
CN0228000000000	02	280	Wrangell-Petersburg Census Area, AK	2000	NA	3078	2777	301	9.8
CN0228200000000	02	282	Yakutat Borough/city, AK	2000	NA	371	345	26	7
CN0229000000000	02	290	Yukon-Koyukuk Census Area, AK	2000	NA	2644	2338	306	11.6
CN0400100000000	04	001	Apache County, AZ	2000	NA	19028	17318	1710	9
CN0400300000000	04	003	Cochise County, AZ	2000	NA	48643	46462	2181	4.5
CN0400500000000	04	005	Coconino County, AZ	2000	NA	62612	59882	2730	4.4
CN0400700000000	04	007	Gila County, AZ	2000	NA	20334	19267	1067	5.2
CN0400900000000	04	009	Graham County, AZ	2000	NA	12270	11604	666	5.4
CN0401100000000	04	011	Greenlee County, AZ	2000	NA	3921	3756	165	4.2
CN0401200000000	04	012	La Paz County, AZ	2000	NA	7623	7140	483	6.3
CN0401300000000	04	013	Maricopa County, AZ	2000	NA	1598108	1546411	51697	3.2
CN0401500000000	04	015	Mohave County, AZ	2000	NA	68796	65744	3052	4.4
CN0401700000000	04	017	Navajo County, AZ	2000	NA	34267	31791	2476	7.2
CN0401900000000	04	019	Pima County, AZ	2000	NA	409776	394635	15141	3.7
CN0402100000000	04	021	Pinal County, AZ	2000	NA	69618	66450	3168	4.6
CN0402300000000	04	023	Santa Cruz County, AZ	2000	NA	14747	13538	1209	8.2
CN0402500000000	04	025	Yavapai County, AZ	2000	NA	75804	72766	3038	4
CN0402700000000	04	027	Yuma County, AZ	2000	NA	64337	53817	10520	16.4
CN0500100000000	05	001	Arkansas County, AR	2000	NA	10144	9678	466	4.6
CN0500300000000	05	003	Ashley County, AR	2000	NA	10491	9870	621	5.9
CN0500500000000	05	005	Baxter County, AR	2000	NA	16266	15586	680	4.2
CN0500700000000	05	007	Benton County, AR	2000	NA	76753	74600	2153	2.8
CN0500900000000	05	009	Boone County, AR	2000	NA	16217	15537	680	4.2
CN0501100000000	05	011	Bradley County, AR	2000	NA	5096	4764	332	6.5
CN0501300000000	05	013	Calhoun County, AR	2000	NA	2553	2412	141	5.5
CN0501500000000	05	015	Carroll County, AR	2000	NA	13015	12502	513	3.9
CN0501700000000	05	017	Chicot County, AR	2000	NA	5428	5028	400	7.4
CN0501900000000	05	019	Clark County, AR	2000	NA	11208	10725	483	4.3
CN0502100000000	05	021	Clay County, AR	2000	NA	8064	7626	438	5.4
CN0502300000000	05	023	Cleburne County, AR	2000	NA	10719	10232	487	4.5
CN0502500000000	05	025	Cleveland County, AR	2000	NA	3896	3702	194	5
CN0502700000000	05	027	Columbia County, AR	2000	NA	11261	10680	581	5.2
CN0502900000000	05	029	Conway County, AR	2000	NA	9336	8764	572	6.1
CN0503100000000	05	031	Craighead County, AR	2000	NA	42719	41012	1707	4
CN0503300000000	05	033	Crawford County, AR	2000	NA	24738	23848	890	3.6
CN0503500000000	05	035	Crittenden County, AR	2000	NA	21929	21017	912	4.2
CN0503700000000	05	037	Cross County, AR	2000	NA	8671	8262	409	4.7
CN0503900000000	05	039	Dallas County, AR	2000	NA	3858	3643	215	5.6
CN0504100000000	05	041	Desha County, AR	2000	NA	6312	5795	517	8.2
CN0504300000000	05	043	Drew County, AR	2000	NA	8732	8211	521	6
CN0504500000000	05	045	Faulkner County, AR	2000	NA	45405	43748	1657	3.6
CN0504700000000	05	047	Franklin County, AR	2000	NA	8061	7787	274	3.4
CN0504900000000	05	049	Fulton County, AR	2000	NA	4962	4768	194	3.9
CN0505100000000	05	051	Garland County, AR	2000	NA	38407	36755	1652	4.3
CN0505300000000	05	053	Grant County, AR	2000	NA	8083	7761	322	4
CN0505500000000	05	055	Greene County, AR	2000	NA	18115	17239	876	4.8
CN0505700000000	05	057	Hempstead County, AR	2000	NA	11062	10552	510	4.6
CN0505900000000	05	059	Hot Spring County, AR	2000	NA	14271	13663	608	4.3
CN0506100000000	05	061	Howard County, AR	2000	NA	6624	6340	284	4.3
CN0506300000000	05	063	Independence County, AR	2000	NA	16692	15880	812	4.9
CN0506500000000	05	065	Izard County, AR	2000	NA	5217	4971	246	4.7
CN0506700000000	05	067	Jackson County, AR	2000	NA	7695	7112	583	7.6
CN0506900000000	05	069	Jefferson County, AR	2000	NA	35900	33810	2090	5.8
CN0507100000000	05	071	Johnson County, AR	2000	NA	10184	9755	429	4.2
CN0507300000000	05	073	Lafayette County, AR	2000	NA	3450	3244	206	6
CN0507500000000	05	075	Lawrence County, AR	2000	NA	7857	7437	420	5.3
CN0507700000000	05	077	Lee County, AR	2000	NA	3892	3600	292	7.5
CN0507900000000	05	079	Lincoln County, AR	2000	NA	5032	4722	310	6.2
CN0508100000000	05	081	Little River County, AR	2000	NA	6384	6089	295	4.6
CN0508300000000	05	083	Logan County, AR	2000	NA	9854	9447	407	4.1
CN0508500000000	05	085	Lonoke County, AR	2000	NA	26393	25512	881	3.3
CN0508700000000	05	087	Madison County, AR	2000	NA	6911	6694	217	3.1
CN0508900000000	05	089	Marion County, AR	2000	NA	6645	6389	256	3.9
CN0509100000000	05	091	Miller County, AR	2000	NA	18185	17368	817	4.5
CN0509300000000	05	093	Mississippi County, AR	2000	NA	22654	20888	1766	7.8
CN0509500000000	05	095	Monroe County, AR	2000	NA	4070	3861	209	5.1
CN0509700000000	05	097	Montgomery County, AR	2000	NA	4073	3905	168	4.1
CN0509900000000	05	099	Nevada County, AR	2000	NA	4603	4383	220	4.8
CN0510100000000	05	101	Newton County, AR	2000	NA	3754	3591	163	4.3
CN0510300000000	05	103	Ouachita County, AR	2000	NA	12385	11652	733	5.9
CN0510500000000	05	105	Perry County, AR	2000	NA	4803	4564	239	5
CN0510700000000	05	107	Phillips County, AR	2000	NA	9693	9091	602	6.2
CN0510900000000	05	109	Pike County, AR	2000	NA	5429	5202	227	4.2
CN0511100000000	05	111	Poinsett County, AR	2000	NA	11432	10886	546	4.8
CN0511300000000	05	113	Polk County, AR	2000	NA	8976	8607	369	4.1
CN0511500000000	05	115	Pope County, AR	2000	NA	26758	25616	1142	4.3
CN0511700000000	05	117	Prairie County, AR	2000	NA	4399	4205	194	4.4
CN0511900000000	05	119	Pulaski County, AR	2000	NA	184110	177186	6924	3.8
CN0512100000000	05	121	Randolph County, AR	2000	NA	8280	7841	439	5.3
CN0512300000000	05	123	St. Francis County, AR	2000	NA	10906	10144	762	7
CN0512500000000	05	125	Saline County, AR	2000	NA	42665	41261	1404	3.3
CN0512700000000	05	127	Scott County, AR	2000	NA	4927	4754	173	3.5
CN0512900000000	05	129	Searcy County, AR	2000	NA	3304	3140	164	5
CN0513100000000	05	131	Sebastian County, AR	2000	NA	56415	54505	1910	3.4
CN0513300000000	05	133	Sevier County, AR	2000	NA	7230	6953	277	3.8
CN0513500000000	05	135	Sharp County, AR	2000	NA	6556	6211	345	5.3
CN0513700000000	05	137	Stone County, AR	2000	NA	4659	4453	206	4.4
CN0513900000000	05	139	Union County, AR	2000	NA	20172	19213	959	4.8
CN0514100000000	05	141	Van Buren County, AR	2000	NA	6619	6264	355	5.4
CN0514300000000	05	143	Washington County, AR	2000	NA	82117	79670	2447	3
CN0514500000000	05	145	White County, AR	2000	NA	30946	29464	1482	4.8
CN0514700000000	05	147	Woodruff County, AR	2000	NA	3771	3535	236	6.3
CN0514900000000	05	149	Yell County, AR	2000	NA	9921	9522	399	4
CN0600100000000	06	001	Alameda County, CA	2000	NA	769669	741850	27819	3.6
CN0600300000000	06	003	Alpine County, CA	2000	NA	555	520	35	6.3
CN0600500000000	06	005	Amador County, CA	2000	NA	15284	14489	795	5.2
CN0600700000000	06	007	Butte County, CA	2000	NA	93228	87431	5797	6.2
CN0600900000000	06	009	Calaveras County, CA	2000	NA	18161	17147	1014	5.6
CN0601100000000	06	011	Colusa County, CA	2000	NA	9274	8200	1074	11.6
CN0601300000000	06	013	Contra Costa County, CA	2000	NA	501337	483535	17802	3.6
CN0601500000000	06	015	Del Norte County, CA	2000	NA	10247	9486	761	7.4
CN0601700000000	06	017	El Dorado County, CA	2000	NA	82237	78825	3412	4.1
CN0601900000000	06	019	Fresno County, CA	2000	NA	388673	348153	40520	10.4
CN0602100000000	06	021	Glenn County, CA	2000	NA	11298	10342	956	8.5
CN0602300000000	06	023	Humboldt County, CA	2000	NA	60172	56679	3493	5.8
CN0602500000000	06	025	Imperial County, CA	2000	NA	56129	46328	9801	17.5
CN0602700000000	06	027	Inyo County, CA	2000	NA	8861	8447	414	4.7
CN0602900000000	06	029	Kern County, CA	2000	NA	293919	269613	24306	8.3
CN0603100000000	06	031	Kings County, CA	2000	NA	49264	44333	4931	10
CN0603300000000	06	033	Lake County, CA	2000	NA	23101	21419	1682	7.3
CN0603500000000	06	035	Lassen County, CA	2000	NA	11363	10550	813	7.2
CN0603700000000	06	037	Los Angeles County, CA	2000	NA	4677389	4425623	251766	5.4
CN0603900000000	06	039	Madera County, CA	2000	NA	54963	50174	4789	8.7
CN0604100000000	06	041	Marin County, CA	2000	NA	141919	137867	4052	2.9
CN0604300000000	06	043	Mariposa County, CA	2000	NA	7984	7490	494	6.2
CN0604500000000	06	045	Mendocino County, CA	2000	NA	43614	41182	2432	5.6
CN0604700000000	06	047	Merced County, CA	2000	NA	90390	81691	8699	9.6
CN0604900000000	06	049	Modoc County, CA	2000	NA	3757	3474	283	7.5
CN0605100000000	06	051	Mono County, CA	2000	NA	7403	7058	345	4.7
CN0605300000000	06	053	Monterey County, CA	2000	NA	203392	188378	15014	7.4
CN0605500000000	06	055	Napa County, CA	2000	NA	66678	64275	2403	3.6
CN0605700000000	06	057	Nevada County, CA	2000	NA	45500	43609	1891	4.2
CN0605900000000	06	059	Orange County, CA	2000	NA	1482303	1430102	52201	3.5
CN0606100000000	06	061	Placer County, CA	2000	NA	132217	127450	4767	3.6
CN0606300000000	06	063	Plumas County, CA	2000	NA	9770	9073	697	7.1
CN0606500000000	06	065	Riverside County, CA	2000	NA	681290	644661	36629	5.4
CN0606700000000	06	067	Sacramento County, CA	2000	NA	609256	582785	26471	4.3
CN0606900000000	06	069	San Benito County, CA	2000	NA	27476	25822	1654	6
CN0607100000000	06	071	San Bernardino County, CA	2000	NA	740001	704481	35520	4.8
CN0607300000000	06	073	San Diego County, CA	2000	NA	1377101	1323166	53935	3.9
CN0607500000000	06	075	San Francisco County/city, CA	2000	NA	473130	456993	16137	3.4
CN0607700000000	06	077	San Joaquin County, CA	2000	NA	259158	241091	18067	7
CN0607900000000	06	079	San Luis Obispo County, CA	2000	NA	122563	117613	4950	4
CN0608100000000	06	081	San Mateo County, CA	2000	NA	398478	387032	11446	2.9
CN0608300000000	06	083	Santa Barbara County, CA	2000	NA	202556	193699	8857	4.4
CN0608500000000	06	085	Santa Clara County, CA	2000	NA	941470	912217	29253	3.1
CN0608700000000	06	087	Santa Cruz County, CA	2000	NA	148485	140881	7604	5.1
CN0608900000000	06	089	Shasta County, CA	2000	NA	74906	70353	4553	6.1
CN0609100000000	06	091	Sierra County, CA	2000	NA	1803	1697	106	5.9
CN0609300000000	06	093	Siskiyou County, CA	2000	NA	19162	17716	1446	7.5
CN0609500000000	06	095	Solano County, CA	2000	NA	194370	185345	9025	4.6
CN0609700000000	06	097	Sonoma County, CA	2000	NA	253460	244927	8533	3.4
CN0609900000000	06	099	Stanislaus County, CA	2000	NA	207963	191746	16217	7.8
CN0610100000000	06	101	Sutter County, CA	2000	NA	37899	34331	3568	9.4
CN0610300000000	06	103	Tehama County, CA	2000	NA	23634	22089	1545	6.5
CN0610500000000	06	105	Trinity County, CA	2000	NA	5115	4613	502	9.8
CN0610700000000	06	107	Tulare County, CA	2000	NA	172016	154107	17909	10.4
CN0610900000000	06	109	Tuolumne County, CA	2000	NA	22909	21557	1352	5.9
CN0611100000000	06	111	Ventura County, CA	2000	NA	392984	375180	17804	4.5
CN0611300000000	06	113	Yolo County, CA	2000	NA	86259	81906	4353	5
CN0611500000000	06	115	Yuba County, CA	2000	NA	24316	22379	1937	8
CN0800100000000	08	001	Adams County, CO	2000	NA	186727	181535	5192	2.8
CN0800300000000	08	003	Alamosa County, CO	2000	NA	7210	6947	263	3.6
CN0800500000000	08	005	Arapahoe County, CO	2000	NA	281811	274923	6888	2.4
CN0800700000000	08	007	Archuleta County, CO	2000	NA	5015	4854	161	3.2
CN0800900000000	08	009	Baca County, CO	2000	NA	2106	2044	62	2.9
CN0801100000000	08	011	Bent County, CO	2000	NA	2274	2185	89	3.9
CN0801300000000	08	013	Boulder County, CO	2000	NA	160011	156146	3865	2.4
CN0801400000000	08	014	Broomfield County/city, CO	2000	NA	22562	22017	545	2.4
CN0801500000000	08	015	Chaffee County, CO	2000	NA	7349	7103	246	3.3
CN0801700000000	08	017	Cheyenne County, CO	2000	NA	1121	1092	29	2.6
CN0801900000000	08	019	Clear Creek County, CO	2000	NA	6045	5879	166	2.7
CN0802100000000	08	021	Conejos County, CO	2000	NA	3342	3172	170	5.1
CN0802300000000	08	023	Costilla County, CO	2000	NA	1248	1155	93	7.5
CN0802500000000	08	025	Crowley County, CO	2000	NA	1489	1409	80	5.4
CN0802700000000	08	027	Custer County, CO	2000	NA	1665	1608	57	3.4
CN0802900000000	08	029	Delta County, CO	2000	NA	12337	11877	460	3.7
CN0803100000000	08	031	Denver County/city, CO	2000	NA	305202	295908	9294	3
CN0803300000000	08	033	Dolores County, CO	2000	NA	904	853	51	5.6
CN0803500000000	08	035	Douglas County, CO	2000	NA	105589	103403	2186	2.1
CN0803700000000	08	037	Eagle County, CO	2000	NA	25631	25014	617	2.4
CN0803900000000	08	039	Elbert County, CO	2000	NA	11604	11341	263	2.3
CN0804100000000	08	041	El Paso County, CO	2000	NA	264680	256914	7766	2.9
CN0804300000000	08	043	Fremont County, CO	2000	NA	17856	17151	705	3.9
CN0804500000000	08	045	Garfield County, CO	2000	NA	24755	24087	668	2.7
CN0804700000000	08	047	Gilpin County, CO	2000	NA	3308	3225	83	2.5
CN0804900000000	08	049	Grand County, CO	2000	NA	7627	7438	189	2.5
CN0805100000000	08	051	Gunnison County, CO	2000	NA	8183	7957	226	2.8
CN0805300000000	08	053	Hinsdale County, CO	2000	NA	651	638	13	2
CN0805500000000	08	055	Huerfano County, CO	2000	NA	3079	2906	173	5.6
CN0805700000000	08	057	Jackson County, CO	2000	NA	885	860	25	2.8
CN0805900000000	08	059	Jefferson County, CO	2000	NA	309348	302024	7324	2.4
CN0806100000000	08	061	Kiowa County, CO	2000	NA	782	758	24	3.1
CN0806300000000	08	063	Kit Carson County, CO	2000	NA	3846	3747	99	2.6
CN0806500000000	08	065	Lake County, CO	2000	NA	4043	3907	136	3.4
CN0806700000000	08	067	La Plata County, CO	2000	NA	24459	23753	706	2.9
CN0806900000000	08	069	Larimer County, CO	2000	NA	146317	142656	3661	2.5
CN0807100000000	08	071	Las Animas County, CO	2000	NA	6680	6401	279	4.2
CN0807300000000	08	073	Lincoln County, CO	2000	NA	2625	2552	73	2.8
CN0807500000000	08	075	Logan County, CO	2000	NA	10004	9718	286	2.9
CN0807700000000	08	077	Mesa County, CO	2000	NA	58884	56921	1963	3.3
CN0807900000000	08	079	Mineral County, CO	2000	NA	419	404	15	3.6
CN0808100000000	08	081	Moffat County, CO	2000	NA	7000	6750	250	3.6
CN0808300000000	08	083	Montezuma County, CO	2000	NA	11807	11311	496	4.2
CN0808500000000	08	085	Montrose County, CO	2000	NA	16215	15615	600	3.7
CN0808700000000	08	087	Morgan County, CO	2000	NA	12549	12168	381	3
CN0808900000000	08	089	Otero County, CO	2000	NA	8821	8437	384	4.4
CN0809100000000	08	091	Ouray County, CO	2000	NA	2198	2140	58	2.6
CN0809300000000	08	093	Park County, CO	2000	NA	8528	8310	218	2.6
CN0809500000000	08	095	Phillips County, CO	2000	NA	2053	1999	54	2.6
CN0809700000000	08	097	Pitkin County, CO	2000	NA	9925	9651	274	2.8
CN0809900000000	08	099	Prowers County, CO	2000	NA	6930	6729	201	2.9
CN0810100000000	08	101	Pueblo County, CO	2000	NA	63956	61428	2528	4
CN0810300000000	08	103	Rio Blanco County, CO	2000	NA	3237	3143	94	2.9
CN0810500000000	08	105	Rio Grande County, CO	2000	NA	5821	5558	263	4.5
CN0810700000000	08	107	Routt County, CO	2000	NA	12511	12195	316	2.5
CN0810900000000	08	109	Saguache County, CO	2000	NA	2708	2557	151	5.6
CN0811100000000	08	111	San Juan County, CO	2000	NA	515	491	24	4.7
CN0811300000000	08	113	San Miguel County, CO	2000	NA	4724	4580	144	3
CN0811500000000	08	115	Sedgwick County, CO	2000	NA	1399	1361	38	2.7
CN0811700000000	08	117	Summit County, CO	2000	NA	16070	15706	364	2.3
CN0811900000000	08	119	Teller County, CO	2000	NA	11888	11533	355	3
CN0812100000000	08	121	Washington County, CO	2000	NA	2440	2377	63	2.6
CN0812300000000	08	123	Weld County, CO	2000	NA	93511	90983	2528	2.7
CN0812500000000	08	125	Yuma County, CO	2000	NA	5038	4905	133	2.6
CN0900100000000	09	001	Fairfield County, CT	2000	NA	452280	442598	9682	2.1
CN0900300000000	09	003	Hartford County, CT	2000	NA	435261	423806	11455	2.6
CN0900500000000	09	005	Litchfield County, CT	2000	NA	100816	98723	2093	2.1
CN0900700000000	09	007	Middlesex County, CT	2000	NA	86650	84801	1849	2.1
CN0900900000000	09	009	New Haven County, CT	2000	NA	420320	409354	10966	2.6
CN0901100000000	09	011	New London County, CT	2000	NA	133684	130536	3148	2.4
CN0901300000000	09	013	Tolland County, CT	2000	NA	76716	75241	1475	1.9
CN0901500000000	09	015	Windham County, CT	2000	NA	58402	56854	1548	2.7
CN1000100000000	10	001	Kent County, DE	2000	NA	63479	60922	2557	4
CN1000300000000	10	003	New Castle County, DE	2000	NA	270531	260715	9816	3.6
CN1000500000000	10	005	Sussex County, DE	2000	NA	79492	76391	3101	3.9
CN1100100000000	11	001	District of Columbia	2000	NA	310469	293086	17383	5.6
CN1200100000000	12	001	Alachua County, FL	2000	NA	116143	112640	3503	3
CN1200300000000	12	003	Baker County, FL	2000	NA	10392	10078	314	3
CN1200500000000	12	005	Bay County, FL	2000	NA	71968	68623	3345	4.6
CN1200700000000	12	007	Bradford County, FL	2000	NA	10581	10183	398	3.8
CN1200900000000	12	009	Brevard County, FL	2000	NA	231904	223468	8436	3.6
CN1201100000000	12	011	Broward County, FL	2000	NA	854842	823673	31169	3.6
CN1201300000000	12	013	Calhoun County, FL	2000	NA	5152	4909	243	4.7
CN1201500000000	12	015	Charlotte County, FL	2000	NA	55138	53090	2048	3.7
CN1201700000000	12	017	Citrus County, FL	2000	NA	43726	41677	2049	4.7
CN1201900000000	12	019	Clay County, FL	2000	NA	73838	71600	2238	3
CN1202100000000	12	021	Collier County, FL	2000	NA	116066	111735	4331	3.7
CN1202300000000	12	023	Columbia County, FL	2000	NA	25668	24657	1011	3.9
CN1202700000000	12	027	DeSoto County, FL	2000	NA	13270	12679	591	4.5
CN1202900000000	12	029	Dixie County, FL	2000	NA	5128	4899	229	4.5
CN1203100000000	12	031	Duval County, FL	2000	NA	408161	394593	13568	3.3
CN1203300000000	12	033	Escambia County, FL	2000	NA	132433	127082	5351	4
CN1203500000000	12	035	Flagler County, FL	2000	NA	21000	20245	755	3.6
CN1203700000000	12	037	Franklin County, FL	2000	NA	4411	4237	174	3.9
CN1203900000000	12	039	Gadsden County, FL	2000	NA	19945	19145	800	4
CN1204100000000	12	041	Gilchrist County, FL	2000	NA	6427	6196	231	3.6
CN1204300000000	12	043	Glades County, FL	2000	NA	4085	3892	193	4.7
CN1204500000000	12	045	Gulf County, FL	2000	NA	5245	4928	317	6
CN1204700000000	12	047	Hamilton County, FL	2000	NA	4580	4335	245	5.3
CN1204900000000	12	049	Hardee County, FL	2000	NA	10751	10114	637	5.9
CN1205100000000	12	051	Hendry County, FL	2000	NA	16295	15116	1179	7.2
CN1205300000000	12	053	Hernando County, FL	2000	NA	49574	47411	2163	4.4
CN1205500000000	12	055	Highlands County, FL	2000	NA	33162	31569	1593	4.8
CN1205700000000	12	057	Hillsborough County, FL	2000	NA	528746	511461	17285	3.3
CN1205900000000	12	059	Holmes County, FL	2000	NA	7737	7364	373	4.8
CN1206100000000	12	061	Indian River County, FL	2000	NA	51043	48426	2617	5.1
CN1206300000000	12	063	Jackson County, FL	2000	NA	19391	18499	892	4.6
CN1206500000000	12	065	Jefferson County, FL	2000	NA	6065	5841	224	3.7
CN1206700000000	12	067	Lafayette County, FL	2000	NA	2718	2607	111	4.1
CN1206900000000	12	069	Lake County, FL	2000	NA	93264	89912	3352	3.6
CN1207100000000	12	071	Lee County, FL	2000	NA	207658	200939	6719	3.2
CN1207300000000	12	073	Leon County, FL	2000	NA	134773	130656	4117	3.1
CN1207500000000	12	075	Levy County, FL	2000	NA	14394	13834	560	3.9
CN1207700000000	12	077	Liberty County, FL	2000	NA	2621	2512	109	4.2
CN1207900000000	12	079	Madison County, FL	2000	NA	7695	7381	314	4.1
CN1208100000000	12	081	Manatee County, FL	2000	NA	123188	119262	3926	3.2
CN1208300000000	12	083	Marion County, FL	2000	NA	109171	104748	4423	4.1
CN1208500000000	12	085	Martin County, FL	2000	NA	56333	53983	2350	4.2
CN1208600000000	12	086	Miami-Dade County, FL	2000	NA	1093542	1046967	46575	4.3
CN1208700000000	12	087	Monroe County, FL	2000	NA	45170	43877	1293	2.9
CN1208900000000	12	089	Nassau County, FL	2000	NA	30268	29267	1001	3.3
CN1209100000000	12	091	Okaloosa County, FL	2000	NA	80375	77412	2963	3.7
CN1209300000000	12	093	Okeechobee County, FL	2000	NA	15658	14815	843	5.4
CN1209500000000	12	095	Orange County, FL	2000	NA	499432	484112	15320	3.1
CN1209700000000	12	097	Osceola County, FL	2000	NA	89542	86592	2950	3.3
CN1209900000000	12	099	Palm Beach County, FL	2000	NA	541551	518667	22884	4.2
CN1210100000000	12	101	Pasco County, FL	2000	NA	150210	144659	5551	3.7
CN1210300000000	12	103	Pinellas County, FL	2000	NA	470985	455503	15482	3.3
CN1210500000000	12	105	Polk County, FL	2000	NA	231202	221632	9570	4.1
CN1210700000000	12	107	Putnam County, FL	2000	NA	29345	28090	1255	4.3
CN1210900000000	12	109	St. Johns County, FL	2000	NA	66434	64467	1967	3
CN1211100000000	12	111	St. Lucie County, FL	2000	NA	87437	82393	5044	5.8
CN1211300000000	12	113	Santa Rosa County, FL	2000	NA	54960	52852	2108	3.8
CN1211500000000	12	115	Sarasota County, FL	2000	NA	148776	144010	4766	3.2
CN1211700000000	12	117	Seminole County, FL	2000	NA	212542	206108	6434	3
CN1211900000000	12	119	Sumter County, FL	2000	NA	16919	16189	730	4.3
CN1212100000000	12	121	Suwannee County, FL	2000	NA	15419	14866	553	3.6
CN1212300000000	12	123	Taylor County, FL	2000	NA	8276	7868	408	4.9
CN1212500000000	12	125	Union County, FL	2000	NA	4529	4331	198	4.4
CN1212700000000	12	127	Volusia County, FL	2000	NA	209603	202516	7087	3.4
CN1212900000000	12	129	Wakulla County, FL	2000	NA	11691	11316	375	3.2
CN1213100000000	12	131	Walton County, FL	2000	NA	19410	18737	673	3.5
CN1213300000000	12	133	Washington County, FL	2000	NA	8945	8541	404	4.5
CN1300100000000	13	001	Appling County, GA	2000	NA	8562	8095	467	5.5
CN1300300000000	13	003	Atkinson County, GA	2000	NA	3506	3318	188	5.4
CN1300500000000	13	005	Bacon County, GA	2000	NA	4664	4449	215	4.6
CN1300700000000	13	007	Baker County, GA	2000	NA	1742	1667	75	4.3
CN1300900000000	13	009	Baldwin County, GA	2000	NA	18967	18042	925	4.9
CN1301100000000	13	011	Banks County, GA	2000	NA	7804	7565	239	3.1
CN1301300000000	13	013	Barrow County, GA	2000	NA	25128	24364	764	3
CN1301500000000	13	015	Bartow County, GA	2000	NA	40537	39030	1507	3.7
CN1301700000000	13	017	Ben Hill County, GA	2000	NA	8151	7752	399	4.9
CN1301900000000	13	019	Berrien County, GA	2000	NA	8053	7728	325	4
CN1302100000000	13	021	Bibb County, GA	2000	NA	70329	67260	3069	4.4
CN1302300000000	13	023	Bleckley County, GA	2000	NA	5170	4950	220	4.3
CN1302500000000	13	025	Brantley County, GA	2000	NA	6786	6498	288	4.2
CN1302700000000	13	027	Brooks County, GA	2000	NA	7557	7205	352	4.7
CN1302900000000	13	029	Bryan County, GA	2000	NA	11595	11228	367	3.2
CN1303100000000	13	031	Bulloch County, GA	2000	NA	27281	26214	1067	3.9
CN1303300000000	13	033	Burke County, GA	2000	NA	9176	8707	469	5.1
CN1303500000000	13	035	Butts County, GA	2000	NA	9070	8650	420	4.6
CN1303700000000	13	037	Calhoun County, GA	2000	NA	2358	2203	155	6.6
CN1303900000000	13	039	Camden County, GA	2000	NA	17796	17141	655	3.7
CN1304300000000	13	043	Candler County, GA	2000	NA	3985	3798	187	4.7
CN1304500000000	13	045	Carroll County, GA	2000	NA	44846	43157	1689	3.8
CN1304700000000	13	047	Catoosa County, GA	2000	NA	29667	28863	804	2.7
CN1304900000000	13	049	Charlton County, GA	2000	NA	3948	3784	164	4.2
CN1305100000000	13	051	Chatham County, GA	2000	NA	111566	107528	4038	3.6
CN1305300000000	13	053	Chattahoochee County, GA	2000	NA	2633	2415	218	8.3
CN1305500000000	13	055	Chattooga County, GA	2000	NA	11630	11187	443	3.8
CN1305700000000	13	057	Cherokee County, GA	2000	NA	82743	80578	2165	2.6
CN1305900000000	13	059	Clarke County, GA	2000	NA	54212	52334	1878	3.5
CN1306100000000	13	061	Clay County, GA	2000	NA	1343	1268	75	5.6
CN1306300000000	13	063	Clayton County, GA	2000	NA	126141	121852	4289	3.4
CN1306500000000	13	065	Clinch County, GA	2000	NA	2766	2616	150	5.4
CN1306700000000	13	067	Cobb County, GA	2000	NA	360309	350131	10178	2.8
CN1306900000000	13	069	Coffee County, GA	2000	NA	17154	16352	802	4.7
CN1307100000000	13	071	Colquitt County, GA	2000	NA	19350	18447	903	4.7
CN1307300000000	13	073	Columbia County, GA	2000	NA	47195	45805	1390	2.9
CN1307500000000	13	075	Cook County, GA	2000	NA	7260	6926	334	4.6
CN1307700000000	13	077	Coweta County, GA	2000	NA	48664	47041	1623	3.3
CN1307900000000	13	079	Crawford County, GA	2000	NA	5869	5633	236	4
CN1308100000000	13	081	Crisp County, GA	2000	NA	9729	9269	460	4.7
CN1308300000000	13	083	Dade County, GA	2000	NA	7703	7469	234	3
CN1308500000000	13	085	Dawson County, GA	2000	NA	9021	8774	247	2.7
CN1308700000000	13	087	Decatur County, GA	2000	NA	12298	11737	561	4.6
CN1308900000000	13	089	DeKalb County, GA	2000	NA	380802	368116	12686	3.3
CN1309100000000	13	091	Dodge County, GA	2000	NA	8505	8096	409	4.8
CN1309300000000	13	093	Dooly County, GA	2000	NA	4793	4561	232	4.8
CN1309500000000	13	095	Dougherty County, GA	2000	NA	41490	39301	2189	5.3
CN1309700000000	13	097	Douglas County, GA	2000	NA	51398	49859	1539	3
CN1309900000000	13	099	Early County, GA	2000	NA	5356	5084	272	5.1
CN1310100000000	13	101	Echols County, GA	2000	NA	1857	1792	65	3.5
CN1310300000000	13	103	Effingham County, GA	2000	NA	19004	18398	606	3.2
CN1310500000000	13	105	Elbert County, GA	2000	NA	9710	9195	515	5.3
CN1310700000000	13	107	Emanuel County, GA	2000	NA	9933	9364	569	5.7
CN1310900000000	13	109	Evans County, GA	2000	NA	4690	4485	205	4.4
CN1311100000000	13	111	Fannin County, GA	2000	NA	9070	8712	358	3.9
CN1311300000000	13	113	Fayette County, GA	2000	NA	49730	48393	1337	2.7
CN1311500000000	13	115	Floyd County, GA	2000	NA	44685	42959	1726	3.9
CN1311700000000	13	117	Forsyth County, GA	2000	NA	57230	55837	1393	2.4
CN1311900000000	13	119	Franklin County, GA	2000	NA	9934	9540	394	4
CN1312100000000	13	121	Fulton County, GA	2000	NA	429759	414781	14978	3.5
CN1312300000000	13	123	Gilmer County, GA	2000	NA	11300	10920	380	3.4
CN1312500000000	13	125	Glascock County, GA	2000	NA	1189	1140	49	4.1
CN1312700000000	13	127	Glynn County, GA	2000	NA	34787	33548	1239	3.6
CN1312900000000	13	129	Gordon County, GA	2000	NA	24302	23474	828	3.4
CN1313100000000	13	131	Grady County, GA	2000	NA	11001	10507	494	4.5
CN1313300000000	13	133	Greene County, GA	2000	NA	6371	6085	286	4.5
CN1313500000000	13	135	Gwinnett County, GA	2000	NA	346112	336524	9588	2.8
CN1313700000000	13	137	Habersham County, GA	2000	NA	18359	17709	650	3.5
CN1313900000000	13	139	Hall County, GA	2000	NA	73522	71319	2203	3
CN1314100000000	13	141	Hancock County, GA	2000	NA	3274	3015	259	7.9
CN1314300000000	13	143	Haralson County, GA	2000	NA	12391	11945	446	3.6
CN1314500000000	13	145	Harris County, GA	2000	NA	12901	12491	410	3.2
CN1314700000000	13	147	Hart County, GA	2000	NA	11367	10910	457	4
CN1314900000000	13	149	Heard County, GA	2000	NA	5124	4918	206	4
CN1315100000000	13	151	Henry County, GA	2000	NA	67461	65635	1826	2.7
CN1315300000000	13	153	Houston County, GA	2000	NA	53584	51743	1841	3.4
CN1315500000000	13	155	Irwin County, GA	2000	NA	4537	4325	212	4.7
CN1315700000000	13	157	Jackson County, GA	2000	NA	21347	20662	685	3.2
CN1315900000000	13	159	Jasper County, GA	2000	NA	5774	5586	188	3.3
CN1316100000000	13	161	Jeff Davis County, GA	2000	NA	5783	5513	270	4.7
CN1316300000000	13	163	Jefferson County, GA	2000	NA	6764	6307	457	6.8
CN1316500000000	13	165	Jenkins County, GA	2000	NA	3727	3527	200	5.4
CN1316700000000	13	167	Johnson County, GA	2000	NA	3401	3193	208	6.1
CN1316900000000	13	169	Jones County, GA	2000	NA	11787	11327	460	3.9
CN1317100000000	13	171	Lamar County, GA	2000	NA	8045	7681	364	4.5
CN1317300000000	13	173	Lanier County, GA	2000	NA	3332	3167	165	5
CN1317500000000	13	175	Laurens County, GA	2000	NA	21401	20416	985	4.6
CN1317700000000	13	177	Lee County, GA	2000	NA	13142	12688	454	3.5
CN1317900000000	13	179	Liberty County, GA	2000	NA	19618	18576	1042	5.3
CN1318100000000	13	181	Lincoln County, GA	2000	NA	3771	3552	219	5.8
CN1318300000000	13	183	Long County, GA	2000	NA	4317	4158	159	3.7
CN1318500000000	13	185	Lowndes County, GA	2000	NA	43444	41485	1959	4.5
CN1318700000000	13	187	Lumpkin County, GA	2000	NA	10903	10577	326	3
CN1318900000000	13	189	McDuffie County, GA	2000	NA	9898	9457	441	4.5
CN1319100000000	13	191	McIntosh County, GA	2000	NA	4890	4678	212	4.3
CN1319300000000	13	193	Macon County, GA	2000	NA	5419	5055	364	6.7
CN1319500000000	13	195	Madison County, GA	2000	NA	13797	13344	453	3.3
CN1319700000000	13	197	Marion County, GA	2000	NA	3321	3188	133	4
CN1319900000000	13	199	Meriwether County, GA	2000	NA	10129	9666	463	4.6
CN1320100000000	13	201	Miller County, GA	2000	NA	3253	3117	136	4.2
CN1320500000000	13	205	Mitchell County, GA	2000	NA	9907	9394	513	5.2
CN1320700000000	13	207	Monroe County, GA	2000	NA	11349	10924	425	3.7
CN1320900000000	13	209	Montgomery County, GA	2000	NA	3918	3690	228	5.8
CN1321100000000	13	211	Morgan County, GA	2000	NA	8170	7886	284	3.5
CN1321300000000	13	213	Murray County, GA	2000	NA	19601	18935	666	3.4
CN1321500000000	13	215	Muscogee County, GA	2000	NA	83631	79637	3994	4.8
CN1321700000000	13	217	Newton County, GA	2000	NA	32279	31214	1065	3.3
CN1321900000000	13	219	Oconee County, GA	2000	NA	14334	13963	371	2.6
CN1322100000000	13	221	Oglethorpe County, GA	2000	NA	6624	6421	203	3.1
CN1322300000000	13	223	Paulding County, GA	2000	NA	45732	44497	1235	2.7
CN1322500000000	13	225	Peach County, GA	2000	NA	10808	10311	497	4.6
CN1322700000000	13	227	Pickens County, GA	2000	NA	12476	12097	379	3
CN1322900000000	13	229	Pierce County, GA	2000	NA	7635	7325	310	4.1
CN1323100000000	13	231	Pike County, GA	2000	NA	6979	6719	260	3.7
CN1323300000000	13	233	Polk County, GA	2000	NA	17583	16855	728	4.1
CN1323500000000	13	235	Pulaski County, GA	2000	NA	4369	4189	180	4.1
CN1323700000000	13	237	Putnam County, GA	2000	NA	9040	8717	323	3.6
CN1323900000000	13	239	Quitman County, GA	2000	NA	1041	974	67	6.4
CN1324100000000	13	241	Rabun County, GA	2000	NA	7267	7032	235	3.2
CN1324300000000	13	243	Randolph County, GA	2000	NA	3003	2823	180	6
CN1324500000000	13	245	Richmond County, GA	2000	NA	87167	83280	3887	4.5
CN1324700000000	13	247	Rockdale County, GA	2000	NA	36870	35713	1157	3.1
CN1324900000000	13	249	Schley County, GA	2000	NA	1715	1644	71	4.1
CN1325100000000	13	251	Screven County, GA	2000	NA	6598	6271	327	5
CN1325300000000	13	253	Seminole County, GA	2000	NA	4007	3807	200	5
CN1325500000000	13	255	Spalding County, GA	2000	NA	28104	26882	1222	4.3
CN1325700000000	13	257	Stephens County, GA	2000	NA	13206	12724	482	3.6
CN1325900000000	13	259	Stewart County, GA	2000	NA	2086	1971	115	5.5
CN1326100000000	13	261	Sumter County, GA	2000	NA	15318	14677	641	4.2
CN1326300000000	13	263	Talbot County, GA	2000	NA	2849	2692	157	5.5
CN1326500000000	13	265	Taliaferro County, GA	2000	NA	848	804	44	5.2
CN1326700000000	13	267	Tattnall County, GA	2000	NA	8848	8331	517	5.8
CN1326900000000	13	269	Taylor County, GA	2000	NA	3407	3225	182	5.3
CN1327100000000	13	271	Telfair County, GA	2000	NA	4427	4081	346	7.8
CN1327300000000	13	273	Terrell County, GA	2000	NA	4654	4406	248	5.3
CN1327500000000	13	275	Thomas County, GA	2000	NA	19832	18989	843	4.3
CN1327700000000	13	277	Tift County, GA	2000	NA	18903	18114	789	4.2
CN1327900000000	13	279	Toombs County, GA	2000	NA	12239	11428	811	6.6
CN1328100000000	13	281	Towns County, GA	2000	NA	4249	4064	185	4.4
CN1328300000000	13	283	Treutlen County, GA	2000	NA	2634	2426	208	7.9
CN1328500000000	13	285	Troup County, GA	2000	NA	30066	28969	1097	3.6
CN1328700000000	13	287	Turner County, GA	2000	NA	4366	4121	245	5.6
CN1328900000000	13	289	Twiggs County, GA	2000	NA	4597	4392	205	4.5
CN1329100000000	13	291	Union County, GA	2000	NA	8098	7775	323	4
CN1329300000000	13	293	Upson County, GA	2000	NA	12798	12143	655	5.1
CN1329500000000	13	295	Walker County, GA	2000	NA	30410	29323	1087	3.6
CN1329700000000	13	297	Walton County, GA	2000	NA	32489	31464	1025	3.2
CN1329900000000	13	299	Ware County, GA	2000	NA	15209	14436	773	5.1
CN1330100000000	13	301	Warren County, GA	2000	NA	2641	2494	147	5.6
CN1330300000000	13	303	Washington County, GA	2000	NA	8567	8157	410	4.8
CN1330500000000	13	305	Wayne County, GA	2000	NA	11350	10783	567	5
CN1330700000000	13	307	Webster County, GA	2000	NA	1069	1028	41	3.8
CN1330900000000	13	309	Wheeler County, GA	2000	NA	2306	2161	145	6.3
CN1331100000000	13	311	White County, GA	2000	NA	10819	10434	385	3.6
CN1331300000000	13	313	Whitfield County, GA	2000	NA	43622	42072	1550	3.6
CN1331500000000	13	315	Wilcox County, GA	2000	NA	3251	3096	155	4.8
CN1331700000000	13	317	Wilkes County, GA	2000	NA	5039	4802	237	4.7
CN1331900000000	13	319	Wilkinson County, GA	2000	NA	4510	4315	195	4.3
CN1332100000000	13	321	Worth County, GA	2000	NA	10288	9834	454	4.4
CN1500100000000	15	001	Hawaii County, HI	2000	NA	73877	70165	3712	5
CN1500300000000	15	003	Honolulu County/city, HI	2000	NA	430891	413120	17771	4.1
CN1500700000000	15	007	Kauai County, HI	2000	NA	30231	28769	1462	4.8
CN1500900000000	15	009	Maui County, HI	2000	NA	70949	68160	2789	3.9
CN1600100000000	16	001	Ada County, ID	2000	NA	169932	164171	5761	3.4
CN1600300000000	16	003	Adams County, ID	2000	NA	1920	1728	192	10
CN1600500000000	16	005	Bannock County, ID	2000	NA	38180	36401	1779	4.7
CN1600700000000	16	007	Bear Lake County, ID	2000	NA	2947	2802	145	4.9
CN1600900000000	16	009	Benewah County, ID	2000	NA	4003	3560	443	11.1
CN1601100000000	16	011	Bingham County, ID	2000	NA	19688	18819	869	4.4
CN1601300000000	16	013	Blaine County, ID	2000	NA	11800	11380	420	3.6
CN1601500000000	16	015	Boise County, ID	2000	NA	3418	3250	168	4.9
CN1601700000000	16	017	Bonner County, ID	2000	NA	17617	16256	1361	7.7
CN1601900000000	16	019	Bonneville County, ID	2000	NA	41423	40005	1418	3.4
CN1602100000000	16	021	Boundary County, ID	2000	NA	4195	3870	325	7.7
CN1602300000000	16	023	Butte County, ID	2000	NA	1443	1380	63	4.4
CN1602500000000	16	025	Camas County, ID	2000	NA	535	515	20	3.7
CN1602700000000	16	027	Canyon County, ID	2000	NA	65786	62838	2948	4.5
CN1602900000000	16	029	Caribou County, ID	2000	NA	3259	3092	167	5.1
CN1603100000000	16	031	Cassia County, ID	2000	NA	10262	9753	509	5
CN1603300000000	16	033	Clark County, ID	2000	NA	529	501	28	5.3
CN1603500000000	16	035	Clearwater County, ID	2000	NA	3691	3202	489	13.2
CN1603700000000	16	037	Custer County, ID	2000	NA	2591	2446	145	5.6
CN1603900000000	16	039	Elmore County, ID	2000	NA	10598	9990	608	5.7
CN1604100000000	16	041	Franklin County, ID	2000	NA	5205	5036	169	3.2
CN1604300000000	16	043	Fremont County, ID	2000	NA	5625	5353	272	4.8
CN1604500000000	16	045	Gem County, ID	2000	NA	7012	6652	360	5.1
CN1604700000000	16	047	Gooding County, ID	2000	NA	7075	6803	272	3.8
CN1604900000000	16	049	Idaho County, ID	2000	NA	6953	6366	587	8.4
CN1605100000000	16	051	Jefferson County, ID	2000	NA	8989	8650	339	3.8
CN1605300000000	16	053	Jerome County, ID	2000	NA	9136	8737	399	4.4
CN1605500000000	16	055	Kootenai County, ID	2000	NA	56292	52720	3572	6.3
CN1605700000000	16	057	Latah County, ID	2000	NA	17577	16826	751	4.3
CN1605900000000	16	059	Lemhi County, ID	2000	NA	3808	3502	306	8
CN1606100000000	16	061	Lewis County, ID	2000	NA	1745	1631	114	6.5
CN1606300000000	16	063	Lincoln County, ID	2000	NA	2157	2062	95	4.4
CN1606500000000	16	065	Madison County, ID	2000	NA	12693	12243	450	3.5
CN1606700000000	16	067	Minidoka County, ID	2000	NA	10131	9550	581	5.7
CN1606900000000	16	069	Nez Perce County, ID	2000	NA	18878	17890	988	5.2
CN1607100000000	16	071	Oneida County, ID	2000	NA	1983	1915	68	3.4
CN1607300000000	16	073	Owyhee County, ID	2000	NA	4775	4588	187	3.9
CN1607500000000	16	075	Payette County, ID	2000	NA	9789	9126	663	6.8
CN1607700000000	16	077	Power County, ID	2000	NA	3591	3384	207	5.8
CN1607900000000	16	079	Shoshone County, ID	2000	NA	6036	5441	595	9.9
CN1608100000000	16	081	Teton County, ID	2000	NA	3652	3544	108	3
CN1608300000000	16	083	Twin Falls County, ID	2000	NA	33608	32192	1416	4.2
CN1608500000000	16	085	Valley County, ID	2000	NA	4111	3834	277	6.7
CN1608700000000	16	087	Washington County, ID	2000	NA	5196	4843	353	6.8
CN1700100000000	17	001	Adams County, IL	2000	NA	36253	35001	1252	3.5
CN1700300000000	17	003	Alexander County, IL	2000	NA	3651	3387	264	7.2
CN1700500000000	17	005	Bond County, IL	2000	NA	8371	8030	341	4.1
CN1700700000000	17	007	Boone County, IL	2000	NA	22241	21232	1009	4.5
CN1700900000000	17	009	Brown County, IL	2000	NA	2812	2722	90	3.2
CN1701100000000	17	011	Bureau County, IL	2000	NA	19286	18401	885	4.6
CN1701300000000	17	013	Calhoun County, IL	2000	NA	2559	2428	131	5.1
CN1701500000000	17	015	Carroll County, IL	2000	NA	8688	8222	466	5.4
CN1701700000000	17	017	Cass County, IL	2000	NA	7155	6847	308	4.3
CN1701900000000	17	019	Champaign County, IL	2000	NA	100039	96792	3247	3.2
CN1702100000000	17	021	Christian County, IL	2000	NA	17606	16730	876	5
CN1702300000000	17	023	Clark County, IL	2000	NA	8791	8389	402	4.6
CN1702500000000	17	025	Clay County, IL	2000	NA	7231	6824	407	5.6
CN1702700000000	17	027	Clinton County, IL	2000	NA	18499	17845	654	3.5
CN1702900000000	17	029	Coles County, IL	2000	NA	28403	27309	1094	3.9
CN1703100000000	17	031	Cook County, IL	2000	NA	2729293	2597449	131844	4.8
CN1703300000000	17	033	Crawford County, IL	2000	NA	9665	9153	512	5.3
CN1703500000000	17	035	Cumberland County, IL	2000	NA	5886	5623	263	4.5
CN1703700000000	17	037	DeKalb County, IL	2000	NA	51750	50031	1719	3.3
CN1703900000000	17	039	De Witt County, IL	2000	NA	9237	8765	472	5.1
CN1704100000000	17	041	Douglas County, IL	2000	NA	10432	10050	382	3.7
CN1704300000000	17	043	DuPage County, IL	2000	NA	529864	512199	17665	3.3
CN1704500000000	17	045	Edgar County, IL	2000	NA	9955	9539	416	4.2
CN1704700000000	17	047	Edwards County, IL	2000	NA	3676	3497	179	4.9
CN1704900000000	17	049	Effingham County, IL	2000	NA	18507	17744	763	4.1
CN1705100000000	17	051	Fayette County, IL	2000	NA	10323	9722	601	5.8
CN1705300000000	17	053	Ford County, IL	2000	NA	7387	7130	257	3.5
CN1705500000000	17	055	Franklin County, IL	2000	NA	17682	16546	1136	6.4
CN1705700000000	17	057	Fulton County, IL	2000	NA	17802	16879	923	5.2
CN1705900000000	17	059	Gallatin County, IL	2000	NA	2896	2730	166	5.7
CN1706100000000	17	061	Greene County, IL	2000	NA	7001	6653	348	5
CN1706300000000	17	063	Grundy County, IL	2000	NA	21100	19993	1107	5.2
CN1706500000000	17	065	Hamilton County, IL	2000	NA	4026	3835	191	4.7
CN1706700000000	17	067	Hancock County, IL	2000	NA	10949	10490	459	4.2
CN1706900000000	17	069	Hardin County, IL	2000	NA	1963	1842	121	6.2
CN1707100000000	17	071	Henderson County, IL	2000	NA	4328	4162	166	3.8
CN1707300000000	17	073	Henry County, IL	2000	NA	27554	26305	1249	4.5
CN1707500000000	17	075	Iroquois County, IL	2000	NA	16559	15890	669	4
CN1707700000000	17	077	Jackson County, IL	2000	NA	30584	29343	1241	4.1
CN1707900000000	17	079	Jasper County, IL	2000	NA	5378	5127	251	4.7
CN1708100000000	17	081	Jefferson County, IL	2000	NA	19260	18303	957	5
CN1708300000000	17	083	Jersey County, IL	2000	NA	11234	10758	476	4.2
CN1708500000000	17	085	Jo Daviess County, IL	2000	NA	12900	12383	517	4
CN1708700000000	17	087	Johnson County, IL	2000	NA	4892	4606	286	5.8
CN1708900000000	17	089	Kane County, IL	2000	NA	223778	214910	8868	4
CN1709100000000	17	091	Kankakee County, IL	2000	NA	52870	50620	2250	4.3
CN1709300000000	17	093	Kendall County, IL	2000	NA	32368	31303	1065	3.3
CN1709500000000	17	095	Knox County, IL	2000	NA	28228	26959	1269	4.5
CN1709700000000	17	097	Lake County, IL	2000	NA	341564	330057	11507	3.4
CN1709900000000	17	099	LaSalle County, IL	2000	NA	56839	54009	2830	5
CN1710100000000	17	101	Lawrence County, IL	2000	NA	8162	7734	428	5.2
CN1710300000000	17	103	Lee County, IL	2000	NA	17855	17144	711	4
CN1710500000000	17	105	Livingston County, IL	2000	NA	19677	18977	700	3.6
CN1710700000000	17	107	Logan County, IL	2000	NA	15173	14617	556	3.7
CN1710900000000	17	109	McDonough County, IL	2000	NA	16993	16313	680	4
CN1711100000000	17	111	McHenry County, IL	2000	NA	151416	145988	5428	3.6
CN1711300000000	17	113	McLean County, IL	2000	NA	86307	83643	2664	3.1
CN1711500000000	17	115	Macon County, IL	2000	NA	56346	53613	2733	4.9
CN1711700000000	17	117	Macoupin County, IL	2000	NA	24597	23566	1031	4.2
CN1711900000000	17	119	Madison County, IL	2000	NA	133862	128440	5422	4.1
CN1712100000000	17	121	Marion County, IL	2000	NA	20892	19780	1112	5.3
CN1712300000000	17	123	Marshall County, IL	2000	NA	7065	6793	272	3.8
CN1712500000000	17	125	Mason County, IL	2000	NA	7971	7540	431	5.4
CN1712700000000	17	127	Massac County, IL	2000	NA	7274	6914	360	4.9
CN1712900000000	17	129	Menard County, IL	2000	NA	7081	6846	235	3.3
CN1713100000000	17	131	Mercer County, IL	2000	NA	8910	8448	462	5.2
CN1713300000000	17	133	Monroe County, IL	2000	NA	15662	15184	478	3.1
CN1713500000000	17	135	Montgomery County, IL	2000	NA	14267	13516	751	5.3
CN1713700000000	17	137	Morgan County, IL	2000	NA	18995	18256	739	3.9
CN1713900000000	17	139	Moultrie County, IL	2000	NA	7524	7230	294	3.9
CN1714100000000	17	141	Ogle County, IL	2000	NA	27240	26147	1093	4
CN1714300000000	17	143	Peoria County, IL	2000	NA	92142	88277	3865	4.2
CN1714500000000	17	145	Perry County, IL	2000	NA	10374	9694	680	6.6
CN1714700000000	17	147	Piatt County, IL	2000	NA	9130	8824	306	3.4
CN1714900000000	17	149	Pike County, IL	2000	NA	8579	8146	433	5
CN1715100000000	17	151	Pope County, IL	2000	NA	2051	1924	127	6.2
CN1715300000000	17	153	Pulaski County, IL	2000	NA	3120	2914	206	6.6
CN1715500000000	17	155	Putnam County, IL	2000	NA	3171	3023	148	4.7
CN1715700000000	17	157	Randolph County, IL	2000	NA	15339	14620	719	4.7
CN1715900000000	17	159	Richland County, IL	2000	NA	7921	7467	454	5.7
CN1716100000000	17	161	Rock Island County, IL	2000	NA	78310	75000	3310	4.2
CN1716300000000	17	163	St. Clair County, IL	2000	NA	120586	114930	5656	4.7
CN1716500000000	17	165	Saline County, IL	2000	NA	11870	11099	771	6.5
CN1716700000000	17	167	Sangamon County, IL	2000	NA	106380	102745	3635	3.4
CN1716900000000	17	169	Schuyler County, IL	2000	NA	4020	3828	192	4.8
CN1717100000000	17	171	Scott County, IL	2000	NA	3009	2873	136	4.5
CN1717300000000	17	173	Shelby County, IL	2000	NA	11810	11266	544	4.6
CN1717500000000	17	175	Stark County, IL	2000	NA	2914	2750	164	5.6
CN1717700000000	17	177	Stephenson County, IL	2000	NA	26204	24917	1287	4.9
CN1717900000000	17	179	Tazewell County, IL	2000	NA	67858	65294	2564	3.8
CN1718100000000	17	181	Union County, IL	2000	NA	8428	7918	510	6.1
CN1718300000000	17	183	Vermilion County, IL	2000	NA	39183	37040	2143	5.5
CN1718500000000	17	185	Wabash County, IL	2000	NA	6946	6608	338	4.9
CN1718700000000	17	187	Warren County, IL	2000	NA	10150	9728	422	4.2
CN1718900000000	17	189	Washington County, IL	2000	NA	8432	8120	312	3.7
CN1719100000000	17	191	Wayne County, IL	2000	NA	8472	8004	468	5.5
CN1719300000000	17	193	White County, IL	2000	NA	7556	7200	356	4.7
CN1719500000000	17	195	Whiteside County, IL	2000	NA	31166	29937	1229	3.9
CN1719700000000	17	197	Will County, IL	2000	NA	278890	267518	11372	4.1
CN1719900000000	17	199	Williamson County, IL	2000	NA	30161	28448	1713	5.7
CN1720100000000	17	201	Winnebago County, IL	2000	NA	147775	141496	6279	4.2
CN1720300000000	17	203	Woodford County, IL	2000	NA	18952	18350	602	3.2
CN1800100000000	18	001	Adams County, IN	2000	NA	16558	16092	466	2.8
CN1800300000000	18	003	Allen County, IN	2000	NA	175714	170831	4883	2.8
CN1800500000000	18	005	Bartholomew County, IN	2000	NA	37297	36292	1005	2.7
CN1800700000000	18	007	Benton County, IN	2000	NA	4829	4686	143	3
CN1800900000000	18	009	Blackford County, IN	2000	NA	7031	6719	312	4.4
CN1801100000000	18	011	Boone County, IN	2000	NA	24257	23735	522	2.2
CN1801300000000	18	013	Brown County, IN	2000	NA	7871	7638	233	3
CN1801500000000	18	015	Carroll County, IN	2000	NA	10496	10195	301	2.9
CN1801700000000	18	017	Cass County, IN	2000	NA	20652	20003	649	3.1
CN1801900000000	18	019	Clark County, IN	2000	NA	52473	50559	1914	3.6
CN1802100000000	18	021	Clay County, IN	2000	NA	12852	12309	543	4.2
CN1802300000000	18	023	Clinton County, IN	2000	NA	16464	15970	494	3
CN1802500000000	18	025	Crawford County, IN	2000	NA	5113	4861	252	4.9
CN1802700000000	18	027	Daviess County, IN	2000	NA	14093	13661	432	3.1
CN1802900000000	18	029	Dearborn County, IN	2000	NA	24464	23639	825	3.4
CN1803100000000	18	031	Decatur County, IN	2000	NA	13427	13117	310	2.3
CN1803300000000	18	033	DeKalb County, IN	2000	NA	21700	21033	667	3.1
CN1803500000000	18	035	Delaware County, IN	2000	NA	58650	56569	2081	3.5
CN1803700000000	18	037	Dubois County, IN	2000	NA	22149	21645	504	2.3
CN1803900000000	18	039	Elkhart County, IN	2000	NA	96750	94152	2598	2.7
CN1804100000000	18	041	Fayette County, IN	2000	NA	12407	11854	553	4.5
CN1804300000000	18	043	Floyd County, IN	2000	NA	38036	36709	1327	3.5
CN1804500000000	18	045	Fountain County, IN	2000	NA	8654	8377	277	3.2
CN1804700000000	18	047	Franklin County, IN	2000	NA	11316	10911	405	3.6
CN1804900000000	18	049	Fulton County, IN	2000	NA	10764	10318	446	4.1
CN1805100000000	18	051	Gibson County, IN	2000	NA	16736	16167	569	3.4
CN1805300000000	18	053	Grant County, IN	2000	NA	34828	33419	1409	4
CN1805500000000	18	055	Greene County, IN	2000	NA	16023	15241	782	4.9
CN1805700000000	18	057	Hamilton County, IN	2000	NA	101251	99314	1937	1.9
CN1805900000000	18	059	Hancock County, IN	2000	NA	30389	29686	703	2.3
CN1806100000000	18	061	Harrison County, IN	2000	NA	18715	18075	640	3.4
CN1806300000000	18	063	Hendricks County, IN	2000	NA	57464	56303	1161	2
CN1806500000000	18	065	Henry County, IN	2000	NA	23348	22420	928	4
CN1806700000000	18	067	Howard County, IN	2000	NA	41485	40135	1350	3.3
CN1806900000000	18	069	Huntington County, IN	2000	NA	20784	20130	654	3.1
CN1807100000000	18	071	Jackson County, IN	2000	NA	21696	21102	594	2.7
CN1807300000000	18	073	Jasper County, IN	2000	NA	14701	14186	515	3.5
CN1807500000000	18	075	Jay County, IN	2000	NA	10978	10600	378	3.4
CN1807700000000	18	077	Jefferson County, IN	2000	NA	16169	15625	544	3.4
CN1807900000000	18	079	Jennings County, IN	2000	NA	14048	13639	409	2.9
CN1808100000000	18	081	Johnson County, IN	2000	NA	63225	61843	1382	2.2
CN1808300000000	18	083	Knox County, IN	2000	NA	19478	18741	737	3.8
CN1808500000000	18	085	Kosciusko County, IN	2000	NA	39242	38248	994	2.5
CN1808700000000	18	087	LaGrange County, IN	2000	NA	16887	16479	408	2.4
CN1808900000000	18	089	Lake County, IN	2000	NA	225445	216712	8733	3.9
CN1809100000000	18	091	LaPorte County, IN	2000	NA	53804	51890	1914	3.6
CN1809300000000	18	093	Lawrence County, IN	2000	NA	22922	21971	951	4.1
CN1809500000000	18	095	Madison County, IN	2000	NA	63445	61399	2046	3.2
CN1809700000000	18	097	Marion County, IN	2000	NA	455135	442211	12924	2.8
CN1809900000000	18	099	Marshall County, IN	2000	NA	23304	22564	740	3.2
CN1810100000000	18	101	Martin County, IN	2000	NA	5073	4897	176	3.5
CN1810300000000	18	103	Miami County, IN	2000	NA	17567	16957	610	3.5
CN1810500000000	18	105	Monroe County, IN	2000	NA	63749	61992	1757	2.8
CN1810700000000	18	107	Montgomery County, IN	2000	NA	19663	19134	529	2.7
CN1810900000000	18	109	Morgan County, IN	2000	NA	35539	34647	892	2.5
CN1811100000000	18	111	Newton County, IN	2000	NA	7256	7036	220	3
CN1811300000000	18	113	Noble County, IN	2000	NA	24416	23697	719	2.9
CN1811500000000	18	115	Ohio County, IN	2000	NA	2985	2881	104	3.5
CN1811700000000	18	117	Orange County, IN	2000	NA	9587	9154	433	4.5
CN1811900000000	18	119	Owen County, IN	2000	NA	10742	10405	337	3.1
CN1812100000000	18	121	Parke County, IN	2000	NA	8017	7728	289	3.6
CN1812300000000	18	123	Perry County, IN	2000	NA	9492	9036	456	4.8
CN1812500000000	18	125	Pike County, IN	2000	NA	6349	6120	229	3.6
CN1812700000000	18	127	Porter County, IN	2000	NA	77453	75181	2272	2.9
CN1812900000000	18	129	Posey County, IN	2000	NA	13852	13419	433	3.1
CN1813100000000	18	131	Pulaski County, IN	2000	NA	6760	6455	305	4.5
CN1813300000000	18	133	Putnam County, IN	2000	NA	17104	16599	505	3
CN1813500000000	18	135	Randolph County, IN	2000	NA	13531	13004	527	3.9
CN1813700000000	18	137	Ripley County, IN	2000	NA	13712	13349	363	2.6
CN1813900000000	18	139	Rush County, IN	2000	NA	9459	9203	256	2.7
CN1814100000000	18	141	St. Joseph County, IN	2000	NA	134193	129774	4419	3.3
CN1814300000000	18	143	Scott County, IN	2000	NA	11277	10894	383	3.4
CN1814500000000	18	145	Shelby County, IN	2000	NA	23544	22906	638	2.7
CN1814700000000	18	147	Spencer County, IN	2000	NA	10979	10580	399	3.6
CN1814900000000	18	149	Starke County, IN	2000	NA	10834	10300	534	4.9
CN1815100000000	18	151	Steuben County, IN	2000	NA	18468	17897	571	3.1
CN1815300000000	18	153	Sullivan County, IN	2000	NA	9225	8728	497	5.4
CN1815500000000	18	155	Switzerland County, IN	2000	NA	5009	4759	250	5
CN1815700000000	18	157	Tippecanoe County, IN	2000	NA	77923	75826	2097	2.7
CN1815900000000	18	159	Tipton County, IN	2000	NA	8674	8436	238	2.7
CN1816100000000	18	161	Union County, IN	2000	NA	3791	3670	121	3.2
CN1816300000000	18	163	Vanderburgh County, IN	2000	NA	89699	86739	2960	3.3
CN1816500000000	18	165	Vermillion County, IN	2000	NA	8134	7746	388	4.8
CN1816700000000	18	167	Vigo County, IN	2000	NA	50774	48666	2108	4.2
CN1816900000000	18	169	Wabash County, IN	2000	NA	18071	17513	558	3.1
CN1817100000000	18	171	Warren County, IN	2000	NA	4483	4359	124	2.8
CN1817300000000	18	173	Warrick County, IN	2000	NA	28416	27452	964	3.4
CN1817500000000	18	175	Washington County, IN	2000	NA	14032	13489	543	3.9
CN1817700000000	18	177	Wayne County, IN	2000	NA	35502	34175	1327	3.7
CN1817900000000	18	179	Wells County, IN	2000	NA	14871	14499	372	2.5
CN1818100000000	18	181	White County, IN	2000	NA	13584	13169	415	3.1
CN1818300000000	18	183	Whitley County, IN	2000	NA	17082	16635	447	2.6
CN1900100000000	19	001	Adair County, IA	2000	NA	4453	4335	118	2.6
CN1900300000000	19	003	Adams County, IA	2000	NA	2330	2242	88	3.8
CN1900500000000	19	005	Allamakee County, IA	2000	NA	7943	7676	267	3.4
CN1900700000000	19	007	Appanoose County, IA	2000	NA	6330	6056	274	4.3
CN1900900000000	19	009	Audubon County, IA	2000	NA	3410	3311	99	2.9
CN1901100000000	19	011	Benton County, IA	2000	NA	13663	13352	311	2.3
CN1901300000000	19	013	Black Hawk County, IA	2000	NA	68420	66536	1884	2.8
CN1901500000000	19	015	Boone County, IA	2000	NA	14581	14270	311	2.1
CN1901700000000	19	017	Bremer County, IA	2000	NA	12772	12460	312	2.4
CN1901900000000	19	019	Buchanan County, IA	2000	NA	10652	10355	297	2.8
CN1902100000000	19	021	Buena Vista County, IA	2000	NA	10249	10010	239	2.3
CN1902300000000	19	023	Butler County, IA	2000	NA	7978	7724	254	3.2
CN1902500000000	19	025	Calhoun County, IA	2000	NA	5335	5188	147	2.8
CN1902700000000	19	027	Carroll County, IA	2000	NA	11933	11667	266	2.2
CN1902900000000	19	029	Cass County, IA	2000	NA	7870	7589	281	3.6
CN1903100000000	19	031	Cedar County, IA	2000	NA	10354	10122	232	2.2
CN1903300000000	19	033	Cerro Gordo County, IA	2000	NA	25172	24446	726	2.9
CN1903500000000	19	035	Cherokee County, IA	2000	NA	6948	6787	161	2.3
CN1903700000000	19	037	Chickasaw County, IA	2000	NA	6863	6430	433	6.3
CN1903900000000	19	039	Clarke County, IA	2000	NA	4867	4715	152	3.1
CN1904100000000	19	041	Clay County, IA	2000	NA	9936	9694	242	2.4
CN1904300000000	19	043	Clayton County, IA	2000	NA	10207	9862	345	3.4
CN1904500000000	19	045	Clinton County, IA	2000	NA	26060	25176	884	3.4
CN1904700000000	19	047	Crawford County, IA	2000	NA	8894	8675	219	2.5
CN1904900000000	19	049	Dallas County, IA	2000	NA	23495	23049	446	1.9
CN1905100000000	19	051	Davis County, IA	2000	NA	4154	4019	135	3.2
CN1905300000000	19	053	Decatur County, IA	2000	NA	4261	4120	141	3.3
CN1905500000000	19	055	Delaware County, IA	2000	NA	10148	9864	284	2.8
CN1905700000000	19	057	Des Moines County, IA	2000	NA	22248	21477	771	3.5
CN1905900000000	19	059	Dickinson County, IA	2000	NA	9431	9175	256	2.7
CN1906100000000	19	061	Dubuque County, IA	2000	NA	48376	46822	1554	3.2
CN1906300000000	19	063	Emmet County, IA	2000	NA	6003	5833	170	2.8
CN1906500000000	19	065	Fayette County, IA	2000	NA	11183	10765	418	3.7
CN1906700000000	19	067	Floyd County, IA	2000	NA	8483	8172	311	3.7
CN1906900000000	19	069	Franklin County, IA	2000	NA	5684	5530	154	2.7
CN1907100000000	19	071	Fremont County, IA	2000	NA	4224	4125	99	2.3
CN1907300000000	19	073	Greene County, IA	2000	NA	4978	4816	162	3.3
CN1907500000000	19	075	Grundy County, IA	2000	NA	6505	6357	148	2.3
CN1907700000000	19	077	Guthrie County, IA	2000	NA	6043	5885	158	2.6
CN1907900000000	19	079	Hamilton County, IA	2000	NA	8928	8708	220	2.5
CN1908100000000	19	081	Hancock County, IA	2000	NA	6307	6171	136	2.2
CN1908300000000	19	083	Hardin County, IA	2000	NA	9481	9193	288	3
CN1908500000000	19	085	Harrison County, IA	2000	NA	8066	7852	214	2.7
CN1908700000000	19	087	Henry County, IA	2000	NA	10540	10231	309	2.9
CN1908900000000	19	089	Howard County, IA	2000	NA	5114	4954	160	3.1
CN1909100000000	19	091	Humboldt County, IA	2000	NA	5262	5128	134	2.5
CN1909300000000	19	093	Ida County, IA	2000	NA	3981	3895	86	2.2
CN1909500000000	19	095	Iowa County, IA	2000	NA	8824	8641	183	2.1
CN1909700000000	19	097	Jackson County, IA	2000	NA	11120	10723	397	3.6
CN1909900000000	19	099	Jasper County, IA	2000	NA	19769	19284	485	2.5
CN1910100000000	19	101	Jefferson County, IA	2000	NA	9018	8762	256	2.8
CN1910300000000	19	103	Johnson County, IA	2000	NA	67120	65893	1227	1.8
CN1910500000000	19	105	Jones County, IA	2000	NA	10394	10124	270	2.6
CN1910700000000	19	107	Keokuk County, IA	2000	NA	5810	5626	184	3.2
CN1910900000000	19	109	Kossuth County, IA	2000	NA	8821	8598	223	2.5
CN1911100000000	19	111	Lee County, IA	2000	NA	18601	17776	825	4.4
CN1911300000000	19	113	Linn County, IA	2000	NA	110907	108407	2500	2.3
CN1911500000000	19	115	Louisa County, IA	2000	NA	6236	6054	182	2.9
CN1911700000000	19	117	Lucas County, IA	2000	NA	4732	4602	130	2.7
CN1911900000000	19	119	Lyon County, IA	2000	NA	6351	6225	126	2
CN1912100000000	19	121	Madison County, IA	2000	NA	7599	7366	233	3.1
CN1912300000000	19	123	Mahaska County, IA	2000	NA	11507	11237	270	2.3
CN1912500000000	19	125	Marion County, IA	2000	NA	17580	17192	388	2.2
CN1912700000000	19	127	Marshall County, IA	2000	NA	20554	20001	553	2.7
CN1912900000000	19	129	Mills County, IA	2000	NA	7882	7726	156	2
CN1913100000000	19	131	Mitchell County, IA	2000	NA	5445	5297	148	2.7
CN1913300000000	19	133	Monona County, IA	2000	NA	4974	4821	153	3.1
CN1913500000000	19	135	Monroe County, IA	2000	NA	3895	3776	119	3.1
CN1913700000000	19	137	Montgomery County, IA	2000	NA	5992	5799	193	3.2
CN1913900000000	19	139	Muscatine County, IA	2000	NA	22224	21628	596	2.7
CN1914100000000	19	141	O'Brien County, IA	2000	NA	7751	7576	175	2.3
CN1914300000000	19	143	Osceola County, IA	2000	NA	3603	3515	88	2.4
CN1914500000000	19	145	Page County, IA	2000	NA	8334	8070	264	3.2
CN1914700000000	19	147	Palo Alto County, IA	2000	NA	5193	5074	119	2.3
CN1914900000000	19	149	Plymouth County, IA	2000	NA	13476	13137	339	2.5
CN1915100000000	19	151	Pocahontas County, IA	2000	NA	4190	4077	113	2.7
CN1915300000000	19	153	Polk County, IA	2000	NA	214484	209530	4954	2.3
CN1915500000000	19	155	Pottawattamie County, IA	2000	NA	47977	46857	1120	2.3
CN1915700000000	19	157	Poweshiek County, IA	2000	NA	10338	10062	276	2.7
CN1915900000000	19	159	Ringgold County, IA	2000	NA	2581	2505	76	2.9
CN1916100000000	19	161	Sac County, IA	2000	NA	5944	5791	153	2.6
CN1916300000000	19	163	Scott County, IA	2000	NA	85499	82756	2743	3.2
CN1916500000000	19	165	Shelby County, IA	2000	NA	7066	6902	164	2.3
CN1916700000000	19	167	Sioux County, IA	2000	NA	17576	17239	337	1.9
CN1916900000000	19	169	Story County, IA	2000	NA	46236	45430	806	1.7
CN1917100000000	19	171	Tama County, IA	2000	NA	9217	8909	308	3.3
CN1917300000000	19	173	Taylor County, IA	2000	NA	3478	3367	111	3.2
CN1917500000000	19	175	Union County, IA	2000	NA	6555	6338	217	3.3
CN1917700000000	19	177	Van Buren County, IA	2000	NA	3987	3861	126	3.2
CN1917900000000	19	179	Wapello County, IA	2000	NA	17831	17203	628	3.5
CN1918100000000	19	181	Warren County, IA	2000	NA	23477	22981	496	2.1
CN1918300000000	19	183	Washington County, IA	2000	NA	11286	11041	245	2.2
CN1918500000000	19	185	Wayne County, IA	2000	NA	3233	3136	97	3
CN1918700000000	19	187	Webster County, IA	2000	NA	19865	19269	596	3
CN1918900000000	19	189	Winnebago County, IA	2000	NA	6436	6307	129	2
CN1919100000000	19	191	Winneshiek County, IA	2000	NA	12139	11835	304	2.5
CN1919300000000	19	193	Woodbury County, IA	2000	NA	55308	53888	1420	2.6
CN1919500000000	19	195	Worth County, IA	2000	NA	4352	4225	127	2.9
CN1919700000000	19	197	Wright County, IA	2000	NA	7574	7378	196	2.6
CN2000100000000	20	001	Allen County, KS	2000	NA	7167	6846	321	4.5
CN2000300000000	20	003	Anderson County, KS	2000	NA	4073	3906	167	4.1
CN2000500000000	20	005	Atchison County, KS	2000	NA	8405	8043	362	4.3
CN2000700000000	20	007	Barber County, KS	2000	NA	2657	2586	71	2.7
CN2000900000000	20	009	Barton County, KS	2000	NA	14319	13848	471	3.3
CN2001100000000	20	011	Bourbon County, KS	2000	NA	8214	7908	306	3.7
CN2001300000000	20	013	Brown County, KS	2000	NA	5432	5170	262	4.8
CN2001500000000	20	015	Butler County, KS	2000	NA	30625	29427	1198	3.9
CN2001700000000	20	017	Chase County, KS	2000	NA	1571	1526	45	2.9
CN2001900000000	20	019	Chautauqua County, KS	2000	NA	1892	1811	81	4.3
CN2002100000000	20	021	Cherokee County, KS	2000	NA	10822	10314	508	4.7
CN2002300000000	20	023	Cheyenne County, KS	2000	NA	1613	1572	41	2.5
CN2002500000000	20	025	Clark County, KS	2000	NA	1194	1161	33	2.8
CN2002700000000	20	027	Clay County, KS	2000	NA	4557	4410	147	3.2
CN2002900000000	20	029	Cloud County, KS	2000	NA	5291	5101	190	3.6
CN2003100000000	20	031	Coffey County, KS	2000	NA	4674	4501	173	3.7
CN2003300000000	20	033	Comanche County, KS	2000	NA	1034	1011	23	2.2
CN2003500000000	20	035	Cowley County, KS	2000	NA	17577	16796	781	4.4
CN2003700000000	20	037	Crawford County, KS	2000	NA	18904	18087	817	4.3
CN2003900000000	20	039	Decatur County, KS	2000	NA	1730	1686	44	2.5
CN2004100000000	20	041	Dickinson County, KS	2000	NA	10264	9941	323	3.1
CN2004300000000	20	043	Doniphan County, KS	2000	NA	4116	3920	196	4.8
CN2004500000000	20	045	Douglas County, KS	2000	NA	58565	56989	1576	2.7
CN2004700000000	20	047	Edwards County, KS	2000	NA	1697	1653	44	2.6
CN2004900000000	20	049	Elk County, KS	2000	NA	1432	1363	69	4.8
CN2005100000000	20	051	Ellis County, KS	2000	NA	15342	14947	395	2.6
CN2005300000000	20	053	Ellsworth County, KS	2000	NA	3162	3057	105	3.3
CN2005500000000	20	055	Finney County, KS	2000	NA	20222	19709	513	2.5
CN2005700000000	20	057	Ford County, KS	2000	NA	15838	15428	410	2.6
CN2005900000000	20	059	Franklin County, KS	2000	NA	13198	12719	479	3.6
CN2006100000000	20	061	Geary County, KS	2000	NA	11335	10805	530	4.7
CN2006300000000	20	063	Gove County, KS	2000	NA	1576	1541	35	2.2
CN2006500000000	20	065	Graham County, KS	2000	NA	1438	1398	40	2.8
CN2006700000000	20	067	Grant County, KS	2000	NA	3722	3617	105	2.8
CN2006900000000	20	069	Gray County, KS	2000	NA	2996	2919	77	2.6
CN2007100000000	20	071	Greeley County, KS	2000	NA	762	737	25	3.3
CN2007300000000	20	073	Greenwood County, KS	2000	NA	3721	3547	174	4.7
CN2007500000000	20	075	Hamilton County, KS	2000	NA	1274	1240	34	2.7
CN2007700000000	20	077	Harper County, KS	2000	NA	3178	3063	115	3.6
CN2007900000000	20	079	Harvey County, KS	2000	NA	17596	16988	608	3.5
CN2008100000000	20	081	Haskell County, KS	2000	NA	2081	2034	47	2.3
CN2008300000000	20	083	Hodgeman County, KS	2000	NA	1006	973	33	3.3
CN2008500000000	20	085	Jackson County, KS	2000	NA	6657	6385	272	4.1
CN2008700000000	20	087	Jefferson County, KS	2000	NA	9768	9398	370	3.8
CN2008900000000	20	089	Jewell County, KS	2000	NA	1892	1843	49	2.6
CN2009100000000	20	091	Johnson County, KS	2000	NA	263190	255705	7485	2.8
CN2009300000000	20	093	Kearny County, KS	2000	NA	2031	1976	55	2.7
CN2009500000000	20	095	Kingman County, KS	2000	NA	4248	4098	150	3.5
CN2009700000000	20	097	Kiowa County, KS	2000	NA	1610	1566	44	2.7
CN2009900000000	20	099	Labette County, KS	2000	NA	11342	10799	543	4.8
CN2010100000000	20	101	Lane County, KS	2000	NA	1117	1086	31	2.8
CN2010300000000	20	103	Leavenworth County, KS	2000	NA	31310	30074	1236	3.9
CN2010500000000	20	105	Lincoln County, KS	2000	NA	1900	1848	52	2.7
CN2010700000000	20	107	Linn County, KS	2000	NA	4740	4515	225	4.7
CN2010900000000	20	109	Logan County, KS	2000	NA	1601	1546	55	3.4
CN2011100000000	20	111	Lyon County, KS	2000	NA	18572	18002	570	3.1
CN2011300000000	20	113	McPherson County, KS	2000	NA	15377	14934	443	2.9
CN2011500000000	20	115	Marion County, KS	2000	NA	6711	6512	199	3
CN2011700000000	20	117	Marshall County, KS	2000	NA	5560	5365	195	3.5
CN2011900000000	20	119	Meade County, KS	2000	NA	2168	2111	57	2.6
CN2012100000000	20	121	Miami County, KS	2000	NA	15359	14864	495	3.2
CN2012300000000	20	123	Mitchell County, KS	2000	NA	3511	3417	94	2.7
CN2012500000000	20	125	Montgomery County, KS	2000	NA	16998	16131	867	5.1
CN2012700000000	20	127	Morris County, KS	2000	NA	3061	2953	108	3.5
CN2012900000000	20	129	Morton County, KS	2000	NA	1746	1698	48	2.7
CN2013100000000	20	131	Nemaha County, KS	2000	NA	5232	5084	148	2.8
CN2013300000000	20	133	Neosho County, KS	2000	NA	8398	8033	365	4.3
CN2013500000000	20	135	Ness County, KS	2000	NA	1783	1740	43	2.4
CN2013700000000	20	137	Norton County, KS	2000	NA	2661	2581	80	3
CN2013900000000	20	139	Osage County, KS	2000	NA	8842	8455	387	4.4
CN2014100000000	20	141	Osborne County, KS	2000	NA	2310	2250	60	2.6
CN2014300000000	20	143	Ottawa County, KS	2000	NA	3372	3272	100	3
CN2014500000000	20	145	Pawnee County, KS	2000	NA	3524	3427	97	2.8
CN2014700000000	20	147	Phillips County, KS	2000	NA	3122	3037	85	2.7
CN2014900000000	20	149	Pottawatomie County, KS	2000	NA	9357	9060	297	3.2
CN2015100000000	20	151	Pratt County, KS	2000	NA	5063	4929	134	2.6
CN2015300000000	20	153	Rawlins County, KS	2000	NA	1468	1427	41	2.8
CN2015500000000	20	155	Reno County, KS	2000	NA	32322	31134	1188	3.7
CN2015700000000	20	157	Republic County, KS	2000	NA	2975	2890	85	2.9
CN2015900000000	20	159	Rice County, KS	2000	NA	5202	5014	188	3.6
CN2016100000000	20	161	Riley County, KS	2000	NA	30748	29874	874	2.8
CN2016300000000	20	163	Rooks County, KS	2000	NA	2733	2645	88	3.2
CN2016500000000	20	165	Rush County, KS	2000	NA	1731	1673	58	3.4
CN2016700000000	20	167	Russell County, KS	2000	NA	3544	3404	140	4
CN2016900000000	20	169	Saline County, KS	2000	NA	29912	29031	881	2.9
CN2017100000000	20	171	Scott County, KS	2000	NA	2988	2924	64	2.1
CN2017300000000	20	173	Sedgwick County, KS	2000	NA	238296	228780	9516	4
CN2017500000000	20	175	Seward County, KS	2000	NA	10385	10085	300	2.9
CN2017700000000	20	177	Shawnee County, KS	2000	NA	91500	87979	3521	3.8
CN2017900000000	20	179	Sheridan County, KS	2000	NA	1488	1457	31	2.1
CN2018100000000	20	181	Sherman County, KS	2000	NA	3620	3522	98	2.7
CN2018300000000	20	183	Smith County, KS	2000	NA	2175	2116	59	2.7
CN2018500000000	20	185	Stafford County, KS	2000	NA	2286	2215	71	3.1
CN2018700000000	20	187	Stanton County, KS	2000	NA	1266	1236	30	2.4
CN2018900000000	20	189	Stevens County, KS	2000	NA	2463	2394	69	2.8
CN2019100000000	20	191	Sumner County, KS	2000	NA	12868	12290	578	4.5
CN2019300000000	20	193	Thomas County, KS	2000	NA	4257	4156	101	2.4
CN2019500000000	20	195	Trego County, KS	2000	NA	1666	1625	41	2.5
CN2019700000000	20	197	Wabaunsee County, KS	2000	NA	3739	3619	120	3.2
CN2019900000000	20	199	Wallace County, KS	2000	NA	931	911	20	2.1
CN2020100000000	20	201	Washington County, KS	2000	NA	3348	3234	114	3.4
CN2020300000000	20	203	Wichita County, KS	2000	NA	1254	1219	35	2.8
CN2020500000000	20	205	Wilson County, KS	2000	NA	4996	4804	192	3.8
CN2020700000000	20	207	Woodson County, KS	2000	NA	1702	1621	81	4.8
CN2020900000000	20	209	Wyandotte County, KS	2000	NA	74318	69878	4440	6
CN2100100000000	21	001	Adair County, KY	2000	NA	8239	7825	414	5
CN2100300000000	21	003	Allen County, KY	2000	NA	8517	8144	373	4.4
CN2100500000000	21	005	Anderson County, KY	2000	NA	10242	9892	350	3.4
CN2100700000000	21	007	Ballard County, KY	2000	NA	4240	3988	252	5.9
CN2100900000000	21	009	Barren County, KY	2000	NA	19423	18529	894	4.6
CN2101100000000	21	011	Bath County, KY	2000	NA	4970	4665	305	6.1
CN2101300000000	21	013	Bell County, KY	2000	NA	9945	9295	650	6.5
CN2101500000000	21	015	Boone County, KY	2000	NA	49328	47873	1455	2.9
CN2101700000000	21	017	Bourbon County, KY	2000	NA	10038	9707	331	3.3
CN2101900000000	21	019	Boyd County, KY	2000	NA	21564	20320	1244	5.8
CN2102100000000	21	021	Boyle County, KY	2000	NA	13583	13045	538	4
CN2102300000000	21	023	Bracken County, KY	2000	NA	4208	4061	147	3.5
CN2102500000000	21	025	Breathitt County, KY	2000	NA	5423	5060	363	6.7
CN2102700000000	21	027	Breckinridge County, KY	2000	NA	8705	8290	415	4.8
CN2102900000000	21	029	Bullitt County, KY	2000	NA	33653	32564	1089	3.2
CN2103100000000	21	031	Butler County, KY	2000	NA	6638	6369	269	4.1
CN2103300000000	21	033	Caldwell County, KY	2000	NA	6234	5958	276	4.4
CN2103500000000	21	035	Calloway County, KY	2000	NA	17382	16701	681	3.9
CN2103700000000	21	037	Campbell County, KY	2000	NA	46821	45291	1530	3.3
CN2103900000000	21	039	Carlisle County, KY	2000	NA	2420	2273	147	6.1
CN2104100000000	21	041	Carroll County, KY	2000	NA	4995	4780	215	4.3
CN2104300000000	21	043	Carter County, KY	2000	NA	11797	10950	847	7.2
CN2104500000000	21	045	Casey County, KY	2000	NA	6899	6583	316	4.6
CN2104700000000	21	047	Christian County, KY	2000	NA	26573	25307	1266	4.8
CN2104900000000	21	049	Clark County, KY	2000	NA	17100	16469	631	3.7
CN2105100000000	21	051	Clay County, KY	2000	NA	7261	6783	478	6.6
CN2105300000000	21	053	Clinton County, KY	2000	NA	4549	4321	228	5
CN2105500000000	21	055	Crittenden County, KY	2000	NA	4372	4092	280	6.4
CN2105700000000	21	057	Cumberland County, KY	2000	NA	3200	3019	181	5.7
CN2105900000000	21	059	Daviess County, KY	2000	NA	47038	45066	1972	4.2
CN2106100000000	21	061	Edmonson County, KY	2000	NA	5056	4806	250	4.9
CN2106300000000	21	063	Elliott County, KY	2000	NA	2469	2250	219	8.9
CN2106500000000	21	065	Estill County, KY	2000	NA	6050	5761	289	4.8
CN2106700000000	21	067	Fayette County, KY	2000	NA	150199	145815	4384	2.9
CN2106900000000	21	069	Fleming County, KY	2000	NA	6516	6212	304	4.7
CN2107100000000	21	071	Floyd County, KY	2000	NA	13875	12919	956	6.9
CN2107300000000	21	073	Franklin County, KY	2000	NA	25571	24714	857	3.4
CN2107500000000	21	075	Fulton County, KY	2000	NA	3160	2994	166	5.3
CN2107700000000	21	077	Gallatin County, KY	2000	NA	3934	3779	155	3.9
CN2107900000000	21	079	Garrard County, KY	2000	NA	7599	7334	265	3.5
CN2108100000000	21	081	Grant County, KY	2000	NA	11633	11188	445	3.8
CN2108300000000	21	083	Graves County, KY	2000	NA	17221	16368	853	5
CN2108500000000	21	085	Grayson County, KY	2000	NA	11304	10724	580	5.1
CN2108700000000	21	087	Green County, KY	2000	NA	5368	5122	246	4.6
CN2108900000000	21	089	Greenup County, KY	2000	NA	15892	14969	923	5.8
CN2109100000000	21	091	Hancock County, KY	2000	NA	4203	3996	207	4.9
CN2109300000000	21	093	Hardin County, KY	2000	NA	43226	41368	1858	4.3
CN2109500000000	21	095	Harlan County, KY	2000	NA	10083	9252	831	8.2
CN2109700000000	21	097	Harrison County, KY	2000	NA	9183	8858	325	3.5
CN2109900000000	21	099	Hart County, KY	2000	NA	7670	7309	361	4.7
CN2110100000000	21	101	Henderson County, KY	2000	NA	22956	22152	804	3.5
CN2110300000000	21	103	Henry County, KY	2000	NA	7813	7565	248	3.2
CN2110500000000	21	105	Hickman County, KY	2000	NA	2377	2266	111	4.7
CN2110700000000	21	107	Hopkins County, KY	2000	NA	21349	20205	1144	5.4
CN2110900000000	21	109	Jackson County, KY	2000	NA	5065	4779	286	5.6
CN2111100000000	21	111	Jefferson County, KY	2000	NA	364088	350740	13348	3.7
CN2111300000000	21	113	Jessamine County, KY	2000	NA	20775	20164	611	2.9
CN2111500000000	21	115	Johnson County, KY	2000	NA	9130	8607	523	5.7
CN2111700000000	21	117	Kenton County, KY	2000	NA	83422	80744	2678	3.2
CN2111900000000	21	119	Knott County, KY	2000	NA	5732	5314	418	7.3
CN2112100000000	21	121	Knox County, KY	2000	NA	11163	10525	638	5.7
CN2112300000000	21	123	Larue County, KY	2000	NA	6450	6166	284	4.4
CN2112500000000	21	125	Laurel County, KY	2000	NA	24252	23241	1011	4.2
CN2112700000000	21	127	Lawrence County, KY	2000	NA	5520	5139	381	6.9
CN2112900000000	21	129	Lee County, KY	2000	NA	2502	2355	147	5.9
CN2113100000000	21	131	Leslie County, KY	2000	NA	3949	3718	231	5.8
CN2113300000000	21	133	Letcher County, KY	2000	NA	8838	8149	689	7.8
CN2113500000000	21	135	Lewis County, KY	2000	NA	5633	5151	482	8.6
CN2113700000000	21	137	Lincoln County, KY	2000	NA	10874	10431	443	4.1
CN2113900000000	21	139	Livingston County, KY	2000	NA	4950	4672	278	5.6
CN2114100000000	21	141	Logan County, KY	2000	NA	13321	12835	486	3.6
CN2114300000000	21	143	Lyon County, KY	2000	NA	3167	2989	178	5.6
CN2114500000000	21	145	McCracken County, KY	2000	NA	31776	30312	1464	4.6
CN2114700000000	21	147	McCreary County, KY	2000	NA	6093	5690	403	6.6
CN2114900000000	21	149	McLean County, KY	2000	NA	4783	4543	240	5
CN2115100000000	21	151	Madison County, KY	2000	NA	37585	36255	1330	3.5
CN2115300000000	21	153	Magoffin County, KY	2000	NA	4468	4000	468	10.5
CN2115500000000	21	155	Marion County, KY	2000	NA	8628	8196	432	5
CN2115700000000	21	157	Marshall County, KY	2000	NA	14821	14066	755	5.1
CN2115900000000	21	159	Martin County, KY	2000	NA	3464	3213	251	7.2
CN2116100000000	21	161	Mason County, KY	2000	NA	8337	8027	310	3.7
CN2116300000000	21	163	Meade County, KY	2000	NA	11781	11306	475	4
CN2116500000000	21	165	Menifee County, KY	2000	NA	2614	2451	163	6.2
CN2116700000000	21	167	Mercer County, KY	2000	NA	10744	10338	406	3.8
CN2116900000000	21	169	Metcalfe County, KY	2000	NA	4620	4412	208	4.5
CN2117100000000	21	171	Monroe County, KY	2000	NA	5421	4982	439	8.1
CN2117300000000	21	173	Montgomery County, KY	2000	NA	11266	10777	489	4.3
CN2117500000000	21	175	Morgan County, KY	2000	NA	4898	4583	315	6.4
CN2117700000000	21	177	Muhlenberg County, KY	2000	NA	13152	12385	767	5.8
CN2117900000000	21	179	Nelson County, KY	2000	NA	19731	18909	822	4.2
CN2118100000000	21	181	Nicholas County, KY	2000	NA	3280	3050	230	7
CN2118300000000	21	183	Ohio County, KY	2000	NA	10618	10076	542	5.1
CN2118500000000	21	185	Oldham County, KY	2000	NA	24177	23456	721	3
CN2118700000000	21	187	Owen County, KY	2000	NA	5019	4837	182	3.6
CN2118900000000	21	189	Owsley County, KY	2000	NA	1532	1445	87	5.7
CN2119100000000	21	191	Pendleton County, KY	2000	NA	7199	6950	249	3.5
CN2119300000000	21	193	Perry County, KY	2000	NA	10033	9365	668	6.7
CN2119500000000	21	195	Pike County, KY	2000	NA	25018	23495	1523	6.1
CN2119700000000	21	197	Powell County, KY	2000	NA	5836	5551	285	4.9
CN2119900000000	21	199	Pulaski County, KY	2000	NA	25802	24681	1121	4.3
CN2120100000000	21	201	Robertson County, KY	2000	NA	1098	1050	48	4.4
CN2120300000000	21	203	Rockcastle County, KY	2000	NA	7184	6847	337	4.7
CN2120500000000	21	205	Rowan County, KY	2000	NA	10829	10361	468	4.3
CN2120700000000	21	207	Russell County, KY	2000	NA	7466	7041	425	5.7
CN2120900000000	21	209	Scott County, KY	2000	NA	18430	17855	575	3.1
CN2121100000000	21	211	Shelby County, KY	2000	NA	18420	17867	553	3
CN2121300000000	21	213	Simpson County, KY	2000	NA	8510	8219	291	3.4
CN2121500000000	21	215	Spencer County, KY	2000	NA	6559	6362	197	3
CN2121700000000	21	217	Taylor County, KY	2000	NA	11240	10660	580	5.2
CN2121900000000	21	219	Todd County, KY	2000	NA	5778	5542	236	4.1
CN2122100000000	21	221	Trigg County, KY	2000	NA	5977	5711	266	4.5
CN2122300000000	21	223	Trimble County, KY	2000	NA	4105	3951	154	3.8
CN2122500000000	21	225	Union County, KY	2000	NA	7447	7096	351	4.7
CN2122700000000	21	227	Warren County, KY	2000	NA	50447	48580	1867	3.7
CN2122900000000	21	229	Washington County, KY	2000	NA	5247	5032	215	4.1
CN2123100000000	21	231	Wayne County, KY	2000	NA	8207	7759	448	5.5
CN2123300000000	21	233	Webster County, KY	2000	NA	6805	6494	311	4.6
CN2123500000000	21	235	Whitley County, KY	2000	NA	14347	13647	700	4.9
CN2123700000000	21	237	Wolfe County, KY	2000	NA	2531	2318	213	8.4
CN2123900000000	21	239	Woodford County, KY	2000	NA	13479	13110	369	2.7
CN2200100000000	22	001	Acadia Parish, LA	2000	NA	23944	22552	1392	5.8
CN2200300000000	22	003	Allen Parish, LA	2000	NA	8737	8148	589	6.7
CN2200500000000	22	005	Ascension Parish, LA	2000	NA	38466	36431	2035	5.3
CN2200700000000	22	007	Assumption Parish, LA	2000	NA	10014	9370	644	6.4
CN2200900000000	22	009	Avoyelles Parish, LA	2000	NA	15738	14732	1006	6.4
CN2201100000000	22	011	Beauregard Parish, LA	2000	NA	14032	13286	746	5.3
CN2201300000000	22	013	Bienville Parish, LA	2000	NA	5946	5545	401	6.7
CN2201500000000	22	015	Bossier Parish, LA	2000	NA	47153	44895	2258	4.8
CN2201700000000	22	017	Caddo Parish, LA	2000	NA	115086	109145	5941	5.2
CN2201900000000	22	019	Calcasieu Parish, LA	2000	NA	86596	82198	4398	5.1
CN2202100000000	22	021	Caldwell Parish, LA	2000	NA	4357	4060	297	6.8
CN2202300000000	22	023	Cameron Parish, LA	2000	NA	4544	4316	228	5
CN2202500000000	22	025	Catahoula Parish, LA	2000	NA	4151	3760	391	9.4
CN2202700000000	22	027	Claiborne Parish, LA	2000	NA	6498	6081	417	6.4
CN2202900000000	22	029	Concordia Parish, LA	2000	NA	7776	7118	658	8.5
CN2203100000000	22	031	De Soto Parish, LA	2000	NA	10813	10143	670	6.2
CN2203300000000	22	033	East Baton Rouge Parish, LA	2000	NA	207375	197789	9586	4.6
CN2203500000000	22	035	East Carroll Parish, LA	2000	NA	3111	2810	301	9.7
CN2203700000000	22	037	East Feliciana Parish, LA	2000	NA	8287	7811	476	5.7
CN2203900000000	22	039	Evangeline Parish, LA	2000	NA	12156	11432	724	6
CN2204100000000	22	041	Franklin Parish, LA	2000	NA	8220	7616	604	7.3
CN2204300000000	22	043	Grant Parish, LA	2000	NA	7918	7419	499	6.3
CN2204500000000	22	045	Iberia Parish, LA	2000	NA	30531	28760	1771	5.8
CN2204700000000	22	047	Iberville Parish, LA	2000	NA	12638	11745	893	7.1
CN2204900000000	22	049	Jackson Parish, LA	2000	NA	6718	6334	384	5.7
CN2205100000000	22	051	Jefferson Parish, LA	2000	NA	232236	221554	10682	4.6
CN2205300000000	22	053	Jefferson Davis Parish, LA	2000	NA	12807	12056	751	5.9
CN2205500000000	22	055	Lafayette Parish, LA	2000	NA	97491	93498	3993	4.1
CN2205700000000	22	057	Lafourche Parish, LA	2000	NA	41142	39295	1847	4.5
CN2205900000000	22	059	LaSalle Parish, LA	2000	NA	5903	5559	344	5.8
CN2206100000000	22	061	Lincoln Parish, LA	2000	NA	19104	18072	1032	5.4
CN2206300000000	22	063	Livingston Parish, LA	2000	NA	44859	42326	2533	5.6
CN2206500000000	22	065	Madison Parish, LA	2000	NA	4978	4577	401	8.1
CN2206700000000	22	067	Morehouse Parish, LA	2000	NA	12489	11532	957	7.7
CN2206900000000	22	069	Natchitoches Parish, LA	2000	NA	16622	15644	978	5.9
CN2207100000000	22	071	Orleans Parish, LA	2000	NA	211299	199774	11525	5.5
CN2207300000000	22	073	Ouachita Parish, LA	2000	NA	69948	66628	3320	4.7
CN2207500000000	22	075	Plaquemines Parish, LA	2000	NA	11041	10398	643	5.8
CN2207700000000	22	077	Pointe Coupee Parish, LA	2000	NA	9766	9150	616	6.3
CN2207900000000	22	079	Rapides Parish, LA	2000	NA	55791	52767	3024	5.4
CN2208100000000	22	081	Red River Parish, LA	2000	NA	3555	3308	247	6.9
CN2208300000000	22	083	Richland Parish, LA	2000	NA	8687	8088	599	6.9
CN2208500000000	22	085	Sabine Parish, LA	2000	NA	9313	8825	488	5.2
CN2208700000000	22	087	St. Bernard Parish, LA	2000	NA	32271	30510	1761	5.5
CN2208900000000	22	089	St. Charles Parish, LA	2000	NA	23964	22627	1337	5.6
CN2209100000000	22	091	St. Helena Parish, LA	2000	NA	4064	3830	234	5.8
CN2209300000000	22	093	St. James Parish, LA	2000	NA	8864	8102	762	8.6
CN2209500000000	22	095	St. John the Baptist Parish, LA	2000	NA	20065	18702	1363	6.8
CN2209700000000	22	097	St. Landry Parish, LA	2000	NA	32791	30658	2133	6.5
CN2209900000000	22	099	St. Martin Parish, LA	2000	NA	21381	20193	1188	5.6
CN2210100000000	22	101	St. Mary Parish, LA	2000	NA	22530	20866	1664	7.4
CN2210300000000	22	103	St. Tammany Parish, LA	2000	NA	96612	92428	4184	4.3
CN2210500000000	22	105	Tangipahoa Parish, LA	2000	NA	45252	42326	2926	6.5
CN2210700000000	22	107	Tensas Parish, LA	2000	NA	2484	2295	189	7.6
CN2210900000000	22	109	Terrebonne Parish, LA	2000	NA	45879	43746	2133	4.6
CN2211100000000	22	111	Union Parish, LA	2000	NA	10204	9623	581	5.7
CN2211300000000	22	113	Vermilion Parish, LA	2000	NA	23345	22103	1242	5.3
CN2211500000000	22	115	Vernon Parish, LA	2000	NA	18330	17203	1127	6.1
CN2211700000000	22	117	Washington Parish, LA	2000	NA	16815	15769	1046	6.2
CN2211900000000	22	119	Webster Parish, LA	2000	NA	18485	17353	1132	6.1
CN2212100000000	22	121	West Baton Rouge Parish, LA	2000	NA	10181	9642	539	5.3
CN2212300000000	22	123	West Carroll Parish, LA	2000	NA	4862	4395	467	9.6
CN2212500000000	22	125	West Feliciana Parish, LA	2000	NA	4816	4492	324	6.7
CN2212700000000	22	127	Winn Parish, LA	2000	NA	6047	5650	397	6.6
CN2300100000000	23	001	Androscoggin County, ME	2000	NA	55712	53809	1903	3.4
CN2300300000000	23	003	Aroostook County, ME	2000	NA	34925	33453	1472	4.2
CN2300500000000	23	005	Cumberland County, ME	2000	NA	149932	146206	3726	2.5
CN2300700000000	23	007	Franklin County, ME	2000	NA	14492	13760	732	5.1
CN2300900000000	23	009	Hancock County, ME	2000	NA	28872	27707	1165	4
CN2301100000000	23	011	Kennebec County, ME	2000	NA	61345	59188	2157	3.5
CN2301300000000	23	013	Knox County, ME	2000	NA	21024	20440	584	2.8
CN2301500000000	23	015	Lincoln County, ME	2000	NA	17911	17370	541	3
CN2301700000000	23	017	Oxford County, ME	2000	NA	27828	26687	1141	4.1
CN2301900000000	23	019	Penobscot County, ME	2000	NA	75494	72700	2794	3.7
CN2302100000000	23	021	Piscataquis County, ME	2000	NA	7964	7545	419	5.3
CN2302300000000	23	023	Sagadahoc County, ME	2000	NA	18950	18444	506	2.7
CN2302500000000	23	025	Somerset County, ME	2000	NA	25258	24049	1209	4.8
CN2302700000000	23	027	Waldo County, ME	2000	NA	19142	18390	752	3.9
CN2302900000000	23	029	Washington County, ME	2000	NA	15809	14866	943	6
CN2303100000000	23	031	York County, ME	2000	NA	103477	100722	2755	2.7
CN2400100000000	24	001	Allegany County, MD	2000	NA	32899	30942	1957	5.9
CN2400300000000	24	003	Anne Arundel County, MD	2000	NA	267502	259373	8129	3
CN2400500000000	24	005	Baltimore County, MD	2000	NA	408295	393073	15222	3.7
CN2400900000000	24	009	Calvert County, MD	2000	NA	40363	39142	1221	3
CN2401100000000	24	011	Caroline County, MD	2000	NA	15358	14802	556	3.6
CN2401300000000	24	013	Carroll County, MD	2000	NA	83928	81422	2506	3
CN2401500000000	24	015	Cecil County, MD	2000	NA	45771	44149	1622	3.5
CN2401700000000	24	017	Charles County, MD	2000	NA	65114	63181	1933	3
CN2401900000000	24	019	Dorchester County, MD	2000	NA	15588	14787	801	5.1
CN2402100000000	24	021	Frederick County, MD	2000	NA	109593	106609	2984	2.7
CN2402300000000	24	023	Garrett County, MD	2000	NA	14516	13759	757	5.2
CN2402500000000	24	025	Harford County, MD	2000	NA	119865	115950	3915	3.3
CN2402700000000	24	027	Howard County, MD	2000	NA	144594	140938	3656	2.5
CN2402900000000	24	029	Kent County, MD	2000	NA	10065	9674	391	3.9
CN2403100000000	24	031	Montgomery County, MD	2000	NA	487647	474773	12874	2.6
CN2403300000000	24	033	Prince George's County, MD	2000	NA	429199	413296	15903	3.7
CN2403500000000	24	035	Queen Anne's County, MD	2000	NA	22697	21999	698	3.1
CN2403700000000	24	037	St. Mary's County, MD	2000	NA	44340	42894	1446	3.3
CN2403900000000	24	039	Somerset County, MD	2000	NA	10449	9795	654	6.3
CN2404100000000	24	041	Talbot County, MD	2000	NA	17513	16926	587	3.4
CN2404300000000	24	043	Washington County, MD	2000	NA	66142	63713	2429	3.7
CN2404500000000	24	045	Wicomico County, MD	2000	NA	46226	44293	1933	4.2
CN2404700000000	24	047	Worcester County, MD	2000	NA	25995	24396	1599	6.2
CN2451000000000	24	510	Baltimore city, MD	2000	NA	280025	263397	16628	5.9
CN2500100000000	25	001	Barnstable County, MA	2000	NA	112276	108455	3821	3.4
CN2500300000000	25	003	Berkshire County, MA	2000	NA	69422	67406	2016	2.9
CN2500500000000	25	005	Bristol County, MA	2000	NA	275099	264925	10174	3.7
CN2500700000000	25	007	Dukes County, MA	2000	NA	9969	9695	274	2.7
CN2500900000000	25	009	Essex County, MA	2000	NA	369009	358867	10142	2.7
CN2501100000000	25	011	Franklin County, MA	2000	NA	38618	37669	949	2.5
CN2501300000000	25	013	Hampden County, MA	2000	NA	216891	209760	7131	3.3
CN2501500000000	25	015	Hampshire County, MA	2000	NA	85106	83255	1851	2.2
CN2501700000000	25	017	Middlesex County, MA	2000	NA	813222	795506	17716	2.2
CN2501900000000	25	019	Nantucket County/town, MA	2000	NA	7212	7107	105	1.5
CN2502100000000	25	021	Norfolk County, MA	2000	NA	353406	345263	8143	2.3
CN2502300000000	25	023	Plymouth County, MA	2000	NA	248719	242044	6675	2.7
CN2502500000000	25	025	Suffolk County, MA	2000	NA	347381	336913	10468	3
CN2502700000000	25	027	Worcester County, MA	2000	NA	383858	373382	10476	2.7
CN2600100000000	26	001	Alcona County, MI	2000	NA	4487	4174	313	7
CN2600300000000	26	003	Alger County, MI	2000	NA	4391	4150	241	5.5
CN2600500000000	26	005	Allegan County, MI	2000	NA	58011	56313	1698	2.9
CN2600700000000	26	007	Alpena County, MI	2000	NA	15598	14715	883	5.7
CN2600900000000	26	009	Antrim County, MI	2000	NA	11647	11098	549	4.7
CN2601100000000	26	011	Arenac County, MI	2000	NA	7683	7229	454	5.9
CN2601300000000	26	013	Baraga County, MI	2000	NA	4138	3862	276	6.7
CN2601500000000	26	015	Barry County, MI	2000	NA	30548	29510	1038	3.4
CN2601700000000	26	017	Bay County, MI	2000	NA	57036	54668	2368	4.2
CN2601900000000	26	019	Benzie County, MI	2000	NA	8420	8031	389	4.6
CN2602100000000	26	021	Berrien County, MI	2000	NA	82832	79633	3199	3.9
CN2602300000000	26	023	Branch County, MI	2000	NA	23502	22586	916	3.9
CN2602500000000	26	025	Calhoun County, MI	2000	NA	70635	67638	2997	4.2
CN2602700000000	26	027	Cass County, MI	2000	NA	27184	26303	881	3.2
CN2602900000000	26	029	Charlevoix County, MI	2000	NA	13867	13231	636	4.6
CN2603100000000	26	031	Cheboygan County, MI	2000	NA	13007	11922	1085	8.3
CN2603300000000	26	033	Chippewa County, MI	2000	NA	17529	16388	1141	6.5
CN2603500000000	26	035	Clare County, MI	2000	NA	13080	12355	725	5.5
CN2603700000000	26	037	Clinton County, MI	2000	NA	35681	34730	951	2.7
CN2603900000000	26	039	Crawford County, MI	2000	NA	6728	6410	318	4.7
CN2604100000000	26	041	Delta County, MI	2000	NA	19888	18810	1078	5.4
CN2604300000000	26	043	Dickinson County, MI	2000	NA	14051	13455	596	4.2
CN2604500000000	26	045	Eaton County, MI	2000	NA	57995	56329	1666	2.9
CN2604700000000	26	047	Emmet County, MI	2000	NA	18124	17107	1017	5.6
CN2604900000000	26	049	Genesee County, MI	2000	NA	215846	206051	9795	4.5
CN2605100000000	26	051	Gladwin County, MI	2000	NA	11006	10410	596	5.4
CN2605300000000	26	053	Gogebic County, MI	2000	NA	7758	7259	499	6.4
CN2605500000000	26	055	Grand Traverse County, MI	2000	NA	45707	44107	1600	3.5
CN2605700000000	26	057	Gratiot County, MI	2000	NA	19609	18697	912	4.7
CN2605900000000	26	059	Hillsdale County, MI	2000	NA	24256	23341	915	3.8
CN2606100000000	26	061	Houghton County, MI	2000	NA	17186	16325	861	5
CN2606300000000	26	063	Huron County, MI	2000	NA	17668	16842	826	4.7
CN2606500000000	26	065	Ingham County, MI	2000	NA	154743	150077	4666	3
CN2606700000000	26	067	Ionia County, MI	2000	NA	30120	28992	1128	3.7
CN2606900000000	26	069	Iosco County, MI	2000	NA	11661	10888	773	6.6
CN2607100000000	26	071	Iron County, MI	2000	NA	5684	5345	339	6
CN2607300000000	26	073	Isabella County, MI	2000	NA	34909	33725	1184	3.4
CN2607500000000	26	075	Jackson County, MI	2000	NA	79369	76596	2773	3.5
CN2607700000000	26	077	Kalamazoo County, MI	2000	NA	133298	129235	4063	3
CN2607900000000	26	079	Kalkaska County, MI	2000	NA	8580	8170	410	4.8
CN2608100000000	26	081	Kent County, MI	2000	NA	320150	310020	10130	3.2
CN2608300000000	26	083	Keweenaw County, MI	2000	NA	1054	987	67	6.4
CN2608500000000	26	085	Lake County, MI	2000	NA	4476	4215	261	5.8
CN2608700000000	26	087	Lapeer County, MI	2000	NA	46069	44252	1817	3.9
CN2608900000000	26	089	Leelanau County, MI	2000	NA	11358	11002	356	3.1
CN2609100000000	26	091	Lenawee County, MI	2000	NA	51888	49901	1987	3.8
CN2609300000000	26	093	Livingston County, MI	2000	NA	90099	87936	2163	2.4
CN2609500000000	26	095	Luce County, MI	2000	NA	2765	2594	171	6.2
CN2609700000000	26	097	Mackinac County, MI	2000	NA	6909	6375	534	7.7
CN2609900000000	26	099	Macomb County, MI	2000	NA	435533	421151	14382	3.3
CN2610100000000	26	101	Manistee County, MI	2000	NA	11877	11228	649	5.5
CN2610300000000	26	103	Marquette County, MI	2000	NA	34294	32766	1528	4.5
CN2610500000000	26	105	Mason County, MI	2000	NA	14786	14052	734	5
CN2610700000000	26	107	Mecosta County, MI	2000	NA	18987	18159	828	4.4
CN2610900000000	26	109	Menominee County, MI	2000	NA	13319	12752	567	4.3
CN2611100000000	26	111	Midland County, MI	2000	NA	42694	41272	1422	3.3
CN2611300000000	26	113	Missaukee County, MI	2000	NA	7025	6704	321	4.6
CN2611500000000	26	115	Monroe County, MI	2000	NA	77465	74954	2511	3.2
CN2611700000000	26	117	Montcalm County, MI	2000	NA	29514	28263	1251	4.2
CN2611900000000	26	119	Montmorency County, MI	2000	NA	4106	3766	340	8.3
CN2612100000000	26	121	Muskegon County, MI	2000	NA	85904	82305	3599	4.2
CN2612300000000	26	123	Newaygo County, MI	2000	NA	23132	22046	1086	4.7
CN2612500000000	26	125	Oakland County, MI	2000	NA	678896	661139	17757	2.6
CN2612700000000	26	127	Oceana County, MI	2000	NA	13272	12474	798	6
CN2612900000000	26	129	Ogemaw County, MI	2000	NA	9640	9105	535	5.5
CN2613100000000	26	131	Ontonagon County, MI	2000	NA	3665	3426	239	6.5
CN2613300000000	26	133	Osceola County, MI	2000	NA	11214	10694	520	4.6
CN2613500000000	26	135	Oscoda County, MI	2000	NA	3912	3667	245	6.3
CN2613700000000	26	137	Otsego County, MI	2000	NA	12394	11868	526	4.2
CN2613900000000	26	139	Ottawa County, MI	2000	NA	136514	132803	3711	2.7
CN2614100000000	26	141	Presque Isle County, MI	2000	NA	6532	5977	555	8.5
CN2614300000000	26	143	Roscommon County, MI	2000	NA	10422	9836	586	5.6
CN2614500000000	26	145	Saginaw County, MI	2000	NA	100589	96385	4204	4.2
CN2614700000000	26	147	St. Clair County, MI	2000	NA	87339	83977	3362	3.8
CN2614900000000	26	149	St. Joseph County, MI	2000	NA	32684	31557	1127	3.4
CN2615100000000	26	151	Sanilac County, MI	2000	NA	22018	20979	1039	4.7
CN2615300000000	26	153	Schoolcraft County, MI	2000	NA	3943	3616	327	8.3
CN2615500000000	26	155	Shiawassee County, MI	2000	NA	37531	36044	1487	4
CN2615700000000	26	157	Tuscola County, MI	2000	NA	28835	27487	1348	4.7
CN2615900000000	26	159	Van Buren County, MI	2000	NA	39775	38140	1635	4.1
CN2616100000000	26	161	Washtenaw County, MI	2000	NA	185811	181382	4429	2.4
CN2616300000000	26	163	Wayne County, MI	2000	NA	955276	917566	37710	3.9
CN2616500000000	26	165	Wexford County, MI	2000	NA	15654	14795	859	5.5
CN2700100000000	27	001	Aitkin County, MN	2000	NA	7200	6757	443	6.2
CN2700300000000	27	003	Anoka County, MN	2000	NA	179312	174416	4896	2.7
CN2700500000000	27	005	Becker County, MN	2000	NA	15652	14871	781	5
CN2700700000000	27	007	Beltrami County, MN	2000	NA	20356	19402	954	4.7
CN2700900000000	27	009	Benton County, MN	2000	NA	20607	19887	720	3.5
CN2701100000000	27	011	Big Stone County, MN	2000	NA	2782	2662	120	4.3
CN2701300000000	27	013	Blue Earth County, MN	2000	NA	33930	32975	955	2.8
CN2701500000000	27	015	Brown County, MN	2000	NA	15439	14855	584	3.8
CN2701700000000	27	017	Carlton County, MN	2000	NA	15905	15121	784	4.9
CN2701900000000	27	019	Carver County, MN	2000	NA	41076	40076	1000	2.4
CN2702100000000	27	021	Cass County, MN	2000	NA	13419	12682	737	5.5
CN2702300000000	27	023	Chippewa County, MN	2000	NA	7131	6773	358	5
CN2702500000000	27	025	Chisago County, MN	2000	NA	23250	22394	856	3.7
CN2702700000000	27	027	Clay County, MN	2000	NA	28082	27174	908	3.2
CN2702900000000	27	029	Clearwater County, MN	2000	NA	4210	3812	398	9.5
CN2703100000000	27	031	Cook County, MN	2000	NA	3139	3011	128	4.1
CN2703300000000	27	033	Cottonwood County, MN	2000	NA	6278	5976	302	4.8
CN2703500000000	27	035	Crow Wing County, MN	2000	NA	29129	27935	1194	4.1
CN2703700000000	27	037	Dakota County, MN	2000	NA	217183	211870	5313	2.4
CN2703900000000	27	039	Dodge County, MN	2000	NA	10238	9928	310	3
CN2704100000000	27	041	Douglas County, MN	2000	NA	18231	17620	611	3.4
CN2704300000000	27	043	Faribault County, MN	2000	NA	8622	8296	326	3.8
CN2704500000000	27	045	Fillmore County, MN	2000	NA	11760	11386	374	3.2
CN2704700000000	27	047	Freeborn County, MN	2000	NA	17452	16834	618	3.5
CN2704900000000	27	049	Goodhue County, MN	2000	NA	25165	24385	780	3.1
CN2705100000000	27	051	Grant County, MN	2000	NA	3301	3136	165	5
CN2705300000000	27	053	Hennepin County, MN	2000	NA	666621	648571	18050	2.7
CN2705500000000	27	055	Houston County, MN	2000	NA	10960	10513	447	4.1
CN2705700000000	27	057	Hubbard County, MN	2000	NA	9166	8710	456	5
CN2705900000000	27	059	Isanti County, MN	2000	NA	17944	17329	615	3.4
CN2706100000000	27	061	Itasca County, MN	2000	NA	21704	20444	1260	5.8
CN2706300000000	27	063	Jackson County, MN	2000	NA	6157	5964	193	3.1
CN2706500000000	27	065	Kanabec County, MN	2000	NA	7932	7550	382	4.8
CN2706700000000	27	067	Kandiyohi County, MN	2000	NA	22956	22206	750	3.3
CN2706900000000	27	069	Kittson County, MN	2000	NA	2584	2440	144	5.6
CN2707100000000	27	071	Koochiching County, MN	2000	NA	7263	6881	382	5.3
CN2707300000000	27	073	Lac qui Parle County, MN	2000	NA	4132	3989	143	3.5
CN2707500000000	27	075	Lake County, MN	2000	NA	5932	5680	252	4.2
CN2707700000000	27	077	Lake of the Woods County, MN	2000	NA	2352	2256	96	4.1
CN2707900000000	27	079	Le Sueur County, MN	2000	NA	14959	14380	579	3.9
CN2708100000000	27	081	Lincoln County, MN	2000	NA	3473	3345	128	3.7
CN2708300000000	27	083	Lyon County, MN	2000	NA	14683	14252	431	2.9
CN2708500000000	27	085	McLeod County, MN	2000	NA	20301	19628	673	3.3
CN2708700000000	27	087	Mahnomen County, MN	2000	NA	2479	2335	144	5.8
CN2708900000000	27	089	Marshall County, MN	2000	NA	5211	4796	415	8
CN2709100000000	27	091	Martin County, MN	2000	NA	11736	11321	415	3.5
CN2709300000000	27	093	Meeker County, MN	2000	NA	12343	11808	535	4.3
CN2709500000000	27	095	Mille Lacs County, MN	2000	NA	11885	11348	537	4.5
CN2709700000000	27	097	Morrison County, MN	2000	NA	16720	15936	784	4.7
CN2709900000000	27	099	Mower County, MN	2000	NA	19995	19409	586	2.9
CN2710100000000	27	101	Murray County, MN	2000	NA	5200	5001	199	3.8
CN2710300000000	27	103	Nicollet County, MN	2000	NA	18146	17647	499	2.7
CN2710500000000	27	105	Nobles County, MN	2000	NA	11117	10777	340	3.1
CN2710700000000	27	107	Norman County, MN	2000	NA	3731	3562	169	4.5
CN2710900000000	27	109	Olmsted County, MN	2000	NA	72757	70797	1960	2.7
CN2711100000000	27	111	Otter Tail County, MN	2000	NA	29381	28152	1229	4.2
CN2711300000000	27	113	Pennington County, MN	2000	NA	7692	7229	463	6
CN2711500000000	27	115	Pine County, MN	2000	NA	13456	12744	712	5.3
CN2711700000000	27	117	Pipestone County, MN	2000	NA	5421	5235	186	3.4
CN2711900000000	27	119	Polk County, MN	2000	NA	15846	15080	766	4.8
CN2712100000000	27	121	Pope County, MN	2000	NA	5879	5700	179	3
CN2712300000000	27	123	Ramsey County, MN	2000	NA	286658	278404	8254	2.9
CN2712500000000	27	125	Red Lake County, MN	2000	NA	2212	2047	165	7.5
CN2712700000000	27	127	Redwood County, MN	2000	NA	8915	8629	286	3.2
CN2712900000000	27	129	Renville County, MN	2000	NA	9182	8813	369	4
CN2713100000000	27	131	Rice County, MN	2000	NA	31616	30628	988	3.1
CN2713300000000	27	133	Rock County, MN	2000	NA	5250	5106	144	2.7
CN2713500000000	27	135	Roseau County, MN	2000	NA	9309	8967	342	3.7
CN2713700000000	27	137	St. Louis County, MN	2000	NA	103527	98964	4563	4.4
CN2713900000000	27	139	Scott County, MN	2000	NA	54351	52918	1433	2.6
CN2714100000000	27	141	Sherburne County, MN	2000	NA	37904	36748	1156	3
CN2714300000000	27	143	Sibley County, MN	2000	NA	8801	8512	289	3.3
CN2714500000000	27	145	Stearns County, MN	2000	NA	78375	75921	2454	3.1
CN2714700000000	27	147	Steele County, MN	2000	NA	19513	18943	570	2.9
CN2714900000000	27	149	Stevens County, MN	2000	NA	5706	5509	197	3.5
CN2715100000000	27	151	Swift County, MN	2000	NA	5683	5462	221	3.9
CN2715300000000	27	153	Todd County, MN	2000	NA	12395	11909	486	3.9
CN2715500000000	27	155	Traverse County, MN	2000	NA	1818	1730	88	4.8
CN2715700000000	27	157	Wabasha County, MN	2000	NA	12323	11961	362	2.9
CN2715900000000	27	159	Wadena County, MN	2000	NA	6697	6349	348	5.2
CN2716100000000	27	161	Waseca County, MN	2000	NA	10615	10294	321	3
CN2716300000000	27	163	Washington County, MN	2000	NA	118092	115159	2933	2.5
CN2716500000000	27	165	Watonwan County, MN	2000	NA	6059	5856	203	3.4
CN2716700000000	27	167	Wilkin County, MN	2000	NA	3698	3585	113	3.1
CN2716900000000	27	169	Winona County, MN	2000	NA	28956	28055	901	3.1
CN2717100000000	27	171	Wright County, MN	2000	NA	52598	50909	1689	3.2
CN2717300000000	27	173	Yellow Medicine County, MN	2000	NA	5738	5493	245	4.3
CN2800100000000	28	001	Adams County, MS	2000	NA	14574	13663	911	6.3
CN2800300000000	28	003	Alcorn County, MS	2000	NA	16751	15938	813	4.9
CN2800500000000	28	005	Amite County, MS	2000	NA	5569	5274	295	5.3
CN2800700000000	28	007	Attala County, MS	2000	NA	8377	7786	591	7.1
CN2800900000000	28	009	Benton County, MS	2000	NA	3214	3006	208	6.5
CN2801100000000	28	011	Bolivar County, MS	2000	NA	16316	15149	1167	7.2
CN2801300000000	28	013	Calhoun County, MS	2000	NA	6963	6568	395	5.7
CN2801500000000	28	015	Carroll County, MS	2000	NA	5051	4764	287	5.7
CN2801700000000	28	017	Chickasaw County, MS	2000	NA	8826	8355	471	5.3
CN2801900000000	28	019	Choctaw County, MS	2000	NA	4050	3748	302	7.5
CN2802100000000	28	021	Claiborne County, MS	2000	NA	4298	3909	389	9.1
CN2802300000000	28	023	Clarke County, MS	2000	NA	7653	7027	626	8.2
CN2802500000000	28	025	Clay County, MS	2000	NA	9804	9203	601	6.1
CN2802700000000	28	027	Coahoma County, MS	2000	NA	11819	10915	904	7.6
CN2802900000000	28	029	Copiah County, MS	2000	NA	12296	11535	761	6.2
CN2803100000000	28	031	Covington County, MS	2000	NA	8438	7975	463	5.5
CN2803300000000	28	033	DeSoto County, MS	2000	NA	59225	57810	1415	2.4
CN2803500000000	28	035	Forrest County, MS	2000	NA	35256	33562	1694	4.8
CN2803700000000	28	037	Franklin County, MS	2000	NA	3459	3234	225	6.5
CN2803900000000	28	039	George County, MS	2000	NA	8429	7793	636	7.5
CN2804100000000	28	041	Greene County, MS	2000	NA	4810	4402	408	8.5
CN2804300000000	28	043	Grenada County, MS	2000	NA	10589	10006	583	5.5
CN2804500000000	28	045	Hancock County, MS	2000	NA	19599	18691	908	4.6
CN2804700000000	28	047	Harrison County, MS	2000	NA	91244	87056	4188	4.6
CN2804900000000	28	049	Hinds County, MS	2000	NA	122940	116785	6155	5
CN2805100000000	28	051	Holmes County, MS	2000	NA	7626	6627	999	13.1
CN2805300000000	28	053	Humphreys County, MS	2000	NA	4263	3866	397	9.3
CN2805500000000	28	055	Issaquena County, MS	2000	NA	850	764	86	10.1
CN2805700000000	28	057	Itawamba County, MS	2000	NA	11174	10591	583	5.2
CN2805900000000	28	059	Jackson County, MS	2000	NA	63739	60106	3633	5.7
CN2806100000000	28	061	Jasper County, MS	2000	NA	7470	7037	433	5.8
CN2806300000000	28	063	Jefferson County, MS	2000	NA	3180	2800	380	11.9
CN2806500000000	28	065	Jefferson Davis County, MS	2000	NA	5455	4923	532	9.8
CN2806700000000	28	067	Jones County, MS	2000	NA	30061	28739	1322	4.4
CN2806900000000	28	069	Kemper County, MS	2000	NA	4419	4055	364	8.2
CN2807100000000	28	071	Lafayette County, MS	2000	NA	19834	18976	858	4.3
CN2807300000000	28	073	Lamar County, MS	2000	NA	20116	19320	796	4
CN2807500000000	28	075	Lauderdale County, MS	2000	NA	34698	32743	1955	5.6
CN2807700000000	28	077	Lawrence County, MS	2000	NA	5948	5494	454	7.6
CN2807900000000	28	079	Leake County, MS	2000	NA	8937	8378	559	6.3
CN2808100000000	28	081	Lee County, MS	2000	NA	40018	38265	1753	4.4
CN2808300000000	28	083	Leflore County, MS	2000	NA	14659	13372	1287	8.8
CN2808500000000	28	085	Lincoln County, MS	2000	NA	14776	13981	795	5.4
CN2808700000000	28	087	Lowndes County, MS	2000	NA	27766	26231	1535	5.5
CN2808900000000	28	089	Madison County, MS	2000	NA	39495	37869	1626	4.1
CN2809100000000	28	091	Marion County, MS	2000	NA	10680	10046	634	5.9
CN2809300000000	28	093	Marshall County, MS	2000	NA	15329	14692	637	4.2
CN2809500000000	28	095	Monroe County, MS	2000	NA	17766	16523	1243	7
CN2809700000000	28	097	Montgomery County, MS	2000	NA	5355	5020	335	6.3
CN2809900000000	28	099	Neshoba County, MS	2000	NA	13408	12698	710	5.3
CN2810100000000	28	101	Newton County, MS	2000	NA	9885	9339	546	5.5
CN2810300000000	28	103	Noxubee County, MS	2000	NA	4741	4322	419	8.8
CN2810500000000	28	105	Oktibbeha County, MS	2000	NA	20815	19760	1055	5.1
CN2810700000000	28	107	Panola County, MS	2000	NA	14786	13760	1026	6.9
CN2810900000000	28	109	Pearl River County, MS	2000	NA	21343	20275	1068	5
CN2811100000000	28	111	Perry County, MS	2000	NA	5211	4893	318	6.1
CN2811300000000	28	113	Pike County, MS	2000	NA	16143	15128	1015	6.3
CN2811500000000	28	115	Pontotoc County, MS	2000	NA	13723	13105	618	4.5
CN2811700000000	28	117	Prentiss County, MS	2000	NA	12329	11704	625	5.1
CN2811900000000	28	119	Quitman County, MS	2000	NA	4045	3754	291	7.2
CN2812100000000	28	121	Rankin County, MS	2000	NA	63636	61377	2259	3.5
CN2812300000000	28	123	Scott County, MS	2000	NA	12790	12195	595	4.7
CN2812500000000	28	125	Sharkey County, MS	2000	NA	2650	2390	260	9.8
CN2812700000000	28	127	Simpson County, MS	2000	NA	11907	11336	571	4.8
CN2812900000000	28	129	Smith County, MS	2000	NA	7366	7019	347	4.7
CN2813100000000	28	131	Stone County, MS	2000	NA	6600	6236	364	5.5
CN2813300000000	28	133	Sunflower County, MS	2000	NA	12162	11087	1075	8.8
CN2813500000000	28	135	Tallahatchie County, MS	2000	NA	6056	5565	491	8.1
CN2813700000000	28	137	Tate County, MS	2000	NA	11765	11341	424	3.6
CN2813900000000	28	139	Tippah County, MS	2000	NA	9847	9296	551	5.6
CN2814100000000	28	141	Tishomingo County, MS	2000	NA	8971	8345	626	7
CN2814300000000	28	143	Tunica County, MS	2000	NA	4053	3850	203	5
CN2814500000000	28	145	Union County, MS	2000	NA	12577	12024	553	4.4
CN2814700000000	28	147	Walthall County, MS	2000	NA	6342	5915	427	6.7
CN2814900000000	28	149	Warren County, MS	2000	NA	24454	23233	1221	5
CN2815100000000	28	151	Washington County, MS	2000	NA	26135	24136	1999	7.6
CN2815300000000	28	153	Wayne County, MS	2000	NA	8859	8293	566	6.4
CN2815500000000	28	155	Webster County, MS	2000	NA	4714	4483	231	4.9
CN2815700000000	28	157	Wilkinson County, MS	2000	NA	3536	3239	297	8.4
CN2815900000000	28	159	Winston County, MS	2000	NA	8718	8130	588	6.7
CN2816100000000	28	161	Yalobusha County, MS	2000	NA	5766	5433	333	5.8
CN2816300000000	28	163	Yazoo County, MS	2000	NA	10768	10004	764	7.1
CN2900100000000	29	001	Adair County, MO	2000	NA	13682	13257	425	3.1
CN2900300000000	29	003	Andrew County, MO	2000	NA	8818	8534	284	3.2
CN2900500000000	29	005	Atchison County, MO	2000	NA	3455	3361	94	2.7
CN2900700000000	29	007	Audrain County, MO	2000	NA	13110	12688	422	3.2
CN2900900000000	29	009	Barry County, MO	2000	NA	17211	16609	602	3.5
CN2901100000000	29	011	Barton County, MO	2000	NA	6720	6529	191	2.8
CN2901300000000	29	013	Bates County, MO	2000	NA	8139	7826	313	3.8
CN2901500000000	29	015	Benton County, MO	2000	NA	7732	7309	423	5.5
CN2901700000000	29	017	Bollinger County, MO	2000	NA	6222	5951	271	4.4
CN2901900000000	29	019	Boone County, MO	2000	NA	78731	76887	1844	2.3
CN2902100000000	29	021	Buchanan County, MO	2000	NA	42347	40774	1573	3.7
CN2902300000000	29	023	Butler County, MO	2000	NA	19794	18824	970	4.9
CN2902500000000	29	025	Caldwell County, MO	2000	NA	4449	4294	155	3.5
CN2902700000000	29	027	Callaway County, MO	2000	NA	21758	21106	652	3
CN2902900000000	29	029	Camden County, MO	2000	NA	19765	18924	841	4.3
CN2903100000000	29	031	Cape Girardeau County, MO	2000	NA	40092	38848	1244	3.1
CN2903300000000	29	033	Carroll County, MO	2000	NA	5200	5022	178	3.4
CN2903500000000	29	035	Carter County, MO	2000	NA	2619	2468	151	5.8
CN2903700000000	29	037	Cass County, MO	2000	NA	44777	43479	1298	2.9
CN2903900000000	29	039	Cedar County, MO	2000	NA	6091	5858	233	3.8
CN2904100000000	29	041	Chariton County, MO	2000	NA	4473	4301	172	3.8
CN2904300000000	29	043	Christian County, MO	2000	NA	30599	29688	911	3
CN2904500000000	29	045	Clark County, MO	2000	NA	3808	3662	146	3.8
CN2904700000000	29	047	Clay County, MO	2000	NA	106765	104031	2734	2.6
CN2904900000000	29	049	Clinton County, MO	2000	NA	9941	9631	310	3.1
CN2905100000000	29	051	Cole County, MO	2000	NA	39625	38542	1083	2.7
CN2905300000000	29	053	Cooper County, MO	2000	NA	8329	8048	281	3.4
CN2905500000000	29	055	Crawford County, MO	2000	NA	11359	10839	520	4.6
CN2905700000000	29	057	Dade County, MO	2000	NA	3865	3724	141	3.6
CN2905900000000	29	059	Dallas County, MO	2000	NA	7170	6836	334	4.7
CN2906100000000	29	061	Daviess County, MO	2000	NA	4027	3893	134	3.3
CN2906300000000	29	063	DeKalb County, MO	2000	NA	4949	4748	201	4.1
CN2906500000000	29	065	Dent County, MO	2000	NA	7062	6711	351	5
CN2906700000000	29	067	Douglas County, MO	2000	NA	6250	5956	294	4.7
CN2906900000000	29	069	Dunklin County, MO	2000	NA	15121	14412	709	4.7
CN2907100000000	29	071	Franklin County, MO	2000	NA	50952	49037	1915	3.8
CN2907300000000	29	073	Gasconade County, MO	2000	NA	8039	7752	287	3.6
CN2907500000000	29	075	Gentry County, MO	2000	NA	3423	3311	112	3.3
CN2907700000000	29	077	Greene County, MO	2000	NA	131978	128058	3920	3
CN2907900000000	29	079	Grundy County, MO	2000	NA	5379	5199	180	3.3
CN2908100000000	29	081	Harrison County, MO	2000	NA	4638	4488	150	3.2
CN2908300000000	29	083	Henry County, MO	2000	NA	11352	10927	425	3.7
CN2908500000000	29	085	Hickory County, MO	2000	NA	3417	3203	214	6.3
CN2908700000000	29	087	Holt County, MO	2000	NA	2800	2710	90	3.2
CN2908900000000	29	089	Howard County, MO	2000	NA	5358	5189	169	3.2
CN2909100000000	29	091	Howell County, MO	2000	NA	18669	17938	731	3.9
CN2909300000000	29	093	Iron County, MO	2000	NA	4937	4653	284	5.8
CN2909500000000	29	095	Jackson County, MO	2000	NA	346703	333861	12842	3.7
CN2909700000000	29	097	Jasper County, MO	2000	NA	53949	52081	1868	3.5
CN2909900000000	29	099	Jefferson County, MO	2000	NA	110127	106436	3691	3.4
CN2910100000000	29	101	Johnson County, MO	2000	NA	24755	23929	826	3.3
CN2910300000000	29	103	Knox County, MO	2000	NA	2187	2107	80	3.7
CN2910500000000	29	105	Laclede County, MO	2000	NA	17009	16358	651	3.8
CN2910700000000	29	107	Lafayette County, MO	2000	NA	17486	16898	588	3.4
CN2910900000000	29	109	Lawrence County, MO	2000	NA	18364	17749	615	3.3
CN2911100000000	29	111	Lewis County, MO	2000	NA	5660	5463	197	3.5
CN2911300000000	29	113	Lincoln County, MO	2000	NA	20638	19920	718	3.5
CN2911500000000	29	115	Linn County, MO	2000	NA	7217	6834	383	5.3
CN2911700000000	29	117	Livingston County, MO	2000	NA	7548	7331	217	2.9
CN2911900000000	29	119	McDonald County, MO	2000	NA	10660	10261	399	3.7
CN2912100000000	29	121	Macon County, MO	2000	NA	8587	8213	374	4.4
CN2912300000000	29	123	Madison County, MO	2000	NA	5601	5318	283	5.1
CN2912500000000	29	125	Maries County, MO	2000	NA	4686	4507	179	3.8
CN2912700000000	29	127	Marion County, MO	2000	NA	15019	14416	603	4
CN2912900000000	29	129	Mercer County, MO	2000	NA	1974	1914	60	3
CN2913100000000	29	131	Miller County, MO	2000	NA	12777	12197	580	4.5
CN2913300000000	29	133	Mississippi County, MO	2000	NA	6209	5873	336	5.4
CN2913500000000	29	135	Moniteau County, MO	2000	NA	7441	7200	241	3.2
CN2913700000000	29	137	Monroe County, MO	2000	NA	4899	4706	193	3.9
CN2913900000000	29	139	Montgomery County, MO	2000	NA	6362	6135	227	3.6
CN2914100000000	29	141	Morgan County, MO	2000	NA	9563	9153	410	4.3
CN2914300000000	29	143	New Madrid County, MO	2000	NA	9486	9009	477	5
CN2914500000000	29	145	Newton County, MO	2000	NA	27535	26436	1099	4
CN2914700000000	29	147	Nodaway County, MO	2000	NA	12349	12049	300	2.4
CN2914900000000	29	149	Oregon County, MO	2000	NA	4463	4281	182	4.1
CN2915100000000	29	151	Osage County, MO	2000	NA	7362	7067	295	4
CN2915300000000	29	153	Ozark County, MO	2000	NA	4433	4236	197	4.4
CN2915500000000	29	155	Pemiscot County, MO	2000	NA	8424	7932	492	5.8
CN2915700000000	29	157	Perry County, MO	2000	NA	10308	10028	280	2.7
CN2915900000000	29	159	Pettis County, MO	2000	NA	21206	20463	743	3.5
CN2916100000000	29	161	Phelps County, MO	2000	NA	20170	19447	723	3.6
CN2916300000000	29	163	Pike County, MO	2000	NA	8821	8494	327	3.7
CN2916500000000	29	165	Platte County, MO	2000	NA	44875	43810	1065	2.4
CN2916700000000	29	167	Polk County, MO	2000	NA	13079	12656	423	3.2
CN2916900000000	29	169	Pulaski County, MO	2000	NA	15371	14585	786	5.1
CN2917100000000	29	171	Putnam County, MO	2000	NA	2507	2420	87	3.5
CN2917300000000	29	173	Ralls County, MO	2000	NA	5707	5493	214	3.7
CN2917500000000	29	175	Randolph County, MO	2000	NA	12327	11839	488	4
CN2917700000000	29	177	Ray County, MO	2000	NA	12054	11599	455	3.8
CN2917900000000	29	179	Reynolds County, MO	2000	NA	2805	2597	208	7.4
CN2918100000000	29	181	Ripley County, MO	2000	NA	5819	5514	305	5.2
CN2918300000000	29	183	St. Charles County, MO	2000	NA	165907	161544	4363	2.6
CN2918500000000	29	185	St. Clair County, MO	2000	NA	4455	4272	183	4.1
CN2918600000000	29	186	Ste. Genevieve County, MO	2000	NA	9626	9303	323	3.4
CN2918700000000	29	187	St. Francois County, MO	2000	NA	25992	24486	1506	5.8
CN2918900000000	29	189	St. Louis County, MO	2000	NA	554013	536744	17269	3.1
CN2919500000000	29	195	Saline County, MO	2000	NA	12869	12480	389	3
CN2919700000000	29	197	Schuyler County, MO	2000	NA	2217	2117	100	4.5
CN2919900000000	29	199	Scotland County, MO	2000	NA	2623	2543	80	3
CN2920100000000	29	201	Scott County, MO	2000	NA	21035	20086	949	4.5
CN2920300000000	29	203	Shannon County, MO	2000	NA	3891	3673	218	5.6
CN2920500000000	29	205	Shelby County, MO	2000	NA	3728	3548	180	4.8
CN2920700000000	29	207	Stoddard County, MO	2000	NA	15092	14430	662	4.4
CN2920900000000	29	209	Stone County, MO	2000	NA	14888	13938	950	6.4
CN2921100000000	29	211	Sullivan County, MO	2000	NA	3766	3647	119	3.2
CN2921300000000	29	213	Taney County, MO	2000	NA	23894	22254	1640	6.9
CN2921500000000	29	215	Texas County, MO	2000	NA	10857	10290	567	5.2
CN2921700000000	29	217	Vernon County, MO	2000	NA	10544	10230	314	3
CN2921900000000	29	219	Warren County, MO	2000	NA	13506	13039	467	3.5
CN2922100000000	29	221	Washington County, MO	2000	NA	9910	9300	610	6.2
CN2922300000000	29	223	Wayne County, MO	2000	NA	5498	5190	308	5.6
CN2922500000000	29	225	Webster County, MO	2000	NA	15107	14560	547	3.6
CN2922700000000	29	227	Worth County, MO	2000	NA	1212	1166	46	3.8
CN2922900000000	29	229	Wright County, MO	2000	NA	8408	8017	391	4.7
CN2951000000000	29	510	St. Louis city, MO	2000	NA	161391	152189	9202	5.7
CN3000100000000	30	001	Beaverhead County, MT	2000	NA	5011	4797	214	4.3
CN3000300000000	30	003	Big Horn County, MT	2000	NA	5437	4906	531	9.8
CN3000500000000	30	005	Blaine County, MT	2000	NA	2968	2800	168	5.7
CN3000700000000	30	007	Broadwater County, MT	2000	NA	2230	2126	104	4.7
CN3000900000000	30	009	Carbon County, MT	2000	NA	4975	4747	228	4.6
CN3001100000000	30	011	Carter County, MT	2000	NA	773	744	29	3.8
CN3001300000000	30	013	Cascade County, MT	2000	NA	38200	36240	1960	5.1
CN3001500000000	30	015	Chouteau County, MT	2000	NA	2796	2687	109	3.9
CN3001700000000	30	017	Custer County, MT	2000	NA	5970	5689	281	4.7
CN3001900000000	30	019	Daniels County, MT	2000	NA	972	925	47	4.8
CN3002100000000	30	021	Dawson County, MT	2000	NA	4752	4552	200	4.2
CN3002300000000	30	023	Deer Lodge County, MT	2000	NA	4240	3926	314	7.4
CN3002500000000	30	025	Fallon County, MT	2000	NA	1542	1483	59	3.8
CN3002700000000	30	027	Fergus County, MT	2000	NA	6105	5773	332	5.4
CN3002900000000	30	029	Flathead County, MT	2000	NA	39210	37069	2141	5.5
CN3003100000000	30	031	Gallatin County, MT	2000	NA	41448	39902	1546	3.7
CN3003300000000	30	033	Garfield County, MT	2000	NA	705	674	31	4.4
CN3003500000000	30	035	Glacier County, MT	2000	NA	5707	5228	479	8.4
CN3003700000000	30	037	Golden Valley County, MT	2000	NA	545	515	30	5.5
CN3003900000000	30	039	Granite County, MT	2000	NA	1351	1264	87	6.4
CN3004100000000	30	041	Hill County, MT	2000	NA	7979	7574	405	5.1
CN3004300000000	30	043	Jefferson County, MT	2000	NA	5357	5095	262	4.9
CN3004500000000	30	045	Judith Basin County, MT	2000	NA	1179	1123	56	4.7
CN3004700000000	30	047	Lake County, MT	2000	NA	12289	11587	702	5.7
CN3004900000000	30	049	Lewis and Clark County, MT	2000	NA	31097	29801	1296	4.2
CN3005100000000	30	051	Liberty County, MT	2000	NA	960	918	42	4.4
CN3005300000000	30	053	Lincoln County, MT	2000	NA	7875	7192	683	8.7
CN3005500000000	30	055	McCone County, MT	2000	NA	1099	1057	42	3.8
CN3005700000000	30	057	Madison County, MT	2000	NA	3346	3173	173	5.2
CN3005900000000	30	059	Meagher County, MT	2000	NA	990	930	60	6.1
CN3006100000000	30	061	Mineral County, MT	2000	NA	1884	1758	126	6.7
CN3006300000000	30	063	Missoula County, MT	2000	NA	54007	51755	2252	4.2
CN3006500000000	30	065	Musselshell County, MT	2000	NA	2090	1958	132	6.3
CN3006700000000	30	067	Park County, MT	2000	NA	9023	8544	479	5.3
CN3006900000000	30	069	Petroleum County, MT	2000	NA	251	234	17	6.8
CN3007100000000	30	071	Phillips County, MT	2000	NA	2317	2209	108	4.7
CN3007300000000	30	073	Pondera County, MT	2000	NA	2972	2825	147	4.9
CN3007500000000	30	075	Powder River County, MT	2000	NA	999	959	40	4
CN3007700000000	30	077	Powell County, MT	2000	NA	2878	2705	173	6
CN3007900000000	30	079	Prairie County, MT	2000	NA	615	582	33	5.4
CN3008100000000	30	081	Ravalli County, MT	2000	NA	17050	16108	942	5.5
CN3008300000000	30	083	Richland County, MT	2000	NA	4963	4691	272	5.5
CN3008500000000	30	085	Roosevelt County, MT	2000	NA	4253	3942	311	7.3
CN3008700000000	30	087	Rosebud County, MT	2000	NA	4266	4007	259	6.1
CN3008900000000	30	089	Sanders County, MT	2000	NA	4398	4083	315	7.2
CN3009100000000	30	091	Sheridan County, MT	2000	NA	2014	1918	96	4.8
CN3009300000000	30	093	Silver Bow County, MT	2000	NA	17143	16114	1029	6
CN3009500000000	30	095	Stillwater County, MT	2000	NA	4408	4201	207	4.7
CN3009700000000	30	097	Sweet Grass County, MT	2000	NA	1984	1918	66	3.3
CN3009900000000	30	099	Teton County, MT	2000	NA	2970	2835	135	4.5
CN3010100000000	30	101	Toole County, MT	2000	NA	2519	2412	107	4.2
CN3010300000000	30	103	Treasure County, MT	2000	NA	456	434	22	4.8
CN3010500000000	30	105	Valley County, MT	2000	NA	3838	3661	177	4.6
CN3010700000000	30	107	Wheatland County, MT	2000	NA	1120	1064	56	5
CN3010900000000	30	109	Wibaux County, MT	2000	NA	549	524	25	4.6
CN3011100000000	30	111	Yellowstone County, MT	2000	NA	71223	68198	3025	4.2
CN3100100000000	31	001	Adams County, NE	2000	NA	17249	16804	445	2.6
CN3100300000000	31	003	Antelope County, NE	2000	NA	3980	3869	111	2.8
CN3100500000000	31	005	Arthur County, NE	2000	NA	272	266	6	2.2
CN3100700000000	31	007	Banner County, NE	2000	NA	428	415	13	3
CN3100900000000	31	009	Blaine County, NE	2000	NA	319	308	11	3.4
CN3101100000000	31	011	Boone County, NE	2000	NA	3228	3148	80	2.5
CN3101300000000	31	013	Box Butte County, NE	2000	NA	6422	6170	252	3.9
CN3101500000000	31	015	Boyd County, NE	2000	NA	1255	1218	37	2.9
CN3101700000000	31	017	Brown County, NE	2000	NA	1920	1857	63	3.3
CN3101900000000	31	019	Buffalo County, NE	2000	NA	24905	24331	574	2.3
CN3102100000000	31	021	Burt County, NE	2000	NA	4130	3977	153	3.7
CN3102300000000	31	023	Butler County, NE	2000	NA	4702	4569	133	2.8
CN3102500000000	31	025	Cass County, NE	2000	NA	13555	13177	378	2.8
CN3102700000000	31	027	Cedar County, NE	2000	NA	5040	4915	125	2.5
CN3102900000000	31	029	Chase County, NE	2000	NA	2117	2067	50	2.4
CN3103100000000	31	031	Cherry County, NE	2000	NA	3523	3433	90	2.6
CN3103300000000	31	033	Cheyenne County, NE	2000	NA	5655	5524	131	2.3
CN3103500000000	31	035	Clay County, NE	2000	NA	3641	3535	106	2.9
CN3103700000000	31	037	Colfax County, NE	2000	NA	5683	5561	122	2.1
CN3103900000000	31	039	Cuming County, NE	2000	NA	5679	5550	129	2.3
CN3104100000000	31	041	Custer County, NE	2000	NA	6194	6036	158	2.6
CN3104300000000	31	043	Dakota County, NE	2000	NA	10860	10508	352	3.2
CN3104500000000	31	045	Dawes County, NE	2000	NA	5062	4909	153	3
CN3104700000000	31	047	Dawson County, NE	2000	NA	12340	11962	378	3.1
CN3104900000000	31	049	Deuel County, NE	2000	NA	1175	1140	35	3
CN3105100000000	31	051	Dixon County, NE	2000	NA	3342	3256	86	2.6
CN3105300000000	31	053	Dodge County, NE	2000	NA	19768	19151	617	3.1
CN3105500000000	31	055	Douglas County, NE	2000	NA	258571	250752	7819	3
CN3105700000000	31	057	Dundy County, NE	2000	NA	1209	1182	27	2.2
CN3105900000000	31	059	Fillmore County, NE	2000	NA	3517	3425	92	2.6
CN3106100000000	31	061	Franklin County, NE	2000	NA	1814	1765	49	2.7
CN3106300000000	31	063	Frontier County, NE	2000	NA	1743	1700	43	2.5
CN3106500000000	31	065	Furnas County, NE	2000	NA	2641	2567	74	2.8
CN3106700000000	31	067	Gage County, NE	2000	NA	12622	12239	383	3
CN3106900000000	31	069	Garden County, NE	2000	NA	1217	1185	32	2.6
CN3107100000000	31	071	Garfield County, NE	2000	NA	1017	991	26	2.6
CN3107300000000	31	073	Gosper County, NE	2000	NA	1142	1112	30	2.6
CN3107500000000	31	075	Grant County, NE	2000	NA	439	429	10	2.3
CN3107700000000	31	077	Greeley County, NE	2000	NA	1404	1363	41	2.9
CN3107900000000	31	079	Hall County, NE	2000	NA	28887	28034	853	3
CN3108100000000	31	081	Hamilton County, NE	2000	NA	5136	5015	121	2.4
CN3108300000000	31	083	Harlan County, NE	2000	NA	1923	1873	50	2.6
CN3108500000000	31	085	Hayes County, NE	2000	NA	585	565	20	3.4
CN3108700000000	31	087	Hitchcock County, NE	2000	NA	1540	1499	41	2.7
CN3108900000000	31	089	Holt County, NE	2000	NA	6262	6097	165	2.6
CN3109100000000	31	091	Hooker County, NE	2000	NA	451	436	15	3.3
CN3109300000000	31	093	Howard County, NE	2000	NA	3555	3463	92	2.6
CN3109500000000	31	095	Jefferson County, NE	2000	NA	4373	4233	140	3.2
CN3109700000000	31	097	Johnson County, NE	2000	NA	2506	2351	155	6.2
CN3109900000000	31	099	Kearney County, NE	2000	NA	3741	3664	77	2.1
CN3110100000000	31	101	Keith County, NE	2000	NA	4875	4742	133	2.7
CN3110300000000	31	103	Keya Paha County, NE	2000	NA	499	487	12	2.4
CN3110500000000	31	105	Kimball County, NE	2000	NA	2198	2144	54	2.5
CN3110700000000	31	107	Knox County, NE	2000	NA	4814	4632	182	3.8
CN3110900000000	31	109	Lancaster County, NE	2000	NA	148280	144779	3501	2.4
CN3111100000000	31	111	Lincoln County, NE	2000	NA	18390	17803	587	3.2
CN3111300000000	31	113	Logan County, NE	2000	NA	418	408	10	2.4
CN3111500000000	31	115	Loup County, NE	2000	NA	335	327	8	2.4
CN3111700000000	31	117	McPherson County, NE	2000	NA	273	268	5	1.8
CN3111900000000	31	119	Madison County, NE	2000	NA	19275	18644	631	3.3
CN3112100000000	31	121	Merrick County, NE	2000	NA	4287	4172	115	2.7
CN3112300000000	31	123	Morrill County, NE	2000	NA	2798	2701	97	3.5
CN3112500000000	31	125	Nance County, NE	2000	NA	2063	2001	62	3
CN3112700000000	31	127	Nemaha County, NE	2000	NA	3775	3624	151	4
CN3112900000000	31	129	Nuckolls County, NE	2000	NA	2579	2511	68	2.6
CN3113100000000	31	131	Otoe County, NE	2000	NA	8324	8062	262	3.1
CN3113300000000	31	133	Pawnee County, NE	2000	NA	1638	1580	58	3.5
CN3113500000000	31	135	Perkins County, NE	2000	NA	1646	1609	37	2.2
CN3113700000000	31	137	Phelps County, NE	2000	NA	5368	5249	119	2.2
CN3113900000000	31	139	Pierce County, NE	2000	NA	4216	4106	110	2.6
CN3114100000000	31	141	Platte County, NE	2000	NA	17469	16984	485	2.8
CN3114300000000	31	143	Polk County, NE	2000	NA	3039	2970	69	2.3
CN3114500000000	31	145	Red Willow County, NE	2000	NA	6187	6025	162	2.6
CN3114700000000	31	147	Richardson County, NE	2000	NA	4726	4488	238	5
CN3114900000000	31	149	Rock County, NE	2000	NA	1013	985	28	2.8
CN3115100000000	31	151	Saline County, NE	2000	NA	7635	7436	199	2.6
CN3115300000000	31	153	Sarpy County, NE	2000	NA	65950	64442	1508	2.3
CN3115500000000	31	155	Saunders County, NE	2000	NA	11066	10753	313	2.8
CN3115700000000	31	157	Scotts Bluff County, NE	2000	NA	18775	18019	756	4
CN3115900000000	31	159	Seward County, NE	2000	NA	9191	8975	216	2.4
CN3116100000000	31	161	Sheridan County, NE	2000	NA	3295	3198	97	2.9
CN3116300000000	31	163	Sherman County, NE	2000	NA	1783	1733	50	2.8
CN3116500000000	31	165	Sioux County, NE	2000	NA	802	787	15	1.9
CN3116700000000	31	167	Stanton County, NE	2000	NA	3533	3442	91	2.6
CN3116900000000	31	169	Thayer County, NE	2000	NA	3162	3081	81	2.6
CN3117100000000	31	171	Thomas County, NE	2000	NA	416	395	21	5
CN3117300000000	31	173	Thurston County, NE	2000	NA	2840	2642	198	7
CN3117500000000	31	175	Valley County, NE	2000	NA	2426	2361	65	2.7
CN3117700000000	31	177	Washington County, NE	2000	NA	10879	10615	264	2.4
CN3117900000000	31	179	Wayne County, NE	2000	NA	5703	5556	147	2.6
CN3118100000000	31	181	Webster County, NE	2000	NA	1963	1909	54	2.8
CN3118300000000	31	183	Wheeler County, NE	2000	NA	499	487	12	2.4
CN3118500000000	31	185	York County, NE	2000	NA	7844	7649	195	2.5
CN3200100000000	32	001	Churchill County, NV	2000	NA	12018	11318	700	5.8
CN3200300000000	32	003	Clark County, NV	2000	NA	730308	698877	31431	4.3
CN3200500000000	32	005	Douglas County, NV	2000	NA	21804	20968	836	3.8
CN3200700000000	32	007	Elko County, NV	2000	NA	24312	23422	890	3.7
CN3200900000000	32	009	Esmeralda County, NV	2000	NA	511	470	41	8
CN3201100000000	32	011	Eureka County, NV	2000	NA	797	773	24	3
CN3201300000000	32	013	Humboldt County, NV	2000	NA	7821	7463	358	4.6
CN3201500000000	32	015	Lander County, NV	2000	NA	2859	2704	155	5.4
CN3201700000000	32	017	Lincoln County, NV	2000	NA	1661	1584	77	4.6
CN3201900000000	32	019	Lyon County, NV	2000	NA	17975	16998	977	5.4
CN3202100000000	32	021	Mineral County, NV	2000	NA	2355	2173	182	7.7
CN3202300000000	32	023	Nye County, NV	2000	NA	14093	13196	897	6.4
CN3202700000000	32	027	Pershing County, NV	2000	NA	2564	2458	106	4.1
CN3202900000000	32	029	Storey County, NV	2000	NA	2004	1944	60	3
CN3203100000000	32	031	Washoe County, NV	2000	NA	195569	188813	6756	3.5
CN3203300000000	32	033	White Pine County, NV	2000	NA	3784	3637	147	3.9
CN3251000000000	32	510	Carson City, NV	2000	NA	26590	25665	925	3.5
CN3300100000000	33	001	Belknap County, NH	2000	NA	30953	30197	756	2.4
CN3300300000000	33	003	Carroll County, NH	2000	NA	23642	23010	632	2.7
CN3300500000000	33	005	Cheshire County, NH	2000	NA	39905	38861	1044	2.6
CN3300700000000	33	007	Coos County, NH	2000	NA	17134	16512	622	3.6
CN3300900000000	33	009	Grafton County, NH	2000	NA	44855	43799	1056	2.4
CN3301100000000	33	011	Hillsborough County, NH	2000	NA	212572	207152	5420	2.5
CN3301300000000	33	013	Merrimack County, NH	2000	NA	74785	73010	1775	2.4
CN3301500000000	33	015	Rockingham County, NH	2000	NA	160555	155772	4783	3
CN3301700000000	33	017	Strafford County, NH	2000	NA	61812	60154	1658	2.7
CN3301900000000	33	019	Sullivan County, NH	2000	NA	21692	21155	537	2.5
CN3400100000000	34	001	Atlantic County, NJ	2000	NA	128823	122783	6040	4.7
CN3400300000000	34	003	Bergen County, NJ	2000	NA	468371	453532	14839	3.2
CN3400500000000	34	005	Burlington County, NJ	2000	NA	221069	214177	6892	3.1
CN3400700000000	34	007	Camden County, NJ	2000	NA	253927	244044	9883	3.9
CN3400900000000	34	009	Cape May County, NJ	2000	NA	55469	51897	3572	6.4
CN3401100000000	34	011	Cumberland County, NJ	2000	NA	65461	61646	3815	5.8
CN3401300000000	34	013	Essex County, NJ	2000	NA	365491	349001	16490	4.5
CN3401500000000	34	015	Gloucester County, NJ	2000	NA	134657	129764	4893	3.6
CN3401700000000	34	017	Hudson County, NJ	2000	NA	297250	282845	14405	4.8
CN3401900000000	34	019	Hunterdon County, NJ	2000	NA	67840	66247	1593	2.3
CN3402100000000	34	021	Mercer County, NJ	2000	NA	179928	174028	5900	3.3
CN3402300000000	34	023	Middlesex County, NJ	2000	NA	400922	387461	13461	3.4
CN3402500000000	34	025	Monmouth County, NJ	2000	NA	317914	307639	10275	3.2
CN3402700000000	34	027	Morris County, NJ	2000	NA	260858	253914	6944	2.7
CN3402900000000	34	029	Ocean County, NJ	2000	NA	231928	223264	8664	3.7
CN3403100000000	34	031	Passaic County, NJ	2000	NA	235907	225034	10873	4.6
CN3403300000000	34	033	Salem County, NJ	2000	NA	31505	30281	1224	3.9
CN3403500000000	34	035	Somerset County, NJ	2000	NA	165405	161100	4305	2.6
CN3403700000000	34	037	Sussex County, NJ	2000	NA	79409	77055	2354	3
CN3403900000000	34	039	Union County, NJ	2000	NA	264337	254040	10297	3.9
CN3404100000000	34	041	Warren County, NJ	2000	NA	55600	53965	1635	2.9
CN3500100000000	35	001	Bernalillo County, NM	2000	NA	287292	275836	11456	4
CN3500300000000	35	003	Catron County, NM	2000	NA	1446	1350	96	6.6
CN3500500000000	35	005	Chaves County, NM	2000	NA	25619	24192	1427	5.6
CN3500600000000	35	006	Cibola County, NM	2000	NA	9898	9225	673	6.8
CN3500700000000	35	007	Colfax County, NM	2000	NA	6925	6579	346	5
CN3500900000000	35	009	Curry County, NM	2000	NA	18616	17753	863	4.6
CN3501100000000	35	011	De Baca County, NM	2000	NA	957	912	45	4.7
CN3501300000000	35	013	Dona Ana County, NM	2000	NA	75909	71282	4627	6.1
CN3501500000000	35	015	Eddy County, NM	2000	NA	23109	21806	1303	5.6
CN3501700000000	35	017	Grant County, NM	2000	NA	12764	12026	738	5.8
CN3501900000000	35	019	Guadalupe County, NM	2000	NA	1780	1651	129	7.2
CN3502100000000	35	021	Harding County, NM	2000	NA	412	395	17	4.1
CN3502300000000	35	023	Hidalgo County, NM	2000	NA	2614	2436	178	6.8
CN3502500000000	35	025	Lea County, NM	2000	NA	22489	21315	1174	5.2
CN3502700000000	35	027	Lincoln County, NM	2000	NA	9584	9180	404	4.2
CN3502800000000	35	028	Los Alamos County, NM	2000	NA	10431	10113	318	3
CN3502900000000	35	029	Luna County, NM	2000	NA	10664	9011	1653	15.5
CN3503100000000	35	031	McKinley County, NM	2000	NA	24393	22796	1597	6.5
CN3503300000000	35	033	Mora County, NM	2000	NA	1955	1750	205	10.5
CN3503500000000	35	035	Otero County, NM	2000	NA	24214	22933	1281	5.3
CN3503700000000	35	037	Quay County, NM	2000	NA	4413	4196	217	4.9
CN3503900000000	35	039	Rio Arriba County, NM	2000	NA	18828	17682	1146	6.1
CN3504100000000	35	041	Roosevelt County, NM	2000	NA	7978	7628	350	4.4
CN3504300000000	35	043	Sandoval County, NM	2000	NA	43280	41448	1832	4.2
CN3504500000000	35	045	San Juan County, NM	2000	NA	49296	46477	2819	5.7
CN3504700000000	35	047	San Miguel County, NM	2000	NA	12489	11767	722	5.8
CN3504900000000	35	049	Santa Fe County, NM	2000	NA	70244	67714	2530	3.6
CN3505100000000	35	051	Sierra County, NM	2000	NA	5255	5024	231	4.4
CN3505300000000	35	053	Socorro County, NM	2000	NA	7908	7510	398	5
CN3505500000000	35	055	Taos County, NM	2000	NA	15479	14440	1039	6.7
CN3505700000000	35	057	Torrance County, NM	2000	NA	7528	7154	374	5
CN3505900000000	35	059	Union County, NM	2000	NA	2046	1970	76	3.7
CN3506100000000	35	061	Valencia County, NM	2000	NA	29942	28552	1390	4.6
CN3600100000000	36	001	Albany County, NY	2000	NA	153997	148813	5184	3.4
CN3600300000000	36	003	Allegany County, NY	2000	NA	22659	21544	1115	4.9
CN3600500000000	36	005	Bronx County, NY	2000	NA	486621	452036	34585	7.1
CN3600700000000	36	007	Broome County, NY	2000	NA	97734	94155	3579	3.7
CN3600900000000	36	009	Cattaraugus County, NY	2000	NA	40867	39002	1865	4.6
CN3601100000000	36	011	Cayuga County, NY	2000	NA	40194	38613	1581	3.9
CN3601300000000	36	013	Chautauqua County, NY	2000	NA	67733	64986	2747	4.1
CN3601500000000	36	015	Chemung County, NY	2000	NA	42544	40695	1849	4.3
CN3601700000000	36	017	Chenango County, NY	2000	NA	24373	23390	983	4
CN3601900000000	36	019	Clinton County, NY	2000	NA	38375	36568	1807	4.7
CN3602100000000	36	021	Columbia County, NY	2000	NA	31344	30259	1085	3.5
CN3602300000000	36	023	Cortland County, NY	2000	NA	24037	22983	1054	4.4
CN3602500000000	36	025	Delaware County, NY	2000	NA	22070	21142	928	4.2
CN3602700000000	36	027	Dutchess County, NY	2000	NA	138446	133979	4467	3.2
CN3602900000000	36	029	Erie County, NY	2000	NA	465621	445939	19682	4.2
CN3603100000000	36	031	Essex County, NY	2000	NA	18442	17554	888	4.8
CN3603300000000	36	033	Franklin County, NY	2000	NA	22103	20821	1282	5.8
CN3603500000000	36	035	Fulton County, NY	2000	NA	26196	24965	1231	4.7
CN3603700000000	36	037	Genesee County, NY	2000	NA	32428	31134	1294	4
CN3603900000000	36	039	Greene County, NY	2000	NA	22496	21469	1027	4.6
CN3604100000000	36	041	Hamilton County, NY	2000	NA	2848	2690	158	5.5
CN3604300000000	36	043	Herkimer County, NY	2000	NA	31544	30189	1355	4.3
CN3604500000000	36	045	Jefferson County, NY	2000	NA	44776	42122	2654	5.9
CN3604700000000	36	047	Kings County, NY	2000	NA	1042699	976598	66101	6.3
CN3604900000000	36	049	Lewis County, NY	2000	NA	12639	11982	657	5.2
CN3605100000000	36	051	Livingston County, NY	2000	NA	32793	31454	1339	4.1
CN3605300000000	36	053	Madison County, NY	2000	NA	34868	33518	1350	3.9
CN3605500000000	36	055	Monroe County, NY	2000	NA	375172	361843	13329	3.6
CN3605700000000	36	057	Montgomery County, NY	2000	NA	23528	22396	1132	4.8
CN3605900000000	36	059	Nassau County, NY	2000	NA	673797	651257	22540	3.3
CN3606100000000	36	061	New York County, NY	2000	NA	855358	812237	43121	5
CN3606300000000	36	063	Niagara County, NY	2000	NA	109413	104250	5163	4.7
CN3606500000000	36	065	Oneida County, NY	2000	NA	110407	106089	4318	3.9
CN3606700000000	36	067	Onondaga County, NY	2000	NA	229488	221363	8125	3.5
CN3606900000000	36	069	Ontario County, NY	2000	NA	54309	52373	1936	3.6
CN3607100000000	36	071	Orange County, NY	2000	NA	161294	155817	5477	3.4
CN3607300000000	36	073	Orleans County, NY	2000	NA	20207	19260	947	4.7
CN3607500000000	36	075	Oswego County, NY	2000	NA	58432	55621	2811	4.8
CN3607700000000	36	077	Otsego County, NY	2000	NA	29583	28322	1261	4.3
CN3607900000000	36	079	Putnam County, NY	2000	NA	52023	50498	1525	2.9
CN3608100000000	36	081	Queens County, NY	2000	NA	1064415	1008221	56194	5.3
CN3608300000000	36	083	Rensselaer County, NY	2000	NA	80419	77484	2935	3.6
CN3608500000000	36	085	Richmond County, NY	2000	NA	217223	206215	11008	5.1
CN3608700000000	36	087	Rockland County, NY	2000	NA	144031	139261	4770	3.3
CN3608900000000	36	089	St. Lawrence County, NY	2000	NA	48706	45912	2794	5.7
CN3609100000000	36	091	Saratoga County, NY	2000	NA	110124	106435	3689	3.3
CN3609300000000	36	093	Schenectady County, NY	2000	NA	72222	69694	2528	3.5
CN3609500000000	36	095	Schoharie County, NY	2000	NA	15120	14469	651	4.3
CN3609700000000	36	097	Schuyler County, NY	2000	NA	9352	8930	422	4.5
CN3609900000000	36	099	Seneca County, NY	2000	NA	16342	15659	683	4.2
CN3610100000000	36	101	Steuben County, NY	2000	NA	47811	45841	1970	4.1
CN3610300000000	36	103	Suffolk County, NY	2000	NA	731428	706167	25261	3.5
CN3610500000000	36	105	Sullivan County, NY	2000	NA	32971	31523	1448	4.4
CN3610700000000	36	107	Tioga County, NY	2000	NA	26398	25482	916	3.5
CN3610900000000	36	109	Tompkins County, NY	2000	NA	50538	48872	1666	3.3
CN3611100000000	36	111	Ulster County, NY	2000	NA	88059	84900	3159	3.6
CN3611300000000	36	113	Warren County, NY	2000	NA	33152	31763	1389	4.2
CN3611500000000	36	115	Washington County, NY	2000	NA	29981	28859	1122	3.7
CN3611700000000	36	117	Wayne County, NY	2000	NA	48722	46858	1864	3.8
CN3611900000000	36	119	Westchester County, NY	2000	NA	461112	445401	15711	3.4
CN3612100000000	36	121	Wyoming County, NY	2000	NA	20236	19274	962	4.8
CN3612300000000	36	123	Yates County, NY	2000	NA	12055	11605	450	3.7
CN3700100000000	37	001	Alamance County, NC	2000	NA	69593	67432	2161	3.1
CN3700300000000	37	003	Alexander County, NC	2000	NA	19441	18915	526	2.7
CN3700500000000	37	005	Alleghany County, NC	2000	NA	5652	5318	334	5.9
CN3700700000000	37	007	Anson County, NC	2000	NA	11045	10472	573	5.2
CN3700900000000	37	009	Ashe County, NC	2000	NA	12533	11902	631	5
CN3701100000000	37	011	Avery County, NC	2000	NA	7964	7649	315	4
CN3701300000000	37	013	Beaufort County, NC	2000	NA	20738	19501	1237	6
CN3701500000000	37	015	Bertie County, NC	2000	NA	8400	7816	584	7
CN3701700000000	37	017	Bladen County, NC	2000	NA	14713	13826	887	6
CN3701900000000	37	019	Brunswick County, NC	2000	NA	35564	33976	1588	4.5
CN3702100000000	37	021	Buncombe County, NC	2000	NA	108031	104697	3334	3.1
CN3702300000000	37	023	Burke County, NC	2000	NA	46421	44805	1616	3.5
CN3702500000000	37	025	Cabarrus County, NC	2000	NA	72210	70058	2152	3
CN3702700000000	37	027	Caldwell County, NC	2000	NA	42560	41340	1220	2.9
CN3702900000000	37	029	Camden County, NC	2000	NA	3325	3228	97	2.9
CN3703100000000	37	031	Carteret County, NC	2000	NA	29694	28482	1212	4.1
CN3703300000000	37	033	Caswell County, NC	2000	NA	10917	10515	402	3.7
CN3703500000000	37	035	Catawba County, NC	2000	NA	80519	78333	2186	2.7
CN3703700000000	37	037	Chatham County, NC	2000	NA	26909	26179	730	2.7
CN3703900000000	37	039	Cherokee County, NC	2000	NA	11499	10769	730	6.3
CN3704100000000	37	041	Chowan County, NC	2000	NA	6506	6252	254	3.9
CN3704300000000	37	043	Clay County, NC	2000	NA	4046	3884	162	4
CN3704500000000	37	045	Cleveland County, NC	2000	NA	49126	46734	2392	4.9
CN3704700000000	37	047	Columbus County, NC	2000	NA	23571	21782	1789	7.6
CN3704900000000	37	049	Craven County, NC	2000	NA	38689	37104	1585	4.1
CN3705100000000	37	051	Cumberland County, NC	2000	NA	119608	114356	5252	4.4
CN3705300000000	37	053	Currituck County, NC	2000	NA	9247	8996	251	2.7
CN3705500000000	37	055	Dare County, NC	2000	NA	18833	18032	801	4.3
CN3705700000000	37	057	Davidson County, NC	2000	NA	79844	77286	2558	3.2
CN3705900000000	37	059	Davie County, NC	2000	NA	18487	17722	765	4.1
CN3706100000000	37	061	Duplin County, NC	2000	NA	23486	22486	1000	4.3
CN3706300000000	37	063	Durham County, NC	2000	NA	122577	119017	3560	2.9
CN3706500000000	37	065	Edgecombe County, NC	2000	NA	25133	23687	1446	5.8
CN3706700000000	37	067	Forsyth County, NC	2000	NA	162259	157131	5128	3.2
CN3706900000000	37	069	Franklin County, NC	2000	NA	24492	23709	783	3.2
CN3707100000000	37	071	Gaston County, NC	2000	NA	100292	94873	5419	5.4
CN3707300000000	37	073	Gates County, NC	2000	NA	4667	4510	157	3.4
CN3707500000000	37	075	Graham County, NC	2000	NA	3822	3573	249	6.5
CN3707700000000	37	077	Granville County, NC	2000	NA	22578	21599	979	4.3
CN3707900000000	37	079	Greene County, NC	2000	NA	8629	8234	395	4.6
CN3708100000000	37	081	Guilford County, NC	2000	NA	233796	226263	7533	3.2
CN3708300000000	37	083	Halifax County, NC	2000	NA	22983	21614	1369	6
CN3708500000000	37	085	Harnett County, NC	2000	NA	42417	40831	1586	3.7
CN3708700000000	37	087	Haywood County, NC	2000	NA	25958	24961	997	3.8
CN3708900000000	37	089	Henderson County, NC	2000	NA	42348	41092	1256	3
CN3709100000000	37	091	Hertford County, NC	2000	NA	9540	9052	488	5.1
CN3709300000000	37	093	Hoke County, NC	2000	NA	14523	13703	820	5.6
CN3709500000000	37	095	Hyde County, NC	2000	NA	2875	2713	162	5.6
CN3709700000000	37	097	Iredell County, NC	2000	NA	66143	63864	2279	3.4
CN3709900000000	37	099	Jackson County, NC	2000	NA	17256	16587	669	3.9
CN3710100000000	37	101	Johnston County, NC	2000	NA	64266	62432	1834	2.9
CN3710300000000	37	103	Jones County, NC	2000	NA	4684	4474	210	4.5
CN3710500000000	37	105	Lee County, NC	2000	NA	24697	23723	974	3.9
CN3710700000000	37	107	Lenoir County, NC	2000	NA	27835	26393	1442	5.2
CN3710900000000	37	109	Lincoln County, NC	2000	NA	34894	33601	1293	3.7
CN3711100000000	37	111	McDowell County, NC	2000	NA	21488	20575	913	4.2
CN3711300000000	37	113	Macon County, NC	2000	NA	14162	13619	543	3.8
CN3711500000000	37	115	Madison County, NC	2000	NA	9405	9059	346	3.7
CN3711700000000	37	117	Martin County, NC	2000	NA	11836	11027	809	6.8
CN3711900000000	37	119	Mecklenburg County, NC	2000	NA	397029	385524	11505	2.9
CN3712100000000	37	121	Mitchell County, NC	2000	NA	7794	7448	346	4.4
CN3712300000000	37	123	Montgomery County, NC	2000	NA	12797	12302	495	3.9
CN3712500000000	37	125	Moore County, NC	2000	NA	34728	33488	1240	3.6
CN3712700000000	37	127	Nash County, NC	2000	NA	43641	41668	1973	4.5
CN3712900000000	37	129	New Hanover County, NC	2000	NA	87947	84778	3169	3.6
CN3713100000000	37	131	Northampton County, NC	2000	NA	8721	8254	467	5.4
CN3713300000000	37	133	Onslow County, NC	2000	NA	53363	51074	2289	4.3
CN3713500000000	37	135	Orange County, NC	2000	NA	65035	63423	1612	2.5
CN3713700000000	37	137	Pamlico County, NC	2000	NA	5438	5221	217	4
CN3713900000000	37	139	Pasquotank County, NC	2000	NA	15475	14898	577	3.7
CN3714100000000	37	141	Pender County, NC	2000	NA	19510	18719	791	4.1
CN3714300000000	37	143	Perquimans County, NC	2000	NA	4791	4606	185	3.9
CN3714500000000	37	145	Person County, NC	2000	NA	18212	17430	782	4.3
CN3714700000000	37	147	Pitt County, NC	2000	NA	70106	67216	2890	4.1
CN3714900000000	37	149	Polk County, NC	2000	NA	8524	8219	305	3.6
CN3715100000000	37	151	Randolph County, NC	2000	NA	72549	70105	2444	3.4
CN3715300000000	37	153	Richmond County, NC	2000	NA	20953	19850	1103	5.3
CN3715500000000	37	155	Robeson County, NC	2000	NA	53760	50193	3567	6.6
CN3715700000000	37	157	Rockingham County, NC	2000	NA	46279	44084	2195	4.7
CN3715900000000	37	159	Rowan County, NC	2000	NA	65703	62799	2904	4.4
CN3716100000000	37	161	Rutherford County, NC	2000	NA	31082	29292	1790	5.8
CN3716300000000	37	163	Sampson County, NC	2000	NA	28932	27927	1005	3.5
CN3716500000000	37	165	Scotland County, NC	2000	NA	15772	14778	994	6.3
CN3716700000000	37	167	Stanly County, NC	2000	NA	29930	28785	1145	3.8
CN3716900000000	37	169	Stokes County, NC	2000	NA	24007	23180	827	3.4
CN3717100000000	37	171	Surry County, NC	2000	NA	37095	35610	1485	4
CN3717300000000	37	173	Swain County, NC	2000	NA	6213	5667	546	8.8
CN3717500000000	37	175	Transylvania County, NC	2000	NA	13440	13010	430	3.2
CN3717700000000	37	177	Tyrrell County, NC	2000	NA	1887	1750	137	7.3
CN3717900000000	37	179	Union County, NC	2000	NA	67442	65589	1853	2.7
CN3718100000000	37	181	Vance County, NC	2000	NA	20297	18933	1364	6.7
CN3718300000000	37	183	Wake County, NC	2000	NA	367403	358674	8729	2.4
CN3718500000000	37	185	Warren County, NC	2000	NA	8154	7668	486	6
CN3718700000000	37	187	Washington County, NC	2000	NA	5982	5665	317	5.3
CN3718900000000	37	189	Watauga County, NC	2000	NA	23317	22650	667	2.9
CN3719100000000	37	191	Wayne County, NC	2000	NA	51076	49066	2010	3.9
CN3719300000000	37	193	Wilkes County, NC	2000	NA	34110	32909	1201	3.5
CN3719500000000	37	195	Wilson County, NC	2000	NA	37315	35258	2057	5.5
CN3719700000000	37	197	Yadkin County, NC	2000	NA	19131	18458	673	3.5
CN3719900000000	37	199	Yancey County, NC	2000	NA	8538	8229	309	3.6
CN3800100000000	38	001	Adams County, ND	2000	NA	1316	1280	36	2.7
CN3800300000000	38	003	Barnes County, ND	2000	NA	6025	5833	192	3.2
CN3800500000000	38	005	Benson County, ND	2000	NA	2616	2460	156	6
CN3800700000000	38	007	Billings County, ND	2000	NA	486	474	12	2.5
CN3800900000000	38	009	Bottineau County, ND	2000	NA	3482	3350	132	3.8
CN3801100000000	38	011	Bowman County, ND	2000	NA	1801	1764	37	2.1
CN3801300000000	38	013	Burke County, ND	2000	NA	1053	1022	31	2.9
CN3801500000000	38	015	Burleigh County, ND	2000	NA	40119	39178	941	2.3
CN3801700000000	38	017	Cass County, ND	2000	NA	75351	73751	1600	2.1
CN3801900000000	38	019	Cavalier County, ND	2000	NA	2357	2278	79	3.4
CN3802100000000	38	021	Dickey County, ND	2000	NA	3063	2998	65	2.1
CN3802300000000	38	023	Divide County, ND	2000	NA	1066	1035	31	2.9
CN3802500000000	38	025	Dunn County, ND	2000	NA	1763	1707	56	3.2
CN3802700000000	38	027	Eddy County, ND	2000	NA	1364	1307	57	4.2
CN3802900000000	38	029	Emmons County, ND	2000	NA	2080	1993	87	4.2
CN3803100000000	38	031	Foster County, ND	2000	NA	1958	1902	56	2.9
CN3803300000000	38	033	Golden Valley County, ND	2000	NA	911	883	28	3.1
CN3803500000000	38	035	Grand Forks County, ND	2000	NA	35939	34924	1015	2.8
CN3803700000000	38	037	Grant County, ND	2000	NA	1364	1322	42	3.1
CN3803900000000	38	039	Griggs County, ND	2000	NA	1371	1337	34	2.5
CN3804100000000	38	041	Hettinger County, ND	2000	NA	1257	1219	38	3
CN3804300000000	38	043	Kidder County, ND	2000	NA	1304	1244	60	4.6
CN3804500000000	38	045	LaMoure County, ND	2000	NA	2287	2223	64	2.8
CN3804700000000	38	047	Logan County, ND	2000	NA	1044	1015	29	2.8
CN3804900000000	38	049	McHenry County, ND	2000	NA	2813	2676	137	4.9
CN3805100000000	38	051	McIntosh County, ND	2000	NA	1561	1516	45	2.9
CN3805300000000	38	053	McKenzie County, ND	2000	NA	2679	2595	84	3.1
CN3805500000000	38	055	McLean County, ND	2000	NA	4560	4345	215	4.7
CN3805700000000	38	057	Mercer County, ND	2000	NA	4497	4301	196	4.4
CN3805900000000	38	059	Morton County, ND	2000	NA	13857	13441	416	3
CN3806100000000	38	061	Mountrail County, ND	2000	NA	3019	2878	141	4.7
CN3806300000000	38	063	Nelson County, ND	2000	NA	1822	1752	70	3.8
CN3806500000000	38	065	Oliver County, ND	2000	NA	1127	1080	47	4.2
CN3806700000000	38	067	Pembina County, ND	2000	NA	4689	4444	245	5.2
CN3806900000000	38	069	Pierce County, ND	2000	NA	2194	2119	75	3.4
CN3807100000000	38	071	Ramsey County, ND	2000	NA	6187	5979	208	3.4
CN3807300000000	38	073	Ransom County, ND	2000	NA	3099	3026	73	2.4
CN3807500000000	38	075	Renville County, ND	2000	NA	1305	1272	33	2.5
CN3807700000000	38	077	Richland County, ND	2000	NA	9379	9121	258	2.8
CN3807900000000	38	079	Rolette County, ND	2000	NA	5233	4734	499	9.5
CN3808100000000	38	081	Sargent County, ND	2000	NA	2349	2293	56	2.4
CN3808300000000	38	083	Sheridan County, ND	2000	NA	791	750	41	5.2
CN3808500000000	38	085	Sioux County, ND	2000	NA	1263	1192	71	5.6
CN3808700000000	38	087	Slope County, ND	2000	NA	426	415	11	2.6
CN3808900000000	38	089	Stark County, ND	2000	NA	12316	11966	350	2.8
CN3809100000000	38	091	Steele County, ND	2000	NA	1176	1152	24	2
CN3809300000000	38	093	Stutsman County, ND	2000	NA	11843	11543	300	2.5
CN3809500000000	38	095	Towner County, ND	2000	NA	1440	1399	41	2.8
CN3809700000000	38	097	Traill County, ND	2000	NA	4268	4145	123	2.9
CN3809900000000	38	099	Walsh County, ND	2000	NA	6457	6224	233	3.6
CN3810100000000	38	101	Ward County, ND	2000	NA	27968	27072	896	3.2
CN3810300000000	38	103	Wells County, ND	2000	NA	2351	2257	94	4
CN3810500000000	38	105	Williams County, ND	2000	NA	10526	10221	305	2.9
CN3900100000000	39	001	Adams County, OH	2000	NA	12564	11628	936	7.4
CN3900300000000	39	003	Allen County, OH	2000	NA	51566	49187	2379	4.6
CN3900500000000	39	005	Ashland County, OH	2000	NA	27088	25957	1131	4.2
CN3900700000000	39	007	Ashtabula County, OH	2000	NA	50518	47951	2567	5.1
CN3900900000000	39	009	Athens County, OH	2000	NA	27756	26225	1531	5.5
CN3901100000000	39	011	Auglaize County, OH	2000	NA	25130	24240	890	3.5
CN3901300000000	39	013	Belmont County, OH	2000	NA	31047	29053	1994	6.4
CN3901500000000	39	015	Brown County, OH	2000	NA	20642	19531	1111	5.4
CN3901700000000	39	017	Butler County, OH	2000	NA	173347	166834	6513	3.8
CN3901900000000	39	019	Carroll County, OH	2000	NA	14163	13513	650	4.6
CN3902100000000	39	021	Champaign County, OH	2000	NA	20516	19744	772	3.8
CN3902300000000	39	023	Clark County, OH	2000	NA	72332	69042	3290	4.5
CN3902500000000	39	025	Clermont County, OH	2000	NA	95365	91711	3654	3.8
CN3902700000000	39	027	Clinton County, OH	2000	NA	21890	21072	818	3.7
CN3902900000000	39	029	Columbiana County, OH	2000	NA	54311	51564	2747	5.1
CN3903100000000	39	031	Coshocton County, OH	2000	NA	18220	17393	827	4.5
CN3903300000000	39	033	Crawford County, OH	2000	NA	23491	22428	1063	4.5
CN3903500000000	39	035	Cuyahoga County, OH	2000	NA	683667	664303	19364	2.8
CN3903700000000	39	037	Darke County, OH	2000	NA	27872	26707	1165	4.2
CN3903900000000	39	039	Defiance County, OH	2000	NA	21230	20400	830	3.9
CN3904100000000	39	041	Delaware County, OH	2000	NA	62688	60924	1764	2.8
CN3904300000000	39	043	Erie County, OH	2000	NA	42130	40250	1880	4.5
CN3904500000000	39	045	Fairfield County, OH	2000	NA	65550	63292	2258	3.4
CN3904700000000	39	047	Fayette County, OH	2000	NA	14934	14320	614	4.1
CN3904900000000	39	049	Franklin County, OH	2000	NA	593207	573832	19375	3.3
CN3905100000000	39	051	Fulton County, OH	2000	NA	22674	21717	957	4.2
CN3905300000000	39	053	Gallia County, OH	2000	NA	13350	12381	969	7.3
CN3905500000000	39	055	Geauga County, OH	2000	NA	48560	47500	1060	2.2
CN3905700000000	39	057	Greene County, OH	2000	NA	76254	73279	2975	3.9
CN3905900000000	39	059	Guernsey County, OH	2000	NA	18702	17458	1244	6.7
CN3906100000000	39	061	Hamilton County, OH	2000	NA	428312	411751	16561	3.9
CN3906300000000	39	063	Hancock County, OH	2000	NA	38955	37592	1363	3.5
CN3906500000000	39	065	Hardin County, OH	2000	NA	15733	15052	681	4.3
CN3906700000000	39	067	Harrison County, OH	2000	NA	7186	6795	391	5.4
CN3906900000000	39	069	Henry County, OH	2000	NA	15259	14571	688	4.5
CN3907100000000	39	071	Highland County, OH	2000	NA	19572	18673	899	4.6
CN3907300000000	39	073	Hocking County, OH	2000	NA	13165	12303	862	6.5
CN3907500000000	39	075	Holmes County, OH	2000	NA	17736	17202	534	3
CN3907700000000	39	077	Huron County, OH	2000	NA	30703	28948	1755	5.7
CN3907900000000	39	079	Jackson County, OH	2000	NA	14473	13584	889	6.1
CN3908100000000	39	081	Jefferson County, OH	2000	NA	31742	29822	1920	6
CN3908300000000	39	083	Knox County, OH	2000	NA	27415	26224	1191	4.3
CN3908500000000	39	085	Lake County, OH	2000	NA	127624	124593	3031	2.4
CN3908700000000	39	087	Lawrence County, OH	2000	NA	26178	24149	2029	7.8
CN3908900000000	39	089	Licking County, OH	2000	NA	77423	74446	2977	3.8
CN3909100000000	39	091	Logan County, OH	2000	NA	24142	23229	913	3.8
CN3909300000000	39	093	Lorain County, OH	2000	NA	146681	142440	4241	2.9
CN3909500000000	39	095	Lucas County, OH	2000	NA	227177	216358	10819	4.8
CN3909700000000	39	097	Madison County, OH	2000	NA	19333	18644	689	3.6
CN3909900000000	39	099	Mahoning County, OH	2000	NA	120261	113808	6453	5.4
CN3910100000000	39	101	Marion County, OH	2000	NA	31762	30368	1394	4.4
CN3910300000000	39	103	Medina County, OH	2000	NA	83930	82024	1906	2.3
CN3910500000000	39	105	Meigs County, OH	2000	NA	9842	9095	747	7.6
CN3910700000000	39	107	Mercer County, OH	2000	NA	21712	20790	922	4.2
CN3910900000000	39	109	Miami County, OH	2000	NA	53886	51893	1993	3.7
CN3911100000000	39	111	Monroe County, OH	2000	NA	6348	5874	474	7.5
CN3911300000000	39	113	Montgomery County, OH	2000	NA	279370	267628	11742	4.2
CN3911500000000	39	115	Morgan County, OH	2000	NA	6608	6146	462	7
CN3911700000000	39	117	Morrow County, OH	2000	NA	16437	15787	650	4
CN3911900000000	39	119	Muskingum County, OH	2000	NA	42085	39785	2300	5.5
CN3912100000000	39	121	Noble County, OH	2000	NA	5655	5276	379	6.7
CN3912300000000	39	123	Ottawa County, OH	2000	NA	21395	20256	1139	5.3
CN3912500000000	39	125	Paulding County, OH	2000	NA	10485	10065	420	4
CN3912700000000	39	127	Perry County, OH	2000	NA	16140	15243	897	5.6
CN3912900000000	39	129	Pickaway County, OH	2000	NA	23870	22864	1006	4.2
CN3913100000000	39	131	Pike County, OH	2000	NA	11443	10616	827	7.2
CN3913300000000	39	133	Portage County, OH	2000	NA	84675	81207	3468	4.1
CN3913500000000	39	135	Preble County, OH	2000	NA	21897	21013	884	4
CN3913700000000	39	137	Putnam County, OH	2000	NA	18277	17645	632	3.5
CN3913900000000	39	139	Richland County, OH	2000	NA	63248	59883	3365	5.3
CN3914100000000	39	141	Ross County, OH	2000	NA	33504	31726	1778	5.3
CN3914300000000	39	143	Sandusky County, OH	2000	NA	32789	31352	1437	4.4
CN3914500000000	39	145	Scioto County, OH	2000	NA	32074	29625	2449	7.6
CN3914700000000	39	147	Seneca County, OH	2000	NA	30929	29534	1395	4.5
CN3914900000000	39	149	Shelby County, OH	2000	NA	25535	24497	1038	4.1
CN3915100000000	39	151	Stark County, OH	2000	NA	192777	184367	8410	4.4
CN3915300000000	39	153	Summit County, OH	2000	NA	280078	267841	12237	4.4
CN3915500000000	39	155	Trumbull County, OH	2000	NA	107518	101853	5665	5.3
CN3915700000000	39	157	Tuscarawas County, OH	2000	NA	46427	44388	2039	4.4
CN3915900000000	39	159	Union County, OH	2000	NA	22181	21476	705	3.2
CN3916100000000	39	161	Van Wert County, OH	2000	NA	15648	14953	695	4.4
CN3916300000000	39	163	Vinton County, OH	2000	NA	5444	5052	392	7.2
CN3916500000000	39	165	Warren County, OH	2000	NA	83482	80568	2914	3.5
CN3916700000000	39	167	Washington County, OH	2000	NA	31320	29521	1799	5.7
CN3916900000000	39	169	Wayne County, OH	2000	NA	58854	56789	2065	3.5
CN3917100000000	39	171	Williams County, OH	2000	NA	21252	20463	789	3.7
CN3917300000000	39	173	Wood County, OH	2000	NA	66267	63823	2444	3.7
CN3917500000000	39	175	Wyandot County, OH	2000	NA	12373	11858	515	4.2
CN4000100000000	40	001	Adair County, OK	2000	NA	9216	8891	325	3.5
CN4000300000000	40	003	Alfalfa County, OK	2000	NA	2616	2539	77	2.9
CN4000500000000	40	005	Atoka County, OK	2000	NA	5192	5007	185	3.6
CN4000700000000	40	007	Beaver County, OK	2000	NA	2943	2873	70	2.4
CN4000900000000	40	009	Beckham County, OK	2000	NA	8640	8369	271	3.1
CN4001100000000	40	011	Blaine County, OK	2000	NA	4803	4669	134	2.8
CN4001300000000	40	013	Bryan County, OK	2000	NA	16769	16279	490	2.9
CN4001500000000	40	015	Caddo County, OK	2000	NA	12159	11707	452	3.7
CN4001700000000	40	017	Canadian County, OK	2000	NA	46614	45525	1089	2.3
CN4001900000000	40	019	Carter County, OK	2000	NA	20914	20136	778	3.7
CN4002100000000	40	021	Cherokee County, OK	2000	NA	18840	18247	593	3.1
CN4002300000000	40	023	Choctaw County, OK	2000	NA	6071	5784	287	4.7
CN4002500000000	40	025	Cimarron County, OK	2000	NA	1602	1567	35	2.2
CN4002700000000	40	027	Cleveland County, OK	2000	NA	111428	108892	2536	2.3
CN4002900000000	40	029	Coal County, OK	2000	NA	2495	2389	106	4.2
CN4003100000000	40	031	Comanche County, OK	2000	NA	43303	41751	1552	3.6
CN4003300000000	40	033	Cotton County, OK	2000	NA	2865	2774	91	3.2
CN4003500000000	40	035	Craig County, OK	2000	NA	6930	6685	245	3.5
CN4003700000000	40	037	Creek County, OK	2000	NA	31960	30942	1018	3.2
CN4003900000000	40	039	Custer County, OK	2000	NA	13258	12933	325	2.5
CN4004100000000	40	041	Delaware County, OK	2000	NA	15990	15417	573	3.6
CN4004300000000	40	043	Dewey County, OK	2000	NA	2276	2215	61	2.7
CN4004500000000	40	045	Ellis County, OK	2000	NA	2110	2055	55	2.6
CN4004700000000	40	047	Garfield County, OK	2000	NA	28105	27326	779	2.8
CN4004900000000	40	049	Garvin County, OK	2000	NA	12495	12069	426	3.4
CN4005100000000	40	051	Grady County, OK	2000	NA	21996	21360	636	2.9
CN4005300000000	40	053	Grant County, OK	2000	NA	2569	2506	63	2.5
CN4005500000000	40	055	Greer County, OK	2000	NA	2268	2179	89	3.9
CN4005700000000	40	057	Harmon County, OK	2000	NA	1435	1396	39	2.7
CN4005900000000	40	059	Harper County, OK	2000	NA	1916	1876	40	2.1
CN4006100000000	40	061	Haskell County, OK	2000	NA	5100	4878	222	4.4
CN4006300000000	40	063	Hughes County, OK	2000	NA	5555	5270	285	5.1
CN4006500000000	40	065	Jackson County, OK	2000	NA	11906	11551	355	3
CN4006700000000	40	067	Jefferson County, OK	2000	NA	2835	2735	100	3.5
CN4006900000000	40	069	Johnston County, OK	2000	NA	4534	4372	162	3.6
CN4007100000000	40	071	Kay County, OK	2000	NA	22028	21093	935	4.2
CN4007300000000	40	073	Kingfisher County, OK	2000	NA	7179	7022	157	2.2
CN4007500000000	40	075	Kiowa County, OK	2000	NA	4598	4471	127	2.8
CN4007700000000	40	077	Latimer County, OK	2000	NA	4431	4224	207	4.7
CN4007900000000	40	079	Le Flore County, OK	2000	NA	20730	19855	875	4.2
CN4008100000000	40	081	Lincoln County, OK	2000	NA	14889	14456	433	2.9
CN4008300000000	40	083	Logan County, OK	2000	NA	17005	16582	423	2.5
CN4008500000000	40	085	Love County, OK	2000	NA	4214	4066	148	3.5
CN4008700000000	40	087	McClain County, OK	2000	NA	13848	13498	350	2.5
CN4008900000000	40	089	McCurtain County, OK	2000	NA	14843	14142	701	4.7
CN4009100000000	40	091	McIntosh County, OK	2000	NA	7930	7572	358	4.5
CN4009300000000	40	093	Major County, OK	2000	NA	4003	3910	93	2.3
CN4009500000000	40	095	Marshall County, OK	2000	NA	5716	5507	209	3.7
CN4009700000000	40	097	Mayes County, OK	2000	NA	18004	17412	592	3.3
CN4009900000000	40	099	Murray County, OK	2000	NA	6018	5810	208	3.5
CN4010100000000	40	101	Muskogee County, OK	2000	NA	28945	27838	1107	3.8
CN4010300000000	40	103	Noble County, OK	2000	NA	5740	5609	131	2.3
CN4010500000000	40	105	Nowata County, OK	2000	NA	4865	4700	165	3.4
CN4010700000000	40	107	Okfuskee County, OK	2000	NA	4537	4363	174	3.8
CN4010900000000	40	109	Oklahoma County, OK	2000	NA	326691	317386	9305	2.8
CN4011100000000	40	111	Okmulgee County, OK	2000	NA	17104	16350	754	4.4
CN4011300000000	40	113	Osage County, OK	2000	NA	20837	20183	654	3.1
CN4011500000000	40	115	Ottawa County, OK	2000	NA	15603	14899	704	4.5
CN4011700000000	40	117	Pawnee County, OK	2000	NA	7924	7634	290	3.7
CN4011900000000	40	119	Payne County, OK	2000	NA	36200	35314	886	2.4
CN4012100000000	40	121	Pittsburg County, OK	2000	NA	17692	16912	780	4.4
CN4012300000000	40	123	Pontotoc County, OK	2000	NA	16705	16162	543	3.3
CN4012500000000	40	125	Pottawatomie County, OK	2000	NA	30199	29245	954	3.2
CN4012700000000	40	127	Pushmataha County, OK	2000	NA	4656	4457	199	4.3
CN4012900000000	40	129	Roger Mills County, OK	2000	NA	1831	1787	44	2.4
CN4013100000000	40	131	Rogers County, OK	2000	NA	36130	35173	957	2.6
CN4013300000000	40	133	Seminole County, OK	2000	NA	10424	9982	442	4.2
CN4013500000000	40	135	Sequoyah County, OK	2000	NA	17195	16460	735	4.3
CN4013700000000	40	137	Stephens County, OK	2000	NA	19298	18659	639	3.3
CN4013900000000	40	139	Texas County, OK	2000	NA	10605	10330	275	2.6
CN4014100000000	40	141	Tillman County, OK	2000	NA	3802	3681	121	3.2
CN4014300000000	40	143	Tulsa County, OK	2000	NA	296763	288526	8237	2.8
CN4014500000000	40	145	Wagoner County, OK	2000	NA	29473	28723	750	2.5
CN4014700000000	40	147	Washington County, OK	2000	NA	22852	22156	696	3
CN4014900000000	40	149	Washita County, OK	2000	NA	5561	5415	146	2.6
CN4015100000000	40	151	Woods County, OK	2000	NA	4569	4456	113	2.5
CN4015300000000	40	153	Woodward County, OK	2000	NA	9189	8918	271	2.9
CN4100100000000	41	001	Baker County, OR	2000	NA	7304	6787	517	7.1
CN4100300000000	41	003	Benton County, OR	2000	NA	41419	39828	1591	3.8
CN4100500000000	41	005	Clackamas County, OR	2000	NA	188587	180982	7605	4
CN4100700000000	41	007	Clatsop County, OR	2000	NA	17999	17104	895	5
CN4100900000000	41	009	Columbia County, OR	2000	NA	22582	21346	1236	5.5
CN4101100000000	41	011	Coos County, OR	2000	NA	27415	25402	2013	7.3
CN4101300000000	41	013	Crook County, OR	2000	NA	8775	8143	632	7.2
CN4101500000000	41	015	Curry County, OR	2000	NA	8836	8218	618	7
CN4101700000000	41	017	Deschutes County, OR	2000	NA	62089	58778	3311	5.3
CN4101900000000	41	019	Douglas County, OR	2000	NA	46318	42933	3385	7.3
CN4102100000000	41	021	Gilliam County, OR	2000	NA	1011	962	49	4.8
CN4102300000000	41	023	Grant County, OR	2000	NA	3799	3435	364	9.6
CN4102500000000	41	025	Harney County, OR	2000	NA	3875	3550	325	8.4
CN4102700000000	41	027	Hood River County, OR	2000	NA	11511	10757	754	6.6
CN4102900000000	41	029	Jackson County, OR	2000	NA	90977	85902	5075	5.6
CN4103100000000	41	031	Jefferson County, OR	2000	NA	8813	8346	467	5.3
CN4103300000000	41	033	Josephine County, OR	2000	NA	31473	29281	2192	7
CN4103500000000	41	035	Klamath County, OR	2000	NA	29824	27632	2192	7.3
CN4103700000000	41	037	Lake County, OR	2000	NA	3389	3109	280	8.3
CN4103900000000	41	039	Lane County, OR	2000	NA	170474	161349	9125	5.4
CN4104100000000	41	041	Lincoln County, OR	2000	NA	21265	19904	1361	6.4
CN4104300000000	41	043	Linn County, OR	2000	NA	51531	48154	3377	6.6
CN4104500000000	41	045	Malheur County, OR	2000	NA	13105	12113	992	7.6
CN4104700000000	41	047	Marion County, OR	2000	NA	145246	137280	7966	5.5
CN4104900000000	41	049	Morrow County, OR	2000	NA	5490	5070	420	7.7
CN4105100000000	41	051	Multnomah County, OR	2000	NA	381239	363518	17721	4.6
CN4105300000000	41	053	Polk County, OR	2000	NA	33329	31743	1586	4.8
CN4105500000000	41	055	Sherman County, OR	2000	NA	891	836	55	6.2
CN4105700000000	41	057	Tillamook County, OR	2000	NA	11595	10994	601	5.2
CN4105900000000	41	059	Umatilla County, OR	2000	NA	36053	33859	2194	6.1
CN4106100000000	41	061	Union County, OR	2000	NA	12035	11373	662	5.5
CN4106300000000	41	063	Wallowa County, OR	2000	NA	3514	3251	263	7.5
CN4106500000000	41	065	Wasco County, OR	2000	NA	12608	11838	770	6.1
CN4106700000000	41	067	Washington County, OR	2000	NA	259502	249497	10005	3.9
CN4106900000000	41	069	Wheeler County, OR	2000	NA	725	673	52	7.2
CN4107100000000	41	071	Yamhill County, OR	2000	NA	43964	41801	2163	4.9
CN4200100000000	42	001	Adams County, PA	2000	NA	49605	48043	1562	3.1
CN4200300000000	42	003	Allegheny County, PA	2000	NA	638137	612461	25676	4
CN4200500000000	42	005	Armstrong County, PA	2000	NA	33253	31374	1879	5.7
CN4200700000000	42	007	Beaver County, PA	2000	NA	89156	85361	3795	4.3
CN4200900000000	42	009	Bedford County, PA	2000	NA	24685	23335	1350	5.5
CN4201100000000	42	011	Berks County, PA	2000	NA	195287	187690	7597	3.9
CN4201300000000	42	013	Blair County, PA	2000	NA	62587	59692	2895	4.6
CN4201500000000	42	015	Bradford County, PA	2000	NA	30349	29262	1087	3.6
CN4201700000000	42	017	Bucks County, PA	2000	NA	330239	319083	11156	3.4
CN4201900000000	42	019	Butler County, PA	2000	NA	89406	85772	3634	4.1
CN4202100000000	42	021	Cambria County, PA	2000	NA	66867	62811	4056	6.1
CN4202300000000	42	023	Cameron County, PA	2000	NA	2793	2610	183	6.6
CN4202500000000	42	025	Carbon County, PA	2000	NA	29091	27608	1483	5.1
CN4202700000000	42	027	Centre County, PA	2000	NA	68658	66308	2350	3.4
CN4202900000000	42	029	Chester County, PA	2000	NA	236657	229523	7134	3
CN4203100000000	42	031	Clarion County, PA	2000	NA	19418	18440	978	5
CN4203300000000	42	033	Clearfield County, PA	2000	NA	39499	37299	2200	5.6
CN4203500000000	42	035	Clinton County, PA	2000	NA	18264	17327	937	5.1
CN4203700000000	42	037	Columbia County, PA	2000	NA	32060	30394	1666	5.2
CN4203900000000	42	039	Crawford County, PA	2000	NA	42892	40809	2083	4.9
CN4204100000000	42	041	Cumberland County, PA	2000	NA	114198	110638	3560	3.1
CN4204300000000	42	043	Dauphin County, PA	2000	NA	131742	127162	4580	3.5
CN4204500000000	42	045	Delaware County, PA	2000	NA	278014	267671	10343	3.7
CN4204700000000	42	047	Elk County, PA	2000	NA	18257	17376	881	4.8
CN4204900000000	42	049	Erie County, PA	2000	NA	140747	134452	6295	4.5
CN4205100000000	42	051	Fayette County, PA	2000	NA	64754	61105	3649	5.6
CN4205300000000	42	053	Forest County, PA	2000	NA	2018	1877	141	7
CN4205500000000	42	055	Franklin County, PA	2000	NA	67744	65231	2513	3.7
CN4205700000000	42	057	Fulton County, PA	2000	NA	7282	7005	277	3.8
CN4205900000000	42	059	Greene County, PA	2000	NA	16738	15762	976	5.8
CN4206100000000	42	061	Huntingdon County, PA	2000	NA	20871	19618	1253	6
CN4206300000000	42	063	Indiana County, PA	2000	NA	41102	38740	2362	5.7
CN4206500000000	42	065	Jefferson County, PA	2000	NA	21564	20432	1132	5.2
CN4206700000000	42	067	Juniata County, PA	2000	NA	11524	11046	478	4.1
CN4206900000000	42	069	Lackawanna County, PA	2000	NA	104017	99375	4642	4.5
CN4207100000000	42	071	Lancaster County, PA	2000	NA	251460	244446	7014	2.8
CN4207300000000	42	073	Lawrence County, PA	2000	NA	44793	42606	2187	4.9
CN4207500000000	42	075	Lebanon County, PA	2000	NA	64373	62355	2018	3.1
CN4207700000000	42	077	Lehigh County, PA	2000	NA	163039	157140	5899	3.6
CN4207900000000	42	079	Luzerne County, PA	2000	NA	156008	148047	7961	5.1
CN4208100000000	42	081	Lycoming County, PA	2000	NA	59454	56907	2547	4.3
CN4208300000000	42	083	McKean County, PA	2000	NA	21930	20890	1040	4.7
CN4208500000000	42	085	Mercer County, PA	2000	NA	56823	54020	2803	4.9
CN4208700000000	42	087	Mifflin County, PA	2000	NA	22243	21298	945	4.2
CN4208900000000	42	089	Monroe County, PA	2000	NA	69483	66602	2881	4.1
CN4209100000000	42	091	Montgomery County, PA	2000	NA	410178	397383	12795	3.1
CN4209300000000	42	093	Montour County, PA	2000	NA	8630	8332	298	3.5
CN4209500000000	42	095	Northampton County, PA	2000	NA	138653	133478	5175	3.7
CN4209700000000	42	097	Northumberland County, PA	2000	NA	45577	43531	2046	4.5
CN4209900000000	42	099	Perry County, PA	2000	NA	23378	22517	861	3.7
CN4210100000000	42	101	Philadelphia County/city, PA	2000	NA	637072	602049	35023	5.5
CN4210300000000	42	103	Pike County, PA	2000	NA	21255	20457	798	3.8
CN4210500000000	42	105	Potter County, PA	2000	NA	8520	8139	381	4.5
CN4210700000000	42	107	Schuylkill County, PA	2000	NA	70184	66106	4078	5.8
CN4210900000000	42	109	Snyder County, PA	2000	NA	19080	18396	684	3.6
CN4211100000000	42	111	Somerset County, PA	2000	NA	38179	36186	1993	5.2
CN4211300000000	42	113	Sullivan County, PA	2000	NA	2989	2846	143	4.8
CN4211500000000	42	115	Susquehanna County, PA	2000	NA	20432	19638	794	3.9
CN4211700000000	42	117	Tioga County, PA	2000	NA	20065	19185	880	4.4
CN4211900000000	42	119	Union County, PA	2000	NA	17344	16679	665	3.8
CN4212100000000	42	121	Venango County, PA	2000	NA	26869	25514	1355	5
CN4212300000000	42	123	Warren County, PA	2000	NA	22203	21379	824	3.7
CN4212500000000	42	125	Washington County, PA	2000	NA	98726	94219	4507	4.6
CN4212700000000	42	127	Wayne County, PA	2000	NA	22712	21692	1020	4.5
CN4212900000000	42	129	Westmoreland County, PA	2000	NA	182252	173853	8399	4.6
CN4213100000000	42	131	Wyoming County, PA	2000	NA	13857	13197	660	4.8
CN4213300000000	42	133	York County, PA	2000	NA	209665	202777	6888	3.3
CN4400100000000	44	001	Bristol County, RI	2000	NA	26850	25881	969	3.6
CN4400300000000	44	003	Kent County, RI	2000	NA	92859	89267	3592	3.9
CN4400500000000	44	005	Newport County, RI	2000	NA	44990	43336	1654	3.7
CN4400700000000	44	007	Providence County, RI	2000	NA	309746	296002	13744	4.4
CN4400900000000	44	009	Washington County, RI	2000	NA	69117	66828	2289	3.3
CN4500100000000	45	001	Abbeville County, SC	2000	NA	12602	12119	483	3.8
CN4500300000000	45	003	Aiken County, SC	2000	NA	69965	67225	2740	3.9
CN4500500000000	45	005	Allendale County, SC	2000	NA	3749	3550	199	5.3
CN4500700000000	45	007	Anderson County, SC	2000	NA	84560	81859	2701	3.2
CN4500900000000	45	009	Bamberg County, SC	2000	NA	6564	6220	344	5.2
CN4501100000000	45	011	Barnwell County, SC	2000	NA	10341	9810	531	5.1
CN4501300000000	45	013	Beaufort County, SC	2000	NA	51639	49972	1667	3.2
CN4501500000000	45	015	Berkeley County, SC	2000	NA	66480	64257	2223	3.3
CN4501700000000	45	017	Calhoun County, SC	2000	NA	7171	6893	278	3.9
CN4501900000000	45	019	Charleston County, SC	2000	NA	154636	149448	5188	3.4
CN4502100000000	45	021	Cherokee County, SC	2000	NA	25816	24699	1117	4.3
CN4502300000000	45	023	Chester County, SC	2000	NA	16496	15629	867	5.3
CN4502500000000	45	025	Chesterfield County, SC	2000	NA	19468	18542	926	4.8
CN4502700000000	45	027	Clarendon County, SC	2000	NA	13189	12457	732	5.6
CN4502900000000	45	029	Colleton County, SC	2000	NA	16110	15479	631	3.9
CN4503100000000	45	031	Darlington County, SC	2000	NA	31843	30248	1595	5
CN4503300000000	45	033	Dillon County, SC	2000	NA	13804	12841	963	7
CN4503500000000	45	035	Dorchester County, SC	2000	NA	47746	46256	1490	3.1
CN4503700000000	45	037	Edgefield County, SC	2000	NA	10481	10090	391	3.7
CN4503900000000	45	039	Fairfield County, SC	2000	NA	11185	10614	571	5.1
CN4504100000000	45	041	Florence County, SC	2000	NA	60971	58398	2573	4.2
CN4504300000000	45	043	Georgetown County, SC	2000	NA	26159	24706	1453	5.6
CN4504500000000	45	045	Greenville County, SC	2000	NA	205617	200014	5603	2.7
CN4504700000000	45	047	Greenwood County, SC	2000	NA	32955	31505	1450	4.4
CN4504900000000	45	049	Hampton County, SC	2000	NA	8412	8039	373	4.4
CN4505100000000	45	051	Horry County, SC	2000	NA	106718	102770	3948	3.7
CN4505300000000	45	053	Jasper County, SC	2000	NA	9294	8952	342	3.7
CN4505500000000	45	055	Kershaw County, SC	2000	NA	27399	26344	1055	3.9
CN4505700000000	45	057	Lancaster County, SC	2000	NA	30430	29281	1149	3.8
CN4505900000000	45	059	Laurens County, SC	2000	NA	34270	33109	1161	3.4
CN4506100000000	45	061	Lee County, SC	2000	NA	8371	7883	488	5.8
CN4506300000000	45	063	Lexington County, SC	2000	NA	119575	116254	3321	2.8
CN4506500000000	45	065	McCormick County, SC	2000	NA	3786	3540	246	6.5
CN4506700000000	45	067	Marion County, SC	2000	NA	15681	14173	1508	9.6
CN4506900000000	45	069	Marlboro County, SC	2000	NA	12414	11547	867	7
CN4507100000000	45	071	Newberry County, SC	2000	NA	17481	16722	759	4.3
CN4507300000000	45	073	Oconee County, SC	2000	NA	32691	31509	1182	3.6
CN4507500000000	45	075	Orangeburg County, SC	2000	NA	41179	38715	2464	6
CN4507700000000	45	077	Pickens County, SC	2000	NA	58200	56380	1820	3.1
CN4507900000000	45	079	Richland County, SC	2000	NA	163432	157932	5500	3.4
CN4508100000000	45	081	Saluda County, SC	2000	NA	9488	9132	356	3.8
CN4508300000000	45	083	Spartanburg County, SC	2000	NA	131126	126306	4820	3.7
CN4508500000000	45	085	Sumter County, SC	2000	NA	45279	43291	1988	4.4
CN4508700000000	45	087	Union County, SC	2000	NA	14297	13542	755	5.3
CN4508900000000	45	089	Williamsburg County, SC	2000	NA	15312	14120	1192	7.8
CN4509100000000	45	091	York County, SC	2000	NA	89184	86214	2970	3.3
CN4600300000000	46	003	Aurora County, SD	2000	NA	1582	1547	35	2.2
CN4600500000000	46	005	Beadle County, SD	2000	NA	9100	8878	222	2.4
CN4600700000000	46	007	Bennett County, SD	2000	NA	1337	1290	47	3.5
CN4600900000000	46	009	Bon Homme County, SD	2000	NA	3324	3238	86	2.6
CN4601100000000	46	011	Brookings County, SD	2000	NA	17612	17257	355	2
CN4601300000000	46	013	Brown County, SD	2000	NA	20480	20018	462	2.3
CN4601500000000	46	015	Brule County, SD	2000	NA	2718	2653	65	2.4
CN4601700000000	46	017	Buffalo County, SD	2000	NA	511	464	47	9.2
CN4601900000000	46	019	Butte County, SD	2000	NA	4782	4653	129	2.7
CN4602100000000	46	021	Campbell County, SD	2000	NA	928	879	49	5.3
CN4602300000000	46	023	Charles Mix County, SD	2000	NA	4013	3903	110	2.7
CN4602500000000	46	025	Clark County, SD	2000	NA	2135	2058	77	3.6
CN4602700000000	46	027	Clay County, SD	2000	NA	7382	7230	152	2.1
CN4602900000000	46	029	Codington County, SD	2000	NA	15516	15140	376	2.4
CN4603100000000	46	031	Corson County, SD	2000	NA	1385	1309	76	5.5
CN4603300000000	46	033	Custer County, SD	2000	NA	4171	4050	121	2.9
CN4603500000000	46	035	Davison County, SD	2000	NA	10322	10092	230	2.2
CN4603700000000	46	037	Day County, SD	2000	NA	3041	2918	123	4
CN4603900000000	46	039	Deuel County, SD	2000	NA	2513	2435	78	3.1
CN4604100000000	46	041	Dewey County, SD	2000	NA	2266	2063	203	9
CN4604300000000	46	043	Douglas County, SD	2000	NA	1736	1699	37	2.1
CN4604500000000	46	045	Edmunds County, SD	2000	NA	2139	2090	49	2.3
CN4604700000000	46	047	Fall River County, SD	2000	NA	3537	3406	131	3.7
CN4604900000000	46	049	Faulk County, SD	2000	NA	1285	1254	31	2.4
CN4605100000000	46	051	Grant County, SD	2000	NA	4148	4022	126	3
CN4605300000000	46	053	Gregory County, SD	2000	NA	2432	2360	72	3
CN4605500000000	46	055	Haakon County, SD	2000	NA	1264	1242	22	1.7
CN4605700000000	46	057	Hamlin County, SD	2000	NA	2787	2717	70	2.5
CN4605900000000	46	059	Hand County, SD	2000	NA	2043	2002	41	2
CN4606100000000	46	061	Hanson County, SD	2000	NA	1589	1556	33	2.1
CN4606300000000	46	063	Harding County, SD	2000	NA	764	744	20	2.6
CN4606500000000	46	065	Hughes County, SD	2000	NA	9637	9450	187	1.9
CN4606700000000	46	067	Hutchinson County, SD	2000	NA	3973	3872	101	2.5
CN4606900000000	46	069	Hyde County, SD	2000	NA	853	832	21	2.5
CN4607100000000	46	071	Jackson County, SD	2000	NA	1155	1107	48	4.2
CN4607300000000	46	073	Jerauld County, SD	2000	NA	1235	1206	29	2.3
CN4607500000000	46	075	Jones County, SD	2000	NA	761	745	16	2.1
CN4607700000000	46	077	Kingsbury County, SD	2000	NA	3038	2962	76	2.5
CN4607900000000	46	079	Lake County, SD	2000	NA	6549	6392	157	2.4
CN4608100000000	46	081	Lawrence County, SD	2000	NA	11538	11219	319	2.8
CN4608300000000	46	083	Lincoln County, SD	2000	NA	14508	14265	243	1.7
CN4608500000000	46	085	Lyman County, SD	2000	NA	1929	1852	77	4
CN4608700000000	46	087	McCook County, SD	2000	NA	2985	2921	64	2.1
CN4608900000000	46	089	McPherson County, SD	2000	NA	1329	1292	37	2.8
CN4609100000000	46	091	Marshall County, SD	2000	NA	2226	2146	80	3.6
CN4609300000000	46	093	Meade County, SD	2000	NA	12264	11978	286	2.3
CN4609500000000	46	095	Mellette County, SD	2000	NA	857	825	32	3.7
CN4609700000000	46	097	Miner County, SD	2000	NA	1498	1459	39	2.6
CN4609900000000	46	099	Minnehaha County, SD	2000	NA	88976	87261	1715	1.9
CN4610100000000	46	101	Moody County, SD	2000	NA	3721	3585	136	3.7
CN4610200000000	46	102	Oglala Lakota County, SD	2000	NA	2845	2603	242	8.5
CN4610300000000	46	103	Pennington County, SD	2000	NA	48845	47743	1102	2.3
CN4610500000000	46	105	Perkins County, SD	2000	NA	1787	1743	44	2.5
CN4610700000000	46	107	Potter County, SD	2000	NA	1457	1418	39	2.7
CN4610900000000	46	109	Roberts County, SD	2000	NA	4617	4442	175	3.8
CN4611100000000	46	111	Sanborn County, SD	2000	NA	1482	1447	35	2.4
CN4611500000000	46	115	Spink County, SD	2000	NA	3534	3428	106	3
CN4611700000000	46	117	Stanley County, SD	2000	NA	1852	1818	34	1.8
CN4611900000000	46	119	Sully County, SD	2000	NA	913	893	20	2.2
CN4612100000000	46	121	Todd County, SD	2000	NA	2968	2837	131	4.4
CN4612300000000	46	123	Tripp County, SD	2000	NA	3304	3217	87	2.6
CN4612500000000	46	125	Turner County, SD	2000	NA	4783	4678	105	2.2
CN4612700000000	46	127	Union County, SD	2000	NA	7299	7122	177	2.4
CN4612900000000	46	129	Walworth County, SD	2000	NA	2887	2791	96	3.3
CN4613500000000	46	135	Yankton County, SD	2000	NA	11458	11207	251	2.2
CN4613700000000	46	137	Ziebach County, SD	2000	NA	754	697	57	7.6
CN4700100000000	47	001	Anderson County, TN	2000	NA	33715	32337	1378	4.1
CN4700300000000	47	003	Bedford County, TN	2000	NA	19555	18677	878	4.5
CN4700500000000	47	005	Benton County, TN	2000	NA	7303	6771	532	7.3
CN4700700000000	47	007	Bledsoe County, TN	2000	NA	5093	4891	202	4
CN4700900000000	47	009	Blount County, TN	2000	NA	53818	51944	1874	3.5
CN4701100000000	47	011	Bradley County, TN	2000	NA	45225	43645	1580	3.5
CN4701300000000	47	013	Campbell County, TN	2000	NA	16015	15063	952	5.9
CN4701500000000	47	015	Cannon County, TN	2000	NA	6346	6125	221	3.5
CN4701700000000	47	017	Carroll County, TN	2000	NA	14186	13093	1093	7.7
CN4701900000000	47	019	Carter County, TN	2000	NA	27559	26261	1298	4.7
CN4702100000000	47	021	Cheatham County, TN	2000	NA	19473	18944	529	2.7
CN4702300000000	47	023	Chester County, TN	2000	NA	7603	7298	305	4
CN4702500000000	47	025	Claiborne County, TN	2000	NA	12563	11947	616	4.9
CN4702700000000	47	027	Clay County, TN	2000	NA	3688	3452	236	6.4
CN4702900000000	47	029	Cocke County, TN	2000	NA	15531	14551	980	6.3
CN4703100000000	47	031	Coffee County, TN	2000	NA	23466	22547	919	3.9
CN4703300000000	47	033	Crockett County, TN	2000	NA	6809	6494	315	4.6
CN4703500000000	47	035	Cumberland County, TN	2000	NA	20324	19333	991	4.9
CN4703700000000	47	037	Davidson County, TN	2000	NA	308521	298970	9551	3.1
CN4703900000000	47	039	Decatur County, TN	2000	NA	5660	5362	298	5.3
CN4704100000000	47	041	DeKalb County, TN	2000	NA	8572	8175	397	4.6
CN4704300000000	47	043	Dickson County, TN	2000	NA	22074	21296	778	3.5
CN4704500000000	47	045	Dyer County, TN	2000	NA	17958	17049	909	5.1
CN4704700000000	47	047	Fayette County, TN	2000	NA	13946	13329	617	4.4
CN4704900000000	47	049	Fentress County, TN	2000	NA	6841	6341	500	7.3
CN4705100000000	47	051	Franklin County, TN	2000	NA	18679	17965	714	3.8
CN4705300000000	47	053	Gibson County, TN	2000	NA	23160	21946	1214	5.2
CN4705500000000	47	055	Giles County, TN	2000	NA	14857	14221	636	4.3
CN4705700000000	47	057	Grainger County, TN	2000	NA	9662	9232	430	4.5
CN4705900000000	47	059	Greene County, TN	2000	NA	31531	29722	1809	5.7
CN4706100000000	47	061	Grundy County, TN	2000	NA	5648	5373	275	4.9
CN4706300000000	47	063	Hamblen County, TN	2000	NA	29462	28306	1156	3.9
CN4706500000000	47	065	Hamilton County, TN	2000	NA	159100	153944	5156	3.2
CN4706700000000	47	067	Hancock County, TN	2000	NA	2645	2512	133	5
CN4706900000000	47	069	Hardeman County, TN	2000	NA	11001	10446	555	5
CN4707100000000	47	071	Hardin County, TN	2000	NA	11606	10995	611	5.3
CN4707300000000	47	073	Hawkins County, TN	2000	NA	24443	23433	1010	4.1
CN4707500000000	47	075	Haywood County, TN	2000	NA	9250	8741	509	5.5
CN4707700000000	47	077	Henderson County, TN	2000	NA	12798	12174	624	4.9
CN4707900000000	47	079	Henry County, TN	2000	NA	14728	14019	709	4.8
CN4708100000000	47	081	Hickman County, TN	2000	NA	9767	9374	393	4
CN4708300000000	47	083	Houston County, TN	2000	NA	3666	3454	212	5.8
CN4708500000000	47	085	Humphreys County, TN	2000	NA	8864	8428	436	4.9
CN4708700000000	47	087	Jackson County, TN	2000	NA	5051	4739	312	6.2
CN4708900000000	47	089	Jefferson County, TN	2000	NA	22368	21424	944	4.2
CN4709100000000	47	091	Johnson County, TN	2000	NA	6900	6446	454	6.6
CN4709300000000	47	093	Knox County, TN	2000	NA	200467	194379	6088	3
CN4709500000000	47	095	Lake County, TN	2000	NA	2541	2385	156	6.1
CN4709700000000	47	097	Lauderdale County, TN	2000	NA	11177	10612	565	5.1
CN4709900000000	47	099	Lawrence County, TN	2000	NA	18922	17192	1730	9.1
CN4710100000000	47	101	Lewis County, TN	2000	NA	5254	4971	283	5.4
CN4710300000000	47	103	Lincoln County, TN	2000	NA	15736	15185	551	3.5
CN4710500000000	47	105	Loudon County, TN	2000	NA	19422	18744	678	3.5
CN4710700000000	47	107	McMinn County, TN	2000	NA	23485	22444	1041	4.4
CN4710900000000	47	109	McNairy County, TN	2000	NA	11705	11196	509	4.3
CN4711100000000	47	111	Macon County, TN	2000	NA	10165	9792	373	3.7
CN4711300000000	47	113	Madison County, TN	2000	NA	46566	44878	1688	3.6
CN4711500000000	47	115	Marion County, TN	2000	NA	13012	12438	574	4.4
CN4711700000000	47	117	Marshall County, TN	2000	NA	13924	13435	489	3.5
CN4711900000000	47	119	Maury County, TN	2000	NA	36688	35408	1280	3.5
CN4712100000000	47	121	Meigs County, TN	2000	NA	4858	4611	247	5.1
CN4712300000000	47	123	Monroe County, TN	2000	NA	17346	16428	918	5.3
CN4712500000000	47	125	Montgomery County, TN	2000	NA	59228	57034	2194	3.7
CN4712700000000	47	127	Moore County, TN	2000	NA	2906	2817	89	3.1
CN4712900000000	47	129	Morgan County, TN	2000	NA	7984	7582	402	5
CN4713100000000	47	131	Obion County, TN	2000	NA	16226	15541	685	4.2
CN4713300000000	47	133	Overton County, TN	2000	NA	9581	9076	505	5.3
CN4713500000000	47	135	Perry County, TN	2000	NA	3477	3299	178	5.1
CN4713700000000	47	137	Pickett County, TN	2000	NA	2263	2149	114	5
CN4713900000000	47	139	Polk County, TN	2000	NA	7464	7135	329	4.4
CN4714100000000	47	141	Putnam County, TN	2000	NA	31695	30326	1369	4.3
CN4714300000000	47	143	Rhea County, TN	2000	NA	13284	12672	612	4.6
CN4714500000000	47	145	Roane County, TN	2000	NA	24651	23614	1037	4.2
CN4714700000000	47	147	Robertson County, TN	2000	NA	29505	28478	1027	3.5
CN4714900000000	47	149	Rutherford County, TN	2000	NA	102345	99271	3074	3
CN4715100000000	47	151	Scott County, TN	2000	NA	8605	8162	443	5.1
CN4715300000000	47	153	Sequatchie County, TN	2000	NA	5317	5115	202	3.8
CN4715500000000	47	155	Sevier County, TN	2000	NA	39426	37500	1926	4.9
CN4715700000000	47	157	Shelby County, TN	2000	NA	438053	421418	16635	3.8
CN4715900000000	47	159	Smith County, TN	2000	NA	8879	8502	377	4.2
CN4716100000000	47	161	Stewart County, TN	2000	NA	5488	5226	262	4.8
CN4716300000000	47	163	Sullivan County, TN	2000	NA	72620	69973	2647	3.6
CN4716500000000	47	165	Sumner County, TN	2000	NA	70256	68028	2228	3.2
CN4716700000000	47	167	Tipton County, TN	2000	NA	25059	24147	912	3.6
CN4716900000000	47	169	Trousdale County, TN	2000	NA	3542	3423	119	3.4
CN4717100000000	47	171	Unicoi County, TN	2000	NA	8261	7705	556	6.7
CN4717300000000	47	173	Union County, TN	2000	NA	8047	7743	304	3.8
CN4717500000000	47	175	Van Buren County, TN	2000	NA	2651	2530	121	4.6
CN4717700000000	47	177	Warren County, TN	2000	NA	19374	18591	783	4
CN4717900000000	47	179	Washington County, TN	2000	NA	54816	52670	2146	3.9
CN4718100000000	47	181	Wayne County, TN	2000	NA	6679	6138	541	8.1
CN4718300000000	47	183	Weakley County, TN	2000	NA	16760	15942	818	4.9
CN4718500000000	47	185	White County, TN	2000	NA	10906	10413	493	4.5
CN4718700000000	47	187	Williamson County, TN	2000	NA	69784	68072	1712	2.5
CN4718900000000	47	189	Wilson County, TN	2000	NA	49650	48107	1543	3.1
CN4800100000000	48	001	Anderson County, TX	2000	NA	19623	18442	1181	6
CN4800300000000	48	003	Andrews County, TX	2000	NA	5628	5354	274	4.9
CN4800500000000	48	005	Angelina County, TX	2000	NA	37984	36179	1805	4.8
CN4800700000000	48	007	Aransas County, TX	2000	NA	9737	9166	571	5.9
CN4800900000000	48	009	Archer County, TX	2000	NA	4871	4717	154	3.2
CN4801100000000	48	011	Armstrong County, TX	2000	NA	1090	1056	34	3.1
CN4801300000000	48	013	Atascosa County, TX	2000	NA	17239	16536	703	4.1
CN4801500000000	48	015	Austin County, TX	2000	NA	12019	11551	468	3.9
CN4801700000000	48	017	Bailey County, TX	2000	NA	3194	3049	145	4.5
CN4801900000000	48	019	Bandera County, TX	2000	NA	8711	8396	315	3.6
CN4802100000000	48	021	Bastrop County, TX	2000	NA	29727	28723	1004	3.4
CN4802300000000	48	023	Baylor County, TX	2000	NA	1849	1764	85	4.6
CN4802500000000	48	025	Bee County, TX	2000	NA	11323	10663	660	5.8
CN4802700000000	48	027	Bell County, TX	2000	NA	101432	97227	4205	4.1
CN4802900000000	48	029	Bexar County, TX	2000	NA	662639	636095	26544	4
CN4803100000000	48	031	Blanco County, TX	2000	NA	4476	4336	140	3.1
CN4803300000000	48	033	Borden County, TX	2000	NA	422	395	27	6.4
CN4803500000000	48	035	Bosque County, TX	2000	NA	8067	7734	333	4.1
CN4803700000000	48	037	Bowie County, TX	2000	NA	40492	38519	1973	4.9
CN4803900000000	48	039	Brazoria County, TX	2000	NA	120108	114243	5865	4.9
CN4804100000000	48	041	Brazos County, TX	2000	NA	78711	75832	2879	3.7
CN4804300000000	48	043	Brewster County, TX	2000	NA	4561	4385	176	3.9
CN4804500000000	48	045	Briscoe County, TX	2000	NA	911	878	33	3.6
CN4804700000000	48	047	Brooks County, TX	2000	NA	2889	2695	194	6.7
CN4804900000000	48	049	Brown County, TX	2000	NA	17680	16897	783	4.4
CN4805100000000	48	051	Burleson County, TX	2000	NA	7725	7419	306	4
CN4805300000000	48	053	Burnet County, TX	2000	NA	17197	16595	602	3.5
CN4805500000000	48	055	Caldwell County, TX	2000	NA	15106	14495	611	4
CN4805700000000	48	057	Calhoun County, TX	2000	NA	9353	8920	433	4.6
CN4805900000000	48	059	Callahan County, TX	2000	NA	6214	5977	237	3.8
CN4806100000000	48	061	Cameron County, TX	2000	NA	127268	118477	8791	6.9
CN4806300000000	48	063	Camp County, TX	2000	NA	5220	4952	268	5.1
CN4806500000000	48	065	Carson County, TX	2000	NA	3356	3248	108	3.2
CN4806700000000	48	067	Cass County, TX	2000	NA	13542	12754	788	5.8
CN4806900000000	48	069	Castro County, TX	2000	NA	3992	3848	144	3.6
CN4807100000000	48	071	Chambers County, TX	2000	NA	13112	12561	551	4.2
CN4807300000000	48	073	Cherokee County, TX	2000	NA	20935	19976	959	4.6
CN4807500000000	48	075	Childress County, TX	2000	NA	2984	2845	139	4.7
CN4807700000000	48	077	Clay County, TX	2000	NA	5959	5748	211	3.5
CN4807900000000	48	079	Cochran County, TX	2000	NA	1591	1498	93	5.8
CN4808100000000	48	081	Coke County, TX	2000	NA	1663	1593	70	4.2
CN4808300000000	48	083	Coleman County, TX	2000	NA	4220	4020	200	4.7
CN4808500000000	48	085	Collin County, TX	2000	NA	300048	291653	8395	2.8
CN4808700000000	48	087	Collingsworth County, TX	2000	NA	1534	1477	57	3.7
CN4808900000000	48	089	Colorado County, TX	2000	NA	9930	9559	371	3.7
CN4809100000000	48	091	Comal County, TX	2000	NA	40428	39018	1410	3.5
CN4809300000000	48	093	Comanche County, TX	2000	NA	6687	6427	260	3.9
CN4809500000000	48	095	Concho County, TX	2000	NA	1437	1357	80	5.6
CN4809700000000	48	097	Cooke County, TX	2000	NA	18675	17999	676	3.6
CN4809900000000	48	099	Coryell County, TX	2000	NA	23964	22699	1265	5.3
CN4810100000000	48	101	Cottle County, TX	2000	NA	951	910	41	4.3
CN4810300000000	48	103	Crane County, TX	2000	NA	1613	1527	86	5.3
CN4810500000000	48	105	Crockett County, TX	2000	NA	2045	1969	76	3.7
CN4810700000000	48	107	Crosby County, TX	2000	NA	2982	2847	135	4.5
CN4810900000000	48	109	Culberson County, TX	2000	NA	1493	1409	84	5.6
CN4811100000000	48	111	Dallam County, TX	2000	NA	3286	3177	109	3.3
CN4811300000000	48	113	Dallas County, TX	2000	NA	1187494	1142138	45356	3.8
CN4811500000000	48	115	Dawson County, TX	2000	NA	5850	5544	306	5.2
CN4811700000000	48	117	Deaf Smith County, TX	2000	NA	8248	7854	394	4.8
CN4811900000000	48	119	Delta County, TX	2000	NA	2569	2440	129	5
CN4812100000000	48	121	Denton County, TX	2000	NA	267721	260275	7446	2.8
CN4812300000000	48	123	DeWitt County, TX	2000	NA	8989	8606	383	4.3
CN4812500000000	48	125	Dickens County, TX	2000	NA	1136	1078	58	5.1
CN4812700000000	48	127	Dimmit County, TX	2000	NA	3862	3530	332	8.6
CN4812900000000	48	129	Donley County, TX	2000	NA	1869	1793	76	4.1
CN4813100000000	48	131	Duval County, TX	2000	NA	5014	4665	349	7
CN4813300000000	48	133	Eastland County, TX	2000	NA	8594	8187	407	4.7
CN4813500000000	48	135	Ector County, TX	2000	NA	56621	53610	3011	5.3
CN4813700000000	48	137	Edwards County, TX	2000	NA	954	913	41	4.3
CN4813900000000	48	139	Ellis County, TX	2000	NA	60192	58069	2123	3.5
CN4814100000000	48	141	El Paso County, TX	2000	NA	275363	256975	18388	6.7
CN4814300000000	48	143	Erath County, TX	2000	NA	16598	16001	597	3.6
CN4814500000000	48	145	Falls County, TX	2000	NA	7201	6815	386	5.4
CN4814700000000	48	147	Fannin County, TX	2000	NA	13949	13282	667	4.8
CN4814900000000	48	149	Fayette County, TX	2000	NA	11442	11054	388	3.4
CN4815100000000	48	151	Fisher County, TX	2000	NA	2158	2076	82	3.8
CN4815300000000	48	153	Floyd County, TX	2000	NA	3479	3313	166	4.8
CN4815500000000	48	155	Foard County, TX	2000	NA	795	765	30	3.8
CN4815700000000	48	157	Fort Bend County, TX	2000	NA	185694	179151	6543	3.5
CN4815900000000	48	159	Franklin County, TX	2000	NA	4435	4249	186	4.2
CN4816100000000	48	161	Freestone County, TX	2000	NA	7902	7504	398	5
CN4816300000000	48	163	Frio County, TX	2000	NA	6168	5796	372	6
CN4816500000000	48	165	Gaines County, TX	2000	NA	6248	5981	267	4.3
CN4816700000000	48	167	Galveston County, TX	2000	NA	128041	121875	6166	4.8
CN4816900000000	48	169	Garza County, TX	2000	NA	2123	2031	92	4.3
CN4817100000000	48	171	Gillespie County, TX	2000	NA	10537	10133	404	3.8
CN4817300000000	48	173	Glasscock County, TX	2000	NA	728	706	22	3
CN4817500000000	48	175	Goliad County, TX	2000	NA	3337	3211	126	3.8
CN4817700000000	48	177	Gonzales County, TX	2000	NA	9117	8803	314	3.4
CN4817900000000	48	179	Gray County, TX	2000	NA	9991	9495	496	5
CN4818100000000	48	181	Grayson County, TX	2000	NA	56405	54152	2253	4
CN4818300000000	48	183	Gregg County, TX	2000	NA	55252	52286	2966	5.4
CN4818500000000	48	185	Grimes County, TX	2000	NA	9970	9440	530	5.3
CN4818700000000	48	187	Guadalupe County, TX	2000	NA	45406	43873	1533	3.4
CN4818900000000	48	189	Hale County, TX	2000	NA	16959	16204	755	4.5
CN4819100000000	48	191	Hall County, TX	2000	NA	1720	1630	90	5.2
CN4819300000000	48	193	Hamilton County, TX	2000	NA	4052	3901	151	3.7
CN4819500000000	48	195	Hansford County, TX	2000	NA	2828	2745	83	2.9
CN4819700000000	48	197	Hardeman County, TX	2000	NA	2455	2366	89	3.6
CN4819900000000	48	199	Hardin County, TX	2000	NA	23214	21933	1281	5.5
CN4820100000000	48	201	Harris County, TX	2000	NA	1725910	1652532	73378	4.3
CN4820300000000	48	203	Harrison County, TX	2000	NA	29417	27973	1444	4.9
CN4820500000000	48	205	Hartley County, TX	2000	NA	2431	2355	76	3.1
CN4820700000000	48	207	Haskell County, TX	2000	NA	2903	2781	122	4.2
CN4820900000000	48	209	Hays County, TX	2000	NA	56709	54900	1809	3.2
CN4821100000000	48	211	Hemphill County, TX	2000	NA	1844	1791	53	2.9
CN4821300000000	48	213	Henderson County, TX	2000	NA	32897	31530	1367	4.2
CN4821500000000	48	215	Hidalgo County, TX	2000	NA	211320	192190	19130	9.1
CN4821700000000	48	217	Hill County, TX	2000	NA	15243	14555	688	4.5
CN4821900000000	48	219	Hockley County, TX	2000	NA	10919	10480	439	4
CN4822100000000	48	221	Hood County, TX	2000	NA	20324	19527	797	3.9
CN4822300000000	48	223	Hopkins County, TX	2000	NA	16398	15745	653	4
CN4822500000000	48	225	Houston County, TX	2000	NA	9081	8618	463	5.1
CN4822700000000	48	227	Howard County, TX	2000	NA	13606	12920	686	5
CN4822900000000	48	229	Hudspeth County, TX	2000	NA	1318	1259	59	4.5
CN4823100000000	48	231	Hunt County, TX	2000	NA	38897	37275	1622	4.2
CN4823300000000	48	233	Hutchinson County, TX	2000	NA	11023	10500	523	4.7
CN4823500000000	48	235	Irion County, TX	2000	NA	944	914	30	3.2
CN4823700000000	48	237	Jack County, TX	2000	NA	3795	3636	159	4.2
CN4823900000000	48	239	Jackson County, TX	2000	NA	6813	6563	250	3.7
CN4824100000000	48	241	Jasper County, TX	2000	NA	15360	14267	1093	7.1
CN4824300000000	48	243	Jeff Davis County, TX	2000	NA	1165	1121	44	3.8
CN4824500000000	48	245	Jefferson County, TX	2000	NA	112867	105605	7262	6.4
CN4824700000000	48	247	Jim Hogg County, TX	2000	NA	2183	2054	129	5.9
CN4824900000000	48	249	Jim Wells County, TX	2000	NA	16688	15702	986	5.9
CN4825100000000	48	251	Johnson County, TX	2000	NA	66490	64001	2489	3.7
CN4825300000000	48	253	Jones County, TX	2000	NA	7688	7297	391	5.1
CN4825500000000	48	255	Karnes County, TX	2000	NA	5382	5098	284	5.3
CN4825700000000	48	257	Kaufman County, TX	2000	NA	37629	36121	1508	4
CN4825900000000	48	259	Kendall County, TX	2000	NA	12109	11707	402	3.3
CN4826100000000	48	261	Kenedy County, TX	2000	NA	207	200	7	3.4
CN4826300000000	48	263	Kent County, TX	2000	NA	444	427	17	3.8
CN4826500000000	48	265	Kerr County, TX	2000	NA	19283	18557	726	3.8
CN4826700000000	48	267	Kimble County, TX	2000	NA	2260	2182	78	3.5
CN4826900000000	48	269	King County, TX	2000	NA	212	205	7	3.3
CN4827100000000	48	271	Kinney County, TX	2000	NA	1209	1120	89	7.4
CN4827300000000	48	273	Kleberg County, TX	2000	NA	13897	13204	693	5
CN4827500000000	48	275	Knox County, TX	2000	NA	1860	1774	86	4.6
CN4827700000000	48	277	Lamar County, TX	2000	NA	23080	21954	1126	4.9
CN4827900000000	48	279	Lamb County, TX	2000	NA	6921	6582	339	4.9
CN4828100000000	48	281	Lampasas County, TX	2000	NA	8643	8315	328	3.8
CN4828300000000	48	283	La Salle County, TX	2000	NA	2203	2049	154	7
CN4828500000000	48	285	Lavaca County, TX	2000	NA	9614	9315	299	3.1
CN4828700000000	48	287	Lee County, TX	2000	NA	8233	7945	288	3.5
CN4828900000000	48	289	Leon County, TX	2000	NA	7033	6677	356	5.1
CN4829100000000	48	291	Liberty County, TX	2000	NA	30255	28492	1763	5.8
CN4829300000000	48	293	Limestone County, TX	2000	NA	9579	9130	449	4.7
CN4829500000000	48	295	Lipscomb County, TX	2000	NA	1486	1436	50	3.4
CN4829700000000	48	297	Live Oak County, TX	2000	NA	4853	4636	217	4.5
CN4829900000000	48	299	Llano County, TX	2000	NA	7372	7066	306	4.2
CN4830100000000	48	301	Loving County, TX	2000	NA	49	45	4	8.2
CN4830300000000	48	303	Lubbock County, TX	2000	NA	128169	123663	4506	3.5
CN4830500000000	48	305	Lynn County, TX	2000	NA	2994	2873	121	4
CN4830700000000	48	307	McCulloch County, TX	2000	NA	3696	3502	194	5.2
CN4830900000000	48	309	McLennan County, TX	2000	NA	103923	99660	4263	4.1
CN4831100000000	48	311	McMullen County, TX	2000	NA	400	384	16	4
CN4831300000000	48	313	Madison County, TX	2000	NA	4852	4618	234	4.8
CN4831500000000	48	315	Marion County, TX	2000	NA	4654	4360	294	6.3
CN4831700000000	48	317	Martin County, TX	2000	NA	2137	2053	84	3.9
CN4831900000000	48	319	Mason County, TX	2000	NA	2023	1964	59	2.9
CN4832100000000	48	321	Matagorda County, TX	2000	NA	17312	16174	1138	6.6
CN4832300000000	48	323	Maverick County, TX	2000	NA	16493	14048	2445	14.8
CN4832500000000	48	325	Medina County, TX	2000	NA	17979	17274	705	3.9
CN4832700000000	48	327	Menard County, TX	2000	NA	1171	1130	41	3.5
CN4832900000000	48	329	Midland County, TX	2000	NA	58272	55862	2410	4.1
CN4833100000000	48	331	Milam County, TX	2000	NA	11612	11178	434	3.7
CN4833300000000	48	333	Mills County, TX	2000	NA	2464	2377	87	3.5
CN4833500000000	48	335	Mitchell County, TX	2000	NA	3434	3246	188	5.5
CN4833700000000	48	337	Montague County, TX	2000	NA	9245	8810	435	4.7
CN4833900000000	48	339	Montgomery County, TX	2000	NA	152809	147292	5517	3.6
CN4834100000000	48	341	Moore County, TX	2000	NA	9704	9389	315	3.2
CN4834300000000	48	343	Morris County, TX	2000	NA	5949	5574	375	6.3
CN4834500000000	48	345	Motley County, TX	2000	NA	705	681	24	3.4
CN4834700000000	48	347	Nacogdoches County, TX	2000	NA	29104	27849	1255	4.3
CN4834900000000	48	349	Navarro County, TX	2000	NA	21126	20083	1043	4.9
CN4835100000000	48	351	Newton County, TX	2000	NA	6109	5629	480	7.9
CN4835300000000	48	353	Nolan County, TX	2000	NA	7346	6995	351	4.8
CN4835500000000	48	355	Nueces County, TX	2000	NA	148091	140405	7686	5.2
CN4835700000000	48	357	Ochiltree County, TX	2000	NA	4776	4629	147	3.1
CN4835900000000	48	359	Oldham County, TX	2000	NA	1155	1118	37	3.2
CN4836100000000	48	361	Orange County, TX	2000	NA	40681	37896	2785	6.8
CN4836300000000	48	363	Palo Pinto County, TX	2000	NA	13357	12809	548	4.1
CN4836500000000	48	365	Panola County, TX	2000	NA	10407	9827	580	5.6
CN4836700000000	48	367	Parker County, TX	2000	NA	46358	44720	1638	3.5
CN4836900000000	48	369	Parmer County, TX	2000	NA	4499	4348	151	3.4
CN4837100000000	48	371	Pecos County, TX	2000	NA	7000	6651	349	5
CN4837300000000	48	373	Polk County, TX	2000	NA	15901	14977	924	5.8
CN4837500000000	48	375	Potter County, TX	2000	NA	53014	50203	2811	5.3
CN4837700000000	48	377	Presidio County, TX	2000	NA	3186	2662	524	16.4
CN4837900000000	48	379	Rains County, TX	2000	NA	4365	4196	169	3.9
CN4838100000000	48	381	Randall County, TX	2000	NA	60362	58861	1501	2.5
CN4838300000000	48	383	Reagan County, TX	2000	NA	1626	1570	56	3.4
CN4838500000000	48	385	Real County, TX	2000	NA	1390	1329	61	4.4
CN4838700000000	48	387	Red River County, TX	2000	NA	6790	6462	328	4.8
CN4838900000000	48	389	Reeves County, TX	2000	NA	5044	4605	439	8.7
CN4839100000000	48	391	Refugio County, TX	2000	NA	3695	3539	156	4.2
CN4839300000000	48	393	Roberts County, TX	2000	NA	514	501	13	2.5
CN4839500000000	48	395	Robertson County, TX	2000	NA	6969	6650	319	4.6
CN4839700000000	48	397	Rockwall County, TX	2000	NA	24320	23596	724	3
CN4839900000000	48	399	Runnels County, TX	2000	NA	5289	5041	248	4.7
CN4840100000000	48	401	Rusk County, TX	2000	NA	21093	20060	1033	4.9
CN4840300000000	48	403	Sabine County, TX	2000	NA	3772	3457	315	8.4
CN4840500000000	48	405	San Augustine County, TX	2000	NA	3749	3554	195	5.2
CN4840700000000	48	407	San Jacinto County, TX	2000	NA	9400	8964	436	4.6
CN4840900000000	48	409	San Patricio County, TX	2000	NA	27483	25882	1601	5.8
CN4841100000000	48	411	San Saba County, TX	2000	NA	2808	2691	117	4.2
CN4841300000000	48	413	Schleicher County, TX	2000	NA	1509	1453	56	3.7
CN4841500000000	48	415	Scurry County, TX	2000	NA	7235	6891	344	4.8
CN4841700000000	48	417	Shackelford County, TX	2000	NA	1646	1590	56	3.4
CN4841900000000	48	419	Shelby County, TX	2000	NA	11365	10778	587	5.2
CN4842100000000	48	421	Sherman County, TX	2000	NA	1629	1585	44	2.7
CN4842300000000	48	423	Smith County, TX	2000	NA	86479	82708	3771	4.4
CN4842500000000	48	425	Somervell County, TX	2000	NA	3465	3323	142	4.1
CN4842700000000	48	427	Starr County, TX	2000	NA	17725	14791	2934	16.6
CN4842900000000	48	429	Stephens County, TX	2000	NA	4377	4191	186	4.2
CN4843100000000	48	431	Sterling County, TX	2000	NA	730	706	24	3.3
CN4843300000000	48	433	Stonewall County, TX	2000	NA	822	787	35	4.3
CN4843500000000	48	435	Sutton County, TX	2000	NA	2157	2075	82	3.8
CN4843700000000	48	437	Swisher County, TX	2000	NA	3886	3732	154	4
CN4843900000000	48	439	Tarrant County, TX	2000	NA	794779	766783	27996	3.5
CN4844100000000	48	441	Taylor County, TX	2000	NA	61423	58955	2468	4
CN4844300000000	48	443	Terrell County, TX	2000	NA	514	494	20	3.9
CN4844500000000	48	445	Terry County, TX	2000	NA	5612	5339	273	4.9
CN4844700000000	48	447	Throckmorton County, TX	2000	NA	976	943	33	3.4
CN4844900000000	48	449	Titus County, TX	2000	NA	12775	12218	557	4.4
CN4845100000000	48	451	Tom Green County, TX	2000	NA	50754	48790	1964	3.9
CN4845300000000	48	453	Travis County, TX	2000	NA	491981	477302	14679	3
CN4845500000000	48	455	Trinity County, TX	2000	NA	5764	5461	303	5.3
CN4845700000000	48	457	Tyler County, TX	2000	NA	7930	7402	528	6.7
CN4845900000000	48	459	Upshur County, TX	2000	NA	16521	15721	800	4.8
CN4846100000000	48	461	Upton County, TX	2000	NA	1511	1439	72	4.8
CN4846300000000	48	463	Uvalde County, TX	2000	NA	11392	10748	644	5.7
CN4846500000000	48	465	Val Verde County, TX	2000	NA	17348	16270	1078	6.2
CN4846700000000	48	467	Van Zandt County, TX	2000	NA	22609	21721	888	3.9
CN4846900000000	48	469	Victoria County, TX	2000	NA	43154	41566	1588	3.7
CN4847100000000	48	471	Walker County, TX	2000	NA	25139	23980	1159	4.6
CN4847300000000	48	473	Waller County, TX	2000	NA	15332	14662	670	4.4
CN4847500000000	48	475	Ward County, TX	2000	NA	4454	4179	275	6.2
CN4847700000000	48	477	Washington County, TX	2000	NA	15100	14544	556	3.7
CN4847900000000	48	479	Webb County, TX	2000	NA	70985	66705	4280	6
CN4848100000000	48	481	Wharton County, TX	2000	NA	20207	19347	860	4.3
CN4848300000000	48	483	Wheeler County, TX	2000	NA	2708	2603	105	3.9
CN4848500000000	48	485	Wichita County, TX	2000	NA	60999	58206	2793	4.6
CN4848700000000	48	487	Wilbarger County, TX	2000	NA	7233	6963	270	3.7
CN4848900000000	48	489	Willacy County, TX	2000	NA	7288	6574	714	9.8
CN4849100000000	48	491	Williamson County, TX	2000	NA	145239	141290	3949	2.7
CN4849300000000	48	493	Wilson County, TX	2000	NA	15531	14970	561	3.6
CN4849500000000	48	495	Winkler County, TX	2000	NA	2934	2768	166	5.7
CN4849700000000	48	497	Wise County, TX	2000	NA	25344	24477	867	3.4
CN4849900000000	48	499	Wood County, TX	2000	NA	16282	15468	814	5
CN4850100000000	48	501	Yoakum County, TX	2000	NA	3317	3144	173	5.2
CN4850300000000	48	503	Young County, TX	2000	NA	8843	8406	437	4.9
CN4850500000000	48	505	Zapata County, TX	2000	NA	3984	3667	317	8
CN4850700000000	48	507	Zavala County, TX	2000	NA	3713	3255	458	12.3
CN4900100000000	49	001	Beaver County, UT	2000	NA	2703	2610	93	3.4
CN4900300000000	49	003	Box Elder County, UT	2000	NA	20084	19342	742	3.7
CN4900500000000	49	005	Cache County, UT	2000	NA	48230	46887	1343	2.8
CN4900700000000	49	007	Carbon County, UT	2000	NA	9275	8754	521	5.6
CN4900900000000	49	009	Daggett County, UT	2000	NA	463	445	18	3.9
CN4901100000000	49	011	Davis County, UT	2000	NA	120157	116416	3741	3.1
CN4901300000000	49	013	Duchesne County, UT	2000	NA	6128	5826	302	4.9
CN4901500000000	49	015	Emery County, UT	2000	NA	4728	4501	227	4.8
CN4901700000000	49	017	Garfield County, UT	2000	NA	2483	2315	168	6.8
CN4901900000000	49	019	Grand County, UT	2000	NA	4645	4341	304	6.5
CN4902100000000	49	021	Iron County, UT	2000	NA	16898	16349	549	3.2
CN4902300000000	49	023	Juab County, UT	2000	NA	3752	3619	133	3.5
CN4902500000000	49	025	Kane County, UT	2000	NA	3028	2913	115	3.8
CN4902700000000	49	027	Millard County, UT	2000	NA	5190	5011	179	3.4
CN4902900000000	49	029	Morgan County, UT	2000	NA	3417	3300	117	3.4
CN4903100000000	49	031	Piute County, UT	2000	NA	626	598	28	4.5
CN4903300000000	49	033	Rich County, UT	2000	NA	1045	1014	31	3
CN4903500000000	49	035	Salt Lake County, UT	2000	NA	486372	471013	15359	3.2
CN4903700000000	49	037	San Juan County, UT	2000	NA	4724	4348	376	8
CN4903900000000	49	039	Sanpete County, UT	2000	NA	9683	9257	426	4.4
CN4904100000000	49	041	Sevier County, UT	2000	NA	8337	8014	323	3.9
CN4904300000000	49	043	Summit County, UT	2000	NA	18262	17627	635	3.5
CN4904500000000	49	045	Tooele County, UT	2000	NA	20262	19518	744	3.7
CN4904700000000	49	047	Uintah County, UT	2000	NA	11400	10917	483	4.2
CN4904900000000	49	049	Utah County, UT	2000	NA	181131	175815	5316	2.9
CN4905100000000	49	051	Wasatch County, UT	2000	NA	7781	7509	272	3.5
CN4905300000000	49	053	Washington County, UT	2000	NA	39358	37977	1381	3.5
CN4905500000000	49	055	Wayne County, UT	2000	NA	1318	1258	60	4.6
CN4905700000000	49	057	Weber County, UT	2000	NA	100567	96313	4254	4.2
CN5000100000000	50	001	Addison County, VT	2000	NA	19571	19057	514	2.6
CN5000300000000	50	003	Bennington County, VT	2000	NA	19677	19096	581	3
CN5000500000000	50	005	Caledonia County, VT	2000	NA	15289	14776	513	3.4
CN5000700000000	50	007	Chittenden County, VT	2000	NA	84114	82190	1924	2.3
CN5000900000000	50	009	Essex County, VT	2000	NA	3224	3095	129	4
CN5001100000000	50	011	Franklin County, VT	2000	NA	24212	23494	718	3
CN5001300000000	50	013	Grand Isle County, VT	2000	NA	3737	3591	146	3.9
CN5001500000000	50	015	Lamoille County, VT	2000	NA	13188	12767	421	3.2
CN5001700000000	50	017	Orange County, VT	2000	NA	15339	14964	375	2.4
CN5001900000000	50	019	Orleans County, VT	2000	NA	12781	12219	562	4.4
CN5002100000000	50	021	Rutland County, VT	2000	NA	33166	32119	1047	3.2
CN5002300000000	50	023	Washington County, VT	2000	NA	32417	31536	881	2.7
CN5002500000000	50	025	Windham County, VT	2000	NA	24074	23394	680	2.8
CN5002700000000	50	027	Windsor County, VT	2000	NA	30600	29831	769	2.5
CN5100100000000	51	001	Accomack County, VA	2000	NA	18126	17583	543	3
CN5100300000000	51	003	Albemarle County, VA	2000	NA	43562	42810	752	1.7
CN5100500000000	51	005	Alleghany County, VA	2000	NA	7732	7496	236	3.1
CN5100700000000	51	007	Amelia County, VA	2000	NA	5866	5748	118	2
CN5100900000000	51	009	Amherst County, VA	2000	NA	15411	15082	329	2.1
CN5101100000000	51	011	Appomattox County, VA	2000	NA	6767	6599	168	2.5
CN5101300000000	51	013	Arlington County, VA	2000	NA	119330	117448	1882	1.6
CN5101500000000	51	015	Augusta County, VA	2000	NA	34596	33919	677	2
CN5101700000000	51	017	Bath County, VA	2000	NA	2738	2664	74	2.7
CN5101900000000	51	019	Bedford County, VA	2000	NA	34724	34038	686	2
CN5102100000000	51	021	Bland County, VA	2000	NA	2933	2779	154	5.3
CN5102300000000	51	023	Botetourt County, VA	2000	NA	16473	16178	295	1.8
CN5102500000000	51	025	Brunswick County, VA	2000	NA	6851	6609	242	3.5
CN5102700000000	51	027	Buchanan County, VA	2000	NA	8738	8223	515	5.9
CN5102900000000	51	029	Buckingham County, VA	2000	NA	6145	5947	198	3.2
CN5103100000000	51	031	Campbell County, VA	2000	NA	26509	25892	617	2.3
CN5103300000000	51	033	Caroline County, VA	2000	NA	10999	10758	241	2.2
CN5103500000000	51	035	Carroll County, VA	2000	NA	14817	14215	602	4.1
CN5103600000000	51	036	Charles City County, VA	2000	NA	3616	3526	90	2.5
CN5103700000000	51	037	Charlotte County, VA	2000	NA	5518	5343	175	3.2
CN5104100000000	51	041	Chesterfield County, VA	2000	NA	142307	139745	2562	1.8
CN5104300000000	51	043	Clarke County, VA	2000	NA	6908	6798	110	1.6
CN5104500000000	51	045	Craig County, VA	2000	NA	2503	2442	61	2.4
CN5104700000000	51	047	Culpeper County, VA	2000	NA	16930	16604	326	1.9
CN5104900000000	51	049	Cumberland County, VA	2000	NA	4237	4142	95	2.2
CN5105100000000	51	051	Dickenson County, VA	2000	NA	5365	5052	313	5.8
CN5105300000000	51	053	Dinwiddie County, VA	2000	NA	12037	11784	253	2.1
CN5105700000000	51	057	Essex County, VA	2000	NA	5151	5013	138	2.7
CN5105900000000	51	059	Fairfax County, VA	2000	NA	550713	541678	9035	1.6
CN5106100000000	51	061	Fauquier County, VA	2000	NA	30217	29747	470	1.6
CN5106300000000	51	063	Floyd County, VA	2000	NA	6977	6717	260	3.7
CN5106500000000	51	065	Fluvanna County, VA	2000	NA	10227	10024	203	2
CN5106700000000	51	067	Franklin County, VA	2000	NA	24379	23645	734	3
CN5106900000000	51	069	Frederick County, VA	2000	NA	32922	32247	675	2.1
CN5107100000000	51	071	Giles County, VA	2000	NA	7800	7467	333	4.3
CN5107300000000	51	073	Gloucester County, VA	2000	NA	17594	17252	342	1.9
CN5107500000000	51	075	Goochland County, VA	2000	NA	8916	8759	157	1.8
CN5107700000000	51	077	Grayson County, VA	2000	NA	8090	7678	412	5.1
CN5107900000000	51	079	Greene County, VA	2000	NA	8400	8245	155	1.8
CN5108100000000	51	081	Greensville County, VA	2000	NA	4012	3876	136	3.4
CN5108300000000	51	083	Halifax County, VA	2000	NA	16209	15392	817	5
CN5108500000000	51	085	Hanover County, VA	2000	NA	47485	46695	790	1.7
CN5108700000000	51	087	Henrico County, VA	2000	NA	145559	142902	2657	1.8
CN5108900000000	51	089	Henry County, VA	2000	NA	28865	27447	1418	4.9
CN5109100000000	51	091	Highland County, VA	2000	NA	1172	1138	34	2.9
CN5109300000000	51	093	Isle of Wight County, VA	2000	NA	14908	14583	325	2.2
CN5109500000000	51	095	James City County, VA	2000	NA	23292	22831	461	2
CN5109700000000	51	097	King and Queen County, VA	2000	NA	3161	3079	82	2.6
CN5109900000000	51	099	King George County, VA	2000	NA	8407	8243	164	2
CN5110100000000	51	101	King William County, VA	2000	NA	7029	6896	133	1.9
CN5110300000000	51	103	Lancaster County, VA	2000	NA	4851	4566	285	5.9
CN5110500000000	51	105	Lee County, VA	2000	NA	8830	8456	374	4.2
CN5110700000000	51	107	Loudoun County, VA	2000	NA	100070	98642	1428	1.4
CN5110900000000	51	109	Louisa County, VA	2000	NA	12886	12578	308	2.4
CN5111100000000	51	111	Lunenburg County, VA	2000	NA	5374	5187	187	3.5
CN5111300000000	51	113	Madison County, VA	2000	NA	6560	6443	117	1.8
CN5111500000000	51	115	Mathews County, VA	2000	NA	4259	4165	94	2.2
CN5111700000000	51	117	Mecklenburg County, VA	2000	NA	14247	13765	482	3.4
CN5111900000000	51	119	Middlesex County, VA	2000	NA	4545	4449	96	2.1
CN5112100000000	51	121	Montgomery County, VA	2000	NA	40823	39784	1039	2.5
CN5112500000000	51	125	Nelson County, VA	2000	NA	7033	6869	164	2.3
CN5112700000000	51	127	New Kent County, VA	2000	NA	7300	7165	135	1.8
CN5113100000000	51	131	Northampton County, VA	2000	NA	5603	5453	150	2.7
CN5113300000000	51	133	Northumberland County, VA	2000	NA	5441	5192	249	4.6
CN5113500000000	51	135	Nottoway County, VA	2000	NA	6172	5991	181	2.9
CN5113700000000	51	137	Orange County, VA	2000	NA	12737	12474	263	2.1
CN5113900000000	51	139	Page County, VA	2000	NA	11786	11474	312	2.6
CN5114100000000	51	141	Patrick County, VA	2000	NA	9509	9193	316	3.3
CN5114300000000	51	143	Pittsylvania County, VA	2000	NA	31960	30895	1065	3.3
CN5114500000000	51	145	Powhatan County, VA	2000	NA	11250	11045	205	1.8
CN5114700000000	51	147	Prince Edward County, VA	2000	NA	8133	7859	274	3.4
CN5114900000000	51	149	Prince George County, VA	2000	NA	13224	12884	340	2.6
CN5115300000000	51	153	Prince William County, VA	2000	NA	153614	150881	2733	1.8
CN5115500000000	51	155	Pulaski County, VA	2000	NA	17403	16607	796	4.6
CN5115700000000	51	157	Rappahannock County, VA	2000	NA	3753	3683	70	1.9
CN5115900000000	51	159	Richmond County, VA	2000	NA	3427	3277	150	4.4
CN5116100000000	51	161	Roanoke County, VA	2000	NA	46009	45205	804	1.7
CN5116300000000	51	163	Rockbridge County, VA	2000	NA	10674	10442	232	2.2
CN5116500000000	51	165	Rockingham County, VA	2000	NA	36123	35508	615	1.7
CN5116700000000	51	167	Russell County, VA	2000	NA	11865	11248	617	5.2
CN5116900000000	51	169	Scott County, VA	2000	NA	9771	9394	377	3.9
CN5117100000000	51	171	Shenandoah County, VA	2000	NA	18513	18179	334	1.8
CN5117300000000	51	173	Smyth County, VA	2000	NA	15862	15171	691	4.4
CN5117500000000	51	175	Southampton County, VA	2000	NA	7489	7281	208	2.8
CN5117700000000	51	177	Spotsylvania County, VA	2000	NA	48522	47689	833	1.7
CN5117900000000	51	179	Stafford County, VA	2000	NA	48423	47600	823	1.7
CN5118100000000	51	181	Surry County, VA	2000	NA	3396	3297	99	2.9
CN5118300000000	51	183	Sussex County, VA	2000	NA	4532	4364	168	3.7
CN5118500000000	51	185	Tazewell County, VA	2000	NA	18999	18022	977	5.1
CN5118700000000	51	187	Warren County, VA	2000	NA	16584	16245	339	2
CN5119100000000	51	191	Washington County, VA	2000	NA	25140	24240	900	3.6
CN5119300000000	51	193	Westmoreland County, VA	2000	NA	7686	7411	275	3.6
CN5119500000000	51	195	Wise County, VA	2000	NA	16152	15467	685	4.2
CN5119700000000	51	197	Wythe County, VA	2000	NA	14162	13546	616	4.3
CN5119900000000	51	199	York County, VA	2000	NA	26860	26332	528	2
CN5151000000000	51	510	Alexandria city, VA	2000	NA	80943	79495	1448	1.8
CN5152000000000	51	520	Bristol city, VA	2000	NA	7512	7273	239	3.2
CN5153000000000	51	530	Buena Vista city, VA	2000	NA	3226	3152	74	2.3
CN5154000000000	51	540	Charlottesville city, VA	2000	NA	19378	18803	575	3
CN5155000000000	51	550	Chesapeake city, VA	2000	NA	97963	95714	2249	2.3
CN5157000000000	51	570	Colonial Heights city, VA	2000	NA	8617	8422	195	2.3
CN5158000000000	51	580	Covington city, VA	2000	NA	2901	2785	116	4
CN5159000000000	51	590	Danville city, VA	2000	NA	21392	20448	944	4.4
CN5159500000000	51	595	Emporia city, VA	2000	NA	2366	2292	74	3.1
CN5160000000000	51	600	Fairfax city, VA	2000	NA	12507	12336	171	1.4
CN5161000000000	51	610	Falls Church city, VA	2000	NA	6156	6056	100	1.6
CN5162000000000	51	620	Franklin city, VA	2000	NA	3569	3456	113	3.2
CN5163000000000	51	630	Fredericksburg city, VA	2000	NA	10325	10086	239	2.3
CN5164000000000	51	640	Galax city, VA	2000	NA	3305	3189	116	3.5
CN5165000000000	51	650	Hampton city, VA	2000	NA	64335	62586	1749	2.7
CN5166000000000	51	660	Harrisonburg city, VA	2000	NA	19658	19206	452	2.3
CN5167000000000	51	670	Hopewell city, VA	2000	NA	9873	9590	283	2.9
CN5167800000000	51	678	Lexington city, VA	2000	NA	2243	2163	80	3.6
CN5168000000000	51	680	Lynchburg city, VA	2000	NA	30784	30034	750	2.4
CN5168300000000	51	683	Manassas city, VA	2000	NA	19275	18949	326	1.7
CN5168500000000	51	685	Manassas Park city, VA	2000	NA	5790	5709	81	1.4
CN5169000000000	51	690	Martinsville city, VA	2000	NA	6748	6211	537	8
CN5170000000000	51	700	Newport News city, VA	2000	NA	82885	80710	2175	2.6
CN5171000000000	51	710	Norfolk city, VA	2000	NA	92995	89931	3064	3.3
CN5172000000000	51	720	Norton city, VA	2000	NA	1488	1427	61	4.1
CN5173000000000	51	730	Petersburg city, VA	2000	NA	13917	13440	477	3.4
CN5173500000000	51	735	Poquoson city, VA	2000	NA	5832	5724	108	1.9
CN5174000000000	51	740	Portsmouth city, VA	2000	NA	42953	41486	1467	3.4
CN5175000000000	51	750	Radford city, VA	2000	NA	7470	7227	243	3.3
CN5176000000000	51	760	Richmond city, VA	2000	NA	95424	92887	2537	2.7
CN5177000000000	51	770	Roanoke city, VA	2000	NA	46705	45553	1152	2.5
CN5177500000000	51	775	Salem city, VA	2000	NA	12975	12724	251	1.9
CN5179000000000	51	790	Staunton city, VA	2000	NA	11645	11393	252	2.2
CN5180000000000	51	800	Suffolk city, VA	2000	NA	29326	28586	740	2.5
CN5181000000000	51	810	Virginia Beach city, VA	2000	NA	205898	201294	4604	2.2
CN5182000000000	51	820	Waynesboro city, VA	2000	NA	9149	8912	237	2.6
CN5183000000000	51	830	Williamsburg city, VA	2000	NA	4607	4404	203	4.4
CN5184000000000	51	840	Winchester city, VA	2000	NA	12913	12624	289	2.2
CN5300100000000	53	001	Adams County, WA	2000	NA	8079	7404	675	8.4
CN5300300000000	53	003	Asotin County, WA	2000	NA	9676	9134	542	5.6
CN5300500000000	53	005	Benton County, WA	2000	NA	76225	72039	4186	5.5
CN5300700000000	53	007	Chelan County, WA	2000	NA	36622	33993	2629	7.2
CN5300900000000	53	009	Clallam County, WA	2000	NA	25933	23955	1978	7.6
CN5301100000000	53	011	Clark County, WA	2000	NA	179672	170175	9497	5.3
CN5301300000000	53	013	Columbia County, WA	2000	NA	1788	1631	157	8.8
CN5301500000000	53	015	Cowlitz County, WA	2000	NA	43311	40260	3051	7
CN5301700000000	53	017	Douglas County, WA	2000	NA	18109	16884	1225	6.8
CN5301900000000	53	019	Ferry County, WA	2000	NA	2994	2681	313	10.5
CN5302100000000	53	021	Franklin County, WA	2000	NA	23054	21221	1833	8
CN5302300000000	53	023	Garfield County, WA	2000	NA	1037	983	54	5.2
CN5302500000000	53	025	Grant County, WA	2000	NA	35775	32702	3073	8.6
CN5302700000000	53	027	Grays Harbor County, WA	2000	NA	29367	26987	2380	8.1
CN5302900000000	53	029	Island County, WA	2000	NA	29034	27422	1612	5.6
CN5303100000000	53	031	Jefferson County, WA	2000	NA	11692	10992	700	6
CN5303300000000	53	033	King County, WA	2000	NA	988130	951669	36461	3.7
CN5303500000000	53	035	Kitsap County, WA	2000	NA	106205	100257	5948	5.6
CN5303700000000	53	037	Kittitas County, WA	2000	NA	17298	16244	1054	6.1
CN5303900000000	53	039	Klickitat County, WA	2000	NA	9320	8542	778	8.3
CN5304100000000	53	041	Lewis County, WA	2000	NA	29888	27462	2426	8.1
CN5304300000000	53	043	Lincoln County, WA	2000	NA	4620	4377	243	5.3
CN5304500000000	53	045	Mason County, WA	2000	NA	21017	19535	1482	7.1
CN5304700000000	53	047	Okanogan County, WA	2000	NA	20644	18769	1875	9.1
CN5304900000000	53	049	Pacific County, WA	2000	NA	8611	7937	674	7.8
CN5305100000000	53	051	Pend Oreille County, WA	2000	NA	4628	4238	390	8.4
CN5305300000000	53	053	Pierce County, WA	2000	NA	340655	321727	18928	5.6
CN5305500000000	53	055	San Juan County, WA	2000	NA	7499	7168	331	4.4
CN5305700000000	53	057	Skagit County, WA	2000	NA	52076	48718	3358	6.4
CN5305900000000	53	059	Skamania County, WA	2000	NA	4824	4497	327	6.8
CN5306100000000	53	061	Snohomish County, WA	2000	NA	323911	310635	13276	4.1
CN5306300000000	53	063	Spokane County, WA	2000	NA	211671	199489	12182	5.8
CN5306500000000	53	065	Stevens County, WA	2000	NA	17582	16168	1414	8
CN5306700000000	53	067	Thurston County, WA	2000	NA	108427	102916	5511	5.1
CN5306900000000	53	069	Wahkiakum County, WA	2000	NA	1662	1539	123	7.4
CN5307100000000	53	071	Walla Walla County, WA	2000	NA	27223	25503	1720	6.3
CN5307300000000	53	073	Whatcom County, WA	2000	NA	88217	83181	5036	5.7
CN5307500000000	53	075	Whitman County, WA	2000	NA	19280	18482	798	4.1
CN5307700000000	53	077	Yakima County, WA	2000	NA	113583	103976	9607	8.5
CN5400100000000	54	001	Barbour County, WV	2000	NA	6666	6138	528	7.9
CN5400300000000	54	003	Berkeley County, WV	2000	NA	39612	38182	1430	3.6
CN5400500000000	54	005	Boone County, WV	2000	NA	9810	9146	664	6.8
CN5400700000000	54	007	Braxton County, WV	2000	NA	5853	5423	430	7.3
CN5400900000000	54	009	Brooke County, WV	2000	NA	11811	11267	544	4.6
CN5401100000000	54	011	Cabell County, WV	2000	NA	44806	42660	2146	4.8
CN5401300000000	54	013	Calhoun County, WV	2000	NA	2935	2632	303	10.3
CN5401500000000	54	015	Clay County, WV	2000	NA	3643	3335	308	8.5
CN5401700000000	54	017	Doddridge County, WV	2000	NA	2910	2740	170	5.8
CN5401900000000	54	019	Fayette County, WV	2000	NA	18508	17188	1320	7.1
CN5402100000000	54	021	Gilmer County, WV	2000	NA	2785	2583	202	7.3
CN5402300000000	54	023	Grant County, WV	2000	NA	5474	5183	291	5.3
CN5402500000000	54	025	Greenbrier County, WV	2000	NA	15129	14137	992	6.6
CN5402700000000	54	027	Hampshire County, WV	2000	NA	9351	9046	305	3.3
CN5402900000000	54	029	Hancock County, WV	2000	NA	15702	14983	719	4.6
CN5403100000000	54	031	Hardy County, WV	2000	NA	6685	6429	256	3.8
CN5403300000000	54	033	Harrison County, WV	2000	NA	31348	29545	1803	5.8
CN5403500000000	54	035	Jackson County, WV	2000	NA	12733	11981	752	5.9
CN5403700000000	54	037	Jefferson County, WV	2000	NA	23354	22566	788	3.4
CN5403900000000	54	039	Kanawha County, WV	2000	NA	97313	92508	4805	4.9
CN5404100000000	54	041	Lewis County, WV	2000	NA	7465	7030	435	5.8
CN5404300000000	54	043	Lincoln County, WV	2000	NA	8136	7540	596	7.3
CN5404500000000	54	045	Logan County, WV	2000	NA	13734	12704	1030	7.5
CN5404700000000	54	047	McDowell County, WV	2000	NA	7091	6361	730	10.3
CN5404900000000	54	049	Marion County, WV	2000	NA	26009	24504	1505	5.8
CN5405100000000	54	051	Marshall County, WV	2000	NA	15896	14986	910	5.7
CN5405300000000	54	053	Mason County, WV	2000	NA	10579	9727	852	8.1
CN5405500000000	54	055	Mercer County, WV	2000	NA	25664	24360	1304	5.1
CN5405700000000	54	057	Mineral County, WV	2000	NA	12983	12279	704	5.4
CN5405900000000	54	059	Mingo County, WV	2000	NA	9079	8370	709	7.8
CN5406100000000	54	061	Monongalia County, WV	2000	NA	41250	39462	1788	4.3
CN5406300000000	54	063	Monroe County, WV	2000	NA	5831	5544	287	4.9
CN5406500000000	54	065	Morgan County, WV	2000	NA	7286	7002	284	3.9
CN5406700000000	54	067	Nicholas County, WV	2000	NA	11074	10319	755	6.8
CN5406900000000	54	069	Ohio County, WV	2000	NA	22465	21460	1005	4.5
CN5407100000000	54	071	Pendleton County, WV	2000	NA	3967	3655	312	7.9
CN5407300000000	54	073	Pleasants County, WV	2000	NA	3326	3133	193	5.8
CN5407500000000	54	075	Pocahontas County, WV	2000	NA	4037	3766	271	6.7
CN5407700000000	54	077	Preston County, WV	2000	NA	13394	12650	744	5.6
CN5407900000000	54	079	Putnam County, WV	2000	NA	26217	24958	1259	4.8
CN5408100000000	54	081	Raleigh County, WV	2000	NA	32720	30713	2007	6.1
CN5408300000000	54	083	Randolph County, WV	2000	NA	12841	12067	774	6
CN5408500000000	54	085	Ritchie County, WV	2000	NA	4611	4322	289	6.3
CN5408700000000	54	087	Roane County, WV	2000	NA	6209	5649	560	9
CN5408900000000	54	089	Summers County, WV	2000	NA	4827	4472	355	7.4
CN5409100000000	54	091	Taylor County, WV	2000	NA	6977	6595	382	5.5
CN5409300000000	54	093	Tucker County, WV	2000	NA	3330	3119	211	6.3
CN5409500000000	54	095	Tyler County, WV	2000	NA	3841	3613	228	5.9
CN5409700000000	54	097	Upshur County, WV	2000	NA	10381	9760	621	6
CN5409900000000	54	099	Wayne County, WV	2000	NA	17686	16758	928	5.2
CN5410100000000	54	101	Webster County, WV	2000	NA	3261	3023	238	7.3
CN5410300000000	54	103	Wetzel County, WV	2000	NA	7117	6548	569	8
CN5410500000000	54	105	Wirt County, WV	2000	NA	2563	2383	180	7
CN5410700000000	54	107	Wood County, WV	2000	NA	42188	40263	1925	4.6
CN5410900000000	54	109	Wyoming County, WV	2000	NA	8610	7948	662	7.7
CN5500100000000	55	001	Adams County, WI	2000	NA	8859	8454	405	4.6
CN5500300000000	55	003	Ashland County, WI	2000	NA	8875	8386	489	5.5
CN5500500000000	55	005	Barron County, WI	2000	NA	24862	23851	1011	4.1
CN5500700000000	55	007	Bayfield County, WI	2000	NA	7690	7267	423	5.5
CN5500900000000	55	009	Brown County, WI	2000	NA	130602	126762	3840	2.9
CN5501100000000	55	011	Buffalo County, WI	2000	NA	7837	7542	295	3.8
CN5501300000000	55	013	Burnett County, WI	2000	NA	7758	7448	310	4
CN5501500000000	55	015	Calumet County, WI	2000	NA	24000	23331	669	2.8
CN5501700000000	55	017	Chippewa County, WI	2000	NA	29866	28567	1299	4.3
CN5501900000000	55	019	Clark County, WI	2000	NA	17468	16693	775	4.4
CN5502100000000	55	021	Columbia County, WI	2000	NA	29708	28605	1103	3.7
CN5502300000000	55	023	Crawford County, WI	2000	NA	9100	8758	342	3.8
CN5502500000000	55	025	Dane County, WI	2000	NA	264274	257939	6335	2.4
CN5502700000000	55	027	Dodge County, WI	2000	NA	47291	45739	1552	3.3
CN5502900000000	55	029	Door County, WI	2000	NA	16397	15728	669	4.1
CN5503100000000	55	031	Douglas County, WI	2000	NA	22673	21662	1011	4.5
CN5503300000000	55	033	Dunn County, WI	2000	NA	22399	21610	789	3.5
CN5503500000000	55	035	Eau Claire County, WI	2000	NA	52971	51220	1751	3.3
CN5503700000000	55	037	Florence County, WI	2000	NA	2611	2499	112	4.3
CN5503900000000	55	039	Fond du Lac County, WI	2000	NA	55532	53795	1737	3.1
CN5504100000000	55	041	Forest County, WI	2000	NA	4628	4356	272	5.9
CN5504300000000	55	043	Grant County, WI	2000	NA	27351	26415	936	3.4
CN5504500000000	55	045	Green County, WI	2000	NA	19969	19318	651	3.3
CN5504700000000	55	047	Green Lake County, WI	2000	NA	10696	10259	437	4.1
CN5504900000000	55	049	Iowa County, WI	2000	NA	13590	13192	398	2.9
CN5505100000000	55	051	Iron County, WI	2000	NA	3262	3030	232	7.1
CN5505300000000	55	053	Jackson County, WI	2000	NA	9774	9311	463	4.7
CN5505500000000	55	055	Jefferson County, WI	2000	NA	43097	41802	1295	3
CN5505700000000	55	057	Juneau County, WI	2000	NA	12771	12116	655	5.1
CN5505900000000	55	059	Kenosha County, WI	2000	NA	80569	77211	3358	4.2
CN5506100000000	55	061	Kewaunee County, WI	2000	NA	11561	11242	319	2.8
CN5506300000000	55	063	La Crosse County, WI	2000	NA	61123	59101	2022	3.3
CN5506500000000	55	065	Lafayette County, WI	2000	NA	9145	8866	279	3.1
CN5506700000000	55	067	Langlade County, WI	2000	NA	10760	10248	512	4.8
CN5506900000000	55	069	Lincoln County, WI	2000	NA	16093	15401	692	4.3
CN5507100000000	55	071	Manitowoc County, WI	2000	NA	46826	45256	1570	3.4
CN5507300000000	55	073	Marathon County, WI	2000	NA	71794	69355	2439	3.4
CN5507500000000	55	075	Marinette County, WI	2000	NA	22405	21388	1017	4.5
CN5507700000000	55	077	Marquette County, WI	2000	NA	7496	7090	406	5.4
CN5507800000000	55	078	Menominee County, WI	2000	NA	1637	1488	149	9.1
CN5507900000000	55	079	Milwaukee County, WI	2000	NA	474899	453896	21003	4.4
CN5508100000000	55	081	Monroe County, WI	2000	NA	21559	20737	822	3.8
CN5508300000000	55	083	Oconto County, WI	2000	NA	19346	18639	707	3.7
CN5508500000000	55	085	Oneida County, WI	2000	NA	19674	18673	1001	5.1
CN5508700000000	55	087	Outagamie County, WI	2000	NA	92829	90036	2793	3
CN5508900000000	55	089	Ozaukee County, WI	2000	NA	47313	46091	1222	2.6
CN5509100000000	55	091	Pepin County, WI	2000	NA	3904	3762	142	3.6
CN5509300000000	55	093	Pierce County, WI	2000	NA	22725	22125	600	2.6
CN5509500000000	55	095	Polk County, WI	2000	NA	22632	21848	784	3.5
CN5509700000000	55	097	Portage County, WI	2000	NA	38536	37155	1381	3.6
CN5509900000000	55	099	Price County, WI	2000	NA	8351	7914	437	5.2
CN5510100000000	55	101	Racine County, WI	2000	NA	99119	95097	4022	4.1
CN5510300000000	55	103	Richland County, WI	2000	NA	9581	9238	343	3.6
CN5510500000000	55	105	Rock County, WI	2000	NA	82306	78752	3554	4.3
CN5510700000000	55	107	Rusk County, WI	2000	NA	7887	7463	424	5.4
CN5510900000000	55	109	St. Croix County, WI	2000	NA	37744	36806	938	2.5
CN5511100000000	55	111	Sauk County, WI	2000	NA	33079	32060	1019	3.1
CN5511300000000	55	113	Sawyer County, WI	2000	NA	8406	7946	460	5.5
CN5511500000000	55	115	Shawano County, WI	2000	NA	21969	21149	820	3.7
CN5511700000000	55	117	Sheboygan County, WI	2000	NA	64092	62433	1659	2.6
CN5511900000000	55	119	Taylor County, WI	2000	NA	10942	10517	425	3.9
CN5512100000000	55	121	Trempealeau County, WI	2000	NA	15369	14739	630	4.1
CN5512300000000	55	123	Vernon County, WI	2000	NA	14306	13756	550	3.8
CN5512500000000	55	125	Vilas County, WI	2000	NA	10933	10370	563	5.1
CN5512700000000	55	127	Walworth County, WI	2000	NA	53747	52137	1610	3
CN5512900000000	55	129	Washburn County, WI	2000	NA	7979	7559	420	5.3
CN5513100000000	55	131	Washington County, WI	2000	NA	69541	67533	2008	2.9
CN5513300000000	55	133	Waukesha County, WI	2000	NA	209660	203795	5865	2.8
CN5513500000000	55	135	Waupaca County, WI	2000	NA	27706	26747	959	3.5
CN5513700000000	55	137	Waushara County, WI	2000	NA	11756	11249	507	4.3
CN5513900000000	55	139	Winnebago County, WI	2000	NA	89268	86736	2532	2.8
CN5514100000000	55	141	Wood County, WI	2000	NA	40745	39121	1624	4
CN5600100000000	56	001	Albany County, WY	2000	NA	18291	17666	625	3.4
CN5600300000000	56	003	Big Horn County, WY	2000	NA	5316	5044	272	5.1
CN5600500000000	56	005	Campbell County, WY	2000	NA	19898	19278	620	3.1
CN5600700000000	56	007	Carbon County, WY	2000	NA	8093	7749	344	4.3
CN5600900000000	56	009	Converse County, WY	2000	NA	6581	6318	263	4
CN5601100000000	56	011	Crook County, WY	2000	NA	3172	3054	118	3.7
CN5601300000000	56	013	Fremont County, WY	2000	NA	17664	16731	933	5.3
CN5601500000000	56	015	Goshen County, WY	2000	NA	6246	6015	231	3.7
CN5601700000000	56	017	Hot Springs County, WY	2000	NA	2642	2544	98	3.7
CN5601900000000	56	019	Johnson County, WY	2000	NA	3573	3438	135	3.8
CN5602100000000	56	021	Laramie County, WY	2000	NA	40224	38689	1535	3.8
CN5602300000000	56	023	Lincoln County, WY	2000	NA	7355	7065	290	3.9
CN5602500000000	56	025	Natrona County, WY	2000	NA	36524	35070	1454	4
CN5602700000000	56	027	Niobrara County, WY	2000	NA	1235	1189	46	3.7
CN5602900000000	56	029	Park County, WY	2000	NA	14379	13789	590	4.1
CN5603100000000	56	031	Platte County, WY	2000	NA	4353	4174	179	4.1
CN5603300000000	56	033	Sheridan County, WY	2000	NA	14751	14153	598	4.1
CN5603500000000	56	035	Sublette County, WY	2000	NA	3559	3452	107	3
CN5603700000000	56	037	Sweetwater County, WY	2000	NA	20709	19874	835	4
CN5603900000000	56	039	Teton County, WY	2000	NA	14183	13833	350	2.5
CN5604100000000	56	041	Uinta County, WY	2000	NA	10458	10031	427	4.1
CN5604300000000	56	043	Washakie County, WY	2000	NA	4305	4103	202	4.7
CN5604500000000	56	045	Weston County, WY	2000	NA	3299	3156	143	4.3
CN7200100000000	72	001	Adjuntas Municipio, PR	2000	NA	5197	4548	649	12.5
CN7200300000000	72	003	Aguada Municipio, PR	2000	NA	14028	12188	1840	13.1
CN7200500000000	72	005	Aguadilla Municipio, PR	2000	NA	20277	17598	2679	13.2
CN7200700000000	72	007	Aguas Buenas Municipio, PR	2000	NA	8768	7891	877	10
CN7200900000000	72	009	Aibonito Municipio, PR	2000	NA	7668	6770	898	11.7
CN7201100000000	72	011	Anasco Municipio, PR	2000	NA	9713	8498	1215	12.5
CN7201300000000	72	013	Arecibo Municipio, PR	2000	NA	32680	29028	3652	11.2
CN7201500000000	72	015	Arroyo Municipio, PR	2000	NA	5035	4301	734	14.6
CN7201700000000	72	017	Barceloneta Municipio, PR	2000	NA	7022	6124	898	12.8
CN7201900000000	72	019	Barranquitas Municipio, PR	2000	NA	7330	6530	800	10.9
CN7202100000000	72	021	Bayamon Municipio, PR	2000	NA	83450	77126	6324	7.6
CN7202300000000	72	023	Cabo Rojo Municipio, PR	2000	NA	17597	15901	1696	9.6
CN7202500000000	72	025	Caguas Municipio, PR	2000	NA	52880	47987	4893	9.3
CN7202700000000	72	027	Camuy Municipio, PR	2000	NA	11750	10514	1236	10.5
CN7202900000000	72	029	Canovanas Municipio, PR	2000	NA	13360	11761	1599	12
CN7203100000000	72	031	Carolina Municipio, PR	2000	NA	76669	70619	6050	7.9
CN7203300000000	72	033	Catano Municipio, PR	2000	NA	8773	7953	820	9.3
CN7203500000000	72	035	Cayey Municipio, PR	2000	NA	15671	13891	1780	11.4
CN7203700000000	72	037	Ceiba Municipio, PR	2000	NA	5789	5168	621	10.7
CN7203900000000	72	039	Ciales Municipio, PR	2000	NA	4962	4257	705	14.2
CN7204100000000	72	041	Cidra Municipio, PR	2000	NA	13989	12524	1465	10.5
CN7204300000000	72	043	Coamo Municipio, PR	2000	NA	10773	9527	1246	11.6
CN7204500000000	72	045	Comerio Municipio, PR	2000	NA	4846	4263	583	12
CN7204700000000	72	047	Corozal Municipio, PR	2000	NA	9933	8946	987	9.9
CN7204900000000	72	049	Culebra Municipio, PR	2000	NA	780	734	46	5.9
CN7205100000000	72	051	Dorado Municipio, PR	2000	NA	11977	11008	969	8.1
CN7205300000000	72	053	Fajardo Municipio, PR	2000	NA	14323	12628	1695	11.8
CN7205400000000	72	054	Florida Municipio, PR	2000	NA	3397	2971	426	12.5
CN7205500000000	72	055	Guanica Municipio, PR	2000	NA	5865	4940	925	15.8
CN7205700000000	72	057	Guayama Municipio, PR	2000	NA	12684	11062	1622	12.8
CN7205900000000	72	059	Guayanilla Municipio, PR	2000	NA	6332	5343	989	15.6
CN7206100000000	72	061	Guaynabo Municipio, PR	2000	NA	43406	41009	2397	5.5
CN7206300000000	72	063	Gurabo Municipio, PR	2000	NA	13384	12198	1186	8.9
CN7206500000000	72	065	Hatillo Municipio, PR	2000	NA	11753	10436	1317	11.2
CN7206700000000	72	067	Hormigueros Municipio, PR	2000	NA	6449	5766	683	10.6
CN7206900000000	72	069	Humacao Municipio, PR	2000	NA	19994	17546	2448	12.2
CN7207100000000	72	071	Isabela Municipio, PR	2000	NA	14270	12269	2001	14
CN7207300000000	72	073	Jayuya Municipio, PR	2000	NA	4593	4018	575	12.5
CN7207500000000	72	075	Juana Diaz Municipio, PR	2000	NA	14686	12838	1848	12.6
CN7207700000000	72	077	Juncos Municipio, PR	2000	NA	11738	10458	1280	10.9
CN7207900000000	72	079	Lajas Municipio, PR	2000	NA	8059	7020	1039	12.9
CN7208100000000	72	081	Lares Municipio, PR	2000	NA	10221	9048	1173	11.5
CN7208300000000	72	083	Las Marias Municipio, PR	2000	NA	3578	3080	498	13.9
CN7208500000000	72	085	Las Piedras Municipio, PR	2000	NA	11388	10003	1385	12.2
CN7208700000000	72	087	Loiza Municipio, PR	2000	NA	8410	7431	979	11.6
CN7208900000000	72	089	Luquillo Municipio, PR	2000	NA	6676	5820	856	12.8
CN7209100000000	72	091	Manati Municipio, PR	2000	NA	13737	11901	1836	13.4
CN7209300000000	72	093	Maricao Municipio, PR	2000	NA	2144	1882	262	12.2
CN7209500000000	72	095	Maunabo Municipio, PR	2000	NA	3520	3015	505	14.3
CN7209700000000	72	097	Mayaguez Municipio, PR	2000	NA	32155	28187	3968	12.3
CN7209900000000	72	099	Moca Municipio, PR	2000	NA	13164	11454	1710	13
CN7210100000000	72	101	Morovis Municipio, PR	2000	NA	8446	7353	1093	12.9
CN7210300000000	72	103	Naguabo Municipio, PR	2000	NA	7154	6286	868	12.1
CN7210500000000	72	105	Naranjito Municipio, PR	2000	NA	8383	7603	780	9.3
CN7210700000000	72	107	Orocovis Municipio, PR	2000	NA	5197	4493	704	13.5
CN7210900000000	72	109	Patillas Municipio, PR	2000	NA	5342	4566	776	14.5
CN7211100000000	72	111	Penuelas Municipio, PR	2000	NA	7684	6579	1105	14.4
CN7211300000000	72	113	Ponce Municipio, PR	2000	NA	58896	52076	6820	11.6
CN7211500000000	72	115	Quebradillas Municipio, PR	2000	NA	8037	7091	946	11.8
CN7211700000000	72	117	Rincon Municipio, PR	2000	NA	4846	4216	630	13
CN7211900000000	72	119	Rio Grande Municipio, PR	2000	NA	16937	14993	1944	11.5
CN7212100000000	72	121	Sabana Grande Municipio, PR	2000	NA	8374	7355	1019	12.2
CN7212300000000	72	123	Salinas Municipio, PR	2000	NA	8287	7141	1146	13.8
CN7212500000000	72	125	San German Municipio, PR	2000	NA	12325	10677	1648	13.4
CN7212700000000	72	127	San Juan Municipio, PR	2000	NA	173897	161065	12832	7.4
CN7212900000000	72	129	San Lorenzo Municipio, PR	2000	NA	13334	11885	1449	10.9
CN7213100000000	72	131	San Sebastian Municipio, PR	2000	NA	13947	11977	1970	14.1
CN7213300000000	72	133	Santa Isabel Municipio, PR	2000	NA	7744	6837	907	11.7
CN7213500000000	72	135	Toa Alta Municipio, PR	2000	NA	23986	22331	1655	6.9
CN7213700000000	72	137	Toa Baja Municipio, PR	2000	NA	35005	32425	2580	7.4
CN7213900000000	72	139	Trujillo Alto Municipio, PR	2000	NA	31171	29065	2106	6.8
CN7214100000000	72	141	Utuado Municipio, PR	2000	NA	9217	8079	1138	12.3
CN7214300000000	72	143	Vega Alta Municipio, PR	2000	NA	11786	10712	1074	9.1
CN7214500000000	72	145	Vega Baja Municipio, PR	2000	NA	19805	17607	2198	11.1
CN7214700000000	72	147	Vieques Municipio, PR	2000	NA	2441	2120	321	13.2
CN7214900000000	72	149	Villalba Municipio, PR	2000	NA	7636	6648	988	12.9
CN7215100000000	72	151	Yabucoa Municipio, PR	2000	NA	10613	9005	1608	15.2
CN7215300000000	72	153	Yauco Municipio, PR	2000	NA	14664	12871	1793	12.2
NA	NA	NA	NA	NA	NA	NA	NA	NA	NA
SOURCE:  BLS, LAUS	NA	NA	NA	NA	NA	NA	NA	NA	NA
March 18, 2016	NA	NA	NA	NA	NA	NA	NA	NA	NA
