LAUS_CODE	STATE_FIPS	COUNTY_FIPS	COUNTY	YEAR	ESTIMATED	LABOR_FORCE	EMPLOYED	UNEMPLOYED_LEVEL	UNEMPLOYED_RATE
CN0100100000000	01	001	Autauga County, AL	2003	NA	22604	21462	1142	5.1
CN0100300000000	01	003	Baldwin County, AL	2003	NA	72299	68702	3597	5
CN0100500000000	01	005	Barbour County, AL	2003	NA	10977	10196	781	7.1
CN0100700000000	01	007	Bibb County, AL	2003	NA	8836	8309	527	6
CN0100900000000	01	009	Blount County, AL	2003	NA	25900	24702	1198	4.6
CN0101100000000	01	011	Bullock County, AL	2003	NA	3979	3540	439	11
CN0101300000000	01	013	Butler County, AL	2003	NA	9183	8386	797	8.7
CN0101500000000	01	015	Calhoun County, AL	2003	NA	52817	49673	3144	6
CN0101700000000	01	017	Chambers County, AL	2003	NA	16829	15745	1084	6.4
CN0101900000000	01	019	Cherokee County, AL	2003	NA	11929	11342	587	4.9
CN0102100000000	01	021	Chilton County, AL	2003	NA	19478	18499	979	5
CN0102300000000	01	023	Choctaw County, AL	2003	NA	5651	5085	566	10
CN0102500000000	01	025	Clarke County, AL	2003	NA	10769	9839	930	8.6
CN0102700000000	01	027	Clay County, AL	2003	NA	5923	5492	431	7.3
CN0102900000000	01	029	Cleburne County, AL	2003	NA	6672	6267	405	6.1
CN0103100000000	01	031	Coffee County, AL	2003	NA	19932	18834	1098	5.5
CN0103300000000	01	033	Colbert County, AL	2003	NA	24562	22720	1842	7.5
CN0103500000000	01	035	Conecuh County, AL	2003	NA	5149	4707	442	8.6
CN0103700000000	01	037	Coosa County, AL	2003	NA	5056	4641	415	8.2
CN0103900000000	01	039	Covington County, AL	2003	NA	17322	16110	1212	7
CN0104100000000	01	041	Crenshaw County, AL	2003	NA	5920	5517	403	6.8
CN0104300000000	01	043	Cullman County, AL	2003	NA	38276	36045	2231	5.8
CN0104500000000	01	045	Dale County, AL	2003	NA	20546	19457	1089	5.3
CN0104700000000	01	047	Dallas County, AL	2003	NA	16783	14878	1905	11.4
CN0104900000000	01	049	DeKalb County, AL	2003	NA	32218	30363	1855	5.8
CN0105100000000	01	051	Elmore County, AL	2003	NA	32603	30929	1674	5.1
CN0105300000000	01	053	Escambia County, AL	2003	NA	14644	13379	1265	8.6
CN0105500000000	01	055	Etowah County, AL	2003	NA	46388	43351	3037	6.5
CN0105700000000	01	057	Fayette County, AL	2003	NA	8048	7490	558	6.9
CN0105900000000	01	059	Franklin County, AL	2003	NA	13561	12265	1296	9.6
CN0106100000000	01	061	Geneva County, AL	2003	NA	11722	11065	657	5.6
CN0106300000000	01	063	Greene County, AL	2003	NA	3504	3205	299	8.5
CN0106500000000	01	065	Hale County, AL	2003	NA	7086	6485	601	8.5
CN0106700000000	01	067	Henry County, AL	2003	NA	7494	7059	435	5.8
CN0106900000000	01	069	Houston County, AL	2003	NA	45185	42984	2201	4.9
CN0107100000000	01	071	Jackson County, AL	2003	NA	27187	25272	1915	7
CN0107300000000	01	073	Jefferson County, AL	2003	NA	321042	303282	17760	5.5
CN0107500000000	01	075	Lamar County, AL	2003	NA	6691	6104	587	8.8
CN0107700000000	01	077	Lauderdale County, AL	2003	NA	41196	38184	3012	7.3
CN0107900000000	01	079	Lawrence County, AL	2003	NA	15788	14728	1060	6.7
CN0108100000000	01	081	Lee County, AL	2003	NA	60597	57747	2850	4.7
CN0108300000000	01	083	Limestone County, AL	2003	NA	33924	32046	1878	5.5
CN0108500000000	01	085	Lowndes County, AL	2003	NA	5021	4557	464	9.2
CN0108700000000	01	087	Macon County, AL	2003	NA	8522	7924	598	7
CN0108900000000	01	089	Madison County, AL	2003	NA	154255	146915	7340	4.8
CN0109100000000	01	091	Marengo County, AL	2003	NA	8999	8431	568	6.3
CN0109300000000	01	093	Marion County, AL	2003	NA	13071	12130	941	7.2
CN0109500000000	01	095	Marshall County, AL	2003	NA	40587	38316	2271	5.6
CN0109700000000	01	097	Mobile County, AL	2003	NA	180242	167696	12546	7
CN0109900000000	01	099	Monroe County, AL	2003	NA	9417	8627	790	8.4
CN0110100000000	01	101	Montgomery County, AL	2003	NA	104505	98402	6103	5.8
CN0110300000000	01	103	Morgan County, AL	2003	NA	55227	51605	3622	6.6
CN0110500000000	01	105	Perry County, AL	2003	NA	3843	3432	411	10.7
CN0110700000000	01	107	Pickens County, AL	2003	NA	8138	7475	663	8.1
CN0110900000000	01	109	Pike County, AL	2003	NA	14397	13556	841	5.8
CN0111100000000	01	111	Randolph County, AL	2003	NA	9791	9061	730	7.5
CN0111300000000	01	113	Russell County, AL	2003	NA	21870	20224	1646	7.5
CN0111500000000	01	115	St. Clair County, AL	2003	NA	32291	30607	1684	5.2
CN0111700000000	01	117	Shelby County, AL	2003	NA	88275	85144	3131	3.5
CN0111900000000	01	119	Sumter County, AL	2003	NA	5110	4594	516	10.1
CN0112100000000	01	121	Talladega County, AL	2003	NA	38205	35246	2959	7.7
CN0112300000000	01	123	Tallapoosa County, AL	2003	NA	18456	17174	1282	6.9
CN0112500000000	01	125	Tuscaloosa County, AL	2003	NA	82091	78055	4036	4.9
CN0112700000000	01	127	Walker County, AL	2003	NA	30327	28360	1967	6.5
CN0112900000000	01	129	Washington County, AL	2003	NA	7103	6362	741	10.4
CN0113100000000	01	131	Wilcox County, AL	2003	NA	3818	3345	473	12.4
CN0113300000000	01	133	Winston County, AL	2003	NA	10407	9418	989	9.5
CN0201300000000	02	013	Aleutians East Borough, AK	2003	NA	1010	911	99	9.8
CN0201600000000	02	016	Aleutians West Census Area, AK	2003	NA	2931	2743	188	6.4
CN0202000000000	02	020	Anchorage Borough/municipality, AK	2003	NA	145428	136227	9201	6.3
CN0205000000000	02	050	Bethel Census Area, AK	2003	NA	7059	6192	867	12.3
CN0206000000000	02	060	Bristol Bay Borough, AK	2003	NA	971	910	61	6.3
CN0206800000000	02	068	Denali Borough, AK	2003	NA	1408	1283	125	8.9
CN0207000000000	02	070	Dillingham Census Area, AK	2003	NA	1923	1708	215	11.2
CN0209000000000	02	090	Fairbanks North Star Borough, AK	2003	NA	42599	39603	2996	7
CN0210000000000	02	100	Haines Borough, AK	2003	NA	1360	1200	160	11.8
CN0211000000000	02	110	Juneau Borough/city, AK	2003	NA	18058	17005	1053	5.8
CN0212200000000	02	122	Kenai Peninsula Borough, AK	2003	NA	25039	22476	2563	10.2
CN0213000000000	02	130	Ketchikan Gateway Borough, AK	2003	NA	7789	7156	633	8.1
CN0215000000000	02	150	Kodiak Island Borough, AK	2003	NA	5961	5377	584	9.8
CN0215800000000	02	158	Kusilvak Census Area, AK	2003	NA	2656	2176	480	18.1
CN0216400000000	02	164	Lake and Peninsula Borough, AK	2003	NA	942	865	77	8.2
CN0217000000000	02	170	Matanuska-Susitna Borough, AK	2003	NA	32820	29928	2892	8.8
CN0218000000000	02	180	Nome Census Area, AK	2003	NA	3913	3486	427	10.9
CN0218500000000	02	185	North Slope Borough, AK	2003	NA	3701	3318	383	10.3
CN0218800000000	02	188	Northwest Arctic Borough, AK	2003	NA	2979	2584	395	13.3
CN0220100000000	02	201	Prince of Wales-Outer Ketchikan Census Area, AK	2003	NA	2451	2092	359	14.6
CN0222000000000	02	220	Sitka Borough/city, AK	2003	NA	4664	4373	291	6.2
CN0223200000000	02	232	Skagway-Hoonah-Angoon Census Area, AK	2003	NA	1876	1651	225	12
CN0224000000000	02	240	Southeast Fairbanks Census Area, AK	2003	NA	2506	2180	326	13
CN0226100000000	02	261	Valdez-Cordova Census Area, AK	2003	NA	5375	4829	546	10.2
CN0228000000000	02	280	Wrangell-Petersburg Census Area, AK	2003	NA	3011	2642	369	12.3
CN0228200000000	02	282	Yakutat Borough/city, AK	2003	NA	302	268	34	11.3
CN0229000000000	02	290	Yukon-Koyukuk Census Area, AK	2003	NA	2941	2542	399	13.6
CN0400100000000	04	001	Apache County, AZ	2003	NA	20638	18198	2440	11.8
CN0400300000000	04	003	Cochise County, AZ	2003	NA	54049	50985	3064	5.7
CN0400500000000	04	005	Coconino County, AZ	2003	NA	65739	61985	3754	5.7
CN0400700000000	04	007	Gila County, AZ	2003	NA	21039	19511	1528	7.3
CN0400900000000	04	009	Graham County, AZ	2003	NA	12170	11320	850	7
CN0401100000000	04	011	Greenlee County, AZ	2003	NA	3531	3285	246	7
CN0401200000000	04	012	La Paz County, AZ	2003	NA	7451	6925	526	7.1
CN0401300000000	04	013	Maricopa County, AZ	2003	NA	1749197	1658323	90874	5.2
CN0401500000000	04	015	Mohave County, AZ	2003	NA	82110	78073	4037	4.9
CN0401700000000	04	017	Navajo County, AZ	2003	NA	38252	34962	3290	8.6
CN0401900000000	04	019	Pima County, AZ	2003	NA	429349	406481	22868	5.3
CN0402100000000	04	021	Pinal County, AZ	2003	NA	78892	73375	5517	7
CN0402300000000	04	023	Santa Cruz County, AZ	2003	NA	15707	14208	1499	9.5
CN0402500000000	04	025	Yavapai County, AZ	2003	NA	85008	80664	4344	5.1
CN0402700000000	04	027	Yuma County, AZ	2003	NA	72869	60560	12309	16.9
CN0500100000000	05	001	Arkansas County, AR	2003	NA	10716	10120	596	5.6
CN0500300000000	05	003	Ashley County, AR	2003	NA	9989	9040	949	9.5
CN0500500000000	05	005	Baxter County, AR	2003	NA	15939	14871	1068	6.7
CN0500700000000	05	007	Benton County, AR	2003	NA	87883	84706	3177	3.6
CN0500900000000	05	009	Boone County, AR	2003	NA	16050	15113	937	5.8
CN0501100000000	05	011	Bradley County, AR	2003	NA	5488	5089	399	7.3
CN0501300000000	05	013	Calhoun County, AR	2003	NA	2537	2336	201	7.9
CN0501500000000	05	015	Carroll County, AR	2003	NA	13223	12581	642	4.9
CN0501700000000	05	017	Chicot County, AR	2003	NA	5174	4626	548	10.6
CN0501900000000	05	019	Clark County, AR	2003	NA	11145	10428	717	6.4
CN0502100000000	05	021	Clay County, AR	2003	NA	7491	6882	609	8.1
CN0502300000000	05	023	Cleburne County, AR	2003	NA	10900	10278	622	5.7
CN0502500000000	05	025	Cleveland County, AR	2003	NA	3969	3721	248	6.2
CN0502700000000	05	027	Columbia County, AR	2003	NA	10697	9970	727	6.8
CN0502900000000	05	029	Conway County, AR	2003	NA	9596	8993	603	6.3
CN0503100000000	05	031	Craighead County, AR	2003	NA	42858	40458	2400	5.6
CN0503300000000	05	033	Crawford County, AR	2003	NA	25250	23893	1357	5.4
CN0503500000000	05	035	Crittenden County, AR	2003	NA	21317	19869	1448	6.8
CN0503700000000	05	037	Cross County, AR	2003	NA	8681	8030	651	7.5
CN0503900000000	05	039	Dallas County, AR	2003	NA	3821	3516	305	8
CN0504100000000	05	041	Desha County, AR	2003	NA	6162	5607	555	9
CN0504300000000	05	043	Drew County, AR	2003	NA	8514	7837	677	8
CN0504500000000	05	045	Faulkner County, AR	2003	NA	47763	45147	2616	5.5
CN0504700000000	05	047	Franklin County, AR	2003	NA	7971	7581	390	4.9
CN0504900000000	05	049	Fulton County, AR	2003	NA	4966	4654	312	6.3
CN0505100000000	05	051	Garland County, AR	2003	NA	39209	36682	2527	6.4
CN0505300000000	05	053	Grant County, AR	2003	NA	8096	7641	455	5.6
CN0505500000000	05	055	Greene County, AR	2003	NA	17113	15956	1157	6.8
CN0505700000000	05	057	Hempstead County, AR	2003	NA	11068	10473	595	5.4
CN0505900000000	05	059	Hot Spring County, AR	2003	NA	14214	13260	954	6.7
CN0506100000000	05	061	Howard County, AR	2003	NA	6528	6132	396	6.1
CN0506300000000	05	063	Independence County, AR	2003	NA	17007	15905	1102	6.5
CN0506500000000	05	065	Izard County, AR	2003	NA	5206	4794	412	7.9
CN0506700000000	05	067	Jackson County, AR	2003	NA	7781	7080	701	9
CN0506900000000	05	069	Jefferson County, AR	2003	NA	35724	32855	2869	8
CN0507100000000	05	071	Johnson County, AR	2003	NA	10649	10064	585	5.5
CN0507300000000	05	073	Lafayette County, AR	2003	NA	3369	3167	202	6
CN0507500000000	05	075	Lawrence County, AR	2003	NA	7720	7060	660	8.5
CN0507700000000	05	077	Lee County, AR	2003	NA	3664	3237	427	11.7
CN0507900000000	05	079	Lincoln County, AR	2003	NA	5074	4660	414	8.2
CN0508100000000	05	081	Little River County, AR	2003	NA	6398	6084	314	4.9
CN0508300000000	05	083	Logan County, AR	2003	NA	9938	9372	566	5.7
CN0508500000000	05	085	Lonoke County, AR	2003	NA	27489	26153	1336	4.9
CN0508700000000	05	087	Madison County, AR	2003	NA	7175	6890	285	4
CN0508900000000	05	089	Marion County, AR	2003	NA	6498	6075	423	6.5
CN0509100000000	05	091	Miller County, AR	2003	NA	18224	17296	928	5.1
CN0509300000000	05	093	Mississippi County, AR	2003	NA	20220	17797	2423	12
CN0509500000000	05	095	Monroe County, AR	2003	NA	3968	3668	300	7.6
CN0509700000000	05	097	Montgomery County, AR	2003	NA	4249	4010	239	5.6
CN0509900000000	05	099	Nevada County, AR	2003	NA	4493	4265	228	5.1
CN0510100000000	05	101	Newton County, AR	2003	NA	3615	3404	211	5.8
CN0510300000000	05	103	Ouachita County, AR	2003	NA	12085	11122	963	8
CN0510500000000	05	105	Perry County, AR	2003	NA	4778	4446	332	6.9
CN0510700000000	05	107	Phillips County, AR	2003	NA	9175	8367	808	8.8
CN0510900000000	05	109	Pike County, AR	2003	NA	5189	4904	285	5.5
CN0511100000000	05	111	Poinsett County, AR	2003	NA	11200	10370	830	7.4
CN0511300000000	05	113	Polk County, AR	2003	NA	8587	7925	662	7.7
CN0511500000000	05	115	Pope County, AR	2003	NA	26555	25020	1535	5.8
CN0511700000000	05	117	Prairie County, AR	2003	NA	4457	4221	236	5.3
CN0511900000000	05	119	Pulaski County, AR	2003	NA	181174	171643	9531	5.3
CN0512100000000	05	121	Randolph County, AR	2003	NA	7838	7087	751	9.6
CN0512300000000	05	123	St. Francis County, AR	2003	NA	10823	9805	1018	9.4
CN0512500000000	05	125	Saline County, AR	2003	NA	43406	41275	2131	4.9
CN0512700000000	05	127	Scott County, AR	2003	NA	4706	4477	229	4.9
CN0512900000000	05	129	Searcy County, AR	2003	NA	3373	3184	189	5.6
CN0513100000000	05	131	Sebastian County, AR	2003	NA	56011	53227	2784	5
CN0513300000000	05	133	Sevier County, AR	2003	NA	7396	7048	348	4.7
CN0513500000000	05	135	Sharp County, AR	2003	NA	6401	5845	556	8.7
CN0513700000000	05	137	Stone County, AR	2003	NA	4479	4138	341	7.6
CN0513900000000	05	139	Union County, AR	2003	NA	19714	18137	1577	8
CN0514100000000	05	141	Van Buren County, AR	2003	NA	6812	6320	492	7.2
CN0514300000000	05	143	Washington County, AR	2003	NA	90430	86944	3486	3.9
CN0514500000000	05	145	White County, AR	2003	NA	30761	28791	1970	6.4
CN0514700000000	05	147	Woodruff County, AR	2003	NA	3774	3408	366	9.7
CN0514900000000	05	149	Yell County, AR	2003	NA	9793	9273	520	5.3
CN0600100000000	06	001	Alameda County, CA	2003	NA	754375	702984	51391	6.8
CN0600300000000	06	003	Alpine County, CA	2003	NA	554	508	46	8.3
CN0600500000000	06	005	Amador County, CA	2003	NA	16389	15384	1005	6.1
CN0600700000000	06	007	Butte County, CA	2003	NA	98296	90885	7411	7.5
CN0600900000000	06	009	Calaveras County, CA	2003	NA	19854	18398	1456	7.3
CN0601100000000	06	011	Colusa County, CA	2003	NA	9433	8086	1347	14.3
CN0601300000000	06	013	Contra Costa County, CA	2003	NA	508420	477620	30800	6.1
CN0601500000000	06	015	Del Norte County, CA	2003	NA	10313	9440	873	8.5
CN0601700000000	06	017	El Dorado County, CA	2003	NA	87468	82631	4837	5.5
CN0601900000000	06	019	Fresno County, CA	2003	NA	403733	356645	47088	11.7
CN0602100000000	06	021	Glenn County, CA	2003	NA	11124	9992	1132	10.2
CN0602300000000	06	023	Humboldt County, CA	2003	NA	60584	56464	4120	6.8
CN0602500000000	06	025	Imperial County, CA	2003	NA	58642	49550	9092	15.5
CN0602700000000	06	027	Inyo County, CA	2003	NA	9097	8576	521	5.7
CN0602900000000	06	029	Kern County, CA	2003	NA	311344	279400	31944	10.3
CN0603100000000	06	031	Kings County, CA	2003	NA	53114	46796	6318	11.9
CN0603300000000	06	033	Lake County, CA	2003	NA	25856	23508	2348	9.1
CN0603500000000	06	035	Lassen County, CA	2003	NA	12313	11373	940	7.6
CN0603700000000	06	037	Los Angeles County, CA	2003	NA	4739472	4409913	329559	7
CN0603900000000	06	039	Madera County, CA	2003	NA	58971	52916	6055	10.3
CN0604100000000	06	041	Marin County, CA	2003	NA	130647	124287	6360	4.9
CN0604300000000	06	043	Mariposa County, CA	2003	NA	8416	7839	577	6.9
CN0604500000000	06	045	Mendocino County, CA	2003	NA	44970	41898	3072	6.8
CN0604700000000	06	047	Merced County, CA	2003	NA	96839	85757	11082	11.4
CN0604900000000	06	049	Modoc County, CA	2003	NA	4203	3839	364	8.7
CN0605100000000	06	051	Mono County, CA	2003	NA	8271	7856	415	5
CN0605300000000	06	053	Monterey County, CA	2003	NA	208693	190091	18602	8.9
CN0605500000000	06	055	Napa County, CA	2003	NA	70670	67261	3409	4.8
CN0605700000000	06	057	Nevada County, CA	2003	NA	48277	45602	2675	5.5
CN0605900000000	06	059	Orange County, CA	2003	NA	1545768	1472492	73276	4.7
CN0606100000000	06	061	Placer County, CA	2003	NA	152740	145004	7736	5.1
CN0606300000000	06	063	Plumas County, CA	2003	NA	10443	9420	1023	9.8
CN0606500000000	06	065	Riverside County, CA	2003	NA	775966	725702	50264	6.5
CN0606700000000	06	067	Sacramento County, CA	2003	NA	652166	614089	38077	5.8
CN0606900000000	06	069	San Benito County, CA	2003	NA	25500	22974	2526	9.9
CN0607100000000	06	071	San Bernardino County, CA	2003	NA	802230	752340	49890	6.2
CN0607300000000	06	073	San Diego County, CA	2003	NA	1457538	1382273	75265	5.2
CN0607500000000	06	075	San Francisco County/city, CA	2003	NA	429292	400587	28705	6.7
CN0607700000000	06	077	San Joaquin County, CA	2003	NA	278846	253418	25428	9.1
CN0607900000000	06	079	San Luis Obispo County, CA	2003	NA	127924	121939	5985	4.7
CN0608100000000	06	081	San Mateo County, CA	2003	NA	366878	345638	21240	5.8
CN0608300000000	06	083	Santa Barbara County, CA	2003	NA	207876	197443	10433	5
CN0608500000000	06	085	Santa Clara County, CA	2003	NA	843720	773878	69842	8.3
CN0608700000000	06	087	Santa Cruz County, CA	2003	NA	144155	133052	11103	7.7
CN0608900000000	06	089	Shasta County, CA	2003	NA	82380	76198	6182	7.5
CN0609100000000	06	091	Sierra County, CA	2003	NA	1635	1483	152	9.3
CN0609300000000	06	093	Siskiyou County, CA	2003	NA	19216	17399	1817	9.5
CN0609500000000	06	095	Solano County, CA	2003	NA	205399	192560	12839	6.3
CN0609700000000	06	097	Sonoma County, CA	2003	NA	252912	239225	13687	5.4
CN0609900000000	06	099	Stanislaus County, CA	2003	NA	221714	199975	21739	9.8
CN0610100000000	06	101	Sutter County, CA	2003	NA	39403	35017	4386	11.1
CN0610300000000	06	103	Tehama County, CA	2003	NA	25613	23658	1955	7.6
CN0610500000000	06	105	Trinity County, CA	2003	NA	5376	4815	561	10.4
CN0610700000000	06	107	Tulare County, CA	2003	NA	181161	159083	22078	12.2
CN0610900000000	06	109	Tuolumne County, CA	2003	NA	25295	23527	1768	7
CN0611100000000	06	111	Ventura County, CA	2003	NA	409668	386156	23512	5.7
CN0611300000000	06	113	Yolo County, CA	2003	NA	91289	85500	5789	6.3
CN0611500000000	06	115	Yuba County, CA	2003	NA	25183	22497	2686	10.7
CN0800100000000	08	001	Adams County, CO	2003	NA	200583	186573	14010	7
CN0800300000000	08	003	Alamosa County, CO	2003	NA	8190	7724	466	5.7
CN0800500000000	08	005	Arapahoe County, CO	2003	NA	291896	274121	17775	6.1
CN0800700000000	08	007	Archuleta County, CO	2003	NA	5589	5268	321	5.7
CN0800900000000	08	009	Baca County, CO	2003	NA	2374	2287	87	3.7
CN0801100000000	08	011	Bent County, CO	2003	NA	2413	2230	183	7.6
CN0801300000000	08	013	Boulder County, CO	2003	NA	164483	155291	9192	5.6
CN0801400000000	08	014	Broomfield County/city, CO	2003	NA	23707	22230	1477	6.2
CN0801500000000	08	015	Chaffee County, CO	2003	NA	7813	7373	440	5.6
CN0801700000000	08	017	Cheyenne County, CO	2003	NA	1287	1243	44	3.4
CN0801900000000	08	019	Clear Creek County, CO	2003	NA	6012	5682	330	5.5
CN0802100000000	08	021	Conejos County, CO	2003	NA	3759	3499	260	6.9
CN0802300000000	08	023	Costilla County, CO	2003	NA	1333	1198	135	10.1
CN0802500000000	08	025	Crowley County, CO	2003	NA	1604	1467	137	8.5
CN0802700000000	08	027	Custer County, CO	2003	NA	1967	1868	99	5
CN0802900000000	08	029	Delta County, CO	2003	NA	14094	13273	821	5.8
CN0803100000000	08	031	Denver County/city, CO	2003	NA	302578	281272	21306	7
CN0803300000000	08	033	Dolores County, CO	2003	NA	987	907	80	8.1
CN0803500000000	08	035	Douglas County, CO	2003	NA	128710	122091	6619	5.1
CN0803700000000	08	037	Eagle County, CO	2003	NA	26188	24960	1228	4.7
CN0803900000000	08	039	Elbert County, CO	2003	NA	12572	11894	678	5.4
CN0804100000000	08	041	El Paso County, CO	2003	NA	279948	262889	17059	6.1
CN0804300000000	08	043	Fremont County, CO	2003	NA	18572	17202	1370	7.4
CN0804500000000	08	045	Garfield County, CO	2003	NA	26980	25668	1312	4.9
CN0804700000000	08	047	Gilpin County, CO	2003	NA	3297	3107	190	5.8
CN0804900000000	08	049	Grand County, CO	2003	NA	8417	8072	345	4.1
CN0805100000000	08	051	Gunnison County, CO	2003	NA	8357	7964	393	4.7
CN0805300000000	08	053	Hinsdale County, CO	2003	NA	610	585	25	4.1
CN0805500000000	08	055	Huerfano County, CO	2003	NA	3354	3073	281	8.4
CN0805700000000	08	057	Jackson County, CO	2003	NA	1074	1020	54	5
CN0805900000000	08	059	Jefferson County, CO	2003	NA	305664	288127	17537	5.7
CN0806100000000	08	061	Kiowa County, CO	2003	NA	865	821	44	5.1
CN0806300000000	08	063	Kit Carson County, CO	2003	NA	4241	4060	181	4.3
CN0806500000000	08	065	Lake County, CO	2003	NA	3791	3562	229	6
CN0806700000000	08	067	La Plata County, CO	2003	NA	26612	25447	1165	4.4
CN0806900000000	08	069	Larimer County, CO	2003	NA	159187	151297	7890	5
CN0807100000000	08	071	Las Animas County, CO	2003	NA	7847	7385	462	5.9
CN0807300000000	08	073	Lincoln County, CO	2003	NA	3001	2870	131	4.4
CN0807500000000	08	075	Logan County, CO	2003	NA	10886	10433	453	4.2
CN0807700000000	08	077	Mesa County, CO	2003	NA	66826	63199	3627	5.4
CN0807900000000	08	079	Mineral County, CO	2003	NA	445	423	22	4.9
CN0808100000000	08	081	Moffat County, CO	2003	NA	7545	7116	429	5.7
CN0808300000000	08	083	Montezuma County, CO	2003	NA	12283	11577	706	5.7
CN0808500000000	08	085	Montrose County, CO	2003	NA	18219	17168	1051	5.8
CN0808700000000	08	087	Morgan County, CO	2003	NA	14134	13472	662	4.7
CN0808900000000	08	089	Otero County, CO	2003	NA	9267	8675	592	6.4
CN0809100000000	08	091	Ouray County, CO	2003	NA	2442	2335	107	4.4
CN0809300000000	08	093	Park County, CO	2003	NA	9363	8860	503	5.4
CN0809500000000	08	095	Phillips County, CO	2003	NA	2352	2263	89	3.8
CN0809700000000	08	097	Pitkin County, CO	2003	NA	10192	9672	520	5.1
CN0809900000000	08	099	Prowers County, CO	2003	NA	7221	6867	354	4.9
CN0810100000000	08	101	Pueblo County, CO	2003	NA	68640	63637	5003	7.3
CN0810300000000	08	103	Rio Blanco County, CO	2003	NA	3554	3416	138	3.9
CN0810500000000	08	105	Rio Grande County, CO	2003	NA	6432	6053	379	5.9
CN0810700000000	08	107	Routt County, CO	2003	NA	13712	13103	609	4.4
CN0810900000000	08	109	Saguache County, CO	2003	NA	3043	2838	205	6.7
CN0811100000000	08	111	San Juan County, CO	2003	NA	609	570	39	6.4
CN0811300000000	08	113	San Miguel County, CO	2003	NA	4918	4648	270	5.5
CN0811500000000	08	115	Sedgwick County, CO	2003	NA	1516	1451	65	4.3
CN0811700000000	08	117	Summit County, CO	2003	NA	15881	15133	748	4.7
CN0811900000000	08	119	Teller County, CO	2003	NA	12444	11685	759	6.1
CN0812100000000	08	121	Washington County, CO	2003	NA	2753	2657	96	3.5
CN0812300000000	08	123	Weld County, CO	2003	NA	105619	99557	6062	5.7
CN0812500000000	08	125	Yuma County, CO	2003	NA	5980	5798	182	3
CN0900100000000	09	001	Fairfield County, CT	2003	NA	452081	429839	22242	4.9
CN0900300000000	09	003	Hartford County, CT	2003	NA	435069	408956	26113	6
CN0900500000000	09	005	Litchfield County, CT	2003	NA	101455	96380	5075	5
CN0900700000000	09	007	Middlesex County, CT	2003	NA	88091	83898	4193	4.8
CN0900900000000	09	009	New Haven County, CT	2003	NA	426501	401675	24826	5.8
CN0901100000000	09	011	New London County, CT	2003	NA	142276	135389	6887	4.8
CN0901300000000	09	013	Tolland County, CT	2003	NA	79032	75590	3442	4.4
CN0901500000000	09	015	Windham County, CT	2003	NA	59753	56196	3557	6
CN1000100000000	10	001	Kent County, DE	2003	NA	66965	64113	2852	4.3
CN1000300000000	10	003	New Castle County, DE	2003	NA	265814	254061	11753	4.4
CN1000500000000	10	005	Sussex County, DE	2003	NA	82382	79298	3084	3.7
CN1100100000000	11	001	District of Columbia	2003	NA	306422	285454	20968	6.8
CN1200100000000	12	001	Alachua County, FL	2003	NA	119087	114641	4446	3.7
CN1200300000000	12	003	Baker County, FL	2003	NA	10426	9922	504	4.8
CN1200500000000	12	005	Bay County, FL	2003	NA	75980	71922	4058	5.3
CN1200700000000	12	007	Bradford County, FL	2003	NA	11322	10855	467	4.1
CN1200900000000	12	009	Brevard County, FL	2003	NA	242235	229392	12843	5.3
CN1201100000000	12	011	Broward County, FL	2003	NA	905406	855456	49950	5.5
CN1201300000000	12	013	Calhoun County, FL	2003	NA	5337	5073	264	4.9
CN1201500000000	12	015	Charlotte County, FL	2003	NA	59862	56570	3292	5.5
CN1201700000000	12	017	Citrus County, FL	2003	NA	47248	44264	2984	6.3
CN1201900000000	12	019	Clay County, FL	2003	NA	78118	74524	3594	4.6
CN1202100000000	12	021	Collier County, FL	2003	NA	133208	126494	6714	5
CN1202300000000	12	023	Columbia County, FL	2003	NA	26626	25345	1281	4.8
CN1202700000000	12	027	DeSoto County, FL	2003	NA	13780	12981	799	5.8
CN1202900000000	12	029	Dixie County, FL	2003	NA	5592	5300	292	5.2
CN1203100000000	12	031	Duval County, FL	2003	NA	408062	385700	22362	5.5
CN1203300000000	12	033	Escambia County, FL	2003	NA	131277	124650	6627	5
CN1203500000000	12	035	Flagler County, FL	2003	NA	24930	23489	1441	5.8
CN1203700000000	12	037	Franklin County, FL	2003	NA	4955	4732	223	4.5
CN1203900000000	12	039	Gadsden County, FL	2003	NA	19737	18699	1038	5.3
CN1204100000000	12	041	Gilchrist County, FL	2003	NA	6984	6673	311	4.5
CN1204300000000	12	043	Glades County, FL	2003	NA	4499	4245	254	5.6
CN1204500000000	12	045	Gulf County, FL	2003	NA	5842	5561	281	4.8
CN1204700000000	12	047	Hamilton County, FL	2003	NA	4517	4266	251	5.6
CN1204900000000	12	049	Hardee County, FL	2003	NA	11115	10364	751	6.8
CN1205100000000	12	051	Hendry County, FL	2003	NA	17176	15696	1480	8.6
CN1205300000000	12	053	Hernando County, FL	2003	NA	52747	49323	3424	6.5
CN1205500000000	12	055	Highlands County, FL	2003	NA	37938	35768	2170	5.7
CN1205700000000	12	057	Hillsborough County, FL	2003	NA	550232	521627	28605	5.2
CN1205900000000	12	059	Holmes County, FL	2003	NA	7744	7363	381	4.9
CN1206100000000	12	061	Indian River County, FL	2003	NA	56163	52242	3921	7
CN1206300000000	12	063	Jackson County, FL	2003	NA	20181	19309	872	4.3
CN1206500000000	12	065	Jefferson County, FL	2003	NA	6511	6223	288	4.4
CN1206700000000	12	067	Lafayette County, FL	2003	NA	2804	2686	118	4.2
CN1206900000000	12	069	Lake County, FL	2003	NA	103685	98199	5486	5.3
CN1207100000000	12	071	Lee County, FL	2003	NA	237744	226562	11182	4.7
CN1207300000000	12	073	Leon County, FL	2003	NA	134093	128524	5569	4.2
CN1207500000000	12	075	Levy County, FL	2003	NA	15251	14419	832	5.5
CN1207700000000	12	077	Liberty County, FL	2003	NA	3026	2911	115	3.8
CN1207900000000	12	079	Madison County, FL	2003	NA	7212	6845	367	5.1
CN1208100000000	12	081	Manatee County, FL	2003	NA	136093	129549	6544	4.8
CN1208300000000	12	083	Marion County, FL	2003	NA	114386	108099	6287	5.5
CN1208500000000	12	085	Martin County, FL	2003	NA	61161	57777	3384	5.5
CN1208600000000	12	086	Miami-Dade County, FL	2003	NA	1083791	1034235	49556	4.6
CN1208700000000	12	087	Monroe County, FL	2003	NA	46720	45131	1589	3.4
CN1208900000000	12	089	Nassau County, FL	2003	NA	30704	29203	1501	4.9
CN1209100000000	12	091	Okaloosa County, FL	2003	NA	88742	85403	3339	3.8
CN1209300000000	12	093	Okeechobee County, FL	2003	NA	16219	15118	1101	6.8
CN1209500000000	12	095	Orange County, FL	2003	NA	514061	486989	27072	5.3
CN1209700000000	12	097	Osceola County, FL	2003	NA	102110	96488	5622	5.5
CN1209900000000	12	099	Palm Beach County, FL	2003	NA	585815	551385	34430	5.9
CN1210100000000	12	101	Pasco County, FL	2003	NA	163533	154113	9420	5.8
CN1210300000000	12	103	Pinellas County, FL	2003	NA	460833	435958	24875	5.4
CN1210500000000	12	105	Polk County, FL	2003	NA	239924	226315	13609	5.7
CN1210700000000	12	107	Putnam County, FL	2003	NA	30712	28960	1752	5.7
CN1210900000000	12	109	St. Johns County, FL	2003	NA	72616	69518	3098	4.3
CN1211100000000	12	111	St. Lucie County, FL	2003	NA	98471	91824	6647	6.8
CN1211300000000	12	113	Santa Rosa County, FL	2003	NA	60030	57230	2800	4.7
CN1211500000000	12	115	Sarasota County, FL	2003	NA	160918	153394	7524	4.7
CN1211700000000	12	117	Seminole County, FL	2003	NA	214905	203760	11145	5.2
CN1211900000000	12	119	Sumter County, FL	2003	NA	19493	18461	1032	5.3
CN1212100000000	12	121	Suwannee County, FL	2003	NA	16084	15331	753	4.7
CN1212300000000	12	123	Taylor County, FL	2003	NA	8220	7662	558	6.8
CN1212500000000	12	125	Union County, FL	2003	NA	4858	4673	185	3.8
CN1212700000000	12	127	Volusia County, FL	2003	NA	226951	214968	11983	5.3
CN1212900000000	12	129	Wakulla County, FL	2003	NA	13117	12562	555	4.2
CN1213100000000	12	131	Walton County, FL	2003	NA	22749	21875	874	3.8
CN1213300000000	12	133	Washington County, FL	2003	NA	8832	8356	476	5.4
CN1300100000000	13	001	Appling County, GA	2003	NA	8200	7652	548	6.7
CN1300300000000	13	003	Atkinson County, GA	2003	NA	3495	3284	211	6
CN1300500000000	13	005	Bacon County, GA	2003	NA	4295	4063	232	5.4
CN1300700000000	13	007	Baker County, GA	2003	NA	1851	1761	90	4.9
CN1300900000000	13	009	Baldwin County, GA	2003	NA	19930	18992	938	4.7
CN1301100000000	13	011	Banks County, GA	2003	NA	8333	8011	322	3.9
CN1301300000000	13	013	Barrow County, GA	2003	NA	27438	26136	1302	4.7
CN1301500000000	13	015	Bartow County, GA	2003	NA	42706	40447	2259	5.3
CN1301700000000	13	017	Ben Hill County, GA	2003	NA	7762	7243	519	6.7
CN1301900000000	13	019	Berrien County, GA	2003	NA	8465	8175	290	3.4
CN1302100000000	13	021	Bibb County, GA	2003	NA	71971	68488	3483	4.8
CN1302300000000	13	023	Bleckley County, GA	2003	NA	5311	5047	264	5
CN1302500000000	13	025	Brantley County, GA	2003	NA	7195	6806	389	5.4
CN1302700000000	13	027	Brooks County, GA	2003	NA	7997	7727	270	3.4
CN1302900000000	13	029	Bryan County, GA	2003	NA	13183	12708	475	3.6
CN1303100000000	13	031	Bulloch County, GA	2003	NA	29120	27895	1225	4.2
CN1303300000000	13	033	Burke County, GA	2003	NA	9964	9139	825	8.3
CN1303500000000	13	035	Butts County, GA	2003	NA	9576	9077	499	5.2
CN1303700000000	13	037	Calhoun County, GA	2003	NA	2454	2294	160	6.5
CN1303900000000	13	039	Camden County, GA	2003	NA	18756	17745	1011	5.4
CN1304300000000	13	043	Candler County, GA	2003	NA	4162	3980	182	4.4
CN1304500000000	13	045	Carroll County, GA	2003	NA	47729	45255	2474	5.2
CN1304700000000	13	047	Catoosa County, GA	2003	NA	32863	31775	1088	3.3
CN1304900000000	13	049	Charlton County, GA	2003	NA	4243	4014	229	5.4
CN1305100000000	13	051	Chatham County, GA	2003	NA	116179	111181	4998	4.3
CN1305300000000	13	053	Chattahoochee County, GA	2003	NA	2748	2523	225	8.2
CN1305500000000	13	055	Chattooga County, GA	2003	NA	11335	10836	499	4.4
CN1305700000000	13	057	Cherokee County, GA	2003	NA	91178	87455	3723	4.1
CN1305900000000	13	059	Clarke County, GA	2003	NA	57142	54998	2144	3.8
CN1306100000000	13	061	Clay County, GA	2003	NA	1536	1468	68	4.4
CN1306300000000	13	063	Clayton County, GA	2003	NA	131772	123982	7790	5.9
CN1306500000000	13	065	Clinch County, GA	2003	NA	2426	2284	142	5.9
CN1306700000000	13	067	Cobb County, GA	2003	NA	361172	345198	15974	4.4
CN1306900000000	13	069	Coffee County, GA	2003	NA	17318	16114	1204	7
CN1307100000000	13	071	Colquitt County, GA	2003	NA	18303	17337	966	5.3
CN1307300000000	13	073	Columbia County, GA	2003	NA	52446	50601	1845	3.5
CN1307500000000	13	075	Cook County, GA	2003	NA	7032	6661	371	5.3
CN1307700000000	13	077	Coweta County, GA	2003	NA	51879	49526	2353	4.5
CN1307900000000	13	079	Crawford County, GA	2003	NA	6095	5806	289	4.7
CN1308100000000	13	081	Crisp County, GA	2003	NA	9527	8982	545	5.7
CN1308300000000	13	083	Dade County, GA	2003	NA	8286	7932	354	4.3
CN1308500000000	13	085	Dawson County, GA	2003	NA	9731	9352	379	3.9
CN1308700000000	13	087	Decatur County, GA	2003	NA	12160	11470	690	5.7
CN1308900000000	13	089	DeKalb County, GA	2003	NA	366983	346963	20020	5.5
CN1309100000000	13	091	Dodge County, GA	2003	NA	8753	8290	463	5.3
CN1309300000000	13	093	Dooly County, GA	2003	NA	4749	4464	285	6
CN1309500000000	13	095	Dougherty County, GA	2003	NA	41489	39134	2355	5.7
CN1309700000000	13	097	Douglas County, GA	2003	NA	53789	51241	2548	4.7
CN1309900000000	13	099	Early County, GA	2003	NA	5864	5530	334	5.7
CN1310100000000	13	101	Echols County, GA	2003	NA	2114	2049	65	3.1
CN1310300000000	13	103	Effingham County, GA	2003	NA	22030	21165	865	3.9
CN1310500000000	13	105	Elbert County, GA	2003	NA	10190	9605	585	5.7
CN1310700000000	13	107	Emanuel County, GA	2003	NA	10448	9929	519	5
CN1310900000000	13	109	Evans County, GA	2003	NA	4765	4565	200	4.2
CN1311100000000	13	111	Fannin County, GA	2003	NA	9643	9032	611	6.3
CN1311300000000	13	113	Fayette County, GA	2003	NA	50383	48525	1858	3.7
CN1311500000000	13	115	Floyd County, GA	2003	NA	49057	46768	2289	4.7
CN1311700000000	13	117	Forsyth County, GA	2003	NA	67047	64525	2522	3.8
CN1311900000000	13	119	Franklin County, GA	2003	NA	10342	9792	550	5.3
CN1312100000000	13	121	Fulton County, GA	2003	NA	445338	421444	23894	5.4
CN1312300000000	13	123	Gilmer County, GA	2003	NA	12593	12055	538	4.3
CN1312500000000	13	125	Glascock County, GA	2003	NA	1201	1141	60	5
CN1312700000000	13	127	Glynn County, GA	2003	NA	36363	34899	1464	4
CN1312900000000	13	129	Gordon County, GA	2003	NA	24904	23731	1173	4.7
CN1313100000000	13	131	Grady County, GA	2003	NA	11135	10629	506	4.5
CN1313300000000	13	133	Greene County, GA	2003	NA	6467	6054	413	6.4
CN1313500000000	13	135	Gwinnett County, GA	2003	NA	371758	355315	16443	4.4
CN1313700000000	13	137	Habersham County, GA	2003	NA	19365	18590	775	4
CN1313900000000	13	139	Hall County, GA	2003	NA	79352	76163	3189	4
CN1314100000000	13	141	Hancock County, GA	2003	NA	3378	3128	250	7.4
CN1314300000000	13	143	Haralson County, GA	2003	NA	12494	11881	613	4.9
CN1314500000000	13	145	Harris County, GA	2003	NA	14334	13809	525	3.7
CN1314700000000	13	147	Hart County, GA	2003	NA	10972	10416	556	5.1
CN1314900000000	13	149	Heard County, GA	2003	NA	4941	4636	305	6.2
CN1315100000000	13	151	Henry County, GA	2003	NA	79163	75731	3432	4.3
CN1315300000000	13	153	Houston County, GA	2003	NA	59021	56840	2181	3.7
CN1315500000000	13	155	Irwin County, GA	2003	NA	4432	4166	266	6
CN1315700000000	13	157	Jackson County, GA	2003	NA	22844	21805	1039	4.5
CN1315900000000	13	159	Jasper County, GA	2003	NA	6037	5727	310	5.1
CN1316100000000	13	161	Jeff Davis County, GA	2003	NA	5629	5200	429	7.6
CN1316300000000	13	163	Jefferson County, GA	2003	NA	6918	6352	566	8.2
CN1316500000000	13	165	Jenkins County, GA	2003	NA	3410	3198	212	6.2
CN1316700000000	13	167	Johnson County, GA	2003	NA	3662	3406	256	7
CN1316900000000	13	169	Jones County, GA	2003	NA	12881	12372	509	4
CN1317100000000	13	171	Lamar County, GA	2003	NA	7740	7328	412	5.3
CN1317300000000	13	173	Lanier County, GA	2003	NA	3637	3509	128	3.5
CN1317500000000	13	175	Laurens County, GA	2003	NA	21594	20306	1288	6
CN1317700000000	13	177	Lee County, GA	2003	NA	15200	14679	521	3.4
CN1317900000000	13	179	Liberty County, GA	2003	NA	20909	19819	1090	5.2
CN1318100000000	13	181	Lincoln County, GA	2003	NA	3481	3225	256	7.4
CN1318300000000	13	183	Long County, GA	2003	NA	4922	4741	181	3.7
CN1318500000000	13	185	Lowndes County, GA	2003	NA	47898	46201	1697	3.5
CN1318700000000	13	187	Lumpkin County, GA	2003	NA	11664	11184	480	4.1
CN1318900000000	13	189	McDuffie County, GA	2003	NA	10375	9723	652	6.3
CN1319100000000	13	191	McIntosh County, GA	2003	NA	4933	4718	215	4.4
CN1319300000000	13	193	Macon County, GA	2003	NA	5176	4774	402	7.8
CN1319500000000	13	195	Madison County, GA	2003	NA	15101	14498	603	4
CN1319700000000	13	197	Marion County, GA	2003	NA	3392	3202	190	5.6
CN1319900000000	13	199	Meriwether County, GA	2003	NA	9722	9096	626	6.4
CN1320100000000	13	201	Miller County, GA	2003	NA	3502	3329	173	4.9
CN1320500000000	13	205	Mitchell County, GA	2003	NA	9928	9375	553	5.6
CN1320700000000	13	207	Monroe County, GA	2003	NA	12327	11825	502	4.1
CN1320900000000	13	209	Montgomery County, GA	2003	NA	4132	3893	239	5.8
CN1321100000000	13	211	Morgan County, GA	2003	NA	8567	8203	364	4.2
CN1321300000000	13	213	Murray County, GA	2003	NA	20534	19686	848	4.1
CN1321500000000	13	215	Muscogee County, GA	2003	NA	83339	78888	4451	5.3
CN1321700000000	13	217	Newton County, GA	2003	NA	37464	35495	1969	5.3
CN1321900000000	13	219	Oconee County, GA	2003	NA	15875	15421	454	2.9
CN1322100000000	13	221	Oglethorpe County, GA	2003	NA	7285	6987	298	4.1
CN1322300000000	13	223	Paulding County, GA	2003	NA	52290	50125	2165	4.1
CN1322500000000	13	225	Peach County, GA	2003	NA	11276	10622	654	5.8
CN1322700000000	13	227	Pickens County, GA	2003	NA	13644	13048	596	4.4
CN1322900000000	13	229	Pierce County, GA	2003	NA	7902	7559	343	4.3
CN1323100000000	13	231	Pike County, GA	2003	NA	7230	6856	374	5.2
CN1323300000000	13	233	Polk County, GA	2003	NA	19626	18703	923	4.7
CN1323500000000	13	235	Pulaski County, GA	2003	NA	4284	4096	188	4.4
CN1323700000000	13	237	Putnam County, GA	2003	NA	9095	8690	405	4.5
CN1323900000000	13	239	Quitman County, GA	2003	NA	971	921	50	5.1
CN1324100000000	13	241	Rabun County, GA	2003	NA	7435	7160	275	3.7
CN1324300000000	13	243	Randolph County, GA	2003	NA	2970	2748	222	7.5
CN1324500000000	13	245	Richmond County, GA	2003	NA	88868	84014	4854	5.5
CN1324700000000	13	247	Rockdale County, GA	2003	NA	37304	35459	1845	4.9
CN1324900000000	13	249	Schley County, GA	2003	NA	1728	1631	97	5.6
CN1325100000000	13	251	Screven County, GA	2003	NA	6611	6247	364	5.5
CN1325300000000	13	253	Seminole County, GA	2003	NA	4045	3827	218	5.4
CN1325500000000	13	255	Spalding County, GA	2003	NA	27734	25981	1753	6.3
CN1325700000000	13	257	Stephens County, GA	2003	NA	13383	12591	792	5.9
CN1325900000000	13	259	Stewart County, GA	2003	NA	2050	1901	149	7.3
CN1326100000000	13	261	Sumter County, GA	2003	NA	14747	13927	820	5.6
CN1326300000000	13	263	Talbot County, GA	2003	NA	2958	2784	174	5.9
CN1326500000000	13	265	Taliaferro County, GA	2003	NA	762	704	58	7.6
CN1326700000000	13	267	Tattnall County, GA	2003	NA	8549	8124	425	5
CN1326900000000	13	269	Taylor County, GA	2003	NA	3303	3104	199	6
CN1327100000000	13	271	Telfair County, GA	2003	NA	4149	3795	354	8.5
CN1327300000000	13	273	Terrell County, GA	2003	NA	4649	4403	246	5.3
CN1327500000000	13	275	Thomas County, GA	2003	NA	21218	20298	920	4.3
CN1327700000000	13	277	Tift County, GA	2003	NA	19057	18223	834	4.4
CN1327900000000	13	279	Toombs County, GA	2003	NA	12262	11512	750	6.1
CN1328100000000	13	281	Towns County, GA	2003	NA	5126	4938	188	3.7
CN1328300000000	13	283	Treutlen County, GA	2003	NA	2653	2470	183	6.9
CN1328500000000	13	285	Troup County, GA	2003	NA	30064	28439	1625	5.4
CN1328700000000	13	287	Turner County, GA	2003	NA	4889	4578	311	6.4
CN1328900000000	13	289	Twiggs County, GA	2003	NA	4676	4429	247	5.3
CN1329100000000	13	291	Union County, GA	2003	NA	9478	9076	402	4.2
CN1329300000000	13	293	Upson County, GA	2003	NA	11530	10802	728	6.3
CN1329500000000	13	295	Walker County, GA	2003	NA	31834	30471	1363	4.3
CN1329700000000	13	297	Walton County, GA	2003	NA	34653	33168	1485	4.3
CN1329900000000	13	299	Ware County, GA	2003	NA	15222	14435	787	5.2
CN1330100000000	13	301	Warren County, GA	2003	NA	2519	2269	250	9.9
CN1330300000000	13	303	Washington County, GA	2003	NA	8316	7815	501	6
CN1330500000000	13	305	Wayne County, GA	2003	NA	11347	10754	593	5.2
CN1330700000000	13	307	Webster County, GA	2003	NA	1061	1006	55	5.2
CN1330900000000	13	309	Wheeler County, GA	2003	NA	2381	2234	147	6.2
CN1331100000000	13	311	White County, GA	2003	NA	11403	10968	435	3.8
CN1331300000000	13	313	Whitfield County, GA	2003	NA	44249	42400	1849	4.2
CN1331500000000	13	315	Wilcox County, GA	2003	NA	3286	3074	212	6.5
CN1331700000000	13	317	Wilkes County, GA	2003	NA	4700	4345	355	7.6
CN1331900000000	13	319	Wilkinson County, GA	2003	NA	4448	4204	244	5.5
CN1332100000000	13	321	Worth County, GA	2003	NA	10320	9812	508	4.9
CN1500100000000	15	001	Hawaii County, HI	2003	NA	76757	72980	3777	4.9
CN1500300000000	15	003	Honolulu County/city, HI	2003	NA	424451	407549	16902	4
CN1500700000000	15	007	Kauai County, HI	2003	NA	30644	29350	1294	4.2
CN1500900000000	15	009	Maui County, HI	2003	NA	71272	68445	2827	4
CN1600100000000	16	001	Ada County, ID	2003	NA	177056	168453	8603	4.9
CN1600300000000	16	003	Adams County, ID	2003	NA	1867	1635	232	12.4
CN1600500000000	16	005	Bannock County, ID	2003	NA	39448	37355	2093	5.3
CN1600700000000	16	007	Bear Lake County, ID	2003	NA	2895	2730	165	5.7
CN1600900000000	16	009	Benewah County, ID	2003	NA	3963	3524	439	11.1
CN1601100000000	16	011	Bingham County, ID	2003	NA	20205	19252	953	4.7
CN1601300000000	16	013	Blaine County, ID	2003	NA	12674	12117	557	4.4
CN1601500000000	16	015	Boise County, ID	2003	NA	3530	3333	197	5.6
CN1601700000000	16	017	Bonner County, ID	2003	NA	18533	17087	1446	7.8
CN1601900000000	16	019	Bonneville County, ID	2003	NA	45703	43994	1709	3.7
CN1602100000000	16	021	Boundary County, ID	2003	NA	4204	3822	382	9.1
CN1602300000000	16	023	Butte County, ID	2003	NA	1316	1231	85	6.5
CN1602500000000	16	025	Camas County, ID	2003	NA	564	534	30	5.3
CN1602700000000	16	027	Canyon County, ID	2003	NA	73260	68544	4716	6.4
CN1602900000000	16	029	Caribou County, ID	2003	NA	3405	3172	233	6.8
CN1603100000000	16	031	Cassia County, ID	2003	NA	9882	9272	610	6.2
CN1603300000000	16	033	Clark County, ID	2003	NA	538	507	31	5.8
CN1603500000000	16	035	Clearwater County, ID	2003	NA	3296	2900	396	12
CN1603700000000	16	037	Custer County, ID	2003	NA	2531	2369	162	6.4
CN1603900000000	16	039	Elmore County, ID	2003	NA	10698	10016	682	6.4
CN1604100000000	16	041	Franklin County, ID	2003	NA	5800	5546	254	4.4
CN1604300000000	16	043	Fremont County, ID	2003	NA	5709	5414	295	5.2
CN1604500000000	16	045	Gem County, ID	2003	NA	7044	6593	451	6.4
CN1604700000000	16	047	Gooding County, ID	2003	NA	7401	7090	311	4.2
CN1604900000000	16	049	Idaho County, ID	2003	NA	6860	6238	622	9.1
CN1605100000000	16	051	Jefferson County, ID	2003	NA	9904	9518	386	3.9
CN1605300000000	16	053	Jerome County, ID	2003	NA	9527	9077	450	4.7
CN1605500000000	16	055	Kootenai County, ID	2003	NA	61574	57403	4171	6.8
CN1605700000000	16	057	Latah County, ID	2003	NA	16099	15342	757	4.7
CN1605900000000	16	059	Lemhi County, ID	2003	NA	3835	3541	294	7.7
CN1606100000000	16	061	Lewis County, ID	2003	NA	1673	1598	75	4.5
CN1606300000000	16	063	Lincoln County, ID	2003	NA	2269	2138	131	5.8
CN1606500000000	16	065	Madison County, ID	2003	NA	13418	13006	412	3.1
CN1606700000000	16	067	Minidoka County, ID	2003	NA	9402	8683	719	7.6
CN1606900000000	16	069	Nez Perce County, ID	2003	NA	19193	18143	1050	5.5
CN1607100000000	16	071	Oneida County, ID	2003	NA	1961	1882	79	4
CN1607300000000	16	073	Owyhee County, ID	2003	NA	4689	4553	136	2.9
CN1607500000000	16	075	Payette County, ID	2003	NA	10469	9534	935	8.9
CN1607700000000	16	077	Power County, ID	2003	NA	3660	3401	259	7.1
CN1607900000000	16	079	Shoshone County, ID	2003	NA	5494	4802	692	12.6
CN1608100000000	16	081	Teton County, ID	2003	NA	4169	4016	153	3.7
CN1608300000000	16	083	Twin Falls County, ID	2003	NA	35545	33937	1608	4.5
CN1608500000000	16	085	Valley County, ID	2003	NA	4013	3678	335	8.3
CN1608700000000	16	087	Washington County, ID	2003	NA	4737	4358	379	8
CN1700100000000	17	001	Adams County, IL	2003	NA	35240	33362	1878	5.3
CN1700300000000	17	003	Alexander County, IL	2003	NA	3470	3101	369	10.6
CN1700500000000	17	005	Bond County, IL	2003	NA	8204	7699	505	6.2
CN1700700000000	17	007	Boone County, IL	2003	NA	22656	20847	1809	8
CN1700900000000	17	009	Brown County, IL	2003	NA	3046	2914	132	4.3
CN1701100000000	17	011	Bureau County, IL	2003	NA	18128	16831	1297	7.2
CN1701300000000	17	013	Calhoun County, IL	2003	NA	2485	2307	178	7.2
CN1701500000000	17	015	Carroll County, IL	2003	NA	8194	7535	659	8
CN1701700000000	17	017	Cass County, IL	2003	NA	7142	6733	409	5.7
CN1701900000000	17	019	Champaign County, IL	2003	NA	98703	94298	4405	4.5
CN1702100000000	17	021	Christian County, IL	2003	NA	16784	15655	1129	6.7
CN1702300000000	17	023	Clark County, IL	2003	NA	8372	7778	594	7.1
CN1702500000000	17	025	Clay County, IL	2003	NA	6872	6384	488	7.1
CN1702700000000	17	027	Clinton County, IL	2003	NA	18082	17052	1030	5.7
CN1702900000000	17	029	Coles County, IL	2003	NA	26759	25211	1548	5.8
CN1703100000000	17	031	Cook County, IL	2003	NA	2585535	2392771	192764	7.5
CN1703300000000	17	033	Crawford County, IL	2003	NA	9027	8368	659	7.3
CN1703500000000	17	035	Cumberland County, IL	2003	NA	5597	5218	379	6.8
CN1703700000000	17	037	DeKalb County, IL	2003	NA	51256	48330	2926	5.7
CN1703900000000	17	039	De Witt County, IL	2003	NA	8132	7602	530	6.5
CN1704100000000	17	041	Douglas County, IL	2003	NA	10406	9859	547	5.3
CN1704300000000	17	043	DuPage County, IL	2003	NA	512204	483622	28582	5.6
CN1704500000000	17	045	Edgar County, IL	2003	NA	9952	9353	599	6
CN1704700000000	17	047	Edwards County, IL	2003	NA	3461	3289	172	5
CN1704900000000	17	049	Effingham County, IL	2003	NA	17448	16421	1027	5.9
CN1705100000000	17	051	Fayette County, IL	2003	NA	9840	9075	765	7.8
CN1705300000000	17	053	Ford County, IL	2003	NA	7125	6755	370	5.2
CN1705500000000	17	055	Franklin County, IL	2003	NA	17080	15579	1501	8.8
CN1705700000000	17	057	Fulton County, IL	2003	NA	17139	15802	1337	7.8
CN1705900000000	17	059	Gallatin County, IL	2003	NA	2687	2452	235	8.7
CN1706100000000	17	061	Greene County, IL	2003	NA	6939	6522	417	6
CN1706300000000	17	063	Grundy County, IL	2003	NA	21161	19458	1703	8
CN1706500000000	17	065	Hamilton County, IL	2003	NA	3916	3640	276	7
CN1706700000000	17	067	Hancock County, IL	2003	NA	10171	9458	713	7
CN1706900000000	17	069	Hardin County, IL	2003	NA	1896	1730	166	8.8
CN1707100000000	17	071	Henderson County, IL	2003	NA	3994	3703	291	7.3
CN1707300000000	17	073	Henry County, IL	2003	NA	26167	24602	1565	6
CN1707500000000	17	075	Iroquois County, IL	2003	NA	15767	14822	945	6
CN1707700000000	17	077	Jackson County, IL	2003	NA	30608	28958	1650	5.4
CN1707900000000	17	079	Jasper County, IL	2003	NA	5098	4752	346	6.8
CN1708100000000	17	081	Jefferson County, IL	2003	NA	19149	17960	1189	6.2
CN1708300000000	17	083	Jersey County, IL	2003	NA	10988	10347	641	5.8
CN1708500000000	17	085	Jo Daviess County, IL	2003	NA	12344	11657	687	5.6
CN1708700000000	17	087	Johnson County, IL	2003	NA	4938	4600	338	6.8
CN1708900000000	17	089	Kane County, IL	2003	NA	238534	222593	15941	6.7
CN1709100000000	17	091	Kankakee County, IL	2003	NA	51211	47472	3739	7.3
CN1709300000000	17	093	Kendall County, IL	2003	NA	37374	35219	2155	5.8
CN1709500000000	17	095	Knox County, IL	2003	NA	25870	23866	2004	7.7
CN1709700000000	17	097	Lake County, IL	2003	NA	341104	321483	19621	5.8
CN1709900000000	17	099	LaSalle County, IL	2003	NA	54081	49889	4192	7.8
CN1710100000000	17	101	Lawrence County, IL	2003	NA	8162	7668	494	6.1
CN1710300000000	17	103	Lee County, IL	2003	NA	17156	16086	1070	6.2
CN1710500000000	17	105	Livingston County, IL	2003	NA	18590	17516	1074	5.8
CN1710700000000	17	107	Logan County, IL	2003	NA	13256	12364	892	6.7
CN1710900000000	17	109	McDonough County, IL	2003	NA	16143	15200	943	5.8
CN1711100000000	17	111	McHenry County, IL	2003	NA	158544	149079	9465	6
CN1711300000000	17	113	McLean County, IL	2003	NA	85369	81892	3477	4.1
CN1711500000000	17	115	Macon County, IL	2003	NA	51487	47547	3940	7.7
CN1711700000000	17	117	Macoupin County, IL	2003	NA	23812	22242	1570	6.6
CN1711900000000	17	119	Madison County, IL	2003	NA	131111	123036	8075	6.2
CN1712100000000	17	121	Marion County, IL	2003	NA	18313	16626	1687	9.2
CN1712300000000	17	123	Marshall County, IL	2003	NA	6694	6311	383	5.7
CN1712500000000	17	125	Mason County, IL	2003	NA	7624	7004	620	8.1
CN1712700000000	17	127	Massac County, IL	2003	NA	7105	6659	446	6.3
CN1712900000000	17	129	Menard County, IL	2003	NA	6679	6361	318	4.8
CN1713100000000	17	131	Mercer County, IL	2003	NA	8535	7932	603	7.1
CN1713300000000	17	133	Monroe County, IL	2003	NA	16079	15335	744	4.6
CN1713500000000	17	135	Montgomery County, IL	2003	NA	13184	12037	1147	8.7
CN1713700000000	17	137	Morgan County, IL	2003	NA	17845	16805	1040	5.8
CN1713900000000	17	139	Moultrie County, IL	2003	NA	7224	6824	400	5.5
CN1714100000000	17	141	Ogle County, IL	2003	NA	25517	23758	1759	6.9
CN1714300000000	17	143	Peoria County, IL	2003	NA	87735	82075	5660	6.5
CN1714500000000	17	145	Perry County, IL	2003	NA	10337	9522	815	7.9
CN1714700000000	17	147	Piatt County, IL	2003	NA	8876	8433	443	5
CN1714900000000	17	149	Pike County, IL	2003	NA	8372	7867	505	6
CN1715100000000	17	151	Pope County, IL	2003	NA	1906	1749	157	8.2
CN1715300000000	17	153	Pulaski County, IL	2003	NA	2990	2707	283	9.5
CN1715500000000	17	155	Putnam County, IL	2003	NA	3014	2793	221	7.3
CN1715700000000	17	157	Randolph County, IL	2003	NA	15132	14210	922	6.1
CN1715900000000	17	159	Richland County, IL	2003	NA	7234	6728	506	7
CN1716100000000	17	161	Rock Island County, IL	2003	NA	74394	69932	4462	6
CN1716300000000	17	163	St. Clair County, IL	2003	NA	117650	109343	8307	7.1
CN1716500000000	17	165	Saline County, IL	2003	NA	11968	11056	912	7.6
CN1716700000000	17	167	Sangamon County, IL	2003	NA	101339	95863	5476	5.4
CN1716900000000	17	169	Schuyler County, IL	2003	NA	4115	3884	231	5.6
CN1717100000000	17	171	Scott County, IL	2003	NA	2840	2664	176	6.2
CN1717300000000	17	173	Shelby County, IL	2003	NA	11075	10371	704	6.4
CN1717500000000	17	175	Stark County, IL	2003	NA	2733	2524	209	7.6
CN1717700000000	17	177	Stephenson County, IL	2003	NA	24655	22910	1745	7.1
CN1717900000000	17	179	Tazewell County, IL	2003	NA	64755	60985	3770	5.8
CN1718100000000	17	181	Union County, IL	2003	NA	8198	7553	645	7.9
CN1718300000000	17	183	Vermilion County, IL	2003	NA	37268	34280	2988	8
CN1718500000000	17	185	Wabash County, IL	2003	NA	6508	6114	394	6.1
CN1718700000000	17	187	Warren County, IL	2003	NA	9200	8617	583	6.3
CN1718900000000	17	189	Washington County, IL	2003	NA	8313	7876	437	5.3
CN1719100000000	17	191	Wayne County, IL	2003	NA	7871	7377	494	6.3
CN1719300000000	17	193	White County, IL	2003	NA	7778	7340	438	5.6
CN1719500000000	17	195	Whiteside County, IL	2003	NA	28859	26813	2046	7.1
CN1719700000000	17	197	Will County, IL	2003	NA	305756	285399	20357	6.7
CN1719900000000	17	199	Williamson County, IL	2003	NA	30950	28837	2113	6.8
CN1720100000000	17	201	Winnebago County, IL	2003	NA	139186	127977	11209	8.1
CN1720300000000	17	203	Woodford County, IL	2003	NA	18458	17598	860	4.7
CN1800100000000	18	001	Adams County, IN	2003	NA	16096	15404	692	4.3
CN1800300000000	18	003	Allen County, IN	2003	NA	179084	169628	9456	5.3
CN1800500000000	18	005	Bartholomew County, IN	2003	NA	35692	33990	1702	4.8
CN1800700000000	18	007	Benton County, IN	2003	NA	4693	4438	255	5.4
CN1800900000000	18	009	Blackford County, IN	2003	NA	6916	6406	510	7.4
CN1801100000000	18	011	Boone County, IN	2003	NA	26153	25100	1053	4
CN1801300000000	18	013	Brown County, IN	2003	NA	8119	7710	409	5
CN1801500000000	18	015	Carroll County, IN	2003	NA	10633	9987	646	6.1
CN1801700000000	18	017	Cass County, IN	2003	NA	20040	18788	1252	6.2
CN1801900000000	18	019	Clark County, IN	2003	NA	52949	50345	2604	4.9
CN1802100000000	18	021	Clay County, IN	2003	NA	13020	12268	752	5.8
CN1802300000000	18	023	Clinton County, IN	2003	NA	16863	15977	886	5.3
CN1802500000000	18	025	Crawford County, IN	2003	NA	5350	4984	366	6.8
CN1802700000000	18	027	Daviess County, IN	2003	NA	14358	13772	586	4.1
CN1802900000000	18	029	Dearborn County, IN	2003	NA	25885	24550	1335	5.2
CN1803100000000	18	031	Decatur County, IN	2003	NA	12526	11954	572	4.6
CN1803300000000	18	033	DeKalb County, IN	2003	NA	22044	20795	1249	5.7
CN1803500000000	18	035	Delaware County, IN	2003	NA	59032	55339	3693	6.3
CN1803700000000	18	037	Dubois County, IN	2003	NA	22469	21657	812	3.6
CN1803900000000	18	039	Elkhart County, IN	2003	NA	96260	91732	4528	4.7
CN1804100000000	18	041	Fayette County, IN	2003	NA	11637	10708	929	8
CN1804300000000	18	043	Floyd County, IN	2003	NA	37514	35776	1738	4.6
CN1804500000000	18	045	Fountain County, IN	2003	NA	8412	7933	479	5.7
CN1804700000000	18	047	Franklin County, IN	2003	NA	11890	11205	685	5.8
CN1804900000000	18	049	Fulton County, IN	2003	NA	10375	9740	635	6.1
CN1805100000000	18	051	Gibson County, IN	2003	NA	17384	16577	807	4.6
CN1805300000000	18	053	Grant County, IN	2003	NA	34814	32207	2607	7.5
CN1805500000000	18	055	Greene County, IN	2003	NA	16588	15542	1046	6.3
CN1805700000000	18	057	Hamilton County, IN	2003	NA	121206	117220	3986	3.3
CN1805900000000	18	059	Hancock County, IN	2003	NA	32857	31511	1346	4.1
CN1806100000000	18	061	Harrison County, IN	2003	NA	19064	18128	936	4.9
CN1806300000000	18	063	Hendricks County, IN	2003	NA	65540	62833	2707	4.1
CN1806500000000	18	065	Henry County, IN	2003	NA	23523	22121	1402	6
CN1806700000000	18	067	Howard County, IN	2003	NA	40158	37413	2745	6.8
CN1806900000000	18	069	Huntington County, IN	2003	NA	20684	19565	1119	5.4
CN1807100000000	18	071	Jackson County, IN	2003	NA	21979	20935	1044	4.7
CN1807300000000	18	073	Jasper County, IN	2003	NA	15099	14245	854	5.7
CN1807500000000	18	075	Jay County, IN	2003	NA	10735	9938	797	7.4
CN1807700000000	18	077	Jefferson County, IN	2003	NA	16842	16036	806	4.8
CN1807900000000	18	079	Jennings County, IN	2003	NA	13925	13038	887	6.4
CN1808100000000	18	081	Johnson County, IN	2003	NA	67982	65252	2730	4
CN1808300000000	18	083	Knox County, IN	2003	NA	19634	18767	867	4.4
CN1808500000000	18	085	Kosciusko County, IN	2003	NA	39671	37937	1734	4.4
CN1808700000000	18	087	LaGrange County, IN	2003	NA	16552	15812	740	4.5
CN1808900000000	18	089	Lake County, IN	2003	NA	225896	212063	13833	6.1
CN1809100000000	18	091	LaPorte County, IN	2003	NA	53847	50198	3649	6.8
CN1809300000000	18	093	Lawrence County, IN	2003	NA	22708	21100	1608	7.1
CN1809500000000	18	095	Madison County, IN	2003	NA	64539	60677	3862	6
CN1809700000000	18	097	Marion County, IN	2003	NA	464331	439470	24861	5.4
CN1809900000000	18	099	Marshall County, IN	2003	NA	22225	21020	1205	5.4
CN1810100000000	18	101	Martin County, IN	2003	NA	5385	5116	269	5
CN1810300000000	18	103	Miami County, IN	2003	NA	17414	16142	1272	7.3
CN1810500000000	18	105	Monroe County, IN	2003	NA	65677	62901	2776	4.2
CN1810700000000	18	107	Montgomery County, IN	2003	NA	19603	18764	839	4.3
CN1810900000000	18	109	Morgan County, IN	2003	NA	36996	35221	1775	4.8
CN1811100000000	18	111	Newton County, IN	2003	NA	7166	6783	383	5.3
CN1811300000000	18	113	Noble County, IN	2003	NA	23760	22293	1467	6.2
CN1811500000000	18	115	Ohio County, IN	2003	NA	3092	2941	151	4.9
CN1811700000000	18	117	Orange County, IN	2003	NA	9200	8474	726	7.9
CN1811900000000	18	119	Owen County, IN	2003	NA	11704	11052	652	5.6
CN1812100000000	18	121	Parke County, IN	2003	NA	8049	7586	463	5.8
CN1812300000000	18	123	Perry County, IN	2003	NA	9626	9102	524	5.4
CN1812500000000	18	125	Pike County, IN	2003	NA	6433	6090	343	5.3
CN1812700000000	18	127	Porter County, IN	2003	NA	79859	75808	4051	5.1
CN1812900000000	18	129	Posey County, IN	2003	NA	14086	13474	612	4.3
CN1813100000000	18	131	Pulaski County, IN	2003	NA	6699	6322	377	5.6
CN1813300000000	18	133	Putnam County, IN	2003	NA	17671	16693	978	5.5
CN1813500000000	18	135	Randolph County, IN	2003	NA	13552	12621	931	6.9
CN1813700000000	18	137	Ripley County, IN	2003	NA	14720	14045	675	4.6
CN1813900000000	18	139	Rush County, IN	2003	NA	9279	8824	455	4.9
CN1814100000000	18	141	St. Joseph County, IN	2003	NA	132464	125425	7039	5.3
CN1814300000000	18	143	Scott County, IN	2003	NA	11092	10375	717	6.5
CN1814500000000	18	145	Shelby County, IN	2003	NA	23825	22683	1142	4.8
CN1814700000000	18	147	Spencer County, IN	2003	NA	10794	10234	560	5.2
CN1814900000000	18	149	Starke County, IN	2003	NA	10543	9777	766	7.3
CN1815100000000	18	151	Steuben County, IN	2003	NA	17014	15916	1098	6.5
CN1815300000000	18	153	Sullivan County, IN	2003	NA	9296	8664	632	6.8
CN1815500000000	18	155	Switzerland County, IN	2003	NA	5748	5494	254	4.4
CN1815700000000	18	157	Tippecanoe County, IN	2003	NA	77577	73934	3643	4.7
CN1815900000000	18	159	Tipton County, IN	2003	NA	8313	7863	450	5.4
CN1816100000000	18	161	Union County, IN	2003	NA	3775	3582	193	5.1
CN1816300000000	18	163	Vanderburgh County, IN	2003	NA	92430	88057	4373	4.7
CN1816500000000	18	165	Vermillion County, IN	2003	NA	8058	7531	527	6.5
CN1816700000000	18	167	Vigo County, IN	2003	NA	50396	47383	3013	6
CN1816900000000	18	169	Wabash County, IN	2003	NA	17715	16712	1003	5.7
CN1817100000000	18	171	Warren County, IN	2003	NA	4553	4329	224	4.9
CN1817300000000	18	173	Warrick County, IN	2003	NA	30145	28866	1279	4.2
CN1817500000000	18	175	Washington County, IN	2003	NA	14067	13260	807	5.7
CN1817700000000	18	177	Wayne County, IN	2003	NA	34415	32141	2274	6.6
CN1817900000000	18	179	Wells County, IN	2003	NA	14970	14259	711	4.7
CN1818100000000	18	181	White County, IN	2003	NA	12361	11445	916	7.4
CN1818300000000	18	183	Whitley County, IN	2003	NA	17679	16687	992	5.6
CN1900100000000	19	001	Adair County, IA	2003	NA	4286	4110	176	4.1
CN1900300000000	19	003	Adams County, IA	2003	NA	2127	2019	108	5.1
CN1900500000000	19	005	Allamakee County, IA	2003	NA	8065	7615	450	5.6
CN1900700000000	19	007	Appanoose County, IA	2003	NA	6496	6143	353	5.4
CN1900900000000	19	009	Audubon County, IA	2003	NA	3278	3146	132	4
CN1901100000000	19	011	Benton County, IA	2003	NA	14079	13406	673	4.8
CN1901300000000	19	013	Black Hawk County, IA	2003	NA	70964	67697	3267	4.6
CN1901500000000	19	015	Boone County, IA	2003	NA	15028	14498	530	3.5
CN1901700000000	19	017	Bremer County, IA	2003	NA	13468	12942	526	3.9
CN1901900000000	19	019	Buchanan County, IA	2003	NA	10867	10372	495	4.6
CN1902100000000	19	021	Buena Vista County, IA	2003	NA	10382	10005	377	3.6
CN1902300000000	19	023	Butler County, IA	2003	NA	8095	7686	409	5.1
CN1902500000000	19	025	Calhoun County, IA	2003	NA	5116	4899	217	4.2
CN1902700000000	19	027	Carroll County, IA	2003	NA	12231	11882	349	2.9
CN1902900000000	19	029	Cass County, IA	2003	NA	7522	7139	383	5.1
CN1903100000000	19	031	Cedar County, IA	2003	NA	10402	10007	395	3.8
CN1903300000000	19	033	Cerro Gordo County, IA	2003	NA	25493	24400	1093	4.3
CN1903500000000	19	035	Cherokee County, IA	2003	NA	6712	6429	283	4.2
CN1903700000000	19	037	Chickasaw County, IA	2003	NA	6276	5891	385	6.1
CN1903900000000	19	039	Clarke County, IA	2003	NA	4861	4467	394	8.1
CN1904100000000	19	041	Clay County, IA	2003	NA	9746	9337	409	4.2
CN1904300000000	19	043	Clayton County, IA	2003	NA	9564	8975	589	6.2
CN1904500000000	19	045	Clinton County, IA	2003	NA	26173	24743	1430	5.5
CN1904700000000	19	047	Crawford County, IA	2003	NA	8755	8416	339	3.9
CN1904900000000	19	049	Dallas County, IA	2003	NA	26484	25602	882	3.3
CN1905100000000	19	051	Davis County, IA	2003	NA	4231	4023	208	4.9
CN1905300000000	19	053	Decatur County, IA	2003	NA	4278	4029	249	5.8
CN1905500000000	19	055	Delaware County, IA	2003	NA	9913	9415	498	5
CN1905700000000	19	057	Des Moines County, IA	2003	NA	21297	19870	1427	6.7
CN1905900000000	19	059	Dickinson County, IA	2003	NA	9838	9378	460	4.7
CN1906100000000	19	061	Dubuque County, IA	2003	NA	48823	46709	2114	4.3
CN1906300000000	19	063	Emmet County, IA	2003	NA	5989	5668	321	5.4
CN1906500000000	19	065	Fayette County, IA	2003	NA	10946	10385	561	5.1
CN1906700000000	19	067	Floyd County, IA	2003	NA	8579	8147	432	5
CN1906900000000	19	069	Franklin County, IA	2003	NA	5397	5151	246	4.6
CN1907100000000	19	071	Fremont County, IA	2003	NA	4304	4159	145	3.4
CN1907300000000	19	073	Greene County, IA	2003	NA	4991	4796	195	3.9
CN1907500000000	19	075	Grundy County, IA	2003	NA	6809	6548	261	3.8
CN1907700000000	19	077	Guthrie County, IA	2003	NA	6081	5833	248	4.1
CN1907900000000	19	079	Hamilton County, IA	2003	NA	8612	8237	375	4.4
CN1908100000000	19	081	Hancock County, IA	2003	NA	6265	6035	230	3.7
CN1908300000000	19	083	Hardin County, IA	2003	NA	9133	8660	473	5.2
CN1908500000000	19	085	Harrison County, IA	2003	NA	8169	7787	382	4.7
CN1908700000000	19	087	Henry County, IA	2003	NA	10166	9488	678	6.7
CN1908900000000	19	089	Howard County, IA	2003	NA	5047	4824	223	4.4
CN1909100000000	19	091	Humboldt County, IA	2003	NA	5196	4976	220	4.2
CN1909300000000	19	093	Ida County, IA	2003	NA	3864	3714	150	3.9
CN1909500000000	19	095	Iowa County, IA	2003	NA	8625	8301	324	3.8
CN1909700000000	19	097	Jackson County, IA	2003	NA	11199	10514	685	6.1
CN1909900000000	19	099	Jasper County, IA	2003	NA	19678	18666	1012	5.1
CN1910100000000	19	101	Jefferson County, IA	2003	NA	8281	7824	457	5.5
CN1910300000000	19	103	Johnson County, IA	2003	NA	72412	70184	2228	3.1
CN1910500000000	19	105	Jones County, IA	2003	NA	10422	9876	546	5.2
CN1910700000000	19	107	Keokuk County, IA	2003	NA	6082	5803	279	4.6
CN1910900000000	19	109	Kossuth County, IA	2003	NA	8792	8400	392	4.5
CN1911100000000	19	111	Lee County, IA	2003	NA	17473	16122	1351	7.7
CN1911300000000	19	113	Linn County, IA	2003	NA	112195	106753	5442	4.9
CN1911500000000	19	115	Louisa County, IA	2003	NA	6270	5978	292	4.7
CN1911700000000	19	117	Lucas County, IA	2003	NA	4832	4576	256	5.3
CN1911900000000	19	119	Lyon County, IA	2003	NA	6275	6051	224	3.6
CN1912100000000	19	121	Madison County, IA	2003	NA	7848	7494	354	4.5
CN1912300000000	19	123	Mahaska County, IA	2003	NA	11298	10747	551	4.9
CN1912500000000	19	125	Marion County, IA	2003	NA	16967	16186	781	4.6
CN1912700000000	19	127	Marshall County, IA	2003	NA	20620	19517	1103	5.3
CN1912900000000	19	129	Mills County, IA	2003	NA	8119	7808	311	3.8
CN1913100000000	19	131	Mitchell County, IA	2003	NA	5359	5159	200	3.7
CN1913300000000	19	133	Monona County, IA	2003	NA	4869	4616	253	5.2
CN1913500000000	19	135	Monroe County, IA	2003	NA	3485	3286	199	5.7
CN1913700000000	19	137	Montgomery County, IA	2003	NA	5679	5394	285	5
CN1913900000000	19	139	Muscatine County, IA	2003	NA	22386	21426	960	4.3
CN1914100000000	19	141	O'Brien County, IA	2003	NA	7473	7183	290	3.9
CN1914300000000	19	143	Osceola County, IA	2003	NA	3478	3346	132	3.8
CN1914500000000	19	145	Page County, IA	2003	NA	7550	7187	363	4.8
CN1914700000000	19	147	Palo Alto County, IA	2003	NA	5006	4812	194	3.9
CN1914900000000	19	149	Plymouth County, IA	2003	NA	13774	13251	523	3.8
CN1915100000000	19	151	Pocahontas County, IA	2003	NA	3845	3625	220	5.7
CN1915300000000	19	153	Polk County, IA	2003	NA	222159	212939	9220	4.2
CN1915500000000	19	155	Pottawattamie County, IA	2003	NA	48989	46665	2324	4.7
CN1915700000000	19	157	Poweshiek County, IA	2003	NA	10254	9772	482	4.7
CN1915900000000	19	159	Ringgold County, IA	2003	NA	2544	2425	119	4.7
CN1916100000000	19	161	Sac County, IA	2003	NA	5768	5532	236	4.1
CN1916300000000	19	163	Scott County, IA	2003	NA	85740	81639	4101	4.8
CN1916500000000	19	165	Shelby County, IA	2003	NA	6944	6687	257	3.7
CN1916700000000	19	167	Sioux County, IA	2003	NA	17951	17406	545	3
CN1916900000000	19	169	Story County, IA	2003	NA	46960	45620	1340	2.9
CN1917100000000	19	171	Tama County, IA	2003	NA	9007	8281	726	8.1
CN1917300000000	19	173	Taylor County, IA	2003	NA	3293	3145	148	4.5
CN1917500000000	19	175	Union County, IA	2003	NA	6266	5910	356	5.7
CN1917700000000	19	177	Van Buren County, IA	2003	NA	3789	3572	217	5.7
CN1917900000000	19	179	Wapello County, IA	2003	NA	19282	18201	1081	5.6
CN1918100000000	19	181	Warren County, IA	2003	NA	24157	23272	885	3.7
CN1918300000000	19	183	Washington County, IA	2003	NA	12114	11659	455	3.8
CN1918500000000	19	185	Wayne County, IA	2003	NA	3162	3017	145	4.6
CN1918700000000	19	187	Webster County, IA	2003	NA	19575	18646	929	4.7
CN1918900000000	19	189	Winnebago County, IA	2003	NA	6020	5793	227	3.8
CN1919100000000	19	191	Winneshiek County, IA	2003	NA	12258	11733	525	4.3
CN1919300000000	19	193	Woodbury County, IA	2003	NA	54526	51986	2540	4.7
CN1919500000000	19	195	Worth County, IA	2003	NA	4401	4219	182	4.1
CN1919700000000	19	197	Wright County, IA	2003	NA	6950	6630	320	4.6
CN2000100000000	20	001	Allen County, KS	2003	NA	7185	6837	348	4.8
CN2000300000000	20	003	Anderson County, KS	2003	NA	4130	3904	226	5.5
CN2000500000000	20	005	Atchison County, KS	2003	NA	8315	7858	457	5.5
CN2000700000000	20	007	Barber County, KS	2003	NA	2662	2565	97	3.6
CN2000900000000	20	009	Barton County, KS	2003	NA	14522	13882	640	4.4
CN2001100000000	20	011	Bourbon County, KS	2003	NA	8593	8185	408	4.7
CN2001300000000	20	013	Brown County, KS	2003	NA	5485	5236	249	4.5
CN2001500000000	20	015	Butler County, KS	2003	NA	30833	28935	1898	6.2
CN2001700000000	20	017	Chase County, KS	2003	NA	1629	1560	69	4.2
CN2001900000000	20	019	Chautauqua County, KS	2003	NA	1955	1854	101	5.2
CN2002100000000	20	021	Cherokee County, KS	2003	NA	10702	9953	749	7
CN2002300000000	20	023	Cheyenne County, KS	2003	NA	1623	1575	48	3
CN2002500000000	20	025	Clark County, KS	2003	NA	1253	1212	41	3.3
CN2002700000000	20	027	Clay County, KS	2003	NA	4612	4411	201	4.4
CN2002900000000	20	029	Cloud County, KS	2003	NA	5764	5556	208	3.6
CN2003100000000	20	031	Coffey County, KS	2003	NA	4920	4629	291	5.9
CN2003300000000	20	033	Comanche County, KS	2003	NA	1033	1003	30	2.9
CN2003500000000	20	035	Cowley County, KS	2003	NA	18368	17143	1225	6.7
CN2003700000000	20	037	Crawford County, KS	2003	NA	19334	18258	1076	5.6
CN2003900000000	20	039	Decatur County, KS	2003	NA	1866	1807	59	3.2
CN2004100000000	20	041	Dickinson County, KS	2003	NA	10408	9930	478	4.6
CN2004300000000	20	043	Doniphan County, KS	2003	NA	4409	4092	317	7.2
CN2004500000000	20	045	Douglas County, KS	2003	NA	61314	58936	2378	3.9
CN2004700000000	20	047	Edwards County, KS	2003	NA	1694	1632	62	3.7
CN2004900000000	20	049	Elk County, KS	2003	NA	1442	1355	87	6
CN2005100000000	20	051	Ellis County, KS	2003	NA	16859	16333	526	3.1
CN2005300000000	20	053	Ellsworth County, KS	2003	NA	3152	3020	132	4.2
CN2005500000000	20	055	Finney County, KS	2003	NA	18149	17475	674	3.7
CN2005700000000	20	057	Ford County, KS	2003	NA	16612	16042	570	3.4
CN2005900000000	20	059	Franklin County, KS	2003	NA	13509	12756	753	5.6
CN2006100000000	20	061	Geary County, KS	2003	NA	11131	10452	679	6.1
CN2006300000000	20	063	Gove County, KS	2003	NA	1573	1528	45	2.9
CN2006500000000	20	065	Graham County, KS	2003	NA	1442	1395	47	3.3
CN2006700000000	20	067	Grant County, KS	2003	NA	3793	3656	137	3.6
CN2006900000000	20	069	Gray County, KS	2003	NA	3149	3056	93	3
CN2007100000000	20	071	Greeley County, KS	2003	NA	787	758	29	3.7
CN2007300000000	20	073	Greenwood County, KS	2003	NA	3625	3414	211	5.8
CN2007500000000	20	075	Hamilton County, KS	2003	NA	1285	1246	39	3
CN2007700000000	20	077	Harper County, KS	2003	NA	3258	3119	139	4.3
CN2007900000000	20	079	Harvey County, KS	2003	NA	17572	16672	900	5.1
CN2008100000000	20	081	Haskell County, KS	2003	NA	2115	2054	61	2.9
CN2008300000000	20	083	Hodgeman County, KS	2003	NA	987	948	39	4
CN2008500000000	20	085	Jackson County, KS	2003	NA	7023	6593	430	6.1
CN2008700000000	20	087	Jefferson County, KS	2003	NA	10106	9590	516	5.1
CN2008900000000	20	089	Jewell County, KS	2003	NA	2093	2032	61	2.9
CN2009100000000	20	091	Johnson County, KS	2003	NA	277509	263333	14176	5.1
CN2009300000000	20	093	Kearny County, KS	2003	NA	2022	1944	78	3.9
CN2009500000000	20	095	Kingman County, KS	2003	NA	4253	4027	226	5.3
CN2009700000000	20	097	Kiowa County, KS	2003	NA	1627	1575	52	3.2
CN2009900000000	20	099	Labette County, KS	2003	NA	10194	9522	672	6.6
CN2010100000000	20	101	Lane County, KS	2003	NA	1117	1073	44	3.9
CN2010300000000	20	103	Leavenworth County, KS	2003	NA	32140	30168	1972	6.1
CN2010500000000	20	105	Lincoln County, KS	2003	NA	1917	1820	97	5.1
CN2010700000000	20	107	Linn County, KS	2003	NA	4718	4401	317	6.7
CN2010900000000	20	109	Logan County, KS	2003	NA	1593	1542	51	3.2
CN2011100000000	20	111	Lyon County, KS	2003	NA	19476	18611	865	4.4
CN2011300000000	20	113	McPherson County, KS	2003	NA	16104	15501	603	3.7
CN2011500000000	20	115	Marion County, KS	2003	NA	6663	6359	304	4.6
CN2011700000000	20	117	Marshall County, KS	2003	NA	5730	5520	210	3.7
CN2011900000000	20	119	Meade County, KS	2003	NA	2238	2168	70	3.1
CN2012100000000	20	121	Miami County, KS	2003	NA	15449	14659	790	5.1
CN2012300000000	20	123	Mitchell County, KS	2003	NA	3424	3290	134	3.9
CN2012500000000	20	125	Montgomery County, KS	2003	NA	16557	15455	1102	6.7
CN2012700000000	20	127	Morris County, KS	2003	NA	3117	2986	131	4.2
CN2012900000000	20	129	Morton County, KS	2003	NA	1676	1625	51	3
CN2013100000000	20	131	Nemaha County, KS	2003	NA	5258	5084	174	3.3
CN2013300000000	20	133	Neosho County, KS	2003	NA	8908	8480	428	4.8
CN2013500000000	20	135	Ness County, KS	2003	NA	1714	1662	52	3
CN2013700000000	20	137	Norton County, KS	2003	NA	2646	2541	105	4
CN2013900000000	20	139	Osage County, KS	2003	NA	9060	8533	527	5.8
CN2014100000000	20	141	Osborne County, KS	2003	NA	2375	2283	92	3.9
CN2014300000000	20	143	Ottawa County, KS	2003	NA	3352	3204	148	4.4
CN2014500000000	20	145	Pawnee County, KS	2003	NA	3548	3412	136	3.8
CN2014700000000	20	147	Phillips County, KS	2003	NA	3145	3039	106	3.4
CN2014900000000	20	149	Pottawatomie County, KS	2003	NA	9932	9525	407	4.1
CN2015100000000	20	151	Pratt County, KS	2003	NA	5464	5282	182	3.3
CN2015300000000	20	153	Rawlins County, KS	2003	NA	1407	1356	51	3.6
CN2015500000000	20	155	Reno County, KS	2003	NA	32493	30814	1679	5.2
CN2015700000000	20	157	Republic County, KS	2003	NA	2911	2773	138	4.7
CN2015900000000	20	159	Rice County, KS	2003	NA	5254	5031	223	4.2
CN2016100000000	20	161	Riley County, KS	2003	NA	32007	30879	1128	3.5
CN2016300000000	20	163	Rooks County, KS	2003	NA	2732	2582	150	5.5
CN2016500000000	20	165	Rush County, KS	2003	NA	1686	1614	72	4.3
CN2016700000000	20	167	Russell County, KS	2003	NA	3418	3273	145	4.2
CN2016900000000	20	169	Saline County, KS	2003	NA	29927	28561	1366	4.6
CN2017100000000	20	171	Scott County, KS	2003	NA	2903	2819	84	2.9
CN2017300000000	20	173	Sedgwick County, KS	2003	NA	240350	224059	16291	6.8
CN2017500000000	20	175	Seward County, KS	2003	NA	10304	9915	389	3.8
CN2017700000000	20	177	Shawnee County, KS	2003	NA	93520	88640	4880	5.2
CN2017900000000	20	179	Sheridan County, KS	2003	NA	1536	1494	42	2.7
CN2018100000000	20	181	Sherman County, KS	2003	NA	3791	3673	118	3.1
CN2018300000000	20	183	Smith County, KS	2003	NA	2254	2175	79	3.5
CN2018500000000	20	185	Stafford County, KS	2003	NA	2248	2159	89	4
CN2018700000000	20	187	Stanton County, KS	2003	NA	1179	1145	34	2.9
CN2018900000000	20	189	Stevens County, KS	2003	NA	2320	2240	80	3.4
CN2019100000000	20	191	Sumner County, KS	2003	NA	12434	11478	956	7.7
CN2019300000000	20	193	Thomas County, KS	2003	NA	4315	4185	130	3
CN2019500000000	20	195	Trego County, KS	2003	NA	1717	1659	58	3.4
CN2019700000000	20	197	Wabaunsee County, KS	2003	NA	3757	3601	156	4.2
CN2019900000000	20	199	Wallace County, KS	2003	NA	964	938	26	2.7
CN2020100000000	20	201	Washington County, KS	2003	NA	3428	3299	129	3.8
CN2020300000000	20	203	Wichita County, KS	2003	NA	1304	1259	45	3.5
CN2020500000000	20	205	Wilson County, KS	2003	NA	5015	4750	265	5.3
CN2020700000000	20	207	Woodson County, KS	2003	NA	1722	1611	111	6.4
CN2020900000000	20	209	Wyandotte County, KS	2003	NA	74937	66813	8124	10.8
CN2100100000000	21	001	Adair County, KY	2003	NA	8772	8258	514	5.9
CN2100300000000	21	003	Allen County, KY	2003	NA	8525	7945	580	6.8
CN2100500000000	21	005	Anderson County, KY	2003	NA	10278	9803	475	4.6
CN2100700000000	21	007	Ballard County, KY	2003	NA	4131	3809	322	7.8
CN2100900000000	21	009	Barren County, KY	2003	NA	19404	18397	1007	5.2
CN2101100000000	21	011	Bath County, KY	2003	NA	5076	4678	398	7.8
CN2101300000000	21	013	Bell County, KY	2003	NA	9459	8642	817	8.6
CN2101500000000	21	015	Boone County, KY	2003	NA	53738	51136	2602	4.8
CN2101700000000	21	017	Bourbon County, KY	2003	NA	9719	9161	558	5.7
CN2101900000000	21	019	Boyd County, KY	2003	NA	22710	21133	1577	6.9
CN2102100000000	21	021	Boyle County, KY	2003	NA	13357	12225	1132	8.5
CN2102300000000	21	023	Bracken County, KY	2003	NA	4246	3987	259	6.1
CN2102500000000	21	025	Breathitt County, KY	2003	NA	5474	5003	471	8.6
CN2102700000000	21	027	Breckinridge County, KY	2003	NA	8980	8359	621	6.9
CN2102900000000	21	029	Bullitt County, KY	2003	NA	33695	31806	1889	5.6
CN2103100000000	21	031	Butler County, KY	2003	NA	6190	5593	597	9.6
CN2103300000000	21	033	Caldwell County, KY	2003	NA	6372	5994	378	5.9
CN2103500000000	21	035	Calloway County, KY	2003	NA	16631	15369	1262	7.6
CN2103700000000	21	037	Campbell County, KY	2003	NA	45125	42883	2242	5
CN2103900000000	21	039	Carlisle County, KY	2003	NA	2429	2236	193	7.9
CN2104100000000	21	041	Carroll County, KY	2003	NA	5294	4936	358	6.8
CN2104300000000	21	043	Carter County, KY	2003	NA	13058	11901	1157	8.9
CN2104500000000	21	045	Casey County, KY	2003	NA	7308	6817	491	6.7
CN2104700000000	21	047	Christian County, KY	2003	NA	26182	24445	1737	6.6
CN2104900000000	21	049	Clark County, KY	2003	NA	16657	15714	943	5.7
CN2105100000000	21	051	Clay County, KY	2003	NA	7133	6418	715	10
CN2105300000000	21	053	Clinton County, KY	2003	NA	4756	4318	438	9.2
CN2105500000000	21	055	Crittenden County, KY	2003	NA	4277	3984	293	6.9
CN2105700000000	21	057	Cumberland County, KY	2003	NA	3205	2971	234	7.3
CN2105900000000	21	059	Daviess County, KY	2003	NA	46123	43355	2768	6
CN2106100000000	21	061	Edmonson County, KY	2003	NA	5129	4768	361	7
CN2106300000000	21	063	Elliott County, KY	2003	NA	2729	2504	225	8.2
CN2106500000000	21	065	Estill County, KY	2003	NA	6035	5589	446	7.4
CN2106700000000	21	067	Fayette County, KY	2003	NA	145310	138669	6641	4.6
CN2106900000000	21	069	Fleming County, KY	2003	NA	6812	6412	400	5.9
CN2107100000000	21	071	Floyd County, KY	2003	NA	14470	13297	1173	8.1
CN2107300000000	21	073	Franklin County, KY	2003	NA	24919	23783	1136	4.6
CN2107500000000	21	075	Fulton County, KY	2003	NA	3105	2760	345	11.1
CN2107700000000	21	077	Gallatin County, KY	2003	NA	3908	3686	222	5.7
CN2107900000000	21	079	Garrard County, KY	2003	NA	7936	7482	454	5.7
CN2108100000000	21	081	Grant County, KY	2003	NA	12122	11402	720	5.9
CN2108300000000	21	083	Graves County, KY	2003	NA	16730	15496	1234	7.4
CN2108500000000	21	085	Grayson County, KY	2003	NA	11755	10677	1078	9.2
CN2108700000000	21	087	Green County, KY	2003	NA	5639	5282	357	6.3
CN2108900000000	21	089	Greenup County, KY	2003	NA	16775	15624	1151	6.9
CN2109100000000	21	091	Hancock County, KY	2003	NA	4102	3816	286	7
CN2109300000000	21	093	Hardin County, KY	2003	NA	44952	42458	2494	5.5
CN2109500000000	21	095	Harlan County, KY	2003	NA	10435	9421	1014	9.7
CN2109700000000	21	097	Harrison County, KY	2003	NA	9167	8641	526	5.7
CN2109900000000	21	099	Hart County, KY	2003	NA	7883	7394	489	6.2
CN2110100000000	21	101	Henderson County, KY	2003	NA	22818	21569	1249	5.5
CN2110300000000	21	103	Henry County, KY	2003	NA	7615	7214	401	5.3
CN2110500000000	21	105	Hickman County, KY	2003	NA	2239	2042	197	8.8
CN2110700000000	21	107	Hopkins County, KY	2003	NA	21659	20234	1425	6.6
CN2110900000000	21	109	Jackson County, KY	2003	NA	4878	4505	373	7.6
CN2111100000000	21	111	Jefferson County, KY	2003	NA	347618	326521	21097	6.1
CN2111300000000	21	113	Jessamine County, KY	2003	NA	20891	19921	970	4.6
CN2111500000000	21	115	Johnson County, KY	2003	NA	9705	9049	656	6.8
CN2111700000000	21	117	Kenton County, KY	2003	NA	81539	77636	3903	4.8
CN2111900000000	21	119	Knott County, KY	2003	NA	6006	5617	389	6.5
CN2112100000000	21	121	Knox County, KY	2003	NA	11610	10728	882	7.6
CN2112300000000	21	123	Larue County, KY	2003	NA	6579	6243	336	5.1
CN2112500000000	21	125	Laurel County, KY	2003	NA	24912	23256	1656	6.6
CN2112700000000	21	127	Lawrence County, KY	2003	NA	5738	5235	503	8.8
CN2112900000000	21	129	Lee County, KY	2003	NA	2644	2408	236	8.9
CN2113100000000	21	131	Leslie County, KY	2003	NA	3724	3366	358	9.6
CN2113300000000	21	133	Letcher County, KY	2003	NA	8991	8084	907	10.1
CN2113500000000	21	135	Lewis County, KY	2003	NA	5597	5161	436	7.8
CN2113700000000	21	137	Lincoln County, KY	2003	NA	10996	10143	853	7.8
CN2113900000000	21	139	Livingston County, KY	2003	NA	4793	4464	329	6.9
CN2114100000000	21	141	Logan County, KY	2003	NA	12574	11789	785	6.2
CN2114300000000	21	143	Lyon County, KY	2003	NA	3205	2937	268	8.4
CN2114500000000	21	145	McCracken County, KY	2003	NA	30768	28817	1951	6.3
CN2114700000000	21	147	McCreary County, KY	2003	NA	5868	5303	565	9.6
CN2114900000000	21	149	McLean County, KY	2003	NA	4649	4299	350	7.5
CN2115100000000	21	151	Madison County, KY	2003	NA	39490	37433	2057	5.2
CN2115300000000	21	153	Magoffin County, KY	2003	NA	4555	4018	537	11.8
CN2115500000000	21	155	Marion County, KY	2003	NA	9373	8846	527	5.6
CN2115700000000	21	157	Marshall County, KY	2003	NA	14432	13346	1086	7.5
CN2115900000000	21	159	Martin County, KY	2003	NA	3917	3596	321	8.2
CN2116100000000	21	161	Mason County, KY	2003	NA	8770	8258	512	5.8
CN2116300000000	21	163	Meade County, KY	2003	NA	11590	10863	727	6.3
CN2116500000000	21	165	Menifee County, KY	2003	NA	2667	2423	244	9.1
CN2116700000000	21	167	Mercer County, KY	2003	NA	10460	9814	646	6.2
CN2116900000000	21	169	Metcalfe County, KY	2003	NA	4520	4278	242	5.4
CN2117100000000	21	171	Monroe County, KY	2003	NA	5284	4907	377	7.1
CN2117300000000	21	173	Montgomery County, KY	2003	NA	11678	10920	758	6.5
CN2117500000000	21	175	Morgan County, KY	2003	NA	5175	4682	493	9.5
CN2117700000000	21	177	Muhlenberg County, KY	2003	NA	13179	12121	1058	8
CN2117900000000	21	179	Nelson County, KY	2003	NA	19603	18416	1187	6.1
CN2118100000000	21	181	Nicholas County, KY	2003	NA	3206	2993	213	6.6
CN2118300000000	21	183	Ohio County, KY	2003	NA	11065	10230	835	7.5
CN2118500000000	21	185	Oldham County, KY	2003	NA	24449	23373	1076	4.4
CN2118700000000	21	187	Owen County, KY	2003	NA	5105	4853	252	4.9
CN2118900000000	21	189	Owsley County, KY	2003	NA	1583	1448	135	8.5
CN2119100000000	21	191	Pendleton County, KY	2003	NA	7342	6889	453	6.2
CN2119300000000	21	193	Perry County, KY	2003	NA	10555	9617	938	8.9
CN2119500000000	21	195	Pike County, KY	2003	NA	24225	22327	1898	7.8
CN2119700000000	21	197	Powell County, KY	2003	NA	5669	5158	511	9
CN2119900000000	21	199	Pulaski County, KY	2003	NA	26428	24628	1800	6.8
CN2120100000000	21	201	Robertson County, KY	2003	NA	1144	1077	67	5.9
CN2120300000000	21	203	Rockcastle County, KY	2003	NA	7173	6773	400	5.6
CN2120500000000	21	205	Rowan County, KY	2003	NA	12086	11440	646	5.3
CN2120700000000	21	207	Russell County, KY	2003	NA	7804	7226	578	7.4
CN2120900000000	21	209	Scott County, KY	2003	NA	19375	18335	1040	5.4
CN2121100000000	21	211	Shelby County, KY	2003	NA	18705	17744	961	5.1
CN2121300000000	21	213	Simpson County, KY	2003	NA	8590	8110	480	5.6
CN2121500000000	21	215	Spencer County, KY	2003	NA	7352	7018	334	4.5
CN2121700000000	21	217	Taylor County, KY	2003	NA	12125	11431	694	5.7
CN2121900000000	21	219	Todd County, KY	2003	NA	5941	5678	263	4.4
CN2122100000000	21	221	Trigg County, KY	2003	NA	6079	5721	358	5.9
CN2122300000000	21	223	Trimble County, KY	2003	NA	4166	3933	233	5.6
CN2122500000000	21	225	Union County, KY	2003	NA	7549	7080	469	6.2
CN2122700000000	21	227	Warren County, KY	2003	NA	51487	48690	2797	5.4
CN2122900000000	21	229	Washington County, KY	2003	NA	5433	5123	310	5.7
CN2123100000000	21	231	Wayne County, KY	2003	NA	8873	8283	590	6.6
CN2123300000000	21	233	Webster County, KY	2003	NA	6682	6241	441	6.6
CN2123500000000	21	235	Whitley County, KY	2003	NA	13991	12965	1026	7.3
CN2123700000000	21	237	Wolfe County, KY	2003	NA	2367	2139	228	9.6
CN2123900000000	21	239	Woodford County, KY	2003	NA	12980	12461	519	4
CN2200100000000	22	001	Acadia Parish, LA	2003	NA	23938	22307	1631	6.8
CN2200300000000	22	003	Allen Parish, LA	2003	NA	8979	8195	784	8.7
CN2200500000000	22	005	Ascension Parish, LA	2003	NA	40892	38109	2783	6.8
CN2200700000000	22	007	Assumption Parish, LA	2003	NA	10597	9881	716	6.8
CN2200900000000	22	009	Avoyelles Parish, LA	2003	NA	15788	14432	1356	8.6
CN2201100000000	22	011	Beauregard Parish, LA	2003	NA	14215	13173	1042	7.3
CN2201300000000	22	013	Bienville Parish, LA	2003	NA	6001	5471	530	8.8
CN2201500000000	22	015	Bossier Parish, LA	2003	NA	47314	44298	3016	6.4
CN2201700000000	22	017	Caddo Parish, LA	2003	NA	111245	103290	7955	7.2
CN2201900000000	22	019	Calcasieu Parish, LA	2003	NA	85859	80333	5526	6.4
CN2202100000000	22	021	Caldwell Parish, LA	2003	NA	4399	3965	434	9.9
CN2202300000000	22	023	Cameron Parish, LA	2003	NA	4325	4086	239	5.5
CN2202500000000	22	025	Catahoula Parish, LA	2003	NA	4123	3721	402	9.8
CN2202700000000	22	027	Claiborne Parish, LA	2003	NA	6790	6276	514	7.6
CN2202900000000	22	029	Concordia Parish, LA	2003	NA	7278	6444	834	11.5
CN2203100000000	22	031	De Soto Parish, LA	2003	NA	10744	9820	924	8.6
CN2203300000000	22	033	East Baton Rouge Parish, LA	2003	NA	200693	188806	11887	5.9
CN2203500000000	22	035	East Carroll Parish, LA	2003	NA	3109	2697	412	13.3
CN2203700000000	22	037	East Feliciana Parish, LA	2003	NA	7963	7366	597	7.5
CN2203900000000	22	039	Evangeline Parish, LA	2003	NA	11828	10869	959	8.1
CN2204100000000	22	041	Franklin Parish, LA	2003	NA	8012	7217	795	9.9
CN2204300000000	22	043	Grant Parish, LA	2003	NA	7999	7368	631	7.9
CN2204500000000	22	045	Iberia Parish, LA	2003	NA	30739	28754	1985	6.5
CN2204700000000	22	047	Iberville Parish, LA	2003	NA	12215	11087	1128	9.2
CN2204900000000	22	049	Jackson Parish, LA	2003	NA	6531	5964	567	8.7
CN2205100000000	22	051	Jefferson Parish, LA	2003	NA	222833	211306	11527	5.2
CN2205300000000	22	053	Jefferson Davis Parish, LA	2003	NA	13498	12708	790	5.9
CN2205500000000	22	055	Lafayette Parish, LA	2003	NA	97675	92904	4771	4.9
CN2205700000000	22	057	Lafourche Parish, LA	2003	NA	43556	41434	2122	4.9
CN2205900000000	22	059	LaSalle Parish, LA	2003	NA	5864	5345	519	8.9
CN2206100000000	22	061	Lincoln Parish, LA	2003	NA	18241	16975	1266	6.9
CN2206300000000	22	063	Livingston Parish, LA	2003	NA	48057	44765	3292	6.9
CN2206500000000	22	065	Madison Parish, LA	2003	NA	4969	4424	545	11
CN2206700000000	22	067	Morehouse Parish, LA	2003	NA	12635	11354	1281	10.1
CN2206900000000	22	069	Natchitoches Parish, LA	2003	NA	16643	15379	1264	7.6
CN2207100000000	22	071	Orleans Parish, LA	2003	NA	197740	185357	12383	6.3
CN2207300000000	22	073	Ouachita Parish, LA	2003	NA	71690	67389	4301	6
CN2207500000000	22	075	Plaquemines Parish, LA	2003	NA	11092	10428	664	6
CN2207700000000	22	077	Pointe Coupee Parish, LA	2003	NA	9388	8670	718	7.6
CN2207900000000	22	079	Rapides Parish, LA	2003	NA	55951	52323	3628	6.5
CN2208100000000	22	081	Red River Parish, LA	2003	NA	3648	3297	351	9.6
CN2208300000000	22	083	Richland Parish, LA	2003	NA	8720	7957	763	8.8
CN2208500000000	22	085	Sabine Parish, LA	2003	NA	9348	8657	691	7.4
CN2208700000000	22	087	St. Bernard Parish, LA	2003	NA	30655	28767	1888	6.2
CN2208900000000	22	089	St. Charles Parish, LA	2003	NA	23553	22225	1328	5.6
CN2209100000000	22	091	St. Helena Parish, LA	2003	NA	3875	3605	270	7
CN2209300000000	22	093	St. James Parish, LA	2003	NA	8807	7927	880	10
CN2209500000000	22	095	St. John the Baptist Parish, LA	2003	NA	20064	18662	1402	7
CN2209700000000	22	097	St. Landry Parish, LA	2003	NA	33588	31023	2565	7.6
CN2209900000000	22	099	St. Martin Parish, LA	2003	NA	21536	20228	1308	6.1
CN2210100000000	22	101	St. Mary Parish, LA	2003	NA	22167	20509	1658	7.5
CN2210300000000	22	103	St. Tammany Parish, LA	2003	NA	100593	95728	4865	4.8
CN2210500000000	22	105	Tangipahoa Parish, LA	2003	NA	46732	43371	3361	7.2
CN2210700000000	22	107	Tensas Parish, LA	2003	NA	2403	2181	222	9.2
CN2210900000000	22	109	Terrebonne Parish, LA	2003	NA	48476	46055	2421	5
CN2211100000000	22	111	Union Parish, LA	2003	NA	10535	9756	779	7.4
CN2211300000000	22	113	Vermilion Parish, LA	2003	NA	23024	21478	1546	6.7
CN2211500000000	22	115	Vernon Parish, LA	2003	NA	18600	17373	1227	6.6
CN2211700000000	22	117	Washington Parish, LA	2003	NA	16550	15244	1306	7.9
CN2211900000000	22	119	Webster Parish, LA	2003	NA	18384	16834	1550	8.4
CN2212100000000	22	121	West Baton Rouge Parish, LA	2003	NA	10007	9296	711	7.1
CN2212300000000	22	123	West Carroll Parish, LA	2003	NA	4746	4104	642	13.5
CN2212500000000	22	125	West Feliciana Parish, LA	2003	NA	4701	4334	367	7.8
CN2212700000000	22	127	Winn Parish, LA	2003	NA	6205	5674	531	8.6
CN2300100000000	23	001	Androscoggin County, ME	2003	NA	56145	53348	2797	5
CN2300300000000	23	003	Aroostook County, ME	2003	NA	34421	32324	2097	6.1
CN2300500000000	23	005	Cumberland County, ME	2003	NA	151456	146156	5300	3.5
CN2300700000000	23	007	Franklin County, ME	2003	NA	14276	13440	836	5.9
CN2300900000000	23	009	Hancock County, ME	2003	NA	29246	27783	1463	5
CN2301100000000	23	011	Kennebec County, ME	2003	NA	60881	57797	3084	5.1
CN2301300000000	23	013	Knox County, ME	2003	NA	21230	20336	894	4.2
CN2301500000000	23	015	Lincoln County, ME	2003	NA	17788	17045	743	4.2
CN2301700000000	23	017	Oxford County, ME	2003	NA	27643	26037	1606	5.8
CN2301900000000	23	019	Penobscot County, ME	2003	NA	76852	72290	4562	5.9
CN2302100000000	23	021	Piscataquis County, ME	2003	NA	7461	6875	586	7.9
CN2302300000000	23	023	Sagadahoc County, ME	2003	NA	18282	17570	712	3.9
CN2302500000000	23	025	Somerset County, ME	2003	NA	24586	22681	1905	7.7
CN2302700000000	23	027	Waldo County, ME	2003	NA	19698	18600	1098	5.6
CN2302900000000	23	029	Washington County, ME	2003	NA	15364	14035	1329	8.7
CN2303100000000	23	031	York County, ME	2003	NA	108219	103259	4960	4.6
CN2400100000000	24	001	Allegany County, MD	2003	NA	34654	32589	2065	6
CN2400300000000	24	003	Anne Arundel County, MD	2003	NA	271014	260711	10303	3.8
CN2400500000000	24	005	Baltimore County, MD	2003	NA	413908	394519	19389	4.7
CN2400900000000	24	009	Calvert County, MD	2003	NA	44406	42865	1541	3.5
CN2401100000000	24	011	Caroline County, MD	2003	NA	15611	14808	803	5.1
CN2401300000000	24	013	Carroll County, MD	2003	NA	89032	85819	3213	3.6
CN2401500000000	24	015	Cecil County, MD	2003	NA	47811	45366	2445	5.1
CN2401700000000	24	017	Charles County, MD	2003	NA	69873	67475	2398	3.4
CN2401900000000	24	019	Dorchester County, MD	2003	NA	16322	15204	1118	6.8
CN2402100000000	24	021	Frederick County, MD	2003	NA	116690	112660	4030	3.5
CN2402300000000	24	023	Garrett County, MD	2003	NA	15569	14759	810	5.2
CN2402500000000	24	025	Harford County, MD	2003	NA	125175	119790	5385	4.3
CN2402700000000	24	027	Howard County, MD	2003	NA	150740	145719	5021	3.3
CN2402900000000	24	029	Kent County, MD	2003	NA	10256	9750	506	4.9
CN2403100000000	24	031	Montgomery County, MD	2003	NA	498402	481984	16418	3.3
CN2403300000000	24	033	Prince George's County, MD	2003	NA	441104	420528	20576	4.7
CN2403500000000	24	035	Queen Anne's County, MD	2003	NA	24229	23313	916	3.8
CN2403700000000	24	037	St. Mary's County, MD	2003	NA	48588	46911	1677	3.5
CN2403900000000	24	039	Somerset County, MD	2003	NA	10983	10265	718	6.5
CN2404100000000	24	041	Talbot County, MD	2003	NA	18588	17788	800	4.3
CN2404300000000	24	043	Washington County, MD	2003	NA	67267	63960	3307	4.9
CN2404500000000	24	045	Wicomico County, MD	2003	NA	48567	46248	2319	4.8
CN2404700000000	24	047	Worcester County, MD	2003	NA	27803	25995	1808	6.5
CN2451000000000	24	510	Baltimore city, MD	2003	NA	275629	255498	20131	7.3
CN2500100000000	25	001	Barnstable County, MA	2003	NA	122422	116079	6343	5.2
CN2500300000000	25	003	Berkshire County, MA	2003	NA	73000	69344	3656	5
CN2500500000000	25	005	Bristol County, MA	2003	NA	287664	268965	18699	6.5
CN2500700000000	25	007	Dukes County, MA	2003	NA	11132	10668	464	4.2
CN2500900000000	25	009	Essex County, MA	2003	NA	380797	356823	23974	6.3
CN2501100000000	25	011	Franklin County, MA	2003	NA	40280	38471	1809	4.5
CN2501300000000	25	013	Hampden County, MA	2003	NA	225822	211254	14568	6.5
CN2501500000000	25	015	Hampshire County, MA	2003	NA	88172	84495	3677	4.2
CN2501700000000	25	017	Middlesex County, MA	2003	NA	821249	778252	42997	5.2
CN2501900000000	25	019	Nantucket County/town, MA	2003	NA	7732	7540	192	2.5
CN2502100000000	25	021	Norfolk County, MA	2003	NA	358047	339996	18051	5
CN2502300000000	25	023	Plymouth County, MA	2003	NA	257470	243296	14174	5.5
CN2502500000000	25	025	Suffolk County, MA	2003	NA	345791	323479	22312	6.5
CN2502700000000	25	027	Worcester County, MA	2003	NA	402837	378322	24515	6.1
CN2600100000000	26	001	Alcona County, MI	2003	NA	4187	3683	504	12
CN2600300000000	26	003	Alger County, MI	2003	NA	4419	4071	348	7.9
CN2600500000000	26	005	Allegan County, MI	2003	NA	52965	49458	3507	6.6
CN2600700000000	26	007	Alpena County, MI	2003	NA	15174	13780	1394	9.2
CN2600900000000	26	009	Antrim County, MI	2003	NA	11649	10652	997	8.6
CN2601100000000	26	011	Arenac County, MI	2003	NA	7649	6898	751	9.8
CN2601300000000	26	013	Baraga County, MI	2003	NA	3885	3498	387	10
CN2601500000000	26	015	Barry County, MI	2003	NA	29633	27849	1784	6
CN2601700000000	26	017	Bay County, MI	2003	NA	55391	51191	4200	7.6
CN2601900000000	26	019	Benzie County, MI	2003	NA	8742	8044	698	8
CN2602100000000	26	021	Berrien County, MI	2003	NA	78117	72352	5765	7.4
CN2602300000000	26	023	Branch County, MI	2003	NA	22925	21340	1585	6.9
CN2602500000000	26	025	Calhoun County, MI	2003	NA	71176	66083	5093	7.2
CN2602700000000	26	027	Cass County, MI	2003	NA	25918	24594	1324	5.1
CN2602900000000	26	029	Charlevoix County, MI	2003	NA	13745	12618	1127	8.2
CN2603100000000	26	031	Cheboygan County, MI	2003	NA	12715	11422	1293	10.2
CN2603300000000	26	033	Chippewa County, MI	2003	NA	17251	15721	1530	8.9
CN2603500000000	26	035	Clare County, MI	2003	NA	12962	11761	1201	9.3
CN2603700000000	26	037	Clinton County, MI	2003	NA	36222	34505	1717	4.7
CN2603900000000	26	039	Crawford County, MI	2003	NA	6659	6145	514	7.7
CN2604100000000	26	041	Delta County, MI	2003	NA	19963	18280	1683	8.4
CN2604300000000	26	043	Dickinson County, MI	2003	NA	14107	13146	961	6.8
CN2604500000000	26	045	Eaton County, MI	2003	NA	57844	55014	2830	4.9
CN2604700000000	26	047	Emmet County, MI	2003	NA	19005	17539	1466	7.7
CN2604900000000	26	049	Genesee County, MI	2003	NA	208776	191377	17399	8.3
CN2605100000000	26	051	Gladwin County, MI	2003	NA	11141	10081	1060	9.5
CN2605300000000	26	053	Gogebic County, MI	2003	NA	7854	7184	670	8.5
CN2605500000000	26	055	Grand Traverse County, MI	2003	NA	46486	43580	2906	6.3
CN2605700000000	26	057	Gratiot County, MI	2003	NA	19602	18186	1416	7.2
CN2605900000000	26	059	Hillsdale County, MI	2003	NA	22879	21127	1752	7.7
CN2606100000000	26	061	Houghton County, MI	2003	NA	17013	15811	1202	7.1
CN2606300000000	26	063	Huron County, MI	2003	NA	17124	15499	1625	9.5
CN2606500000000	26	065	Ingham County, MI	2003	NA	151665	143052	8613	5.7
CN2606700000000	26	067	Ionia County, MI	2003	NA	29418	27317	2101	7.1
CN2606900000000	26	069	Iosco County, MI	2003	NA	10564	9480	1084	10.3
CN2607100000000	26	071	Iron County, MI	2003	NA	5816	5383	433	7.4
CN2607300000000	26	073	Isabella County, MI	2003	NA	34960	33152	1808	5.2
CN2607500000000	26	075	Jackson County, MI	2003	NA	77256	71054	6202	8
CN2607700000000	26	077	Kalamazoo County, MI	2003	NA	129785	122658	7127	5.5
CN2607900000000	26	079	Kalkaska County, MI	2003	NA	8642	7932	710	8.2
CN2608100000000	26	081	Kent County, MI	2003	NA	312867	289940	22927	7.3
CN2608300000000	26	083	Keweenaw County, MI	2003	NA	1048	939	109	10.4
CN2608500000000	26	085	Lake County, MI	2003	NA	4488	4037	451	10
CN2608700000000	26	087	Lapeer County, MI	2003	NA	45545	41827	3718	8.2
CN2608900000000	26	089	Leelanau County, MI	2003	NA	11313	10672	641	5.7
CN2609100000000	26	091	Lenawee County, MI	2003	NA	50072	46417	3655	7.3
CN2609300000000	26	093	Livingston County, MI	2003	NA	92225	87545	4680	5.1
CN2609500000000	26	095	Luce County, MI	2003	NA	2884	2660	224	7.8
CN2609700000000	26	097	Mackinac County, MI	2003	NA	6534	5912	622	9.5
CN2609900000000	26	099	Macomb County, MI	2003	NA	425040	396080	28960	6.8
CN2610100000000	26	101	Manistee County, MI	2003	NA	11846	10798	1048	8.8
CN2610300000000	26	103	Marquette County, MI	2003	NA	34032	31774	2258	6.6
CN2610500000000	26	105	Mason County, MI	2003	NA	15273	13559	1714	11.2
CN2610700000000	26	107	Mecosta County, MI	2003	NA	19750	18403	1347	6.8
CN2610900000000	26	109	Menominee County, MI	2003	NA	13269	12445	824	6.2
CN2611100000000	26	111	Midland County, MI	2003	NA	41210	38581	2629	6.4
CN2611300000000	26	113	Missaukee County, MI	2003	NA	6617	6088	529	8
CN2611500000000	26	115	Monroe County, MI	2003	NA	76923	72219	4704	6.1
CN2611700000000	26	117	Montcalm County, MI	2003	NA	29232	26889	2343	8
CN2611900000000	26	119	Montmorency County, MI	2003	NA	4276	3768	508	11.9
CN2612100000000	26	121	Muskegon County, MI	2003	NA	87933	80001	7932	9
CN2612300000000	26	123	Newaygo County, MI	2003	NA	22719	20715	2004	8.8
CN2612500000000	26	125	Oakland County, MI	2003	NA	644959	608748	36211	5.6
CN2612700000000	26	127	Oceana County, MI	2003	NA	13485	12207	1278	9.5
CN2612900000000	26	129	Ogemaw County, MI	2003	NA	9639	8746	893	9.3
CN2613100000000	26	131	Ontonagon County, MI	2003	NA	3503	3225	278	7.9
CN2613300000000	26	133	Osceola County, MI	2003	NA	10814	9938	876	8.1
CN2613500000000	26	135	Oscoda County, MI	2003	NA	3785	3350	435	11.5
CN2613700000000	26	137	Otsego County, MI	2003	NA	12263	11250	1013	8.3
CN2613900000000	26	139	Ottawa County, MI	2003	NA	131705	123836	7869	6
CN2614100000000	26	141	Presque Isle County, MI	2003	NA	6524	5786	738	11.3
CN2614300000000	26	143	Roscommon County, MI	2003	NA	10651	9726	925	8.7
CN2614500000000	26	145	Saginaw County, MI	2003	NA	99280	90388	8892	9
CN2614700000000	26	147	St. Clair County, MI	2003	NA	86110	78823	7287	8.5
CN2614900000000	26	149	St. Joseph County, MI	2003	NA	30474	28255	2219	7.3
CN2615100000000	26	151	Sanilac County, MI	2003	NA	21530	19452	2078	9.7
CN2615300000000	26	153	Schoolcraft County, MI	2003	NA	3901	3472	429	11
CN2615500000000	26	155	Shiawassee County, MI	2003	NA	35710	33042	2668	7.5
CN2615700000000	26	157	Tuscola County, MI	2003	NA	29151	26517	2634	9
CN2615900000000	26	159	Van Buren County, MI	2003	NA	39364	36571	2793	7.1
CN2616100000000	26	161	Washtenaw County, MI	2003	NA	184030	176442	7588	4.1
CN2616300000000	26	163	Wayne County, MI	2003	NA	920061	840332	79729	8.7
CN2616500000000	26	165	Wexford County, MI	2003	NA	14542	13212	1330	9.1
CN2700100000000	27	001	Aitkin County, MN	2003	NA	7540	7010	530	7
CN2700300000000	27	003	Anoka County, MN	2003	NA	185945	177029	8916	4.8
CN2700500000000	27	005	Becker County, MN	2003	NA	16451	15461	990	6
CN2700700000000	27	007	Beltrami County, MN	2003	NA	21267	20106	1161	5.5
CN2700900000000	27	009	Benton County, MN	2003	NA	21817	20640	1177	5.4
CN2701100000000	27	011	Big Stone County, MN	2003	NA	2833	2700	133	4.7
CN2701300000000	27	013	Blue Earth County, MN	2003	NA	35160	33775	1385	3.9
CN2701500000000	27	015	Brown County, MN	2003	NA	15232	14402	830	5.4
CN2701700000000	27	017	Carlton County, MN	2003	NA	16583	15529	1054	6.4
CN2701900000000	27	019	Carver County, MN	2003	NA	45259	43306	1953	4.3
CN2702100000000	27	021	Cass County, MN	2003	NA	14140	13147	993	7
CN2702300000000	27	023	Chippewa County, MN	2003	NA	7218	6845	373	5.2
CN2702500000000	27	025	Chisago County, MN	2003	NA	25897	24390	1507	5.8
CN2702700000000	27	027	Clay County, MN	2003	NA	29468	28399	1069	3.6
CN2702900000000	27	029	Clearwater County, MN	2003	NA	4028	3575	453	11.2
CN2703100000000	27	031	Cook County, MN	2003	NA	3156	3002	154	4.9
CN2703300000000	27	033	Cottonwood County, MN	2003	NA	6684	6375	309	4.6
CN2703500000000	27	035	Crow Wing County, MN	2003	NA	31442	29634	1808	5.8
CN2703700000000	27	037	Dakota County, MN	2003	NA	223604	214057	9547	4.3
CN2703900000000	27	039	Dodge County, MN	2003	NA	10861	10384	477	4.4
CN2704100000000	27	041	Douglas County, MN	2003	NA	19861	19095	766	3.9
CN2704300000000	27	043	Faribault County, MN	2003	NA	8572	8127	445	5.2
CN2704500000000	27	045	Fillmore County, MN	2003	NA	11740	11154	586	5
CN2704700000000	27	047	Freeborn County, MN	2003	NA	16866	15962	904	5.4
CN2704900000000	27	049	Goodhue County, MN	2003	NA	25618	24392	1226	4.8
CN2705100000000	27	051	Grant County, MN	2003	NA	3225	3024	201	6.2
CN2705300000000	27	053	Hennepin County, MN	2003	NA	660470	629699	30771	4.7
CN2705500000000	27	055	Houston County, MN	2003	NA	11149	10554	595	5.3
CN2705700000000	27	057	Hubbard County, MN	2003	NA	9718	9139	579	6
CN2705900000000	27	059	Isanti County, MN	2003	NA	20027	18882	1145	5.7
CN2706100000000	27	061	Itasca County, MN	2003	NA	22454	20775	1679	7.5
CN2706300000000	27	063	Jackson County, MN	2003	NA	6505	6235	270	4.2
CN2706500000000	27	065	Kanabec County, MN	2003	NA	7900	7257	643	8.1
CN2706700000000	27	067	Kandiyohi County, MN	2003	NA	23557	22515	1042	4.4
CN2706900000000	27	069	Kittson County, MN	2003	NA	2537	2347	190	7.5
CN2707100000000	27	071	Koochiching County, MN	2003	NA	7188	6719	469	6.5
CN2707300000000	27	073	Lac qui Parle County, MN	2003	NA	4080	3902	178	4.4
CN2707500000000	27	075	Lake County, MN	2003	NA	6068	5781	287	4.7
CN2707700000000	27	077	Lake of the Woods County, MN	2003	NA	2471	2357	114	4.6
CN2707900000000	27	079	Le Sueur County, MN	2003	NA	14788	13850	938	6.3
CN2708100000000	27	081	Lincoln County, MN	2003	NA	3360	3225	135	4
CN2708300000000	27	083	Lyon County, MN	2003	NA	14433	13818	615	4.3
CN2708500000000	27	085	McLeod County, MN	2003	NA	20114	19192	922	4.6
CN2708700000000	27	087	Mahnomen County, MN	2003	NA	2717	2572	145	5.3
CN2708900000000	27	089	Marshall County, MN	2003	NA	5239	4806	433	8.3
CN2709100000000	27	091	Martin County, MN	2003	NA	11780	11228	552	4.7
CN2709300000000	27	093	Meeker County, MN	2003	NA	12635	11909	726	5.7
CN2709500000000	27	095	Mille Lacs County, MN	2003	NA	12163	11266	897	7.4
CN2709700000000	27	097	Morrison County, MN	2003	NA	17588	16491	1097	6.2
CN2709900000000	27	099	Mower County, MN	2003	NA	20376	19449	927	4.5
CN2710100000000	27	101	Murray County, MN	2003	NA	5503	5259	244	4.4
CN2710300000000	27	103	Nicollet County, MN	2003	NA	18811	18091	720	3.8
CN2710500000000	27	105	Nobles County, MN	2003	NA	11278	10844	434	3.8
CN2710700000000	27	107	Norman County, MN	2003	NA	3693	3495	198	5.4
CN2710900000000	27	109	Olmsted County, MN	2003	NA	76609	73293	3316	4.3
CN2711100000000	27	111	Otter Tail County, MN	2003	NA	30016	28371	1645	5.5
CN2711300000000	27	113	Pennington County, MN	2003	NA	7995	7508	487	6.1
CN2711500000000	27	115	Pine County, MN	2003	NA	14718	13701	1017	6.9
CN2711700000000	27	117	Pipestone County, MN	2003	NA	5478	5266	212	3.9
CN2711900000000	27	119	Polk County, MN	2003	NA	16562	15711	851	5.1
CN2712100000000	27	121	Pope County, MN	2003	NA	6204	5950	254	4.1
CN2712300000000	27	123	Ramsey County, MN	2003	NA	279615	266120	13495	4.8
CN2712500000000	27	125	Red Lake County, MN	2003	NA	2189	2016	173	7.9
CN2712700000000	27	127	Redwood County, MN	2003	NA	8614	8223	391	4.5
CN2712900000000	27	129	Renville County, MN	2003	NA	8953	8473	480	5.4
CN2713100000000	27	131	Rice County, MN	2003	NA	33086	31492	1594	4.8
CN2713300000000	27	133	Rock County, MN	2003	NA	5237	5055	182	3.5
CN2713500000000	27	135	Roseau County, MN	2003	NA	10194	9449	745	7.3
CN2713700000000	27	137	St. Louis County, MN	2003	NA	103199	96753	6446	6.2
CN2713900000000	27	139	Scott County, MN	2003	NA	64052	61279	2773	4.3
CN2714100000000	27	141	Sherburne County, MN	2003	NA	43310	41090	2220	5.1
CN2714300000000	27	143	Sibley County, MN	2003	NA	9028	8589	439	4.9
CN2714500000000	27	145	Stearns County, MN	2003	NA	79727	75928	3799	4.8
CN2714700000000	27	147	Steele County, MN	2003	NA	19429	18469	960	4.9
CN2714900000000	27	149	Stevens County, MN	2003	NA	5718	5494	224	3.9
CN2715100000000	27	151	Swift County, MN	2003	NA	5493	5220	273	5
CN2715300000000	27	153	Todd County, MN	2003	NA	12840	12192	648	5
CN2715500000000	27	155	Traverse County, MN	2003	NA	1903	1816	87	4.6
CN2715700000000	27	157	Wabasha County, MN	2003	NA	12606	12055	551	4.4
CN2715900000000	27	159	Wadena County, MN	2003	NA	6684	6242	442	6.6
CN2716100000000	27	161	Waseca County, MN	2003	NA	10671	10165	506	4.7
CN2716300000000	27	163	Washington County, MN	2003	NA	122962	117815	5147	4.2
CN2716500000000	27	165	Watonwan County, MN	2003	NA	5963	5671	292	4.9
CN2716700000000	27	167	Wilkin County, MN	2003	NA	3769	3621	148	3.9
CN2716900000000	27	169	Winona County, MN	2003	NA	28170	26832	1338	4.7
CN2717100000000	27	171	Wright County, MN	2003	NA	58927	55893	3034	5.1
CN2717300000000	27	173	Yellow Medicine County, MN	2003	NA	5682	5362	320	5.6
CN2800100000000	28	001	Adams County, MS	2003	NA	13622	12469	1153	8.5
CN2800300000000	28	003	Alcorn County, MS	2003	NA	15860	14688	1172	7.4
CN2800500000000	28	005	Amite County, MS	2003	NA	5364	4904	460	8.6
CN2800700000000	28	007	Attala County, MS	2003	NA	8486	7824	662	7.8
CN2800900000000	28	009	Benton County, MS	2003	NA	2955	2640	315	10.7
CN2801100000000	28	011	Bolivar County, MS	2003	NA	15761	14499	1262	8
CN2801300000000	28	013	Calhoun County, MS	2003	NA	6564	6078	486	7.4
CN2801500000000	28	015	Carroll County, MS	2003	NA	5043	4741	302	6
CN2801700000000	28	017	Chickasaw County, MS	2003	NA	7907	7217	690	8.7
CN2801900000000	28	019	Choctaw County, MS	2003	NA	3619	3226	393	10.9
CN2802100000000	28	021	Claiborne County, MS	2003	NA	3965	3545	420	10.6
CN2802300000000	28	023	Clarke County, MS	2003	NA	7313	6633	680	9.3
CN2802500000000	28	025	Clay County, MS	2003	NA	8954	8083	871	9.7
CN2802700000000	28	027	Coahoma County, MS	2003	NA	11618	10648	970	8.3
CN2802900000000	28	029	Copiah County, MS	2003	NA	12296	11524	772	6.3
CN2803100000000	28	031	Covington County, MS	2003	NA	8675	8197	478	5.5
CN2803300000000	28	033	DeSoto County, MS	2003	NA	65522	63103	2419	3.7
CN2803500000000	28	035	Forrest County, MS	2003	NA	35169	33319	1850	5.3
CN2803700000000	28	037	Franklin County, MS	2003	NA	3141	2871	270	8.6
CN2803900000000	28	039	George County, MS	2003	NA	8507	7648	859	10.1
CN2804100000000	28	041	Greene County, MS	2003	NA	4946	4484	462	9.3
CN2804300000000	28	043	Grenada County, MS	2003	NA	9946	9337	609	6.1
CN2804500000000	28	045	Hancock County, MS	2003	NA	20420	19388	1032	5.1
CN2804700000000	28	047	Harrison County, MS	2003	NA	90776	86329	4447	4.9
CN2804900000000	28	049	Hinds County, MS	2003	NA	121448	114758	6690	5.5
CN2805100000000	28	051	Holmes County, MS	2003	NA	6837	6067	770	11.3
CN2805300000000	28	053	Humphreys County, MS	2003	NA	4593	4204	389	8.5
CN2805500000000	28	055	Issaquena County, MS	2003	NA	844	753	91	10.8
CN2805700000000	28	057	Itawamba County, MS	2003	NA	10396	9741	655	6.3
CN2805900000000	28	059	Jackson County, MS	2003	NA	59685	55958	3727	6.2
CN2806100000000	28	061	Jasper County, MS	2003	NA	7167	6636	531	7.4
CN2806300000000	28	063	Jefferson County, MS	2003	NA	2912	2534	378	13
CN2806500000000	28	065	Jefferson Davis County, MS	2003	NA	5333	4925	408	7.7
CN2806700000000	28	067	Jones County, MS	2003	NA	28691	27147	1544	5.4
CN2806900000000	28	069	Kemper County, MS	2003	NA	4288	3901	387	9
CN2807100000000	28	071	Lafayette County, MS	2003	NA	20256	19126	1130	5.6
CN2807300000000	28	073	Lamar County, MS	2003	NA	20909	20037	872	4.2
CN2807500000000	28	075	Lauderdale County, MS	2003	NA	33550	31250	2300	6.9
CN2807700000000	28	077	Lawrence County, MS	2003	NA	5396	5037	359	6.7
CN2807900000000	28	079	Leake County, MS	2003	NA	9505	8952	553	5.8
CN2808100000000	28	081	Lee County, MS	2003	NA	37732	35463	2269	6
CN2808300000000	28	083	Leflore County, MS	2003	NA	14519	13020	1499	10.3
CN2808500000000	28	085	Lincoln County, MS	2003	NA	14405	13508	897	6.2
CN2808700000000	28	087	Lowndes County, MS	2003	NA	25717	23845	1872	7.3
CN2808900000000	28	089	Madison County, MS	2003	NA	41741	39846	1895	4.5
CN2809100000000	28	091	Marion County, MS	2003	NA	10578	9947	631	6
CN2809300000000	28	093	Marshall County, MS	2003	NA	15424	14184	1240	8
CN2809500000000	28	095	Monroe County, MS	2003	NA	16865	15511	1354	8
CN2809700000000	28	097	Montgomery County, MS	2003	NA	4986	4530	456	9.1
CN2809900000000	28	099	Neshoba County, MS	2003	NA	14628	13857	771	5.3
CN2810100000000	28	101	Newton County, MS	2003	NA	9680	9138	542	5.6
CN2810300000000	28	103	Noxubee County, MS	2003	NA	4517	4089	428	9.5
CN2810500000000	28	105	Oktibbeha County, MS	2003	NA	20046	18905	1141	5.7
CN2810700000000	28	107	Panola County, MS	2003	NA	14663	13357	1306	8.9
CN2810900000000	28	109	Pearl River County, MS	2003	NA	21275	20138	1137	5.3
CN2811100000000	28	111	Perry County, MS	2003	NA	5159	4782	377	7.3
CN2811300000000	28	113	Pike County, MS	2003	NA	15101	14117	984	6.5
CN2811500000000	28	115	Pontotoc County, MS	2003	NA	13032	12294	738	5.7
CN2811700000000	28	117	Prentiss County, MS	2003	NA	12088	11328	760	6.3
CN2811900000000	28	119	Quitman County, MS	2003	NA	4157	3808	349	8.4
CN2812100000000	28	121	Rankin County, MS	2003	NA	68079	65286	2793	4.1
CN2812300000000	28	123	Scott County, MS	2003	NA	13048	12339	709	5.4
CN2812500000000	28	125	Sharkey County, MS	2003	NA	2700	2453	247	9.1
CN2812700000000	28	127	Simpson County, MS	2003	NA	11834	11180	654	5.5
CN2812900000000	28	129	Smith County, MS	2003	NA	7341	6986	355	4.8
CN2813100000000	28	131	Stone County, MS	2003	NA	6845	6464	381	5.6
CN2813300000000	28	133	Sunflower County, MS	2003	NA	11465	10401	1064	9.3
CN2813500000000	28	135	Tallahatchie County, MS	2003	NA	6333	5768	565	8.9
CN2813700000000	28	137	Tate County, MS	2003	NA	11695	10985	710	6.1
CN2813900000000	28	139	Tippah County, MS	2003	NA	9223	8487	736	8
CN2814100000000	28	141	Tishomingo County, MS	2003	NA	8224	7460	764	9.3
CN2814300000000	28	143	Tunica County, MS	2003	NA	4461	3975	486	10.9
CN2814500000000	28	145	Union County, MS	2003	NA	11700	10933	767	6.6
CN2814700000000	28	147	Walthall County, MS	2003	NA	5850	5440	410	7
CN2814900000000	28	149	Warren County, MS	2003	NA	23279	21863	1416	6.1
CN2815100000000	28	151	Washington County, MS	2003	NA	24557	22356	2201	9
CN2815300000000	28	153	Wayne County, MS	2003	NA	8620	7923	697	8.1
CN2815500000000	28	155	Webster County, MS	2003	NA	3468	3073	395	11.4
CN2815700000000	28	157	Wilkinson County, MS	2003	NA	3747	3395	352	9.4
CN2815900000000	28	159	Winston County, MS	2003	NA	7823	7198	625	8
CN2816100000000	28	161	Yalobusha County, MS	2003	NA	5622	5149	473	8.4
CN2816300000000	28	163	Yazoo County, MS	2003	NA	10786	9941	845	7.8
CN2900100000000	29	001	Adair County, MO	2003	NA	13484	12819	665	4.9
CN2900300000000	29	003	Andrew County, MO	2003	NA	9563	9084	479	5
CN2900500000000	29	005	Atchison County, MO	2003	NA	3419	3283	136	4
CN2900700000000	29	007	Audrain County, MO	2003	NA	12068	11329	739	6.1
CN2900900000000	29	009	Barry County, MO	2003	NA	17411	16534	877	5
CN2901100000000	29	011	Barton County, MO	2003	NA	6691	6361	330	4.9
CN2901300000000	29	013	Bates County, MO	2003	NA	8084	7584	500	6.2
CN2901500000000	29	015	Benton County, MO	2003	NA	8375	7819	556	6.6
CN2901700000000	29	017	Bollinger County, MO	2003	NA	6309	5934	375	5.9
CN2901900000000	29	019	Boone County, MO	2003	NA	83738	80767	2971	3.5
CN2902100000000	29	021	Buchanan County, MO	2003	NA	44592	42008	2584	5.8
CN2902300000000	29	023	Butler County, MO	2003	NA	20929	19744	1185	5.7
CN2902500000000	29	025	Caldwell County, MO	2003	NA	4431	4173	258	5.8
CN2902700000000	29	027	Callaway County, MO	2003	NA	22815	21761	1054	4.6
CN2902900000000	29	029	Camden County, MO	2003	NA	20620	19451	1169	5.7
CN2903100000000	29	031	Cape Girardeau County, MO	2003	NA	40186	38490	1696	4.2
CN2903300000000	29	033	Carroll County, MO	2003	NA	5160	4878	282	5.5
CN2903500000000	29	035	Carter County, MO	2003	NA	2898	2708	190	6.6
CN2903700000000	29	037	Cass County, MO	2003	NA	47030	44587	2443	5.2
CN2903900000000	29	039	Cedar County, MO	2003	NA	6278	5863	415	6.6
CN2904100000000	29	041	Chariton County, MO	2003	NA	4320	4070	250	5.8
CN2904300000000	29	043	Christian County, MO	2003	NA	34737	33029	1708	4.9
CN2904500000000	29	045	Clark County, MO	2003	NA	3678	3412	266	7.2
CN2904700000000	29	047	Clay County, MO	2003	NA	109412	104284	5128	4.7
CN2904900000000	29	049	Clinton County, MO	2003	NA	10256	9706	550	5.4
CN2905100000000	29	051	Cole County, MO	2003	NA	40557	38959	1598	3.9
CN2905300000000	29	053	Cooper County, MO	2003	NA	8832	8418	414	4.7
CN2905500000000	29	055	Crawford County, MO	2003	NA	11852	11085	767	6.5
CN2905700000000	29	057	Dade County, MO	2003	NA	3929	3741	188	4.8
CN2905900000000	29	059	Dallas County, MO	2003	NA	7402	6960	442	6
CN2906100000000	29	061	Daviess County, MO	2003	NA	3958	3739	219	5.5
CN2906300000000	29	063	DeKalb County, MO	2003	NA	5223	4898	325	6.2
CN2906500000000	29	065	Dent County, MO	2003	NA	6604	6184	420	6.4
CN2906700000000	29	067	Douglas County, MO	2003	NA	5933	5498	435	7.3
CN2906900000000	29	069	Dunklin County, MO	2003	NA	15030	13896	1134	7.5
CN2907100000000	29	071	Franklin County, MO	2003	NA	52433	49466	2967	5.7
CN2907300000000	29	073	Gasconade County, MO	2003	NA	7748	7268	480	6.2
CN2907500000000	29	075	Gentry County, MO	2003	NA	3381	3229	152	4.5
CN2907700000000	29	077	Greene County, MO	2003	NA	135887	129803	6084	4.5
CN2907900000000	29	079	Grundy County, MO	2003	NA	5032	4724	308	6.1
CN2908100000000	29	081	Harrison County, MO	2003	NA	4427	4199	228	5.2
CN2908300000000	29	083	Henry County, MO	2003	NA	11123	10316	807	7.3
CN2908500000000	29	085	Hickory County, MO	2003	NA	3458	3176	282	8.2
CN2908700000000	29	087	Holt County, MO	2003	NA	2624	2483	141	5.4
CN2908900000000	29	089	Howard County, MO	2003	NA	5404	5179	225	4.2
CN2909100000000	29	091	Howell County, MO	2003	NA	19663	18593	1070	5.4
CN2909300000000	29	093	Iron County, MO	2003	NA	5022	4643	379	7.5
CN2909500000000	29	095	Jackson County, MO	2003	NA	343792	321297	22495	6.5
CN2909700000000	29	097	Jasper County, MO	2003	NA	55142	52206	2936	5.3
CN2909900000000	29	099	Jefferson County, MO	2003	NA	114629	108503	6126	5.3
CN2910100000000	29	101	Johnson County, MO	2003	NA	25113	23928	1185	4.7
CN2910300000000	29	103	Knox County, MO	2003	NA	2165	2067	98	4.5
CN2910500000000	29	105	Laclede County, MO	2003	NA	16903	15496	1407	8.3
CN2910700000000	29	107	Lafayette County, MO	2003	NA	17011	16115	896	5.3
CN2910900000000	29	109	Lawrence County, MO	2003	NA	18695	17779	916	4.9
CN2911100000000	29	111	Lewis County, MO	2003	NA	5659	5344	315	5.6
CN2911300000000	29	113	Lincoln County, MO	2003	NA	23307	21985	1322	5.7
CN2911500000000	29	115	Linn County, MO	2003	NA	7150	6618	532	7.4
CN2911700000000	29	117	Livingston County, MO	2003	NA	7220	6843	377	5.2
CN2911900000000	29	119	McDonald County, MO	2003	NA	11766	11188	578	4.9
CN2912100000000	29	121	Macon County, MO	2003	NA	8382	7942	440	5.2
CN2912300000000	29	123	Madison County, MO	2003	NA	5856	5484	372	6.4
CN2912500000000	29	125	Maries County, MO	2003	NA	4821	4579	242	5
CN2912700000000	29	127	Marion County, MO	2003	NA	14721	13875	846	5.7
CN2912900000000	29	129	Mercer County, MO	2003	NA	1766	1663	103	5.8
CN2913100000000	29	131	Miller County, MO	2003	NA	12934	12160	774	6
CN2913300000000	29	133	Mississippi County, MO	2003	NA	6248	5795	453	7.3
CN2913500000000	29	135	Moniteau County, MO	2003	NA	7605	7262	343	4.5
CN2913700000000	29	137	Monroe County, MO	2003	NA	4510	4245	265	5.9
CN2913900000000	29	139	Montgomery County, MO	2003	NA	6443	6048	395	6.1
CN2914100000000	29	141	Morgan County, MO	2003	NA	9499	8907	592	6.2
CN2914300000000	29	143	New Madrid County, MO	2003	NA	8892	8032	860	9.7
CN2914500000000	29	145	Newton County, MO	2003	NA	28056	26380	1676	6
CN2914700000000	29	147	Nodaway County, MO	2003	NA	12834	12385	449	3.5
CN2914900000000	29	149	Oregon County, MO	2003	NA	4279	4042	237	5.5
CN2915100000000	29	151	Osage County, MO	2003	NA	7532	7157	375	5
CN2915300000000	29	153	Ozark County, MO	2003	NA	4526	4259	267	5.9
CN2915500000000	29	155	Pemiscot County, MO	2003	NA	8199	7396	803	9.8
CN2915700000000	29	157	Perry County, MO	2003	NA	10269	9857	412	4
CN2915900000000	29	159	Pettis County, MO	2003	NA	20800	19585	1215	5.8
CN2916100000000	29	161	Phelps County, MO	2003	NA	22304	21316	988	4.4
CN2916300000000	29	163	Pike County, MO	2003	NA	8950	8479	471	5.3
CN2916500000000	29	165	Platte County, MO	2003	NA	46726	44688	2038	4.4
CN2916700000000	29	167	Polk County, MO	2003	NA	13775	13044	731	5.3
CN2916900000000	29	169	Pulaski County, MO	2003	NA	17406	16469	937	5.4
CN2917100000000	29	171	Putnam County, MO	2003	NA	2528	2380	148	5.9
CN2917300000000	29	173	Ralls County, MO	2003	NA	5610	5281	329	5.9
CN2917500000000	29	175	Randolph County, MO	2003	NA	13070	12362	708	5.4
CN2917700000000	29	177	Ray County, MO	2003	NA	11990	11318	672	5.6
CN2917900000000	29	179	Reynolds County, MO	2003	NA	2638	2411	227	8.6
CN2918100000000	29	181	Ripley County, MO	2003	NA	6356	5939	417	6.6
CN2918300000000	29	183	St. Charles County, MO	2003	NA	180237	172350	7887	4.4
CN2918500000000	29	185	St. Clair County, MO	2003	NA	4595	4275	320	7
CN2918600000000	29	186	Ste. Genevieve County, MO	2003	NA	9645	9148	497	5.2
CN2918700000000	29	187	St. Francois County, MO	2003	NA	27693	25846	1847	6.7
CN2918900000000	29	189	St. Louis County, MO	2003	NA	552250	523010	29240	5.3
CN2919500000000	29	195	Saline County, MO	2003	NA	12122	11476	646	5.3
CN2919700000000	29	197	Schuyler County, MO	2003	NA	2239	2097	142	6.3
CN2919900000000	29	199	Scotland County, MO	2003	NA	2459	2351	108	4.4
CN2920100000000	29	201	Scott County, MO	2003	NA	20989	19799	1190	5.7
CN2920300000000	29	203	Shannon County, MO	2003	NA	4114	3797	317	7.7
CN2920500000000	29	205	Shelby County, MO	2003	NA	3263	3079	184	5.6
CN2920700000000	29	207	Stoddard County, MO	2003	NA	15598	14649	949	6.1
CN2920900000000	29	209	Stone County, MO	2003	NA	15896	14572	1324	8.3
CN2921100000000	29	211	Sullivan County, MO	2003	NA	3349	3006	343	10.2
CN2921300000000	29	213	Taney County, MO	2003	NA	25201	22986	2215	8.8
CN2921500000000	29	215	Texas County, MO	2003	NA	10911	10130	781	7.2
CN2921700000000	29	217	Vernon County, MO	2003	NA	10505	9992	513	4.9
CN2921900000000	29	219	Warren County, MO	2003	NA	14763	13925	838	5.7
CN2922100000000	29	221	Washington County, MO	2003	NA	10085	9249	836	8.3
CN2922300000000	29	223	Wayne County, MO	2003	NA	5801	5363	438	7.6
CN2922500000000	29	225	Webster County, MO	2003	NA	16146	15352	794	4.9
CN2922700000000	29	227	Worth County, MO	2003	NA	1226	1178	48	3.9
CN2922900000000	29	229	Wright County, MO	2003	NA	8110	7599	511	6.3
CN2951000000000	29	510	St. Louis city, MO	2003	NA	163540	149509	14031	8.6
CN3000100000000	30	001	Beaverhead County, MT	2003	NA	5139	4945	194	3.8
CN3000300000000	30	003	Big Horn County, MT	2003	NA	4923	4354	569	11.6
CN3000500000000	30	005	Blaine County, MT	2003	NA	2747	2617	130	4.7
CN3000700000000	30	007	Broadwater County, MT	2003	NA	2283	2175	108	4.7
CN3000900000000	30	009	Carbon County, MT	2003	NA	5210	5006	204	3.9
CN3001100000000	30	011	Carter County, MT	2003	NA	669	648	21	3.1
CN3001300000000	30	013	Cascade County, MT	2003	NA	38361	36653	1708	4.5
CN3001500000000	30	015	Chouteau County, MT	2003	NA	2506	2421	85	3.4
CN3001700000000	30	017	Custer County, MT	2003	NA	5692	5471	221	3.9
CN3001900000000	30	019	Daniels County, MT	2003	NA	825	788	37	4.5
CN3002100000000	30	021	Dawson County, MT	2003	NA	4297	4149	148	3.4
CN3002300000000	30	023	Deer Lodge County, MT	2003	NA	3872	3621	251	6.5
CN3002500000000	30	025	Fallon County, MT	2003	NA	1545	1497	48	3.1
CN3002700000000	30	027	Fergus County, MT	2003	NA	5759	5469	290	5
CN3002900000000	30	029	Flathead County, MT	2003	NA	40571	38169	2402	5.9
CN3003100000000	30	031	Gallatin County, MT	2003	NA	42904	41361	1543	3.6
CN3003300000000	30	033	Garfield County, MT	2003	NA	631	609	22	3.5
CN3003500000000	30	035	Glacier County, MT	2003	NA	5735	5282	453	7.9
CN3003700000000	30	037	Golden Valley County, MT	2003	NA	446	418	28	6.3
CN3003900000000	30	039	Granite County, MT	2003	NA	1287	1213	74	5.7
CN3004100000000	30	041	Hill County, MT	2003	NA	7875	7533	342	4.3
CN3004300000000	30	043	Jefferson County, MT	2003	NA	5425	5191	234	4.3
CN3004500000000	30	045	Judith Basin County, MT	2003	NA	1091	1044	47	4.3
CN3004700000000	30	047	Lake County, MT	2003	NA	11482	10772	710	6.2
CN3004900000000	30	049	Lewis and Clark County, MT	2003	NA	30888	29694	1194	3.9
CN3005100000000	30	051	Liberty County, MT	2003	NA	847	812	35	4.1
CN3005300000000	30	053	Lincoln County, MT	2003	NA	7693	6752	941	12.2
CN3005500000000	30	055	McCone County, MT	2003	NA	993	959	34	3.4
CN3005700000000	30	057	Madison County, MT	2003	NA	3373	3212	161	4.8
CN3005900000000	30	059	Meagher County, MT	2003	NA	914	862	52	5.7
CN3006100000000	30	061	Mineral County, MT	2003	NA	1888	1755	133	7
CN3006300000000	30	063	Missoula County, MT	2003	NA	56501	54184	2317	4.1
CN3006500000000	30	065	Musselshell County, MT	2003	NA	2063	1937	126	6.1
CN3006700000000	30	067	Park County, MT	2003	NA	8538	8123	415	4.9
CN3006900000000	30	069	Petroleum County, MT	2003	NA	204	191	13	6.4
CN3007100000000	30	071	Phillips County, MT	2003	NA	2122	2026	96	4.5
CN3007300000000	30	073	Pondera County, MT	2003	NA	2761	2624	137	5
CN3007500000000	30	075	Powder River County, MT	2003	NA	889	852	37	4.2
CN3007700000000	30	077	Powell County, MT	2003	NA	2694	2530	164	6.1
CN3007900000000	30	079	Prairie County, MT	2003	NA	539	513	26	4.8
CN3008100000000	30	081	Ravalli County, MT	2003	NA	17833	16792	1041	5.8
CN3008300000000	30	083	Richland County, MT	2003	NA	4652	4441	211	4.5
CN3008500000000	30	085	Roosevelt County, MT	2003	NA	4123	3874	249	6
CN3008700000000	30	087	Rosebud County, MT	2003	NA	4307	4069	238	5.5
CN3008900000000	30	089	Sanders County, MT	2003	NA	4543	4210	333	7.3
CN3009100000000	30	091	Sheridan County, MT	2003	NA	1808	1732	76	4.2
CN3009300000000	30	093	Silver Bow County, MT	2003	NA	16974	16098	876	5.2
CN3009500000000	30	095	Stillwater County, MT	2003	NA	4334	4165	169	3.9
CN3009700000000	30	097	Sweet Grass County, MT	2003	NA	2271	2213	58	2.6
CN3009900000000	30	099	Teton County, MT	2003	NA	2938	2821	117	4
CN3010100000000	30	101	Toole County, MT	2003	NA	2527	2437	90	3.6
CN3010300000000	30	103	Treasure County, MT	2003	NA	432	416	16	3.7
CN3010500000000	30	105	Valley County, MT	2003	NA	3791	3634	157	4.1
CN3010700000000	30	107	Wheatland County, MT	2003	NA	1016	968	48	4.7
CN3010900000000	30	109	Wibaux County, MT	2003	NA	502	481	21	4.2
CN3011100000000	30	111	Yellowstone County, MT	2003	NA	75259	72484	2775	3.7
CN3100100000000	31	001	Adams County, NE	2003	NA	16792	16106	686	4.1
CN3100300000000	31	003	Antelope County, NE	2003	NA	3985	3854	131	3.3
CN3100500000000	31	005	Arthur County, NE	2003	NA	248	235	13	5.2
CN3100700000000	31	007	Banner County, NE	2003	NA	398	388	10	2.5
CN3100900000000	31	009	Blaine County, NE	2003	NA	296	286	10	3.4
CN3101100000000	31	011	Boone County, NE	2003	NA	3270	3166	104	3.2
CN3101300000000	31	013	Box Butte County, NE	2003	NA	5659	5392	267	4.7
CN3101500000000	31	015	Boyd County, NE	2003	NA	1286	1247	39	3
CN3101700000000	31	017	Brown County, NE	2003	NA	1911	1837	74	3.9
CN3101900000000	31	019	Buffalo County, NE	2003	NA	26425	25697	728	2.8
CN3102100000000	31	021	Burt County, NE	2003	NA	4045	3839	206	5.1
CN3102300000000	31	023	Butler County, NE	2003	NA	4690	4490	200	4.3
CN3102500000000	31	025	Cass County, NE	2003	NA	13870	13313	557	4
CN3102700000000	31	027	Cedar County, NE	2003	NA	5032	4875	157	3.1
CN3102900000000	31	029	Chase County, NE	2003	NA	2223	2164	59	2.7
CN3103100000000	31	031	Cherry County, NE	2003	NA	3696	3598	98	2.7
CN3103300000000	31	033	Cheyenne County, NE	2003	NA	4945	4784	161	3.3
CN3103500000000	31	035	Clay County, NE	2003	NA	3317	3192	125	3.8
CN3103700000000	31	037	Colfax County, NE	2003	NA	6086	5899	187	3.1
CN3103900000000	31	039	Cuming County, NE	2003	NA	5608	5456	152	2.7
CN3104100000000	31	041	Custer County, NE	2003	NA	6372	6190	182	2.9
CN3104300000000	31	043	Dakota County, NE	2003	NA	10699	10196	503	4.7
CN3104500000000	31	045	Dawes County, NE	2003	NA	4741	4585	156	3.3
CN3104700000000	31	047	Dawson County, NE	2003	NA	12540	12024	516	4.1
CN3104900000000	31	049	Deuel County, NE	2003	NA	1169	1134	35	3
CN3105100000000	31	051	Dixon County, NE	2003	NA	3143	3029	114	3.6
CN3105300000000	31	053	Dodge County, NE	2003	NA	19524	18600	924	4.7
CN3105500000000	31	055	Douglas County, NE	2003	NA	263051	251038	12013	4.6
CN3105700000000	31	057	Dundy County, NE	2003	NA	1217	1178	39	3.2
CN3105900000000	31	059	Fillmore County, NE	2003	NA	3450	3322	128	3.7
CN3106100000000	31	061	Franklin County, NE	2003	NA	1971	1908	63	3.2
CN3106300000000	31	063	Frontier County, NE	2003	NA	1814	1763	51	2.8
CN3106500000000	31	065	Furnas County, NE	2003	NA	2562	2476	86	3.4
CN3106700000000	31	067	Gage County, NE	2003	NA	12899	12353	546	4.2
CN3106900000000	31	069	Garden County, NE	2003	NA	1154	1110	44	3.8
CN3107100000000	31	071	Garfield County, NE	2003	NA	1060	1023	37	3.5
CN3107300000000	31	073	Gosper County, NE	2003	NA	1116	1079	37	3.3
CN3107500000000	31	075	Grant County, NE	2003	NA	434	422	12	2.8
CN3107700000000	31	077	Greeley County, NE	2003	NA	1455	1404	51	3.5
CN3107900000000	31	079	Hall County, NE	2003	NA	29424	28136	1288	4.4
CN3108100000000	31	081	Hamilton County, NE	2003	NA	5309	5113	196	3.7
CN3108300000000	31	083	Harlan County, NE	2003	NA	1891	1830	61	3.2
CN3108500000000	31	085	Hayes County, NE	2003	NA	574	553	21	3.7
CN3108700000000	31	087	Hitchcock County, NE	2003	NA	1520	1461	59	3.9
CN3108900000000	31	089	Holt County, NE	2003	NA	6365	6169	196	3.1
CN3109100000000	31	091	Hooker County, NE	2003	NA	418	404	14	3.3
CN3109300000000	31	093	Howard County, NE	2003	NA	3634	3480	154	4.2
CN3109500000000	31	095	Jefferson County, NE	2003	NA	4274	4092	182	4.3
CN3109700000000	31	097	Johnson County, NE	2003	NA	3039	2948	91	3
CN3109900000000	31	099	Kearney County, NE	2003	NA	3891	3786	105	2.7
CN3110100000000	31	101	Keith County, NE	2003	NA	4989	4821	168	3.4
CN3110300000000	31	103	Keya Paha County, NE	2003	NA	460	445	15	3.3
CN3110500000000	31	105	Kimball County, NE	2003	NA	2121	2062	59	2.8
CN3110700000000	31	107	Knox County, NE	2003	NA	4975	4803	172	3.5
CN3110900000000	31	109	Lancaster County, NE	2003	NA	153762	148183	5579	3.6
CN3111100000000	31	111	Lincoln County, NE	2003	NA	20461	19741	720	3.5
CN3111300000000	31	113	Logan County, NE	2003	NA	429	417	12	2.8
CN3111500000000	31	115	Loup County, NE	2003	NA	358	344	14	3.9
CN3111700000000	31	117	McPherson County, NE	2003	NA	306	297	9	2.9
CN3111900000000	31	119	Madison County, NE	2003	NA	20431	19613	818	4
CN3112100000000	31	121	Merrick County, NE	2003	NA	4270	4097	173	4.1
CN3112300000000	31	123	Morrill County, NE	2003	NA	2833	2722	111	3.9
CN3112500000000	31	125	Nance County, NE	2003	NA	2092	1984	108	5.2
CN3112700000000	31	127	Nemaha County, NE	2003	NA	3564	3412	152	4.3
CN3112900000000	31	129	Nuckolls County, NE	2003	NA	2512	2435	77	3.1
CN3113100000000	31	131	Otoe County, NE	2003	NA	8763	8410	353	4
CN3113300000000	31	133	Pawnee County, NE	2003	NA	1670	1602	68	4.1
CN3113500000000	31	135	Perkins County, NE	2003	NA	1664	1621	43	2.6
CN3113700000000	31	137	Phelps County, NE	2003	NA	5381	5217	164	3
CN3113900000000	31	139	Pierce County, NE	2003	NA	4326	4175	151	3.5
CN3114100000000	31	141	Platte County, NE	2003	NA	16916	16117	799	4.7
CN3114300000000	31	143	Polk County, NE	2003	NA	3054	2945	109	3.6
CN3114500000000	31	145	Red Willow County, NE	2003	NA	6078	5873	205	3.4
CN3114700000000	31	147	Richardson County, NE	2003	NA	4512	4256	256	5.7
CN3114900000000	31	149	Rock County, NE	2003	NA	1031	992	39	3.8
CN3115100000000	31	151	Saline County, NE	2003	NA	8218	7948	270	3.3
CN3115300000000	31	153	Sarpy County, NE	2003	NA	69654	67434	2220	3.2
CN3115500000000	31	155	Saunders County, NE	2003	NA	11032	10608	424	3.8
CN3115700000000	31	157	Scotts Bluff County, NE	2003	NA	18943	18002	941	5
CN3115900000000	31	159	Seward County, NE	2003	NA	9191	8894	297	3.2
CN3116100000000	31	161	Sheridan County, NE	2003	NA	3415	3326	89	2.6
CN3116300000000	31	163	Sherman County, NE	2003	NA	1855	1796	59	3.2
CN3116500000000	31	165	Sioux County, NE	2003	NA	800	776	24	3
CN3116700000000	31	167	Stanton County, NE	2003	NA	3754	3632	122	3.2
CN3116900000000	31	169	Thayer County, NE	2003	NA	3014	2920	94	3.1
CN3117100000000	31	171	Thomas County, NE	2003	NA	422	404	18	4.3
CN3117300000000	31	173	Thurston County, NE	2003	NA	2909	2692	217	7.5
CN3117500000000	31	175	Valley County, NE	2003	NA	2601	2513	88	3.4
CN3117700000000	31	177	Washington County, NE	2003	NA	11110	10766	344	3.1
CN3117900000000	31	179	Wayne County, NE	2003	NA	5475	5318	157	2.9
CN3118100000000	31	181	Webster County, NE	2003	NA	2046	1973	73	3.6
CN3118300000000	31	183	Wheeler County, NE	2003	NA	499	485	14	2.8
CN3118500000000	31	185	York County, NE	2003	NA	7883	7622	261	3.3
CN3200100000000	32	001	Churchill County, NV	2003	NA	12163	11606	557	4.6
CN3200300000000	32	003	Clark County, NV	2003	NA	801220	759476	41744	5.2
CN3200500000000	32	005	Douglas County, NV	2003	NA	22070	20993	1077	4.9
CN3200700000000	32	007	Elko County, NV	2003	NA	22799	21780	1019	4.5
CN3200900000000	32	009	Esmeralda County, NV	2003	NA	468	448	20	4.3
CN3201100000000	32	011	Eureka County, NV	2003	NA	705	667	38	5.4
CN3201300000000	32	013	Humboldt County, NV	2003	NA	7406	7047	359	4.8
CN3201500000000	32	015	Lander County, NV	2003	NA	2456	2330	126	5.1
CN3201700000000	32	017	Lincoln County, NV	2003	NA	1595	1512	83	5.2
CN3201900000000	32	019	Lyon County, NV	2003	NA	19946	18851	1095	5.5
CN3202100000000	32	021	Mineral County, NV	2003	NA	2138	2016	122	5.7
CN3202300000000	32	023	Nye County, NV	2003	NA	14967	13879	1088	7.3
CN3202700000000	32	027	Pershing County, NV	2003	NA	2529	2404	125	4.9
CN3202900000000	32	029	Storey County, NV	2003	NA	1991	1924	67	3.4
CN3203100000000	32	031	Washoe County, NV	2003	NA	203657	194591	9066	4.5
CN3203300000000	32	033	White Pine County, NV	2003	NA	3691	3545	146	4
CN3251000000000	32	510	Carson City, NV	2003	NA	27242	25721	1521	5.6
CN3300100000000	33	001	Belknap County, NH	2003	NA	31544	30323	1221	3.9
CN3300300000000	33	003	Carroll County, NH	2003	NA	24407	23544	863	3.5
CN3300500000000	33	005	Cheshire County, NH	2003	NA	40090	38673	1417	3.5
CN3300700000000	33	007	Coos County, NH	2003	NA	16511	15656	855	5.2
CN3300900000000	33	009	Grafton County, NH	2003	NA	45671	44295	1376	3
CN3301100000000	33	011	Hillsborough County, NH	2003	NA	219658	209646	10012	4.6
CN3301300000000	33	013	Merrimack County, NH	2003	NA	77336	74603	2733	3.5
CN3301500000000	33	015	Rockingham County, NH	2003	NA	166414	157694	8720	5.2
CN3301700000000	33	017	Strafford County, NH	2003	NA	64896	62327	2569	4
CN3301900000000	33	019	Sullivan County, NH	2003	NA	20994	20269	725	3.5
CN3400100000000	34	001	Atlantic County, NJ	2003	NA	132292	124072	8220	6.2
CN3400300000000	34	003	Bergen County, NJ	2003	NA	463347	439897	23450	5.1
CN3400500000000	34	005	Burlington County, NJ	2003	NA	230703	219602	11101	4.8
CN3400700000000	34	007	Camden County, NJ	2003	NA	256605	241129	15476	6
CN3400900000000	34	009	Cape May County, NJ	2003	NA	55722	51250	4472	8
CN3401100000000	34	011	Cumberland County, NJ	2003	NA	66586	61344	5242	7.9
CN3401300000000	34	013	Essex County, NJ	2003	NA	367727	341078	26649	7.2
CN3401500000000	34	015	Gloucester County, NJ	2003	NA	140946	133355	7591	5.4
CN3401700000000	34	017	Hudson County, NJ	2003	NA	291065	269663	21402	7.4
CN3401900000000	34	019	Hunterdon County, NJ	2003	NA	70296	67293	3003	4.3
CN3402100000000	34	021	Mercer County, NJ	2003	NA	186864	177229	9635	5.2
CN3402300000000	34	023	Middlesex County, NJ	2003	NA	409562	386982	22580	5.5
CN3402500000000	34	025	Monmouth County, NJ	2003	NA	322552	305095	17457	5.4
CN3402700000000	34	027	Morris County, NJ	2003	NA	265061	252952	12109	4.6
CN3402900000000	34	029	Ocean County, NJ	2003	NA	244048	229840	14208	5.8
CN3403100000000	34	031	Passaic County, NJ	2003	NA	235805	218576	17229	7.3
CN3403300000000	34	033	Salem County, NJ	2003	NA	30307	28490	1817	6
CN3403500000000	34	035	Somerset County, NJ	2003	NA	170535	162699	7836	4.6
CN3403700000000	34	037	Sussex County, NJ	2003	NA	82395	78133	4262	5.2
CN3403900000000	34	039	Union County, NJ	2003	NA	267073	250237	16836	6.3
CN3404100000000	34	041	Warren County, NJ	2003	NA	57664	54772	2892	5
CN3500100000000	35	001	Bernalillo County, NM	2003	NA	296480	280961	15519	5.2
CN3500300000000	35	003	Catron County, NM	2003	NA	1487	1375	112	7.5
CN3500500000000	35	005	Chaves County, NM	2003	NA	25859	23966	1893	7.3
CN3500600000000	35	006	Cibola County, NM	2003	NA	11852	11114	738	6.2
CN3500700000000	35	007	Colfax County, NM	2003	NA	7165	6718	447	6.2
CN3500900000000	35	009	Curry County, NM	2003	NA	20001	19112	889	4.4
CN3501100000000	35	011	De Baca County, NM	2003	NA	905	833	72	8
CN3501300000000	35	013	Dona Ana County, NM	2003	NA	81929	76633	5296	6.5
CN3501500000000	35	015	Eddy County, NM	2003	NA	24205	22767	1438	5.9
CN3501700000000	35	017	Grant County, NM	2003	NA	11934	10718	1216	10.2
CN3501900000000	35	019	Guadalupe County, NM	2003	NA	1671	1541	130	7.8
CN3502100000000	35	021	Harding County, NM	2003	NA	437	413	24	5.5
CN3502300000000	35	023	Hidalgo County, NM	2003	NA	2392	2270	122	5.1
CN3502500000000	35	025	Lea County, NM	2003	NA	23972	22718	1254	5.2
CN3502700000000	35	027	Lincoln County, NM	2003	NA	10867	10402	465	4.3
CN3502800000000	35	028	Los Alamos County, NM	2003	NA	11331	11028	303	2.7
CN3502900000000	35	029	Luna County, NM	2003	NA	12128	10196	1932	15.9
CN3503100000000	35	031	McKinley County, NM	2003	NA	26445	24630	1815	6.9
CN3503300000000	35	033	Mora County, NM	2003	NA	2113	1886	227	10.7
CN3503500000000	35	035	Otero County, NM	2003	NA	25474	23932	1542	6.1
CN3503700000000	35	037	Quay County, NM	2003	NA	3973	3712	261	6.6
CN3503900000000	35	039	Rio Arriba County, NM	2003	NA	20270	18920	1350	6.7
CN3504100000000	35	041	Roosevelt County, NM	2003	NA	9382	9010	372	4
CN3504300000000	35	043	Sandoval County, NM	2003	NA	46855	44021	2834	6
CN3504500000000	35	045	San Juan County, NM	2003	NA	51719	48244	3475	6.7
CN3504700000000	35	047	San Miguel County, NM	2003	NA	13618	12761	857	6.3
CN3504900000000	35	049	Santa Fe County, NM	2003	NA	73907	70728	3179	4.3
CN3505100000000	35	051	Sierra County, NM	2003	NA	5338	5043	295	5.5
CN3505300000000	35	053	Socorro County, NM	2003	NA	8761	8321	440	5
CN3505500000000	35	055	Taos County, NM	2003	NA	17251	15998	1253	7.3
CN3505700000000	35	057	Torrance County, NM	2003	NA	7490	7072	418	5.6
CN3505900000000	35	059	Union County, NM	2003	NA	2009	1932	77	3.8
CN3506100000000	35	061	Valencia County, NM	2003	NA	30518	28696	1822	6
CN3600100000000	36	001	Albany County, NY	2003	NA	157860	151200	6660	4.2
CN3600300000000	36	003	Allegany County, NY	2003	NA	23399	21881	1518	6.5
CN3600500000000	36	005	Bronx County, NY	2003	NA	497689	444901	52788	10.6
CN3600700000000	36	007	Broome County, NY	2003	NA	96722	91138	5584	5.8
CN3600900000000	36	009	Cattaraugus County, NY	2003	NA	42157	39725	2432	5.8
CN3601100000000	36	011	Cayuga County, NY	2003	NA	41387	39221	2166	5.2
CN3601300000000	36	013	Chautauqua County, NY	2003	NA	66735	62909	3826	5.7
CN3601500000000	36	015	Chemung County, NY	2003	NA	41187	38550	2637	6.4
CN3601700000000	36	017	Chenango County, NY	2003	NA	24219	22820	1399	5.8
CN3601900000000	36	019	Clinton County, NY	2003	NA	39878	37484	2394	6
CN3602100000000	36	021	Columbia County, NY	2003	NA	31337	29975	1362	4.3
CN3602300000000	36	023	Cortland County, NY	2003	NA	24375	22951	1424	5.8
CN3602500000000	36	025	Delaware County, NY	2003	NA	23012	21909	1103	4.8
CN3602700000000	36	027	Dutchess County, NY	2003	NA	143707	137820	5887	4.1
CN3602900000000	36	029	Erie County, NY	2003	NA	470115	443315	26800	5.7
CN3603100000000	36	031	Essex County, NY	2003	NA	18349	17389	960	5.2
CN3603300000000	36	033	Franklin County, NY	2003	NA	22398	20917	1481	6.6
CN3603500000000	36	035	Fulton County, NY	2003	NA	26513	25002	1511	5.7
CN3603700000000	36	037	Genesee County, NY	2003	NA	33154	31345	1809	5.5
CN3603900000000	36	039	Greene County, NY	2003	NA	23727	22519	1208	5.1
CN3604100000000	36	041	Hamilton County, NY	2003	NA	2952	2794	158	5.4
CN3604300000000	36	043	Herkimer County, NY	2003	NA	31369	29595	1774	5.7
CN3604500000000	36	045	Jefferson County, NY	2003	NA	45949	42837	3112	6.8
CN3604700000000	36	047	Kings County, NY	2003	NA	1041574	946939	94635	9.1
CN3604900000000	36	049	Lewis County, NY	2003	NA	12435	11639	796	6.4
CN3605100000000	36	051	Livingston County, NY	2003	NA	32663	30709	1954	6
CN3605300000000	36	053	Madison County, NY	2003	NA	35519	33550	1969	5.5
CN3605500000000	36	055	Monroe County, NY	2003	NA	374026	353621	20405	5.5
CN3605700000000	36	057	Montgomery County, NY	2003	NA	24006	22476	1530	6.4
CN3605900000000	36	059	Nassau County, NY	2003	NA	681398	649939	31459	4.6
CN3606100000000	36	061	New York County, NY	2003	NA	867301	802107	65194	7.5
CN3606300000000	36	063	Niagara County, NY	2003	NA	111316	104007	7309	6.6
CN3606500000000	36	065	Oneida County, NY	2003	NA	110669	104703	5966	5.4
CN3606700000000	36	067	Onondaga County, NY	2003	NA	231168	219486	11682	5.1
CN3606900000000	36	069	Ontario County, NY	2003	NA	55127	52287	2840	5.2
CN3607100000000	36	071	Orange County, NY	2003	NA	172258	164197	8061	4.7
CN3607300000000	36	073	Orleans County, NY	2003	NA	19920	18543	1377	6.9
CN3607500000000	36	075	Oswego County, NY	2003	NA	59880	55518	4362	7.3
CN3607700000000	36	077	Otsego County, NY	2003	NA	31024	29528	1496	4.8
CN3607900000000	36	079	Putnam County, NY	2003	NA	54374	52196	2178	4
CN3608100000000	36	081	Queens County, NY	2003	NA	1054959	976778	78181	7.4
CN3608300000000	36	083	Rensselaer County, NY	2003	NA	82105	78326	3779	4.6
CN3608500000000	36	085	Richmond County, NY	2003	NA	221855	205235	16620	7.5
CN3608700000000	36	087	Rockland County, NY	2003	NA	148401	141503	6898	4.6
CN3608900000000	36	089	St. Lawrence County, NY	2003	NA	49310	45857	3453	7
CN3609100000000	36	091	Saratoga County, NY	2003	NA	116292	111699	4593	3.9
CN3609300000000	36	093	Schenectady County, NY	2003	NA	73783	70480	3303	4.5
CN3609500000000	36	095	Schoharie County, NY	2003	NA	15464	14644	820	5.3
CN3609700000000	36	097	Schuyler County, NY	2003	NA	9782	9154	628	6.4
CN3609900000000	36	099	Seneca County, NY	2003	NA	17178	16253	925	5.4
CN3610100000000	36	101	Steuben County, NY	2003	NA	44926	41653	3273	7.3
CN3610300000000	36	103	Suffolk County, NY	2003	NA	760943	724648	36295	4.8
CN3610500000000	36	105	Sullivan County, NY	2003	NA	34390	32597	1793	5.2
CN3610700000000	36	107	Tioga County, NY	2003	NA	26318	24842	1476	5.6
CN3610900000000	36	109	Tompkins County, NY	2003	NA	53288	51200	2088	3.9
CN3611100000000	36	111	Ulster County, NY	2003	NA	91397	87246	4151	4.5
CN3611300000000	36	113	Warren County, NY	2003	NA	34478	32729	1749	5.1
CN3611500000000	36	115	Washington County, NY	2003	NA	30963	29561	1402	4.5
CN3611700000000	36	117	Wayne County, NY	2003	NA	48701	45823	2878	5.9
CN3611900000000	36	119	Westchester County, NY	2003	NA	472045	450950	21095	4.5
CN3612100000000	36	121	Wyoming County, NY	2003	NA	21091	19821	1270	6
CN3612300000000	36	123	Yates County, NY	2003	NA	12886	12270	616	4.8
CN3700100000000	37	001	Alamance County, NC	2003	NA	70121	65118	5003	7.1
CN3700300000000	37	003	Alexander County, NC	2003	NA	18578	17268	1310	7.1
CN3700500000000	37	005	Alleghany County, NC	2003	NA	4908	4457	451	9.2
CN3700700000000	37	007	Anson County, NC	2003	NA	10984	9944	1040	9.5
CN3700900000000	37	009	Ashe County, NC	2003	NA	12877	12019	858	6.7
CN3701100000000	37	011	Avery County, NC	2003	NA	8053	7588	465	5.8
CN3701300000000	37	013	Beaufort County, NC	2003	NA	20130	18416	1714	8.5
CN3701500000000	37	015	Bertie County, NC	2003	NA	8488	7869	619	7.3
CN3701700000000	37	017	Bladen County, NC	2003	NA	15053	13797	1256	8.3
CN3701900000000	37	019	Brunswick County, NC	2003	NA	39245	36750	2495	6.4
CN3702100000000	37	021	Buncombe County, NC	2003	NA	113491	108150	5341	4.7
CN3702300000000	37	023	Burke County, NC	2003	NA	43047	39721	3326	7.7
CN3702500000000	37	025	Cabarrus County, NC	2003	NA	77743	72104	5639	7.3
CN3702700000000	37	027	Caldwell County, NC	2003	NA	40599	37178	3421	8.4
CN3702900000000	37	029	Camden County, NC	2003	NA	3882	3724	158	4.1
CN3703100000000	37	031	Carteret County, NC	2003	NA	31306	29655	1651	5.3
CN3703300000000	37	033	Caswell County, NC	2003	NA	10871	9928	943	8.7
CN3703500000000	37	035	Catawba County, NC	2003	NA	77740	71634	6106	7.9
CN3703700000000	37	037	Chatham County, NC	2003	NA	29502	27997	1505	5.1
CN3703900000000	37	039	Cherokee County, NC	2003	NA	9842	9042	800	8.1
CN3704100000000	37	041	Chowan County, NC	2003	NA	6849	6493	356	5.2
CN3704300000000	37	043	Clay County, NC	2003	NA	4198	3996	202	4.8
CN3704500000000	37	045	Cleveland County, NC	2003	NA	48134	44016	4118	8.6
CN3704700000000	37	047	Columbus County, NC	2003	NA	23487	21648	1839	7.8
CN3704900000000	37	049	Craven County, NC	2003	NA	40097	37822	2275	5.7
CN3705100000000	37	051	Cumberland County, NC	2003	NA	122697	115103	7594	6.2
CN3705300000000	37	053	Currituck County, NC	2003	NA	10737	10396	341	3.2
CN3705500000000	37	055	Dare County, NC	2003	NA	21818	20721	1097	5
CN3705700000000	37	057	Davidson County, NC	2003	NA	79379	73714	5665	7.1
CN3705900000000	37	059	Davie County, NC	2003	NA	19368	18195	1173	6.1
CN3706100000000	37	061	Duplin County, NC	2003	NA	24366	22729	1637	6.7
CN3706300000000	37	063	Durham County, NC	2003	NA	127158	120142	7016	5.5
CN3706500000000	37	065	Edgecombe County, NC	2003	NA	25090	22631	2459	9.8
CN3706700000000	37	067	Forsyth County, NC	2003	NA	166347	157185	9162	5.5
CN3706900000000	37	069	Franklin County, NC	2003	NA	25568	23989	1579	6.2
CN3707100000000	37	071	Gaston County, NC	2003	NA	98527	91427	7100	7.2
CN3707300000000	37	073	Gates County, NC	2003	NA	4839	4640	199	4.1
CN3707500000000	37	075	Graham County, NC	2003	NA	3878	3557	321	8.3
CN3707700000000	37	077	Granville County, NC	2003	NA	24346	22472	1874	7.7
CN3707900000000	37	079	Greene County, NC	2003	NA	8896	8305	591	6.6
CN3708100000000	37	081	Guilford County, NC	2003	NA	238775	224234	14541	6.1
CN3708300000000	37	083	Halifax County, NC	2003	NA	23343	21361	1982	8.5
CN3708500000000	37	085	Harnett County, NC	2003	NA	43835	40993	2842	6.5
CN3708700000000	37	087	Haywood County, NC	2003	NA	27176	25748	1428	5.3
CN3708900000000	37	089	Henderson County, NC	2003	NA	45370	43168	2202	4.9
CN3709100000000	37	091	Hertford County, NC	2003	NA	9728	9139	589	6.1
CN3709300000000	37	093	Hoke County, NC	2003	NA	16231	15027	1204	7.4
CN3709500000000	37	095	Hyde County, NC	2003	NA	2848	2638	210	7.4
CN3709700000000	37	097	Iredell County, NC	2003	NA	69316	64858	4458	6.4
CN3709900000000	37	099	Jackson County, NC	2003	NA	19797	18838	959	4.8
CN3710100000000	37	101	Johnston County, NC	2003	NA	67607	64022	3585	5.3
CN3710300000000	37	103	Jones County, NC	2003	NA	4731	4468	263	5.6
CN3710500000000	37	105	Lee County, NC	2003	NA	25341	23529	1812	7.2
CN3710700000000	37	107	Lenoir County, NC	2003	NA	27178	25174	2004	7.4
CN3710900000000	37	109	Lincoln County, NC	2003	NA	36013	33513	2500	6.9
CN3711100000000	37	111	McDowell County, NC	2003	NA	21684	20125	1559	7.2
CN3711300000000	37	113	Macon County, NC	2003	NA	15405	14650	755	4.9
CN3711500000000	37	115	Madison County, NC	2003	NA	9697	9196	501	5.2
CN3711700000000	37	117	Martin County, NC	2003	NA	12223	11356	867	7.1
CN3711900000000	37	119	Mecklenburg County, NC	2003	NA	418025	393995	24030	5.7
CN3712100000000	37	121	Mitchell County, NC	2003	NA	7709	7109	600	7.8
CN3712300000000	37	123	Montgomery County, NC	2003	NA	12538	11435	1103	8.8
CN3712500000000	37	125	Moore County, NC	2003	NA	35532	33254	2278	6.4
CN3712700000000	37	127	Nash County, NC	2003	NA	44358	41195	3163	7.1
CN3712900000000	37	129	New Hanover County, NC	2003	NA	92071	86890	5181	5.6
CN3713100000000	37	131	Northampton County, NC	2003	NA	8850	8151	699	7.9
CN3713300000000	37	133	Onslow County, NC	2003	NA	53864	50408	3456	6.4
CN3713500000000	37	135	Orange County, NC	2003	NA	64347	61616	2731	4.2
CN3713700000000	37	137	Pamlico County, NC	2003	NA	5573	5268	305	5.5
CN3713900000000	37	139	Pasquotank County, NC	2003	NA	16435	15600	835	5.1
CN3714100000000	37	141	Pender County, NC	2003	NA	20700	19337	1363	6.6
CN3714300000000	37	143	Perquimans County, NC	2003	NA	5013	4760	253	5
CN3714500000000	37	145	Person County, NC	2003	NA	18637	17216	1421	7.6
CN3714700000000	37	147	Pitt County, NC	2003	NA	71610	67005	4605	6.4
CN3714900000000	37	149	Polk County, NC	2003	NA	8916	8495	421	4.7
CN3715100000000	37	151	Randolph County, NC	2003	NA	74226	69651	4575	6.2
CN3715300000000	37	153	Richmond County, NC	2003	NA	20437	18446	1991	9.7
CN3715500000000	37	155	Robeson County, NC	2003	NA	52391	47960	4431	8.5
CN3715700000000	37	157	Rockingham County, NC	2003	NA	46934	42804	4130	8.8
CN3715900000000	37	159	Rowan County, NC	2003	NA	67700	62600	5100	7.5
CN3716100000000	37	161	Rutherford County, NC	2003	NA	31487	28813	2674	8.5
CN3716300000000	37	163	Sampson County, NC	2003	NA	31165	29387	1778	5.7
CN3716500000000	37	165	Scotland County, NC	2003	NA	16231	14391	1840	11.3
CN3716700000000	37	167	Stanly County, NC	2003	NA	29720	27585	2135	7.2
CN3716900000000	37	169	Stokes County, NC	2003	NA	24040	22596	1444	6
CN3717100000000	37	171	Surry County, NC	2003	NA	36201	33467	2734	7.6
CN3717300000000	37	173	Swain County, NC	2003	NA	6742	6211	531	7.9
CN3717500000000	37	175	Transylvania County, NC	2003	NA	12676	11569	1107	8.7
CN3717700000000	37	177	Tyrrell County, NC	2003	NA	2143	1955	188	8.8
CN3717900000000	37	179	Union County, NC	2003	NA	76383	72447	3936	5.2
CN3718100000000	37	181	Vance County, NC	2003	NA	19949	17822	2127	10.7
CN3718300000000	37	183	Wake County, NC	2003	NA	385646	365385	20261	5.3
CN3718500000000	37	185	Warren County, NC	2003	NA	8193	7518	675	8.2
CN3718700000000	37	187	Washington County, NC	2003	NA	6189	5696	493	8
CN3718900000000	37	189	Watauga County, NC	2003	NA	22740	21749	991	4.4
CN3719100000000	37	191	Wayne County, NC	2003	NA	51591	48452	3139	6.1
CN3719300000000	37	193	Wilkes County, NC	2003	NA	33636	31181	2455	7.3
CN3719500000000	37	195	Wilson County, NC	2003	NA	38987	35836	3151	8.1
CN3719700000000	37	197	Yadkin County, NC	2003	NA	19425	18244	1181	6.1
CN3719900000000	37	199	Yancey County, NC	2003	NA	8088	7523	565	7
CN3800100000000	38	001	Adams County, ND	2003	NA	1254	1216	38	3
CN3800300000000	38	003	Barnes County, ND	2003	NA	6058	5845	213	3.5
CN3800500000000	38	005	Benson County, ND	2003	NA	2726	2575	151	5.5
CN3800700000000	38	007	Billings County, ND	2003	NA	500	485	15	3
CN3800900000000	38	009	Bottineau County, ND	2003	NA	3546	3376	170	4.8
CN3801100000000	38	011	Bowman County, ND	2003	NA	1755	1715	40	2.3
CN3801300000000	38	013	Burke County, ND	2003	NA	1019	985	34	3.3
CN3801500000000	38	015	Burleigh County, ND	2003	NA	41743	40462	1281	3.1
CN3801700000000	38	017	Cass County, ND	2003	NA	77467	75182	2285	2.9
CN3801900000000	38	019	Cavalier County, ND	2003	NA	2239	2155	84	3.8
CN3802100000000	38	021	Dickey County, ND	2003	NA	2844	2754	90	3.2
CN3802300000000	38	023	Divide County, ND	2003	NA	1079	1042	37	3.4
CN3802500000000	38	025	Dunn County, ND	2003	NA	1797	1729	68	3.8
CN3802700000000	38	027	Eddy County, ND	2003	NA	1378	1306	72	5.2
CN3802900000000	38	029	Emmons County, ND	2003	NA	2013	1897	116	5.8
CN3803100000000	38	031	Foster County, ND	2003	NA	1781	1717	64	3.6
CN3803300000000	38	033	Golden Valley County, ND	2003	NA	953	930	23	2.4
CN3803500000000	38	035	Grand Forks County, ND	2003	NA	36218	34978	1240	3.4
CN3803700000000	38	037	Grant County, ND	2003	NA	1313	1259	54	4.1
CN3803900000000	38	039	Griggs County, ND	2003	NA	1362	1321	41	3
CN3804100000000	38	041	Hettinger County, ND	2003	NA	1252	1202	50	4
CN3804300000000	38	043	Kidder County, ND	2003	NA	1243	1168	75	6
CN3804500000000	38	045	LaMoure County, ND	2003	NA	2327	2243	84	3.6
CN3804700000000	38	047	Logan County, ND	2003	NA	976	941	35	3.6
CN3804900000000	38	049	McHenry County, ND	2003	NA	2814	2625	189	6.7
CN3805100000000	38	051	McIntosh County, ND	2003	NA	1508	1459	49	3.2
CN3805300000000	38	053	McKenzie County, ND	2003	NA	2714	2609	105	3.9
CN3805500000000	38	055	McLean County, ND	2003	NA	4509	4241	268	5.9
CN3805700000000	38	057	Mercer County, ND	2003	NA	4693	4469	224	4.8
CN3805900000000	38	059	Morton County, ND	2003	NA	13916	13372	544	3.9
CN3806100000000	38	061	Mountrail County, ND	2003	NA	2979	2818	161	5.4
CN3806300000000	38	063	Nelson County, ND	2003	NA	1751	1678	73	4.2
CN3806500000000	38	065	Oliver County, ND	2003	NA	1191	1143	48	4
CN3806700000000	38	067	Pembina County, ND	2003	NA	4272	3976	296	6.9
CN3806900000000	38	069	Pierce County, ND	2003	NA	1966	1860	106	5.4
CN3807100000000	38	071	Ramsey County, ND	2003	NA	6007	5752	255	4.2
CN3807300000000	38	073	Ransom County, ND	2003	NA	2966	2874	92	3.1
CN3807500000000	38	075	Renville County, ND	2003	NA	1291	1251	40	3.1
CN3807700000000	38	077	Richland County, ND	2003	NA	9307	8965	342	3.7
CN3807900000000	38	079	Rolette County, ND	2003	NA	5337	4756	581	10.9
CN3808100000000	38	081	Sargent County, ND	2003	NA	2169	2106	63	2.9
CN3808300000000	38	083	Sheridan County, ND	2003	NA	762	721	41	5.4
CN3808500000000	38	085	Sioux County, ND	2003	NA	1341	1270	71	5.3
CN3808700000000	38	087	Slope County, ND	2003	NA	489	475	14	2.9
CN3808900000000	38	089	Stark County, ND	2003	NA	12830	12396	434	3.4
CN3809100000000	38	091	Steele County, ND	2003	NA	1145	1118	27	2.4
CN3809300000000	38	093	Stutsman County, ND	2003	NA	11460	11034	426	3.7
CN3809500000000	38	095	Towner County, ND	2003	NA	1336	1283	53	4
CN3809700000000	38	097	Traill County, ND	2003	NA	4131	3979	152	3.7
CN3809900000000	38	099	Walsh County, ND	2003	NA	6031	5774	257	4.3
CN3810100000000	38	101	Ward County, ND	2003	NA	27732	26631	1101	4
CN3810300000000	38	103	Wells County, ND	2003	NA	2285	2174	111	4.9
CN3810500000000	38	105	Williams County, ND	2003	NA	10910	10563	347	3.2
CN3900100000000	39	001	Adams County, OH	2003	NA	12613	11349	1264	10
CN3900300000000	39	003	Allen County, OH	2003	NA	52611	48956	3655	6.9
CN3900500000000	39	005	Ashland County, OH	2003	NA	27144	25230	1914	7.1
CN3900700000000	39	007	Ashtabula County, OH	2003	NA	50382	46332	4050	8
CN3900900000000	39	009	Athens County, OH	2003	NA	29664	27685	1979	6.7
CN3901100000000	39	011	Auglaize County, OH	2003	NA	25290	23949	1341	5.3
CN3901300000000	39	013	Belmont County, OH	2003	NA	31800	29586	2214	7
CN3901500000000	39	015	Brown County, OH	2003	NA	21727	20127	1600	7.4
CN3901700000000	39	017	Butler County, OH	2003	NA	181388	171343	10045	5.5
CN3901900000000	39	019	Carroll County, OH	2003	NA	14444	13293	1151	8
CN3902100000000	39	021	Champaign County, OH	2003	NA	20629	19228	1401	6.8
CN3902300000000	39	023	Clark County, OH	2003	NA	71491	66141	5350	7.5
CN3902500000000	39	025	Clermont County, OH	2003	NA	101096	95333	5763	5.7
CN3902700000000	39	027	Clinton County, OH	2003	NA	21962	20688	1274	5.8
CN3902900000000	39	029	Columbiana County, OH	2003	NA	54640	50423	4217	7.7
CN3903100000000	39	031	Coshocton County, OH	2003	NA	17918	16568	1350	7.5
CN3903300000000	39	033	Crawford County, OH	2003	NA	23113	21287	1826	7.9
CN3903500000000	39	035	Cuyahoga County, OH	2003	NA	672890	634730	38160	5.7
CN3903700000000	39	037	Darke County, OH	2003	NA	28802	26865	1937	6.7
CN3903900000000	39	039	Defiance County, OH	2003	NA	20664	19348	1316	6.4
CN3904100000000	39	041	Delaware County, OH	2003	NA	75679	72317	3362	4.4
CN3904300000000	39	043	Erie County, OH	2003	NA	43194	40477	2717	6.3
CN3904500000000	39	045	Fairfield County, OH	2003	NA	70491	66557	3934	5.6
CN3904700000000	39	047	Fayette County, OH	2003	NA	15675	14767	908	5.8
CN3904900000000	39	049	Franklin County, OH	2003	NA	602224	569021	33203	5.5
CN3905100000000	39	051	Fulton County, OH	2003	NA	22714	21175	1539	6.8
CN3905300000000	39	053	Gallia County, OH	2003	NA	14214	12991	1223	8.6
CN3905500000000	39	055	Geauga County, OH	2003	NA	50086	47832	2254	4.5
CN3905700000000	39	057	Greene County, OH	2003	NA	77289	72888	4401	5.7
CN3905900000000	39	059	Guernsey County, OH	2003	NA	20041	18487	1554	7.8
CN3906100000000	39	061	Hamilton County, OH	2003	NA	425099	401250	23849	5.6
CN3906300000000	39	063	Hancock County, OH	2003	NA	38888	36806	2082	5.4
CN3906500000000	39	065	Hardin County, OH	2003	NA	15590	14595	995	6.4
CN3906700000000	39	067	Harrison County, OH	2003	NA	7403	6827	576	7.8
CN3906900000000	39	069	Henry County, OH	2003	NA	16001	14915	1086	6.8
CN3907100000000	39	071	Highland County, OH	2003	NA	20331	18999	1332	6.6
CN3907300000000	39	073	Hocking County, OH	2003	NA	13573	12567	1006	7.4
CN3907500000000	39	075	Holmes County, OH	2003	NA	18379	17605	774	4.2
CN3907700000000	39	077	Huron County, OH	2003	NA	30317	27905	2412	8
CN3907900000000	39	079	Jackson County, OH	2003	NA	15117	13819	1298	8.6
CN3908100000000	39	081	Jefferson County, OH	2003	NA	32631	30175	2456	7.5
CN3908300000000	39	083	Knox County, OH	2003	NA	28529	26687	1842	6.5
CN3908500000000	39	085	Lake County, OH	2003	NA	130203	123491	6712	5.2
CN3908700000000	39	087	Lawrence County, OH	2003	NA	28201	26276	1925	6.8
CN3908900000000	39	089	Licking County, OH	2003	NA	80165	75174	4991	6.2
CN3909100000000	39	091	Logan County, OH	2003	NA	24473	23121	1352	5.5
CN3909300000000	39	093	Lorain County, OH	2003	NA	150844	142286	8558	5.7
CN3909500000000	39	095	Lucas County, OH	2003	NA	226158	208751	17407	7.7
CN3909700000000	39	097	Madison County, OH	2003	NA	19591	18454	1137	5.8
CN3909900000000	39	099	Mahoning County, OH	2003	NA	118721	109601	9120	7.7
CN3910100000000	39	101	Marion County, OH	2003	NA	31918	29868	2050	6.4
CN3910300000000	39	103	Medina County, OH	2003	NA	89523	85303	4220	4.7
CN3910500000000	39	105	Meigs County, OH	2003	NA	9210	8150	1060	11.5
CN3910700000000	39	107	Mercer County, OH	2003	NA	22228	21174	1054	4.7
CN3910900000000	39	109	Miami County, OH	2003	NA	54645	51292	3353	6.1
CN3911100000000	39	111	Monroe County, OH	2003	NA	6090	5570	520	8.5
CN3911300000000	39	113	Montgomery County, OH	2003	NA	276809	258382	18427	6.7
CN3911500000000	39	115	Morgan County, OH	2003	NA	6542	5869	673	10.3
CN3911700000000	39	117	Morrow County, OH	2003	NA	17413	16298	1115	6.4
CN3911900000000	39	119	Muskingum County, OH	2003	NA	41946	38734	3212	7.7
CN3912100000000	39	121	Noble County, OH	2003	NA	5873	5351	522	8.9
CN3912300000000	39	123	Ottawa County, OH	2003	NA	21537	19737	1800	8.4
CN3912500000000	39	125	Paulding County, OH	2003	NA	10464	9783	681	6.5
CN3912700000000	39	127	Perry County, OH	2003	NA	16684	15321	1363	8.2
CN3912900000000	39	129	Pickaway County, OH	2003	NA	23574	21960	1614	6.8
CN3913100000000	39	131	Pike County, OH	2003	NA	11451	10244	1207	10.5
CN3913300000000	39	133	Portage County, OH	2003	NA	86956	81739	5217	6
CN3913500000000	39	135	Preble County, OH	2003	NA	22008	20631	1377	6.3
CN3913700000000	39	137	Putnam County, OH	2003	NA	18054	16865	1189	6.6
CN3913900000000	39	139	Richland County, OH	2003	NA	64277	59496	4781	7.4
CN3914100000000	39	141	Ross County, OH	2003	NA	34441	31735	2706	7.9
CN3914300000000	39	143	Sandusky County, OH	2003	NA	33110	30881	2229	6.7
CN3914500000000	39	145	Scioto County, OH	2003	NA	32683	29751	2932	9
CN3914700000000	39	147	Seneca County, OH	2003	NA	31017	28953	2064	6.7
CN3914900000000	39	149	Shelby County, OH	2003	NA	26658	25141	1517	5.7
CN3915100000000	39	151	Stark County, OH	2003	NA	191959	178584	13375	7
CN3915300000000	39	153	Summit County, OH	2003	NA	284960	266835	18125	6.4
CN3915500000000	39	155	Trumbull County, OH	2003	NA	107113	98802	8311	7.8
CN3915700000000	39	157	Tuscarawas County, OH	2003	NA	47815	44746	3069	6.4
CN3915900000000	39	159	Union County, OH	2003	NA	23468	22321	1147	4.9
CN3916100000000	39	161	Van Wert County, OH	2003	NA	14767	13840	927	6.3
CN3916300000000	39	163	Vinton County, OH	2003	NA	5635	5100	535	9.5
CN3916500000000	39	165	Warren County, OH	2003	NA	96105	91178	4927	5.1
CN3916700000000	39	167	Washington County, OH	2003	NA	33362	31232	2130	6.4
CN3916900000000	39	169	Wayne County, OH	2003	NA	60256	57084	3172	5.3
CN3917100000000	39	171	Williams County, OH	2003	NA	19880	18483	1397	7
CN3917300000000	39	173	Wood County, OH	2003	NA	66423	62475	3948	5.9
CN3917500000000	39	175	Wyandot County, OH	2003	NA	13430	12673	757	5.6
CN4000100000000	40	001	Adair County, OK	2003	NA	9789	9027	762	7.8
CN4000300000000	40	003	Alfalfa County, OK	2003	NA	2564	2463	101	3.9
CN4000500000000	40	005	Atoka County, OK	2003	NA	5651	5252	399	7.1
CN4000700000000	40	007	Beaver County, OK	2003	NA	3015	2900	115	3.8
CN4000900000000	40	009	Beckham County, OK	2003	NA	9242	8899	343	3.7
CN4001100000000	40	011	Blaine County, OK	2003	NA	4787	4555	232	4.8
CN4001300000000	40	013	Bryan County, OK	2003	NA	18029	17206	823	4.6
CN4001500000000	40	015	Caddo County, OK	2003	NA	12477	11816	661	5.3
CN4001700000000	40	017	Canadian County, OK	2003	NA	48460	46206	2254	4.7
CN4001900000000	40	019	Carter County, OK	2003	NA	22832	21745	1087	4.8
CN4002100000000	40	021	Cherokee County, OK	2003	NA	20065	19003	1062	5.3
CN4002300000000	40	023	Choctaw County, OK	2003	NA	6460	5965	495	7.7
CN4002500000000	40	025	Cimarron County, OK	2003	NA	1537	1481	56	3.6
CN4002700000000	40	027	Cleveland County, OK	2003	NA	114921	110168	4753	4.1
CN4002900000000	40	029	Coal County, OK	2003	NA	2483	2183	300	12.1
CN4003100000000	40	031	Comanche County, OK	2003	NA	45139	43219	1920	4.3
CN4003300000000	40	033	Cotton County, OK	2003	NA	3073	2936	137	4.5
CN4003500000000	40	035	Craig County, OK	2003	NA	6681	6309	372	5.6
CN4003700000000	40	037	Creek County, OK	2003	NA	32027	29898	2129	6.6
CN4003900000000	40	039	Custer County, OK	2003	NA	13104	12632	472	3.6
CN4004100000000	40	041	Delaware County, OK	2003	NA	16817	15865	952	5.7
CN4004300000000	40	043	Dewey County, OK	2003	NA	2445	2357	88	3.6
CN4004500000000	40	045	Ellis County, OK	2003	NA	2213	2148	65	2.9
CN4004700000000	40	047	Garfield County, OK	2003	NA	27446	26317	1129	4.1
CN4004900000000	40	049	Garvin County, OK	2003	NA	13149	12509	640	4.9
CN4005100000000	40	051	Grady County, OK	2003	NA	22442	21374	1068	4.8
CN4005300000000	40	053	Grant County, OK	2003	NA	2617	2521	96	3.7
CN4005500000000	40	055	Greer County, OK	2003	NA	2306	2151	155	6.7
CN4005700000000	40	057	Harmon County, OK	2003	NA	1439	1382	57	4
CN4005900000000	40	059	Harper County, OK	2003	NA	1983	1913	70	3.5
CN4006100000000	40	061	Haskell County, OK	2003	NA	5616	5249	367	6.5
CN4006300000000	40	063	Hughes County, OK	2003	NA	5364	4865	499	9.3
CN4006500000000	40	065	Jackson County, OK	2003	NA	12632	12165	467	3.7
CN4006700000000	40	067	Jefferson County, OK	2003	NA	2483	2327	156	6.3
CN4006900000000	40	069	Johnston County, OK	2003	NA	4888	4632	256	5.2
CN4007100000000	40	071	Kay County, OK	2003	NA	21959	20488	1471	6.7
CN4007300000000	40	073	Kingfisher County, OK	2003	NA	7391	7147	244	3.3
CN4007500000000	40	075	Kiowa County, OK	2003	NA	4479	4263	216	4.8
CN4007700000000	40	077	Latimer County, OK	2003	NA	4085	3815	270	6.6
CN4007900000000	40	079	Le Flore County, OK	2003	NA	21356	19966	1390	6.5
CN4008100000000	40	081	Lincoln County, OK	2003	NA	14745	13964	781	5.3
CN4008300000000	40	083	Logan County, OK	2003	NA	17498	16750	748	4.3
CN4008500000000	40	085	Love County, OK	2003	NA	4596	4372	224	4.9
CN4008700000000	40	087	McClain County, OK	2003	NA	14041	13378	663	4.7
CN4008900000000	40	089	McCurtain County, OK	2003	NA	14739	13423	1316	8.9
CN4009100000000	40	091	McIntosh County, OK	2003	NA	8245	7627	618	7.5
CN4009300000000	40	093	Major County, OK	2003	NA	3843	3708	135	3.5
CN4009500000000	40	095	Marshall County, OK	2003	NA	5925	5636	289	4.9
CN4009700000000	40	097	Mayes County, OK	2003	NA	16491	15263	1228	7.4
CN4009900000000	40	099	Murray County, OK	2003	NA	6053	5743	310	5.1
CN4010100000000	40	101	Muskogee County, OK	2003	NA	28927	26868	2059	7.1
CN4010300000000	40	103	Noble County, OK	2003	NA	5288	5060	228	4.3
CN4010500000000	40	105	Nowata County, OK	2003	NA	4937	4635	302	6.1
CN4010700000000	40	107	Okfuskee County, OK	2003	NA	4658	4278	380	8.2
CN4010900000000	40	109	Oklahoma County, OK	2003	NA	330607	312633	17974	5.4
CN4011100000000	40	111	Okmulgee County, OK	2003	NA	16876	15581	1295	7.7
CN4011300000000	40	113	Osage County, OK	2003	NA	20684	19421	1263	6.1
CN4011500000000	40	115	Ottawa County, OK	2003	NA	15119	14014	1105	7.3
CN4011700000000	40	117	Pawnee County, OK	2003	NA	7853	7325	528	6.7
CN4011900000000	40	119	Payne County, OK	2003	NA	34808	33393	1415	4.1
CN4012100000000	40	121	Pittsburg County, OK	2003	NA	19488	18255	1233	6.3
CN4012300000000	40	123	Pontotoc County, OK	2003	NA	17894	17004	890	5
CN4012500000000	40	125	Pottawatomie County, OK	2003	NA	30090	28376	1714	5.7
CN4012700000000	40	127	Pushmataha County, OK	2003	NA	5235	4853	382	7.3
CN4012900000000	40	129	Roger Mills County, OK	2003	NA	1949	1897	52	2.7
CN4013100000000	40	131	Rogers County, OK	2003	NA	38305	36151	2154	5.6
CN4013300000000	40	133	Seminole County, OK	2003	NA	10600	9664	936	8.8
CN4013500000000	40	135	Sequoyah County, OK	2003	NA	17876	16694	1182	6.6
CN4013700000000	40	137	Stephens County, OK	2003	NA	19631	18645	986	5
CN4013900000000	40	139	Texas County, OK	2003	NA	10447	10088	359	3.4
CN4014100000000	40	141	Tillman County, OK	2003	NA	3765	3595	170	4.5
CN4014300000000	40	143	Tulsa County, OK	2003	NA	293867	276855	17012	5.8
CN4014500000000	40	145	Wagoner County, OK	2003	NA	30818	29150	1668	5.4
CN4014700000000	40	147	Washington County, OK	2003	NA	24027	22781	1246	5.2
CN4014900000000	40	149	Washita County, OK	2003	NA	5875	5660	215	3.7
CN4015100000000	40	151	Woods County, OK	2003	NA	4740	4296	444	9.4
CN4015300000000	40	153	Woodward County, OK	2003	NA	9590	9171	419	4.4
CN4100100000000	41	001	Baker County, OR	2003	NA	7319	6626	693	9.5
CN4100300000000	41	003	Benton County, OR	2003	NA	42214	39771	2443	5.8
CN4100500000000	41	005	Clackamas County, OR	2003	NA	188891	174728	14163	7.5
CN4100700000000	41	007	Clatsop County, OR	2003	NA	18450	17070	1380	7.5
CN4100900000000	41	009	Columbia County, OR	2003	NA	23176	20777	2399	10.4
CN4101100000000	41	011	Coos County, OR	2003	NA	27921	25360	2561	9.2
CN4101300000000	41	013	Crook County, OR	2003	NA	8839	7987	852	9.6
CN4101500000000	41	015	Curry County, OR	2003	NA	9245	8468	777	8.4
CN4101700000000	41	017	Deschutes County, OR	2003	NA	68261	62951	5310	7.8
CN4101900000000	41	019	Douglas County, OR	2003	NA	47653	42966	4687	9.8
CN4102100000000	41	021	Gilliam County, OR	2003	NA	1041	970	71	6.8
CN4102300000000	41	023	Grant County, OR	2003	NA	3798	3403	395	10.4
CN4102500000000	41	025	Harney County, OR	2003	NA	3520	3136	384	10.9
CN4102700000000	41	027	Hood River County, OR	2003	NA	12171	11131	1040	8.5
CN4102900000000	41	029	Jackson County, OR	2003	NA	96636	89209	7427	7.7
CN4103100000000	41	031	Jefferson County, OR	2003	NA	8819	8198	621	7
CN4103300000000	41	033	Josephine County, OR	2003	NA	33481	30464	3017	9
CN4103500000000	41	035	Klamath County, OR	2003	NA	29889	26970	2919	9.8
CN4103700000000	41	037	Lake County, OR	2003	NA	3606	3259	347	9.6
CN4103900000000	41	039	Lane County, OR	2003	NA	172432	158631	13801	8
CN4104100000000	41	041	Lincoln County, OR	2003	NA	21690	19744	1946	9
CN4104300000000	41	043	Linn County, OR	2003	NA	52496	47209	5287	10.1
CN4104500000000	41	045	Malheur County, OR	2003	NA	13249	11955	1294	9.8
CN4104700000000	41	047	Marion County, OR	2003	NA	148494	136675	11819	8
CN4104900000000	41	049	Morrow County, OR	2003	NA	5753	5285	468	8.1
CN4105100000000	41	051	Multnomah County, OR	2003	NA	373523	342005	31518	8.4
CN4105300000000	41	053	Polk County, OR	2003	NA	34266	31926	2340	6.8
CN4105500000000	41	055	Sherman County, OR	2003	NA	947	845	102	10.8
CN4105700000000	41	057	Tillamook County, OR	2003	NA	12072	11180	892	7.4
CN4105900000000	41	059	Umatilla County, OR	2003	NA	37734	34639	3095	8.2
CN4106100000000	41	061	Union County, OR	2003	NA	12312	11408	904	7.3
CN4106300000000	41	063	Wallowa County, OR	2003	NA	3615	3262	353	9.8
CN4106500000000	41	065	Wasco County, OR	2003	NA	12837	11594	1243	9.7
CN4106700000000	41	067	Washington County, OR	2003	NA	264657	245189	19468	7.4
CN4106900000000	41	069	Wheeler County, OR	2003	NA	735	678	57	7.8
CN4107100000000	41	071	Yamhill County, OR	2003	NA	43808	40240	3568	8.1
CN4200100000000	42	001	Adams County, PA	2003	NA	51479	49332	2147	4.2
CN4200300000000	42	003	Allegheny County, PA	2003	NA	638132	602885	35247	5.5
CN4200500000000	42	005	Armstrong County, PA	2003	NA	33375	31110	2265	6.8
CN4200700000000	42	007	Beaver County, PA	2003	NA	89915	84371	5544	6.2
CN4200900000000	42	009	Bedford County, PA	2003	NA	23730	21761	1969	8.3
CN4201100000000	42	011	Berks County, PA	2003	NA	193110	181673	11437	5.9
CN4201300000000	42	013	Blair County, PA	2003	NA	64164	60689	3475	5.4
CN4201500000000	42	015	Bradford County, PA	2003	NA	31490	29815	1675	5.3
CN4201700000000	42	017	Bucks County, PA	2003	NA	336864	321104	15760	4.7
CN4201900000000	42	019	Butler County, PA	2003	NA	93618	88374	5244	5.6
CN4202100000000	42	021	Cambria County, PA	2003	NA	66740	62090	4650	7
CN4202300000000	42	023	Cameron County, PA	2003	NA	2607	2413	194	7.4
CN4202500000000	42	025	Carbon County, PA	2003	NA	29884	27696	2188	7.3
CN4202700000000	42	027	Centre County, PA	2003	NA	70740	67666	3074	4.3
CN4202900000000	42	029	Chester County, PA	2003	NA	247448	237295	10153	4.1
CN4203100000000	42	031	Clarion County, PA	2003	NA	19748	18620	1128	5.7
CN4203300000000	42	033	Clearfield County, PA	2003	NA	41003	38047	2956	7.2
CN4203500000000	42	035	Clinton County, PA	2003	NA	18628	17295	1333	7.2
CN4203700000000	42	037	Columbia County, PA	2003	NA	32688	30500	2188	6.7
CN4203900000000	42	039	Crawford County, PA	2003	NA	41650	38802	2848	6.8
CN4204100000000	42	041	Cumberland County, PA	2003	NA	117295	112428	4867	4.1
CN4204300000000	42	043	Dauphin County, PA	2003	NA	133198	126655	6543	4.9
CN4204500000000	42	045	Delaware County, PA	2003	NA	278832	264475	14357	5.1
CN4204700000000	42	047	Elk County, PA	2003	NA	17240	16128	1112	6.5
CN4204900000000	42	049	Erie County, PA	2003	NA	138178	129079	9099	6.6
CN4205100000000	42	051	Fayette County, PA	2003	NA	65216	60226	4990	7.7
CN4205300000000	42	053	Forest County, PA	2003	NA	2235	1915	320	14.3
CN4205500000000	42	055	Franklin County, PA	2003	NA	70648	67602	3046	4.3
CN4205700000000	42	057	Fulton County, PA	2003	NA	7136	6709	427	6
CN4205900000000	42	059	Greene County, PA	2003	NA	16939	15802	1137	6.7
CN4206100000000	42	061	Huntingdon County, PA	2003	NA	21248	19616	1632	7.7
CN4206300000000	42	063	Indiana County, PA	2003	NA	43332	40679	2653	6.1
CN4206500000000	42	065	Jefferson County, PA	2003	NA	21802	20443	1359	6.2
CN4206700000000	42	067	Juniata County, PA	2003	NA	12173	11560	613	5
CN4206900000000	42	069	Lackawanna County, PA	2003	NA	103854	97754	6100	5.9
CN4207100000000	42	071	Lancaster County, PA	2003	NA	257851	247222	10629	4.1
CN4207300000000	42	073	Lawrence County, PA	2003	NA	43991	41273	2718	6.2
CN4207500000000	42	075	Lebanon County, PA	2003	NA	66870	64023	2847	4.3
CN4207700000000	42	077	Lehigh County, PA	2003	NA	167631	158147	9484	5.7
CN4207900000000	42	079	Luzerne County, PA	2003	NA	155325	145306	10019	6.5
CN4208100000000	42	081	Lycoming County, PA	2003	NA	59002	55460	3542	6
CN4208300000000	42	083	McKean County, PA	2003	NA	21596	20283	1313	6.1
CN4208500000000	42	085	Mercer County, PA	2003	NA	55697	52261	3436	6.2
CN4208700000000	42	087	Mifflin County, PA	2003	NA	22096	20605	1491	6.7
CN4208900000000	42	089	Monroe County, PA	2003	NA	74292	69908	4384	5.9
CN4209100000000	42	091	Montgomery County, PA	2003	NA	420500	401387	19113	4.5
CN4209300000000	42	093	Montour County, PA	2003	NA	8618	8214	404	4.7
CN4209500000000	42	095	Northampton County, PA	2003	NA	143850	135918	7932	5.5
CN4209700000000	42	097	Northumberland County, PA	2003	NA	45060	41993	3067	6.8
CN4209900000000	42	099	Perry County, PA	2003	NA	23858	22650	1208	5.1
CN4210100000000	42	101	Philadelphia County/city, PA	2003	NA	625101	578304	46797	7.5
CN4210300000000	42	103	Pike County, PA	2003	NA	24161	22762	1399	5.8
CN4210500000000	42	105	Potter County, PA	2003	NA	8468	7843	625	7.4
CN4210700000000	42	107	Schuylkill County, PA	2003	NA	69460	64554	4906	7.1
CN4210900000000	42	109	Snyder County, PA	2003	NA	19178	18237	941	4.9
CN4211100000000	42	111	Somerset County, PA	2003	NA	38646	36040	2606	6.7
CN4211300000000	42	113	Sullivan County, PA	2003	NA	3049	2864	185	6.1
CN4211500000000	42	115	Susquehanna County, PA	2003	NA	20698	19452	1246	6
CN4211700000000	42	117	Tioga County, PA	2003	NA	20323	19054	1269	6.2
CN4211900000000	42	119	Union County, PA	2003	NA	17375	16418	957	5.5
CN4212100000000	42	121	Venango County, PA	2003	NA	26139	24551	1588	6.1
CN4212300000000	42	123	Warren County, PA	2003	NA	21297	19969	1328	6.2
CN4212500000000	42	125	Washington County, PA	2003	NA	101301	95142	6159	6.1
CN4212700000000	42	127	Wayne County, PA	2003	NA	23624	22421	1203	5.1
CN4212900000000	42	129	Westmoreland County, PA	2003	NA	184460	173430	11030	6
CN4213100000000	42	131	Wyoming County, PA	2003	NA	14030	13189	841	6
CN4213300000000	42	133	York County, PA	2003	NA	210480	200227	10253	4.9
CN4400100000000	44	001	Bristol County, RI	2003	NA	27636	26372	1264	4.6
CN4400300000000	44	003	Kent County, RI	2003	NA	95429	90678	4751	5
CN4400500000000	44	005	Newport County, RI	2003	NA	45061	42946	2115	4.7
CN4400700000000	44	007	Providence County, RI	2003	NA	320539	301684	18855	5.9
CN4400900000000	44	009	Washington County, RI	2003	NA	71818	68887	2931	4.1
CN4500100000000	45	001	Abbeville County, SC	2003	NA	11813	10736	1077	9.1
CN4500300000000	45	003	Aiken County, SC	2003	NA	71273	67455	3818	5.4
CN4500500000000	45	005	Allendale County, SC	2003	NA	3413	3114	299	8.8
CN4500700000000	45	007	Anderson County, SC	2003	NA	81882	75857	6025	7.4
CN4500900000000	45	009	Bamberg County, SC	2003	NA	6546	6031	515	7.9
CN4501100000000	45	011	Barnwell County, SC	2003	NA	9604	8676	928	9.7
CN4501300000000	45	013	Beaufort County, SC	2003	NA	56173	53413	2760	4.9
CN4501500000000	45	015	Berkeley County, SC	2003	NA	67909	64115	3794	5.6
CN4501700000000	45	017	Calhoun County, SC	2003	NA	7055	6561	494	7
CN4501900000000	45	019	Charleston County, SC	2003	NA	159204	150548	8656	5.4
CN4502100000000	45	021	Cherokee County, SC	2003	NA	24451	22276	2175	8.9
CN4502300000000	45	023	Chester County, SC	2003	NA	15752	13982	1770	11.2
CN4502500000000	45	025	Chesterfield County, SC	2003	NA	18814	16902	1912	10.2
CN4502700000000	45	027	Clarendon County, SC	2003	NA	12821	11683	1138	8.9
CN4502900000000	45	029	Colleton County, SC	2003	NA	16196	14990	1206	7.4
CN4503100000000	45	031	Darlington County, SC	2003	NA	31347	28720	2627	8.4
CN4503300000000	45	033	Dillon County, SC	2003	NA	13268	11989	1279	9.6
CN4503500000000	45	035	Dorchester County, SC	2003	NA	51237	48553	2684	5.2
CN4503700000000	45	037	Edgefield County, SC	2003	NA	10601	10058	543	5.1
CN4503900000000	45	039	Fairfield County, SC	2003	NA	11408	10173	1235	10.8
CN4504100000000	45	041	Florence County, SC	2003	NA	61236	56353	4883	8
CN4504300000000	45	043	Georgetown County, SC	2003	NA	27115	24370	2745	10.1
CN4504500000000	45	045	Greenville County, SC	2003	NA	201296	189885	11411	5.7
CN4504700000000	45	047	Greenwood County, SC	2003	NA	31962	28902	3060	9.6
CN4504900000000	45	049	Hampton County, SC	2003	NA	8056	7284	772	9.6
CN4505100000000	45	051	Horry County, SC	2003	NA	112092	105510	6582	5.9
CN4505300000000	45	053	Jasper County, SC	2003	NA	9642	9058	584	6.1
CN4505500000000	45	055	Kershaw County, SC	2003	NA	27580	25775	1805	6.5
CN4505700000000	45	057	Lancaster County, SC	2003	NA	29516	26809	2707	9.2
CN4505900000000	45	059	Laurens County, SC	2003	NA	33089	30532	2557	7.7
CN4506100000000	45	061	Lee County, SC	2003	NA	8311	7593	718	8.6
CN4506300000000	45	063	Lexington County, SC	2003	NA	120921	115244	5677	4.7
CN4506500000000	45	065	McCormick County, SC	2003	NA	3647	3178	469	12.9
CN4506700000000	45	067	Marion County, SC	2003	NA	14340	12446	1894	13.2
CN4506900000000	45	069	Marlboro County, SC	2003	NA	12685	11002	1683	13.3
CN4507100000000	45	071	Newberry County, SC	2003	NA	17796	16435	1361	7.6
CN4507300000000	45	073	Oconee County, SC	2003	NA	31987	29515	2472	7.7
CN4507500000000	45	075	Orangeburg County, SC	2003	NA	40255	36140	4115	10.2
CN4507700000000	45	077	Pickens County, SC	2003	NA	55948	52054	3894	7
CN4507900000000	45	079	Richland County, SC	2003	NA	164046	154509	9537	5.8
CN4508100000000	45	081	Saluda County, SC	2003	NA	9176	8584	592	6.5
CN4508300000000	45	083	Spartanburg County, SC	2003	NA	129838	120185	9653	7.4
CN4508500000000	45	085	Sumter County, SC	2003	NA	44868	41406	3462	7.7
CN4508700000000	45	087	Union County, SC	2003	NA	13345	11811	1534	11.5
CN4508900000000	45	089	Williamsburg County, SC	2003	NA	15621	13574	2047	13.1
CN4509100000000	45	091	York County, SC	2003	NA	92849	85786	7063	7.6
CN4600300000000	46	003	Aurora County, SD	2003	NA	1454	1400	54	3.7
CN4600500000000	46	005	Beadle County, SD	2003	NA	9073	8689	384	4.2
CN4600700000000	46	007	Bennett County, SD	2003	NA	1436	1381	55	3.8
CN4600900000000	46	009	Bon Homme County, SD	2003	NA	3424	3303	121	3.5
CN4601100000000	46	011	Brookings County, SD	2003	NA	17533	17004	529	3
CN4601300000000	46	013	Brown County, SD	2003	NA	20460	19801	659	3.2
CN4601500000000	46	015	Brule County, SD	2003	NA	2910	2831	79	2.7
CN4601700000000	46	017	Buffalo County, SD	2003	NA	551	508	43	7.8
CN4601900000000	46	019	Butte County, SD	2003	NA	5096	4922	174	3.4
CN4602100000000	46	021	Campbell County, SD	2003	NA	943	898	45	4.8
CN4602300000000	46	023	Charles Mix County, SD	2003	NA	4322	4171	151	3.5
CN4602500000000	46	025	Clark County, SD	2003	NA	1935	1833	102	5.3
CN4602700000000	46	027	Clay County, SD	2003	NA	7152	6933	219	3.1
CN4602900000000	46	029	Codington County, SD	2003	NA	15618	15001	617	4
CN4603100000000	46	031	Corson County, SD	2003	NA	1458	1368	90	6.2
CN4603300000000	46	033	Custer County, SD	2003	NA	4636	4459	177	3.8
CN4603500000000	46	035	Davison County, SD	2003	NA	10872	10549	323	3
CN4603700000000	46	037	Day County, SD	2003	NA	3111	2923	188	6
CN4603900000000	46	039	Deuel County, SD	2003	NA	2623	2515	108	4.1
CN4604100000000	46	041	Dewey County, SD	2003	NA	2692	2465	227	8.4
CN4604300000000	46	043	Douglas County, SD	2003	NA	1816	1767	49	2.7
CN4604500000000	46	045	Edmunds County, SD	2003	NA	2095	2026	69	3.3
CN4604700000000	46	047	Fall River County, SD	2003	NA	3804	3626	178	4.7
CN4604900000000	46	049	Faulk County, SD	2003	NA	1211	1172	39	3.2
CN4605100000000	46	051	Grant County, SD	2003	NA	4339	4161	178	4.1
CN4605300000000	46	053	Gregory County, SD	2003	NA	2588	2505	83	3.2
CN4605500000000	46	055	Haakon County, SD	2003	NA	1269	1238	31	2.4
CN4605700000000	46	057	Hamlin County, SD	2003	NA	2818	2708	110	3.9
CN4605900000000	46	059	Hand County, SD	2003	NA	1963	1903	60	3.1
CN4606100000000	46	061	Hanson County, SD	2003	NA	1842	1783	59	3.2
CN4606300000000	46	063	Harding County, SD	2003	NA	820	796	24	2.9
CN4606500000000	46	065	Hughes County, SD	2003	NA	9782	9519	263	2.7
CN4606700000000	46	067	Hutchinson County, SD	2003	NA	3921	3775	146	3.7
CN4606900000000	46	069	Hyde County, SD	2003	NA	854	827	27	3.2
CN4607100000000	46	071	Jackson County, SD	2003	NA	1276	1206	70	5.5
CN4607300000000	46	073	Jerauld County, SD	2003	NA	1284	1245	39	3
CN4607500000000	46	075	Jones County, SD	2003	NA	812	797	15	1.8
CN4607700000000	46	077	Kingsbury County, SD	2003	NA	3136	3021	115	3.7
CN4607900000000	46	079	Lake County, SD	2003	NA	6641	6392	249	3.7
CN4608100000000	46	081	Lawrence County, SD	2003	NA	12508	12094	414	3.3
CN4608300000000	46	083	Lincoln County, SD	2003	NA	17104	16670	434	2.5
CN4608500000000	46	085	Lyman County, SD	2003	NA	2021	1937	84	4.2
CN4608700000000	46	087	McCook County, SD	2003	NA	2962	2864	98	3.3
CN4608900000000	46	089	McPherson County, SD	2003	NA	1276	1213	63	4.9
CN4609100000000	46	091	Marshall County, SD	2003	NA	2117	2008	109	5.1
CN4609300000000	46	093	Meade County, SD	2003	NA	12626	12203	423	3.4
CN4609500000000	46	095	Mellette County, SD	2003	NA	952	903	49	5.1
CN4609700000000	46	097	Miner County, SD	2003	NA	1208	1150	58	4.8
CN4609900000000	46	099	Minnehaha County, SD	2003	NA	91822	88953	2869	3.1
CN4610100000000	46	101	Moody County, SD	2003	NA	3872	3674	198	5.1
CN4610200000000	46	102	Oglala Lakota County, SD	2003	NA	3922	3554	368	9.4
CN4610300000000	46	103	Pennington County, SD	2003	NA	51313	49644	1669	3.3
CN4610500000000	46	105	Perkins County, SD	2003	NA	1797	1739	58	3.2
CN4610700000000	46	107	Potter County, SD	2003	NA	1422	1377	45	3.2
CN4610900000000	46	109	Roberts County, SD	2003	NA	4625	4375	250	5.4
CN4611100000000	46	111	Sanborn County, SD	2003	NA	1565	1520	45	2.9
CN4611500000000	46	115	Spink County, SD	2003	NA	3405	3289	116	3.4
CN4611700000000	46	117	Stanley County, SD	2003	NA	1851	1799	52	2.8
CN4611900000000	46	119	Sully County, SD	2003	NA	1021	999	22	2.2
CN4612100000000	46	121	Todd County, SD	2003	NA	3420	3229	191	5.6
CN4612300000000	46	123	Tripp County, SD	2003	NA	3268	3157	111	3.4
CN4612500000000	46	125	Turner County, SD	2003	NA	4622	4470	152	3.3
CN4612700000000	46	127	Union County, SD	2003	NA	7475	7151	324	4.3
CN4612900000000	46	129	Walworth County, SD	2003	NA	2749	2612	137	5
CN4613500000000	46	135	Yankton County, SD	2003	NA	11654	11252	402	3.4
CN4613700000000	46	137	Ziebach County, SD	2003	NA	892	834	58	6.5
CN4700100000000	47	001	Anderson County, TN	2003	NA	34964	33130	1834	5.2
CN4700300000000	47	003	Bedford County, TN	2003	NA	21003	19576	1427	6.8
CN4700500000000	47	005	Benton County, TN	2003	NA	7020	6347	673	9.6
CN4700700000000	47	007	Bledsoe County, TN	2003	NA	5040	4663	377	7.5
CN4700900000000	47	009	Blount County, TN	2003	NA	57948	55325	2623	4.5
CN4701100000000	47	011	Bradley County, TN	2003	NA	45614	43254	2360	5.2
CN4701300000000	47	013	Campbell County, TN	2003	NA	16635	15478	1157	7
CN4701500000000	47	015	Cannon County, TN	2003	NA	6387	6066	321	5
CN4701700000000	47	017	Carroll County, TN	2003	NA	13941	12645	1296	9.3
CN4701900000000	47	019	Carter County, TN	2003	NA	28813	26987	1826	6.3
CN4702100000000	47	021	Cheatham County, TN	2003	NA	19801	18960	841	4.2
CN4702300000000	47	023	Chester County, TN	2003	NA	7422	6976	446	6
CN4702500000000	47	025	Claiborne County, TN	2003	NA	12888	12142	746	5.8
CN4702700000000	47	027	Clay County, TN	2003	NA	3877	3535	342	8.8
CN4702900000000	47	029	Cocke County, TN	2003	NA	15727	14383	1344	8.5
CN4703100000000	47	031	Coffee County, TN	2003	NA	25657	24378	1279	5
CN4703300000000	47	033	Crockett County, TN	2003	NA	7017	6386	631	9
CN4703500000000	47	035	Cumberland County, TN	2003	NA	22696	21197	1499	6.6
CN4703700000000	47	037	Davidson County, TN	2003	NA	303542	289575	13967	4.6
CN4703900000000	47	039	Decatur County, TN	2003	NA	5540	5083	457	8.2
CN4704100000000	47	041	DeKalb County, TN	2003	NA	9632	9150	482	5
CN4704300000000	47	043	Dickson County, TN	2003	NA	22543	21411	1132	5
CN4704500000000	47	045	Dyer County, TN	2003	NA	17483	16275	1208	6.9
CN4704700000000	47	047	Fayette County, TN	2003	NA	15317	14378	939	6.1
CN4704900000000	47	049	Fentress County, TN	2003	NA	7149	6582	567	7.9
CN4705100000000	47	051	Franklin County, TN	2003	NA	20400	19353	1047	5.1
CN4705300000000	47	053	Gibson County, TN	2003	NA	22065	20157	1908	8.6
CN4705500000000	47	055	Giles County, TN	2003	NA	14124	12832	1292	9.1
CN4705700000000	47	057	Grainger County, TN	2003	NA	9945	9225	720	7.2
CN4705900000000	47	059	Greene County, TN	2003	NA	32236	29814	2422	7.5
CN4706100000000	47	061	Grundy County, TN	2003	NA	5834	5472	362	6.2
CN4706300000000	47	063	Hamblen County, TN	2003	NA	29291	27495	1796	6.1
CN4706500000000	47	065	Hamilton County, TN	2003	NA	158186	151034	7152	4.5
CN4706700000000	47	067	Hancock County, TN	2003	NA	2654	2471	183	6.9
CN4706900000000	47	069	Hardeman County, TN	2003	NA	11392	10482	910	8
CN4707100000000	47	071	Hardin County, TN	2003	NA	11699	10620	1079	9.2
CN4707300000000	47	073	Hawkins County, TN	2003	NA	25807	24094	1713	6.6
CN4707500000000	47	075	Haywood County, TN	2003	NA	9652	8753	899	9.3
CN4707700000000	47	077	Henderson County, TN	2003	NA	13089	12041	1048	8
CN4707900000000	47	079	Henry County, TN	2003	NA	14563	13343	1220	8.4
CN4708100000000	47	081	Hickman County, TN	2003	NA	10027	9427	600	6
CN4708300000000	47	083	Houston County, TN	2003	NA	3729	3445	284	7.6
CN4708500000000	47	085	Humphreys County, TN	2003	NA	8917	8319	598	6.7
CN4708700000000	47	087	Jackson County, TN	2003	NA	5237	4818	419	8
CN4708900000000	47	089	Jefferson County, TN	2003	NA	23107	21677	1430	6.2
CN4709100000000	47	091	Johnson County, TN	2003	NA	6986	6381	605	8.7
CN4709300000000	47	093	Knox County, TN	2003	NA	212988	204625	8363	3.9
CN4709500000000	47	095	Lake County, TN	2003	NA	2770	2572	198	7.1
CN4709700000000	47	097	Lauderdale County, TN	2003	NA	10476	9356	1120	10.7
CN4709900000000	47	099	Lawrence County, TN	2003	NA	18828	17082	1746	9.3
CN4710100000000	47	101	Lewis County, TN	2003	NA	5407	4969	438	8.1
CN4710300000000	47	103	Lincoln County, TN	2003	NA	16116	15265	851	5.3
CN4710500000000	47	105	Loudon County, TN	2003	NA	21212	20190	1022	4.8
CN4710700000000	47	107	McMinn County, TN	2003	NA	24079	22291	1788	7.4
CN4710900000000	47	109	McNairy County, TN	2003	NA	12266	11422	844	6.9
CN4711100000000	47	111	Macon County, TN	2003	NA	10491	9759	732	7
CN4711300000000	47	113	Madison County, TN	2003	NA	46484	43715	2769	6
CN4711500000000	47	115	Marion County, TN	2003	NA	12914	12168	746	5.8
CN4711700000000	47	117	Marshall County, TN	2003	NA	13312	11998	1314	9.9
CN4711900000000	47	119	Maury County, TN	2003	NA	36888	34633	2255	6.1
CN4712100000000	47	121	Meigs County, TN	2003	NA	4846	4461	385	7.9
CN4712300000000	47	123	Monroe County, TN	2003	NA	17826	16430	1396	7.8
CN4712500000000	47	125	Montgomery County, TN	2003	NA	62703	59549	3154	5
CN4712700000000	47	127	Moore County, TN	2003	NA	3149	3030	119	3.8
CN4712900000000	47	129	Morgan County, TN	2003	NA	8140	7478	662	8.1
CN4713100000000	47	131	Obion County, TN	2003	NA	16350	15193	1157	7.1
CN4713300000000	47	133	Overton County, TN	2003	NA	9706	9091	615	6.3
CN4713500000000	47	135	Perry County, TN	2003	NA	3215	2993	222	6.9
CN4713700000000	47	137	Pickett County, TN	2003	NA	2026	1848	178	8.8
CN4713900000000	47	139	Polk County, TN	2003	NA	7399	6949	450	6.1
CN4714100000000	47	141	Putnam County, TN	2003	NA	33261	31603	1658	5
CN4714300000000	47	143	Rhea County, TN	2003	NA	13226	12437	789	6
CN4714500000000	47	145	Roane County, TN	2003	NA	25676	24277	1399	5.4
CN4714700000000	47	147	Robertson County, TN	2003	NA	30872	29281	1591	5.2
CN4714900000000	47	149	Rutherford County, TN	2003	NA	110835	105991	4844	4.4
CN4715100000000	47	151	Scott County, TN	2003	NA	8509	7681	828	9.7
CN4715300000000	47	153	Sequatchie County, TN	2003	NA	5560	5270	290	5.2
CN4715500000000	47	155	Sevier County, TN	2003	NA	43166	40607	2559	5.9
CN4715700000000	47	157	Shelby County, TN	2003	NA	438615	412494	26121	6
CN4715900000000	47	159	Smith County, TN	2003	NA	9219	8466	753	8.2
CN4716100000000	47	161	Stewart County, TN	2003	NA	5864	5468	396	6.8
CN4716300000000	47	163	Sullivan County, TN	2003	NA	74156	69943	4213	5.7
CN4716500000000	47	165	Sumner County, TN	2003	NA	73106	69687	3419	4.7
CN4716700000000	47	167	Tipton County, TN	2003	NA	26319	24632	1687	6.4
CN4716900000000	47	169	Trousdale County, TN	2003	NA	3583	3375	208	5.8
CN4717100000000	47	171	Unicoi County, TN	2003	NA	8283	7727	556	6.7
CN4717300000000	47	173	Union County, TN	2003	NA	8724	8284	440	5
CN4717500000000	47	175	Van Buren County, TN	2003	NA	2515	2326	189	7.5
CN4717700000000	47	177	Warren County, TN	2003	NA	19738	18589	1149	5.8
CN4717900000000	47	179	Washington County, TN	2003	NA	56810	53857	2953	5.2
CN4718100000000	47	181	Wayne County, TN	2003	NA	6720	6052	668	9.9
CN4718300000000	47	183	Weakley County, TN	2003	NA	16538	15184	1354	8.2
CN4718500000000	47	185	White County, TN	2003	NA	10801	9959	842	7.8
CN4718700000000	47	187	Williamson County, TN	2003	NA	75612	72878	2734	3.6
CN4718900000000	47	189	Wilson County, TN	2003	NA	52298	49871	2427	4.6
CN4800100000000	48	001	Anderson County, TX	2003	NA	20632	18992	1640	7.9
CN4800300000000	48	003	Andrews County, TX	2003	NA	6244	5901	343	5.5
CN4800500000000	48	005	Angelina County, TX	2003	NA	40274	37631	2643	6.6
CN4800700000000	48	007	Aransas County, TX	2003	NA	10740	9946	794	7.4
CN4800900000000	48	009	Archer County, TX	2003	NA	5262	5039	223	4.2
CN4801100000000	48	011	Armstrong County, TX	2003	NA	1093	1042	51	4.7
CN4801300000000	48	013	Atascosa County, TX	2003	NA	18663	17414	1249	6.7
CN4801500000000	48	015	Austin County, TX	2003	NA	12629	11849	780	6.2
CN4801700000000	48	017	Bailey County, TX	2003	NA	3645	3437	208	5.7
CN4801900000000	48	019	Bandera County, TX	2003	NA	9480	8967	513	5.4
CN4802100000000	48	021	Bastrop County, TX	2003	NA	32574	30383	2191	6.7
CN4802300000000	48	023	Baylor County, TX	2003	NA	2029	1908	121	6
CN4802500000000	48	025	Bee County, TX	2003	NA	11826	10868	958	8.1
CN4802700000000	48	027	Bell County, TX	2003	NA	108776	102007	6769	6.2
CN4802900000000	48	029	Bexar County, TX	2003	NA	697931	654692	43239	6.2
CN4803100000000	48	031	Blanco County, TX	2003	NA	4687	4459	228	4.9
CN4803300000000	48	033	Borden County, TX	2003	NA	527	504	23	4.4
CN4803500000000	48	035	Bosque County, TX	2003	NA	8280	7727	553	6.7
CN4803700000000	48	037	Bowie County, TX	2003	NA	41888	39153	2735	6.5
CN4803900000000	48	039	Brazoria County, TX	2003	NA	129263	119843	9420	7.3
CN4804100000000	48	041	Brazos County, TX	2003	NA	84869	80819	4050	4.8
CN4804300000000	48	043	Brewster County, TX	2003	NA	5112	4869	243	4.8
CN4804500000000	48	045	Briscoe County, TX	2003	NA	805	755	50	6.2
CN4804700000000	48	047	Brooks County, TX	2003	NA	3300	3031	269	8.2
CN4804900000000	48	049	Brown County, TX	2003	NA	18489	17415	1074	5.8
CN4805100000000	48	051	Burleson County, TX	2003	NA	8466	7962	504	6
CN4805300000000	48	053	Burnet County, TX	2003	NA	20188	19065	1123	5.6
CN4805500000000	48	055	Caldwell County, TX	2003	NA	15808	14649	1159	7.3
CN4805700000000	48	057	Calhoun County, TX	2003	NA	9239	8549	690	7.5
CN4805900000000	48	059	Callahan County, TX	2003	NA	6754	6393	361	5.3
CN4806100000000	48	061	Cameron County, TX	2003	NA	142105	128600	13505	9.5
CN4806300000000	48	063	Camp County, TX	2003	NA	5907	5505	402	6.8
CN4806500000000	48	065	Carson County, TX	2003	NA	3502	3336	166	4.7
CN4806700000000	48	067	Cass County, TX	2003	NA	13761	12663	1098	8
CN4806900000000	48	069	Castro County, TX	2003	NA	3938	3736	202	5.1
CN4807100000000	48	071	Chambers County, TX	2003	NA	13646	12807	839	6.1
CN4807300000000	48	073	Cherokee County, TX	2003	NA	21807	20522	1285	5.9
CN4807500000000	48	075	Childress County, TX	2003	NA	3298	3102	196	5.9
CN4807700000000	48	077	Clay County, TX	2003	NA	6415	6111	304	4.7
CN4807900000000	48	079	Cochran County, TX	2003	NA	1734	1594	140	8.1
CN4808100000000	48	081	Coke County, TX	2003	NA	1616	1523	93	5.8
CN4808300000000	48	083	Coleman County, TX	2003	NA	4376	4098	278	6.4
CN4808500000000	48	085	Collin County, TX	2003	NA	339497	319162	20335	6
CN4808700000000	48	087	Collingsworth County, TX	2003	NA	1713	1629	84	4.9
CN4808900000000	48	089	Colorado County, TX	2003	NA	10365	9797	568	5.5
CN4809100000000	48	091	Comal County, TX	2003	NA	45240	42637	2603	5.8
CN4809300000000	48	093	Comanche County, TX	2003	NA	7083	6716	367	5.2
CN4809500000000	48	095	Concho County, TX	2003	NA	1478	1383	95	6.4
CN4809700000000	48	097	Cooke County, TX	2003	NA	19045	17966	1079	5.7
CN4809900000000	48	099	Coryell County, TX	2003	NA	24710	22903	1807	7.3
CN4810100000000	48	101	Cottle County, TX	2003	NA	985	924	61	6.2
CN4810300000000	48	103	Crane County, TX	2003	NA	1684	1561	123	7.3
CN4810500000000	48	105	Crockett County, TX	2003	NA	2177	2089	88	4
CN4810700000000	48	107	Crosby County, TX	2003	NA	2957	2765	192	6.5
CN4810900000000	48	109	Culberson County, TX	2003	NA	1599	1511	88	5.5
CN4811100000000	48	111	Dallam County, TX	2003	NA	3413	3273	140	4.1
CN4811300000000	48	113	Dallas County, TX	2003	NA	1158506	1072829	85677	7.4
CN4811500000000	48	115	Dawson County, TX	2003	NA	5622	5201	421	7.5
CN4811700000000	48	117	Deaf Smith County, TX	2003	NA	8159	7684	475	5.8
CN4811900000000	48	119	Delta County, TX	2003	NA	2419	2259	160	6.6
CN4812100000000	48	121	Denton County, TX	2003	NA	292734	277387	15347	5.2
CN4812300000000	48	123	DeWitt County, TX	2003	NA	9674	9126	548	5.7
CN4812500000000	48	125	Dickens County, TX	2003	NA	1190	1117	73	6.1
CN4812700000000	48	127	Dimmit County, TX	2003	NA	4248	3850	398	9.4
CN4812900000000	48	129	Donley County, TX	2003	NA	1972	1863	109	5.5
CN4813100000000	48	131	Duval County, TX	2003	NA	5280	4841	439	8.3
CN4813300000000	48	133	Eastland County, TX	2003	NA	8648	8091	557	6.4
CN4813500000000	48	135	Ector County, TX	2003	NA	60621	56615	4006	6.6
CN4813700000000	48	137	Edwards County, TX	2003	NA	1141	1092	49	4.3
CN4813900000000	48	139	Ellis County, TX	2003	NA	63011	59012	3999	6.3
CN4814100000000	48	141	El Paso County, TX	2003	NA	288490	263240	25250	8.8
CN4814300000000	48	143	Erath County, TX	2003	NA	17796	16937	859	4.8
CN4814500000000	48	145	Falls County, TX	2003	NA	7631	7096	535	7
CN4814700000000	48	147	Fannin County, TX	2003	NA	13954	12917	1037	7.4
CN4814900000000	48	149	Fayette County, TX	2003	NA	12194	11616	578	4.7
CN4815100000000	48	151	Fisher County, TX	2003	NA	2226	2102	124	5.6
CN4815300000000	48	153	Floyd County, TX	2003	NA	3670	3410	260	7.1
CN4815500000000	48	155	Foard County, TX	2003	NA	807	747	60	7.4
CN4815700000000	48	157	Fort Bend County, TX	2003	NA	216199	203016	13183	6.1
CN4815900000000	48	159	Franklin County, TX	2003	NA	4834	4587	247	5.1
CN4816100000000	48	161	Freestone County, TX	2003	NA	9450	8882	568	6
CN4816300000000	48	163	Frio County, TX	2003	NA	6619	6103	516	7.8
CN4816500000000	48	165	Gaines County, TX	2003	NA	6837	6501	336	4.9
CN4816700000000	48	167	Galveston County, TX	2003	NA	135219	125578	9641	7.1
CN4816900000000	48	169	Garza County, TX	2003	NA	2307	2172	135	5.9
CN4817100000000	48	171	Gillespie County, TX	2003	NA	11795	11286	509	4.3
CN4817300000000	48	173	Glasscock County, TX	2003	NA	744	713	31	4.2
CN4817500000000	48	175	Goliad County, TX	2003	NA	3376	3187	189	5.6
CN4817700000000	48	177	Gonzales County, TX	2003	NA	10088	9583	505	5
CN4817900000000	48	179	Gray County, TX	2003	NA	10329	9707	622	6
CN4818100000000	48	181	Grayson County, TX	2003	NA	57062	53038	4024	7.1
CN4818300000000	48	183	Gregg County, TX	2003	NA	57976	53906	4070	7
CN4818500000000	48	185	Grimes County, TX	2003	NA	10297	9461	836	8.1
CN4818700000000	48	187	Guadalupe County, TX	2003	NA	49002	46400	2602	5.3
CN4818900000000	48	189	Hale County, TX	2003	NA	17699	16618	1081	6.1
CN4819100000000	48	191	Hall County, TX	2003	NA	1739	1625	114	6.6
CN4819300000000	48	193	Hamilton County, TX	2003	NA	4484	4265	219	4.9
CN4819500000000	48	195	Hansford County, TX	2003	NA	2884	2767	117	4.1
CN4819700000000	48	197	Hardeman County, TX	2003	NA	2375	2223	152	6.4
CN4819900000000	48	199	Hardin County, TX	2003	NA	24477	22584	1893	7.7
CN4820100000000	48	201	Harris County, TX	2003	NA	1806134	1683596	122538	6.8
CN4820300000000	48	203	Harrison County, TX	2003	NA	30649	28617	2032	6.6
CN4820500000000	48	205	Hartley County, TX	2003	NA	2569	2464	105	4.1
CN4820700000000	48	207	Haskell County, TX	2003	NA	3142	2968	174	5.5
CN4820900000000	48	209	Hays County, TX	2003	NA	62864	59214	3650	5.8
CN4821100000000	48	211	Hemphill County, TX	2003	NA	2345	2277	68	2.9
CN4821300000000	48	213	Henderson County, TX	2003	NA	34679	32544	2135	6.2
CN4821500000000	48	215	Hidalgo County, TX	2003	NA	245527	220128	25399	10.3
CN4821700000000	48	217	Hill County, TX	2003	NA	15386	14214	1172	7.6
CN4821900000000	48	219	Hockley County, TX	2003	NA	11702	11084	618	5.3
CN4822100000000	48	221	Hood County, TX	2003	NA	22771	21341	1430	6.3
CN4822300000000	48	223	Hopkins County, TX	2003	NA	16817	15815	1002	6
CN4822500000000	48	225	Houston County, TX	2003	NA	9818	9117	701	7.1
CN4822700000000	48	227	Howard County, TX	2003	NA	14225	13315	910	6.4
CN4822900000000	48	229	Hudspeth County, TX	2003	NA	1386	1278	108	7.8
CN4823100000000	48	231	Hunt County, TX	2003	NA	38296	35704	2592	6.8
CN4823300000000	48	233	Hutchinson County, TX	2003	NA	10997	10276	721	6.6
CN4823500000000	48	235	Irion County, TX	2003	NA	972	930	42	4.3
CN4823700000000	48	237	Jack County, TX	2003	NA	4220	4003	217	5.1
CN4823900000000	48	239	Jackson County, TX	2003	NA	6873	6474	399	5.8
CN4824100000000	48	241	Jasper County, TX	2003	NA	16198	14645	1553	9.6
CN4824300000000	48	243	Jeff Davis County, TX	2003	NA	1358	1303	55	4.1
CN4824500000000	48	245	Jefferson County, TX	2003	NA	114138	104372	9766	8.6
CN4824700000000	48	247	Jim Hogg County, TX	2003	NA	2471	2321	150	6.1
CN4824900000000	48	249	Jim Wells County, TX	2003	NA	19199	17864	1335	7
CN4825100000000	48	251	Johnson County, TX	2003	NA	69838	65321	4517	6.5
CN4825300000000	48	253	Jones County, TX	2003	NA	8011	7492	519	6.5
CN4825500000000	48	255	Karnes County, TX	2003	NA	5647	5235	412	7.3
CN4825700000000	48	257	Kaufman County, TX	2003	NA	40844	37679	3165	7.7
CN4825900000000	48	259	Kendall County, TX	2003	NA	13353	12652	701	5.2
CN4826100000000	48	261	Kenedy County, TX	2003	NA	230	221	9	3.9
CN4826300000000	48	263	Kent County, TX	2003	NA	513	488	25	4.9
CN4826500000000	48	265	Kerr County, TX	2003	NA	21034	19930	1104	5.2
CN4826700000000	48	267	Kimble County, TX	2003	NA	2302	2197	105	4.6
CN4826900000000	48	269	King County, TX	2003	NA	240	231	9	3.8
CN4827100000000	48	271	Kinney County, TX	2003	NA	1423	1314	109	7.7
CN4827300000000	48	273	Kleberg County, TX	2003	NA	15696	14746	950	6.1
CN4827500000000	48	275	Knox County, TX	2003	NA	2048	1936	112	5.5
CN4827700000000	48	277	Lamar County, TX	2003	NA	24064	22333	1731	7.2
CN4827900000000	48	279	Lamb County, TX	2003	NA	7571	7130	441	5.8
CN4828100000000	48	281	Lampasas County, TX	2003	NA	9520	9000	520	5.5
CN4828300000000	48	283	La Salle County, TX	2003	NA	2366	2183	183	7.7
CN4828500000000	48	285	Lavaca County, TX	2003	NA	10106	9680	426	4.2
CN4828700000000	48	287	Lee County, TX	2003	NA	8743	8272	471	5.4
CN4828900000000	48	289	Leon County, TX	2003	NA	7465	6903	562	7.5
CN4829100000000	48	291	Liberty County, TX	2003	NA	31868	28933	2935	9.2
CN4829300000000	48	293	Limestone County, TX	2003	NA	10410	9783	627	6
CN4829500000000	48	295	Lipscomb County, TX	2003	NA	1625	1551	74	4.6
CN4829700000000	48	297	Live Oak County, TX	2003	NA	5216	4923	293	5.6
CN4829900000000	48	299	Llano County, TX	2003	NA	7987	7488	499	6.2
CN4830100000000	48	301	Loving County, TX	2003	NA	50	45	5	10
CN4830300000000	48	303	Lubbock County, TX	2003	NA	135530	128994	6536	4.8
CN4830500000000	48	305	Lynn County, TX	2003	NA	3189	3015	174	5.5
CN4830700000000	48	307	McCulloch County, TX	2003	NA	4007	3798	209	5.2
CN4830900000000	48	309	McLennan County, TX	2003	NA	108552	102006	6546	6
CN4831100000000	48	311	McMullen County, TX	2003	NA	458	435	23	5
CN4831300000000	48	313	Madison County, TX	2003	NA	5195	4856	339	6.5
CN4831500000000	48	315	Marion County, TX	2003	NA	4943	4572	371	7.5
CN4831700000000	48	317	Martin County, TX	2003	NA	2359	2252	107	4.5
CN4831900000000	48	319	Mason County, TX	2003	NA	2315	2230	85	3.7
CN4832100000000	48	321	Matagorda County, TX	2003	NA	17369	15615	1754	10.1
CN4832300000000	48	323	Maverick County, TX	2003	NA	18585	15324	3261	17.5
CN4832500000000	48	325	Medina County, TX	2003	NA	18968	17852	1116	5.9
CN4832700000000	48	327	Menard County, TX	2003	NA	1170	1106	64	5.5
CN4832900000000	48	329	Midland County, TX	2003	NA	62896	59801	3095	4.9
CN4833100000000	48	331	Milam County, TX	2003	NA	12020	11235	785	6.5
CN4833300000000	48	333	Mills County, TX	2003	NA	2716	2600	116	4.3
CN4833500000000	48	335	Mitchell County, TX	2003	NA	3555	3293	262	7.4
CN4833700000000	48	337	Montague County, TX	2003	NA	9536	8950	586	6.1
CN4833900000000	48	339	Montgomery County, TX	2003	NA	175113	165222	9891	5.6
CN4834100000000	48	341	Moore County, TX	2003	NA	10379	9888	491	4.7
CN4834300000000	48	343	Morris County, TX	2003	NA	6116	5580	536	8.8
CN4834500000000	48	345	Motley County, TX	2003	NA	733	704	29	4
CN4834700000000	48	347	Nacogdoches County, TX	2003	NA	31027	29203	1824	5.9
CN4834900000000	48	349	Navarro County, TX	2003	NA	21800	20131	1669	7.7
CN4835100000000	48	351	Newton County, TX	2003	NA	6041	5291	750	12.4
CN4835300000000	48	353	Nolan County, TX	2003	NA	7690	7236	454	5.9
CN4835500000000	48	355	Nueces County, TX	2003	NA	155966	145883	10083	6.5
CN4835700000000	48	357	Ochiltree County, TX	2003	NA	5013	4820	193	3.8
CN4835900000000	48	359	Oldham County, TX	2003	NA	1243	1185	58	4.7
CN4836100000000	48	361	Orange County, TX	2003	NA	41602	37718	3884	9.3
CN4836300000000	48	363	Palo Pinto County, TX	2003	NA	13582	12765	817	6
CN4836500000000	48	365	Panola County, TX	2003	NA	11116	10350	766	6.9
CN4836700000000	48	367	Parker County, TX	2003	NA	48543	45829	2714	5.6
CN4836900000000	48	369	Parmer County, TX	2003	NA	5026	4819	207	4.1
CN4837100000000	48	371	Pecos County, TX	2003	NA	7373	6920	453	6.1
CN4837300000000	48	373	Polk County, TX	2003	NA	17179	15787	1392	8.1
CN4837500000000	48	375	Potter County, TX	2003	NA	56957	53188	3769	6.6
CN4837700000000	48	377	Presidio County, TX	2003	NA	3621	3057	564	15.6
CN4837900000000	48	379	Rains County, TX	2003	NA	4690	4342	348	7.4
CN4838100000000	48	381	Randall County, TX	2003	NA	63866	61806	2060	3.2
CN4838300000000	48	383	Reagan County, TX	2003	NA	1673	1607	66	3.9
CN4838500000000	48	385	Real County, TX	2003	NA	1384	1297	87	6.3
CN4838700000000	48	387	Red River County, TX	2003	NA	6487	6009	478	7.4
CN4838900000000	48	389	Reeves County, TX	2003	NA	4755	4217	538	11.3
CN4839100000000	48	391	Refugio County, TX	2003	NA	3888	3703	185	4.8
CN4839300000000	48	393	Roberts County, TX	2003	NA	513	494	19	3.7
CN4839500000000	48	395	Robertson County, TX	2003	NA	7392	6934	458	6.2
CN4839700000000	48	397	Rockwall County, TX	2003	NA	28683	27011	1672	5.8
CN4839900000000	48	399	Runnels County, TX	2003	NA	4934	4658	276	5.6
CN4840100000000	48	401	Rusk County, TX	2003	NA	21775	20311	1464	6.7
CN4840300000000	48	403	Sabine County, TX	2003	NA	3786	3292	494	13
CN4840500000000	48	405	San Augustine County, TX	2003	NA	3912	3640	272	7
CN4840700000000	48	407	San Jacinto County, TX	2003	NA	9931	9252	679	6.8
CN4840900000000	48	409	San Patricio County, TX	2003	NA	28958	26879	2079	7.2
CN4841100000000	48	411	San Saba County, TX	2003	NA	2836	2687	149	5.3
CN4841300000000	48	413	Schleicher County, TX	2003	NA	1519	1456	63	4.1
CN4841500000000	48	415	Scurry County, TX	2003	NA	7260	6825	435	6
CN4841700000000	48	417	Shackelford County, TX	2003	NA	1970	1894	76	3.9
CN4841900000000	48	419	Shelby County, TX	2003	NA	12562	11685	877	7
CN4842100000000	48	421	Sherman County, TX	2003	NA	1684	1623	61	3.6
CN4842300000000	48	423	Smith County, TX	2003	NA	92322	86852	5470	5.9
CN4842500000000	48	425	Somervell County, TX	2003	NA	3808	3567	241	6.3
CN4842700000000	48	427	Starr County, TX	2003	NA	21130	17779	3351	15.9
CN4842900000000	48	429	Stephens County, TX	2003	NA	4210	3906	304	7.2
CN4843100000000	48	431	Sterling County, TX	2003	NA	948	916	32	3.4
CN4843300000000	48	433	Stonewall County, TX	2003	NA	865	827	38	4.4
CN4843500000000	48	435	Sutton County, TX	2003	NA	2487	2402	85	3.4
CN4843700000000	48	437	Swisher County, TX	2003	NA	4043	3832	211	5.2
CN4843900000000	48	439	Tarrant County, TX	2003	NA	820450	768791	51659	6.3
CN4844100000000	48	441	Taylor County, TX	2003	NA	64835	61492	3343	5.2
CN4844300000000	48	443	Terrell County, TX	2003	NA	499	463	36	7.2
CN4844500000000	48	445	Terry County, TX	2003	NA	5840	5454	386	6.6
CN4844700000000	48	447	Throckmorton County, TX	2003	NA	1027	980	47	4.6
CN4844900000000	48	449	Titus County, TX	2003	NA	14531	13707	824	5.7
CN4845100000000	48	451	Tom Green County, TX	2003	NA	52791	50101	2690	5.1
CN4845300000000	48	453	Travis County, TX	2003	NA	488352	459021	29331	6
CN4845500000000	48	455	Trinity County, TX	2003	NA	5976	5546	430	7.2
CN4845700000000	48	457	Tyler County, TX	2003	NA	8730	7916	814	9.3
CN4845900000000	48	459	Upshur County, TX	2003	NA	17682	16534	1148	6.5
CN4846100000000	48	461	Upton County, TX	2003	NA	1548	1465	83	5.4
CN4846300000000	48	463	Uvalde County, TX	2003	NA	12068	11145	923	7.6
CN4846500000000	48	465	Val Verde County, TX	2003	NA	19479	17952	1527	7.8
CN4846700000000	48	467	Van Zandt County, TX	2003	NA	24893	23379	1514	6.1
CN4846900000000	48	469	Victoria County, TX	2003	NA	43450	40948	2502	5.8
CN4847100000000	48	471	Walker County, TX	2003	NA	26041	24335	1706	6.6
CN4847300000000	48	473	Waller County, TX	2003	NA	16084	15026	1058	6.6
CN4847500000000	48	475	Ward County, TX	2003	NA	4406	4078	328	7.4
CN4847700000000	48	477	Washington County, TX	2003	NA	16020	15179	841	5.2
CN4847900000000	48	479	Webb County, TX	2003	NA	81198	75249	5949	7.3
CN4848100000000	48	481	Wharton County, TX	2003	NA	21463	20142	1321	6.2
CN4848300000000	48	483	Wheeler County, TX	2003	NA	2802	2685	117	4.2
CN4848500000000	48	485	Wichita County, TX	2003	NA	63130	59368	3762	6
CN4848700000000	48	487	Wilbarger County, TX	2003	NA	7540	7167	373	4.9
CN4848900000000	48	489	Willacy County, TX	2003	NA	7632	6731	901	11.8
CN4849100000000	48	491	Williamson County, TX	2003	NA	164784	155457	9327	5.7
CN4849300000000	48	493	Wilson County, TX	2003	NA	16894	15935	959	5.7
CN4849500000000	48	495	Winkler County, TX	2003	NA	3066	2839	227	7.4
CN4849700000000	48	497	Wise County, TX	2003	NA	26768	25215	1553	5.8
CN4849900000000	48	499	Wood County, TX	2003	NA	17479	16312	1167	6.7
CN4850100000000	48	501	Yoakum County, TX	2003	NA	3401	3216	185	5.4
CN4850300000000	48	503	Young County, TX	2003	NA	8959	8425	534	6
CN4850500000000	48	505	Zapata County, TX	2003	NA	4710	4297	413	8.8
CN4850700000000	48	507	Zavala County, TX	2003	NA	4192	3615	577	13.8
CN4900100000000	49	001	Beaver County, UT	2003	NA	2945	2791	154	5.2
CN4900300000000	49	003	Box Elder County, UT	2003	NA	21318	20138	1180	5.5
CN4900500000000	49	005	Cache County, UT	2003	NA	54001	51881	2120	3.9
CN4900700000000	49	007	Carbon County, UT	2003	NA	9359	8637	722	7.7
CN4900900000000	49	009	Daggett County, UT	2003	NA	483	457	26	5.4
CN4901100000000	49	011	Davis County, UT	2003	NA	128457	121880	6577	5.1
CN4901300000000	49	013	Duchesne County, UT	2003	NA	6882	6420	462	6.7
CN4901500000000	49	015	Emery County, UT	2003	NA	4881	4490	391	8
CN4901700000000	49	017	Garfield County, UT	2003	NA	2550	2321	229	9
CN4901900000000	49	019	Grand County, UT	2003	NA	4893	4527	366	7.5
CN4902100000000	49	021	Iron County, UT	2003	NA	17900	16963	937	5.2
CN4902300000000	49	023	Juab County, UT	2003	NA	3683	3421	262	7.1
CN4902500000000	49	025	Kane County, UT	2003	NA	3112	2936	176	5.7
CN4902700000000	49	027	Millard County, UT	2003	NA	5932	5634	298	5
CN4902900000000	49	029	Morgan County, UT	2003	NA	3589	3403	186	5.2
CN4903100000000	49	031	Piute County, UT	2003	NA	803	759	44	5.5
CN4903300000000	49	033	Rich County, UT	2003	NA	1260	1210	50	4
CN4903500000000	49	035	Salt Lake County, UT	2003	NA	496311	467810	28501	5.7
CN4903700000000	49	037	San Juan County, UT	2003	NA	4739	4307	432	9.1
CN4903900000000	49	039	Sanpete County, UT	2003	NA	10308	9608	700	6.8
CN4904100000000	49	041	Sevier County, UT	2003	NA	8756	8250	506	5.8
CN4904300000000	49	043	Summit County, UT	2003	NA	19879	18653	1226	6.2
CN4904500000000	49	045	Tooele County, UT	2003	NA	23242	21788	1454	6.3
CN4904700000000	49	047	Uintah County, UT	2003	NA	13094	12342	752	5.7
CN4904900000000	49	049	Utah County, UT	2003	NA	188833	178807	10026	5.3
CN4905100000000	49	051	Wasatch County, UT	2003	NA	8487	7969	518	6.1
CN4905300000000	49	053	Washington County, UT	2003	NA	47554	45016	2538	5.3
CN4905500000000	49	055	Wayne County, UT	2003	NA	1321	1230	91	6.9
CN4905700000000	49	057	Weber County, UT	2003	NA	105669	98908	6761	6.4
CN5000100000000	50	001	Addison County, VT	2003	NA	21036	20216	820	3.9
CN5000300000000	50	003	Bennington County, VT	2003	NA	19951	19003	948	4.8
CN5000500000000	50	005	Caledonia County, VT	2003	NA	16280	15458	822	5
CN5000700000000	50	007	Chittenden County, VT	2003	NA	86525	83243	3282	3.8
CN5000900000000	50	009	Essex County, VT	2003	NA	3244	3085	159	4.9
CN5001100000000	50	011	Franklin County, VT	2003	NA	25470	24269	1201	4.7
CN5001300000000	50	013	Grand Isle County, VT	2003	NA	4116	3888	228	5.5
CN5001500000000	50	015	Lamoille County, VT	2003	NA	14012	13339	673	4.8
CN5001700000000	50	017	Orange County, VT	2003	NA	16271	15647	624	3.8
CN5001900000000	50	019	Orleans County, VT	2003	NA	13828	12973	855	6.2
CN5002100000000	50	021	Rutland County, VT	2003	NA	34671	33053	1618	4.7
CN5002300000000	50	023	Washington County, VT	2003	NA	33896	32413	1483	4.4
CN5002500000000	50	025	Windham County, VT	2003	NA	24702	23749	953	3.9
CN5002700000000	50	027	Windsor County, VT	2003	NA	31968	30783	1185	3.7
CN5100100000000	51	001	Accomack County, VA	2003	NA	19225	18384	841	4.4
CN5100300000000	51	003	Albemarle County, VA	2003	NA	44702	43179	1523	3.4
CN5100500000000	51	005	Alleghany County, VA	2003	NA	7983	7613	370	4.6
CN5100700000000	51	007	Amelia County, VA	2003	NA	5954	5720	234	3.9
CN5100900000000	51	009	Amherst County, VA	2003	NA	15152	14397	755	5
CN5101100000000	51	011	Appomattox County, VA	2003	NA	6691	6317	374	5.6
CN5101300000000	51	013	Arlington County, VA	2003	NA	120433	117196	3237	2.7
CN5101500000000	51	015	Augusta County, VA	2003	NA	35899	34665	1234	3.4
CN5101700000000	51	017	Bath County, VA	2003	NA	2870	2738	132	4.6
CN5101900000000	51	019	Bedford County, VA	2003	NA	34981	33518	1463	4.2
CN5102100000000	51	021	Bland County, VA	2003	NA	3020	2868	152	5
CN5102300000000	51	023	Botetourt County, VA	2003	NA	16788	16187	601	3.6
CN5102500000000	51	025	Brunswick County, VA	2003	NA	6912	6429	483	7
CN5102700000000	51	027	Buchanan County, VA	2003	NA	8838	8220	618	7
CN5102900000000	51	029	Buckingham County, VA	2003	NA	6425	6144	281	4.4
CN5103100000000	51	031	Campbell County, VA	2003	NA	26171	24862	1309	5
CN5103300000000	51	033	Caroline County, VA	2003	NA	11490	10999	491	4.3
CN5103500000000	51	035	Carroll County, VA	2003	NA	14855	14024	831	5.6
CN5103600000000	51	036	Charles City County, VA	2003	NA	3728	3539	189	5.1
CN5103700000000	51	037	Charlotte County, VA	2003	NA	5636	5268	368	6.5
CN5104100000000	51	041	Chesterfield County, VA	2003	NA	149730	144448	5282	3.5
CN5104300000000	51	043	Clarke County, VA	2003	NA	7106	6885	221	3.1
CN5104500000000	51	045	Craig County, VA	2003	NA	2487	2385	102	4.1
CN5104700000000	51	047	Culpeper County, VA	2003	NA	17933	17208	725	4
CN5104900000000	51	049	Cumberland County, VA	2003	NA	4276	4103	173	4
CN5105100000000	51	051	Dickenson County, VA	2003	NA	5796	5304	492	8.5
CN5105300000000	51	053	Dinwiddie County, VA	2003	NA	12110	11617	493	4.1
CN5105700000000	51	057	Essex County, VA	2003	NA	5313	5026	287	5.4
CN5105900000000	51	059	Fairfax County, VA	2003	NA	547743	530829	16914	3.1
CN5106100000000	51	061	Fauquier County, VA	2003	NA	32377	31367	1010	3.1
CN5106300000000	51	063	Floyd County, VA	2003	NA	7269	6975	294	4
CN5106500000000	51	065	Fluvanna County, VA	2003	NA	11664	11263	401	3.4
CN5106700000000	51	067	Franklin County, VA	2003	NA	24840	23732	1108	4.5
CN5106900000000	51	069	Frederick County, VA	2003	NA	36026	34715	1311	3.6
CN5107100000000	51	071	Giles County, VA	2003	NA	8188	7745	443	5.4
CN5107300000000	51	073	Gloucester County, VA	2003	NA	18849	18248	601	3.2
CN5107500000000	51	075	Goochland County, VA	2003	NA	9523	9203	320	3.4
CN5107700000000	51	077	Grayson County, VA	2003	NA	7910	7411	499	6.3
CN5107900000000	51	079	Greene County, VA	2003	NA	9110	8739	371	4.1
CN5108100000000	51	081	Greensville County, VA	2003	NA	4238	4015	223	5.3
CN5108300000000	51	083	Halifax County, VA	2003	NA	16239	14583	1656	10.2
CN5108500000000	51	085	Hanover County, VA	2003	NA	50886	49232	1654	3.3
CN5108700000000	51	087	Henrico County, VA	2003	NA	149235	143680	5555	3.7
CN5108900000000	51	089	Henry County, VA	2003	NA	27996	25188	2808	10
CN5109100000000	51	091	Highland County, VA	2003	NA	1182	1132	50	4.2
CN5109300000000	51	093	Isle of Wight County, VA	2003	NA	16250	15668	582	3.6
CN5109500000000	51	095	James City County, VA	2003	NA	26182	25309	873	3.3
CN5109700000000	51	097	King and Queen County, VA	2003	NA	3125	2983	142	4.5
CN5109900000000	51	099	King George County, VA	2003	NA	9016	8723	293	3.2
CN5110100000000	51	101	King William County, VA	2003	NA	7462	7191	271	3.6
CN5110300000000	51	103	Lancaster County, VA	2003	NA	5232	4942	290	5.5
CN5110500000000	51	105	Lee County, VA	2003	NA	9627	9048	579	6
CN5110700000000	51	107	Loudoun County, VA	2003	NA	124224	120279	3945	3.2
CN5110900000000	51	109	Louisa County, VA	2003	NA	13935	13343	592	4.2
CN5111100000000	51	111	Lunenburg County, VA	2003	NA	5587	5274	313	5.6
CN5111300000000	51	113	Madison County, VA	2003	NA	7131	6855	276	3.9
CN5111500000000	51	115	Mathews County, VA	2003	NA	4341	4202	139	3.2
CN5111700000000	51	117	Mecklenburg County, VA	2003	NA	13610	12334	1276	9.4
CN5111900000000	51	119	Middlesex County, VA	2003	NA	4837	4667	170	3.5
CN5112100000000	51	121	Montgomery County, VA	2003	NA	42529	40907	1622	3.8
CN5112500000000	51	125	Nelson County, VA	2003	NA	7144	6883	261	3.7
CN5112700000000	51	127	New Kent County, VA	2003	NA	8017	7721	296	3.7
CN5113100000000	51	131	Northampton County, VA	2003	NA	5935	5646	289	4.9
CN5113300000000	51	133	Northumberland County, VA	2003	NA	5630	5314	316	5.6
CN5113500000000	51	135	Nottoway County, VA	2003	NA	6416	6131	285	4.4
CN5113700000000	51	137	Orange County, VA	2003	NA	13726	13176	550	4
CN5113900000000	51	139	Page County, VA	2003	NA	11882	11050	832	7
CN5114100000000	51	141	Patrick County, VA	2003	NA	9758	9010	748	7.7
CN5114300000000	51	143	Pittsylvania County, VA	2003	NA	32612	30478	2134	6.5
CN5114500000000	51	145	Powhatan County, VA	2003	NA	12468	12073	395	3.2
CN5114700000000	51	147	Prince Edward County, VA	2003	NA	8456	7973	483	5.7
CN5114900000000	51	149	Prince George County, VA	2003	NA	14546	13939	607	4.2
CN5115300000000	51	153	Prince William County, VA	2003	NA	170707	164902	5805	3.4
CN5115500000000	51	155	Pulaski County, VA	2003	NA	18041	16939	1102	6.1
CN5115700000000	51	157	Rappahannock County, VA	2003	NA	3945	3825	120	3
CN5115900000000	51	159	Richmond County, VA	2003	NA	3564	3341	223	6.3
CN5116100000000	51	161	Roanoke County, VA	2003	NA	46141	44587	1554	3.4
CN5116300000000	51	163	Rockbridge County, VA	2003	NA	11197	10779	418	3.7
CN5116500000000	51	165	Rockingham County, VA	2003	NA	38991	37751	1240	3.2
CN5116700000000	51	167	Russell County, VA	2003	NA	12281	11519	762	6.2
CN5116900000000	51	169	Scott County, VA	2003	NA	9861	9322	539	5.5
CN5117100000000	51	171	Shenandoah County, VA	2003	NA	19133	18387	746	3.9
CN5117300000000	51	173	Smyth County, VA	2003	NA	15772	14576	1196	7.6
CN5117500000000	51	175	Southampton County, VA	2003	NA	7566	7234	332	4.4
CN5117700000000	51	177	Spotsylvania County, VA	2003	NA	55468	53773	1695	3.1
CN5117900000000	51	179	Stafford County, VA	2003	NA	55344	53623	1721	3.1
CN5118100000000	51	181	Surry County, VA	2003	NA	3549	3386	163	4.6
CN5118300000000	51	183	Sussex County, VA	2003	NA	4473	4163	310	6.9
CN5118500000000	51	185	Tazewell County, VA	2003	NA	19904	18826	1078	5.4
CN5118700000000	51	187	Warren County, VA	2003	NA	17309	16613	696	4
CN5119100000000	51	191	Washington County, VA	2003	NA	25976	24569	1407	5.4
CN5119300000000	51	193	Westmoreland County, VA	2003	NA	8061	7672	389	4.8
CN5119500000000	51	195	Wise County, VA	2003	NA	17258	16263	995	5.8
CN5119700000000	51	197	Wythe County, VA	2003	NA	14728	13949	779	5.3
CN5119900000000	51	199	York County, VA	2003	NA	29158	28235	923	3.2
CN5151000000000	51	510	Alexandria city, VA	2003	NA	82495	80019	2476	3
CN5152000000000	51	520	Bristol city, VA	2003	NA	7837	7350	487	6.2
CN5153000000000	51	530	Buena Vista city, VA	2003	NA	3380	3228	152	4.5
CN5154000000000	51	540	Charlottesville city, VA	2003	NA	19398	18591	807	4.2
CN5155000000000	51	550	Chesapeake city, VA	2003	NA	105117	101059	4058	3.9
CN5157000000000	51	570	Colonial Heights city, VA	2003	NA	8753	8359	394	4.5
CN5158000000000	51	580	Covington city, VA	2003	NA	3065	2896	169	5.5
CN5159000000000	51	590	Danville city, VA	2003	NA	21747	19687	2060	9.5
CN5159500000000	51	595	Emporia city, VA	2003	NA	2558	2380	178	7
CN5160000000000	51	600	Fairfax city, VA	2003	NA	12398	12060	338	2.7
CN5161000000000	51	610	Falls Church city, VA	2003	NA	6081	5883	198	3.3
CN5162000000000	51	620	Franklin city, VA	2003	NA	3666	3486	180	4.9
CN5163000000000	51	630	Fredericksburg city, VA	2003	NA	10598	10042	556	5.2
CN5164000000000	51	640	Galax city, VA	2003	NA	3264	3055	209	6.4
CN5165000000000	51	650	Hampton city, VA	2003	NA	65721	62500	3221	4.9
CN5166000000000	51	660	Harrisonburg city, VA	2003	NA	20967	20148	819	3.9
CN5167000000000	51	670	Hopewell city, VA	2003	NA	10021	9385	636	6.3
CN5167800000000	51	678	Lexington city, VA	2003	NA	2328	2199	129	5.5
CN5168000000000	51	680	Lynchburg city, VA	2003	NA	30693	28974	1719	5.6
CN5168300000000	51	683	Manassas city, VA	2003	NA	19748	19069	679	3.4
CN5168500000000	51	685	Manassas Park city, VA	2003	NA	5969	5810	159	2.7
CN5169000000000	51	690	Martinsville city, VA	2003	NA	6318	5651	667	10.6
CN5170000000000	51	700	Newport News city, VA	2003	NA	85598	81532	4066	4.8
CN5171000000000	51	710	Norfolk city, VA	2003	NA	97219	92073	5146	5.3
CN5172000000000	51	720	Norton city, VA	2003	NA	1610	1523	87	5.4
CN5173000000000	51	730	Petersburg city, VA	2003	NA	14121	12900	1221	8.6
CN5173500000000	51	735	Poquoson city, VA	2003	NA	6027	5836	191	3.2
CN5174000000000	51	740	Portsmouth city, VA	2003	NA	43557	41195	2362	5.4
CN5175000000000	51	750	Radford city, VA	2003	NA	7322	6938	384	5.2
CN5176000000000	51	760	Richmond city, VA	2003	NA	95032	89532	5500	5.8
CN5177000000000	51	770	Roanoke city, VA	2003	NA	45618	43252	2366	5.2
CN5177500000000	51	775	Salem city, VA	2003	NA	12782	12284	498	3.9
CN5179000000000	51	790	Staunton city, VA	2003	NA	11380	10942	438	3.8
CN5180000000000	51	800	Suffolk city, VA	2003	NA	34539	33049	1490	4.3
CN5181000000000	51	810	Virginia Beach city, VA	2003	NA	215308	207436	7872	3.7
CN5182000000000	51	820	Waynesboro city, VA	2003	NA	9673	9233	440	4.5
CN5183000000000	51	830	Williamsburg city, VA	2003	NA	4589	4220	369	8
CN5184000000000	51	840	Winchester city, VA	2003	NA	13330	12839	491	3.7
CN5300100000000	53	001	Adams County, WA	2003	NA	8172	7450	722	8.8
CN5300300000000	53	003	Asotin County, WA	2003	NA	9928	9186	742	7.5
CN5300500000000	53	005	Benton County, WA	2003	NA	82206	76515	5691	6.9
CN5300700000000	53	007	Chelan County, WA	2003	NA	36734	33621	3113	8.5
CN5300900000000	53	009	Clallam County, WA	2003	NA	27035	24693	2342	8.7
CN5301100000000	53	011	Clark County, WA	2003	NA	187492	169407	18085	9.6
CN5301300000000	53	013	Columbia County, WA	2003	NA	1660	1500	160	9.6
CN5301500000000	53	015	Cowlitz County, WA	2003	NA	42455	38201	4254	10
CN5301700000000	53	017	Douglas County, WA	2003	NA	18374	16956	1418	7.7
CN5301900000000	53	019	Ferry County, WA	2003	NA	2923	2525	398	13.6
CN5302100000000	53	021	Franklin County, WA	2003	NA	26162	23843	2319	8.9
CN5302300000000	53	023	Garfield County, WA	2003	NA	1080	1006	74	6.9
CN5302500000000	53	025	Grant County, WA	2003	NA	36677	33238	3439	9.4
CN5302700000000	53	027	Grays Harbor County, WA	2003	NA	29680	26867	2813	9.5
CN5302900000000	53	029	Island County, WA	2003	NA	30516	28187	2329	7.6
CN5303100000000	53	031	Jefferson County, WA	2003	NA	12816	11858	958	7.5
CN5303300000000	53	033	King County, WA	2003	NA	987258	926821	60437	6.1
CN5303500000000	53	035	Kitsap County, WA	2003	NA	113544	105865	7679	6.8
CN5303700000000	53	037	Kittitas County, WA	2003	NA	18502	17075	1427	7.7
CN5303900000000	53	039	Klickitat County, WA	2003	NA	9417	8292	1125	11.9
CN5304100000000	53	041	Lewis County, WA	2003	NA	30107	27250	2857	9.5
CN5304300000000	53	043	Lincoln County, WA	2003	NA	4680	4349	331	7.1
CN5304500000000	53	045	Mason County, WA	2003	NA	22654	20691	1963	8.7
CN5304700000000	53	047	Okanogan County, WA	2003	NA	19764	17882	1882	9.5
CN5304900000000	53	049	Pacific County, WA	2003	NA	9015	8181	834	9.3
CN5305100000000	53	051	Pend Oreille County, WA	2003	NA	4804	4300	504	10.5
CN5305300000000	53	053	Pierce County, WA	2003	NA	348837	320120	28717	8.2
CN5305500000000	53	055	San Juan County, WA	2003	NA	7825	7371	454	5.8
CN5305700000000	53	057	Skagit County, WA	2003	NA	53300	48926	4374	8.2
CN5305900000000	53	059	Skamania County, WA	2003	NA	4738	4255	483	10.2
CN5306100000000	53	061	Snohomish County, WA	2003	NA	335106	311461	23645	7.1
CN5306300000000	53	063	Spokane County, WA	2003	NA	213702	197460	16242	7.6
CN5306500000000	53	065	Stevens County, WA	2003	NA	17601	15892	1709	9.7
CN5306700000000	53	067	Thurston County, WA	2003	NA	115052	107554	7498	6.5
CN5306900000000	53	069	Wahkiakum County, WA	2003	NA	1580	1424	156	9.9
CN5307100000000	53	071	Walla Walla County, WA	2003	NA	28710	26675	2035	7.1
CN5307300000000	53	073	Whatcom County, WA	2003	NA	94539	88113	6426	6.8
CN5307500000000	53	075	Whitman County, WA	2003	NA	19332	18377	955	4.9
CN5307700000000	53	077	Yakima County, WA	2003	NA	113431	102478	10953	9.7
CN5400100000000	54	001	Barbour County, WV	2003	NA	6670	6188	482	7.2
CN5400300000000	54	003	Berkeley County, WV	2003	NA	40419	38540	1879	4.6
CN5400500000000	54	005	Boone County, WV	2003	NA	9406	8815	591	6.3
CN5400700000000	54	007	Braxton County, WV	2003	NA	5937	5495	442	7.4
CN5400900000000	54	009	Brooke County, WV	2003	NA	11317	10601	716	6.3
CN5401100000000	54	011	Cabell County, WV	2003	NA	44073	41860	2213	5
CN5401300000000	54	013	Calhoun County, WV	2003	NA	2906	2572	334	11.5
CN5401500000000	54	015	Clay County, WV	2003	NA	3511	3188	323	9.2
CN5401700000000	54	017	Doddridge County, WV	2003	NA	2874	2704	170	5.9
CN5401900000000	54	019	Fayette County, WV	2003	NA	17819	16508	1311	7.4
CN5402100000000	54	021	Gilmer County, WV	2003	NA	2992	2802	190	6.4
CN5402300000000	54	023	Grant County, WV	2003	NA	5233	4836	397	7.6
CN5402500000000	54	025	Greenbrier County, WV	2003	NA	14937	13990	947	6.3
CN5402700000000	54	027	Hampshire County, WV	2003	NA	9154	8690	464	5.1
CN5402900000000	54	029	Hancock County, WV	2003	NA	14819	13945	874	5.9
CN5403100000000	54	031	Hardy County, WV	2003	NA	6938	6627	311	4.5
CN5403300000000	54	033	Harrison County, WV	2003	NA	30493	28696	1797	5.9
CN5403500000000	54	035	Jackson County, WV	2003	NA	11776	10811	965	8.2
CN5403700000000	54	037	Jefferson County, WV	2003	NA	23149	22278	871	3.8
CN5403900000000	54	039	Kanawha County, WV	2003	NA	91509	86590	4919	5.4
CN5404100000000	54	041	Lewis County, WV	2003	NA	7206	6693	513	7.1
CN5404300000000	54	043	Lincoln County, WV	2003	NA	7878	7285	593	7.5
CN5404500000000	54	045	Logan County, WV	2003	NA	12772	11819	953	7.5
CN5404700000000	54	047	McDowell County, WV	2003	NA	6804	6003	801	11.8
CN5404900000000	54	049	Marion County, WV	2003	NA	25128	23688	1440	5.7
CN5405100000000	54	051	Marshall County, WV	2003	NA	14903	13938	965	6.5
CN5405300000000	54	053	Mason County, WV	2003	NA	10357	9364	993	9.6
CN5405500000000	54	055	Mercer County, WV	2003	NA	24798	23236	1562	6.3
CN5405700000000	54	057	Mineral County, WV	2003	NA	13104	12260	844	6.4
CN5405900000000	54	059	Mingo County, WV	2003	NA	8186	7429	757	9.2
CN5406100000000	54	061	Monongalia County, WV	2003	NA	42500	40653	1847	4.3
CN5406300000000	54	063	Monroe County, WV	2003	NA	5759	5476	283	4.9
CN5406500000000	54	065	Morgan County, WV	2003	NA	6870	6555	315	4.6
CN5406700000000	54	067	Nicholas County, WV	2003	NA	10421	9657	764	7.3
CN5406900000000	54	069	Ohio County, WV	2003	NA	20670	19546	1124	5.4
CN5407100000000	54	071	Pendleton County, WV	2003	NA	3840	3665	175	4.6
CN5407300000000	54	073	Pleasants County, WV	2003	NA	3290	3040	250	7.6
CN5407500000000	54	075	Pocahontas County, WV	2003	NA	4021	3750	271	6.7
CN5407700000000	54	077	Preston County, WV	2003	NA	13783	12917	866	6.3
CN5407900000000	54	079	Putnam County, WV	2003	NA	25740	24436	1304	5.1
CN5408100000000	54	081	Raleigh County, WV	2003	NA	31173	29152	2021	6.5
CN5408300000000	54	083	Randolph County, WV	2003	NA	12525	11718	807	6.4
CN5408500000000	54	085	Ritchie County, WV	2003	NA	4464	4113	351	7.9
CN5408700000000	54	087	Roane County, WV	2003	NA	5476	4995	481	8.8
CN5408900000000	54	089	Summers County, WV	2003	NA	4689	4357	332	7.1
CN5409100000000	54	091	Taylor County, WV	2003	NA	6883	6481	402	5.8
CN5409300000000	54	093	Tucker County, WV	2003	NA	3092	2864	228	7.4
CN5409500000000	54	095	Tyler County, WV	2003	NA	3674	3403	271	7.4
CN5409700000000	54	097	Upshur County, WV	2003	NA	10528	9858	670	6.4
CN5409900000000	54	099	Wayne County, WV	2003	NA	17563	16538	1025	5.8
CN5410100000000	54	101	Webster County, WV	2003	NA	3345	3124	221	6.6
CN5410300000000	54	103	Wetzel County, WV	2003	NA	6588	6049	539	8.2
CN5410500000000	54	105	Wirt County, WV	2003	NA	2549	2309	240	9.4
CN5410700000000	54	107	Wood County, WV	2003	NA	41838	39316	2522	6
CN5410900000000	54	109	Wyoming County, WV	2003	NA	8209	7570	639	7.8
CN5500100000000	55	001	Adams County, WI	2003	NA	9285	8735	550	5.9
CN5500300000000	55	003	Ashland County, WI	2003	NA	9266	8600	666	7.2
CN5500500000000	55	005	Barron County, WI	2003	NA	25968	24388	1580	6.1
CN5500700000000	55	007	Bayfield County, WI	2003	NA	8087	7553	534	6.6
CN5500900000000	55	009	Brown County, WI	2003	NA	136203	128994	7209	5.3
CN5501100000000	55	011	Buffalo County, WI	2003	NA	8421	7983	438	5.2
CN5501300000000	55	013	Burnett County, WI	2003	NA	8470	8000	470	5.5
CN5501500000000	55	015	Calumet County, WI	2003	NA	25346	24089	1257	5
CN5501700000000	55	017	Chippewa County, WI	2003	NA	31823	29791	2032	6.4
CN5501900000000	55	019	Clark County, WI	2003	NA	18464	17326	1138	6.2
CN5502100000000	55	021	Columbia County, WI	2003	NA	31245	29492	1753	5.6
CN5502300000000	55	023	Crawford County, WI	2003	NA	9397	8806	591	6.3
CN5502500000000	55	025	Dane County, WI	2003	NA	280527	270193	10334	3.7
CN5502700000000	55	027	Dodge County, WI	2003	NA	47560	44701	2859	6
CN5502900000000	55	029	Door County, WI	2003	NA	17044	15770	1274	7.5
CN5503100000000	55	031	Douglas County, WI	2003	NA	22972	21533	1439	6.3
CN5503300000000	55	033	Dunn County, WI	2003	NA	24047	22814	1233	5.1
CN5503500000000	55	035	Eau Claire County, WI	2003	NA	54816	52189	2627	4.8
CN5503700000000	55	037	Florence County, WI	2003	NA	2685	2510	175	6.5
CN5503900000000	55	039	Fond du Lac County, WI	2003	NA	57022	53946	3076	5.4
CN5504100000000	55	041	Forest County, WI	2003	NA	5102	4736	366	7.2
CN5504300000000	55	043	Grant County, WI	2003	NA	28795	27306	1489	5.2
CN5504500000000	55	045	Green County, WI	2003	NA	20057	18967	1090	5.4
CN5504700000000	55	047	Green Lake County, WI	2003	NA	10903	10141	762	7
CN5504900000000	55	049	Iowa County, WI	2003	NA	14113	13494	619	4.4
CN5505100000000	55	051	Iron County, WI	2003	NA	3371	3050	321	9.5
CN5505300000000	55	053	Jackson County, WI	2003	NA	10169	9567	602	5.9
CN5505500000000	55	055	Jefferson County, WI	2003	NA	43326	41087	2239	5.2
CN5505700000000	55	057	Juneau County, WI	2003	NA	13157	12181	976	7.4
CN5505900000000	55	059	Kenosha County, WI	2003	NA	82606	77422	5184	6.3
CN5506100000000	55	061	Kewaunee County, WI	2003	NA	11967	11264	703	5.9
CN5506300000000	55	063	La Crosse County, WI	2003	NA	62356	59494	2862	4.6
CN5506500000000	55	065	Lafayette County, WI	2003	NA	9434	8950	484	5.1
CN5506700000000	55	067	Langlade County, WI	2003	NA	11323	10473	850	7.5
CN5506900000000	55	069	Lincoln County, WI	2003	NA	16306	15247	1059	6.5
CN5507100000000	55	071	Manitowoc County, WI	2003	NA	46459	43230	3229	7
CN5507300000000	55	073	Marathon County, WI	2003	NA	74316	70660	3656	4.9
CN5507500000000	55	075	Marinette County, WI	2003	NA	23390	21675	1715	7.3
CN5507700000000	55	077	Marquette County, WI	2003	NA	8013	7360	653	8.1
CN5507800000000	55	078	Menominee County, WI	2003	NA	1718	1528	190	11.1
CN5507900000000	55	079	Milwaukee County, WI	2003	NA	466169	433157	33012	7.1
CN5508100000000	55	081	Monroe County, WI	2003	NA	23357	22177	1180	5.1
CN5508300000000	55	083	Oconto County, WI	2003	NA	20512	19064	1448	7.1
CN5508500000000	55	085	Oneida County, WI	2003	NA	20526	19085	1441	7
CN5508700000000	55	087	Outagamie County, WI	2003	NA	95937	90515	5422	5.7
CN5508900000000	55	089	Ozaukee County, WI	2003	NA	47874	45601	2273	4.7
CN5509100000000	55	091	Pepin County, WI	2003	NA	4032	3833	199	4.9
CN5509300000000	55	093	Pierce County, WI	2003	NA	23062	22023	1039	4.5
CN5509500000000	55	095	Polk County, WI	2003	NA	23997	22330	1667	6.9
CN5509700000000	55	097	Portage County, WI	2003	NA	40511	38437	2074	5.1
CN5509900000000	55	099	Price County, WI	2003	NA	8682	8196	486	5.6
CN5510100000000	55	101	Racine County, WI	2003	NA	100048	92964	7084	7.1
CN5510300000000	55	103	Richland County, WI	2003	NA	10222	9738	484	4.7
CN5510500000000	55	105	Rock County, WI	2003	NA	83037	77856	5181	6.2
CN5510700000000	55	107	Rusk County, WI	2003	NA	7882	7364	518	6.6
CN5510900000000	55	109	St. Croix County, WI	2003	NA	42447	39923	2524	5.9
CN5511100000000	55	111	Sauk County, WI	2003	NA	34951	33280	1671	4.8
CN5511300000000	55	113	Sawyer County, WI	2003	NA	9041	8404	637	7
CN5511500000000	55	115	Shawano County, WI	2003	NA	22985	21688	1297	5.6
CN5511700000000	55	117	Sheboygan County, WI	2003	NA	64458	61155	3303	5.1
CN5511900000000	55	119	Taylor County, WI	2003	NA	11722	11050	672	5.7
CN5512100000000	55	121	Trempealeau County, WI	2003	NA	15885	14960	925	5.8
CN5512300000000	55	123	Vernon County, WI	2003	NA	15324	14513	811	5.3
CN5512500000000	55	125	Vilas County, WI	2003	NA	11688	10870	818	7
CN5512700000000	55	127	Walworth County, WI	2003	NA	56384	53630	2754	4.9
CN5512900000000	55	129	Washburn County, WI	2003	NA	8323	7711	612	7.4
CN5513100000000	55	131	Washington County, WI	2003	NA	71193	67417	3776	5.3
CN5513300000000	55	133	Waukesha County, WI	2003	NA	212988	202595	10393	4.9
CN5513500000000	55	135	Waupaca County, WI	2003	NA	28653	26998	1655	5.8
CN5513700000000	55	137	Waushara County, WI	2003	NA	12749	11904	845	6.6
CN5513900000000	55	139	Winnebago County, WI	2003	NA	92052	87134	4918	5.3
CN5514100000000	55	141	Wood County, WI	2003	NA	41428	38964	2464	5.9
CN5600100000000	56	001	Albany County, WY	2003	NA	18772	18160	612	3.3
CN5600300000000	56	003	Big Horn County, WY	2003	NA	5210	4953	257	4.9
CN5600500000000	56	005	Campbell County, WY	2003	NA	21824	21055	769	3.5
CN5600700000000	56	007	Carbon County, WY	2003	NA	7706	7296	410	5.3
CN5600900000000	56	009	Converse County, WY	2003	NA	6523	6233	290	4.4
CN5601100000000	56	011	Crook County, WY	2003	NA	3128	2998	130	4.2
CN5601300000000	56	013	Fremont County, WY	2003	NA	17884	16893	991	5.5
CN5601500000000	56	015	Goshen County, WY	2003	NA	5875	5616	259	4.4
CN5601700000000	56	017	Hot Springs County, WY	2003	NA	2387	2288	99	4.1
CN5601900000000	56	019	Johnson County, WY	2003	NA	3652	3492	160	4.4
CN5602100000000	56	021	Laramie County, WY	2003	NA	41853	40011	1842	4.4
CN5602300000000	56	023	Lincoln County, WY	2003	NA	8370	8004	366	4.4
CN5602500000000	56	025	Natrona County, WY	2003	NA	38266	36617	1649	4.3
CN5602700000000	56	027	Niobrara County, WY	2003	NA	1149	1096	53	4.6
CN5602900000000	56	029	Park County, WY	2003	NA	14609	13961	648	4.4
CN5603100000000	56	031	Platte County, WY	2003	NA	4078	3872	206	5.1
CN5603300000000	56	033	Sheridan County, WY	2003	NA	15124	14458	666	4.4
CN5603500000000	56	035	Sublette County, WY	2003	NA	4159	4034	125	3
CN5603700000000	56	037	Sweetwater County, WY	2003	NA	20948	20123	825	3.9
CN5603900000000	56	039	Teton County, WY	2003	NA	13709	13233	476	3.5
CN5604100000000	56	041	Uinta County, WY	2003	NA	10976	10488	488	4.4
CN5604300000000	56	043	Washakie County, WY	2003	NA	4233	4046	187	4.4
CN5604500000000	56	045	Weston County, WY	2003	NA	3186	3043	143	4.5
CN7200100000000	72	001	Adjuntas Municipio, PR	2003	NA	5191	4462	729	14
CN7200300000000	72	003	Aguada Municipio, PR	2003	NA	14664	12604	2060	14
CN7200500000000	72	005	Aguadilla Municipio, PR	2003	NA	20953	17864	3089	14.7
CN7200700000000	72	007	Aguas Buenas Municipio, PR	2003	NA	9390	8174	1216	12.9
CN7200900000000	72	009	Aibonito Municipio, PR	2003	NA	7946	6849	1097	13.8
CN7201100000000	72	011	Anasco Municipio, PR	2003	NA	10299	8707	1592	15.5
CN7201300000000	72	013	Arecibo Municipio, PR	2003	NA	33789	29417	4372	12.9
CN7201500000000	72	015	Arroyo Municipio, PR	2003	NA	5455	4479	976	17.9
CN7201700000000	72	017	Barceloneta Municipio, PR	2003	NA	7351	6226	1125	15.3
CN7201900000000	72	019	Barranquitas Municipio, PR	2003	NA	7629	6666	963	12.6
CN7202100000000	72	021	Bayamon Municipio, PR	2003	NA	84691	76993	7698	9.1
CN7202300000000	72	023	Cabo Rojo Municipio, PR	2003	NA	18770	16735	2035	10.8
CN7202500000000	72	025	Caguas Municipio, PR	2003	NA	54619	48519	6100	11.2
CN7202700000000	72	027	Camuy Municipio, PR	2003	NA	12850	11037	1813	14.1
CN7202900000000	72	029	Canovanas Municipio, PR	2003	NA	14263	12221	2042	14.3
CN7203100000000	72	031	Carolina Municipio, PR	2003	NA	78644	71297	7347	9.3
CN7203300000000	72	033	Catano Municipio, PR	2003	NA	8605	7594	1011	11.7
CN7203500000000	72	035	Cayey Municipio, PR	2003	NA	16012	13935	2077	13
CN7203700000000	72	037	Ceiba Municipio, PR	2003	NA	5905	5041	864	14.6
CN7203900000000	72	039	Ciales Municipio, PR	2003	NA	5172	4334	838	16.2
CN7204100000000	72	041	Cidra Municipio, PR	2003	NA	15000	13173	1827	12.2
CN7204300000000	72	043	Coamo Municipio, PR	2003	NA	11656	9978	1678	14.4
CN7204500000000	72	045	Comerio Municipio, PR	2003	NA	4932	4216	716	14.5
CN7204700000000	72	047	Corozal Municipio, PR	2003	NA	10484	9170	1314	12.5
CN7204900000000	72	049	Culebra Municipio, PR	2003	NA	860	810	50	5.8
CN7205100000000	72	051	Dorado Municipio, PR	2003	NA	12665	11344	1321	10.4
CN7205300000000	72	053	Fajardo Municipio, PR	2003	NA	14681	12494	2187	14.9
CN7205400000000	72	054	Florida Municipio, PR	2003	NA	3873	3290	583	15.1
CN7205500000000	72	055	Guanica Municipio, PR	2003	NA	6080	4965	1115	18.3
CN7205700000000	72	057	Guayama Municipio, PR	2003	NA	13939	11673	2266	16.3
CN7205900000000	72	059	Guayanilla Municipio, PR	2003	NA	6490	5360	1130	17.4
CN7206100000000	72	061	Guaynabo Municipio, PR	2003	NA	44679	41639	3040	6.8
CN7206300000000	72	063	Gurabo Municipio, PR	2003	NA	14658	13053	1605	10.9
CN7206500000000	72	065	Hatillo Municipio, PR	2003	NA	12651	10929	1722	13.6
CN7206700000000	72	067	Hormigueros Municipio, PR	2003	NA	6518	5755	763	11.7
CN7206900000000	72	069	Humacao Municipio, PR	2003	NA	21042	17812	3230	15.4
CN7207100000000	72	071	Isabela Municipio, PR	2003	NA	14864	12650	2214	14.9
CN7207300000000	72	073	Jayuya Municipio, PR	2003	NA	4952	4310	642	13
CN7207500000000	72	075	Juana Diaz Municipio, PR	2003	NA	15783	13600	2183	13.8
CN7207700000000	72	077	Juncos Municipio, PR	2003	NA	12679	11009	1670	13.2
CN7207900000000	72	079	Lajas Municipio, PR	2003	NA	8366	7222	1144	13.7
CN7208100000000	72	081	Lares Municipio, PR	2003	NA	10905	9402	1503	13.8
CN7208300000000	72	083	Las Marias Municipio, PR	2003	NA	3965	3422	543	13.7
CN7208500000000	72	085	Las Piedras Municipio, PR	2003	NA	12347	10601	1746	14.1
CN7208700000000	72	087	Loiza Municipio, PR	2003	NA	8822	7591	1231	14
CN7208900000000	72	089	Luquillo Municipio, PR	2003	NA	7072	5781	1291	18.3
CN7209100000000	72	091	Manati Municipio, PR	2003	NA	14588	12403	2185	15
CN7209300000000	72	093	Maricao Municipio, PR	2003	NA	2212	1920	292	13.2
CN7209500000000	72	095	Maunabo Municipio, PR	2003	NA	3792	3026	766	20.2
CN7209700000000	72	097	Mayaguez Municipio, PR	2003	NA	31725	27037	4688	14.8
CN7209900000000	72	099	Moca Municipio, PR	2003	NA	14059	12019	2040	14.5
CN7210100000000	72	101	Morovis Municipio, PR	2003	NA	8975	7663	1312	14.6
CN7210300000000	72	103	Naguabo Municipio, PR	2003	NA	7575	6368	1207	15.9
CN7210500000000	72	105	Naranjito Municipio, PR	2003	NA	8692	7674	1018	11.7
CN7210700000000	72	107	Orocovis Municipio, PR	2003	NA	5408	4593	815	15.1
CN7210900000000	72	109	Patillas Municipio, PR	2003	NA	5852	4761	1091	18.6
CN7211100000000	72	111	Penuelas Municipio, PR	2003	NA	8151	6791	1360	16.7
CN7211300000000	72	113	Ponce Municipio, PR	2003	NA	60829	53311	7518	12.4
CN7211500000000	72	115	Quebradillas Municipio, PR	2003	NA	8546	7409	1137	13.3
CN7211700000000	72	117	Rincon Municipio, PR	2003	NA	5118	4414	704	13.8
CN7211900000000	72	119	Rio Grande Municipio, PR	2003	NA	17868	15541	2327	13
CN7212100000000	72	121	Sabana Grande Municipio, PR	2003	NA	8822	7569	1253	14.2
CN7212300000000	72	123	Salinas Municipio, PR	2003	NA	8916	7390	1526	17.1
CN7212500000000	72	125	San German Municipio, PR	2003	NA	12551	10769	1782	14.2
CN7212700000000	72	127	San Juan Municipio, PR	2003	NA	175396	160298	15098	8.6
CN7212900000000	72	129	San Lorenzo Municipio, PR	2003	NA	13993	12328	1665	11.9
CN7213100000000	72	131	San Sebastian Municipio, PR	2003	NA	14598	12345	2253	15.4
CN7213300000000	72	133	Santa Isabel Municipio, PR	2003	NA	9027	7862	1165	12.9
CN7213500000000	72	135	Toa Alta Municipio, PR	2003	NA	26919	24620	2299	8.5
CN7213700000000	72	137	Toa Baja Municipio, PR	2003	NA	36090	32736	3354	9.3
CN7213900000000	72	139	Trujillo Alto Municipio, PR	2003	NA	33536	30780	2756	8.2
CN7214100000000	72	141	Utuado Municipio, PR	2003	NA	9539	8055	1484	15.6
CN7214300000000	72	143	Vega Alta Municipio, PR	2003	NA	12451	10971	1480	11.9
CN7214500000000	72	145	Vega Baja Municipio, PR	2003	NA	20789	18031	2758	13.3
CN7214700000000	72	147	Vieques Municipio, PR	2003	NA	2664	2234	430	16.1
CN7214900000000	72	149	Villalba Municipio, PR	2003	NA	8393	7134	1259	15
CN7215100000000	72	151	Yabucoa Municipio, PR	2003	NA	11393	9162	2231	19.6
CN7215300000000	72	153	Yauco Municipio, PR	2003	NA	15161	12974	2187	14.4
NA	NA	NA	NA	NA	NA	NA	NA	NA	NA
SOURCE:  BLS, LAUS	NA	NA	NA	NA	NA	NA	NA	NA	NA
March 18, 2016	NA	NA	NA	NA	NA	NA	NA	NA	NA
