LAUS_CODE	STATE_FIPS	COUNTY_FIPS	COUNTY	YEAR	ESTIMATED	LABOR_FORCE	EMPLOYED	UNEMPLOYED_LEVEL	UNEMPLOYED_RATE
CN0100100000000	01	001	Autauga County, AL	2005	NA	23949	23037	912	3.8
CN0100300000000	01	003	Baldwin County, AL	2005	NA	76804	73743	3061	4
CN0100500000000	01	005	Barbour County, AL	2005	NA	10760	10136	624	5.8
CN0100700000000	01	007	Bibb County, AL	2005	NA	8861	8463	398	4.5
CN0100900000000	01	009	Blount County, AL	2005	NA	26446	25491	955	3.6
CN0101100000000	01	011	Bullock County, AL	2005	NA	3747	3391	356	9.5
CN0101300000000	01	013	Butler County, AL	2005	NA	9139	8547	592	6.5
CN0101500000000	01	015	Calhoun County, AL	2005	NA	53955	51524	2431	4.5
CN0101700000000	01	017	Chambers County, AL	2005	NA	16353	15413	940	5.7
CN0101900000000	01	019	Cherokee County, AL	2005	NA	12044	11519	525	4.4
CN0102100000000	01	021	Chilton County, AL	2005	NA	19674	18901	773	3.9
CN0102300000000	01	023	Choctaw County, AL	2005	NA	5300	4951	349	6.6
CN0102500000000	01	025	Clarke County, AL	2005	NA	10126	9478	648	6.4
CN0102700000000	01	027	Clay County, AL	2005	NA	5950	5655	295	5
CN0102900000000	01	029	Cleburne County, AL	2005	NA	6659	6396	263	3.9
CN0103100000000	01	031	Coffee County, AL	2005	NA	20104	19320	784	3.9
CN0103300000000	01	033	Colbert County, AL	2005	NA	24960	23610	1350	5.4
CN0103500000000	01	035	Conecuh County, AL	2005	NA	5188	4866	322	6.2
CN0103700000000	01	037	Coosa County, AL	2005	NA	4892	4645	247	5
CN0103900000000	01	039	Covington County, AL	2005	NA	16933	16167	766	4.5
CN0104100000000	01	041	Crenshaw County, AL	2005	NA	6186	5882	304	4.9
CN0104300000000	01	043	Cullman County, AL	2005	NA	38494	36946	1548	4
CN0104500000000	01	045	Dale County, AL	2005	NA	20168	19269	899	4.5
CN0104700000000	01	047	Dallas County, AL	2005	NA	16007	14636	1371	8.6
CN0104900000000	01	049	DeKalb County, AL	2005	NA	31239	29648	1591	5.1
CN0105100000000	01	051	Elmore County, AL	2005	NA	34448	33157	1291	3.7
CN0105300000000	01	053	Escambia County, AL	2005	NA	14329	13530	799	5.6
CN0105500000000	01	055	Etowah County, AL	2005	NA	46762	44542	2220	4.7
CN0105700000000	01	057	Fayette County, AL	2005	NA	7886	7533	353	4.5
CN0105900000000	01	059	Franklin County, AL	2005	NA	13789	13059	730	5.3
CN0106100000000	01	061	Geneva County, AL	2005	NA	11628	11174	454	3.9
CN0106300000000	01	063	Greene County, AL	2005	NA	3456	3225	231	6.7
CN0106500000000	01	065	Hale County, AL	2005	NA	7053	6669	384	5.4
CN0106700000000	01	067	Henry County, AL	2005	NA	7469	7146	323	4.3
CN0106900000000	01	069	Houston County, AL	2005	NA	46102	44334	1768	3.8
CN0107100000000	01	071	Jackson County, AL	2005	NA	26776	25427	1349	5
CN0107300000000	01	073	Jefferson County, AL	2005	NA	317359	303260	14099	4.4
CN0107500000000	01	075	Lamar County, AL	2005	NA	6132	5788	344	5.6
CN0107700000000	01	077	Lauderdale County, AL	2005	NA	42063	39905	2158	5.1
CN0107900000000	01	079	Lawrence County, AL	2005	NA	15979	15087	892	5.6
CN0108100000000	01	081	Lee County, AL	2005	NA	63530	61161	2369	3.7
CN0108300000000	01	083	Limestone County, AL	2005	NA	35123	33561	1562	4.4
CN0108500000000	01	085	Lowndes County, AL	2005	NA	4952	4554	398	8
CN0108700000000	01	087	Macon County, AL	2005	NA	8705	8191	514	5.9
CN0108900000000	01	089	Madison County, AL	2005	NA	158767	153075	5692	3.6
CN0109100000000	01	091	Marengo County, AL	2005	NA	8603	8109	494	5.7
CN0109300000000	01	093	Marion County, AL	2005	NA	13536	12929	607	4.5
CN0109500000000	01	095	Marshall County, AL	2005	NA	41954	40314	1640	3.9
CN0109700000000	01	097	Mobile County, AL	2005	NA	180384	171439	8945	5
CN0109900000000	01	099	Monroe County, AL	2005	NA	9587	8996	591	6.2
CN0110100000000	01	101	Montgomery County, AL	2005	NA	105148	100336	4812	4.6
CN0110300000000	01	103	Morgan County, AL	2005	NA	55700	53187	2513	4.5
CN0110500000000	01	105	Perry County, AL	2005	NA	3537	3215	322	9.1
CN0110700000000	01	107	Pickens County, AL	2005	NA	7960	7527	433	5.4
CN0110900000000	01	109	Pike County, AL	2005	NA	15013	14401	612	4.1
CN0111100000000	01	111	Randolph County, AL	2005	NA	9823	9218	605	6.2
CN0111300000000	01	113	Russell County, AL	2005	NA	21501	20203	1298	6
CN0111500000000	01	115	St. Clair County, AL	2005	NA	33750	32407	1343	4
CN0111700000000	01	117	Shelby County, AL	2005	NA	94699	91783	2916	3.1
CN0111900000000	01	119	Sumter County, AL	2005	NA	4865	4512	353	7.3
CN0112100000000	01	121	Talladega County, AL	2005	NA	39684	37777	1907	4.8
CN0112300000000	01	123	Tallapoosa County, AL	2005	NA	18587	17748	839	4.5
CN0112500000000	01	125	Tuscaloosa County, AL	2005	NA	84810	81638	3172	3.7
CN0112700000000	01	127	Walker County, AL	2005	NA	29772	28455	1317	4.4
CN0112900000000	01	129	Washington County, AL	2005	NA	6887	6458	429	6.2
CN0113100000000	01	131	Wilcox County, AL	2005	NA	3626	3290	336	9.3
CN0113300000000	01	133	Winston County, AL	2005	NA	10365	9840	525	5.1
CN0201300000000	02	013	Aleutians East Borough, AK	2005	NA	1077	974	103	9.6
CN0201600000000	02	016	Aleutians West Census Area, AK	2005	NA	3143	2963	180	5.7
CN0202000000000	02	020	Anchorage Borough/municipality, AK	2005	NA	149028	140840	8188	5.5
CN0205000000000	02	050	Bethel Census Area, AK	2005	NA	7089	6182	907	12.8
CN0206000000000	02	060	Bristol Bay Borough, AK	2005	NA	971	914	57	5.9
CN0206800000000	02	068	Denali Borough, AK	2005	NA	1590	1486	104	6.5
CN0207000000000	02	070	Dillingham Census Area, AK	2005	NA	2062	1842	220	10.7
CN0209000000000	02	090	Fairbanks North Star Borough, AK	2005	NA	45247	42606	2641	5.8
CN0210000000000	02	100	Haines Borough, AK	2005	NA	1472	1340	132	9
CN0211000000000	02	110	Juneau Borough/city, AK	2005	NA	18349	17370	979	5.3
CN0212200000000	02	122	Kenai Peninsula Borough, AK	2005	NA	25321	23105	2216	8.8
CN0213000000000	02	130	Ketchikan Gateway Borough, AK	2005	NA	7966	7430	536	6.7
CN0215000000000	02	150	Kodiak Island Borough, AK	2005	NA	6056	5556	500	8.3
CN0215800000000	02	158	Kusilvak Census Area, AK	2005	NA	2542	2011	531	20.9
CN0216400000000	02	164	Lake and Peninsula Borough, AK	2005	NA	1040	964	76	7.3
CN0217000000000	02	170	Matanuska-Susitna Borough, AK	2005	NA	36728	33928	2800	7.6
CN0218000000000	02	180	Nome Census Area, AK	2005	NA	3979	3486	493	12.4
CN0218500000000	02	185	North Slope Borough, AK	2005	NA	3719	3384	335	9
CN0218800000000	02	188	Northwest Arctic Borough, AK	2005	NA	3062	2698	364	11.9
CN0220100000000	02	201	Prince of Wales-Outer Ketchikan Census Area, AK	2005	NA	2568	2232	336	13.1
CN0222000000000	02	220	Sitka Borough/city, AK	2005	NA	4745	4481	264	5.6
CN0223200000000	02	232	Skagway-Hoonah-Angoon Census Area, AK	2005	NA	1846	1601	245	13.3
CN0224000000000	02	240	Southeast Fairbanks Census Area, AK	2005	NA	3310	2963	347	10.5
CN0226100000000	02	261	Valdez-Cordova Census Area, AK	2005	NA	5264	4764	500	9.5
CN0228000000000	02	280	Wrangell-Petersburg Census Area, AK	2005	NA	2931	2635	296	10.1
CN0228200000000	02	282	Yakutat Borough/city, AK	2005	NA	320	286	34	10.6
CN0229000000000	02	290	Yukon-Koyukuk Census Area, AK	2005	NA	3139	2772	367	11.7
CN0400100000000	04	001	Apache County, AZ	2005	NA	20054	17952	2102	10.5
CN0400300000000	04	003	Cochise County, AZ	2005	NA	55774	53097	2677	4.8
CN0400500000000	04	005	Coconino County, AZ	2005	NA	67883	64549	3334	4.9
CN0400700000000	04	007	Gila County, AZ	2005	NA	20667	19446	1221	5.9
CN0400900000000	04	009	Graham County, AZ	2005	NA	12261	11525	736	6
CN0401100000000	04	011	Greenlee County, AZ	2005	NA	3493	3324	169	4.8
CN0401200000000	04	012	La Paz County, AZ	2005	NA	7703	7181	522	6.8
CN0401300000000	04	013	Maricopa County, AZ	2005	NA	1856076	1780954	75122	4
CN0401500000000	04	015	Mohave County, AZ	2005	NA	89079	85271	3808	4.3
CN0401700000000	04	017	Navajo County, AZ	2005	NA	37680	34646	3034	8.1
CN0401900000000	04	019	Pima County, AZ	2005	NA	441581	421815	19766	4.5
CN0402100000000	04	021	Pinal County, AZ	2005	NA	87422	82541	4881	5.6
CN0402300000000	04	023	Santa Cruz County, AZ	2005	NA	16043	14663	1380	8.6
CN0402500000000	04	025	Yavapai County, AZ	2005	NA	91442	87403	4039	4.4
CN0402700000000	04	027	Yuma County, AZ	2005	NA	76067	64004	12063	15.9
CN0500100000000	05	001	Arkansas County, AR	2005	NA	11321	10525	796	7
CN0500300000000	05	003	Ashley County, AR	2005	NA	9646	8844	802	8.3
CN0500500000000	05	005	Baxter County, AR	2005	NA	17214	16254	960	5.6
CN0500700000000	05	007	Benton County, AR	2005	NA	100203	96959	3244	3.2
CN0500900000000	05	009	Boone County, AR	2005	NA	16729	15875	854	5.1
CN0501100000000	05	011	Bradley County, AR	2005	NA	5507	5074	433	7.9
CN0501300000000	05	013	Calhoun County, AR	2005	NA	2686	2502	184	6.9
CN0501500000000	05	015	Carroll County, AR	2005	NA	13545	12929	616	4.5
CN0501700000000	05	017	Chicot County, AR	2005	NA	4892	4403	489	10
CN0501900000000	05	019	Clark County, AR	2005	NA	11051	10375	676	6.1
CN0502100000000	05	021	Clay County, AR	2005	NA	7091	6497	594	8.4
CN0502300000000	05	023	Cleburne County, AR	2005	NA	11633	11063	570	4.9
CN0502500000000	05	025	Cleveland County, AR	2005	NA	4273	4023	250	5.9
CN0502700000000	05	027	Columbia County, AR	2005	NA	11089	10385	704	6.3
CN0502900000000	05	029	Conway County, AR	2005	NA	9660	9164	496	5.1
CN0503100000000	05	031	Craighead County, AR	2005	NA	45084	42935	2149	4.8
CN0503300000000	05	033	Crawford County, AR	2005	NA	27438	26244	1194	4.4
CN0503500000000	05	035	Crittenden County, AR	2005	NA	22513	21044	1469	6.5
CN0503700000000	05	037	Cross County, AR	2005	NA	8502	7856	646	7.6
CN0503900000000	05	039	Dallas County, AR	2005	NA	3868	3597	271	7
CN0504100000000	05	041	Desha County, AR	2005	NA	6089	5561	528	8.7
CN0504300000000	05	043	Drew County, AR	2005	NA	8680	7944	736	8.5
CN0504500000000	05	045	Faulkner County, AR	2005	NA	52018	49704	2314	4.4
CN0504700000000	05	047	Franklin County, AR	2005	NA	8521	8156	365	4.3
CN0504900000000	05	049	Fulton County, AR	2005	NA	5096	4825	271	5.3
CN0505100000000	05	051	Garland County, AR	2005	NA	41936	39562	2374	5.7
CN0505300000000	05	053	Grant County, AR	2005	NA	8663	8242	421	4.9
CN0505500000000	05	055	Greene County, AR	2005	NA	18769	17679	1090	5.8
CN0505700000000	05	057	Hempstead County, AR	2005	NA	10907	10278	629	5.8
CN0505900000000	05	059	Hot Spring County, AR	2005	NA	15158	14358	800	5.3
CN0506100000000	05	061	Howard County, AR	2005	NA	6252	5905	347	5.6
CN0506300000000	05	063	Independence County, AR	2005	NA	17860	16770	1090	6.1
CN0506500000000	05	065	Izard County, AR	2005	NA	5254	4917	337	6.4
CN0506700000000	05	067	Jackson County, AR	2005	NA	7797	7148	649	8.3
CN0506900000000	05	069	Jefferson County, AR	2005	NA	37037	34229	2808	7.6
CN0507100000000	05	071	Johnson County, AR	2005	NA	10992	10455	537	4.9
CN0507300000000	05	073	Lafayette County, AR	2005	NA	3218	2979	239	7.4
CN0507500000000	05	075	Lawrence County, AR	2005	NA	7517	6955	562	7.5
CN0507700000000	05	077	Lee County, AR	2005	NA	3410	3051	359	10.5
CN0507900000000	05	079	Lincoln County, AR	2005	NA	5251	4854	397	7.6
CN0508100000000	05	081	Little River County, AR	2005	NA	6529	6223	306	4.7
CN0508300000000	05	083	Logan County, AR	2005	NA	10076	9580	496	4.9
CN0508500000000	05	085	Lonoke County, AR	2005	NA	30788	29414	1374	4.5
CN0508700000000	05	087	Madison County, AR	2005	NA	7835	7544	291	3.7
CN0508900000000	05	089	Marion County, AR	2005	NA	6801	6450	351	5.2
CN0509100000000	05	091	Miller County, AR	2005	NA	19724	18778	946	4.8
CN0509300000000	05	093	Mississippi County, AR	2005	NA	20201	18456	1745	8.6
CN0509500000000	05	095	Monroe County, AR	2005	NA	3864	3607	257	6.7
CN0509700000000	05	097	Montgomery County, AR	2005	NA	4343	4130	213	4.9
CN0509900000000	05	099	Nevada County, AR	2005	NA	4396	4142	254	5.8
CN0510100000000	05	101	Newton County, AR	2005	NA	3598	3415	183	5.1
CN0510300000000	05	103	Ouachita County, AR	2005	NA	12590	11705	885	7
CN0510500000000	05	105	Perry County, AR	2005	NA	4966	4712	254	5.1
CN0510700000000	05	107	Phillips County, AR	2005	NA	8837	8033	804	9.1
CN0510900000000	05	109	Pike County, AR	2005	NA	5156	4907	249	4.8
CN0511100000000	05	111	Poinsett County, AR	2005	NA	11483	10722	761	6.6
CN0511300000000	05	113	Polk County, AR	2005	NA	8701	8264	437	5
CN0511500000000	05	115	Pope County, AR	2005	NA	29572	28246	1326	4.5
CN0511700000000	05	117	Prairie County, AR	2005	NA	4310	4053	257	6
CN0511900000000	05	119	Pulaski County, AR	2005	NA	190594	181400	9194	4.8
CN0512100000000	05	121	Randolph County, AR	2005	NA	7872	7256	616	7.8
CN0512300000000	05	123	St. Francis County, AR	2005	NA	10805	9882	923	8.5
CN0512500000000	05	125	Saline County, AR	2005	NA	47337	45291	2046	4.3
CN0512700000000	05	127	Scott County, AR	2005	NA	4688	4476	212	4.5
CN0512900000000	05	129	Searcy County, AR	2005	NA	3422	3251	171	5
CN0513100000000	05	131	Sebastian County, AR	2005	NA	59664	57117	2547	4.3
CN0513300000000	05	133	Sevier County, AR	2005	NA	7655	7330	325	4.2
CN0513500000000	05	135	Sharp County, AR	2005	NA	6565	6092	473	7.2
CN0513700000000	05	137	Stone County, AR	2005	NA	4514	4220	294	6.5
CN0513900000000	05	139	Union County, AR	2005	NA	20130	18747	1383	6.9
CN0514100000000	05	141	Van Buren County, AR	2005	NA	7018	6585	433	6.2
CN0514300000000	05	143	Washington County, AR	2005	NA	100890	97492	3398	3.4
CN0514500000000	05	145	White County, AR	2005	NA	32508	30453	2055	6.3
CN0514700000000	05	147	Woodruff County, AR	2005	NA	3462	3145	317	9.2
CN0514900000000	05	149	Yell County, AR	2005	NA	10659	10213	446	4.2
CN0600100000000	06	001	Alameda County, CA	2005	NA	734258	696792	37466	5.1
CN0600300000000	06	003	Alpine County, CA	2005	NA	526	484	42	8
CN0600500000000	06	005	Amador County, CA	2005	NA	17199	16237	962	5.6
CN0600700000000	06	007	Butte County, CA	2005	NA	98309	91677	6632	6.7
CN0600900000000	06	009	Calaveras County, CA	2005	NA	20528	19247	1281	6.2
CN0601100000000	06	011	Colusa County, CA	2005	NA	9880	8627	1253	12.7
CN0601300000000	06	013	Contra Costa County, CA	2005	NA	509864	485198	24666	4.8
CN0601500000000	06	015	Del Norte County, CA	2005	NA	10736	9940	796	7.4
CN0601700000000	06	017	El Dorado County, CA	2005	NA	91050	86697	4353	4.8
CN0601900000000	06	019	Fresno County, CA	2005	NA	407163	370589	36574	9
CN0602100000000	06	021	Glenn County, CA	2005	NA	11535	10565	970	8.4
CN0602300000000	06	023	Humboldt County, CA	2005	NA	59523	55891	3632	6.1
CN0602500000000	06	025	Imperial County, CA	2005	NA	60592	50920	9672	16
CN0602700000000	06	027	Inyo County, CA	2005	NA	9282	8828	454	4.9
CN0602900000000	06	029	Kern County, CA	2005	NA	326748	299406	27342	8.4
CN0603100000000	06	031	Kings County, CA	2005	NA	53840	48757	5083	9.4
CN0603300000000	06	033	Lake County, CA	2005	NA	25985	23927	2058	7.9
CN0603500000000	06	035	Lassen County, CA	2005	NA	12247	11265	982	8
CN0603700000000	06	037	Los Angeles County, CA	2005	NA	4781604	4525223	256381	5.4
CN0603900000000	06	039	Madera County, CA	2005	NA	61881	57015	4866	7.9
CN0604100000000	06	041	Marin County, CA	2005	NA	129095	124094	5001	3.9
CN0604300000000	06	043	Mariposa County, CA	2005	NA	8790	8231	559	6.4
CN0604500000000	06	045	Mendocino County, CA	2005	NA	43841	41325	2516	5.7
CN0604700000000	06	047	Merced County, CA	2005	NA	98738	88880	9858	10
CN0604900000000	06	049	Modoc County, CA	2005	NA	4001	3683	318	7.9
CN0605100000000	06	051	Mono County, CA	2005	NA	8340	7937	403	4.8
CN0605300000000	06	053	Monterey County, CA	2005	NA	206565	191535	15030	7.3
CN0605500000000	06	055	Napa County, CA	2005	NA	71328	68214	3114	4.4
CN0605700000000	06	057	Nevada County, CA	2005	NA	49237	46884	2353	4.8
CN0605900000000	06	059	Orange County, CA	2005	NA	1585916	1526586	59330	3.7
CN0606100000000	06	061	Placer County, CA	2005	NA	164249	157181	7068	4.3
CN0606300000000	06	063	Plumas County, CA	2005	NA	10131	9278	853	8.4
CN0606500000000	06	065	Riverside County, CA	2005	NA	852578	806877	45701	5.4
CN0606700000000	06	067	Sacramento County, CA	2005	NA	664327	631504	32823	4.9
CN0606900000000	06	069	San Benito County, CA	2005	NA	24499	22526	1973	8.1
CN0607100000000	06	071	San Bernardino County, CA	2005	NA	851470	807163	44307	5.2
CN0607300000000	06	073	San Diego County, CA	2005	NA	1489799	1425706	64093	4.3
CN0607500000000	06	075	San Francisco County/city, CA	2005	NA	413337	392747	20590	5
CN0607700000000	06	077	San Joaquin County, CA	2005	NA	283588	261289	22299	7.9
CN0607900000000	06	079	San Luis Obispo County, CA	2005	NA	131479	125879	5600	4.3
CN0608100000000	06	081	San Mateo County, CA	2005	NA	360298	345017	15281	4.2
CN0608300000000	06	083	Santa Barbara County, CA	2005	NA	213206	203962	9244	4.3
CN0608500000000	06	085	Santa Clara County, CA	2005	NA	815361	772046	43315	5.3
CN0608700000000	06	087	Santa Cruz County, CA	2005	NA	142992	134029	8963	6.3
CN0608900000000	06	089	Shasta County, CA	2005	NA	81748	75826	5922	7.2
CN0609100000000	06	091	Sierra County, CA	2005	NA	1580	1449	131	8.3
CN0609300000000	06	093	Siskiyou County, CA	2005	NA	18648	16970	1678	9
CN0609500000000	06	095	Solano County, CA	2005	NA	208486	197341	11145	5.3
CN0609700000000	06	097	Sonoma County, CA	2005	NA	253410	242205	11205	4.4
CN0609900000000	06	099	Stanislaus County, CA	2005	NA	226627	207585	19042	8.4
CN0610100000000	06	101	Sutter County, CA	2005	NA	39999	36145	3854	9.6
CN0610300000000	06	103	Tehama County, CA	2005	NA	25199	23470	1729	6.9
CN0610500000000	06	105	Trinity County, CA	2005	NA	5170	4642	528	10.2
CN0610700000000	06	107	Tulare County, CA	2005	NA	183305	166019	17286	9.4
CN0610900000000	06	109	Tuolumne County, CA	2005	NA	25983	24312	1671	6.4
CN0611100000000	06	111	Ventura County, CA	2005	NA	415958	396225	19733	4.7
CN0611300000000	06	113	Yolo County, CA	2005	NA	92358	87237	5121	5.5
CN0611500000000	06	115	Yuba County, CA	2005	NA	25684	23368	2316	9
CN0800100000000	08	001	Adams County, CO	2005	NA	209927	197954	11973	5.7
CN0800300000000	08	003	Alamosa County, CO	2005	NA	8138	7694	444	5.5
CN0800500000000	08	005	Arapahoe County, CO	2005	NA	298738	283637	15101	5.1
CN0800700000000	08	007	Archuleta County, CO	2005	NA	5984	5676	308	5.1
CN0800900000000	08	009	Baca County, CO	2005	NA	2268	2181	87	3.8
CN0801100000000	08	011	Bent County, CO	2005	NA	2380	2231	149	6.3
CN0801300000000	08	013	Boulder County, CO	2005	NA	168036	160654	7382	4.4
CN0801400000000	08	014	Broomfield County/city, CO	2005	NA	24506	23324	1182	4.8
CN0801500000000	08	015	Chaffee County, CO	2005	NA	8179	7744	435	5.3
CN0801700000000	08	017	Cheyenne County, CO	2005	NA	1349	1308	41	3
CN0801900000000	08	019	Clear Creek County, CO	2005	NA	5837	5563	274	4.7
CN0802100000000	08	021	Conejos County, CO	2005	NA	3777	3484	293	7.8
CN0802300000000	08	023	Costilla County, CO	2005	NA	1346	1210	136	10.1
CN0802500000000	08	025	Crowley County, CO	2005	NA	1604	1478	126	7.9
CN0802700000000	08	027	Custer County, CO	2005	NA	2015	1920	95	4.7
CN0802900000000	08	029	Delta County, CO	2005	NA	15256	14492	764	5
CN0803100000000	08	031	Denver County/city, CO	2005	NA	302009	284892	17117	5.7
CN0803300000000	08	033	Dolores County, CO	2005	NA	978	910	68	7
CN0803500000000	08	035	Douglas County, CO	2005	NA	142904	137000	5904	4.1
CN0803700000000	08	037	Eagle County, CO	2005	NA	28407	27325	1082	3.8
CN0803900000000	08	039	Elbert County, CO	2005	NA	12895	12309	586	4.5
CN0804100000000	08	041	El Paso County, CO	2005	NA	289307	274069	15238	5.3
CN0804300000000	08	043	Fremont County, CO	2005	NA	19249	18067	1182	6.1
CN0804500000000	08	045	Garfield County, CO	2005	NA	29793	28683	1110	3.7
CN0804700000000	08	047	Gilpin County, CO	2005	NA	3337	3177	160	4.8
CN0804900000000	08	049	Grand County, CO	2005	NA	8387	8047	340	4.1
CN0805100000000	08	051	Gunnison County, CO	2005	NA	9008	8655	353	3.9
CN0805300000000	08	053	Hinsdale County, CO	2005	NA	597	580	17	2.8
CN0805500000000	08	055	Huerfano County, CO	2005	NA	3257	3005	252	7.7
CN0805700000000	08	057	Jackson County, CO	2005	NA	1135	1090	45	4
CN0805900000000	08	059	Jefferson County, CO	2005	NA	304514	289606	14908	4.9
CN0806100000000	08	061	Kiowa County, CO	2005	NA	877	841	36	4.1
CN0806300000000	08	063	Kit Carson County, CO	2005	NA	4341	4193	148	3.4
CN0806500000000	08	065	Lake County, CO	2005	NA	3925	3732	193	4.9
CN0806700000000	08	067	La Plata County, CO	2005	NA	29763	28637	1126	3.8
CN0806900000000	08	069	Larimer County, CO	2005	NA	165944	158693	7251	4.4
CN0807100000000	08	071	Las Animas County, CO	2005	NA	8121	7713	408	5
CN0807300000000	08	073	Lincoln County, CO	2005	NA	3025	2902	123	4.1
CN0807500000000	08	075	Logan County, CO	2005	NA	10613	10189	424	4
CN0807700000000	08	077	Mesa County, CO	2005	NA	70811	67350	3461	4.9
CN0807900000000	08	079	Mineral County, CO	2005	NA	459	436	23	5
CN0808100000000	08	081	Moffat County, CO	2005	NA	7832	7484	348	4.4
CN0808300000000	08	083	Montezuma County, CO	2005	NA	12859	12188	671	5.2
CN0808500000000	08	085	Montrose County, CO	2005	NA	19741	18813	928	4.7
CN0808700000000	08	087	Morgan County, CO	2005	NA	14282	13675	607	4.3
CN0808900000000	08	089	Otero County, CO	2005	NA	9323	8730	593	6.4
CN0809100000000	08	091	Ouray County, CO	2005	NA	2934	2833	101	3.4
CN0809300000000	08	093	Park County, CO	2005	NA	9638	9186	452	4.7
CN0809500000000	08	095	Phillips County, CO	2005	NA	2277	2198	79	3.5
CN0809700000000	08	097	Pitkin County, CO	2005	NA	11083	10641	442	4
CN0809900000000	08	099	Prowers County, CO	2005	NA	7437	7086	351	4.7
CN0810100000000	08	101	Pueblo County, CO	2005	NA	69326	64606	4720	6.8
CN0810300000000	08	103	Rio Blanco County, CO	2005	NA	3979	3840	139	3.5
CN0810500000000	08	105	Rio Grande County, CO	2005	NA	6520	6141	379	5.8
CN0810700000000	08	107	Routt County, CO	2005	NA	14515	13984	531	3.7
CN0810900000000	08	109	Saguache County, CO	2005	NA	3074	2844	230	7.5
CN0811100000000	08	111	San Juan County, CO	2005	NA	508	471	37	7.3
CN0811300000000	08	113	San Miguel County, CO	2005	NA	5210	4989	221	4.2
CN0811500000000	08	115	Sedgwick County, CO	2005	NA	1617	1567	50	3.1
CN0811700000000	08	117	Summit County, CO	2005	NA	16264	15649	615	3.8
CN0811900000000	08	119	Teller County, CO	2005	NA	12597	11975	622	4.9
CN0812100000000	08	121	Washington County, CO	2005	NA	2754	2650	104	3.8
CN0812300000000	08	123	Weld County, CO	2005	NA	111087	105019	6068	5.5
CN0812500000000	08	125	Yuma County, CO	2005	NA	6062	5872	190	3.1
CN0900100000000	09	001	Fairfield County, CT	2005	NA	451803	431973	19830	4.4
CN0900300000000	09	003	Hartford County, CT	2005	NA	437887	414699	23188	5.3
CN0900500000000	09	005	Litchfield County, CT	2005	NA	102186	97509	4677	4.6
CN0900700000000	09	007	Middlesex County, CT	2005	NA	89289	85484	3805	4.3
CN0900900000000	09	009	New Haven County, CT	2005	NA	429962	407064	22898	5.3
CN0901100000000	09	011	New London County, CT	2005	NA	144132	137659	6473	4.5
CN0901300000000	09	013	Tolland County, CT	2005	NA	80817	77419	3398	4.2
CN0901500000000	09	015	Windham County, CT	2005	NA	60903	57577	3326	5.5
CN1000100000000	10	001	Kent County, DE	2005	NA	72015	69394	2621	3.6
CN1000300000000	10	003	New Castle County, DE	2005	NA	270152	258145	12007	4.4
CN1000500000000	10	005	Sussex County, DE	2005	NA	90242	86926	3316	3.7
CN1100100000000	11	001	District of Columbia	2005	NA	315616	295484	20132	6.4
CN1200100000000	12	001	Alachua County, FL	2005	NA	123550	119924	3626	2.9
CN1200300000000	12	003	Baker County, FL	2005	NA	11112	10751	361	3.2
CN1200500000000	12	005	Bay County, FL	2005	NA	82406	79474	2932	3.6
CN1200700000000	12	007	Bradford County, FL	2005	NA	11709	11334	375	3.2
CN1200900000000	12	009	Brevard County, FL	2005	NA	260435	250969	9466	3.6
CN1201100000000	12	011	Broward County, FL	2005	NA	957619	922294	35325	3.7
CN1201300000000	12	013	Calhoun County, FL	2005	NA	5247	5050	197	3.8
CN1201500000000	12	015	Charlotte County, FL	2005	NA	66088	63430	2658	4
CN1201700000000	12	017	Citrus County, FL	2005	NA	51324	49126	2198	4.3
CN1201900000000	12	019	Clay County, FL	2005	NA	86643	83661	2982	3.4
CN1202100000000	12	021	Collier County, FL	2005	NA	145136	140087	5049	3.5
CN1202300000000	12	023	Columbia County, FL	2005	NA	28740	27757	983	3.4
CN1202700000000	12	027	DeSoto County, FL	2005	NA	13556	12937	619	4.6
CN1202900000000	12	029	Dixie County, FL	2005	NA	5550	5339	211	3.8
CN1203100000000	12	031	Duval County, FL	2005	NA	421549	404681	16868	4
CN1203300000000	12	033	Escambia County, FL	2005	NA	135677	130436	5241	3.9
CN1203500000000	12	035	Flagler County, FL	2005	NA	29981	28668	1313	4.4
CN1203700000000	12	037	Franklin County, FL	2005	NA	5136	4950	186	3.6
CN1203900000000	12	039	Gadsden County, FL	2005	NA	20488	19692	796	3.9
CN1204100000000	12	041	Gilchrist County, FL	2005	NA	7489	7251	238	3.2
CN1204300000000	12	043	Glades County, FL	2005	NA	4295	4085	210	4.9
CN1204500000000	12	045	Gulf County, FL	2005	NA	6321	6110	211	3.3
CN1204700000000	12	047	Hamilton County, FL	2005	NA	4616	4429	187	4.1
CN1204900000000	12	049	Hardee County, FL	2005	NA	11378	10834	544	4.8
CN1205100000000	12	051	Hendry County, FL	2005	NA	17375	16088	1287	7.4
CN1205300000000	12	053	Hernando County, FL	2005	NA	57093	54294	2799	4.9
CN1205500000000	12	055	Highlands County, FL	2005	NA	39983	38293	1690	4.2
CN1205700000000	12	057	Hillsborough County, FL	2005	NA	570252	548804	21448	3.8
CN1205900000000	12	059	Holmes County, FL	2005	NA	8366	8064	302	3.6
CN1206100000000	12	061	Indian River County, FL	2005	NA	59484	56638	2846	4.8
CN1206300000000	12	063	Jackson County, FL	2005	NA	21058	20313	745	3.5
CN1206500000000	12	065	Jefferson County, FL	2005	NA	6814	6599	215	3.2
CN1206700000000	12	067	Lafayette County, FL	2005	NA	2798	2713	85	3
CN1206900000000	12	069	Lake County, FL	2005	NA	118339	113846	4493	3.8
CN1207100000000	12	071	Lee County, FL	2005	NA	272752	263972	8780	3.2
CN1207300000000	12	073	Leon County, FL	2005	NA	137708	133367	4341	3.2
CN1207500000000	12	075	Levy County, FL	2005	NA	16579	15948	631	3.8
CN1207700000000	12	077	Liberty County, FL	2005	NA	3297	3204	93	2.8
CN1207900000000	12	079	Madison County, FL	2005	NA	7438	7091	347	4.7
CN1208100000000	12	081	Manatee County, FL	2005	NA	144617	139595	5022	3.5
CN1208300000000	12	083	Marion County, FL	2005	NA	127862	123011	4851	3.8
CN1208500000000	12	085	Martin County, FL	2005	NA	64652	62084	2568	4
CN1208600000000	12	086	Miami-Dade County, FL	2005	NA	1147797	1111437	36360	3.2
CN1208700000000	12	087	Monroe County, FL	2005	NA	45496	44259	1237	2.7
CN1208900000000	12	089	Nassau County, FL	2005	NA	32720	31631	1089	3.3
CN1209100000000	12	091	Okaloosa County, FL	2005	NA	96570	93848	2722	2.8
CN1209300000000	12	093	Okeechobee County, FL	2005	NA	17220	16386	834	4.8
CN1209500000000	12	095	Orange County, FL	2005	NA	553951	533969	19982	3.6
CN1209700000000	12	097	Osceola County, FL	2005	NA	116456	111999	4457	3.8
CN1209900000000	12	099	Palm Beach County, FL	2005	NA	604861	578769	26092	4.3
CN1210100000000	12	101	Pasco County, FL	2005	NA	177737	169875	7862	4.4
CN1210300000000	12	103	Pinellas County, FL	2005	NA	453533	435761	17772	3.9
CN1210500000000	12	105	Polk County, FL	2005	NA	258158	247679	10479	4.1
CN1210700000000	12	107	Putnam County, FL	2005	NA	31351	29994	1357	4.3
CN1210900000000	12	109	St. Johns County, FL	2005	NA	83507	80952	2555	3.1
CN1211100000000	12	111	St. Lucie County, FL	2005	NA	112948	107512	5436	4.8
CN1211300000000	12	113	Santa Rosa County, FL	2005	NA	67451	65003	2448	3.6
CN1211500000000	12	115	Sarasota County, FL	2005	NA	169305	163509	5796	3.4
CN1211700000000	12	117	Seminole County, FL	2005	NA	227032	219393	7639	3.4
CN1211900000000	12	119	Sumter County, FL	2005	NA	25555	24685	870	3.4
CN1212100000000	12	121	Suwannee County, FL	2005	NA	16638	16031	607	3.6
CN1212300000000	12	123	Taylor County, FL	2005	NA	8813	8456	357	4.1
CN1212500000000	12	125	Union County, FL	2005	NA	5045	4893	152	3
CN1212700000000	12	127	Volusia County, FL	2005	NA	244688	235627	9061	3.7
CN1212900000000	12	129	Wakulla County, FL	2005	NA	14399	13997	402	2.8
CN1213100000000	12	131	Walton County, FL	2005	NA	27944	27174	770	2.8
CN1213300000000	12	133	Washington County, FL	2005	NA	9291	8946	345	3.7
CN1300100000000	13	001	Appling County, GA	2005	NA	8947	8414	533	6
CN1300300000000	13	003	Atkinson County, GA	2005	NA	3504	3315	189	5.4
CN1300500000000	13	005	Bacon County, GA	2005	NA	4726	4474	252	5.3
CN1300700000000	13	007	Baker County, GA	2005	NA	1791	1697	94	5.2
CN1300900000000	13	009	Baldwin County, GA	2005	NA	20216	19103	1113	5.5
CN1301100000000	13	011	Banks County, GA	2005	NA	9163	8803	360	3.9
CN1301300000000	13	013	Barrow County, GA	2005	NA	30504	29050	1454	4.8
CN1301500000000	13	015	Bartow County, GA	2005	NA	44608	42034	2574	5.8
CN1301700000000	13	017	Ben Hill County, GA	2005	NA	8090	7635	455	5.6
CN1301900000000	13	019	Berrien County, GA	2005	NA	8833	8464	369	4.2
CN1302100000000	13	021	Bibb County, GA	2005	NA	72845	68652	4193	5.8
CN1302300000000	13	023	Bleckley County, GA	2005	NA	5081	4702	379	7.5
CN1302500000000	13	025	Brantley County, GA	2005	NA	7559	7148	411	5.4
CN1302700000000	13	027	Brooks County, GA	2005	NA	8289	7932	357	4.3
CN1302900000000	13	029	Bryan County, GA	2005	NA	15280	14673	607	4
CN1303100000000	13	031	Bulloch County, GA	2005	NA	30251	28835	1416	4.7
CN1303300000000	13	033	Burke County, GA	2005	NA	10078	9315	763	7.6
CN1303500000000	13	035	Butts County, GA	2005	NA	9107	8550	557	6.1
CN1303700000000	13	037	Calhoun County, GA	2005	NA	2325	2158	167	7.2
CN1303900000000	13	039	Camden County, GA	2005	NA	20428	19466	962	4.7
CN1304300000000	13	043	Candler County, GA	2005	NA	4494	4277	217	4.8
CN1304500000000	13	045	Carroll County, GA	2005	NA	50679	47869	2810	5.5
CN1304700000000	13	047	Catoosa County, GA	2005	NA	34815	33295	1520	4.4
CN1304900000000	13	049	Charlton County, GA	2005	NA	4380	4147	233	5.3
CN1305100000000	13	051	Chatham County, GA	2005	NA	124569	118847	5722	4.6
CN1305300000000	13	053	Chattahoochee County, GA	2005	NA	2657	2375	282	10.6
CN1305500000000	13	055	Chattooga County, GA	2005	NA	11053	10449	604	5.5
CN1305700000000	13	057	Cherokee County, GA	2005	NA	99737	95569	4168	4.2
CN1305900000000	13	059	Clarke County, GA	2005	NA	59066	56414	2652	4.5
CN1306100000000	13	061	Clay County, GA	2005	NA	1384	1309	75	5.4
CN1306300000000	13	063	Clayton County, GA	2005	NA	136125	126767	9358	6.9
CN1306500000000	13	065	Clinch County, GA	2005	NA	2499	2345	154	6.2
CN1306700000000	13	067	Cobb County, GA	2005	NA	369291	351402	17889	4.8
CN1306900000000	13	069	Coffee County, GA	2005	NA	17335	16333	1002	5.8
CN1307100000000	13	071	Colquitt County, GA	2005	NA	19256	18261	995	5.2
CN1307300000000	13	073	Columbia County, GA	2005	NA	56828	54198	2630	4.6
CN1307500000000	13	075	Cook County, GA	2005	NA	7008	6590	418	6
CN1307700000000	13	077	Coweta County, GA	2005	NA	55824	53100	2724	4.9
CN1307900000000	13	079	Crawford County, GA	2005	NA	6269	5899	370	5.9
CN1308100000000	13	081	Crisp County, GA	2005	NA	10108	9442	666	6.6
CN1308300000000	13	083	Dade County, GA	2005	NA	8433	8027	406	4.8
CN1308500000000	13	085	Dawson County, GA	2005	NA	10287	9846	441	4.3
CN1308700000000	13	087	Decatur County, GA	2005	NA	12136	11389	747	6.2
CN1308900000000	13	089	DeKalb County, GA	2005	NA	368282	345752	22530	6.1
CN1309100000000	13	091	Dodge County, GA	2005	NA	9104	8576	528	5.8
CN1309300000000	13	093	Dooly County, GA	2005	NA	4852	4548	304	6.3
CN1309500000000	13	095	Dougherty County, GA	2005	NA	41217	38622	2595	6.3
CN1309700000000	13	097	Douglas County, GA	2005	NA	59500	56134	3366	5.7
CN1309900000000	13	099	Early County, GA	2005	NA	5618	5304	314	5.6
CN1310100000000	13	101	Echols County, GA	2005	NA	2314	2236	78	3.4
CN1310300000000	13	103	Effingham County, GA	2005	NA	25609	24593	1016	4
CN1310500000000	13	105	Elbert County, GA	2005	NA	9954	9273	681	6.8
CN1310700000000	13	107	Emanuel County, GA	2005	NA	10651	10059	592	5.6
CN1310900000000	13	109	Evans County, GA	2005	NA	4858	4609	249	5.1
CN1311100000000	13	111	Fannin County, GA	2005	NA	10068	9550	518	5.1
CN1311300000000	13	113	Fayette County, GA	2005	NA	53172	50717	2455	4.6
CN1311500000000	13	115	Floyd County, GA	2005	NA	50139	47541	2598	5.2
CN1311700000000	13	117	Forsyth County, GA	2005	NA	75083	72207	2876	3.8
CN1311900000000	13	119	Franklin County, GA	2005	NA	10389	9795	594	5.7
CN1312100000000	13	121	Fulton County, GA	2005	NA	457326	430634	26692	5.8
CN1312300000000	13	123	Gilmer County, GA	2005	NA	13412	12776	636	4.7
CN1312500000000	13	125	Glascock County, GA	2005	NA	1188	1110	78	6.6
CN1312700000000	13	127	Glynn County, GA	2005	NA	38916	37168	1748	4.5
CN1312900000000	13	129	Gordon County, GA	2005	NA	26657	25363	1294	4.9
CN1313100000000	13	131	Grady County, GA	2005	NA	11609	11070	539	4.6
CN1313300000000	13	133	Greene County, GA	2005	NA	6639	6156	483	7.3
CN1313500000000	13	135	Gwinnett County, GA	2005	NA	398300	379383	18917	4.7
CN1313700000000	13	137	Habersham County, GA	2005	NA	19726	18855	871	4.4
CN1313900000000	13	139	Hall County, GA	2005	NA	82801	79099	3702	4.5
CN1314100000000	13	141	Hancock County, GA	2005	NA	3301	3030	271	8.2
CN1314300000000	13	143	Haralson County, GA	2005	NA	12834	12138	696	5.4
CN1314500000000	13	145	Harris County, GA	2005	NA	15281	14636	645	4.2
CN1314700000000	13	147	Hart County, GA	2005	NA	10936	10174	762	7
CN1314900000000	13	149	Heard County, GA	2005	NA	4936	4652	284	5.8
CN1315100000000	13	151	Henry County, GA	2005	NA	88594	83860	4734	5.3
CN1315300000000	13	153	Houston County, GA	2005	NA	62594	59586	3008	4.8
CN1315500000000	13	155	Irwin County, GA	2005	NA	4623	4356	267	5.8
CN1315700000000	13	157	Jackson County, GA	2005	NA	25395	24196	1199	4.7
CN1315900000000	13	159	Jasper County, GA	2005	NA	6231	5914	317	5.1
CN1316100000000	13	161	Jeff Davis County, GA	2005	NA	5459	5074	385	7.1
CN1316300000000	13	163	Jefferson County, GA	2005	NA	6883	6298	585	8.5
CN1316500000000	13	165	Jenkins County, GA	2005	NA	3501	3292	209	6
CN1316700000000	13	167	Johnson County, GA	2005	NA	3712	3484	228	6.1
CN1316900000000	13	169	Jones County, GA	2005	NA	13664	13001	663	4.9
CN1317100000000	13	171	Lamar County, GA	2005	NA	7764	7287	477	6.1
CN1317300000000	13	173	Lanier County, GA	2005	NA	3810	3658	152	4
CN1317500000000	13	175	Laurens County, GA	2005	NA	22054	20844	1210	5.5
CN1317700000000	13	177	Lee County, GA	2005	NA	16403	15749	654	4
CN1317900000000	13	179	Liberty County, GA	2005	NA	22914	21562	1352	5.9
CN1318100000000	13	181	Lincoln County, GA	2005	NA	3615	3357	258	7.1
CN1318300000000	13	183	Long County, GA	2005	NA	5749	5517	232	4
CN1318500000000	13	185	Lowndes County, GA	2005	NA	50416	48390	2026	4
CN1318700000000	13	187	Lumpkin County, GA	2005	NA	12168	11586	582	4.8
CN1318900000000	13	189	McDuffie County, GA	2005	NA	10635	9894	741	7
CN1319100000000	13	191	McIntosh County, GA	2005	NA	5231	4951	280	5.4
CN1319300000000	13	193	Macon County, GA	2005	NA	5408	4930	478	8.8
CN1319500000000	13	195	Madison County, GA	2005	NA	15469	14782	687	4.4
CN1319700000000	13	197	Marion County, GA	2005	NA	3410	3229	181	5.3
CN1319900000000	13	199	Meriwether County, GA	2005	NA	9814	9103	711	7.2
CN1320100000000	13	201	Miller County, GA	2005	NA	3600	3465	135	3.8
CN1320500000000	13	205	Mitchell County, GA	2005	NA	10130	9559	571	5.6
CN1320700000000	13	207	Monroe County, GA	2005	NA	12689	12047	642	5.1
CN1320900000000	13	209	Montgomery County, GA	2005	NA	4255	4007	248	5.8
CN1321100000000	13	211	Morgan County, GA	2005	NA	8932	8517	415	4.6
CN1321300000000	13	213	Murray County, GA	2005	NA	20981	20013	968	4.6
CN1321500000000	13	215	Muscogee County, GA	2005	NA	84703	79487	5216	6.2
CN1321700000000	13	217	Newton County, GA	2005	NA	42367	39831	2536	6
CN1321900000000	13	219	Oconee County, GA	2005	NA	17109	16513	596	3.5
CN1322100000000	13	221	Oglethorpe County, GA	2005	NA	7556	7211	345	4.6
CN1322300000000	13	223	Paulding County, GA	2005	NA	58563	55791	2772	4.7
CN1322500000000	13	225	Peach County, GA	2005	NA	11353	10591	762	6.7
CN1322700000000	13	227	Pickens County, GA	2005	NA	14232	13639	593	4.2
CN1322900000000	13	229	Pierce County, GA	2005	NA	8327	7931	396	4.8
CN1323100000000	13	231	Pike County, GA	2005	NA	7706	7269	437	5.7
CN1323300000000	13	233	Polk County, GA	2005	NA	20428	19391	1037	5.1
CN1323500000000	13	235	Pulaski County, GA	2005	NA	4368	4120	248	5.7
CN1323700000000	13	237	Putnam County, GA	2005	NA	10075	9528	547	5.4
CN1323900000000	13	239	Quitman County, GA	2005	NA	985	924	61	6.2
CN1324100000000	13	241	Rabun County, GA	2005	NA	7810	7444	366	4.7
CN1324300000000	13	243	Randolph County, GA	2005	NA	2727	2519	208	7.6
CN1324500000000	13	245	Richmond County, GA	2005	NA	89801	83650	6151	6.8
CN1324700000000	13	247	Rockdale County, GA	2005	NA	39089	36806	2283	5.8
CN1324900000000	13	249	Schley County, GA	2005	NA	1769	1649	120	6.8
CN1325100000000	13	251	Screven County, GA	2005	NA	6937	6555	382	5.5
CN1325300000000	13	253	Seminole County, GA	2005	NA	3982	3755	227	5.7
CN1325500000000	13	255	Spalding County, GA	2005	NA	28138	26088	2050	7.3
CN1325700000000	13	257	Stephens County, GA	2005	NA	12977	12217	760	5.9
CN1325900000000	13	259	Stewart County, GA	2005	NA	1951	1770	181	9.3
CN1326100000000	13	261	Sumter County, GA	2005	NA	14368	13381	987	6.9
CN1326300000000	13	263	Talbot County, GA	2005	NA	2973	2762	211	7.1
CN1326500000000	13	265	Taliaferro County, GA	2005	NA	712	659	53	7.4
CN1326700000000	13	267	Tattnall County, GA	2005	NA	8832	8269	563	6.4
CN1326900000000	13	269	Taylor County, GA	2005	NA	3233	2981	252	7.8
CN1327100000000	13	271	Telfair County, GA	2005	NA	4594	4246	348	7.6
CN1327300000000	13	273	Terrell County, GA	2005	NA	4586	4271	315	6.9
CN1327500000000	13	275	Thomas County, GA	2005	NA	22905	21875	1030	4.5
CN1327700000000	13	277	Tift County, GA	2005	NA	19683	18660	1023	5.2
CN1327900000000	13	279	Toombs County, GA	2005	NA	12843	12030	813	6.3
CN1328100000000	13	281	Towns County, GA	2005	NA	5667	5445	222	3.9
CN1328300000000	13	283	Treutlen County, GA	2005	NA	2713	2510	203	7.5
CN1328500000000	13	285	Troup County, GA	2005	NA	30190	28127	2063	6.8
CN1328700000000	13	287	Turner County, GA	2005	NA	4937	4610	327	6.6
CN1328900000000	13	289	Twiggs County, GA	2005	NA	4648	4328	320	6.9
CN1329100000000	13	291	Union County, GA	2005	NA	10196	9760	436	4.3
CN1329300000000	13	293	Upson County, GA	2005	NA	12048	11233	815	6.8
CN1329500000000	13	295	Walker County, GA	2005	NA	32829	31201	1628	5
CN1329700000000	13	297	Walton County, GA	2005	NA	37577	35765	1812	4.8
CN1329900000000	13	299	Ware County, GA	2005	NA	14780	13956	824	5.6
CN1330100000000	13	301	Warren County, GA	2005	NA	2608	2341	267	10.2
CN1330300000000	13	303	Washington County, GA	2005	NA	8294	7743	551	6.6
CN1330500000000	13	305	Wayne County, GA	2005	NA	11789	11058	731	6.2
CN1330700000000	13	307	Webster County, GA	2005	NA	1120	1048	72	6.4
CN1330900000000	13	309	Wheeler County, GA	2005	NA	2575	2410	165	6.4
CN1331100000000	13	311	White County, GA	2005	NA	12000	11463	537	4.5
CN1331300000000	13	313	Whitfield County, GA	2005	NA	45520	43324	2196	4.8
CN1331500000000	13	315	Wilcox County, GA	2005	NA	3239	3020	219	6.8
CN1331700000000	13	317	Wilkes County, GA	2005	NA	4602	4286	316	6.9
CN1331900000000	13	319	Wilkinson County, GA	2005	NA	4428	4167	261	5.9
CN1332100000000	13	321	Worth County, GA	2005	NA	10352	9783	569	5.5
CN1500100000000	15	001	Hawaii County, HI	2005	NA	80769	77983	2786	3.4
CN1500300000000	15	003	Honolulu County/city, HI	2005	NA	439257	427016	12241	2.8
CN1500700000000	15	007	Kauai County, HI	2005	NA	31895	30992	903	2.8
CN1500900000000	15	009	Maui County, HI	2005	NA	74992	72966	2026	2.7
CN1600100000000	16	001	Ada County, ID	2005	NA	187127	180914	6213	3.3
CN1600300000000	16	003	Adams County, ID	2005	NA	1907	1754	153	8
CN1600500000000	16	005	Bannock County, ID	2005	NA	40549	38984	1565	3.9
CN1600700000000	16	007	Bear Lake County, ID	2005	NA	3055	2931	124	4.1
CN1600900000000	16	009	Benewah County, ID	2005	NA	4044	3733	311	7.7
CN1601100000000	16	011	Bingham County, ID	2005	NA	21049	20266	783	3.7
CN1601300000000	16	013	Blaine County, ID	2005	NA	14067	13669	398	2.8
CN1601500000000	16	015	Boise County, ID	2005	NA	3683	3516	167	4.5
CN1601700000000	16	017	Bonner County, ID	2005	NA	20470	19420	1050	5.1
CN1601900000000	16	019	Bonneville County, ID	2005	NA	49007	47534	1473	3
CN1602100000000	16	021	Boundary County, ID	2005	NA	4241	3903	338	8
CN1602300000000	16	023	Butte County, ID	2005	NA	1397	1337	60	4.3
CN1602500000000	16	025	Camas County, ID	2005	NA	622	598	24	3.9
CN1602700000000	16	027	Canyon County, ID	2005	NA	78790	75286	3504	4.4
CN1602900000000	16	029	Caribou County, ID	2005	NA	3309	3134	175	5.3
CN1603100000000	16	031	Cassia County, ID	2005	NA	10065	9602	463	4.6
CN1603300000000	16	033	Clark County, ID	2005	NA	546	519	27	4.9
CN1603500000000	16	035	Clearwater County, ID	2005	NA	3357	3044	313	9.3
CN1603700000000	16	037	Custer County, ID	2005	NA	2604	2473	131	5
CN1603900000000	16	039	Elmore County, ID	2005	NA	10921	10420	501	4.6
CN1604100000000	16	041	Franklin County, ID	2005	NA	6218	6019	199	3.2
CN1604300000000	16	043	Fremont County, ID	2005	NA	6093	5856	237	3.9
CN1604500000000	16	045	Gem County, ID	2005	NA	7238	6891	347	4.8
CN1604700000000	16	047	Gooding County, ID	2005	NA	8142	7896	246	3
CN1604900000000	16	049	Idaho County, ID	2005	NA	7135	6658	477	6.7
CN1605100000000	16	051	Jefferson County, ID	2005	NA	10763	10409	354	3.3
CN1605300000000	16	053	Jerome County, ID	2005	NA	9943	9576	367	3.7
CN1605500000000	16	055	Kootenai County, ID	2005	NA	67178	64151	3027	4.5
CN1605700000000	16	057	Latah County, ID	2005	NA	17947	17314	633	3.5
CN1605900000000	16	059	Lemhi County, ID	2005	NA	4073	3829	244	6
CN1606100000000	16	061	Lewis County, ID	2005	NA	1743	1682	61	3.5
CN1606300000000	16	063	Lincoln County, ID	2005	NA	2422	2314	108	4.5
CN1606500000000	16	065	Madison County, ID	2005	NA	14980	14571	409	2.7
CN1606700000000	16	067	Minidoka County, ID	2005	NA	9476	8932	544	5.7
CN1606900000000	16	069	Nez Perce County, ID	2005	NA	19352	18504	848	4.4
CN1607100000000	16	071	Oneida County, ID	2005	NA	2148	2093	55	2.6
CN1607300000000	16	073	Owyhee County, ID	2005	NA	4719	4603	116	2.5
CN1607500000000	16	075	Payette County, ID	2005	NA	10415	9689	726	7
CN1607700000000	16	077	Power County, ID	2005	NA	3794	3617	177	4.7
CN1607900000000	16	079	Shoshone County, ID	2005	NA	5693	5249	444	7.8
CN1608100000000	16	081	Teton County, ID	2005	NA	4518	4384	134	3
CN1608300000000	16	083	Twin Falls County, ID	2005	NA	37105	35743	1362	3.7
CN1608500000000	16	085	Valley County, ID	2005	NA	4687	4463	224	4.8
CN1608700000000	16	087	Washington County, ID	2005	NA	5079	4809	270	5.3
CN1700100000000	17	001	Adams County, IL	2005	NA	37713	36305	1408	3.7
CN1700300000000	17	003	Alexander County, IL	2005	NA	3319	3032	287	8.6
CN1700500000000	17	005	Bond County, IL	2005	NA	8460	8003	457	5.4
CN1700700000000	17	007	Boone County, IL	2005	NA	24516	22889	1627	6.6
CN1700900000000	17	009	Brown County, IL	2005	NA	3306	3182	124	3.8
CN1701100000000	17	011	Bureau County, IL	2005	NA	18817	17892	925	4.9
CN1701300000000	17	013	Calhoun County, IL	2005	NA	2552	2397	155	6.1
CN1701500000000	17	015	Carroll County, IL	2005	NA	8364	7898	466	5.6
CN1701700000000	17	017	Cass County, IL	2005	NA	7598	7241	357	4.7
CN1701900000000	17	019	Champaign County, IL	2005	NA	101124	96973	4151	4.1
CN1702100000000	17	021	Christian County, IL	2005	NA	16967	15989	978	5.8
CN1702300000000	17	023	Clark County, IL	2005	NA	8512	8044	468	5.5
CN1702500000000	17	025	Clay County, IL	2005	NA	6859	6441	418	6.1
CN1702700000000	17	027	Clinton County, IL	2005	NA	18508	17645	863	4.7
CN1702900000000	17	029	Coles County, IL	2005	NA	26352	25120	1232	4.7
CN1703100000000	17	031	Cook County, IL	2005	NA	2548067	2384929	163138	6.4
CN1703300000000	17	033	Crawford County, IL	2005	NA	9290	8748	542	5.8
CN1703500000000	17	035	Cumberland County, IL	2005	NA	5519	5233	286	5.2
CN1703700000000	17	037	DeKalb County, IL	2005	NA	53459	50744	2715	5.1
CN1703900000000	17	039	De Witt County, IL	2005	NA	8381	7932	449	5.4
CN1704100000000	17	041	Douglas County, IL	2005	NA	10478	9991	487	4.6
CN1704300000000	17	043	DuPage County, IL	2005	NA	512686	488605	24081	4.7
CN1704500000000	17	045	Edgar County, IL	2005	NA	10283	9737	546	5.3
CN1704700000000	17	047	Edwards County, IL	2005	NA	3420	3259	161	4.7
CN1704900000000	17	049	Effingham County, IL	2005	NA	17736	16771	965	5.4
CN1705100000000	17	051	Fayette County, IL	2005	NA	10132	9478	654	6.5
CN1705300000000	17	053	Ford County, IL	2005	NA	7262	6915	347	4.8
CN1705500000000	17	055	Franklin County, IL	2005	NA	17537	16294	1243	7.1
CN1705700000000	17	057	Fulton County, IL	2005	NA	17566	16518	1048	6
CN1705900000000	17	059	Gallatin County, IL	2005	NA	2647	2480	167	6.3
CN1706100000000	17	061	Greene County, IL	2005	NA	7243	6852	391	5.4
CN1706300000000	17	063	Grundy County, IL	2005	NA	23302	21653	1649	7.1
CN1706500000000	17	065	Hamilton County, IL	2005	NA	4089	3865	224	5.5
CN1706700000000	17	067	Hancock County, IL	2005	NA	9943	9444	499	5
CN1706900000000	17	069	Hardin County, IL	2005	NA	1758	1619	139	7.9
CN1707100000000	17	071	Henderson County, IL	2005	NA	4066	3830	236	5.8
CN1707300000000	17	073	Henry County, IL	2005	NA	27308	26074	1234	4.5
CN1707500000000	17	075	Iroquois County, IL	2005	NA	16516	15742	774	4.7
CN1707700000000	17	077	Jackson County, IL	2005	NA	31477	30038	1439	4.6
CN1707900000000	17	079	Jasper County, IL	2005	NA	5190	4880	310	6
CN1708100000000	17	081	Jefferson County, IL	2005	NA	20333	19290	1043	5.1
CN1708300000000	17	083	Jersey County, IL	2005	NA	11464	10853	611	5.3
CN1708500000000	17	085	Jo Daviess County, IL	2005	NA	12973	12431	542	4.2
CN1708700000000	17	087	Johnson County, IL	2005	NA	5095	4786	309	6.1
CN1708900000000	17	089	Kane County, IL	2005	NA	249485	235662	13823	5.5
CN1709100000000	17	091	Kankakee County, IL	2005	NA	52672	49324	3348	6.4
CN1709300000000	17	093	Kendall County, IL	2005	NA	44205	41985	2220	5
CN1709500000000	17	095	Knox County, IL	2005	NA	25341	23503	1838	7.3
CN1709700000000	17	097	Lake County, IL	2005	NA	355521	339088	16433	4.6
CN1709900000000	17	099	LaSalle County, IL	2005	NA	56714	53276	3438	6.1
CN1710100000000	17	101	Lawrence County, IL	2005	NA	8359	7929	430	5.1
CN1710300000000	17	103	Lee County, IL	2005	NA	17993	17088	905	5
CN1710500000000	17	105	Livingston County, IL	2005	NA	18393	17488	905	4.9
CN1710700000000	17	107	Logan County, IL	2005	NA	13311	12574	737	5.5
CN1710900000000	17	109	McDonough County, IL	2005	NA	16500	15737	763	4.6
CN1711100000000	17	111	McHenry County, IL	2005	NA	166361	157880	8481	5.1
CN1711300000000	17	113	McLean County, IL	2005	NA	87165	83611	3554	4.1
CN1711500000000	17	115	Macon County, IL	2005	NA	52836	49634	3202	6.1
CN1711700000000	17	117	Macoupin County, IL	2005	NA	24383	22987	1396	5.7
CN1711900000000	17	119	Madison County, IL	2005	NA	134905	127539	7366	5.5
CN1712100000000	17	121	Marion County, IL	2005	NA	17961	16830	1131	6.3
CN1712300000000	17	123	Marshall County, IL	2005	NA	7115	6805	310	4.4
CN1712500000000	17	125	Mason County, IL	2005	NA	7594	7094	500	6.6
CN1712700000000	17	127	Massac County, IL	2005	NA	7387	6986	401	5.4
CN1712900000000	17	129	Menard County, IL	2005	NA	6982	6675	307	4.4
CN1713100000000	17	131	Mercer County, IL	2005	NA	8911	8425	486	5.5
CN1713300000000	17	133	Monroe County, IL	2005	NA	17252	16521	731	4.2
CN1713500000000	17	135	Montgomery County, IL	2005	NA	13439	12509	930	6.9
CN1713700000000	17	137	Morgan County, IL	2005	NA	17624	16651	973	5.5
CN1713900000000	17	139	Moultrie County, IL	2005	NA	8021	7696	325	4.1
CN1714100000000	17	141	Ogle County, IL	2005	NA	26459	25055	1404	5.3
CN1714300000000	17	143	Peoria County, IL	2005	NA	92082	87555	4527	4.9
CN1714500000000	17	145	Perry County, IL	2005	NA	10371	9679	692	6.7
CN1714700000000	17	147	Piatt County, IL	2005	NA	9119	8758	361	4
CN1714900000000	17	149	Pike County, IL	2005	NA	8700	8279	421	4.8
CN1715100000000	17	151	Pope County, IL	2005	NA	1971	1848	123	6.2
CN1715300000000	17	153	Pulaski County, IL	2005	NA	2931	2700	231	7.9
CN1715500000000	17	155	Putnam County, IL	2005	NA	3127	2955	172	5.5
CN1715700000000	17	157	Randolph County, IL	2005	NA	15119	14304	815	5.4
CN1715900000000	17	159	Richland County, IL	2005	NA	7315	6905	410	5.6
CN1716100000000	17	161	Rock Island County, IL	2005	NA	77924	74361	3563	4.6
CN1716300000000	17	163	St. Clair County, IL	2005	NA	121152	113571	7581	6.3
CN1716500000000	17	165	Saline County, IL	2005	NA	12399	11668	731	5.9
CN1716700000000	17	167	Sangamon County, IL	2005	NA	105121	100375	4746	4.5
CN1716900000000	17	169	Schuyler County, IL	2005	NA	4334	4130	204	4.7
CN1717100000000	17	171	Scott County, IL	2005	NA	2792	2619	173	6.2
CN1717300000000	17	173	Shelby County, IL	2005	NA	11213	10628	585	5.2
CN1717500000000	17	175	Stark County, IL	2005	NA	2833	2676	157	5.5
CN1717700000000	17	177	Stephenson County, IL	2005	NA	25082	23775	1307	5.2
CN1717900000000	17	179	Tazewell County, IL	2005	NA	69006	65851	3155	4.6
CN1718100000000	17	181	Union County, IL	2005	NA	8260	7700	560	6.8
CN1718300000000	17	183	Vermilion County, IL	2005	NA	37822	35444	2378	6.3
CN1718500000000	17	185	Wabash County, IL	2005	NA	6581	6209	372	5.7
CN1718700000000	17	187	Warren County, IL	2005	NA	8833	8347	486	5.5
CN1718900000000	17	189	Washington County, IL	2005	NA	8592	8216	376	4.4
CN1719100000000	17	191	Wayne County, IL	2005	NA	8152	7745	407	5
CN1719300000000	17	193	White County, IL	2005	NA	7921	7534	387	4.9
CN1719500000000	17	195	Whiteside County, IL	2005	NA	29808	28110	1698	5.7
CN1719700000000	17	197	Will County, IL	2005	NA	334294	314932	19362	5.8
CN1719900000000	17	199	Williamson County, IL	2005	NA	33363	31589	1774	5.3
CN1720100000000	17	201	Winnebago County, IL	2005	NA	140493	131577	8916	6.3
CN1720300000000	17	203	Woodford County, IL	2005	NA	20036	19287	749	3.7
CN1800100000000	18	001	Adams County, IN	2005	NA	16555	15756	799	4.8
CN1800300000000	18	003	Allen County, IN	2005	NA	178905	169461	9444	5.3
CN1800500000000	18	005	Bartholomew County, IN	2005	NA	37388	35576	1812	4.8
CN1800700000000	18	007	Benton County, IN	2005	NA	4599	4356	243	5.3
CN1800900000000	18	009	Blackford County, IN	2005	NA	6817	6330	487	7.1
CN1801100000000	18	011	Boone County, IN	2005	NA	27178	26054	1124	4.1
CN1801300000000	18	013	Brown County, IN	2005	NA	8002	7548	454	5.7
CN1801500000000	18	015	Carroll County, IN	2005	NA	10515	9967	548	5.2
CN1801700000000	18	017	Cass County, IN	2005	NA	19274	18161	1113	5.8
CN1801900000000	18	019	Clark County, IN	2005	NA	53370	50569	2801	5.2
CN1802100000000	18	021	Clay County, IN	2005	NA	13314	12379	935	7
CN1802300000000	18	023	Clinton County, IN	2005	NA	17007	16042	965	5.7
CN1802500000000	18	025	Crawford County, IN	2005	NA	5431	5014	417	7.7
CN1802700000000	18	027	Daviess County, IN	2005	NA	14884	14269	615	4.1
CN1802900000000	18	029	Dearborn County, IN	2005	NA	26428	24916	1512	5.7
CN1803100000000	18	031	Decatur County, IN	2005	NA	12695	12051	644	5.1
CN1803300000000	18	033	DeKalb County, IN	2005	NA	21911	20531	1380	6.3
CN1803500000000	18	035	Delaware County, IN	2005	NA	56113	52262	3851	6.9
CN1803700000000	18	037	Dubois County, IN	2005	NA	22402	21523	879	3.9
CN1803900000000	18	039	Elkhart County, IN	2005	NA	101915	97189	4726	4.6
CN1804100000000	18	041	Fayette County, IN	2005	NA	11451	10526	925	8.1
CN1804300000000	18	043	Floyd County, IN	2005	NA	37486	35528	1958	5.2
CN1804500000000	18	045	Fountain County, IN	2005	NA	8803	8324	479	5.4
CN1804700000000	18	047	Franklin County, IN	2005	NA	12052	11278	774	6.4
CN1804900000000	18	049	Fulton County, IN	2005	NA	10464	9900	564	5.4
CN1805100000000	18	051	Gibson County, IN	2005	NA	17306	16447	859	5
CN1805300000000	18	053	Grant County, IN	2005	NA	33333	30514	2819	8.5
CN1805500000000	18	055	Greene County, IN	2005	NA	16736	15620	1116	6.7
CN1805700000000	18	057	Hamilton County, IN	2005	NA	130720	126120	4600	3.5
CN1805900000000	18	059	Hancock County, IN	2005	NA	34425	32941	1484	4.3
CN1806100000000	18	061	Harrison County, IN	2005	NA	19628	18383	1245	6.3
CN1806300000000	18	063	Hendricks County, IN	2005	NA	69433	66604	2829	4.1
CN1806500000000	18	065	Henry County, IN	2005	NA	23047	21473	1574	6.8
CN1806700000000	18	067	Howard County, IN	2005	NA	39174	36607	2567	6.6
CN1806900000000	18	069	Huntington County, IN	2005	NA	20622	19457	1165	5.6
CN1807100000000	18	071	Jackson County, IN	2005	NA	22193	21113	1080	4.9
CN1807300000000	18	073	Jasper County, IN	2005	NA	15224	14356	868	5.7
CN1807500000000	18	075	Jay County, IN	2005	NA	11639	11010	629	5.4
CN1807700000000	18	077	Jefferson County, IN	2005	NA	17393	16459	934	5.4
CN1807900000000	18	079	Jennings County, IN	2005	NA	13989	13045	944	6.7
CN1808100000000	18	081	Johnson County, IN	2005	NA	70047	66984	3063	4.4
CN1808300000000	18	083	Knox County, IN	2005	NA	19258	18266	992	5.2
CN1808500000000	18	085	Kosciusko County, IN	2005	NA	41334	39539	1795	4.3
CN1808700000000	18	087	LaGrange County, IN	2005	NA	17339	16482	857	4.9
CN1808900000000	18	089	Lake County, IN	2005	NA	225412	211454	13958	6.2
CN1809100000000	18	091	LaPorte County, IN	2005	NA	53070	49849	3221	6.1
CN1809300000000	18	093	Lawrence County, IN	2005	NA	22448	20700	1748	7.8
CN1809500000000	18	095	Madison County, IN	2005	NA	63209	59035	4174	6.6
CN1809700000000	18	097	Marion County, IN	2005	NA	459492	433930	25562	5.6
CN1809900000000	18	099	Marshall County, IN	2005	NA	22737	21543	1194	5.3
CN1810100000000	18	101	Martin County, IN	2005	NA	5161	4879	282	5.5
CN1810300000000	18	103	Miami County, IN	2005	NA	17376	16291	1085	6.2
CN1810500000000	18	105	Monroe County, IN	2005	NA	66680	63451	3229	4.8
CN1810700000000	18	107	Montgomery County, IN	2005	NA	19879	18946	933	4.7
CN1810900000000	18	109	Morgan County, IN	2005	NA	37206	35351	1855	5
CN1811100000000	18	111	Newton County, IN	2005	NA	7083	6700	383	5.4
CN1811300000000	18	113	Noble County, IN	2005	NA	23786	22320	1466	6.2
CN1811500000000	18	115	Ohio County, IN	2005	NA	3152	2984	168	5.3
CN1811700000000	18	117	Orange County, IN	2005	NA	9313	8622	691	7.4
CN1811900000000	18	119	Owen County, IN	2005	NA	11766	11026	740	6.3
CN1812100000000	18	121	Parke County, IN	2005	NA	8111	7587	524	6.5
CN1812300000000	18	123	Perry County, IN	2005	NA	9730	9159	571	5.9
CN1812500000000	18	125	Pike County, IN	2005	NA	6237	5889	348	5.6
CN1812700000000	18	127	Porter County, IN	2005	NA	81102	77225	3877	4.8
CN1812900000000	18	129	Posey County, IN	2005	NA	13870	13190	680	4.9
CN1813100000000	18	131	Pulaski County, IN	2005	NA	7075	6720	355	5
CN1813300000000	18	133	Putnam County, IN	2005	NA	17804	16615	1189	6.7
CN1813500000000	18	135	Randolph County, IN	2005	NA	13101	12131	970	7.4
CN1813700000000	18	137	Ripley County, IN	2005	NA	14876	14086	790	5.3
CN1813900000000	18	139	Rush County, IN	2005	NA	9556	9105	451	4.7
CN1814100000000	18	141	St. Joseph County, IN	2005	NA	134160	126995	7165	5.3
CN1814300000000	18	143	Scott County, IN	2005	NA	11393	10682	711	6.2
CN1814500000000	18	145	Shelby County, IN	2005	NA	23676	22487	1189	5
CN1814700000000	18	147	Spencer County, IN	2005	NA	10725	10112	613	5.7
CN1814900000000	18	149	Starke County, IN	2005	NA	10636	9889	747	7
CN1815100000000	18	151	Steuben County, IN	2005	NA	17012	15940	1072	6.3
CN1815300000000	18	153	Sullivan County, IN	2005	NA	9294	8599	695	7.5
CN1815500000000	18	155	Switzerland County, IN	2005	NA	5767	5493	274	4.8
CN1815700000000	18	157	Tippecanoe County, IN	2005	NA	79380	75524	3856	4.9
CN1815900000000	18	159	Tipton County, IN	2005	NA	8077	7613	464	5.7
CN1816100000000	18	161	Union County, IN	2005	NA	3874	3657	217	5.6
CN1816300000000	18	163	Vanderburgh County, IN	2005	NA	91447	86649	4798	5.2
CN1816500000000	18	165	Vermillion County, IN	2005	NA	8131	7527	604	7.4
CN1816700000000	18	167	Vigo County, IN	2005	NA	49898	46501	3397	6.8
CN1816900000000	18	169	Wabash County, IN	2005	NA	17717	16545	1172	6.6
CN1817100000000	18	171	Warren County, IN	2005	NA	4779	4564	215	4.5
CN1817300000000	18	173	Warrick County, IN	2005	NA	30602	29170	1432	4.7
CN1817500000000	18	175	Washington County, IN	2005	NA	14013	13144	869	6.2
CN1817700000000	18	177	Wayne County, IN	2005	NA	33027	30676	2351	7.1
CN1817900000000	18	179	Wells County, IN	2005	NA	14861	14146	715	4.8
CN1818100000000	18	181	White County, IN	2005	NA	12261	11551	710	5.8
CN1818300000000	18	183	Whitley County, IN	2005	NA	17680	16777	903	5.1
CN1900100000000	19	001	Adair County, IA	2005	NA	4400	4224	176	4
CN1900300000000	19	003	Adams County, IA	2005	NA	1996	1892	104	5.2
CN1900500000000	19	005	Allamakee County, IA	2005	NA	7996	7578	418	5.2
CN1900700000000	19	007	Appanoose County, IA	2005	NA	6472	6136	336	5.2
CN1900900000000	19	009	Audubon County, IA	2005	NA	3354	3201	153	4.6
CN1901100000000	19	011	Benton County, IA	2005	NA	14432	13749	683	4.7
CN1901300000000	19	013	Black Hawk County, IA	2005	NA	71506	68402	3104	4.3
CN1901500000000	19	015	Boone County, IA	2005	NA	15374	14843	531	3.5
CN1901700000000	19	017	Bremer County, IA	2005	NA	13732	13228	504	3.7
CN1901900000000	19	019	Buchanan County, IA	2005	NA	11166	10656	510	4.6
CN1902100000000	19	021	Buena Vista County, IA	2005	NA	10283	9891	392	3.8
CN1902300000000	19	023	Butler County, IA	2005	NA	8106	7718	388	4.8
CN1902500000000	19	025	Calhoun County, IA	2005	NA	5152	4947	205	4
CN1902700000000	19	027	Carroll County, IA	2005	NA	12269	11902	367	3
CN1902900000000	19	029	Cass County, IA	2005	NA	7628	7277	351	4.6
CN1903100000000	19	031	Cedar County, IA	2005	NA	10582	10185	397	3.8
CN1903300000000	19	033	Cerro Gordo County, IA	2005	NA	26111	24973	1138	4.4
CN1903500000000	19	035	Cherokee County, IA	2005	NA	6572	6266	306	4.7
CN1903700000000	19	037	Chickasaw County, IA	2005	NA	6235	5907	328	5.3
CN1903900000000	19	039	Clarke County, IA	2005	NA	4643	4403	240	5.2
CN1904100000000	19	041	Clay County, IA	2005	NA	9490	9115	375	4
CN1904300000000	19	043	Clayton County, IA	2005	NA	9496	8879	617	6.5
CN1904500000000	19	045	Clinton County, IA	2005	NA	26826	25554	1272	4.7
CN1904700000000	19	047	Crawford County, IA	2005	NA	9173	8822	351	3.8
CN1904900000000	19	049	Dallas County, IA	2005	NA	29439	28444	995	3.4
CN1905100000000	19	051	Davis County, IA	2005	NA	4124	3904	220	5.3
CN1905300000000	19	053	Decatur County, IA	2005	NA	4192	3988	204	4.9
CN1905500000000	19	055	Delaware County, IA	2005	NA	10443	9984	459	4.4
CN1905700000000	19	057	Des Moines County, IA	2005	NA	20863	19732	1131	5.4
CN1905900000000	19	059	Dickinson County, IA	2005	NA	10164	9728	436	4.3
CN1906100000000	19	061	Dubuque County, IA	2005	NA	50793	48597	2196	4.3
CN1906300000000	19	063	Emmet County, IA	2005	NA	5944	5682	262	4.4
CN1906500000000	19	065	Fayette County, IA	2005	NA	11079	10524	555	5
CN1906700000000	19	067	Floyd County, IA	2005	NA	8813	8370	443	5
CN1906900000000	19	069	Franklin County, IA	2005	NA	5718	5451	267	4.7
CN1907100000000	19	071	Fremont County, IA	2005	NA	3947	3790	157	4
CN1907300000000	19	073	Greene County, IA	2005	NA	5056	4824	232	4.6
CN1907500000000	19	075	Grundy County, IA	2005	NA	6876	6617	259	3.8
CN1907700000000	19	077	Guthrie County, IA	2005	NA	6116	5861	255	4.2
CN1907900000000	19	079	Hamilton County, IA	2005	NA	8671	8335	336	3.9
CN1908100000000	19	081	Hancock County, IA	2005	NA	6332	6045	287	4.5
CN1908300000000	19	083	Hardin County, IA	2005	NA	8944	8521	423	4.7
CN1908500000000	19	085	Harrison County, IA	2005	NA	8066	7689	377	4.7
CN1908700000000	19	087	Henry County, IA	2005	NA	10490	9971	519	4.9
CN1908900000000	19	089	Howard County, IA	2005	NA	5196	4968	228	4.4
CN1909100000000	19	091	Humboldt County, IA	2005	NA	5190	4999	191	3.7
CN1909300000000	19	093	Ida County, IA	2005	NA	3923	3767	156	4
CN1909500000000	19	095	Iowa County, IA	2005	NA	8819	8431	388	4.4
CN1909700000000	19	097	Jackson County, IA	2005	NA	11183	10593	590	5.3
CN1909900000000	19	099	Jasper County, IA	2005	NA	18644	17551	1093	5.9
CN1910100000000	19	101	Jefferson County, IA	2005	NA	8287	7903	384	4.6
CN1910300000000	19	103	Johnson County, IA	2005	NA	73815	71497	2318	3.1
CN1910500000000	19	105	Jones County, IA	2005	NA	10423	9927	496	4.8
CN1910700000000	19	107	Keokuk County, IA	2005	NA	5815	5539	276	4.7
CN1910900000000	19	109	Kossuth County, IA	2005	NA	8883	8529	354	4
CN1911100000000	19	111	Lee County, IA	2005	NA	17402	16262	1140	6.6
CN1911300000000	19	113	Linn County, IA	2005	NA	113248	108404	4844	4.3
CN1911500000000	19	115	Louisa County, IA	2005	NA	6259	5984	275	4.4
CN1911700000000	19	117	Lucas County, IA	2005	NA	4838	4588	250	5.2
CN1911900000000	19	119	Lyon County, IA	2005	NA	6452	6264	188	2.9
CN1912100000000	19	121	Madison County, IA	2005	NA	8141	7771	370	4.5
CN1912300000000	19	123	Mahaska County, IA	2005	NA	11647	11149	498	4.3
CN1912500000000	19	125	Marion County, IA	2005	NA	17599	16904	695	3.9
CN1912700000000	19	127	Marshall County, IA	2005	NA	20482	19505	977	4.8
CN1912900000000	19	129	Mills County, IA	2005	NA	8177	7845	332	4.1
CN1913100000000	19	131	Mitchell County, IA	2005	NA	5347	5120	227	4.2
CN1913300000000	19	133	Monona County, IA	2005	NA	4712	4443	269	5.7
CN1913500000000	19	135	Monroe County, IA	2005	NA	3873	3678	195	5
CN1913700000000	19	137	Montgomery County, IA	2005	NA	5853	5599	254	4.3
CN1913900000000	19	139	Muscatine County, IA	2005	NA	23383	22478	905	3.9
CN1914100000000	19	141	O'Brien County, IA	2005	NA	7600	7312	288	3.8
CN1914300000000	19	143	Osceola County, IA	2005	NA	3439	3303	136	4
CN1914500000000	19	145	Page County, IA	2005	NA	8118	7807	311	3.8
CN1914700000000	19	147	Palo Alto County, IA	2005	NA	5100	4898	202	4
CN1914900000000	19	149	Plymouth County, IA	2005	NA	14087	13594	493	3.5
CN1915100000000	19	151	Pocahontas County, IA	2005	NA	3862	3702	160	4.1
CN1915300000000	19	153	Polk County, IA	2005	NA	227980	218864	9116	4
CN1915500000000	19	155	Pottawattamie County, IA	2005	NA	48658	46274	2384	4.9
CN1915700000000	19	157	Poweshiek County, IA	2005	NA	10271	9800	471	4.6
CN1915900000000	19	159	Ringgold County, IA	2005	NA	2428	2317	111	4.6
CN1916100000000	19	161	Sac County, IA	2005	NA	5757	5531	226	3.9
CN1916300000000	19	163	Scott County, IA	2005	NA	88136	84230	3906	4.4
CN1916500000000	19	165	Shelby County, IA	2005	NA	7069	6807	262	3.7
CN1916700000000	19	167	Sioux County, IA	2005	NA	18840	18293	547	2.9
CN1916900000000	19	169	Story County, IA	2005	NA	46922	45500	1422	3
CN1917100000000	19	171	Tama County, IA	2005	NA	8980	8482	498	5.5
CN1917300000000	19	173	Taylor County, IA	2005	NA	3365	3237	128	3.8
CN1917500000000	19	175	Union County, IA	2005	NA	6339	6026	313	4.9
CN1917700000000	19	177	Van Buren County, IA	2005	NA	3812	3616	196	5.1
CN1917900000000	19	179	Wapello County, IA	2005	NA	19153	18109	1044	5.5
CN1918100000000	19	181	Warren County, IA	2005	NA	24600	23699	901	3.7
CN1918300000000	19	183	Washington County, IA	2005	NA	12251	11792	459	3.7
CN1918500000000	19	185	Wayne County, IA	2005	NA	3166	3020	146	4.6
CN1918700000000	19	187	Webster County, IA	2005	NA	19705	18862	843	4.3
CN1918900000000	19	189	Winnebago County, IA	2005	NA	5953	5682	271	4.6
CN1919100000000	19	191	Winneshiek County, IA	2005	NA	12433	11913	520	4.2
CN1919300000000	19	193	Woodbury County, IA	2005	NA	53329	50751	2578	4.8
CN1919500000000	19	195	Worth County, IA	2005	NA	4611	4399	212	4.6
CN1919700000000	19	197	Wright County, IA	2005	NA	7153	6849	304	4.2
CN2000100000000	20	001	Allen County, KS	2005	NA	7195	6810	385	5.4
CN2000300000000	20	003	Anderson County, KS	2005	NA	4039	3800	239	5.9
CN2000500000000	20	005	Atchison County, KS	2005	NA	8677	8202	475	5.5
CN2000700000000	20	007	Barber County, KS	2005	NA	2601	2506	95	3.7
CN2000900000000	20	009	Barton County, KS	2005	NA	14792	14199	593	4
CN2001100000000	20	011	Bourbon County, KS	2005	NA	8679	8243	436	5
CN2001300000000	20	013	Brown County, KS	2005	NA	5601	5332	269	4.8
CN2001500000000	20	015	Butler County, KS	2005	NA	32038	30277	1761	5.5
CN2001700000000	20	017	Chase County, KS	2005	NA	1688	1619	69	4.1
CN2001900000000	20	019	Chautauqua County, KS	2005	NA	1965	1861	104	5.3
CN2002100000000	20	021	Cherokee County, KS	2005	NA	10896	10194	702	6.4
CN2002300000000	20	023	Cheyenne County, KS	2005	NA	1539	1470	69	4.5
CN2002500000000	20	025	Clark County, KS	2005	NA	1181	1140	41	3.5
CN2002700000000	20	027	Clay County, KS	2005	NA	4873	4674	199	4.1
CN2002900000000	20	029	Cloud County, KS	2005	NA	5687	5472	215	3.8
CN2003100000000	20	031	Coffey County, KS	2005	NA	5154	4867	287	5.6
CN2003300000000	20	033	Comanche County, KS	2005	NA	1074	1043	31	2.9
CN2003500000000	20	035	Cowley County, KS	2005	NA	17755	16779	976	5.5
CN2003700000000	20	037	Crawford County, KS	2005	NA	19439	18327	1112	5.7
CN2003900000000	20	039	Decatur County, KS	2005	NA	1699	1642	57	3.4
CN2004100000000	20	041	Dickinson County, KS	2005	NA	10544	10071	473	4.5
CN2004300000000	20	043	Doniphan County, KS	2005	NA	4436	4158	278	6.3
CN2004500000000	20	045	Douglas County, KS	2005	NA	63186	60679	2507	4
CN2004700000000	20	047	Edwards County, KS	2005	NA	1787	1727	60	3.4
CN2004900000000	20	049	Elk County, KS	2005	NA	1452	1372	80	5.5
CN2005100000000	20	051	Ellis County, KS	2005	NA	16637	16076	561	3.4
CN2005300000000	20	053	Ellsworth County, KS	2005	NA	3398	3265	133	3.9
CN2005500000000	20	055	Finney County, KS	2005	NA	18059	17314	745	4.1
CN2005700000000	20	057	Ford County, KS	2005	NA	16676	16078	598	3.6
CN2005900000000	20	059	Franklin County, KS	2005	NA	13868	13081	787	5.7
CN2006100000000	20	061	Geary County, KS	2005	NA	11144	10484	660	5.9
CN2006300000000	20	063	Gove County, KS	2005	NA	1517	1471	46	3
CN2006500000000	20	065	Graham County, KS	2005	NA	1411	1361	50	3.5
CN2006700000000	20	067	Grant County, KS	2005	NA	3787	3652	135	3.6
CN2006900000000	20	069	Gray County, KS	2005	NA	3155	3060	95	3
CN2007100000000	20	071	Greeley County, KS	2005	NA	742	712	30	4
CN2007300000000	20	073	Greenwood County, KS	2005	NA	3613	3422	191	5.3
CN2007500000000	20	075	Hamilton County, KS	2005	NA	1246	1205	41	3.3
CN2007700000000	20	077	Harper County, KS	2005	NA	3420	3295	125	3.7
CN2007900000000	20	079	Harvey County, KS	2005	NA	18030	17222	808	4.5
CN2008100000000	20	081	Haskell County, KS	2005	NA	2145	2079	66	3.1
CN2008300000000	20	083	Hodgeman County, KS	2005	NA	965	927	38	3.9
CN2008500000000	20	085	Jackson County, KS	2005	NA	7157	6744	413	5.8
CN2008700000000	20	087	Jefferson County, KS	2005	NA	10146	9622	524	5.2
CN2008900000000	20	089	Jewell County, KS	2005	NA	1974	1911	63	3.2
CN2009100000000	20	091	Johnson County, KS	2005	NA	290970	277684	13286	4.6
CN2009300000000	20	093	Kearny County, KS	2005	NA	2018	1933	85	4.2
CN2009500000000	20	095	Kingman County, KS	2005	NA	4332	4150	182	4.2
CN2009700000000	20	097	Kiowa County, KS	2005	NA	1616	1560	56	3.5
CN2009900000000	20	099	Labette County, KS	2005	NA	10444	9770	674	6.5
CN2010100000000	20	101	Lane County, KS	2005	NA	1064	1026	38	3.6
CN2010300000000	20	103	Leavenworth County, KS	2005	NA	33105	31070	2035	6.1
CN2010500000000	20	105	Lincoln County, KS	2005	NA	1805	1728	77	4.3
CN2010700000000	20	107	Linn County, KS	2005	NA	4897	4542	355	7.2
CN2010900000000	20	109	Logan County, KS	2005	NA	1553	1498	55	3.5
CN2011100000000	20	111	Lyon County, KS	2005	NA	19509	18621	888	4.6
CN2011300000000	20	113	McPherson County, KS	2005	NA	17084	16441	643	3.8
CN2011500000000	20	115	Marion County, KS	2005	NA	6779	6496	283	4.2
CN2011700000000	20	117	Marshall County, KS	2005	NA	5919	5699	220	3.7
CN2011900000000	20	119	Meade County, KS	2005	NA	2151	2073	78	3.6
CN2012100000000	20	121	Miami County, KS	2005	NA	16335	15500	835	5.1
CN2012300000000	20	123	Mitchell County, KS	2005	NA	3440	3311	129	3.8
CN2012500000000	20	125	Montgomery County, KS	2005	NA	16896	15910	986	5.8
CN2012700000000	20	127	Morris County, KS	2005	NA	2914	2768	146	5
CN2012900000000	20	129	Morton County, KS	2005	NA	1708	1649	59	3.5
CN2013100000000	20	131	Nemaha County, KS	2005	NA	5423	5225	198	3.7
CN2013300000000	20	133	Neosho County, KS	2005	NA	8789	8347	442	5
CN2013500000000	20	135	Ness County, KS	2005	NA	1701	1646	55	3.2
CN2013700000000	20	137	Norton County, KS	2005	NA	2725	2626	99	3.6
CN2013900000000	20	139	Osage County, KS	2005	NA	9123	8559	564	6.2
CN2014100000000	20	141	Osborne County, KS	2005	NA	2298	2210	88	3.8
CN2014300000000	20	143	Ottawa County, KS	2005	NA	3368	3215	153	4.5
CN2014500000000	20	145	Pawnee County, KS	2005	NA	3866	3720	146	3.8
CN2014700000000	20	147	Phillips County, KS	2005	NA	3079	2966	113	3.7
CN2014900000000	20	149	Pottawatomie County, KS	2005	NA	10813	10373	440	4.1
CN2015100000000	20	151	Pratt County, KS	2005	NA	5493	5298	195	3.5
CN2015300000000	20	153	Rawlins County, KS	2005	NA	1339	1286	53	4
CN2015500000000	20	155	Reno County, KS	2005	NA	32566	30952	1614	5
CN2015700000000	20	157	Republic County, KS	2005	NA	2756	2644	112	4.1
CN2015900000000	20	159	Rice County, KS	2005	NA	5476	5226	250	4.6
CN2016100000000	20	161	Riley County, KS	2005	NA	33993	32724	1269	3.7
CN2016300000000	20	163	Rooks County, KS	2005	NA	2673	2560	113	4.2
CN2016500000000	20	165	Rush County, KS	2005	NA	1660	1593	67	4
CN2016700000000	20	167	Russell County, KS	2005	NA	3466	3305	161	4.6
CN2016900000000	20	169	Saline County, KS	2005	NA	30355	29026	1329	4.4
CN2017100000000	20	171	Scott County, KS	2005	NA	2824	2729	95	3.4
CN2017300000000	20	173	Sedgwick County, KS	2005	NA	244942	231582	13360	5.5
CN2017500000000	20	175	Seward County, KS	2005	NA	10454	10043	411	3.9
CN2017700000000	20	177	Shawnee County, KS	2005	NA	93338	88245	5093	5.5
CN2017900000000	20	179	Sheridan County, KS	2005	NA	1520	1477	43	2.8
CN2018100000000	20	181	Sherman County, KS	2005	NA	3606	3483	123	3.4
CN2018300000000	20	183	Smith County, KS	2005	NA	2256	2174	82	3.6
CN2018500000000	20	185	Stafford County, KS	2005	NA	2223	2136	87	3.9
CN2018700000000	20	187	Stanton County, KS	2005	NA	1136	1102	34	3
CN2018900000000	20	189	Stevens County, KS	2005	NA	2403	2306	97	4
CN2019100000000	20	191	Sumner County, KS	2005	NA	12272	11551	721	5.9
CN2019300000000	20	193	Thomas County, KS	2005	NA	4331	4195	136	3.1
CN2019500000000	20	195	Trego County, KS	2005	NA	1722	1665	57	3.3
CN2019700000000	20	197	Wabaunsee County, KS	2005	NA	3775	3604	171	4.5
CN2019900000000	20	199	Wallace County, KS	2005	NA	928	900	28	3
CN2020100000000	20	201	Washington County, KS	2005	NA	3410	3280	130	3.8
CN2020300000000	20	203	Wichita County, KS	2005	NA	1305	1259	46	3.5
CN2020500000000	20	205	Wilson County, KS	2005	NA	5397	5157	240	4.4
CN2020700000000	20	207	Woodson County, KS	2005	NA	1683	1576	107	6.4
CN2020900000000	20	209	Wyandotte County, KS	2005	NA	73559	67194	6365	8.7
CN2100100000000	21	001	Adair County, KY	2005	NA	8675	8190	485	5.6
CN2100300000000	21	003	Allen County, KY	2005	NA	8586	8029	557	6.5
CN2100500000000	21	005	Anderson County, KY	2005	NA	10616	10108	508	4.8
CN2100700000000	21	007	Ballard County, KY	2005	NA	4180	3895	285	6.8
CN2100900000000	21	009	Barren County, KY	2005	NA	19363	18320	1043	5.4
CN2101100000000	21	011	Bath County, KY	2005	NA	5015	4605	410	8.2
CN2101300000000	21	013	Bell County, KY	2005	NA	9425	8726	699	7.4
CN2101500000000	21	015	Boone County, KY	2005	NA	59889	57025	2864	4.8
CN2101700000000	21	017	Bourbon County, KY	2005	NA	9810	9276	534	5.4
CN2101900000000	21	019	Boyd County, KY	2005	NA	22989	21631	1358	5.9
CN2102100000000	21	021	Boyle County, KY	2005	NA	12713	11872	841	6.6
CN2102300000000	21	023	Bracken County, KY	2005	NA	4422	4142	280	6.3
CN2102500000000	21	025	Breathitt County, KY	2005	NA	5563	5150	413	7.4
CN2102700000000	21	027	Breckinridge County, KY	2005	NA	8919	8296	623	7
CN2102900000000	21	029	Bullitt County, KY	2005	NA	35870	33830	2040	5.7
CN2103100000000	21	031	Butler County, KY	2005	NA	5719	5312	407	7.1
CN2103300000000	21	033	Caldwell County, KY	2005	NA	6394	6019	375	5.9
CN2103500000000	21	035	Calloway County, KY	2005	NA	17597	16615	982	5.6
CN2103700000000	21	037	Campbell County, KY	2005	NA	45946	43475	2471	5.4
CN2103900000000	21	039	Carlisle County, KY	2005	NA	2321	2152	169	7.3
CN2104100000000	21	041	Carroll County, KY	2005	NA	5619	5307	312	5.6
CN2104300000000	21	043	Carter County, KY	2005	NA	13629	12504	1125	8.3
CN2104500000000	21	045	Casey County, KY	2005	NA	7075	6646	429	6.1
CN2104700000000	21	047	Christian County, KY	2005	NA	26460	24620	1840	7
CN2104900000000	21	049	Clark County, KY	2005	NA	17061	16130	931	5.5
CN2105100000000	21	051	Clay County, KY	2005	NA	7153	6547	606	8.5
CN2105300000000	21	053	Clinton County, KY	2005	NA	4542	4251	291	6.4
CN2105500000000	21	055	Crittenden County, KY	2005	NA	4001	3762	239	6
CN2105700000000	21	057	Cumberland County, KY	2005	NA	2963	2728	235	7.9
CN2105900000000	21	059	Daviess County, KY	2005	NA	46341	43643	2698	5.8
CN2106100000000	21	061	Edmonson County, KY	2005	NA	5408	5024	384	7.1
CN2106300000000	21	063	Elliott County, KY	2005	NA	3006	2716	290	9.6
CN2106500000000	21	065	Estill County, KY	2005	NA	6039	5609	430	7.1
CN2106700000000	21	067	Fayette County, KY	2005	NA	146365	139834	6531	4.5
CN2106900000000	21	069	Fleming County, KY	2005	NA	6629	6229	400	6
CN2107100000000	21	071	Floyd County, KY	2005	NA	14982	13928	1054	7
CN2107300000000	21	073	Franklin County, KY	2005	NA	25110	23945	1165	4.6
CN2107500000000	21	075	Fulton County, KY	2005	NA	2858	2647	211	7.4
CN2107700000000	21	077	Gallatin County, KY	2005	NA	4053	3815	238	5.9
CN2107900000000	21	079	Garrard County, KY	2005	NA	7522	7057	465	6.2
CN2108100000000	21	081	Grant County, KY	2005	NA	12592	11903	689	5.5
CN2108300000000	21	083	Graves County, KY	2005	NA	16336	14709	1627	10
CN2108500000000	21	085	Grayson County, KY	2005	NA	11498	10509	989	8.6
CN2108700000000	21	087	Green County, KY	2005	NA	5585	5241	344	6.2
CN2108900000000	21	089	Greenup County, KY	2005	NA	17203	16106	1097	6.4
CN2109100000000	21	091	Hancock County, KY	2005	NA	4154	3895	259	6.2
CN2109300000000	21	093	Hardin County, KY	2005	NA	46216	43522	2694	5.8
CN2109500000000	21	095	Harlan County, KY	2005	NA	10052	9264	788	7.8
CN2109700000000	21	097	Harrison County, KY	2005	NA	8880	8358	522	5.9
CN2109900000000	21	099	Hart County, KY	2005	NA	7814	7309	505	6.5
CN2110100000000	21	101	Henderson County, KY	2005	NA	23169	21920	1249	5.4
CN2110300000000	21	103	Henry County, KY	2005	NA	7904	7452	452	5.7
CN2110500000000	21	105	Hickman County, KY	2005	NA	2049	1890	159	7.8
CN2110700000000	21	107	Hopkins County, KY	2005	NA	22736	21403	1333	5.9
CN2110900000000	21	109	Jackson County, KY	2005	NA	4767	4410	357	7.5
CN2111100000000	21	111	Jefferson County, KY	2005	NA	351726	330869	20857	5.9
CN2111300000000	21	113	Jessamine County, KY	2005	NA	21888	20862	1026	4.7
CN2111500000000	21	115	Johnson County, KY	2005	NA	9712	9058	654	6.7
CN2111700000000	21	117	Kenton County, KY	2005	NA	84011	79788	4223	5
CN2111900000000	21	119	Knott County, KY	2005	NA	6666	6207	459	6.9
CN2112100000000	21	121	Knox County, KY	2005	NA	12093	11322	771	6.4
CN2112300000000	21	123	Larue County, KY	2005	NA	6884	6451	433	6.3
CN2112500000000	21	125	Laurel County, KY	2005	NA	25952	24505	1447	5.6
CN2112700000000	21	127	Lawrence County, KY	2005	NA	5809	5342	467	8
CN2112900000000	21	129	Lee County, KY	2005	NA	2692	2487	205	7.6
CN2113100000000	21	131	Leslie County, KY	2005	NA	3586	3294	292	8.1
CN2113300000000	21	133	Letcher County, KY	2005	NA	9036	8383	653	7.2
CN2113500000000	21	135	Lewis County, KY	2005	NA	5577	5052	525	9.4
CN2113700000000	21	137	Lincoln County, KY	2005	NA	10652	9921	731	6.9
CN2113900000000	21	139	Livingston County, KY	2005	NA	4835	4554	281	5.8
CN2114100000000	21	141	Logan County, KY	2005	NA	12306	11518	788	6.4
CN2114300000000	21	143	Lyon County, KY	2005	NA	3217	2981	236	7.3
CN2114500000000	21	145	McCracken County, KY	2005	NA	31187	29378	1809	5.8
CN2114700000000	21	147	McCreary County, KY	2005	NA	6015	5494	521	8.7
CN2114900000000	21	149	McLean County, KY	2005	NA	4642	4308	334	7.2
CN2115100000000	21	151	Madison County, KY	2005	NA	41502	39467	2035	4.9
CN2115300000000	21	153	Magoffin County, KY	2005	NA	4479	3957	522	11.7
CN2115500000000	21	155	Marion County, KY	2005	NA	9340	8805	535	5.7
CN2115700000000	21	157	Marshall County, KY	2005	NA	14427	13489	938	6.5
CN2115900000000	21	159	Martin County, KY	2005	NA	3672	3390	282	7.7
CN2116100000000	21	161	Mason County, KY	2005	NA	8732	8184	548	6.3
CN2116300000000	21	163	Meade County, KY	2005	NA	12179	11324	855	7
CN2116500000000	21	165	Menifee County, KY	2005	NA	2600	2389	211	8.1
CN2116700000000	21	167	Mercer County, KY	2005	NA	10466	9863	603	5.8
CN2116900000000	21	169	Metcalfe County, KY	2005	NA	4476	4225	251	5.6
CN2117100000000	21	171	Monroe County, KY	2005	NA	5038	4718	320	6.4
CN2117300000000	21	173	Montgomery County, KY	2005	NA	11712	10903	809	6.9
CN2117500000000	21	175	Morgan County, KY	2005	NA	5010	4529	481	9.6
CN2117700000000	21	177	Muhlenberg County, KY	2005	NA	12827	11728	1099	8.6
CN2117900000000	21	179	Nelson County, KY	2005	NA	20580	19280	1300	6.3
CN2118100000000	21	181	Nicholas County, KY	2005	NA	2999	2715	284	9.5
CN2118300000000	21	183	Ohio County, KY	2005	NA	11590	10832	758	6.5
CN2118500000000	21	185	Oldham County, KY	2005	NA	26226	24974	1252	4.8
CN2118700000000	21	187	Owen County, KY	2005	NA	5133	4835	298	5.8
CN2118900000000	21	189	Owsley County, KY	2005	NA	1556	1436	120	7.7
CN2119100000000	21	191	Pendleton County, KY	2005	NA	7494	7069	425	5.7
CN2119300000000	21	193	Perry County, KY	2005	NA	11300	10495	805	7.1
CN2119500000000	21	195	Pike County, KY	2005	NA	24724	23181	1543	6.2
CN2119700000000	21	197	Powell County, KY	2005	NA	5503	5079	424	7.7
CN2119900000000	21	199	Pulaski County, KY	2005	NA	26782	25179	1603	6
CN2120100000000	21	201	Robertson County, KY	2005	NA	1079	1003	76	7
CN2120300000000	21	203	Rockcastle County, KY	2005	NA	7392	6864	528	7.1
CN2120500000000	21	205	Rowan County, KY	2005	NA	12137	11439	698	5.8
CN2120700000000	21	207	Russell County, KY	2005	NA	7864	7346	518	6.6
CN2120900000000	21	209	Scott County, KY	2005	NA	20631	19630	1001	4.9
CN2121100000000	21	211	Shelby County, KY	2005	NA	20059	19022	1037	5.2
CN2121300000000	21	213	Simpson County, KY	2005	NA	8811	8319	492	5.6
CN2121500000000	21	215	Spencer County, KY	2005	NA	8190	7752	438	5.3
CN2121700000000	21	217	Taylor County, KY	2005	NA	12891	12214	677	5.3
CN2121900000000	21	219	Todd County, KY	2005	NA	5334	4986	348	6.5
CN2122100000000	21	221	Trigg County, KY	2005	NA	6469	6044	425	6.6
CN2122300000000	21	223	Trimble County, KY	2005	NA	4358	4080	278	6.4
CN2122500000000	21	225	Union County, KY	2005	NA	7192	6764	428	6
CN2122700000000	21	227	Warren County, KY	2005	NA	55266	52543	2723	4.9
CN2122900000000	21	229	Washington County, KY	2005	NA	5149	4840	309	6
CN2123100000000	21	231	Wayne County, KY	2005	NA	8709	8177	532	6.1
CN2123300000000	21	233	Webster County, KY	2005	NA	6672	6337	335	5
CN2123500000000	21	235	Whitley County, KY	2005	NA	15358	14441	917	6
CN2123700000000	21	237	Wolfe County, KY	2005	NA	2306	2076	230	10
CN2123900000000	21	239	Woodford County, KY	2005	NA	13300	12747	553	4.2
CN2200100000000	22	001	Acadia Parish, LA	2005	NA	25409	23861	1548	6.1
CN2200300000000	22	003	Allen Parish, LA	2005	NA	8697	7854	843	9.7
CN2200500000000	22	005	Ascension Parish, LA	2005	NA	45815	42827	2988	6.5
CN2200700000000	22	007	Assumption Parish, LA	2005	NA	10045	9053	992	9.9
CN2200900000000	22	009	Avoyelles Parish, LA	2005	NA	16059	14730	1329	8.3
CN2201100000000	22	011	Beauregard Parish, LA	2005	NA	14318	13243	1075	7.5
CN2201300000000	22	013	Bienville Parish, LA	2005	NA	6270	5809	461	7.4
CN2201500000000	22	015	Bossier Parish, LA	2005	NA	51496	48695	2801	5.4
CN2201700000000	22	017	Caddo Parish, LA	2005	NA	117535	110343	7192	6.1
CN2201900000000	22	019	Calcasieu Parish, LA	2005	NA	91004	84177	6827	7.5
CN2202100000000	22	021	Caldwell Parish, LA	2005	NA	4328	4010	318	7.3
CN2202300000000	22	023	Cameron Parish, LA	2005	NA	4461	4201	260	5.8
CN2202500000000	22	025	Catahoula Parish, LA	2005	NA	4156	3808	348	8.4
CN2202700000000	22	027	Claiborne Parish, LA	2005	NA	6930	6486	444	6.4
CN2202900000000	22	029	Concordia Parish, LA	2005	NA	7361	6577	784	10.7
CN2203100000000	22	031	De Soto Parish, LA	2005	NA	11419	10627	792	6.9
CN2203300000000	22	033	East Baton Rouge Parish, LA	2005	NA	212877	198114	14763	6.9
CN2203500000000	22	035	East Carroll Parish, LA	2005	NA	2926	2536	390	13.3
CN2203700000000	22	037	East Feliciana Parish, LA	2005	NA	8204	7644	560	6.8
CN2203900000000	22	039	Evangeline Parish, LA	2005	NA	12148	11269	879	7.2
CN2204100000000	22	041	Franklin Parish, LA	2005	NA	7818	7103	715	9.1
CN2204300000000	22	043	Grant Parish, LA	2005	NA	8558	8015	543	6.3
CN2204500000000	22	045	Iberia Parish, LA	2005	NA	32671	30483	2188	6.7
CN2204700000000	22	047	Iberville Parish, LA	2005	NA	12609	11474	1135	9
CN2204900000000	22	049	Jackson Parish, LA	2005	NA	6412	6028	384	6
CN2205100000000	22	051	Jefferson Parish, LA	2005	1	223555.33333333334	213637	9918.333333333334	4.466666666666667
CN2205300000000	22	053	Jefferson Davis Parish, LA	2005	NA	14294	13411	883	6.2
CN2205500000000	22	055	Lafayette Parish, LA	2005	NA	104121	98670	5451	5.2
CN2205700000000	22	057	Lafourche Parish, LA	2005	NA	45371	42664	2707	6
CN2205900000000	22	059	LaSalle Parish, LA	2005	NA	5796	5482	314	5.4
CN2206100000000	22	061	Lincoln Parish, LA	2005	NA	18616	17335	1281	6.9
CN2206300000000	22	063	Livingston Parish, LA	2005	NA	53346	50173	3173	5.9
CN2206500000000	22	065	Madison Parish, LA	2005	NA	4682	4251	431	9.2
CN2206700000000	22	067	Morehouse Parish, LA	2005	NA	11717	10640	1077	9.2
CN2206900000000	22	069	Natchitoches Parish, LA	2005	NA	17850	16615	1235	6.9
CN2207100000000	22	071	Orleans Parish, LA	2005	1	166628.33333333334	157039	9589.333333333334	5.633333333333334
CN2207300000000	22	073	Ouachita Parish, LA	2005	NA	72428	67986	4442	6.1
CN2207500000000	22	075	Plaquemines Parish, LA	2005	1	10699	10157.333333333334	541.6666666666666	4.966666666666667
CN2207700000000	22	077	Pointe Coupee Parish, LA	2005	NA	9917	9037	880	8.9
CN2207900000000	22	079	Rapides Parish, LA	2005	NA	59209	55567	3642	6.2
CN2208100000000	22	081	Red River Parish, LA	2005	NA	3342	3046	296	8.9
CN2208300000000	22	083	Richland Parish, LA	2005	NA	8560	7895	665	7.8
CN2208500000000	22	085	Sabine Parish, LA	2005	NA	9459	8878	581	6.1
CN2208700000000	22	087	St. Bernard Parish, LA	2005	1	23640.333333333332	22398	1242.3333333333333	5.033333333333333
CN2208900000000	22	089	St. Charles Parish, LA	2005	1	24733.666666666668	23563	1170.6666666666667	4.733333333333333
CN2209100000000	22	091	St. Helena Parish, LA	2005	NA	4370	3756	614	14.1
CN2209300000000	22	093	St. James Parish, LA	2005	NA	9021	8067	954	10.6
CN2209500000000	22	095	St. John the Baptist Parish, LA	2005	1	21181.666666666668	19865.333333333332	1316.3333333333333	6.266666666666667
CN2209700000000	22	097	St. Landry Parish, LA	2005	NA	37026	34372	2654	7.2
CN2209900000000	22	099	St. Martin Parish, LA	2005	NA	22687	21322	1365	6
CN2210100000000	22	101	St. Mary Parish, LA	2005	NA	22426	20448	1978	8.8
CN2210300000000	22	103	St. Tammany Parish, LA	2005	1	108120.33333333333	103877.66666666667	4242.666666666667	3.933333333333333
CN2210500000000	22	105	Tangipahoa Parish, LA	2005	NA	50534	45709	4825	9.5
CN2210700000000	22	107	Tensas Parish, LA	2005	NA	2300	1985	315	13.7
CN2210900000000	22	109	Terrebonne Parish, LA	2005	NA	51003	47669	3334	6.5
CN2211100000000	22	111	Union Parish, LA	2005	NA	10458	9805	653	6.2
CN2211300000000	22	113	Vermilion Parish, LA	2005	NA	23387	21973	1414	6
CN2211500000000	22	115	Vernon Parish, LA	2005	NA	21068	19829	1239	5.9
CN2211700000000	22	117	Washington Parish, LA	2005	NA	16300	14652	1648	10.1
CN2211900000000	22	119	Webster Parish, LA	2005	NA	19464	18212	1252	6.4
CN2212100000000	22	121	West Baton Rouge Parish, LA	2005	NA	10456	9720	736	7
CN2212300000000	22	123	West Carroll Parish, LA	2005	NA	4732	4210	522	11
CN2212500000000	22	125	West Feliciana Parish, LA	2005	NA	4932	4533	399	8.1
CN2212700000000	22	127	Winn Parish, LA	2005	NA	6243	5843	400	6.4
CN2300100000000	23	001	Androscoggin County, ME	2005	NA	57033	54212	2821	4.9
CN2300300000000	23	003	Aroostook County, ME	2005	NA	35237	32903	2334	6.6
CN2300500000000	23	005	Cumberland County, ME	2005	NA	155620	149953	5667	3.6
CN2300700000000	23	007	Franklin County, ME	2005	NA	14639	13793	846	5.8
CN2300900000000	23	009	Hancock County, ME	2005	NA	29883	28227	1656	5.5
CN2301100000000	23	011	Kennebec County, ME	2005	NA	62219	59093	3126	5
CN2301300000000	23	013	Knox County, ME	2005	NA	21374	20474	900	4.2
CN2301500000000	23	015	Lincoln County, ME	2005	NA	18258	17442	816	4.5
CN2301700000000	23	017	Oxford County, ME	2005	NA	28122	26492	1630	5.8
CN2301900000000	23	019	Penobscot County, ME	2005	NA	77286	73351	3935	5.1
CN2302100000000	23	021	Piscataquis County, ME	2005	NA	7517	6964	553	7.4
CN2302300000000	23	023	Sagadahoc County, ME	2005	NA	18535	17724	811	4.4
CN2302500000000	23	025	Somerset County, ME	2005	NA	24780	22888	1892	7.6
CN2302700000000	23	027	Waldo County, ME	2005	NA	19519	18465	1054	5.4
CN2302900000000	23	029	Washington County, ME	2005	NA	15343	14037	1306	8.5
CN2303100000000	23	031	York County, ME	2005	NA	111780	107108	4672	4.2
CN2400100000000	24	001	Allegany County, MD	2005	NA	35318	33166	2152	6.1
CN2400300000000	24	003	Anne Arundel County, MD	2005	NA	274457	264791	9666	3.5
CN2400500000000	24	005	Baltimore County, MD	2005	NA	419256	401317	17939	4.3
CN2400900000000	24	009	Calvert County, MD	2005	NA	46014	44445	1569	3.4
CN2401100000000	24	011	Caroline County, MD	2005	NA	16172	15464	708	4.4
CN2401300000000	24	013	Carroll County, MD	2005	NA	91900	88855	3045	3.3
CN2401500000000	24	015	Cecil County, MD	2005	NA	49714	47424	2290	4.6
CN2401700000000	24	017	Charles County, MD	2005	NA	72704	70220	2484	3.4
CN2401900000000	24	019	Dorchester County, MD	2005	NA	16998	16075	923	5.4
CN2402100000000	24	021	Frederick County, MD	2005	NA	120349	116571	3778	3.1
CN2402300000000	24	023	Garrett County, MD	2005	NA	16519	15725	794	4.8
CN2402500000000	24	025	Harford County, MD	2005	NA	129191	124093	5098	3.9
CN2402700000000	24	027	Howard County, MD	2005	NA	154170	149405	4765	3.1
CN2402900000000	24	029	Kent County, MD	2005	NA	10919	10462	457	4.2
CN2403100000000	24	031	Montgomery County, MD	2005	NA	504410	488676	15734	3.1
CN2403300000000	24	033	Prince George's County, MD	2005	NA	442341	422550	19791	4.5
CN2403500000000	24	035	Queen Anne's County, MD	2005	NA	25037	24160	877	3.5
CN2403700000000	24	037	St. Mary's County, MD	2005	NA	49151	47414	1737	3.5
CN2403900000000	24	039	Somerset County, MD	2005	NA	11436	10745	691	6
CN2404100000000	24	041	Talbot County, MD	2005	NA	18922	18184	738	3.9
CN2404300000000	24	043	Washington County, MD	2005	NA	67796	64816	2980	4.4
CN2404500000000	24	045	Wicomico County, MD	2005	NA	51702	49509	2193	4.2
CN2404700000000	24	047	Worcester County, MD	2005	NA	27716	25885	1831	6.6
CN2451000000000	24	510	Baltimore city, MD	2005	NA	272354	253539	18815	6.9
CN2500100000000	25	001	Barnstable County, MA	2005	NA	122143	116121	6022	4.9
CN2500300000000	25	003	Berkshire County, MA	2005	NA	72664	69494	3170	4.4
CN2500500000000	25	005	Bristol County, MA	2005	NA	287829	270614	17215	6
CN2500700000000	25	007	Dukes County, MA	2005	NA	10977	10545	432	3.9
CN2500900000000	25	009	Essex County, MA	2005	NA	375771	356017	19754	5.3
CN2501100000000	25	011	Franklin County, MA	2005	NA	39577	37877	1700	4.3
CN2501300000000	25	013	Hampden County, MA	2005	NA	224160	211095	13065	5.8
CN2501500000000	25	015	Hampshire County, MA	2005	NA	87822	84266	3556	4
CN2501700000000	25	017	Middlesex County, MA	2005	NA	810099	777113	32986	4.1
CN2501900000000	25	019	Nantucket County/town, MA	2005	NA	8138	7940	198	2.4
CN2502100000000	25	021	Norfolk County, MA	2005	NA	355887	341107	14780	4.2
CN2502300000000	25	023	Plymouth County, MA	2005	NA	258416	245829	12587	4.9
CN2502500000000	25	025	Suffolk County, MA	2005	NA	332082	314372	17710	5.3
CN2502700000000	25	027	Worcester County, MA	2005	NA	398556	377703	20853	5.2
CN2600100000000	26	001	Alcona County, MI	2005	NA	4296	3848	448	10.4
CN2600300000000	26	003	Alger County, MI	2005	NA	4384	4049	335	7.6
CN2600500000000	26	005	Allegan County, MI	2005	NA	55028	51556	3472	6.3
CN2600700000000	26	007	Alpena County, MI	2005	NA	15097	13956	1141	7.6
CN2600900000000	26	009	Antrim County, MI	2005	NA	12103	11164	939	7.8
CN2601100000000	26	011	Arenac County, MI	2005	NA	7824	7089	735	9.4
CN2601300000000	26	013	Baraga County, MI	2005	NA	4131	3666	465	11.3
CN2601500000000	26	015	Barry County, MI	2005	NA	30891	29298	1593	5.2
CN2601700000000	26	017	Bay County, MI	2005	NA	55557	51608	3949	7.1
CN2601900000000	26	019	Benzie County, MI	2005	NA	9135	8420	715	7.8
CN2602100000000	26	021	Berrien County, MI	2005	NA	79071	73591	5480	6.9
CN2602300000000	26	023	Branch County, MI	2005	NA	22721	21100	1621	7.1
CN2602500000000	26	025	Calhoun County, MI	2005	NA	71724	66925	4799	6.7
CN2602700000000	26	027	Cass County, MI	2005	NA	27659	26253	1406	5.1
CN2602900000000	26	029	Charlevoix County, MI	2005	NA	14363	13295	1068	7.4
CN2603100000000	26	031	Cheboygan County, MI	2005	NA	13225	12020	1205	9.1
CN2603300000000	26	033	Chippewa County, MI	2005	NA	17538	16024	1514	8.6
CN2603500000000	26	035	Clare County, MI	2005	NA	13482	12170	1312	9.7
CN2603700000000	26	037	Clinton County, MI	2005	NA	37266	35272	1994	5.4
CN2603900000000	26	039	Crawford County, MI	2005	NA	6800	6313	487	7.2
CN2604100000000	26	041	Delta County, MI	2005	NA	20300	18819	1481	7.3
CN2604300000000	26	043	Dickinson County, MI	2005	NA	14474	13637	837	5.8
CN2604500000000	26	045	Eaton County, MI	2005	NA	58653	55410	3243	5.5
CN2604700000000	26	047	Emmet County, MI	2005	NA	20154	18550	1604	8
CN2604900000000	26	049	Genesee County, MI	2005	NA	212686	195902	16784	7.9
CN2605100000000	26	051	Gladwin County, MI	2005	NA	10902	9776	1126	10.3
CN2605300000000	26	053	Gogebic County, MI	2005	NA	7756	7144	612	7.9
CN2605500000000	26	055	Grand Traverse County, MI	2005	NA	48348	45460	2888	6
CN2605700000000	26	057	Gratiot County, MI	2005	NA	20309	18614	1695	8.3
CN2605900000000	26	059	Hillsdale County, MI	2005	NA	22353	20645	1708	7.6
CN2606100000000	26	061	Houghton County, MI	2005	NA	17571	16423	1148	6.5
CN2606300000000	26	063	Huron County, MI	2005	NA	17061	15750	1311	7.7
CN2606500000000	26	065	Ingham County, MI	2005	NA	152166	142407	9759	6.4
CN2606700000000	26	067	Ionia County, MI	2005	NA	30924	28656	2268	7.3
CN2606900000000	26	069	Iosco County, MI	2005	NA	10958	9953	1005	9.2
CN2607100000000	26	071	Iron County, MI	2005	NA	5874	5438	436	7.4
CN2607300000000	26	073	Isabella County, MI	2005	NA	37989	36097	1892	5
CN2607500000000	26	075	Jackson County, MI	2005	NA	78307	72944	5363	6.8
CN2607700000000	26	077	Kalamazoo County, MI	2005	NA	132576	125622	6954	5.2
CN2607900000000	26	079	Kalkaska County, MI	2005	NA	8774	8110	664	7.6
CN2608100000000	26	081	Kent County, MI	2005	NA	321655	302857	18798	5.8
CN2608300000000	26	083	Keweenaw County, MI	2005	NA	1064	951	113	10.6
CN2608500000000	26	085	Lake County, MI	2005	NA	4388	3930	458	10.4
CN2608700000000	26	087	Lapeer County, MI	2005	NA	45788	42344	3444	7.5
CN2608900000000	26	089	Leelanau County, MI	2005	NA	11576	10976	600	5.2
CN2609100000000	26	091	Lenawee County, MI	2005	NA	49734	46189	3545	7.1
CN2609300000000	26	093	Livingston County, MI	2005	NA	96140	91165	4975	5.2
CN2609500000000	26	095	Luce County, MI	2005	NA	2834	2615	219	7.7
CN2609700000000	26	097	Mackinac County, MI	2005	NA	6509	5849	660	10.1
CN2609900000000	26	099	Macomb County, MI	2005	NA	428038	399805	28233	6.6
CN2610100000000	26	101	Manistee County, MI	2005	NA	12157	11188	969	8
CN2610300000000	26	103	Marquette County, MI	2005	NA	35566	33490	2076	5.8
CN2610500000000	26	105	Mason County, MI	2005	NA	15205	14013	1192	7.8
CN2610700000000	26	107	Mecosta County, MI	2005	NA	20188	18705	1483	7.3
CN2610900000000	26	109	Menominee County, MI	2005	NA	13293	12583	710	5.3
CN2611100000000	26	111	Midland County, MI	2005	NA	41907	39428	2479	5.9
CN2611300000000	26	113	Missaukee County, MI	2005	NA	6720	6217	503	7.5
CN2611500000000	26	115	Monroe County, MI	2005	NA	77855	73029	4826	6.2
CN2611700000000	26	117	Montcalm County, MI	2005	NA	29471	26895	2576	8.7
CN2611900000000	26	119	Montmorency County, MI	2005	NA	4301	3780	521	12.1
CN2612100000000	26	121	Muskegon County, MI	2005	NA	90054	83745	6309	7
CN2612300000000	26	123	Newaygo County, MI	2005	NA	23425	21667	1758	7.5
CN2612500000000	26	125	Oakland County, MI	2005	NA	642576	607355	35221	5.5
CN2612700000000	26	127	Oceana County, MI	2005	NA	14393	13221	1172	8.1
CN2612900000000	26	129	Ogemaw County, MI	2005	NA	9884	9126	758	7.7
CN2613100000000	26	131	Ontonagon County, MI	2005	NA	3578	3313	265	7.4
CN2613300000000	26	133	Osceola County, MI	2005	NA	10242	9459	783	7.6
CN2613500000000	26	135	Oscoda County, MI	2005	NA	3957	3537	420	10.6
CN2613700000000	26	137	Otsego County, MI	2005	NA	12957	12041	916	7.1
CN2613900000000	26	139	Ottawa County, MI	2005	NA	136228	129095	7133	5.2
CN2614100000000	26	141	Presque Isle County, MI	2005	NA	6222	5520	702	11.3
CN2614300000000	26	143	Roscommon County, MI	2005	NA	11205	10253	952	8.5
CN2614500000000	26	145	Saginaw County, MI	2005	NA	98365	90520	7845	8
CN2614700000000	26	147	St. Clair County, MI	2005	NA	85725	79111	6614	7.7
CN2614900000000	26	149	St. Joseph County, MI	2005	NA	30942	28946	1996	6.5
CN2615100000000	26	151	Sanilac County, MI	2005	NA	22187	20371	1816	8.2
CN2615300000000	26	153	Schoolcraft County, MI	2005	NA	4070	3633	437	10.7
CN2615500000000	26	155	Shiawassee County, MI	2005	NA	36739	33817	2922	8
CN2615700000000	26	157	Tuscola County, MI	2005	NA	29259	26868	2391	8.2
CN2615900000000	26	159	Van Buren County, MI	2005	NA	40873	37996	2877	7
CN2616100000000	26	161	Washtenaw County, MI	2005	NA	189926	181459	8467	4.5
CN2616300000000	26	163	Wayne County, MI	2005	NA	910762	835251	75511	8.3
CN2616500000000	26	165	Wexford County, MI	2005	NA	14753	13622	1131	7.7
CN2700100000000	27	001	Aitkin County, MN	2005	NA	7741	7276	465	6
CN2700300000000	27	003	Anoka County, MN	2005	NA	189702	182389	7313	3.9
CN2700500000000	27	005	Becker County, MN	2005	NA	16642	15751	891	5.4
CN2700700000000	27	007	Beltrami County, MN	2005	NA	21185	20062	1123	5.3
CN2700900000000	27	009	Benton County, MN	2005	NA	22165	21129	1036	4.7
CN2701100000000	27	011	Big Stone County, MN	2005	NA	2759	2633	126	4.6
CN2701300000000	27	013	Blue Earth County, MN	2005	NA	35479	34296	1183	3.3
CN2701500000000	27	015	Brown County, MN	2005	NA	14822	14187	635	4.3
CN2701700000000	27	017	Carlton County, MN	2005	NA	17021	16036	985	5.8
CN2701900000000	27	019	Carver County, MN	2005	NA	48068	46435	1633	3.4
CN2702100000000	27	021	Cass County, MN	2005	NA	14438	13549	889	6.2
CN2702300000000	27	023	Chippewa County, MN	2005	NA	7170	6875	295	4.1
CN2702500000000	27	025	Chisago County, MN	2005	NA	27047	25756	1291	4.8
CN2702700000000	27	027	Clay County, MN	2005	NA	30853	29791	1062	3.4
CN2702900000000	27	029	Clearwater County, MN	2005	NA	3869	3478	391	10.1
CN2703100000000	27	031	Cook County, MN	2005	NA	3241	3100	141	4.4
CN2703300000000	27	033	Cottonwood County, MN	2005	NA	6311	6038	273	4.3
CN2703500000000	27	035	Crow Wing County, MN	2005	NA	32080	30515	1565	4.9
CN2703700000000	27	037	Dakota County, MN	2005	NA	227941	219756	8185	3.6
CN2703900000000	27	039	Dodge County, MN	2005	NA	11172	10741	431	3.9
CN2704100000000	27	041	Douglas County, MN	2005	NA	20027	19266	761	3.8
CN2704300000000	27	043	Faribault County, MN	2005	NA	8048	7661	387	4.8
CN2704500000000	27	045	Fillmore County, MN	2005	NA	11274	10798	476	4.2
CN2704700000000	27	047	Freeborn County, MN	2005	NA	16243	15485	758	4.7
CN2704900000000	27	049	Goodhue County, MN	2005	NA	24721	23627	1094	4.4
CN2705100000000	27	051	Grant County, MN	2005	NA	3052	2880	172	5.6
CN2705300000000	27	053	Hennepin County, MN	2005	NA	652568	628595	23973	3.7
CN2705500000000	27	055	Houston County, MN	2005	NA	11082	10580	502	4.5
CN2705700000000	27	057	Hubbard County, MN	2005	NA	9656	9131	525	5.4
CN2705900000000	27	059	Isanti County, MN	2005	NA	21044	20029	1015	4.8
CN2706100000000	27	061	Itasca County, MN	2005	NA	22419	21092	1327	5.9
CN2706300000000	27	063	Jackson County, MN	2005	NA	6670	6444	226	3.4
CN2706500000000	27	065	Kanabec County, MN	2005	NA	7778	7256	522	6.7
CN2706700000000	27	067	Kandiyohi County, MN	2005	NA	23214	22252	962	4.1
CN2706900000000	27	069	Kittson County, MN	2005	NA	2575	2440	135	5.2
CN2707100000000	27	071	Koochiching County, MN	2005	NA	6953	6530	423	6.1
CN2707300000000	27	073	Lac qui Parle County, MN	2005	NA	4099	3939	160	3.9
CN2707500000000	27	075	Lake County, MN	2005	NA	6089	5829	260	4.3
CN2707700000000	27	077	Lake of the Woods County, MN	2005	NA	2447	2338	109	4.5
CN2707900000000	27	079	Le Sueur County, MN	2005	NA	14186	13416	770	5.4
CN2708100000000	27	081	Lincoln County, MN	2005	NA	3394	3271	123	3.6
CN2708300000000	27	083	Lyon County, MN	2005	NA	14619	14139	480	3.3
CN2708500000000	27	085	McLeod County, MN	2005	NA	20040	19222	818	4.1
CN2708700000000	27	087	Mahnomen County, MN	2005	NA	2552	2412	140	5.5
CN2708900000000	27	089	Marshall County, MN	2005	NA	5289	4915	374	7.1
CN2709100000000	27	091	Martin County, MN	2005	NA	11241	10776	465	4.1
CN2709300000000	27	093	Meeker County, MN	2005	NA	12352	11725	627	5.1
CN2709500000000	27	095	Mille Lacs County, MN	2005	NA	11974	11174	800	6.7
CN2709700000000	27	097	Morrison County, MN	2005	NA	17370	16425	945	5.4
CN2709900000000	27	099	Mower County, MN	2005	NA	20333	19559	774	3.8
CN2710100000000	27	101	Murray County, MN	2005	NA	5395	5176	219	4.1
CN2710300000000	27	103	Nicollet County, MN	2005	NA	18843	18242	601	3.2
CN2710500000000	27	105	Nobles County, MN	2005	NA	11095	10730	365	3.3
CN2710700000000	27	107	Norman County, MN	2005	NA	3619	3451	168	4.6
CN2710900000000	27	109	Olmsted County, MN	2005	NA	78290	75583	2707	3.5
CN2711100000000	27	111	Otter Tail County, MN	2005	NA	29550	28123	1427	4.8
CN2711300000000	27	113	Pennington County, MN	2005	NA	8194	7742	452	5.5
CN2711500000000	27	115	Pine County, MN	2005	NA	13666	12768	898	6.6
CN2711700000000	27	117	Pipestone County, MN	2005	NA	5049	4866	183	3.6
CN2711900000000	27	119	Polk County, MN	2005	NA	16899	16140	759	4.5
CN2712100000000	27	121	Pope County, MN	2005	NA	6093	5858	235	3.9
CN2712300000000	27	123	Ramsey County, MN	2005	NA	271356	260757	10599	3.9
CN2712500000000	27	125	Red Lake County, MN	2005	NA	2235	2082	153	6.8
CN2712700000000	27	127	Redwood County, MN	2005	NA	8201	7884	317	3.9
CN2712900000000	27	129	Renville County, MN	2005	NA	8437	8024	413	4.9
CN2713100000000	27	131	Rice County, MN	2005	NA	31538	30121	1417	4.5
CN2713300000000	27	133	Rock County, MN	2005	NA	5184	5027	157	3
CN2713500000000	27	135	Roseau County, MN	2005	NA	10185	9672	513	5
CN2713700000000	27	137	St. Louis County, MN	2005	NA	101353	96270	5083	5
CN2713900000000	27	139	Scott County, MN	2005	NA	69821	67345	2476	3.5
CN2714100000000	27	141	Sherburne County, MN	2005	NA	46529	44513	2016	4.3
CN2714300000000	27	143	Sibley County, MN	2005	NA	8874	8504	370	4.2
CN2714500000000	27	145	Stearns County, MN	2005	NA	80640	77165	3475	4.3
CN2714700000000	27	147	Steele County, MN	2005	NA	19668	18858	810	4.1
CN2714900000000	27	149	Stevens County, MN	2005	NA	5528	5328	200	3.6
CN2715100000000	27	151	Swift County, MN	2005	NA	5281	5041	240	4.5
CN2715300000000	27	153	Todd County, MN	2005	NA	12448	11819	629	5.1
CN2715500000000	27	155	Traverse County, MN	2005	NA	1850	1780	70	3.8
CN2715700000000	27	157	Wabasha County, MN	2005	NA	12593	12080	513	4.1
CN2715900000000	27	159	Wadena County, MN	2005	NA	6424	5993	431	6.7
CN2716100000000	27	161	Waseca County, MN	2005	NA	10446	9990	456	4.4
CN2716300000000	27	163	Washington County, MN	2005	NA	125591	121213	4378	3.5
CN2716500000000	27	165	Watonwan County, MN	2005	NA	5749	5512	237	4.1
CN2716700000000	27	167	Wilkin County, MN	2005	NA	3604	3472	132	3.7
CN2716900000000	27	169	Winona County, MN	2005	NA	28262	27240	1022	3.6
CN2717100000000	27	171	Wright County, MN	2005	NA	62757	60088	2669	4.3
CN2717300000000	27	173	Yellow Medicine County, MN	2005	NA	5513	5281	232	4.2
CN2800100000000	28	001	Adams County, MS	2005	NA	13403	12187	1216	9.1
CN2800300000000	28	003	Alcorn County, MS	2005	NA	15986	14873	1113	7
CN2800500000000	28	005	Amite County, MS	2005	NA	5267	4830	437	8.3
CN2800700000000	28	007	Attala County, MS	2005	NA	7659	7034	625	8.2
CN2800900000000	28	009	Benton County, MS	2005	NA	2987	2691	296	9.9
CN2801100000000	28	011	Bolivar County, MS	2005	NA	15524	14105	1419	9.1
CN2801300000000	28	013	Calhoun County, MS	2005	NA	6324	5878	446	7.1
CN2801500000000	28	015	Carroll County, MS	2005	NA	4811	4480	331	6.9
CN2801700000000	28	017	Chickasaw County, MS	2005	NA	7768	7063	705	9.1
CN2801900000000	28	019	Choctaw County, MS	2005	NA	3609	3336	273	7.6
CN2802100000000	28	021	Claiborne County, MS	2005	NA	3759	3321	438	11.7
CN2802300000000	28	023	Clarke County, MS	2005	NA	7215	6670	545	7.6
CN2802500000000	28	025	Clay County, MS	2005	NA	8547	7646	901	10.5
CN2802700000000	28	027	Coahoma County, MS	2005	NA	11127	9979	1148	10.3
CN2802900000000	28	029	Copiah County, MS	2005	NA	12489	11494	995	8
CN2803100000000	28	031	Covington County, MS	2005	NA	8793	8205	588	6.7
CN2803300000000	28	033	DeSoto County, MS	2005	NA	71502	68547	2955	4.1
CN2803500000000	28	035	Forrest County, MS	2005	NA	35646	33425	2221	6.2
CN2803700000000	28	037	Franklin County, MS	2005	NA	3119	2849	270	8.7
CN2803900000000	28	039	George County, MS	2005	NA	8562	7805	757	8.8
CN2804100000000	28	041	Greene County, MS	2005	NA	4769	4330	439	9.2
CN2804300000000	28	043	Grenada County, MS	2005	NA	10186	9443	743	7.3
CN2804500000000	28	045	Hancock County, MS	2005	NA	21028	18754	2274	10.8
CN2804700000000	28	047	Harrison County, MS	2005	NA	92740	82699	10041	10.8
CN2804900000000	28	049	Hinds County, MS	2005	NA	122092	114214	7878	6.5
CN2805100000000	28	051	Holmes County, MS	2005	NA	7045	6222	823	11.7
CN2805300000000	28	053	Humphreys County, MS	2005	NA	4301	3874	427	9.9
CN2805500000000	28	055	Issaquena County, MS	2005	NA	765	676	89	11.6
CN2805700000000	28	057	Itawamba County, MS	2005	NA	10531	9859	672	6.4
CN2805900000000	28	059	Jackson County, MS	2005	NA	62240	56060	6180	9.9
CN2806100000000	28	061	Jasper County, MS	2005	NA	7410	6836	574	7.7
CN2806300000000	28	063	Jefferson County, MS	2005	NA	2813	2399	414	14.7
CN2806500000000	28	065	Jefferson Davis County, MS	2005	NA	5429	4944	485	8.9
CN2806700000000	28	067	Jones County, MS	2005	NA	30093	28366	1727	5.7
CN2806900000000	28	069	Kemper County, MS	2005	NA	4236	3846	390	9.2
CN2807100000000	28	071	Lafayette County, MS	2005	NA	21324	20230	1094	5.1
CN2807300000000	28	073	Lamar County, MS	2005	NA	22323	21140	1183	5.3
CN2807500000000	28	075	Lauderdale County, MS	2005	NA	33605	31249	2356	7
CN2807700000000	28	077	Lawrence County, MS	2005	NA	5128	4711	417	8.1
CN2807900000000	28	079	Leake County, MS	2005	NA	8557	7936	621	7.3
CN2808100000000	28	081	Lee County, MS	2005	NA	38532	36145	2387	6.2
CN2808300000000	28	083	Leflore County, MS	2005	NA	13873	12540	1333	9.6
CN2808500000000	28	085	Lincoln County, MS	2005	NA	14552	13487	1065	7.3
CN2808700000000	28	087	Lowndes County, MS	2005	NA	25498	23594	1904	7.5
CN2808900000000	28	089	Madison County, MS	2005	NA	44044	41794	2250	5.1
CN2809100000000	28	091	Marion County, MS	2005	NA	10325	9480	845	8.2
CN2809300000000	28	093	Marshall County, MS	2005	NA	15345	14042	1303	8.5
CN2809500000000	28	095	Monroe County, MS	2005	NA	17190	15817	1373	8
CN2809700000000	28	097	Montgomery County, MS	2005	NA	4818	4435	383	7.9
CN2809900000000	28	099	Neshoba County, MS	2005	NA	14761	13889	872	5.9
CN2810100000000	28	101	Newton County, MS	2005	NA	9741	9135	606	6.2
CN2810300000000	28	103	Noxubee County, MS	2005	NA	4200	3688	512	12.2
CN2810500000000	28	105	Oktibbeha County, MS	2005	NA	20208	18993	1215	6
CN2810700000000	28	107	Panola County, MS	2005	NA	14792	13517	1275	8.6
CN2810900000000	28	109	Pearl River County, MS	2005	NA	21363	19403	1960	9.2
CN2811100000000	28	111	Perry County, MS	2005	NA	5130	4711	419	8.2
CN2811300000000	28	113	Pike County, MS	2005	NA	15522	14164	1358	8.7
CN2811500000000	28	115	Pontotoc County, MS	2005	NA	13370	12578	792	5.9
CN2811700000000	28	117	Prentiss County, MS	2005	NA	11426	10554	872	7.6
CN2811900000000	28	119	Quitman County, MS	2005	NA	3953	3588	365	9.2
CN2812100000000	28	121	Rankin County, MS	2005	NA	71680	68458	3222	4.5
CN2812300000000	28	123	Scott County, MS	2005	NA	13266	12535	731	5.5
CN2812500000000	28	125	Sharkey County, MS	2005	NA	2561	2280	281	11
CN2812700000000	28	127	Simpson County, MS	2005	NA	11967	11248	719	6
CN2812900000000	28	129	Smith County, MS	2005	NA	6847	6435	412	6
CN2813100000000	28	131	Stone County, MS	2005	NA	6830	6307	523	7.7
CN2813300000000	28	133	Sunflower County, MS	2005	NA	11187	10060	1127	10.1
CN2813500000000	28	135	Tallahatchie County, MS	2005	NA	6428	5849	579	9
CN2813700000000	28	137	Tate County, MS	2005	NA	11896	11121	775	6.5
CN2813900000000	28	139	Tippah County, MS	2005	NA	9567	8918	649	6.8
CN2814100000000	28	141	Tishomingo County, MS	2005	NA	8097	7408	689	8.5
CN2814300000000	28	143	Tunica County, MS	2005	NA	4505	4047	458	10.2
CN2814500000000	28	145	Union County, MS	2005	NA	11913	11155	758	6.4
CN2814700000000	28	147	Walthall County, MS	2005	NA	5894	5361	533	9
CN2814900000000	28	149	Warren County, MS	2005	NA	23031	21454	1577	6.8
CN2815100000000	28	151	Washington County, MS	2005	NA	23151	20602	2549	11
CN2815300000000	28	153	Wayne County, MS	2005	NA	8568	7927	641	7.5
CN2815500000000	28	155	Webster County, MS	2005	NA	3546	3265	281	7.9
CN2815700000000	28	157	Wilkinson County, MS	2005	NA	3724	3268	456	12.2
CN2815900000000	28	159	Winston County, MS	2005	NA	7981	7390	591	7.4
CN2816100000000	28	161	Yalobusha County, MS	2005	NA	5273	4814	459	8.7
CN2816300000000	28	163	Yazoo County, MS	2005	NA	10139	9168	971	9.6
CN2900100000000	29	001	Adair County, MO	2005	NA	13390	12824	566	4.2
CN2900300000000	29	003	Andrew County, MO	2005	NA	9805	9298	507	5.2
CN2900500000000	29	005	Atchison County, MO	2005	NA	3181	3032	149	4.7
CN2900700000000	29	007	Audrain County, MO	2005	NA	12125	11500	625	5.2
CN2900900000000	29	009	Barry County, MO	2005	NA	17406	16544	862	5
CN2901100000000	29	011	Barton County, MO	2005	NA	6456	6130	326	5
CN2901300000000	29	013	Bates County, MO	2005	NA	7936	7432	504	6.4
CN2901500000000	29	015	Benton County, MO	2005	NA	8461	7941	520	6.1
CN2901700000000	29	017	Bollinger County, MO	2005	NA	5856	5493	363	6.2
CN2901900000000	29	019	Boone County, MO	2005	NA	85727	82672	3055	3.6
CN2902100000000	29	021	Buchanan County, MO	2005	NA	45542	42886	2656	5.8
CN2902300000000	29	023	Butler County, MO	2005	NA	22234	21085	1149	5.2
CN2902500000000	29	025	Caldwell County, MO	2005	NA	4406	4143	263	6
CN2902700000000	29	027	Callaway County, MO	2005	NA	22596	21530	1066	4.7
CN2902900000000	29	029	Camden County, MO	2005	NA	22205	21067	1138	5.1
CN2903100000000	29	031	Cape Girardeau County, MO	2005	NA	38033	36330	1703	4.5
CN2903300000000	29	033	Carroll County, MO	2005	NA	5085	4812	273	5.4
CN2903500000000	29	035	Carter County, MO	2005	NA	2958	2774	184	6.2
CN2903700000000	29	037	Cass County, MO	2005	NA	48720	46229	2491	5.1
CN2903900000000	29	039	Cedar County, MO	2005	NA	6390	6013	377	5.9
CN2904100000000	29	041	Chariton County, MO	2005	NA	4221	3988	233	5.5
CN2904300000000	29	043	Christian County, MO	2005	NA	37337	35744	1593	4.3
CN2904500000000	29	045	Clark County, MO	2005	NA	3582	3370	212	5.9
CN2904700000000	29	047	Clay County, MO	2005	NA	111211	106067	5144	4.6
CN2904900000000	29	049	Clinton County, MO	2005	NA	10328	9766	562	5.4
CN2905100000000	29	051	Cole County, MO	2005	NA	40148	38512	1636	4.1
CN2905300000000	29	053	Cooper County, MO	2005	NA	9064	8635	429	4.7
CN2905500000000	29	055	Crawford County, MO	2005	NA	11834	11119	715	6
CN2905700000000	29	057	Dade County, MO	2005	NA	3741	3535	206	5.5
CN2905900000000	29	059	Dallas County, MO	2005	NA	7448	7043	405	5.4
CN2906100000000	29	061	Daviess County, MO	2005	NA	4023	3827	196	4.9
CN2906300000000	29	063	DeKalb County, MO	2005	NA	5062	4765	297	5.9
CN2906500000000	29	065	Dent County, MO	2005	NA	6546	6136	410	6.3
CN2906700000000	29	067	Douglas County, MO	2005	NA	5992	5624	368	6.1
CN2906900000000	29	069	Dunklin County, MO	2005	NA	14607	13549	1058	7.2
CN2907100000000	29	071	Franklin County, MO	2005	NA	52490	49466	3024	5.8
CN2907300000000	29	073	Gasconade County, MO	2005	NA	7898	7459	439	5.6
CN2907500000000	29	075	Gentry County, MO	2005	NA	3332	3184	148	4.4
CN2907700000000	29	077	Greene County, MO	2005	NA	137034	131282	5752	4.2
CN2907900000000	29	079	Grundy County, MO	2005	NA	4920	4665	255	5.2
CN2908100000000	29	081	Harrison County, MO	2005	NA	4624	4381	243	5.3
CN2908300000000	29	083	Henry County, MO	2005	NA	10809	10152	657	6.1
CN2908500000000	29	085	Hickory County, MO	2005	NA	3411	3146	265	7.8
CN2908700000000	29	087	Holt County, MO	2005	NA	2630	2511	119	4.5
CN2908900000000	29	089	Howard County, MO	2005	NA	5411	5166	245	4.5
CN2909100000000	29	091	Howell County, MO	2005	NA	19929	18990	939	4.7
CN2909300000000	29	093	Iron County, MO	2005	NA	5007	4657	350	7
CN2909500000000	29	095	Jackson County, MO	2005	NA	336286	314780	21506	6.4
CN2909700000000	29	097	Jasper County, MO	2005	NA	54567	51929	2638	4.8
CN2909900000000	29	099	Jefferson County, MO	2005	NA	115830	109561	6269	5.4
CN2910100000000	29	101	Johnson County, MO	2005	NA	25822	24641	1181	4.6
CN2910300000000	29	103	Knox County, MO	2005	NA	2439	2345	94	3.9
CN2910500000000	29	105	Laclede County, MO	2005	NA	17124	16190	934	5.5
CN2910700000000	29	107	Lafayette County, MO	2005	NA	16710	15794	916	5.5
CN2910900000000	29	109	Lawrence County, MO	2005	NA	18854	17984	870	4.6
CN2911100000000	29	111	Lewis County, MO	2005	NA	5761	5500	261	4.5
CN2911300000000	29	113	Lincoln County, MO	2005	NA	24529	23192	1337	5.5
CN2911500000000	29	115	Linn County, MO	2005	NA	6725	6185	540	8
CN2911700000000	29	117	Livingston County, MO	2005	NA	7338	6989	349	4.8
CN2911900000000	29	119	McDonald County, MO	2005	NA	11905	11397	508	4.3
CN2912100000000	29	121	Macon County, MO	2005	NA	8302	7894	408	4.9
CN2912300000000	29	123	Madison County, MO	2005	NA	6016	5639	377	6.3
CN2912500000000	29	125	Maries County, MO	2005	NA	4807	4583	224	4.7
CN2912700000000	29	127	Marion County, MO	2005	NA	14545	13795	750	5.2
CN2912900000000	29	129	Mercer County, MO	2005	NA	1810	1732	78	4.3
CN2913100000000	29	131	Miller County, MO	2005	NA	13333	12574	759	5.7
CN2913300000000	29	133	Mississippi County, MO	2005	NA	5835	5415	420	7.2
CN2913500000000	29	135	Moniteau County, MO	2005	NA	7564	7182	382	5.1
CN2913700000000	29	137	Monroe County, MO	2005	NA	4513	4266	247	5.5
CN2913900000000	29	139	Montgomery County, MO	2005	NA	6266	5907	359	5.7
CN2914100000000	29	141	Morgan County, MO	2005	NA	9560	8947	613	6.4
CN2914300000000	29	143	New Madrid County, MO	2005	NA	8634	8043	591	6.8
CN2914500000000	29	145	Newton County, MO	2005	NA	27744	26347	1397	5
CN2914700000000	29	147	Nodaway County, MO	2005	NA	12513	12049	464	3.7
CN2914900000000	29	149	Oregon County, MO	2005	NA	4301	4071	230	5.3
CN2915100000000	29	151	Osage County, MO	2005	NA	7502	7150	352	4.7
CN2915300000000	29	153	Ozark County, MO	2005	NA	4469	4226	243	5.4
CN2915500000000	29	155	Pemiscot County, MO	2005	NA	8048	7439	609	7.6
CN2915700000000	29	157	Perry County, MO	2005	NA	10434	10016	418	4
CN2915900000000	29	159	Pettis County, MO	2005	NA	20760	19610	1150	5.5
CN2916100000000	29	161	Phelps County, MO	2005	NA	22341	21340	1001	4.5
CN2916300000000	29	163	Pike County, MO	2005	NA	8935	8463	472	5.3
CN2916500000000	29	165	Platte County, MO	2005	NA	47312	45192	2120	4.5
CN2916700000000	29	167	Polk County, MO	2005	NA	13964	13285	679	4.9
CN2916900000000	29	169	Pulaski County, MO	2005	NA	18145	17186	959	5.3
CN2917100000000	29	171	Putnam County, MO	2005	NA	2554	2433	121	4.7
CN2917300000000	29	173	Ralls County, MO	2005	NA	5599	5291	308	5.5
CN2917500000000	29	175	Randolph County, MO	2005	NA	13091	12426	665	5.1
CN2917700000000	29	177	Ray County, MO	2005	NA	11787	11145	642	5.4
CN2917900000000	29	179	Reynolds County, MO	2005	NA	2592	2390	202	7.8
CN2918100000000	29	181	Ripley County, MO	2005	NA	6602	6209	393	6
CN2918300000000	29	183	St. Charles County, MO	2005	NA	186254	178363	7891	4.2
CN2918500000000	29	185	St. Clair County, MO	2005	NA	4327	4070	257	5.9
CN2918600000000	29	186	Ste. Genevieve County, MO	2005	NA	9533	9024	509	5.3
CN2918700000000	29	187	St. Francois County, MO	2005	NA	28033	26172	1861	6.6
CN2918900000000	29	189	St. Louis County, MO	2005	NA	535866	508163	27703	5.2
CN2919500000000	29	195	Saline County, MO	2005	NA	12049	11453	596	4.9
CN2919700000000	29	197	Schuyler County, MO	2005	NA	2285	2150	135	5.9
CN2919900000000	29	199	Scotland County, MO	2005	NA	2460	2363	97	3.9
CN2920100000000	29	201	Scott County, MO	2005	NA	20414	19251	1163	5.7
CN2920300000000	29	203	Shannon County, MO	2005	NA	3810	3530	280	7.3
CN2920500000000	29	205	Shelby County, MO	2005	NA	3205	3038	167	5.2
CN2920700000000	29	207	Stoddard County, MO	2005	NA	15970	15051	919	5.8
CN2920900000000	29	209	Stone County, MO	2005	NA	15855	14591	1264	8
CN2921100000000	29	211	Sullivan County, MO	2005	NA	3228	3048	180	5.6
CN2921300000000	29	213	Taney County, MO	2005	NA	25541	23309	2232	8.7
CN2921500000000	29	215	Texas County, MO	2005	NA	10747	10058	689	6.4
CN2921700000000	29	217	Vernon County, MO	2005	NA	10143	9654	489	4.8
CN2921900000000	29	219	Warren County, MO	2005	NA	15347	14523	824	5.4
CN2922100000000	29	221	Washington County, MO	2005	NA	10006	9134	872	8.7
CN2922300000000	29	223	Wayne County, MO	2005	NA	5801	5412	389	6.7
CN2922500000000	29	225	Webster County, MO	2005	NA	16706	15922	784	4.7
CN2922700000000	29	227	Worth County, MO	2005	NA	1144	1098	46	4
CN2922900000000	29	229	Wright County, MO	2005	NA	8195	7677	518	6.3
CN2951000000000	29	510	St. Louis city, MO	2005	NA	157506	144748	12758	8.1
CN3000100000000	30	001	Beaverhead County, MT	2005	NA	4956	4777	179	3.6
CN3000300000000	30	003	Big Horn County, MT	2005	NA	5238	4760	478	9.1
CN3000500000000	30	005	Blaine County, MT	2005	NA	2833	2705	128	4.5
CN3000700000000	30	007	Broadwater County, MT	2005	NA	2313	2219	94	4.1
CN3000900000000	30	009	Carbon County, MT	2005	NA	5387	5182	205	3.8
CN3001100000000	30	011	Carter County, MT	2005	NA	678	651	27	4
CN3001300000000	30	013	Cascade County, MT	2005	NA	38950	37279	1671	4.3
CN3001500000000	30	015	Chouteau County, MT	2005	NA	2630	2533	97	3.7
CN3001700000000	30	017	Custer County, MT	2005	NA	5617	5392	225	4
CN3001900000000	30	019	Daniels County, MT	2005	NA	780	750	30	3.8
CN3002100000000	30	021	Dawson County, MT	2005	NA	4189	4033	156	3.7
CN3002300000000	30	023	Deer Lodge County, MT	2005	NA	3852	3613	239	6.2
CN3002500000000	30	025	Fallon County, MT	2005	NA	1644	1598	46	2.8
CN3002700000000	30	027	Fergus County, MT	2005	NA	5819	5517	302	5.2
CN3002900000000	30	029	Flathead County, MT	2005	NA	42837	40729	2108	4.9
CN3003100000000	30	031	Gallatin County, MT	2005	NA	46649	45172	1477	3.2
CN3003300000000	30	033	Garfield County, MT	2005	NA	643	616	27	4.2
CN3003500000000	30	035	Glacier County, MT	2005	NA	5866	5407	459	7.8
CN3003700000000	30	037	Golden Valley County, MT	2005	NA	537	511	26	4.8
CN3003900000000	30	039	Granite County, MT	2005	NA	1233	1159	74	6
CN3004100000000	30	041	Hill County, MT	2005	NA	7854	7499	355	4.5
CN3004300000000	30	043	Jefferson County, MT	2005	NA	5598	5361	237	4.2
CN3004500000000	30	045	Judith Basin County, MT	2005	NA	1072	1021	51	4.8
CN3004700000000	30	047	Lake County, MT	2005	NA	11573	10900	673	5.8
CN3004900000000	30	049	Lewis and Clark County, MT	2005	NA	30847	29614	1233	4
CN3005100000000	30	051	Liberty County, MT	2005	NA	872	831	41	4.7
CN3005300000000	30	053	Lincoln County, MT	2005	NA	7764	7081	683	8.8
CN3005500000000	30	055	McCone County, MT	2005	NA	1014	978	36	3.6
CN3005700000000	30	057	Madison County, MT	2005	NA	3827	3687	140	3.7
CN3005900000000	30	059	Meagher County, MT	2005	NA	942	897	45	4.8
CN3006100000000	30	061	Mineral County, MT	2005	NA	1948	1830	118	6.1
CN3006300000000	30	063	Missoula County, MT	2005	NA	57899	55617	2282	3.9
CN3006500000000	30	065	Musselshell County, MT	2005	NA	2088	1971	117	5.6
CN3006700000000	30	067	Park County, MT	2005	NA	9011	8631	380	4.2
CN3006900000000	30	069	Petroleum County, MT	2005	NA	227	215	12	5.3
CN3007100000000	30	071	Phillips County, MT	2005	NA	2075	1984	91	4.4
CN3007300000000	30	073	Pondera County, MT	2005	NA	2724	2584	140	5.1
CN3007500000000	30	075	Powder River County, MT	2005	NA	916	880	36	3.9
CN3007700000000	30	077	Powell County, MT	2005	NA	2667	2496	171	6.4
CN3007900000000	30	079	Prairie County, MT	2005	NA	553	525	28	5.1
CN3008100000000	30	081	Ravalli County, MT	2005	NA	18433	17473	960	5.2
CN3008300000000	30	083	Richland County, MT	2005	NA	5080	4902	178	3.5
CN3008500000000	30	085	Roosevelt County, MT	2005	NA	4011	3739	272	6.8
CN3008700000000	30	087	Rosebud County, MT	2005	NA	4037	3794	243	6
CN3008900000000	30	089	Sanders County, MT	2005	NA	4554	4238	316	6.9
CN3009100000000	30	091	Sheridan County, MT	2005	NA	1765	1699	66	3.7
CN3009300000000	30	093	Silver Bow County, MT	2005	NA	17258	16480	778	4.5
CN3009500000000	30	095	Stillwater County, MT	2005	NA	4386	4232	154	3.5
CN3009700000000	30	097	Sweet Grass County, MT	2005	NA	2744	2684	60	2.2
CN3009900000000	30	099	Teton County, MT	2005	NA	3006	2895	111	3.7
CN3010100000000	30	101	Toole County, MT	2005	NA	2536	2449	87	3.4
CN3010300000000	30	103	Treasure County, MT	2005	NA	407	390	17	4.2
CN3010500000000	30	105	Valley County, MT	2005	NA	3628	3475	153	4.2
CN3010700000000	30	107	Wheatland County, MT	2005	NA	1023	979	44	4.3
CN3010900000000	30	109	Wibaux County, MT	2005	NA	493	475	18	3.7
CN3011100000000	30	111	Yellowstone County, MT	2005	NA	78579	75801	2778	3.5
CN3100100000000	31	001	Adams County, NE	2005	NA	17027	16449	578	3.4
CN3100300000000	31	003	Antelope County, NE	2005	NA	3859	3729	130	3.4
CN3100500000000	31	005	Arthur County, NE	2005	NA	257	247	10	3.9
CN3100700000000	31	007	Banner County, NE	2005	NA	388	377	11	2.8
CN3100900000000	31	009	Blaine County, NE	2005	NA	285	274	11	3.9
CN3101100000000	31	011	Boone County, NE	2005	NA	3166	3058	108	3.4
CN3101300000000	31	013	Box Butte County, NE	2005	NA	5614	5392	222	4
CN3101500000000	31	015	Boyd County, NE	2005	NA	1134	1093	41	3.6
CN3101700000000	31	017	Brown County, NE	2005	NA	1923	1861	62	3.2
CN3101900000000	31	019	Buffalo County, NE	2005	NA	27034	26283	751	2.8
CN3102100000000	31	021	Burt County, NE	2005	NA	3874	3683	191	4.9
CN3102300000000	31	023	Butler County, NE	2005	NA	4695	4524	171	3.6
CN3102500000000	31	025	Cass County, NE	2005	NA	14017	13440	577	4.1
CN3102700000000	31	027	Cedar County, NE	2005	NA	4989	4853	136	2.7
CN3102900000000	31	029	Chase County, NE	2005	NA	2140	2080	60	2.8
CN3103100000000	31	031	Cherry County, NE	2005	NA	3693	3606	87	2.4
CN3103300000000	31	033	Cheyenne County, NE	2005	NA	5277	5126	151	2.9
CN3103500000000	31	035	Clay County, NE	2005	NA	3241	3122	119	3.7
CN3103700000000	31	037	Colfax County, NE	2005	NA	5848	5684	164	2.8
CN3103900000000	31	039	Cuming County, NE	2005	NA	5352	5191	161	3
CN3104100000000	31	041	Custer County, NE	2005	NA	6228	6048	180	2.9
CN3104300000000	31	043	Dakota County, NE	2005	NA	10531	10032	499	4.7
CN3104500000000	31	045	Dawes County, NE	2005	NA	4758	4604	154	3.2
CN3104700000000	31	047	Dawson County, NE	2005	NA	12294	11758	536	4.4
CN3104900000000	31	049	Deuel County, NE	2005	NA	1090	1056	34	3.1
CN3105100000000	31	051	Dixon County, NE	2005	NA	3144	3020	124	3.9
CN3105300000000	31	053	Dodge County, NE	2005	NA	19680	18817	863	4.4
CN3105500000000	31	055	Douglas County, NE	2005	NA	266086	254196	11890	4.5
CN3105700000000	31	057	Dundy County, NE	2005	NA	1111	1065	46	4.1
CN3105900000000	31	059	Fillmore County, NE	2005	NA	3356	3249	107	3.2
CN3106100000000	31	061	Franklin County, NE	2005	NA	1893	1829	64	3.4
CN3106300000000	31	063	Frontier County, NE	2005	NA	1783	1739	44	2.5
CN3106500000000	31	065	Furnas County, NE	2005	NA	2547	2453	94	3.7
CN3106700000000	31	067	Gage County, NE	2005	NA	12833	12264	569	4.4
CN3106900000000	31	069	Garden County, NE	2005	NA	1056	1025	31	2.9
CN3107100000000	31	071	Garfield County, NE	2005	NA	1068	1036	32	3
CN3107300000000	31	073	Gosper County, NE	2005	NA	1058	1021	37	3.5
CN3107500000000	31	075	Grant County, NE	2005	NA	424	413	11	2.6
CN3107700000000	31	077	Greeley County, NE	2005	NA	1386	1336	50	3.6
CN3107900000000	31	079	Hall County, NE	2005	NA	30130	28977	1153	3.8
CN3108100000000	31	081	Hamilton County, NE	2005	NA	5439	5292	147	2.7
CN3108300000000	31	083	Harlan County, NE	2005	NA	1793	1736	57	3.2
CN3108500000000	31	085	Hayes County, NE	2005	NA	514	496	18	3.5
CN3108700000000	31	087	Hitchcock County, NE	2005	NA	1488	1433	55	3.7
CN3108900000000	31	089	Holt County, NE	2005	NA	6218	6028	190	3.1
CN3109100000000	31	091	Hooker County, NE	2005	NA	451	436	15	3.3
CN3109300000000	31	093	Howard County, NE	2005	NA	3688	3556	132	3.6
CN3109500000000	31	095	Jefferson County, NE	2005	NA	4364	4196	168	3.8
CN3109700000000	31	097	Johnson County, NE	2005	NA	3140	3027	113	3.6
CN3109900000000	31	099	Kearney County, NE	2005	NA	3891	3781	110	2.8
CN3110100000000	31	101	Keith County, NE	2005	NA	4783	4628	155	3.2
CN3110300000000	31	103	Keya Paha County, NE	2005	NA	435	420	15	3.4
CN3110500000000	31	105	Kimball County, NE	2005	NA	2138	2075	63	2.9
CN3110700000000	31	107	Knox County, NE	2005	NA	4887	4720	167	3.4
CN3110900000000	31	109	Lancaster County, NE	2005	NA	156012	150504	5508	3.5
CN3111100000000	31	111	Lincoln County, NE	2005	NA	21077	20346	731	3.5
CN3111300000000	31	113	Logan County, NE	2005	NA	447	436	11	2.5
CN3111500000000	31	115	Loup County, NE	2005	NA	339	324	15	4.4
CN3111700000000	31	117	McPherson County, NE	2005	NA	291	285	6	2.1
CN3111900000000	31	119	Madison County, NE	2005	NA	20302	19483	819	4
CN3112100000000	31	121	Merrick County, NE	2005	NA	4290	4133	157	3.7
CN3112300000000	31	123	Morrill County, NE	2005	NA	2813	2726	87	3.1
CN3112500000000	31	125	Nance County, NE	2005	NA	2026	1948	78	3.8
CN3112700000000	31	127	Nemaha County, NE	2005	NA	3564	3404	160	4.5
CN3112900000000	31	129	Nuckolls County, NE	2005	NA	2416	2336	80	3.3
CN3113100000000	31	131	Otoe County, NE	2005	NA	8783	8435	348	4
CN3113300000000	31	133	Pawnee County, NE	2005	NA	1633	1574	59	3.6
CN3113500000000	31	135	Perkins County, NE	2005	NA	1587	1547	40	2.5
CN3113700000000	31	137	Phelps County, NE	2005	NA	5230	5082	148	2.8
CN3113900000000	31	139	Pierce County, NE	2005	NA	4266	4116	150	3.5
CN3114100000000	31	141	Platte County, NE	2005	NA	17132	16500	632	3.7
CN3114300000000	31	143	Polk County, NE	2005	NA	3050	2951	99	3.2
CN3114500000000	31	145	Red Willow County, NE	2005	NA	6018	5809	209	3.5
CN3114700000000	31	147	Richardson County, NE	2005	NA	4390	4192	198	4.5
CN3114900000000	31	149	Rock County, NE	2005	NA	937	909	28	3
CN3115100000000	31	151	Saline County, NE	2005	NA	8322	8044	278	3.3
CN3115300000000	31	153	Sarpy County, NE	2005	NA	72972	70497	2475	3.4
CN3115500000000	31	155	Saunders County, NE	2005	NA	11153	10715	438	3.9
CN3115700000000	31	157	Scotts Bluff County, NE	2005	NA	19081	18283	798	4.2
CN3115900000000	31	159	Seward County, NE	2005	NA	9252	8960	292	3.2
CN3116100000000	31	161	Sheridan County, NE	2005	NA	3224	3137	87	2.7
CN3116300000000	31	163	Sherman County, NE	2005	NA	1911	1838	73	3.8
CN3116500000000	31	165	Sioux County, NE	2005	NA	772	750	22	2.8
CN3116700000000	31	167	Stanton County, NE	2005	NA	3740	3624	116	3.1
CN3116900000000	31	169	Thayer County, NE	2005	NA	2985	2894	91	3
CN3117100000000	31	171	Thomas County, NE	2005	NA	414	399	15	3.6
CN3117300000000	31	173	Thurston County, NE	2005	NA	3002	2768	234	7.8
CN3117500000000	31	175	Valley County, NE	2005	NA	2510	2423	87	3.5
CN3117700000000	31	177	Washington County, NE	2005	NA	11168	10798	370	3.3
CN3117900000000	31	179	Wayne County, NE	2005	NA	5474	5309	165	3
CN3118100000000	31	181	Webster County, NE	2005	NA	2011	1939	72	3.6
CN3118300000000	31	183	Wheeler County, NE	2005	NA	472	459	13	2.8
CN3118500000000	31	185	York County, NE	2005	NA	8438	8200	238	2.8
CN3200100000000	32	001	Churchill County, NV	2005	NA	12421	11938	483	3.9
CN3200300000000	32	003	Clark County, NV	2005	NA	869251	833919	35332	4.1
CN3200500000000	32	005	Douglas County, NV	2005	NA	21997	21014	983	4.5
CN3200700000000	32	007	Elko County, NV	2005	NA	23526	22696	830	3.5
CN3200900000000	32	009	Esmeralda County, NV	2005	NA	458	437	21	4.6
CN3201100000000	32	011	Eureka County, NV	2005	NA	672	650	22	3.3
CN3201300000000	32	013	Humboldt County, NV	2005	NA	7791	7511	280	3.6
CN3201500000000	32	015	Lander County, NV	2005	NA	2702	2604	98	3.6
CN3201700000000	32	017	Lincoln County, NV	2005	NA	1563	1485	78	5
CN3201900000000	32	019	Lyon County, NV	2005	NA	20354	19209	1145	5.6
CN3202100000000	32	021	Mineral County, NV	2005	NA	2088	1970	118	5.7
CN3202300000000	32	023	Nye County, NV	2005	NA	16313	15416	897	5.5
CN3202700000000	32	027	Pershing County, NV	2005	NA	2422	2306	116	4.8
CN3202900000000	32	029	Storey County, NV	2005	NA	2266	2169	97	4.3
CN3203100000000	32	031	Washoe County, NV	2005	NA	208503	200280	8223	3.9
CN3203300000000	32	033	White Pine County, NV	2005	NA	4305	4138	167	3.9
CN3251000000000	32	510	Carson City, NV	2005	NA	27201	25967	1234	4.5
CN3300100000000	33	001	Belknap County, NH	2005	NA	31920	30856	1064	3.3
CN3300300000000	33	003	Carroll County, NH	2005	NA	24953	24111	842	3.4
CN3300500000000	33	005	Cheshire County, NH	2005	NA	41895	40566	1329	3.2
CN3300700000000	33	007	Coos County, NH	2005	NA	16662	15980	682	4.1
CN3300900000000	33	009	Grafton County, NH	2005	NA	46776	45453	1323	2.8
CN3301100000000	33	011	Hillsborough County, NH	2005	NA	226188	217986	8202	3.6
CN3301300000000	33	013	Merrimack County, NH	2005	NA	78128	75672	2456	3.1
CN3301500000000	33	015	Rockingham County, NH	2005	NA	170876	163836	7040	4.1
CN3301700000000	33	017	Strafford County, NH	2005	NA	66513	64272	2241	3.4
CN3301900000000	33	019	Sullivan County, NH	2005	NA	21942	21296	646	2.9
CN3400100000000	34	001	Atlantic County, NJ	2005	NA	136314	129021	7293	5.4
CN3400300000000	34	003	Bergen County, NJ	2005	NA	465823	448415	17408	3.7
CN3400500000000	34	005	Burlington County, NJ	2005	NA	237927	228749	9178	3.9
CN3400700000000	34	007	Camden County, NJ	2005	NA	262726	250121	12605	4.8
CN3400900000000	34	009	Cape May County, NJ	2005	NA	57700	53895	3805	6.6
CN3401100000000	34	011	Cumberland County, NJ	2005	NA	69082	64663	4419	6.4
CN3401300000000	34	013	Essex County, NJ	2005	NA	360801	340502	20299	5.6
CN3401500000000	34	015	Gloucester County, NJ	2005	NA	148091	141602	6489	4.4
CN3401700000000	34	017	Hudson County, NJ	2005	NA	287475	271796	15679	5.5
CN3401900000000	34	019	Hunterdon County, NJ	2005	NA	71103	68878	2225	3.1
CN3402100000000	34	021	Mercer County, NJ	2005	NA	193721	186136	7585	3.9
CN3402300000000	34	023	Middlesex County, NJ	2005	NA	414728	397205	17523	4.2
CN3402500000000	34	025	Monmouth County, NJ	2005	NA	323151	309920	13231	4.1
CN3402700000000	34	027	Morris County, NJ	2005	NA	267019	258297	8722	3.3
CN3402900000000	34	029	Ocean County, NJ	2005	NA	248890	237282	11608	4.7
CN3403100000000	34	031	Passaic County, NJ	2005	NA	234831	221929	12902	5.5
CN3403300000000	34	033	Salem County, NJ	2005	NA	31234	29715	1519	4.9
CN3403500000000	34	035	Somerset County, NJ	2005	NA	174544	168578	5966	3.4
CN3403700000000	34	037	Sussex County, NJ	2005	NA	82976	79727	3249	3.9
CN3403900000000	34	039	Union County, NJ	2005	NA	264877	252218	12659	4.8
CN3404100000000	34	041	Warren County, NJ	2005	NA	58567	56249	2318	4
CN3500100000000	35	001	Bernalillo County, NM	2005	NA	305757	291412	14345	4.7
CN3500300000000	35	003	Catron County, NM	2005	NA	1442	1346	96	6.7
CN3500500000000	35	005	Chaves County, NM	2005	NA	26115	24612	1503	5.8
CN3500600000000	35	006	Cibola County, NM	2005	NA	12217	11538	679	5.6
CN3500700000000	35	007	Colfax County, NM	2005	NA	6825	6466	359	5.3
CN3500900000000	35	009	Curry County, NM	2005	NA	20728	19868	860	4.1
CN3501100000000	35	011	De Baca County, NM	2005	NA	835	787	48	5.7
CN3501300000000	35	013	Dona Ana County, NM	2005	NA	85089	80297	4792	5.6
CN3501500000000	35	015	Eddy County, NM	2005	NA	24586	23453	1133	4.6
CN3501700000000	35	017	Grant County, NM	2005	NA	11998	11283	715	6
CN3501900000000	35	019	Guadalupe County, NM	2005	NA	1730	1602	128	7.4
CN3502100000000	35	021	Harding County, NM	2005	NA	379	363	16	4.2
CN3502300000000	35	023	Hidalgo County, NM	2005	NA	2451	2329	122	5
CN3502500000000	35	025	Lea County, NM	2005	NA	25780	24721	1059	4.1
CN3502700000000	35	027	Lincoln County, NM	2005	NA	10809	10328	481	4.4
CN3502800000000	35	028	Los Alamos County, NM	2005	NA	11523	11212	311	2.7
CN3502900000000	35	029	Luna County, NM	2005	NA	12566	10941	1625	12.9
CN3503100000000	35	031	McKinley County, NM	2005	NA	26949	25159	1790	6.6
CN3503300000000	35	033	Mora County, NM	2005	NA	2068	1836	232	11.2
CN3503500000000	35	035	Otero County, NM	2005	NA	26815	25497	1318	4.9
CN3503700000000	35	037	Quay County, NM	2005	NA	3953	3743	210	5.3
CN3503900000000	35	039	Rio Arriba County, NM	2005	NA	20903	19649	1254	6
CN3504100000000	35	041	Roosevelt County, NM	2005	NA	9461	9102	359	3.8
CN3504300000000	35	043	Sandoval County, NM	2005	NA	50173	47553	2620	5.2
CN3504500000000	35	045	San Juan County, NM	2005	NA	54461	51561	2900	5.3
CN3504700000000	35	047	San Miguel County, NM	2005	NA	13377	12552	825	6.2
CN3504900000000	35	049	Santa Fe County, NM	2005	NA	76704	73560	3144	4.1
CN3505100000000	35	051	Sierra County, NM	2005	NA	5452	5160	292	5.4
CN3505300000000	35	053	Socorro County, NM	2005	NA	9360	8944	416	4.4
CN3505500000000	35	055	Taos County, NM	2005	NA	17422	16263	1159	6.7
CN3505700000000	35	057	Torrance County, NM	2005	NA	7606	7188	418	5.5
CN3505900000000	35	059	Union County, NM	2005	NA	1925	1856	69	3.6
CN3506100000000	35	061	Valencia County, NM	2005	NA	30700	29068	1632	5.3
CN3600100000000	36	001	Albany County, NY	2005	NA	159258	153040	6218	3.9
CN3600300000000	36	003	Allegany County, NY	2005	NA	23532	22163	1369	5.8
CN3600500000000	36	005	Bronx County, NY	2005	NA	507229	468809	38420	7.6
CN3600700000000	36	007	Broome County, NY	2005	NA	96287	91585	4702	4.9
CN3600900000000	36	009	Cattaraugus County, NY	2005	NA	42123	39858	2265	5.4
CN3601100000000	36	011	Cayuga County, NY	2005	NA	41868	39835	2033	4.9
CN3601300000000	36	013	Chautauqua County, NY	2005	NA	67149	63929	3220	4.8
CN3601500000000	36	015	Chemung County, NY	2005	NA	40595	38438	2157	5.3
CN3601700000000	36	017	Chenango County, NY	2005	NA	24291	23092	1199	4.9
CN3601900000000	36	019	Clinton County, NY	2005	NA	40018	37915	2103	5.3
CN3602100000000	36	021	Columbia County, NY	2005	NA	32004	30771	1233	3.9
CN3602300000000	36	023	Cortland County, NY	2005	NA	23938	22643	1295	5.4
CN3602500000000	36	025	Delaware County, NY	2005	NA	23525	22491	1034	4.4
CN3602700000000	36	027	Dutchess County, NY	2005	NA	147009	141260	5749	3.9
CN3602900000000	36	029	Erie County, NY	2005	NA	472255	447793	24462	5.2
CN3603100000000	36	031	Essex County, NY	2005	NA	18741	17739	1002	5.3
CN3603300000000	36	033	Franklin County, NY	2005	NA	22551	21231	1320	5.9
CN3603500000000	36	035	Fulton County, NY	2005	NA	26970	25471	1499	5.6
CN3603700000000	36	037	Genesee County, NY	2005	NA	33104	31514	1590	4.8
CN3603900000000	36	039	Greene County, NY	2005	NA	23754	22608	1146	4.8
CN3604100000000	36	041	Hamilton County, NY	2005	NA	3167	2995	172	5.4
CN3604300000000	36	043	Herkimer County, NY	2005	NA	31671	30005	1666	5.3
CN3604500000000	36	045	Jefferson County, NY	2005	NA	47105	44219	2886	6.1
CN3604700000000	36	047	Kings County, NY	2005	NA	1070528	1003685	66843	6.2
CN3604900000000	36	049	Lewis County, NY	2005	NA	12729	11971	758	6
CN3605100000000	36	051	Livingston County, NY	2005	NA	32873	31242	1631	5
CN3605300000000	36	053	Madison County, NY	2005	NA	36109	34253	1856	5.1
CN3605500000000	36	055	Monroe County, NY	2005	NA	376359	359288	17071	4.5
CN3605700000000	36	057	Montgomery County, NY	2005	NA	24686	23372	1314	5.3
CN3605900000000	36	059	Nassau County, NY	2005	NA	689655	661861	27794	4
CN3606100000000	36	061	New York County, NY	2005	NA	902717	857093	45624	5.1
CN3606300000000	36	063	Niagara County, NY	2005	NA	111714	105517	6197	5.5
CN3606500000000	36	065	Oneida County, NY	2005	NA	111233	105942	5291	4.8
CN3606700000000	36	067	Onondaga County, NY	2005	NA	233689	223200	10489	4.5
CN3606900000000	36	069	Ontario County, NY	2005	NA	56825	54274	2551	4.5
CN3607100000000	36	071	Orange County, NY	2005	NA	177596	170098	7498	4.2
CN3607300000000	36	073	Orleans County, NY	2005	NA	19959	18838	1121	5.6
CN3607500000000	36	075	Oswego County, NY	2005	NA	60241	56509	3732	6.2
CN3607700000000	36	077	Otsego County, NY	2005	NA	31942	30507	1435	4.5
CN3607900000000	36	079	Putnam County, NY	2005	NA	56067	53984	2083	3.7
CN3608100000000	36	081	Queens County, NY	2005	NA	1090028	1032819	57209	5.2
CN3608300000000	36	083	Rensselaer County, NY	2005	NA	83813	80311	3502	4.2
CN3608500000000	36	085	Richmond County, NY	2005	NA	231455	219267	12188	5.3
CN3608700000000	36	087	Rockland County, NY	2005	NA	151221	145210	6011	4
CN3608900000000	36	089	St. Lawrence County, NY	2005	NA	49164	46189	2975	6.1
CN3609100000000	36	091	Saratoga County, NY	2005	NA	119981	115603	4378	3.6
CN3609300000000	36	093	Schenectady County, NY	2005	NA	75405	72261	3144	4.2
CN3609500000000	36	095	Schoharie County, NY	2005	NA	15856	15056	800	5
CN3609700000000	36	097	Schuyler County, NY	2005	NA	9881	9342	539	5.5
CN3609900000000	36	099	Seneca County, NY	2005	NA	17337	16532	805	4.6
CN3610100000000	36	101	Steuben County, NY	2005	NA	44595	42072	2523	5.7
CN3610300000000	36	103	Suffolk County, NY	2005	NA	777672	745077	32595	4.2
CN3610500000000	36	105	Sullivan County, NY	2005	NA	35159	33456	1703	4.8
CN3610700000000	36	107	Tioga County, NY	2005	NA	26310	25069	1241	4.7
CN3610900000000	36	109	Tompkins County, NY	2005	NA	54600	52653	1947	3.6
CN3611100000000	36	111	Ulster County, NY	2005	NA	91816	87828	3988	4.3
CN3611300000000	36	113	Warren County, NY	2005	NA	35471	33852	1619	4.6
CN3611500000000	36	115	Washington County, NY	2005	NA	32144	30708	1436	4.5
CN3611700000000	36	117	Wayne County, NY	2005	NA	48987	46588	2399	4.9
CN3611900000000	36	119	Westchester County, NY	2005	NA	482484	463188	19296	4
CN3612100000000	36	121	Wyoming County, NY	2005	NA	21431	20307	1124	5.2
CN3612300000000	36	123	Yates County, NY	2005	NA	12995	12436	559	4.3
CN3700100000000	37	001	Alamance County, NC	2005	NA	68710	64582	4128	6
CN3700300000000	37	003	Alexander County, NC	2005	NA	18234	17246	988	5.4
CN3700500000000	37	005	Alleghany County, NC	2005	NA	4873	4603	270	5.5
CN3700700000000	37	007	Anson County, NC	2005	NA	10562	9777	785	7.4
CN3700900000000	37	009	Ashe County, NC	2005	NA	12759	12028	731	5.7
CN3701100000000	37	011	Avery County, NC	2005	NA	7961	7535	426	5.4
CN3701300000000	37	013	Beaufort County, NC	2005	NA	20198	18904	1294	6.4
CN3701500000000	37	015	Bertie County, NC	2005	NA	8769	8145	624	7.1
CN3701700000000	37	017	Bladen County, NC	2005	NA	15440	14303	1137	7.4
CN3701900000000	37	019	Brunswick County, NC	2005	NA	42827	40686	2141	5
CN3702100000000	37	021	Buncombe County, NC	2005	NA	115125	110113	5012	4.4
CN3702300000000	37	023	Burke County, NC	2005	NA	41432	38812	2620	6.3
CN3702500000000	37	025	Cabarrus County, NC	2005	NA	77153	73595	3558	4.6
CN3702700000000	37	027	Caldwell County, NC	2005	NA	39683	36453	3230	8.1
CN3702900000000	37	029	Camden County, NC	2005	NA	4374	4196	178	4.1
CN3703100000000	37	031	Carteret County, NC	2005	NA	32250	30757	1493	4.6
CN3703300000000	37	033	Caswell County, NC	2005	NA	10583	9762	821	7.8
CN3703500000000	37	035	Catawba County, NC	2005	NA	76867	72108	4759	6.2
CN3703700000000	37	037	Chatham County, NC	2005	NA	30758	29521	1237	4
CN3703900000000	37	039	Cherokee County, NC	2005	NA	10422	9797	625	6
CN3704100000000	37	041	Chowan County, NC	2005	NA	6975	6633	342	4.9
CN3704300000000	37	043	Clay County, NC	2005	NA	4502	4313	189	4.2
CN3704500000000	37	045	Cleveland County, NC	2005	NA	47426	44129	3297	7
CN3704700000000	37	047	Columbus County, NC	2005	NA	23690	22178	1512	6.4
CN3704900000000	37	049	Craven County, NC	2005	NA	40795	38880	1915	4.7
CN3705100000000	37	051	Cumberland County, NC	2005	NA	127153	120282	6871	5.4
CN3705300000000	37	053	Currituck County, NC	2005	NA	12065	11698	367	3
CN3705500000000	37	055	Dare County, NC	2005	NA	22519	21464	1055	4.7
CN3705700000000	37	057	Davidson County, NC	2005	NA	78306	73618	4688	6
CN3705900000000	37	059	Davie County, NC	2005	NA	19826	18987	839	4.2
CN3706100000000	37	061	Duplin County, NC	2005	NA	23659	22232	1427	6
CN3706300000000	37	063	Durham County, NC	2005	NA	129938	124302	5636	4.3
CN3706500000000	37	065	Edgecombe County, NC	2005	NA	24224	22184	2040	8.4
CN3706700000000	37	067	Forsyth County, NC	2005	NA	168092	160199	7893	4.7
CN3706900000000	37	069	Franklin County, NC	2005	NA	25987	24751	1236	4.8
CN3707100000000	37	071	Gaston County, NC	2005	NA	96079	90231	5848	6.1
CN3707300000000	37	073	Gates County, NC	2005	NA	4918	4717	201	4.1
CN3707500000000	37	075	Graham County, NC	2005	NA	4039	3759	280	6.9
CN3707700000000	37	077	Granville County, NC	2005	NA	23754	22320	1434	6
CN3707900000000	37	079	Greene County, NC	2005	NA	8934	8384	550	6.2
CN3708100000000	37	081	Guilford County, NC	2005	NA	240605	228396	12209	5.1
CN3708300000000	37	083	Halifax County, NC	2005	NA	23665	21968	1697	7.2
CN3708500000000	37	085	Harnett County, NC	2005	NA	45310	42913	2397	5.3
CN3708700000000	37	087	Haywood County, NC	2005	NA	27125	25911	1214	4.5
CN3708900000000	37	089	Henderson County, NC	2005	NA	46267	44326	1941	4.2
CN3709100000000	37	091	Hertford County, NC	2005	NA	9808	9232	576	5.9
CN3709300000000	37	093	Hoke County, NC	2005	NA	18402	17340	1062	5.8
CN3709500000000	37	095	Hyde County, NC	2005	NA	2906	2734	172	5.9
CN3709700000000	37	097	Iredell County, NC	2005	NA	72392	68749	3643	5
CN3709900000000	37	099	Jackson County, NC	2005	NA	20511	19676	835	4.1
CN3710100000000	37	101	Johnston County, NC	2005	NA	70876	67718	3158	4.5
CN3710300000000	37	103	Jones County, NC	2005	NA	4935	4695	240	4.9
CN3710500000000	37	105	Lee County, NC	2005	NA	25968	24526	1442	5.6
CN3710700000000	37	107	Lenoir County, NC	2005	NA	27695	26091	1604	5.8
CN3710900000000	37	109	Lincoln County, NC	2005	NA	36213	34184	2029	5.6
CN3711100000000	37	111	McDowell County, NC	2005	NA	21131	19634	1497	7.1
CN3711300000000	37	113	Macon County, NC	2005	NA	15623	14888	735	4.7
CN3711500000000	37	115	Madison County, NC	2005	NA	9766	9264	502	5.1
CN3711700000000	37	117	Martin County, NC	2005	NA	12011	11310	701	5.8
CN3711900000000	37	119	Mecklenburg County, NC	2005	NA	426529	405368	21161	5
CN3712100000000	37	121	Mitchell County, NC	2005	NA	7767	7197	570	7.3
CN3712300000000	37	123	Montgomery County, NC	2005	NA	12345	11504	841	6.8
CN3712500000000	37	125	Moore County, NC	2005	NA	35748	33927	1821	5.1
CN3712700000000	37	127	Nash County, NC	2005	NA	44187	41528	2659	6
CN3712900000000	37	129	New Hanover County, NC	2005	NA	97891	93864	4027	4.1
CN3713100000000	37	131	Northampton County, NC	2005	NA	8941	8344	597	6.7
CN3713300000000	37	133	Onslow County, NC	2005	NA	55996	53011	2985	5.3
CN3713500000000	37	135	Orange County, NC	2005	NA	65060	62622	2438	3.7
CN3713700000000	37	137	Pamlico County, NC	2005	NA	5691	5434	257	4.5
CN3713900000000	37	139	Pasquotank County, NC	2005	NA	17239	16418	821	4.8
CN3714100000000	37	141	Pender County, NC	2005	NA	21914	20864	1050	4.8
CN3714300000000	37	143	Perquimans County, NC	2005	NA	5142	4896	246	4.8
CN3714500000000	37	145	Person County, NC	2005	NA	18733	17537	1196	6.4
CN3714700000000	37	147	Pitt County, NC	2005	NA	73488	69235	4253	5.8
CN3714900000000	37	149	Polk County, NC	2005	NA	9104	8724	380	4.2
CN3715100000000	37	151	Randolph County, NC	2005	NA	74686	71131	3555	4.8
CN3715300000000	37	153	Richmond County, NC	2005	NA	20124	18579	1545	7.7
CN3715500000000	37	155	Robeson County, NC	2005	NA	52340	48783	3557	6.8
CN3715700000000	37	157	Rockingham County, NC	2005	NA	45686	42675	3011	6.6
CN3715900000000	37	159	Rowan County, NC	2005	NA	67803	64151	3652	5.4
CN3716100000000	37	161	Rutherford County, NC	2005	NA	29473	26929	2544	8.6
CN3716300000000	37	163	Sampson County, NC	2005	NA	31203	29682	1521	4.9
CN3716500000000	37	165	Scotland County, NC	2005	NA	15076	13613	1463	9.7
CN3716700000000	37	167	Stanly County, NC	2005	NA	29475	27888	1587	5.4
CN3716900000000	37	169	Stokes County, NC	2005	NA	23944	22748	1196	5
CN3717100000000	37	171	Surry County, NC	2005	NA	34916	32871	2045	5.9
CN3717300000000	37	173	Swain County, NC	2005	NA	6868	6395	473	6.9
CN3717500000000	37	175	Transylvania County, NC	2005	NA	12361	11706	655	5.3
CN3717700000000	37	177	Tyrrell County, NC	2005	NA	2185	2025	160	7.3
CN3717900000000	37	179	Union County, NC	2005	NA	82302	78628	3674	4.5
CN3718100000000	37	181	Vance County, NC	2005	NA	18976	17350	1626	8.6
CN3718300000000	37	183	Wake County, NC	2005	NA	403861	387342	16519	4.1
CN3718500000000	37	185	Warren County, NC	2005	NA	8015	7449	566	7.1
CN3718700000000	37	187	Washington County, NC	2005	NA	6111	5705	406	6.6
CN3718900000000	37	189	Watauga County, NC	2005	NA	23171	22252	919	4
CN3719100000000	37	191	Wayne County, NC	2005	NA	51135	48460	2675	5.2
CN3719300000000	37	193	Wilkes County, NC	2005	NA	32852	30991	1861	5.7
CN3719500000000	37	195	Wilson County, NC	2005	NA	38996	35893	3103	8
CN3719700000000	37	197	Yadkin County, NC	2005	NA	19164	18279	885	4.6
CN3719900000000	37	199	Yancey County, NC	2005	NA	7870	7306	564	7.2
CN3800100000000	38	001	Adams County, ND	2005	NA	1312	1269	43	3.3
CN3800300000000	38	003	Barnes County, ND	2005	NA	6046	5838	208	3.4
CN3800500000000	38	005	Benson County, ND	2005	NA	2794	2637	157	5.6
CN3800700000000	38	007	Billings County, ND	2005	NA	504	490	14	2.8
CN3800900000000	38	009	Bottineau County, ND	2005	NA	3511	3369	142	4
CN3801100000000	38	011	Bowman County, ND	2005	NA	1732	1691	41	2.4
CN3801300000000	38	013	Burke County, ND	2005	NA	1023	996	27	2.6
CN3801500000000	38	015	Burleigh County, ND	2005	NA	44286	43032	1254	2.8
CN3801700000000	38	017	Cass County, ND	2005	NA	82230	80023	2207	2.7
CN3801900000000	38	019	Cavalier County, ND	2005	NA	2146	2067	79	3.7
CN3802100000000	38	021	Dickey County, ND	2005	NA	2962	2881	81	2.7
CN3802300000000	38	023	Divide County, ND	2005	NA	980	948	32	3.3
CN3802500000000	38	025	Dunn County, ND	2005	NA	1730	1672	58	3.4
CN3802700000000	38	027	Eddy County, ND	2005	NA	1342	1267	75	5.6
CN3802900000000	38	029	Emmons County, ND	2005	NA	1854	1757	97	5.2
CN3803100000000	38	031	Foster County, ND	2005	NA	1775	1721	54	3
CN3803300000000	38	033	Golden Valley County, ND	2005	NA	911	882	29	3.2
CN3803500000000	38	035	Grand Forks County, ND	2005	NA	38089	36881	1208	3.2
CN3803700000000	38	037	Grant County, ND	2005	NA	1255	1205	50	4
CN3803900000000	38	039	Griggs County, ND	2005	NA	1385	1345	40	2.9
CN3804100000000	38	041	Hettinger County, ND	2005	NA	1190	1146	44	3.7
CN3804300000000	38	043	Kidder County, ND	2005	NA	1222	1162	60	4.9
CN3804500000000	38	045	LaMoure County, ND	2005	NA	2261	2186	75	3.3
CN3804700000000	38	047	Logan County, ND	2005	NA	933	899	34	3.6
CN3804900000000	38	049	McHenry County, ND	2005	NA	2783	2627	156	5.6
CN3805100000000	38	051	McIntosh County, ND	2005	NA	1462	1420	42	2.9
CN3805300000000	38	053	McKenzie County, ND	2005	NA	2692	2593	99	3.7
CN3805500000000	38	055	McLean County, ND	2005	NA	4615	4389	226	4.9
CN3805700000000	38	057	Mercer County, ND	2005	NA	4577	4370	207	4.5
CN3805900000000	38	059	Morton County, ND	2005	NA	14527	14009	518	3.6
CN3806100000000	38	061	Mountrail County, ND	2005	NA	2991	2814	177	5.9
CN3806300000000	38	063	Nelson County, ND	2005	NA	1696	1625	71	4.2
CN3806500000000	38	065	Oliver County, ND	2005	NA	1097	1045	52	4.7
CN3806700000000	38	067	Pembina County, ND	2005	NA	4156	3886	270	6.5
CN3806900000000	38	069	Pierce County, ND	2005	NA	1951	1861	90	4.6
CN3807100000000	38	071	Ramsey County, ND	2005	NA	6011	5781	230	3.8
CN3807300000000	38	073	Ransom County, ND	2005	NA	3093	2996	97	3.1
CN3807500000000	38	075	Renville County, ND	2005	NA	1300	1260	40	3.1
CN3807700000000	38	077	Richland County, ND	2005	NA	9047	8742	305	3.4
CN3807900000000	38	079	Rolette County, ND	2005	NA	5211	4725	486	9.3
CN3808100000000	38	081	Sargent County, ND	2005	NA	2432	2367	65	2.7
CN3808300000000	38	083	Sheridan County, ND	2005	NA	746	703	43	5.8
CN3808500000000	38	085	Sioux County, ND	2005	NA	1337	1246	91	6.8
CN3808700000000	38	087	Slope County, ND	2005	NA	526	514	12	2.3
CN3808900000000	38	089	Stark County, ND	2005	NA	13426	13033	393	2.9
CN3809100000000	38	091	Steele County, ND	2005	NA	1151	1120	31	2.7
CN3809300000000	38	093	Stutsman County, ND	2005	NA	11672	11303	369	3.2
CN3809500000000	38	095	Towner County, ND	2005	NA	1269	1206	63	5
CN3809700000000	38	097	Traill County, ND	2005	NA	4235	4076	159	3.8
CN3809900000000	38	099	Walsh County, ND	2005	NA	5895	5613	282	4.8
CN3810100000000	38	101	Ward County, ND	2005	NA	28271	27290	981	3.5
CN3810300000000	38	103	Wells County, ND	2005	NA	2200	2095	105	4.8
CN3810500000000	38	105	Williams County, ND	2005	NA	11706	11439	267	2.3
CN3900100000000	39	001	Adams County, OH	2005	NA	13131	12015	1116	8.5
CN3900300000000	39	003	Allen County, OH	2005	NA	52706	49415	3291	6.2
CN3900500000000	39	005	Ashland County, OH	2005	NA	27136	25384	1752	6.5
CN3900700000000	39	007	Ashtabula County, OH	2005	NA	50594	46872	3722	7.4
CN3900900000000	39	009	Athens County, OH	2005	NA	30032	28052	1980	6.6
CN3901100000000	39	011	Auglaize County, OH	2005	NA	26238	25028	1210	4.6
CN3901300000000	39	013	Belmont County, OH	2005	NA	32494	30344	2150	6.6
CN3901500000000	39	015	Brown County, OH	2005	NA	22047	20504	1543	7
CN3901700000000	39	017	Butler County, OH	2005	NA	186502	176383	10119	5.4
CN3901900000000	39	019	Carroll County, OH	2005	NA	14150	13178	972	6.9
CN3902100000000	39	021	Champaign County, OH	2005	NA	20848	19638	1210	5.8
CN3902300000000	39	023	Clark County, OH	2005	NA	70529	65964	4565	6.5
CN3902500000000	39	025	Clermont County, OH	2005	NA	104576	98800	5776	5.5
CN3902700000000	39	027	Clinton County, OH	2005	NA	22687	21416	1271	5.6
CN3902900000000	39	029	Columbiana County, OH	2005	NA	53636	49745	3891	7.3
CN3903100000000	39	031	Coshocton County, OH	2005	NA	18109	16583	1526	8.4
CN3903300000000	39	033	Crawford County, OH	2005	NA	22847	21295	1552	6.8
CN3903500000000	39	035	Cuyahoga County, OH	2005	NA	654861	619785	35076	5.4
CN3903700000000	39	037	Darke County, OH	2005	NA	28345	26653	1692	6
CN3903900000000	39	039	Defiance County, OH	2005	NA	20579	19298	1281	6.2
CN3904100000000	39	041	Delaware County, OH	2005	NA	83514	79828	3686	4.4
CN3904300000000	39	043	Erie County, OH	2005	NA	42843	40061	2782	6.5
CN3904500000000	39	045	Fairfield County, OH	2005	NA	73172	69143	4029	5.5
CN3904700000000	39	047	Fayette County, OH	2005	NA	15939	14998	941	5.9
CN3904900000000	39	049	Franklin County, OH	2005	NA	601304	569067	32237	5.4
CN3905100000000	39	051	Fulton County, OH	2005	NA	23151	21702	1449	6.3
CN3905300000000	39	053	Gallia County, OH	2005	NA	14112	13069	1043	7.4
CN3905500000000	39	055	Geauga County, OH	2005	NA	50378	48208	2170	4.3
CN3905700000000	39	057	Greene County, OH	2005	NA	77375	72943	4432	5.7
CN3905900000000	39	059	Guernsey County, OH	2005	NA	20036	18558	1478	7.4
CN3906100000000	39	061	Hamilton County, OH	2005	NA	419952	396252	23700	5.6
CN3906300000000	39	063	Hancock County, OH	2005	NA	40240	38199	2041	5.1
CN3906500000000	39	065	Hardin County, OH	2005	NA	16247	15265	982	6
CN3906700000000	39	067	Harrison County, OH	2005	NA	7531	7030	501	6.7
CN3906900000000	39	069	Henry County, OH	2005	NA	15891	14885	1006	6.3
CN3907100000000	39	071	Highland County, OH	2005	NA	20973	19704	1269	6.1
CN3907300000000	39	073	Hocking County, OH	2005	NA	13850	12783	1067	7.7
CN3907500000000	39	075	Holmes County, OH	2005	NA	19868	19056	812	4.1
CN3907700000000	39	077	Huron County, OH	2005	NA	30269	27892	2377	7.9
CN3907900000000	39	079	Jackson County, OH	2005	NA	15864	14667	1197	7.5
CN3908100000000	39	081	Jefferson County, OH	2005	NA	31747	29298	2449	7.7
CN3908300000000	39	083	Knox County, OH	2005	NA	30265	28521	1744	5.8
CN3908500000000	39	085	Lake County, OH	2005	NA	129690	123744	5946	4.6
CN3908700000000	39	087	Lawrence County, OH	2005	NA	28685	26903	1782	6.2
CN3908900000000	39	089	Licking County, OH	2005	NA	81708	76862	4846	5.9
CN3909100000000	39	091	Logan County, OH	2005	NA	24671	23355	1316	5.3
CN3909300000000	39	093	Lorain County, OH	2005	NA	151819	143928	7891	5.2
CN3909500000000	39	095	Lucas County, OH	2005	NA	224694	209027	15667	7
CN3909700000000	39	097	Madison County, OH	2005	NA	19828	18647	1181	6
CN3909900000000	39	099	Mahoning County, OH	2005	NA	119944	111451	8493	7.1
CN3910100000000	39	101	Marion County, OH	2005	NA	32193	30160	2033	6.3
CN3910300000000	39	103	Medina County, OH	2005	NA	91736	87733	4003	4.4
CN3910500000000	39	105	Meigs County, OH	2005	NA	9068	8153	915	10.1
CN3910700000000	39	107	Mercer County, OH	2005	NA	23806	22826	980	4.1
CN3910900000000	39	109	Miami County, OH	2005	NA	54855	51691	3164	5.8
CN3911100000000	39	111	Monroe County, OH	2005	NA	5483	4741	742	13.5
CN3911300000000	39	113	Montgomery County, OH	2005	NA	272233	254552	17681	6.5
CN3911500000000	39	115	Morgan County, OH	2005	NA	6213	5580	633	10.2
CN3911700000000	39	117	Morrow County, OH	2005	NA	17738	16597	1141	6.4
CN3911900000000	39	119	Muskingum County, OH	2005	NA	40214	36782	3432	8.5
CN3912100000000	39	121	Noble County, OH	2005	NA	5907	5412	495	8.4
CN3912300000000	39	123	Ottawa County, OH	2005	NA	21855	20137	1718	7.9
CN3912500000000	39	125	Paulding County, OH	2005	NA	10750	10164	586	5.5
CN3912700000000	39	127	Perry County, OH	2005	NA	16652	15253	1399	8.4
CN3912900000000	39	129	Pickaway County, OH	2005	NA	24055	22335	1720	7.2
CN3913100000000	39	131	Pike County, OH	2005	NA	10740	9632	1108	10.3
CN3913300000000	39	133	Portage County, OH	2005	NA	89469	84319	5150	5.8
CN3913500000000	39	135	Preble County, OH	2005	NA	21776	20470	1306	6
CN3913700000000	39	137	Putnam County, OH	2005	NA	17744	16788	956	5.4
CN3913900000000	39	139	Richland County, OH	2005	NA	62761	58534	4227	6.7
CN3914100000000	39	141	Ross County, OH	2005	NA	34771	32180	2591	7.5
CN3914300000000	39	143	Sandusky County, OH	2005	NA	33362	31242	2120	6.4
CN3914500000000	39	145	Scioto County, OH	2005	NA	32205	29355	2850	8.8
CN3914700000000	39	147	Seneca County, OH	2005	NA	31390	29442	1948	6.2
CN3914900000000	39	149	Shelby County, OH	2005	NA	27581	26248	1333	4.8
CN3915100000000	39	151	Stark County, OH	2005	NA	190370	177864	12506	6.6
CN3915300000000	39	153	Summit County, OH	2005	NA	291058	273787	17271	5.9
CN3915500000000	39	155	Trumbull County, OH	2005	NA	105645	98291	7354	7
CN3915700000000	39	157	Tuscarawas County, OH	2005	NA	47366	44603	2763	5.8
CN3915900000000	39	159	Union County, OH	2005	NA	24483	23232	1251	5.1
CN3916100000000	39	161	Van Wert County, OH	2005	NA	15105	14307	798	5.3
CN3916300000000	39	163	Vinton County, OH	2005	NA	5635	5161	474	8.4
CN3916500000000	39	165	Warren County, OH	2005	NA	103976	98874	5102	4.9
CN3916700000000	39	167	Washington County, OH	2005	NA	32614	30618	1996	6.1
CN3916900000000	39	169	Wayne County, OH	2005	NA	61120	58018	3102	5.1
CN3917100000000	39	171	Williams County, OH	2005	NA	19597	18369	1228	6.3
CN3917300000000	39	173	Wood County, OH	2005	NA	67891	63983	3908	5.8
CN3917500000000	39	175	Wyandot County, OH	2005	NA	13035	12259	776	6
CN4000100000000	40	001	Adair County, OK	2005	NA	9943	9465	478	4.8
CN4000300000000	40	003	Alfalfa County, OK	2005	NA	2323	2222	101	4.3
CN4000500000000	40	005	Atoka County, OK	2005	NA	5553	5260	293	5.3
CN4000700000000	40	007	Beaver County, OK	2005	NA	2890	2796	94	3.3
CN4000900000000	40	009	Beckham County, OK	2005	NA	9653	9354	299	3.1
CN4001100000000	40	011	Blaine County, OK	2005	NA	4824	4589	235	4.9
CN4001300000000	40	013	Bryan County, OK	2005	NA	19362	18623	739	3.8
CN4001500000000	40	015	Caddo County, OK	2005	NA	12077	11398	679	5.6
CN4001700000000	40	017	Canadian County, OK	2005	NA	51178	49306	1872	3.7
CN4001900000000	40	019	Carter County, OK	2005	NA	23547	22513	1034	4.4
CN4002100000000	40	021	Cherokee County, OK	2005	NA	20757	19840	917	4.4
CN4002300000000	40	023	Choctaw County, OK	2005	NA	6466	6101	365	5.6
CN4002500000000	40	025	Cimarron County, OK	2005	NA	1320	1274	46	3.5
CN4002700000000	40	027	Cleveland County, OK	2005	NA	118305	113795	4510	3.8
CN4002900000000	40	029	Coal County, OK	2005	NA	2218	2062	156	7
CN4003100000000	40	031	Comanche County, OK	2005	NA	45272	43231	2041	4.5
CN4003300000000	40	033	Cotton County, OK	2005	NA	3301	3178	123	3.7
CN4003500000000	40	035	Craig County, OK	2005	NA	6638	6340	298	4.5
CN4003700000000	40	037	Creek County, OK	2005	NA	32063	30248	1815	5.7
CN4003900000000	40	039	Custer County, OK	2005	NA	13463	13030	433	3.2
CN4004100000000	40	041	Delaware County, OK	2005	NA	17197	16390	807	4.7
CN4004300000000	40	043	Dewey County, OK	2005	NA	2366	2287	79	3.3
CN4004500000000	40	045	Ellis County, OK	2005	NA	2129	2066	63	3
CN4004700000000	40	047	Garfield County, OK	2005	NA	28304	27291	1013	3.6
CN4004900000000	40	049	Garvin County, OK	2005	NA	13174	12636	538	4.1
CN4005100000000	40	051	Grady County, OK	2005	NA	23447	22385	1062	4.5
CN4005300000000	40	053	Grant County, OK	2005	NA	2422	2333	89	3.7
CN4005500000000	40	055	Greer County, OK	2005	NA	2082	1964	118	5.7
CN4005700000000	40	057	Harmon County, OK	2005	NA	1359	1307	52	3.8
CN4005900000000	40	059	Harper County, OK	2005	NA	1815	1761	54	3
CN4006100000000	40	061	Haskell County, OK	2005	NA	5255	5016	239	4.5
CN4006300000000	40	063	Hughes County, OK	2005	NA	5132	4762	370	7.2
CN4006500000000	40	065	Jackson County, OK	2005	NA	12225	11749	476	3.9
CN4006700000000	40	067	Jefferson County, OK	2005	NA	2246	2129	117	5.2
CN4006900000000	40	069	Johnston County, OK	2005	NA	4850	4624	226	4.7
CN4007100000000	40	071	Kay County, OK	2005	NA	20926	19744	1182	5.6
CN4007300000000	40	073	Kingfisher County, OK	2005	NA	7642	7395	247	3.2
CN4007500000000	40	075	Kiowa County, OK	2005	NA	4052	3865	187	4.6
CN4007700000000	40	077	Latimer County, OK	2005	NA	4023	3796	227	5.6
CN4007900000000	40	079	Le Flore County, OK	2005	NA	21322	20232	1090	5.1
CN4008100000000	40	081	Lincoln County, OK	2005	NA	14775	14064	711	4.8
CN4008300000000	40	083	Logan County, OK	2005	NA	18151	17440	711	3.9
CN4008500000000	40	085	Love County, OK	2005	NA	4751	4548	203	4.3
CN4008700000000	40	087	McClain County, OK	2005	NA	14736	14119	617	4.2
CN4008900000000	40	089	McCurtain County, OK	2005	NA	13953	13030	923	6.6
CN4009100000000	40	091	McIntosh County, OK	2005	NA	8398	7907	491	5.8
CN4009300000000	40	093	Major County, OK	2005	NA	3659	3539	120	3.3
CN4009500000000	40	095	Marshall County, OK	2005	NA	6110	5813	297	4.9
CN4009700000000	40	097	Mayes County, OK	2005	NA	16576	15756	820	4.9
CN4009900000000	40	099	Murray County, OK	2005	NA	6999	6734	265	3.8
CN4010100000000	40	101	Muskogee County, OK	2005	NA	29223	27483	1740	6
CN4010300000000	40	103	Noble County, OK	2005	NA	5400	5190	210	3.9
CN4010500000000	40	105	Nowata County, OK	2005	NA	4859	4607	252	5.2
CN4010700000000	40	107	Okfuskee County, OK	2005	NA	4482	4162	320	7.1
CN4010900000000	40	109	Oklahoma County, OK	2005	NA	333282	317817	15465	4.6
CN4011100000000	40	111	Okmulgee County, OK	2005	NA	16816	15751	1065	6.3
CN4011300000000	40	113	Osage County, OK	2005	NA	20773	19775	998	4.8
CN4011500000000	40	115	Ottawa County, OK	2005	NA	15985	15178	807	5
CN4011700000000	40	117	Pawnee County, OK	2005	NA	7798	7410	388	5
CN4011900000000	40	119	Payne County, OK	2005	NA	35044	33658	1386	4
CN4012100000000	40	121	Pittsburg County, OK	2005	NA	20192	19201	991	4.9
CN4012300000000	40	123	Pontotoc County, OK	2005	NA	18664	17853	811	4.3
CN4012500000000	40	125	Pottawatomie County, OK	2005	NA	30845	29211	1634	5.3
CN4012700000000	40	127	Pushmataha County, OK	2005	NA	5299	5033	266	5
CN4012900000000	40	129	Roger Mills County, OK	2005	NA	1829	1778	51	2.8
CN4013100000000	40	131	Rogers County, OK	2005	NA	39849	38256	1593	4
CN4013300000000	40	133	Seminole County, OK	2005	NA	10067	9365	702	7
CN4013500000000	40	135	Sequoyah County, OK	2005	NA	18051	17065	986	5.5
CN4013700000000	40	137	Stephens County, OK	2005	NA	20015	19212	803	4
CN4013900000000	40	139	Texas County, OK	2005	NA	9352	9011	341	3.6
CN4014100000000	40	141	Tillman County, OK	2005	NA	3481	3313	168	4.8
CN4014300000000	40	143	Tulsa County, OK	2005	NA	293516	281404	12112	4.1
CN4014500000000	40	145	Wagoner County, OK	2005	NA	31999	30692	1307	4.1
CN4014700000000	40	147	Washington County, OK	2005	NA	24875	23847	1028	4.1
CN4014900000000	40	149	Washita County, OK	2005	NA	5784	5590	194	3.4
CN4015100000000	40	151	Woods County, OK	2005	NA	4396	4093	303	6.9
CN4015300000000	40	153	Woodward County, OK	2005	NA	10192	9850	342	3.4
CN4100100000000	41	001	Baker County, OR	2005	NA	7112	6585	527	7.4
CN4100300000000	41	003	Benton County, OR	2005	NA	41922	39870	2052	4.9
CN4100500000000	41	005	Clackamas County, OR	2005	NA	190177	179708	10469	5.5
CN4100700000000	41	007	Clatsop County, OR	2005	NA	19123	18023	1100	5.8
CN4100900000000	41	009	Columbia County, OR	2005	NA	23209	21505	1704	7.3
CN4101100000000	41	011	Coos County, OR	2005	NA	28530	26375	2155	7.6
CN4101300000000	41	013	Crook County, OR	2005	NA	9305	8656	649	7
CN4101500000000	41	015	Curry County, OR	2005	NA	9584	8918	666	6.9
CN4101700000000	41	017	Deschutes County, OR	2005	NA	74532	70250	4282	5.7
CN4101900000000	41	019	Douglas County, OR	2005	NA	46794	42948	3846	8.2
CN4102100000000	41	021	Gilliam County, OR	2005	NA	991	934	57	5.8
CN4102300000000	41	023	Grant County, OR	2005	NA	3625	3272	353	9.7
CN4102500000000	41	025	Harney County, OR	2005	NA	3397	3099	298	8.8
CN4102700000000	41	027	Hood River County, OR	2005	NA	12253	11478	775	6.3
CN4102900000000	41	029	Jackson County, OR	2005	NA	98727	92614	6113	6.2
CN4103100000000	41	031	Jefferson County, OR	2005	NA	9062	8520	542	6
CN4103300000000	41	033	Josephine County, OR	2005	NA	34300	31812	2488	7.3
CN4103500000000	41	035	Klamath County, OR	2005	NA	30045	27746	2299	7.7
CN4103700000000	41	037	Lake County, OR	2005	NA	3549	3247	302	8.5
CN4103900000000	41	039	Lane County, OR	2005	NA	173600	162936	10664	6.1
CN4104100000000	41	041	Lincoln County, OR	2005	NA	21930	20410	1520	6.9
CN4104300000000	41	043	Linn County, OR	2005	NA	51945	48046	3899	7.5
CN4104500000000	41	045	Malheur County, OR	2005	NA	12570	11477	1093	8.7
CN4104700000000	41	047	Marion County, OR	2005	NA	147824	138232	9592	6.5
CN4104900000000	41	049	Morrow County, OR	2005	NA	5454	5041	413	7.6
CN4105100000000	41	051	Multnomah County, OR	2005	NA	360354	338487	21867	6.1
CN4105300000000	41	053	Polk County, OR	2005	NA	35556	33556	2000	5.6
CN4105500000000	41	055	Sherman County, OR	2005	NA	882	822	60	6.8
CN4105700000000	41	057	Tillamook County, OR	2005	NA	12262	11504	758	6.2
CN4105900000000	41	059	Umatilla County, OR	2005	NA	36204	33347	2857	7.9
CN4106100000000	41	061	Union County, OR	2005	NA	11737	10936	801	6.8
CN4106300000000	41	063	Wallowa County, OR	2005	NA	3526	3263	263	7.5
CN4106500000000	41	065	Wasco County, OR	2005	NA	12656	11763	893	7.1
CN4106700000000	41	067	Washington County, OR	2005	NA	268325	254482	13843	5.2
CN4106900000000	41	069	Wheeler County, OR	2005	NA	664	622	42	6.3
CN4107100000000	41	071	Yamhill County, OR	2005	NA	44039	41362	2677	6.1
CN4200100000000	42	001	Adams County, PA	2005	NA	54495	52517	1978	3.6
CN4200300000000	42	003	Allegheny County, PA	2005	NA	628051	596886	31165	5
CN4200500000000	42	005	Armstrong County, PA	2005	NA	32901	30906	1995	6.1
CN4200700000000	42	007	Beaver County, PA	2005	NA	89335	84353	4982	5.6
CN4200900000000	42	009	Bedford County, PA	2005	NA	23378	21713	1665	7.1
CN4201100000000	42	011	Berks County, PA	2005	NA	198712	189015	9697	4.9
CN4201300000000	42	013	Blair County, PA	2005	NA	64786	61435	3351	5.2
CN4201500000000	42	015	Bradford County, PA	2005	NA	32179	30567	1612	5
CN4201700000000	42	017	Bucks County, PA	2005	NA	341282	327163	14119	4.1
CN4201900000000	42	019	Butler County, PA	2005	NA	94848	90283	4565	4.8
CN4202100000000	42	021	Cambria County, PA	2005	NA	67122	63007	4115	6.1
CN4202300000000	42	023	Cameron County, PA	2005	NA	2617	2434	183	7
CN4202500000000	42	025	Carbon County, PA	2005	NA	30223	28420	1803	6
CN4202700000000	42	027	Centre County, PA	2005	NA	72388	69492	2896	4
CN4202900000000	42	029	Chester County, PA	2005	NA	256305	246961	9344	3.6
CN4203100000000	42	031	Clarion County, PA	2005	NA	20827	19805	1022	4.9
CN4203300000000	42	033	Clearfield County, PA	2005	NA	40734	38359	2375	5.8
CN4203500000000	42	035	Clinton County, PA	2005	NA	18968	17814	1154	6.1
CN4203700000000	42	037	Columbia County, PA	2005	NA	34035	32045	1990	5.8
CN4203900000000	42	039	Crawford County, PA	2005	NA	42855	40394	2461	5.7
CN4204100000000	42	041	Cumberland County, PA	2005	NA	119810	115331	4479	3.7
CN4204300000000	42	043	Dauphin County, PA	2005	NA	133946	128233	5713	4.3
CN4204500000000	42	045	Delaware County, PA	2005	NA	279252	266447	12805	4.6
CN4204700000000	42	047	Elk County, PA	2005	NA	17583	16710	873	5
CN4204900000000	42	049	Erie County, PA	2005	NA	140605	133043	7562	5.4
CN4205100000000	42	051	Fayette County, PA	2005	NA	65225	60682	4543	7
CN4205300000000	42	053	Forest County, PA	2005	NA	2277	2073	204	9
CN4205500000000	42	055	Franklin County, PA	2005	NA	76938	74296	2642	3.4
CN4205700000000	42	057	Fulton County, PA	2005	NA	8196	7846	350	4.3
CN4205900000000	42	059	Greene County, PA	2005	NA	17247	16168	1079	6.3
CN4206100000000	42	061	Huntingdon County, PA	2005	NA	22120	20788	1332	6
CN4206300000000	42	063	Indiana County, PA	2005	NA	45202	42762	2440	5.4
CN4206500000000	42	065	Jefferson County, PA	2005	NA	22577	21359	1218	5.4
CN4206700000000	42	067	Juniata County, PA	2005	NA	13179	12622	557	4.2
CN4206900000000	42	069	Lackawanna County, PA	2005	NA	105324	99776	5548	5.3
CN4207100000000	42	071	Lancaster County, PA	2005	NA	267575	257802	9773	3.7
CN4207300000000	42	073	Lawrence County, PA	2005	NA	43929	41335	2594	5.9
CN4207500000000	42	075	Lebanon County, PA	2005	NA	70117	67598	2519	3.6
CN4207700000000	42	077	Lehigh County, PA	2005	NA	170760	162363	8397	4.9
CN4207900000000	42	079	Luzerne County, PA	2005	NA	157434	148332	9102	5.8
CN4208100000000	42	081	Lycoming County, PA	2005	NA	59297	56082	3215	5.4
CN4208300000000	42	083	McKean County, PA	2005	NA	21773	20586	1187	5.5
CN4208500000000	42	085	Mercer County, PA	2005	NA	55664	52181	3483	6.3
CN4208700000000	42	087	Mifflin County, PA	2005	NA	23056	21714	1342	5.8
CN4208900000000	42	089	Monroe County, PA	2005	NA	77999	73678	4321	5.5
CN4209100000000	42	091	Montgomery County, PA	2005	NA	422571	406172	16399	3.9
CN4209300000000	42	093	Montour County, PA	2005	NA	8963	8567	396	4.4
CN4209500000000	42	095	Northampton County, PA	2005	NA	147760	140396	7364	5
CN4209700000000	42	097	Northumberland County, PA	2005	NA	47156	44544	2612	5.5
CN4209900000000	42	099	Perry County, PA	2005	NA	24104	23085	1019	4.2
CN4210100000000	42	101	Philadelphia County/city, PA	2005	NA	617131	575746	41385	6.7
CN4210300000000	42	103	Pike County, PA	2005	NA	25838	24321	1517	5.9
CN4210500000000	42	105	Potter County, PA	2005	NA	8632	8083	549	6.4
CN4210700000000	42	107	Schuylkill County, PA	2005	NA	70578	66437	4141	5.9
CN4210900000000	42	109	Snyder County, PA	2005	NA	20279	19396	883	4.4
CN4211100000000	42	111	Somerset County, PA	2005	NA	39459	37108	2351	6
CN4211300000000	42	113	Sullivan County, PA	2005	NA	3115	2931	184	5.9
CN4211500000000	42	115	Susquehanna County, PA	2005	NA	21559	20489	1070	5
CN4211700000000	42	117	Tioga County, PA	2005	NA	20978	19755	1223	5.8
CN4211900000000	42	119	Union County, PA	2005	NA	17926	16967	959	5.3
CN4212100000000	42	121	Venango County, PA	2005	NA	26640	25194	1446	5.4
CN4212300000000	42	123	Warren County, PA	2005	NA	21162	20105	1057	5
CN4212500000000	42	125	Washington County, PA	2005	NA	102273	96666	5607	5.5
CN4212700000000	42	127	Wayne County, PA	2005	NA	24798	23603	1195	4.8
CN4212900000000	42	129	Westmoreland County, PA	2005	NA	184182	174423	9759	5.3
CN4213100000000	42	131	Wyoming County, PA	2005	NA	14264	13527	737	5.2
CN4213300000000	42	133	York County, PA	2005	NA	218916	209684	9232	4.2
CN4400100000000	44	001	Bristol County, RI	2005	NA	28254	27040	1214	4.3
CN4400300000000	44	003	Kent County, RI	2005	NA	96472	91837	4635	4.8
CN4400500000000	44	005	Newport County, RI	2005	NA	44632	42577	2055	4.6
CN4400700000000	44	007	Providence County, RI	2005	NA	323279	305663	17616	5.4
CN4400900000000	44	009	Washington County, RI	2005	NA	73099	70079	3020	4.1
CN4500100000000	45	001	Abbeville County, SC	2005	NA	12067	11137	930	7.7
CN4500300000000	45	003	Aiken County, SC	2005	NA	74270	69907	4363	5.9
CN4500500000000	45	005	Allendale County, SC	2005	NA	3290	2941	349	10.6
CN4500700000000	45	007	Anderson County, SC	2005	NA	83943	77761	6182	7.4
CN4500900000000	45	009	Bamberg County, SC	2005	NA	6563	5997	566	8.6
CN4501100000000	45	011	Barnwell County, SC	2005	NA	9387	8540	847	9
CN4501300000000	45	013	Beaufort County, SC	2005	NA	61574	58579	2995	4.9
CN4501500000000	45	015	Berkeley County, SC	2005	NA	71630	67822	3808	5.3
CN4501700000000	45	017	Calhoun County, SC	2005	NA	7091	6572	519	7.3
CN4501900000000	45	019	Charleston County, SC	2005	NA	167313	158229	9084	5.4
CN4502100000000	45	021	Cherokee County, SC	2005	NA	24899	22938	1961	7.9
CN4502300000000	45	023	Chester County, SC	2005	NA	15896	14437	1459	9.2
CN4502500000000	45	025	Chesterfield County, SC	2005	NA	18083	16380	1703	9.4
CN4502700000000	45	027	Clarendon County, SC	2005	NA	12742	11508	1234	9.7
CN4502900000000	45	029	Colleton County, SC	2005	NA	16396	15224	1172	7.1
CN4503100000000	45	031	Darlington County, SC	2005	NA	30588	27930	2658	8.7
CN4503300000000	45	033	Dillon County, SC	2005	NA	13545	12268	1277	9.4
CN4503500000000	45	035	Dorchester County, SC	2005	NA	56737	53739	2998	5.3
CN4503700000000	45	037	Edgefield County, SC	2005	NA	11168	10366	802	7.2
CN4503900000000	45	039	Fairfield County, SC	2005	NA	11316	10432	884	7.8
CN4504100000000	45	041	Florence County, SC	2005	NA	61798	56307	5491	8.9
CN4504300000000	45	043	Georgetown County, SC	2005	NA	28755	26283	2472	8.6
CN4504500000000	45	045	Greenville County, SC	2005	NA	209830	198291	11539	5.5
CN4504700000000	45	047	Greenwood County, SC	2005	NA	32531	29586	2945	9.1
CN4504900000000	45	049	Hampton County, SC	2005	NA	7772	7127	645	8.3
CN4505100000000	45	051	Horry County, SC	2005	NA	121360	114386	6974	5.7
CN4505300000000	45	053	Jasper County, SC	2005	NA	10107	9586	521	5.2
CN4505500000000	45	055	Kershaw County, SC	2005	NA	28995	27097	1898	6.5
CN4505700000000	45	057	Lancaster County, SC	2005	NA	29727	27241	2486	8.4
CN4505900000000	45	059	Laurens County, SC	2005	NA	33202	30981	2221	6.7
CN4506100000000	45	061	Lee County, SC	2005	NA	8303	7517	786	9.5
CN4506300000000	45	063	Lexington County, SC	2005	NA	127602	121370	6232	4.9
CN4506500000000	45	065	McCormick County, SC	2005	NA	3550	3155	395	11.1
CN4506700000000	45	067	Marion County, SC	2005	NA	13783	11905	1878	13.6
CN4506900000000	45	069	Marlboro County, SC	2005	NA	12547	11122	1425	11.4
CN4507100000000	45	071	Newberry County, SC	2005	NA	17669	16438	1231	7
CN4507300000000	45	073	Oconee County, SC	2005	NA	31781	29035	2746	8.6
CN4507500000000	45	075	Orangeburg County, SC	2005	NA	40563	36659	3904	9.6
CN4507700000000	45	077	Pickens County, SC	2005	NA	57238	53508	3730	6.5
CN4507900000000	45	079	Richland County, SC	2005	NA	171046	160878	10168	5.9
CN4508100000000	45	081	Saluda County, SC	2005	NA	9270	8655	615	6.6
CN4508300000000	45	083	Spartanburg County, SC	2005	NA	131691	121861	9830	7.5
CN4508500000000	45	085	Sumter County, SC	2005	NA	46446	42505	3941	8.5
CN4508700000000	45	087	Union County, SC	2005	NA	12671	11302	1369	10.8
CN4508900000000	45	089	Williamsburg County, SC	2005	NA	15579	13844	1735	11.1
CN4509100000000	45	091	York County, SC	2005	NA	96285	89887	6398	6.6
CN4600300000000	46	003	Aurora County, SD	2005	NA	1375	1319	56	4.1
CN4600500000000	46	005	Beadle County, SD	2005	NA	8889	8501	388	4.4
CN4600700000000	46	007	Bennett County, SD	2005	NA	1436	1348	88	6.1
CN4600900000000	46	009	Bon Homme County, SD	2005	NA	3354	3223	131	3.9
CN4601100000000	46	011	Brookings County, SD	2005	NA	18293	17723	570	3.1
CN4601300000000	46	013	Brown County, SD	2005	NA	20846	20162	684	3.3
CN4601500000000	46	015	Brule County, SD	2005	NA	2861	2766	95	3.3
CN4601700000000	46	017	Buffalo County, SD	2005	NA	573	485	88	15.4
CN4601900000000	46	019	Butte County, SD	2005	NA	5151	4967	184	3.6
CN4602100000000	46	021	Campbell County, SD	2005	NA	891	857	34	3.8
CN4602300000000	46	023	Charles Mix County, SD	2005	NA	4173	3988	185	4.4
CN4602500000000	46	025	Clark County, SD	2005	NA	1869	1778	91	4.9
CN4602700000000	46	027	Clay County, SD	2005	NA	7339	7086	253	3.4
CN4602900000000	46	029	Codington County, SD	2005	NA	15889	15309	580	3.7
CN4603100000000	46	031	Corson County, SD	2005	NA	1431	1327	104	7.3
CN4603300000000	46	033	Custer County, SD	2005	NA	4800	4614	186	3.9
CN4603500000000	46	035	Davison County, SD	2005	NA	11036	10677	359	3.3
CN4603700000000	46	037	Day County, SD	2005	NA	3015	2833	182	6
CN4603900000000	46	039	Deuel County, SD	2005	NA	2664	2550	114	4.3
CN4604100000000	46	041	Dewey County, SD	2005	NA	2668	2404	264	9.9
CN4604300000000	46	043	Douglas County, SD	2005	NA	1784	1725	59	3.3
CN4604500000000	46	045	Edmunds County, SD	2005	NA	2095	2026	69	3.3
CN4604700000000	46	047	Fall River County, SD	2005	NA	3878	3720	158	4.1
CN4604900000000	46	049	Faulk County, SD	2005	NA	1175	1131	44	3.7
CN4605100000000	46	051	Grant County, SD	2005	NA	4133	3946	187	4.5
CN4605300000000	46	053	Gregory County, SD	2005	NA	2486	2391	95	3.8
CN4605500000000	46	055	Haakon County, SD	2005	NA	1196	1156	40	3.3
CN4605700000000	46	057	Hamlin County, SD	2005	NA	2931	2813	118	4
CN4605900000000	46	059	Hand County, SD	2005	NA	1916	1855	61	3.2
CN4606100000000	46	061	Hanson County, SD	2005	NA	2019	1950	69	3.4
CN4606300000000	46	063	Harding County, SD	2005	NA	810	782	28	3.5
CN4606500000000	46	065	Hughes County, SD	2005	NA	10169	9854	315	3.1
CN4606700000000	46	067	Hutchinson County, SD	2005	NA	3825	3671	154	4
CN4606900000000	46	069	Hyde County, SD	2005	NA	776	743	33	4.3
CN4607100000000	46	071	Jackson County, SD	2005	NA	1292	1210	82	6.3
CN4607300000000	46	073	Jerauld County, SD	2005	NA	1322	1276	46	3.5
CN4607500000000	46	075	Jones County, SD	2005	NA	730	709	21	2.9
CN4607700000000	46	077	Kingsbury County, SD	2005	NA	3094	2973	121	3.9
CN4607900000000	46	079	Lake County, SD	2005	NA	6690	6437	253	3.8
CN4608100000000	46	081	Lawrence County, SD	2005	NA	12864	12406	458	3.6
CN4608300000000	46	083	Lincoln County, SD	2005	NA	19303	18733	570	3
CN4608500000000	46	085	Lyman County, SD	2005	NA	2009	1903	106	5.3
CN4608700000000	46	087	McCook County, SD	2005	NA	2962	2860	102	3.4
CN4608900000000	46	089	McPherson County, SD	2005	NA	1225	1172	53	4.3
CN4609100000000	46	091	Marshall County, SD	2005	NA	2120	2018	102	4.8
CN4609300000000	46	093	Meade County, SD	2005	NA	12738	12259	479	3.8
CN4609500000000	46	095	Mellette County, SD	2005	NA	909	856	53	5.8
CN4609700000000	46	097	Miner County, SD	2005	NA	1213	1154	59	4.9
CN4609900000000	46	099	Minnehaha County, SD	2005	NA	93785	90545	3240	3.5
CN4610100000000	46	101	Moody County, SD	2005	NA	3905	3713	192	4.9
CN4610200000000	46	102	Oglala Lakota County, SD	2005	NA	3963	3530	433	10.9
CN4610300000000	46	103	Pennington County, SD	2005	NA	52584	50686	1898	3.6
CN4610500000000	46	105	Perkins County, SD	2005	NA	1735	1665	70	4
CN4610700000000	46	107	Potter County, SD	2005	NA	1366	1315	51	3.7
CN4610900000000	46	109	Roberts County, SD	2005	NA	4806	4561	245	5.1
CN4611100000000	46	111	Sanborn County, SD	2005	NA	1594	1539	55	3.5
CN4611500000000	46	115	Spink County, SD	2005	NA	3494	3356	138	3.9
CN4611700000000	46	117	Stanley County, SD	2005	NA	1937	1885	52	2.7
CN4611900000000	46	119	Sully County, SD	2005	NA	1018	988	30	2.9
CN4612100000000	46	121	Todd County, SD	2005	NA	3477	3270	207	6
CN4612300000000	46	123	Tripp County, SD	2005	NA	3104	2993	111	3.6
CN4612500000000	46	125	Turner County, SD	2005	NA	4514	4345	169	3.7
CN4612700000000	46	127	Union County, SD	2005	NA	7546	7241	305	4
CN4612900000000	46	129	Walworth County, SD	2005	NA	2718	2580	138	5.1
CN4613500000000	46	135	Yankton County, SD	2005	NA	11941	11518	423	3.5
CN4613700000000	46	137	Ziebach County, SD	2005	NA	908	835	73	8
CN4700100000000	47	001	Anderson County, TN	2005	NA	34488	32712	1776	5.1
CN4700300000000	47	003	Bedford County, TN	2005	NA	21415	20256	1159	5.4
CN4700500000000	47	005	Benton County, TN	2005	NA	6732	6175	557	8.3
CN4700700000000	47	007	Bledsoe County, TN	2005	NA	4605	4243	362	7.9
CN4700900000000	47	009	Blount County, TN	2005	NA	59009	56242	2767	4.7
CN4701100000000	47	011	Bradley County, TN	2005	NA	46242	43813	2429	5.3
CN4701300000000	47	013	Campbell County, TN	2005	NA	16672	15680	992	6
CN4701500000000	47	015	Cannon County, TN	2005	NA	6377	6042	335	5.3
CN4701700000000	47	017	Carroll County, TN	2005	NA	13549	12519	1030	7.6
CN4701900000000	47	019	Carter County, TN	2005	NA	28740	27086	1654	5.8
CN4702100000000	47	021	Cheatham County, TN	2005	NA	20229	19344	885	4.4
CN4702300000000	47	023	Chester County, TN	2005	NA	7533	7082	451	6
CN4702500000000	47	025	Claiborne County, TN	2005	NA	12912	12190	722	5.6
CN4702700000000	47	027	Clay County, TN	2005	NA	3550	3140	410	11.5
CN4702900000000	47	029	Cocke County, TN	2005	NA	15749	14533	1216	7.7
CN4703100000000	47	031	Coffee County, TN	2005	NA	25210	23816	1394	5.5
CN4703300000000	47	033	Crockett County, TN	2005	NA	6390	5890	500	7.8
CN4703500000000	47	035	Cumberland County, TN	2005	NA	22228	20748	1480	6.7
CN4703700000000	47	037	Davidson County, TN	2005	NA	301917	288260	13657	4.5
CN4703900000000	47	039	Decatur County, TN	2005	NA	5395	4974	421	7.8
CN4704100000000	47	041	DeKalb County, TN	2005	NA	9698	9135	563	5.8
CN4704300000000	47	043	Dickson County, TN	2005	NA	22668	21544	1124	5
CN4704500000000	47	045	Dyer County, TN	2005	NA	17228	16172	1056	6.1
CN4704700000000	47	047	Fayette County, TN	2005	NA	15955	14874	1081	6.8
CN4704900000000	47	049	Fentress County, TN	2005	NA	7029	6532	497	7.1
CN4705100000000	47	051	Franklin County, TN	2005	NA	19828	18729	1099	5.5
CN4705300000000	47	053	Gibson County, TN	2005	NA	20641	18886	1755	8.5
CN4705500000000	47	055	Giles County, TN	2005	NA	13273	12302	971	7.3
CN4705700000000	47	057	Grainger County, TN	2005	NA	10042	9442	600	6
CN4705900000000	47	059	Greene County, TN	2005	NA	31971	29235	2736	8.6
CN4706100000000	47	061	Grundy County, TN	2005	NA	5756	5323	433	7.5
CN4706300000000	47	063	Hamblen County, TN	2005	NA	29400	27686	1714	5.8
CN4706500000000	47	065	Hamilton County, TN	2005	NA	156630	149223	7407	4.7
CN4706700000000	47	067	Hancock County, TN	2005	NA	2398	2181	217	9
CN4706900000000	47	069	Hardeman County, TN	2005	NA	11035	10089	946	8.6
CN4707100000000	47	071	Hardin County, TN	2005	NA	11177	10360	817	7.3
CN4707300000000	47	073	Hawkins County, TN	2005	NA	25347	23775	1572	6.2
CN4707500000000	47	075	Haywood County, TN	2005	NA	9116	8358	758	8.3
CN4707700000000	47	077	Henderson County, TN	2005	NA	12615	11678	937	7.4
CN4707900000000	47	079	Henry County, TN	2005	NA	14027	12974	1053	7.5
CN4708100000000	47	081	Hickman County, TN	2005	NA	10122	9495	627	6.2
CN4708300000000	47	083	Houston County, TN	2005	NA	3763	3444	319	8.5
CN4708500000000	47	085	Humphreys County, TN	2005	NA	8824	8146	678	7.7
CN4708700000000	47	087	Jackson County, TN	2005	NA	5158	4714	444	8.6
CN4708900000000	47	089	Jefferson County, TN	2005	NA	23507	22115	1392	5.9
CN4709100000000	47	091	Johnson County, TN	2005	NA	6943	6373	570	8.2
CN4709300000000	47	093	Knox County, TN	2005	NA	213735	204747	8988	4.2
CN4709500000000	47	095	Lake County, TN	2005	NA	2568	2357	211	8.2
CN4709700000000	47	097	Lauderdale County, TN	2005	NA	9598	8760	838	8.7
CN4709900000000	47	099	Lawrence County, TN	2005	NA	17272	15537	1735	10
CN4710100000000	47	101	Lewis County, TN	2005	NA	5113	4629	484	9.5
CN4710300000000	47	103	Lincoln County, TN	2005	NA	16401	15621	780	4.8
CN4710500000000	47	105	Loudon County, TN	2005	NA	21651	20642	1009	4.7
CN4710700000000	47	107	McMinn County, TN	2005	NA	23768	22321	1447	6.1
CN4710900000000	47	109	McNairy County, TN	2005	NA	12196	11464	732	6
CN4711100000000	47	111	Macon County, TN	2005	NA	10453	9856	597	5.7
CN4711300000000	47	113	Madison County, TN	2005	NA	46399	43811	2588	5.6
CN4711500000000	47	115	Marion County, TN	2005	NA	12720	11935	785	6.2
CN4711700000000	47	117	Marshall County, TN	2005	NA	12381	11581	800	6.5
CN4711900000000	47	119	Maury County, TN	2005	NA	35653	33509	2144	6
CN4712100000000	47	121	Meigs County, TN	2005	NA	4750	4404	346	7.3
CN4712300000000	47	123	Monroe County, TN	2005	NA	18464	17342	1122	6.1
CN4712500000000	47	125	Montgomery County, TN	2005	NA	65160	61940	3220	4.9
CN4712700000000	47	127	Moore County, TN	2005	NA	3086	2944	142	4.6
CN4712900000000	47	129	Morgan County, TN	2005	NA	8118	7509	609	7.5
CN4713100000000	47	131	Obion County, TN	2005	NA	15360	14434	926	6
CN4713300000000	47	133	Overton County, TN	2005	NA	9705	9140	565	5.8
CN4713500000000	47	135	Perry County, TN	2005	NA	3254	3020	234	7.2
CN4713700000000	47	137	Pickett County, TN	2005	NA	1839	1682	157	8.5
CN4713900000000	47	139	Polk County, TN	2005	NA	7220	6792	428	5.9
CN4714100000000	47	141	Putnam County, TN	2005	NA	33719	32029	1690	5
CN4714300000000	47	143	Rhea County, TN	2005	NA	13141	12253	888	6.8
CN4714500000000	47	145	Roane County, TN	2005	NA	25587	24096	1491	5.8
CN4714700000000	47	147	Robertson County, TN	2005	NA	31473	29943	1530	4.9
CN4714900000000	47	149	Rutherford County, TN	2005	NA	117742	112833	4909	4.2
CN4715100000000	47	151	Scott County, TN	2005	NA	8437	7853	584	6.9
CN4715300000000	47	153	Sequatchie County, TN	2005	NA	5792	5461	331	5.7
CN4715500000000	47	155	Sevier County, TN	2005	NA	44971	42243	2728	6.1
CN4715700000000	47	157	Shelby County, TN	2005	NA	428931	402211	26720	6.2
CN4715900000000	47	159	Smith County, TN	2005	NA	9047	8501	546	6
CN4716100000000	47	161	Stewart County, TN	2005	NA	5865	5432	433	7.4
CN4716300000000	47	163	Sullivan County, TN	2005	NA	71480	67752	3728	5.2
CN4716500000000	47	165	Sumner County, TN	2005	NA	75319	71846	3473	4.6
CN4716700000000	47	167	Tipton County, TN	2005	NA	26436	24733	1703	6.4
CN4716900000000	47	169	Trousdale County, TN	2005	NA	3671	3428	243	6.6
CN4717100000000	47	171	Unicoi County, TN	2005	NA	8144	7638	506	6.2
CN4717300000000	47	173	Union County, TN	2005	NA	8718	8231	487	5.6
CN4717500000000	47	175	Van Buren County, TN	2005	NA	2456	2245	211	8.6
CN4717700000000	47	177	Warren County, TN	2005	NA	18324	16872	1452	7.9
CN4717900000000	47	179	Washington County, TN	2005	NA	57753	54913	2840	4.9
CN4718100000000	47	181	Wayne County, TN	2005	NA	6498	5708	790	12.2
CN4718300000000	47	183	Weakley County, TN	2005	NA	15305	14240	1065	7
CN4718500000000	47	185	White County, TN	2005	NA	10785	9736	1049	9.7
CN4718700000000	47	187	Williamson County, TN	2005	NA	81057	77958	3099	3.8
CN4718900000000	47	189	Wilson County, TN	2005	NA	54198	51727	2471	4.6
CN4800100000000	48	001	Anderson County, TX	2005	NA	20015	18753	1262	6.3
CN4800300000000	48	003	Andrews County, TX	2005	NA	6337	6082	255	4
CN4800500000000	48	005	Angelina County, TX	2005	NA	39283	37137	2146	5.5
CN4800700000000	48	007	Aransas County, TX	2005	NA	10964	10363	601	5.5
CN4800900000000	48	009	Archer County, TX	2005	NA	5289	5105	184	3.5
CN4801100000000	48	011	Armstrong County, TX	2005	NA	1123	1079	44	3.9
CN4801300000000	48	013	Atascosa County, TX	2005	NA	19011	18014	997	5.2
CN4801500000000	48	015	Austin County, TX	2005	NA	12797	12216	581	4.5
CN4801700000000	48	017	Bailey County, TX	2005	NA	3234	3059	175	5.4
CN4801900000000	48	019	Bandera County, TX	2005	NA	9665	9230	435	4.5
CN4802100000000	48	021	Bastrop County, TX	2005	NA	33653	31948	1705	5.1
CN4802300000000	48	023	Baylor County, TX	2005	NA	1863	1774	89	4.8
CN4802500000000	48	025	Bee County, TX	2005	NA	11054	10267	787	7.1
CN4802700000000	48	027	Bell County, TX	2005	NA	114094	108380	5714	5
CN4802900000000	48	029	Bexar County, TX	2005	NA	714126	677680	36446	5.1
CN4803100000000	48	031	Blanco County, TX	2005	NA	4691	4500	191	4.1
CN4803300000000	48	033	Borden County, TX	2005	NA	457	440	17	3.7
CN4803500000000	48	035	Bosque County, TX	2005	NA	8387	7959	428	5.1
CN4803700000000	48	037	Bowie County, TX	2005	NA	42168	39885	2283	5.4
CN4803900000000	48	039	Brazoria County, TX	2005	NA	133540	125868	7672	5.7
CN4804100000000	48	041	Brazos County, TX	2005	NA	86694	83047	3647	4.2
CN4804300000000	48	043	Brewster County, TX	2005	NA	5249	5052	197	3.8
CN4804500000000	48	045	Briscoe County, TX	2005	NA	716	677	39	5.4
CN4804700000000	48	047	Brooks County, TX	2005	NA	3092	2883	209	6.8
CN4804900000000	48	049	Brown County, TX	2005	NA	18671	17793	878	4.7
CN4805100000000	48	051	Burleson County, TX	2005	NA	8615	8258	357	4.1
CN4805300000000	48	053	Burnet County, TX	2005	NA	20273	19380	893	4.4
CN4805500000000	48	055	Caldwell County, TX	2005	NA	15967	15117	850	5.3
CN4805700000000	48	057	Calhoun County, TX	2005	NA	9347	8805	542	5.8
CN4805900000000	48	059	Callahan County, TX	2005	NA	6993	6708	285	4.1
CN4806100000000	48	061	Cameron County, TX	2005	NA	140218	129543	10675	7.6
CN4806300000000	48	063	Camp County, TX	2005	NA	5374	5064	310	5.8
CN4806500000000	48	065	Carson County, TX	2005	NA	3489	3352	137	3.9
CN4806700000000	48	067	Cass County, TX	2005	NA	13340	12512	828	6.2
CN4806900000000	48	069	Castro County, TX	2005	NA	3387	3201	186	5.5
CN4807100000000	48	071	Chambers County, TX	2005	NA	13984	13123	861	6.2
CN4807300000000	48	073	Cherokee County, TX	2005	NA	20580	19430	1150	5.6
CN4807500000000	48	075	Childress County, TX	2005	NA	3069	2896	173	5.6
CN4807700000000	48	077	Clay County, TX	2005	NA	6476	6230	246	3.8
CN4807900000000	48	079	Cochran County, TX	2005	NA	1550	1462	88	5.7
CN4808100000000	48	081	Coke County, TX	2005	NA	1372	1296	76	5.5
CN4808300000000	48	083	Coleman County, TX	2005	NA	4319	4120	199	4.6
CN4808500000000	48	085	Collin County, TX	2005	NA	367439	350325	17114	4.7
CN4808700000000	48	087	Collingsworth County, TX	2005	NA	1625	1553	72	4.4
CN4808900000000	48	089	Colorado County, TX	2005	NA	10314	9852	462	4.5
CN4809100000000	48	091	Comal County, TX	2005	NA	48830	46631	2199	4.5
CN4809300000000	48	093	Comanche County, TX	2005	NA	6427	6125	302	4.7
CN4809500000000	48	095	Concho County, TX	2005	NA	1377	1296	81	5.9
CN4809700000000	48	097	Cooke County, TX	2005	NA	19868	19025	843	4.2
CN4809900000000	48	099	Coryell County, TX	2005	NA	25361	23789	1572	6.2
CN4810100000000	48	101	Cottle County, TX	2005	NA	822	776	46	5.6
CN4810300000000	48	103	Crane County, TX	2005	NA	1578	1498	80	5.1
CN4810500000000	48	105	Crockett County, TX	2005	NA	2036	1961	75	3.7
CN4810700000000	48	107	Crosby County, TX	2005	NA	2923	2765	158	5.4
CN4810900000000	48	109	Culberson County, TX	2005	NA	1648	1583	65	3.9
CN4811100000000	48	111	Dallam County, TX	2005	NA	3079	2976	103	3.3
CN4811300000000	48	113	Dallas County, TX	2005	NA	1142456	1077868	64588	5.7
CN4811500000000	48	115	Dawson County, TX	2005	NA	5170	4817	353	6.8
CN4811700000000	48	117	Deaf Smith County, TX	2005	NA	8330	7943	387	4.6
CN4811900000000	48	119	Delta County, TX	2005	NA	2412	2279	133	5.5
CN4812100000000	48	121	Denton County, TX	2005	NA	314097	299695	14402	4.6
CN4812300000000	48	123	DeWitt County, TX	2005	NA	9338	8907	431	4.6
CN4812500000000	48	125	Dickens County, TX	2005	NA	1076	1020	56	5.2
CN4812700000000	48	127	Dimmit County, TX	2005	NA	3813	3500	313	8.2
CN4812900000000	48	129	Donley County, TX	2005	NA	1835	1745	90	4.9
CN4813100000000	48	131	Duval County, TX	2005	NA	5249	4926	323	6.2
CN4813300000000	48	133	Eastland County, TX	2005	NA	8491	8050	441	5.2
CN4813500000000	48	135	Ector County, TX	2005	NA	62285	59458	2827	4.5
CN4813700000000	48	137	Edwards County, TX	2005	NA	1027	986	41	4
CN4813900000000	48	139	Ellis County, TX	2005	NA	66297	62763	3534	5.3
CN4814100000000	48	141	El Paso County, TX	2005	NA	290010	269570	20440	7
CN4814300000000	48	143	Erath County, TX	2005	NA	17496	16774	722	4.1
CN4814500000000	48	145	Falls County, TX	2005	NA	7276	6826	450	6.2
CN4814700000000	48	147	Fannin County, TX	2005	NA	13803	12921	882	6.4
CN4814900000000	48	149	Fayette County, TX	2005	NA	11997	11529	468	3.9
CN4815100000000	48	151	Fisher County, TX	2005	NA	2028	1942	86	4.2
CN4815300000000	48	153	Floyd County, TX	2005	NA	3255	3069	186	5.7
CN4815500000000	48	155	Foard County, TX	2005	NA	686	653	33	4.8
CN4815700000000	48	157	Fort Bend County, TX	2005	NA	235000	222687	12313	5.2
CN4815900000000	48	159	Franklin County, TX	2005	NA	5137	4888	249	4.8
CN4816100000000	48	161	Freestone County, TX	2005	NA	10010	9586	424	4.2
CN4816300000000	48	163	Frio County, TX	2005	NA	6371	5986	385	6
CN4816500000000	48	165	Gaines County, TX	2005	NA	6223	5926	297	4.8
CN4816700000000	48	167	Galveston County, TX	2005	NA	137734	129836	7898	5.7
CN4816900000000	48	169	Garza County, TX	2005	NA	2399	2292	107	4.5
CN4817100000000	48	171	Gillespie County, TX	2005	NA	12746	12315	431	3.4
CN4817300000000	48	173	Glasscock County, TX	2005	NA	637	613	24	3.8
CN4817500000000	48	175	Goliad County, TX	2005	NA	3397	3234	163	4.8
CN4817700000000	48	177	Gonzales County, TX	2005	NA	9632	9233	399	4.1
CN4817900000000	48	179	Gray County, TX	2005	NA	10824	10367	457	4.2
CN4818100000000	48	181	Grayson County, TX	2005	NA	56416	53380	3036	5.4
CN4818300000000	48	183	Gregg County, TX	2005	NA	60526	57558	2968	4.9
CN4818500000000	48	185	Grimes County, TX	2005	NA	10229	9606	623	6.1
CN4818700000000	48	187	Guadalupe County, TX	2005	NA	51700	49318	2382	4.6
CN4818900000000	48	189	Hale County, TX	2005	NA	16756	15865	891	5.3
CN4819100000000	48	191	Hall County, TX	2005	NA	1585	1493	92	5.8
CN4819300000000	48	193	Hamilton County, TX	2005	NA	3958	3775	183	4.6
CN4819500000000	48	195	Hansford County, TX	2005	NA	2472	2384	88	3.6
CN4819700000000	48	197	Hardeman County, TX	2005	NA	2292	2189	103	4.5
CN4819900000000	48	199	Hardin County, TX	2005	NA	24619	22996	1623	6.6
CN4820100000000	48	201	Harris County, TX	2005	NA	1823699	1719989	103710	5.7
CN4820300000000	48	203	Harrison County, TX	2005	NA	31118	29386	1732	5.6
CN4820500000000	48	205	Hartley County, TX	2005	NA	2276	2187	89	3.9
CN4820700000000	48	207	Haskell County, TX	2005	NA	3147	3028	119	3.8
CN4820900000000	48	209	Hays County, TX	2005	NA	67038	63996	3042	4.5
CN4821100000000	48	211	Hemphill County, TX	2005	NA	2251	2186	65	2.9
CN4821300000000	48	213	Henderson County, TX	2005	NA	34466	32483	1983	5.8
CN4821500000000	48	215	Hidalgo County, TX	2005	NA	260575	239969	20606	7.9
CN4821700000000	48	217	Hill County, TX	2005	NA	15349	14389	960	6.3
CN4821900000000	48	219	Hockley County, TX	2005	NA	11049	10554	495	4.5
CN4822100000000	48	221	Hood County, TX	2005	NA	22525	21350	1175	5.2
CN4822300000000	48	223	Hopkins County, TX	2005	NA	17449	16650	799	4.6
CN4822500000000	48	225	Houston County, TX	2005	NA	8494	7945	549	6.5
CN4822700000000	48	227	Howard County, TX	2005	NA	13311	12602	709	5.3
CN4822900000000	48	229	Hudspeth County, TX	2005	NA	1328	1236	92	6.9
CN4823100000000	48	231	Hunt County, TX	2005	NA	38516	36412	2104	5.5
CN4823300000000	48	233	Hutchinson County, TX	2005	NA	10189	9670	519	5.1
CN4823500000000	48	235	Irion County, TX	2005	NA	957	923	34	3.6
CN4823700000000	48	237	Jack County, TX	2005	NA	4078	3889	189	4.6
CN4823900000000	48	239	Jackson County, TX	2005	NA	6625	6299	326	4.9
CN4824100000000	48	241	Jasper County, TX	2005	NA	15584	14330	1254	8
CN4824300000000	48	243	Jeff Davis County, TX	2005	NA	1203	1156	47	3.9
CN4824500000000	48	245	Jefferson County, TX	2005	NA	111553	102875	8678	7.8
CN4824700000000	48	247	Jim Hogg County, TX	2005	NA	2616	2491	125	4.8
CN4824900000000	48	249	Jim Wells County, TX	2005	NA	19753	18664	1089	5.5
CN4825100000000	48	251	Johnson County, TX	2005	NA	72108	68540	3568	4.9
CN4825300000000	48	253	Jones County, TX	2005	NA	7869	7446	423	5.4
CN4825500000000	48	255	Karnes County, TX	2005	NA	5437	5092	345	6.3
CN4825700000000	48	257	Kaufman County, TX	2005	NA	43006	40644	2362	5.5
CN4825900000000	48	259	Kendall County, TX	2005	NA	14298	13703	595	4.2
CN4826100000000	48	261	Kenedy County, TX	2005	NA	248	241	7	2.8
CN4826300000000	48	263	Kent County, TX	2005	NA	440	422	18	4.1
CN4826500000000	48	265	Kerr County, TX	2005	NA	22578	21655	923	4.1
CN4826700000000	48	267	Kimble County, TX	2005	NA	2264	2171	93	4.1
CN4826900000000	48	269	King County, TX	2005	NA	167	160	7	4.2
CN4827100000000	48	271	Kinney County, TX	2005	NA	1439	1352	87	6
CN4827300000000	48	273	Kleberg County, TX	2005	NA	16308	15469	839	5.1
CN4827500000000	48	275	Knox County, TX	2005	NA	1789	1704	85	4.8
CN4827700000000	48	277	Lamar County, TX	2005	NA	22980	21551	1429	6.2
CN4827900000000	48	279	Lamb County, TX	2005	NA	7213	6861	352	4.9
CN4828100000000	48	281	Lampasas County, TX	2005	NA	9922	9492	430	4.3
CN4828300000000	48	283	La Salle County, TX	2005	NA	2597	2451	146	5.6
CN4828500000000	48	285	Lavaca County, TX	2005	NA	10355	9982	373	3.6
CN4828700000000	48	287	Lee County, TX	2005	NA	8656	8276	380	4.4
CN4828900000000	48	289	Leon County, TX	2005	NA	7702	7277	425	5.5
CN4829100000000	48	291	Liberty County, TX	2005	NA	31272	29160	2112	6.8
CN4829300000000	48	293	Limestone County, TX	2005	NA	10327	9802	525	5.1
CN4829500000000	48	295	Lipscomb County, TX	2005	NA	1662	1604	58	3.5
CN4829700000000	48	297	Live Oak County, TX	2005	NA	5031	4777	254	5
CN4829900000000	48	299	Llano County, TX	2005	NA	8021	7614	407	5.1
CN4830100000000	48	301	Loving County, TX	2005	NA	39	35	4	10.3
CN4830300000000	48	303	Lubbock County, TX	2005	NA	137313	131720	5593	4.1
CN4830500000000	48	305	Lynn County, TX	2005	NA	2831	2667	164	5.8
CN4830700000000	48	307	McCulloch County, TX	2005	NA	3757	3569	188	5
CN4830900000000	48	309	McLennan County, TX	2005	NA	112002	106373	5629	5
CN4831100000000	48	311	McMullen County, TX	2005	NA	381	361	20	5.2
CN4831300000000	48	313	Madison County, TX	2005	NA	4922	4638	284	5.8
CN4831500000000	48	315	Marion County, TX	2005	NA	5063	4775	288	5.7
CN4831700000000	48	317	Martin County, TX	2005	NA	2113	2020	93	4.4
CN4831900000000	48	319	Mason County, TX	2005	NA	2385	2314	71	3
CN4832100000000	48	321	Matagorda County, TX	2005	NA	16325	14998	1327	8.1
CN4832300000000	48	323	Maverick County, TX	2005	NA	19087	16543	2544	13.3
CN4832500000000	48	325	Medina County, TX	2005	NA	19420	18465	955	4.9
CN4832700000000	48	327	Menard County, TX	2005	NA	1090	1040	50	4.6
CN4832900000000	48	329	Midland County, TX	2005	NA	66317	63868	2449	3.7
CN4833100000000	48	331	Milam County, TX	2005	NA	12157	11538	619	5.1
CN4833300000000	48	333	Mills County, TX	2005	NA	2547	2448	99	3.9
CN4833500000000	48	335	Mitchell County, TX	2005	NA	3363	3150	213	6.3
CN4833700000000	48	337	Montague County, TX	2005	NA	9784	9350	434	4.4
CN4833900000000	48	339	Montgomery County, TX	2005	NA	189082	180109	8973	4.7
CN4834100000000	48	341	Moore County, TX	2005	NA	10233	9846	387	3.8
CN4834300000000	48	343	Morris County, TX	2005	NA	6093	5723	370	6.1
CN4834500000000	48	345	Motley County, TX	2005	NA	669	642	27	4
CN4834700000000	48	347	Nacogdoches County, TX	2005	NA	31075	29454	1621	5.2
CN4834900000000	48	349	Navarro County, TX	2005	NA	21441	20210	1231	5.7
CN4835100000000	48	351	Newton County, TX	2005	NA	5771	5239	532	9.2
CN4835300000000	48	353	Nolan County, TX	2005	NA	7559	7205	354	4.7
CN4835500000000	48	355	Nueces County, TX	2005	NA	156542	148088	8454	5.4
CN4835700000000	48	357	Ochiltree County, TX	2005	NA	5023	4863	160	3.2
CN4835900000000	48	359	Oldham County, TX	2005	NA	1058	1018	40	3.8
CN4836100000000	48	361	Orange County, TX	2005	NA	40782	37526	3256	8
CN4836300000000	48	363	Palo Pinto County, TX	2005	NA	14208	13564	644	4.5
CN4836500000000	48	365	Panola County, TX	2005	NA	11619	11050	569	4.9
CN4836700000000	48	367	Parker County, TX	2005	NA	50654	48241	2413	4.8
CN4836900000000	48	369	Parmer County, TX	2005	NA	4594	4413	181	3.9
CN4837100000000	48	371	Pecos County, TX	2005	NA	6650	6308	342	5.1
CN4837300000000	48	373	Polk County, TX	2005	NA	16734	15598	1136	6.8
CN4837500000000	48	375	Potter County, TX	2005	NA	56544	53955	2589	4.6
CN4837700000000	48	377	Presidio County, TX	2005	NA	3241	2884	357	11
CN4837900000000	48	379	Rains County, TX	2005	NA	5087	4814	273	5.4
CN4838100000000	48	381	Randall County, TX	2005	NA	65374	63116	2258	3.5
CN4838300000000	48	383	Reagan County, TX	2005	NA	2183	2129	54	2.5
CN4838500000000	48	385	Real County, TX	2005	NA	1320	1254	66	5
CN4838700000000	48	387	Red River County, TX	2005	NA	6261	5875	386	6.2
CN4838900000000	48	389	Reeves County, TX	2005	NA	4230	3915	315	7.4
CN4839100000000	48	391	Refugio County, TX	2005	NA	3852	3661	191	5
CN4839300000000	48	393	Roberts County, TX	2005	NA	551	533	18	3.3
CN4839500000000	48	395	Robertson County, TX	2005	NA	7558	7182	376	5
CN4839700000000	48	397	Rockwall County, TX	2005	NA	32378	30852	1526	4.7
CN4839900000000	48	399	Runnels County, TX	2005	NA	4611	4373	238	5.2
CN4840100000000	48	401	Rusk County, TX	2005	NA	22712	21527	1185	5.2
CN4840300000000	48	403	Sabine County, TX	2005	NA	3444	3104	340	9.9
CN4840500000000	48	405	San Augustine County, TX	2005	NA	3599	3346	253	7
CN4840700000000	48	407	San Jacinto County, TX	2005	NA	10161	9531	630	6.2
CN4840900000000	48	409	San Patricio County, TX	2005	NA	29557	27529	2028	6.9
CN4841100000000	48	411	San Saba County, TX	2005	NA	2639	2508	131	5
CN4841300000000	48	413	Schleicher County, TX	2005	NA	1362	1308	54	4
CN4841500000000	48	415	Scurry County, TX	2005	NA	7095	6743	352	5
CN4841700000000	48	417	Shackelford County, TX	2005	NA	1933	1875	58	3
CN4841900000000	48	419	Shelby County, TX	2005	NA	11709	11022	687	5.9
CN4842100000000	48	421	Sherman County, TX	2005	NA	1388	1329	59	4.3
CN4842300000000	48	423	Smith County, TX	2005	NA	95360	90560	4800	5
CN4842500000000	48	425	Somervell County, TX	2005	NA	3686	3487	199	5.4
CN4842700000000	48	427	Starr County, TX	2005	NA	21176	18415	2761	13
CN4842900000000	48	429	Stephens County, TX	2005	NA	4299	4102	197	4.6
CN4843100000000	48	431	Sterling County, TX	2005	NA	937	911	26	2.8
CN4843300000000	48	433	Stonewall County, TX	2005	NA	822	793	29	3.5
CN4843500000000	48	435	Sutton County, TX	2005	NA	2695	2619	76	2.8
CN4843700000000	48	437	Swisher County, TX	2005	NA	3608	3438	170	4.7
CN4843900000000	48	439	Tarrant County, TX	2005	NA	843857	800439	43418	5.1
CN4844100000000	48	441	Taylor County, TX	2005	NA	65219	62551	2668	4.1
CN4844300000000	48	443	Terrell County, TX	2005	NA	383	356	27	7
CN4844500000000	48	445	Terry County, TX	2005	NA	5756	5431	325	5.6
CN4844700000000	48	447	Throckmorton County, TX	2005	NA	931	899	32	3.4
CN4844900000000	48	449	Titus County, TX	2005	NA	14690	13997	693	4.7
CN4845100000000	48	451	Tom Green County, TX	2005	NA	51839	49600	2239	4.3
CN4845300000000	48	453	Travis County, TX	2005	NA	502123	479587	22536	4.5
CN4845500000000	48	455	Trinity County, TX	2005	NA	5803	5436	367	6.3
CN4845700000000	48	457	Tyler County, TX	2005	NA	8360	7747	613	7.3
CN4845900000000	48	459	Upshur County, TX	2005	NA	18761	17831	930	5
CN4846100000000	48	461	Upton County, TX	2005	NA	1678	1613	65	3.9
CN4846300000000	48	463	Uvalde County, TX	2005	NA	11690	10980	710	6.1
CN4846500000000	48	465	Val Verde County, TX	2005	NA	20042	18733	1309	6.5
CN4846700000000	48	467	Van Zandt County, TX	2005	NA	25337	24068	1269	5
CN4846900000000	48	469	Victoria County, TX	2005	NA	43899	41913	1986	4.5
CN4847100000000	48	471	Walker County, TX	2005	NA	26030	24571	1459	5.6
CN4847300000000	48	473	Waller County, TX	2005	NA	15833	14961	872	5.5
CN4847500000000	48	475	Ward County, TX	2005	NA	4464	4220	244	5.5
CN4847700000000	48	477	Washington County, TX	2005	NA	16168	15430	738	4.6
CN4847900000000	48	479	Webb County, TX	2005	NA	85624	80484	5140	6
CN4848100000000	48	481	Wharton County, TX	2005	NA	20740	19685	1055	5.1
CN4848300000000	48	483	Wheeler County, TX	2005	NA	2676	2571	105	3.9
CN4848500000000	48	485	Wichita County, TX	2005	NA	62488	59542	2946	4.7
CN4848700000000	48	487	Wilbarger County, TX	2005	NA	7518	7228	290	3.9
CN4848900000000	48	489	Willacy County, TX	2005	NA	7521	6807	714	9.5
CN4849100000000	48	491	Williamson County, TX	2005	NA	179531	171343	8188	4.6
CN4849300000000	48	493	Wilson County, TX	2005	NA	17687	16840	847	4.8
CN4849500000000	48	495	Winkler County, TX	2005	NA	3034	2890	144	4.7
CN4849700000000	48	497	Wise County, TX	2005	NA	27596	26298	1298	4.7
CN4849900000000	48	499	Wood County, TX	2005	NA	17600	16625	975	5.5
CN4850100000000	48	501	Yoakum County, TX	2005	NA	3285	3132	153	4.7
CN4850300000000	48	503	Young County, TX	2005	NA	9348	8952	396	4.2
CN4850500000000	48	505	Zapata County, TX	2005	NA	5061	4724	337	6.7
CN4850700000000	48	507	Zavala County, TX	2005	NA	3846	3401	445	11.6
CN4900100000000	49	001	Beaver County, UT	2005	NA	3071	2944	127	4.1
CN4900300000000	49	003	Box Elder County, UT	2005	NA	22413	21449	964	4.3
CN4900500000000	49	005	Cache County, UT	2005	NA	57222	55373	1849	3.2
CN4900700000000	49	007	Carbon County, UT	2005	NA	9541	9077	464	4.9
CN4900900000000	49	009	Daggett County, UT	2005	NA	503	477	26	5.2
CN4901100000000	49	011	Davis County, UT	2005	NA	135870	130515	5355	3.9
CN4901300000000	49	013	Duchesne County, UT	2005	NA	7690	7358	332	4.3
CN4901500000000	49	015	Emery County, UT	2005	NA	5125	4864	261	5.1
CN4901700000000	49	017	Garfield County, UT	2005	NA	2699	2506	193	7.2
CN4901900000000	49	019	Grand County, UT	2005	NA	5028	4712	316	6.3
CN4902100000000	49	021	Iron County, UT	2005	NA	19873	19101	772	3.9
CN4902300000000	49	023	Juab County, UT	2005	NA	3916	3729	187	4.8
CN4902500000000	49	025	Kane County, UT	2005	NA	3265	3105	160	4.9
CN4902700000000	49	027	Millard County, UT	2005	NA	6092	5847	245	4
CN4902900000000	49	029	Morgan County, UT	2005	NA	3818	3659	159	4.2
CN4903100000000	49	031	Piute County, UT	2005	NA	851	817	34	4
CN4903300000000	49	033	Rich County, UT	2005	NA	1290	1250	40	3.1
CN4903500000000	49	035	Salt Lake County, UT	2005	NA	517454	496679	20775	4
CN4903700000000	49	037	San Juan County, UT	2005	NA	4787	4410	377	7.9
CN4903900000000	49	039	Sanpete County, UT	2005	NA	10563	10003	560	5.3
CN4904100000000	49	041	Sevier County, UT	2005	NA	9149	8742	407	4.4
CN4904300000000	49	043	Summit County, UT	2005	NA	21457	20604	853	4
CN4904500000000	49	045	Tooele County, UT	2005	NA	25165	24068	1097	4.4
CN4904700000000	49	047	Uintah County, UT	2005	NA	14669	14121	548	3.7
CN4904900000000	49	049	Utah County, UT	2005	NA	205142	197112	8030	3.9
CN4905100000000	49	051	Wasatch County, UT	2005	NA	9309	8926	383	4.1
CN4905300000000	49	053	Washington County, UT	2005	NA	56944	54639	2305	4
CN4905500000000	49	055	Wayne County, UT	2005	NA	1337	1265	72	5.4
CN4905700000000	49	057	Weber County, UT	2005	NA	108209	103267	4942	4.6
CN5000100000000	50	001	Addison County, VT	2005	NA	21560	20856	704	3.3
CN5000300000000	50	003	Bennington County, VT	2005	NA	20089	19361	728	3.6
CN5000500000000	50	005	Caledonia County, VT	2005	NA	16451	15817	634	3.9
CN5000700000000	50	007	Chittenden County, VT	2005	NA	87236	84544	2692	3.1
CN5000900000000	50	009	Essex County, VT	2005	NA	3222	3101	121	3.8
CN5001100000000	50	011	Franklin County, VT	2005	NA	25936	24955	981	3.8
CN5001300000000	50	013	Grand Isle County, VT	2005	NA	4248	4035	213	5
CN5001500000000	50	015	Lamoille County, VT	2005	NA	14587	14019	568	3.9
CN5001700000000	50	017	Orange County, VT	2005	NA	16158	15634	524	3.2
CN5001900000000	50	019	Orleans County, VT	2005	NA	14087	13374	713	5.1
CN5002100000000	50	021	Rutland County, VT	2005	NA	35775	34466	1309	3.7
CN5002300000000	50	023	Washington County, VT	2005	NA	34179	32960	1219	3.6
CN5002500000000	50	025	Windham County, VT	2005	NA	24992	24153	839	3.4
CN5002700000000	50	027	Windsor County, VT	2005	NA	32241	31280	961	3
CN5100100000000	51	001	Accomack County, VA	2005	NA	18785	17901	884	4.7
CN5100300000000	51	003	Albemarle County, VA	2005	NA	47414	46060	1354	2.9
CN5100500000000	51	005	Alleghany County, VA	2005	NA	7466	7112	354	4.7
CN5100700000000	51	007	Amelia County, VA	2005	NA	6317	6098	219	3.5
CN5100900000000	51	009	Amherst County, VA	2005	NA	15320	14685	635	4.1
CN5101100000000	51	011	Appomattox County, VA	2005	NA	6824	6500	324	4.7
CN5101300000000	51	013	Arlington County, VA	2005	NA	123328	120442	2886	2.3
CN5101500000000	51	015	Augusta County, VA	2005	NA	36267	35148	1119	3.1
CN5101700000000	51	017	Bath County, VA	2005	NA	2927	2822	105	3.6
CN5101900000000	51	019	Bedford County, VA	2005	NA	36472	35191	1281	3.5
CN5102100000000	51	021	Bland County, VA	2005	NA	3060	2937	123	4
CN5102300000000	51	023	Botetourt County, VA	2005	NA	17017	16499	518	3
CN5102500000000	51	025	Brunswick County, VA	2005	NA	6761	6410	351	5.2
CN5102700000000	51	027	Buchanan County, VA	2005	NA	8401	7947	454	5.4
CN5102900000000	51	029	Buckingham County, VA	2005	NA	6783	6486	297	4.4
CN5103100000000	51	031	Campbell County, VA	2005	NA	26677	25613	1064	4
CN5103300000000	51	033	Caroline County, VA	2005	NA	12862	12369	493	3.8
CN5103500000000	51	035	Carroll County, VA	2005	NA	14383	13570	813	5.7
CN5103600000000	51	036	Charles City County, VA	2005	NA	3757	3592	165	4.4
CN5103700000000	51	037	Charlotte County, VA	2005	NA	5424	4976	448	8.3
CN5104100000000	51	041	Chesterfield County, VA	2005	NA	158613	153561	5052	3.2
CN5104300000000	51	043	Clarke County, VA	2005	NA	7738	7537	201	2.6
CN5104500000000	51	045	Craig County, VA	2005	NA	2500	2402	98	3.9
CN5104700000000	51	047	Culpeper County, VA	2005	NA	19022	18391	631	3.3
CN5104900000000	51	049	Cumberland County, VA	2005	NA	4452	4277	175	3.9
CN5105100000000	51	051	Dickenson County, VA	2005	NA	5720	5350	370	6.5
CN5105300000000	51	053	Dinwiddie County, VA	2005	NA	12594	12072	522	4.1
CN5105700000000	51	057	Essex County, VA	2005	NA	5388	5135	253	4.7
CN5105900000000	51	059	Fairfax County, VA	2005	NA	568187	553530	14657	2.6
CN5106100000000	51	061	Fauquier County, VA	2005	NA	35413	34463	950	2.7
CN5106300000000	51	063	Floyd County, VA	2005	NA	7094	6830	264	3.7
CN5106500000000	51	065	Fluvanna County, VA	2005	NA	12793	12400	393	3.1
CN5106700000000	51	067	Franklin County, VA	2005	NA	25337	24409	928	3.7
CN5106900000000	51	069	Frederick County, VA	2005	NA	38283	37198	1085	2.8
CN5107100000000	51	071	Giles County, VA	2005	NA	8352	7921	431	5.2
CN5107300000000	51	073	Gloucester County, VA	2005	NA	19798	19183	615	3.1
CN5107500000000	51	075	Goochland County, VA	2005	NA	10343	10032	311	3
CN5107700000000	51	077	Grayson County, VA	2005	NA	7401	7052	349	4.7
CN5107900000000	51	079	Greene County, VA	2005	NA	9658	9374	284	2.9
CN5108100000000	51	081	Greensville County, VA	2005	NA	3931	3718	213	5.4
CN5108300000000	51	083	Halifax County, VA	2005	NA	15792	14818	974	6.2
CN5108500000000	51	085	Hanover County, VA	2005	NA	53511	51917	1594	3
CN5108700000000	51	087	Henrico County, VA	2005	NA	156494	151154	5340	3.4
CN5108900000000	51	089	Henry County, VA	2005	NA	25472	23772	1700	6.7
CN5109100000000	51	091	Highland County, VA	2005	NA	1184	1142	42	3.5
CN5109300000000	51	093	Isle of Wight County, VA	2005	NA	17369	16725	644	3.7
CN5109500000000	51	095	James City County, VA	2005	NA	28790	27878	912	3.2
CN5109700000000	51	097	King and Queen County, VA	2005	NA	3263	3134	129	4
CN5109900000000	51	099	King George County, VA	2005	NA	9461	9140	321	3.4
CN5110100000000	51	101	King William County, VA	2005	NA	7911	7633	278	3.5
CN5110300000000	51	103	Lancaster County, VA	2005	NA	5210	4915	295	5.7
CN5110500000000	51	105	Lee County, VA	2005	NA	9229	8762	467	5.1
CN5110700000000	51	107	Loudoun County, VA	2005	NA	147280	143676	3604	2.4
CN5110900000000	51	109	Louisa County, VA	2005	NA	15101	14548	553	3.7
CN5111100000000	51	111	Lunenburg County, VA	2005	NA	5577	5281	296	5.3
CN5111300000000	51	113	Madison County, VA	2005	NA	7172	6949	223	3.1
CN5111500000000	51	115	Mathews County, VA	2005	NA	4396	4263	133	3
CN5111700000000	51	117	Mecklenburg County, VA	2005	NA	13193	12376	817	6.2
CN5111900000000	51	119	Middlesex County, VA	2005	NA	5031	4852	179	3.6
CN5112100000000	51	121	Montgomery County, VA	2005	NA	43120	41566	1554	3.6
CN5112500000000	51	125	Nelson County, VA	2005	NA	7424	7182	242	3.3
CN5112700000000	51	127	New Kent County, VA	2005	NA	8789	8503	286	3.3
CN5113100000000	51	131	Northampton County, VA	2005	NA	5914	5608	306	5.2
CN5113300000000	51	133	Northumberland County, VA	2005	NA	6037	5743	294	4.9
CN5113500000000	51	135	Nottoway County, VA	2005	NA	6345	6053	292	4.6
CN5113700000000	51	137	Orange County, VA	2005	NA	14651	14179	472	3.2
CN5113900000000	51	139	Page County, VA	2005	NA	11433	10843	590	5.2
CN5114100000000	51	141	Patrick County, VA	2005	NA	8779	8195	584	6.7
CN5114300000000	51	143	Pittsylvania County, VA	2005	NA	31788	29753	2035	6.4
CN5114500000000	51	145	Powhatan County, VA	2005	NA	13506	13118	388	2.9
CN5114700000000	51	147	Prince Edward County, VA	2005	NA	8532	8041	491	5.8
CN5114900000000	51	149	Prince George County, VA	2005	NA	15026	14442	584	3.9
CN5115300000000	51	153	Prince William County, VA	2005	NA	189649	184445	5204	2.7
CN5115500000000	51	155	Pulaski County, VA	2005	NA	17995	17179	816	4.5
CN5115700000000	51	157	Rappahannock County, VA	2005	NA	4112	4004	108	2.6
CN5115900000000	51	159	Richmond County, VA	2005	NA	3482	3317	165	4.7
CN5116100000000	51	161	Roanoke County, VA	2005	NA	46636	45233	1403	3
CN5116300000000	51	163	Rockbridge County, VA	2005	NA	11233	10881	352	3.1
CN5116500000000	51	165	Rockingham County, VA	2005	NA	40244	39032	1212	3
CN5116700000000	51	167	Russell County, VA	2005	NA	11955	11265	690	5.8
CN5116900000000	51	169	Scott County, VA	2005	NA	9769	9255	514	5.3
CN5117100000000	51	171	Shenandoah County, VA	2005	NA	19521	18920	601	3.1
CN5117300000000	51	173	Smyth County, VA	2005	NA	15589	14862	727	4.7
CN5117500000000	51	175	Southampton County, VA	2005	NA	7523	7207	316	4.2
CN5117700000000	51	177	Spotsylvania County, VA	2005	NA	61880	60198	1682	2.7
CN5117900000000	51	179	Stafford County, VA	2005	NA	61558	59870	1688	2.7
CN5118100000000	51	181	Surry County, VA	2005	NA	3638	3462	176	4.8
CN5118300000000	51	183	Sussex County, VA	2005	NA	4408	4148	260	5.9
CN5118500000000	51	185	Tazewell County, VA	2005	NA	19489	18598	891	4.6
CN5118700000000	51	187	Warren County, VA	2005	NA	18604	18034	570	3.1
CN5119100000000	51	191	Washington County, VA	2005	NA	25934	24759	1175	4.5
CN5119300000000	51	193	Westmoreland County, VA	2005	NA	8114	7742	372	4.6
CN5119500000000	51	195	Wise County, VA	2005	NA	17238	16413	825	4.8
CN5119700000000	51	197	Wythe County, VA	2005	NA	14965	14312	653	4.4
CN5119900000000	51	199	York County, VA	2005	NA	30554	29620	934	3.1
CN5151000000000	51	510	Alexandria city, VA	2005	NA	84746	82535	2211	2.6
CN5152000000000	51	520	Bristol city, VA	2005	NA	7737	7312	425	5.5
CN5153000000000	51	530	Buena Vista city, VA	2005	NA	3392	3263	129	3.8
CN5154000000000	51	540	Charlottesville city, VA	2005	NA	19797	19039	758	3.8
CN5155000000000	51	550	Chesapeake city, VA	2005	NA	111678	107638	4040	3.6
CN5157000000000	51	570	Colonial Heights city, VA	2005	NA	9059	8684	375	4.1
CN5158000000000	51	580	Covington city, VA	2005	NA	2837	2674	163	5.7
CN5159000000000	51	590	Danville city, VA	2005	NA	20921	18793	2128	10.2
CN5159500000000	51	595	Emporia city, VA	2005	NA	2433	2293	140	5.8
CN5160000000000	51	600	Fairfax city, VA	2005	NA	12777	12434	343	2.7
CN5161000000000	51	610	Falls Church city, VA	2005	NA	6428	6210	218	3.4
CN5162000000000	51	620	Franklin city, VA	2005	NA	3725	3531	194	5.2
CN5163000000000	51	630	Fredericksburg city, VA	2005	NA	11225	10722	503	4.5
CN5164000000000	51	640	Galax city, VA	2005	NA	3110	2950	160	5.1
CN5165000000000	51	650	Hampton city, VA	2005	NA	66763	63746	3017	4.5
CN5166000000000	51	660	Harrisonburg city, VA	2005	NA	20953	20146	807	3.9
CN5167000000000	51	670	Hopewell city, VA	2005	NA	10276	9683	593	5.8
CN5167800000000	51	678	Lexington city, VA	2005	NA	2316	2195	121	5.2
CN5168000000000	51	680	Lynchburg city, VA	2005	NA	31249	29817	1432	4.6
CN5168300000000	51	683	Manassas city, VA	2005	NA	20522	19929	593	2.9
CN5168500000000	51	685	Manassas Park city, VA	2005	NA	6519	6354	165	2.5
CN5169000000000	51	690	Martinsville city, VA	2005	NA	5947	5345	602	10.1
CN5170000000000	51	700	Newport News city, VA	2005	NA	86290	82389	3901	4.5
CN5171000000000	51	710	Norfolk city, VA	2005	NA	96113	91215	4898	5.1
CN5172000000000	51	720	Norton city, VA	2005	NA	1524	1439	85	5.6
CN5173000000000	51	730	Petersburg city, VA	2005	NA	13965	12930	1035	7.4
CN5173500000000	51	735	Poquoson city, VA	2005	NA	6161	5983	178	2.9
CN5174000000000	51	740	Portsmouth city, VA	2005	NA	44821	42403	2418	5.4
CN5175000000000	51	750	Radford city, VA	2005	NA	7228	6899	329	4.6
CN5176000000000	51	760	Richmond city, VA	2005	NA	95504	90382	5122	5.4
CN5177000000000	51	770	Roanoke city, VA	2005	NA	45225	43312	1913	4.2
CN5177500000000	51	775	Salem city, VA	2005	NA	12722	12314	408	3.2
CN5179000000000	51	790	Staunton city, VA	2005	NA	11231	10864	367	3.3
CN5180000000000	51	800	Suffolk city, VA	2005	NA	37792	36284	1508	4
CN5181000000000	51	810	Virginia Beach city, VA	2005	NA	220002	212602	7400	3.4
CN5182000000000	51	820	Waynesboro city, VA	2005	NA	9827	9450	377	3.8
CN5183000000000	51	830	Williamsburg city, VA	2005	NA	4773	4426	347	7.3
CN5184000000000	51	840	Winchester city, VA	2005	NA	13740	13311	429	3.1
CN5300100000000	53	001	Adams County, WA	2005	NA	8176	7596	580	7.1
CN5300300000000	53	003	Asotin County, WA	2005	NA	10517	9858	659	6.3
CN5300500000000	53	005	Benton County, WA	2005	NA	85027	79916	5111	6
CN5300700000000	53	007	Chelan County, WA	2005	NA	39450	37014	2436	6.2
CN5300900000000	53	009	Clallam County, WA	2005	NA	29526	27521	2005	6.8
CN5301100000000	53	011	Clark County, WA	2005	NA	202656	189108	13548	6.7
CN5301300000000	53	013	Columbia County, WA	2005	NA	1636	1503	133	8.1
CN5301500000000	53	015	Cowlitz County, WA	2005	NA	42978	39717	3261	7.6
CN5301700000000	53	017	Douglas County, WA	2005	NA	19966	18824	1142	5.7
CN5301900000000	53	019	Ferry County, WA	2005	NA	3009	2721	288	9.6
CN5302100000000	53	021	Franklin County, WA	2005	NA	29279	27118	2161	7.4
CN5302300000000	53	023	Garfield County, WA	2005	NA	1081	1019	62	5.7
CN5302500000000	53	025	Grant County, WA	2005	NA	38364	35447	2917	7.6
CN5302700000000	53	027	Grays Harbor County, WA	2005	NA	31229	28761	2468	7.9
CN5302900000000	53	029	Island County, WA	2005	NA	31726	29751	1975	6.2
CN5303100000000	53	031	Jefferson County, WA	2005	NA	13598	12798	800	5.9
CN5303300000000	53	033	King County, WA	2005	NA	1011681	967430	44251	4.4
CN5303500000000	53	035	Kitsap County, WA	2005	NA	120999	114535	6464	5.3
CN5303700000000	53	037	Kittitas County, WA	2005	NA	19119	17929	1190	6.2
CN5303900000000	53	039	Klickitat County, WA	2005	NA	9373	8607	766	8.2
CN5304100000000	53	041	Lewis County, WA	2005	NA	30631	28174	2457	8
CN5304300000000	53	043	Lincoln County, WA	2005	NA	4725	4425	300	6.3
CN5304500000000	53	045	Mason County, WA	2005	NA	24024	22395	1629	6.8
CN5304700000000	53	047	Okanogan County, WA	2005	NA	20706	19169	1537	7.4
CN5304900000000	53	049	Pacific County, WA	2005	NA	9095	8420	675	7.4
CN5305100000000	53	051	Pend Oreille County, WA	2005	NA	5067	4640	427	8.4
CN5305300000000	53	053	Pierce County, WA	2005	NA	369155	346469	22686	6.1
CN5305500000000	53	055	San Juan County, WA	2005	NA	8223	7845	378	4.6
CN5305700000000	53	057	Skagit County, WA	2005	NA	56282	52784	3498	6.2
CN5305900000000	53	059	Skamania County, WA	2005	NA	5033	4633	400	7.9
CN5306100000000	53	061	Snohomish County, WA	2005	NA	346207	329649	16558	4.8
CN5306300000000	53	063	Spokane County, WA	2005	NA	224140	210833	13307	5.9
CN5306500000000	53	065	Stevens County, WA	2005	NA	18006	16564	1442	8
CN5306700000000	53	067	Thurston County, WA	2005	NA	121951	115486	6465	5.3
CN5306900000000	53	069	Wahkiakum County, WA	2005	NA	1630	1505	125	7.7
CN5307100000000	53	071	Walla Walla County, WA	2005	NA	28983	27229	1754	6.1
CN5307300000000	53	073	Whatcom County, WA	2005	NA	102524	97125	5399	5.3
CN5307500000000	53	075	Whitman County, WA	2005	NA	20371	19453	918	4.5
CN5307700000000	53	077	Yakima County, WA	2005	NA	117560	108427	9133	7.8
CN5400100000000	54	001	Barbour County, WV	2005	NA	6549	6146	403	6.2
CN5400300000000	54	003	Berkeley County, WV	2005	NA	43568	41847	1721	4
CN5400500000000	54	005	Boone County, WV	2005	NA	9294	8865	429	4.6
CN5400700000000	54	007	Braxton County, WV	2005	NA	5863	5512	351	6
CN5400900000000	54	009	Brooke County, WV	2005	NA	11095	10286	809	7.3
CN5401100000000	54	011	Cabell County, WV	2005	NA	44041	42054	1987	4.5
CN5401300000000	54	013	Calhoun County, WV	2005	NA	2675	2445	230	8.6
CN5401500000000	54	015	Clay County, WV	2005	NA	3484	3213	271	7.8
CN5401700000000	54	017	Doddridge County, WV	2005	NA	2858	2720	138	4.8
CN5401900000000	54	019	Fayette County, WV	2005	NA	17747	16717	1030	5.8
CN5402100000000	54	021	Gilmer County, WV	2005	NA	3048	2906	142	4.7
CN5402300000000	54	023	Grant County, WV	2005	NA	4935	4624	311	6.3
CN5402500000000	54	025	Greenbrier County, WV	2005	NA	15042	14121	921	6.1
CN5402700000000	54	027	Hampshire County, WV	2005	NA	9403	9013	390	4.1
CN5402900000000	54	029	Hancock County, WV	2005	NA	14695	13604	1091	7.4
CN5403100000000	54	031	Hardy County, WV	2005	NA	6982	6715	267	3.8
CN5403300000000	54	033	Harrison County, WV	2005	NA	30438	28999	1439	4.7
CN5403500000000	54	035	Jackson County, WV	2005	NA	11587	10902	685	5.9
CN5403700000000	54	037	Jefferson County, WV	2005	NA	24044	23247	797	3.3
CN5403900000000	54	039	Kanawha County, WV	2005	NA	90679	86270	4409	4.9
CN5404100000000	54	041	Lewis County, WV	2005	NA	7238	6876	362	5
CN5404300000000	54	043	Lincoln County, WV	2005	NA	7837	7334	503	6.4
CN5404500000000	54	045	Logan County, WV	2005	NA	12708	12082	626	4.9
CN5404700000000	54	047	McDowell County, WV	2005	NA	6384	5856	528	8.3
CN5404900000000	54	049	Marion County, WV	2005	NA	25772	24595	1177	4.6
CN5405100000000	54	051	Marshall County, WV	2005	NA	15048	14174	874	5.8
CN5405300000000	54	053	Mason County, WV	2005	NA	10096	9305	791	7.8
CN5405500000000	54	055	Mercer County, WV	2005	NA	23764	22563	1201	5.1
CN5405700000000	54	057	Mineral County, WV	2005	NA	13385	12670	715	5.3
CN5405900000000	54	059	Mingo County, WV	2005	NA	8134	7663	471	5.8
CN5406100000000	54	061	Monongalia County, WV	2005	NA	44216	42591	1625	3.7
CN5406300000000	54	063	Monroe County, WV	2005	NA	5720	5453	267	4.7
CN5406500000000	54	065	Morgan County, WV	2005	NA	7029	6703	326	4.6
CN5406700000000	54	067	Nicholas County, WV	2005	NA	10397	9823	574	5.5
CN5406900000000	54	069	Ohio County, WV	2005	NA	20967	19946	1021	4.9
CN5407100000000	54	071	Pendleton County, WV	2005	NA	3664	3524	140	3.8
CN5407300000000	54	073	Pleasants County, WV	2005	NA	3189	2988	201	6.3
CN5407500000000	54	075	Pocahontas County, WV	2005	NA	3750	3510	240	6.4
CN5407700000000	54	077	Preston County, WV	2005	NA	14293	13610	683	4.8
CN5407900000000	54	079	Putnam County, WV	2005	NA	26468	25260	1208	4.6
CN5408100000000	54	081	Raleigh County, WV	2005	NA	32166	30644	1522	4.7
CN5408300000000	54	083	Randolph County, WV	2005	NA	12839	12167	672	5.2
CN5408500000000	54	085	Ritchie County, WV	2005	NA	4591	4323	268	5.8
CN5408700000000	54	087	Roane County, WV	2005	NA	5413	5012	401	7.4
CN5408900000000	54	089	Summers County, WV	2005	NA	4683	4389	294	6.3
CN5409100000000	54	091	Taylor County, WV	2005	NA	6931	6571	360	5.2
CN5409300000000	54	093	Tucker County, WV	2005	NA	3026	2836	190	6.3
CN5409500000000	54	095	Tyler County, WV	2005	NA	3595	3333	262	7.3
CN5409700000000	54	097	Upshur County, WV	2005	NA	10649	10131	518	4.9
CN5409900000000	54	099	Wayne County, WV	2005	NA	17577	16659	918	5.2
CN5410100000000	54	101	Webster County, WV	2005	NA	3291	3099	192	5.8
CN5410300000000	54	103	Wetzel County, WV	2005	NA	6540	5925	615	9.4
CN5410500000000	54	105	Wirt County, WV	2005	NA	2505	2319	186	7.4
CN5410700000000	54	107	Wood County, WV	2005	NA	40944	38707	2237	5.5
CN5410900000000	54	109	Wyoming County, WV	2005	NA	8154	7718	436	5.3
CN5500100000000	55	001	Adams County, WI	2005	NA	9678	9007	671	6.9
CN5500300000000	55	003	Ashland County, WI	2005	NA	9256	8713	543	5.9
CN5500500000000	55	005	Barron County, WI	2005	NA	25439	24113	1326	5.2
CN5500700000000	55	007	Bayfield County, WI	2005	NA	8202	7705	497	6.1
CN5500900000000	55	009	Brown County, WI	2005	NA	135667	129576	6091	4.5
CN5501100000000	55	011	Buffalo County, WI	2005	NA	8302	7967	335	4
CN5501300000000	55	013	Burnett County, WI	2005	NA	8405	7935	470	5.6
CN5501500000000	55	015	Calumet County, WI	2005	NA	25092	24067	1025	4.1
CN5501700000000	55	017	Chippewa County, WI	2005	NA	32640	30885	1755	5.4
CN5501900000000	55	019	Clark County, WI	2005	NA	17621	16650	971	5.5
CN5502100000000	55	021	Columbia County, WI	2005	NA	31579	30182	1397	4.4
CN5502300000000	55	023	Crawford County, WI	2005	NA	9554	9090	464	4.9
CN5502500000000	55	025	Dane County, WI	2005	NA	285593	276653	8940	3.1
CN5502700000000	55	027	Dodge County, WI	2005	NA	46581	44305	2276	4.9
CN5502900000000	55	029	Door County, WI	2005	NA	16653	15734	919	5.5
CN5503100000000	55	031	Douglas County, WI	2005	NA	22685	21488	1197	5.3
CN5503300000000	55	033	Dunn County, WI	2005	NA	24127	23073	1054	4.4
CN5503500000000	55	035	Eau Claire County, WI	2005	NA	53764	51576	2188	4.1
CN5503700000000	55	037	Florence County, WI	2005	NA	2558	2384	174	6.8
CN5503900000000	55	039	Fond du Lac County, WI	2005	NA	55868	53301	2567	4.6
CN5504100000000	55	041	Forest County, WI	2005	NA	4949	4606	343	6.9
CN5504300000000	55	043	Grant County, WI	2005	NA	26884	25715	1169	4.3
CN5504500000000	55	045	Green County, WI	2005	NA	20008	19125	883	4.4
CN5504700000000	55	047	Green Lake County, WI	2005	NA	10280	9682	598	5.8
CN5504900000000	55	049	Iowa County, WI	2005	NA	14262	13666	596	4.2
CN5505100000000	55	051	Iron County, WI	2005	NA	3188	2923	265	8.3
CN5505300000000	55	053	Jackson County, WI	2005	NA	9816	9256	560	5.7
CN5505500000000	55	055	Jefferson County, WI	2005	NA	42581	40661	1920	4.5
CN5505700000000	55	057	Juneau County, WI	2005	NA	13312	12508	804	6
CN5505900000000	55	059	Kenosha County, WI	2005	NA	82362	77709	4653	5.6
CN5506100000000	55	061	Kewaunee County, WI	2005	NA	11800	11271	529	4.5
CN5506300000000	55	063	La Crosse County, WI	2005	NA	61433	58976	2457	4
CN5506500000000	55	065	Lafayette County, WI	2005	NA	8949	8584	365	4.1
CN5506700000000	55	067	Langlade County, WI	2005	NA	10668	10034	634	5.9
CN5506900000000	55	069	Lincoln County, WI	2005	NA	15824	14965	859	5.4
CN5507100000000	55	071	Manitowoc County, WI	2005	NA	45215	42998	2217	4.9
CN5507300000000	55	073	Marathon County, WI	2005	NA	74364	71307	3057	4.1
CN5507500000000	55	075	Marinette County, WI	2005	NA	22349	21000	1349	6
CN5507700000000	55	077	Marquette County, WI	2005	NA	7849	7369	480	6.1
CN5507800000000	55	078	Menominee County, WI	2005	NA	1643	1479	164	10
CN5507900000000	55	079	Milwaukee County, WI	2005	NA	451298	425389	25909	5.7
CN5508100000000	55	081	Monroe County, WI	2005	NA	23331	22380	951	4.1
CN5508300000000	55	083	Oconto County, WI	2005	NA	20223	19064	1159	5.7
CN5508500000000	55	085	Oneida County, WI	2005	NA	20231	19062	1169	5.8
CN5508700000000	55	087	Outagamie County, WI	2005	NA	94857	90578	4279	4.5
CN5508900000000	55	089	Ozaukee County, WI	2005	NA	47669	45907	1762	3.7
CN5509100000000	55	091	Pepin County, WI	2005	NA	3965	3760	205	5.2
CN5509300000000	55	093	Pierce County, WI	2005	NA	23337	22384	953	4.1
CN5509500000000	55	095	Polk County, WI	2005	NA	23865	22634	1231	5.2
CN5509700000000	55	097	Portage County, WI	2005	NA	39832	38004	1828	4.6
CN5509900000000	55	099	Price County, WI	2005	NA	8623	8202	421	4.9
CN5510100000000	55	101	Racine County, WI	2005	NA	98509	92687	5822	5.9
CN5510300000000	55	103	Richland County, WI	2005	NA	9835	9411	424	4.3
CN5510500000000	55	105	Rock County, WI	2005	NA	83193	78337	4856	5.8
CN5510700000000	55	107	Rusk County, WI	2005	NA	7992	7493	499	6.2
CN5510900000000	55	109	St. Croix County, WI	2005	NA	44624	42583	2041	4.6
CN5511100000000	55	111	Sauk County, WI	2005	NA	34203	32692	1511	4.4
CN5511300000000	55	113	Sawyer County, WI	2005	NA	9348	8793	555	5.9
CN5511500000000	55	115	Shawano County, WI	2005	NA	22408	21315	1093	4.9
CN5511700000000	55	117	Sheboygan County, WI	2005	NA	64550	61993	2557	4
CN5511900000000	55	119	Taylor County, WI	2005	NA	11100	10493	607	5.5
CN5512100000000	55	121	Trempealeau County, WI	2005	NA	15752	15063	689	4.4
CN5512300000000	55	123	Vernon County, WI	2005	NA	14237	13592	645	4.5
CN5512500000000	55	125	Vilas County, WI	2005	NA	11766	11065	701	6
CN5512700000000	55	127	Walworth County, WI	2005	NA	55870	53533	2337	4.2
CN5512900000000	55	129	Washburn County, WI	2005	NA	8289	7783	506	6.1
CN5513100000000	55	131	Washington County, WI	2005	NA	71985	68990	2995	4.2
CN5513300000000	55	133	Waukesha County, WI	2005	NA	211868	203760	8108	3.8
CN5513500000000	55	135	Waupaca County, WI	2005	NA	28000	26521	1479	5.3
CN5513700000000	55	137	Waushara County, WI	2005	NA	12598	11903	695	5.5
CN5513900000000	55	139	Winnebago County, WI	2005	NA	91185	87160	4025	4.4
CN5514100000000	55	141	Wood County, WI	2005	NA	39548	37319	2229	5.6
CN5600100000000	56	001	Albany County, WY	2005	NA	19369	18835	534	2.8
CN5600300000000	56	003	Big Horn County, WY	2005	NA	5299	5060	239	4.5
CN5600500000000	56	005	Campbell County, WY	2005	NA	23193	22592	601	2.6
CN5600700000000	56	007	Carbon County, WY	2005	NA	7612	7316	296	3.9
CN5600900000000	56	009	Converse County, WY	2005	NA	6674	6428	246	3.7
CN5601100000000	56	011	Crook County, WY	2005	NA	3253	3141	112	3.4
CN5601300000000	56	013	Fremont County, WY	2005	NA	17707	16875	832	4.7
CN5601500000000	56	015	Goshen County, WY	2005	NA	5678	5428	250	4.4
CN5601700000000	56	017	Hot Springs County, WY	2005	NA	2312	2220	92	4
CN5601900000000	56	019	Johnson County, WY	2005	NA	3783	3641	142	3.8
CN5602100000000	56	021	Laramie County, WY	2005	NA	41359	39658	1701	4.1
CN5602300000000	56	023	Lincoln County, WY	2005	NA	7807	7491	316	4
CN5602500000000	56	025	Natrona County, WY	2005	NA	39124	37778	1346	3.4
CN5602700000000	56	027	Niobrara County, WY	2005	NA	1116	1073	43	3.9
CN5602900000000	56	029	Park County, WY	2005	NA	14379	13808	571	4
CN5603100000000	56	031	Platte County, WY	2005	NA	4012	3819	193	4.8
CN5603300000000	56	033	Sheridan County, WY	2005	NA	15048	14481	567	3.8
CN5603500000000	56	035	Sublette County, WY	2005	NA	4975	4873	102	2.1
CN5603700000000	56	037	Sweetwater County, WY	2005	NA	22002	21360	642	2.9
CN5603900000000	56	039	Teton County, WY	2005	NA	13756	13344	412	3
CN5604100000000	56	041	Uinta County, WY	2005	NA	10646	10285	361	3.4
CN5604300000000	56	043	Washakie County, WY	2005	NA	4260	4086	174	4.1
CN5604500000000	56	045	Weston County, WY	2005	NA	3165	3039	126	4
CN7200100000000	72	001	Adjuntas Municipio, PR	2005	NA	5931	5109	822	13.9
CN7200300000000	72	003	Aguada Municipio, PR	2005	NA	16068	13871	2197	13.7
CN7200500000000	72	005	Aguadilla Municipio, PR	2005	NA	22468	19428	3040	13.5
CN7200700000000	72	007	Aguas Buenas Municipio, PR	2005	NA	9515	8370	1145	12
CN7200900000000	72	009	Aibonito Municipio, PR	2005	NA	8136	6916	1220	15
CN7201100000000	72	011	Anasco Municipio, PR	2005	NA	11122	9531	1591	14.3
CN7201300000000	72	013	Arecibo Municipio, PR	2005	NA	33919	29678	4241	12.5
CN7201500000000	72	015	Arroyo Municipio, PR	2005	NA	5626	4665	961	17.1
CN7201700000000	72	017	Barceloneta Municipio, PR	2005	NA	7387	6291	1096	14.8
CN7201900000000	72	019	Barranquitas Municipio, PR	2005	NA	7780	6792	988	12.7
CN7202100000000	72	021	Bayamon Municipio, PR	2005	NA	84035	76923	7112	8.5
CN7202300000000	72	023	Cabo Rojo Municipio, PR	2005	NA	20670	18602	2068	10
CN7202500000000	72	025	Caguas Municipio, PR	2005	NA	54820	48864	5956	10.9
CN7202700000000	72	027	Camuy Municipio, PR	2005	NA	12840	11406	1434	11.2
CN7202900000000	72	029	Canovanas Municipio, PR	2005	NA	14496	12542	1954	13.5
CN7203100000000	72	031	Carolina Municipio, PR	2005	NA	78568	71720	6848	8.7
CN7203300000000	72	033	Catano Municipio, PR	2005	NA	8251	7342	909	11
CN7203500000000	72	035	Cayey Municipio, PR	2005	NA	16066	13952	2114	13.2
CN7203700000000	72	037	Ceiba Municipio, PR	2005	NA	6050	5274	776	12.8
CN7203900000000	72	039	Ciales Municipio, PR	2005	NA	5285	4397	888	16.8
CN7204100000000	72	041	Cidra Municipio, PR	2005	NA	15472	13607	1865	12.1
CN7204300000000	72	043	Coamo Municipio, PR	2005	NA	11622	9831	1791	15.4
CN7204500000000	72	045	Comerio Municipio, PR	2005	NA	4919	4188	731	14.9
CN7204700000000	72	047	Corozal Municipio, PR	2005	NA	10760	9335	1425	13.2
CN7204900000000	72	049	Culebra Municipio, PR	2005	NA	873	801	72	8.2
CN7205100000000	72	051	Dorado Municipio, PR	2005	NA	12707	11590	1117	8.8
CN7205300000000	72	053	Fajardo Municipio, PR	2005	NA	15344	13225	2119	13.8
CN7205400000000	72	054	Florida Municipio, PR	2005	NA	4154	3519	635	15.3
CN7205500000000	72	055	Guanica Municipio, PR	2005	NA	6646	5499	1147	17.3
CN7205700000000	72	057	Guayama Municipio, PR	2005	NA	14450	12299	2151	14.9
CN7205900000000	72	059	Guayanilla Municipio, PR	2005	NA	7046	5905	1141	16.2
CN7206100000000	72	061	Guaynabo Municipio, PR	2005	NA	45025	42105	2920	6.5
CN7206300000000	72	063	Gurabo Municipio, PR	2005	NA	15337	13673	1664	10.8
CN7206500000000	72	065	Hatillo Municipio, PR	2005	NA	12892	11270	1622	12.6
CN7206700000000	72	067	Hormigueros Municipio, PR	2005	NA	6615	5824	791	12
CN7206900000000	72	069	Humacao Municipio, PR	2005	NA	21247	18016	3231	15.2
CN7207100000000	72	071	Isabela Municipio, PR	2005	NA	15925	13860	2065	13
CN7207300000000	72	073	Jayuya Municipio, PR	2005	NA	4656	3908	748	16.1
CN7207500000000	72	075	Juana Diaz Municipio, PR	2005	NA	17420	15322	2098	12
CN7207700000000	72	077	Juncos Municipio, PR	2005	NA	13054	11396	1658	12.7
CN7207900000000	72	079	Lajas Municipio, PR	2005	NA	9014	7863	1151	12.8
CN7208100000000	72	081	Lares Municipio, PR	2005	NA	11873	10382	1491	12.6
CN7208300000000	72	083	Las Marias Municipio, PR	2005	NA	3935	3384	551	14
CN7208500000000	72	085	Las Piedras Municipio, PR	2005	NA	12859	11040	1819	14.1
CN7208700000000	72	087	Loiza Municipio, PR	2005	NA	8949	7691	1258	14.1
CN7208900000000	72	089	Luquillo Municipio, PR	2005	NA	7294	6138	1156	15.8
CN7209100000000	72	091	Manati Municipio, PR	2005	NA	14834	12753	2081	14
CN7209300000000	72	093	Maricao Municipio, PR	2005	NA	2107	1814	293	13.9
CN7209500000000	72	095	Maunabo Municipio, PR	2005	NA	3823	3039	784	20.5
CN7209700000000	72	097	Mayaguez Municipio, PR	2005	NA	30821	26590	4231	13.7
CN7209900000000	72	099	Moca Municipio, PR	2005	NA	15210	13310	1900	12.5
CN7210100000000	72	101	Morovis Municipio, PR	2005	NA	9292	7870	1422	15.3
CN7210300000000	72	103	Naguabo Municipio, PR	2005	NA	7621	6427	1194	15.7
CN7210500000000	72	105	Naranjito Municipio, PR	2005	NA	8710	7718	992	11.4
CN7210700000000	72	107	Orocovis Municipio, PR	2005	NA	5470	4660	810	14.8
CN7210900000000	72	109	Patillas Municipio, PR	2005	NA	6079	4984	1095	18
CN7211100000000	72	111	Penuelas Municipio, PR	2005	NA	8921	7631	1290	14.5
CN7211300000000	72	113	Ponce Municipio, PR	2005	NA	65927	58779	7148	10.8
CN7211500000000	72	115	Quebradillas Municipio, PR	2005	NA	8763	7626	1137	13
CN7211700000000	72	117	Rincon Municipio, PR	2005	NA	5712	4891	821	14.4
CN7211900000000	72	119	Rio Grande Municipio, PR	2005	NA	17988	15923	2065	11.5
CN7212100000000	72	121	Sabana Grande Municipio, PR	2005	NA	9590	8287	1303	13.6
CN7212300000000	72	123	Salinas Municipio, PR	2005	NA	8860	7290	1570	17.7
CN7212500000000	72	125	San German Municipio, PR	2005	NA	13445	11609	1836	13.7
CN7212700000000	72	127	San Juan Municipio, PR	2005	NA	173645	159713	13932	8
CN7212900000000	72	129	San Lorenzo Municipio, PR	2005	NA	14435	12661	1774	12.3
CN7213100000000	72	131	San Sebastian Municipio, PR	2005	NA	15769	13561	2208	14
CN7213300000000	72	133	Santa Isabel Municipio, PR	2005	NA	9250	8076	1174	12.7
CN7213500000000	72	135	Toa Alta Municipio, PR	2005	NA	28556	26265	2291	8
CN7213700000000	72	137	Toa Baja Municipio, PR	2005	NA	35943	32903	3040	8.5
CN7213900000000	72	139	Trujillo Alto Municipio, PR	2005	NA	34523	31959	2564	7.4
CN7214100000000	72	141	Utuado Municipio, PR	2005	NA	9671	8198	1473	15.2
CN7214300000000	72	143	Vega Alta Municipio, PR	2005	NA	12539	11152	1387	11.1
CN7214500000000	72	145	Vega Baja Municipio, PR	2005	NA	20930	18296	2634	12.6
CN7214700000000	72	147	Vieques Municipio, PR	2005	NA	3062	2725	337	11
CN7214900000000	72	149	Villalba Municipio, PR	2005	NA	9506	8112	1394	14.7
CN7215100000000	72	151	Yabucoa Municipio, PR	2005	NA	11247	9272	1975	17.6
CN7215300000000	72	153	Yauco Municipio, PR	2005	NA	16695	14380	2315	13.9
NA	NA	NA	NA	NA	NA	NA	NA	NA	NA
SOURCE:  BLS, LAUS	NA	NA	NA	NA	NA	NA	NA	NA	NA
March 18, 2016	NA	NA	NA	NA	NA	NA	NA	NA	NA
