LAUS_CODE	STATE_FIPS	COUNTY_FIPS	COUNTY	YEAR	ESTIMATED	LABOR_FORCE	EMPLOYED	UNEMPLOYED_LEVEL	UNEMPLOYED_RATE
CN0100100000000	01	001	Autauga County, AL	2012	NA	25740	23961	1779	6.9
CN0100300000000	01	003	Baldwin County, AL	2012	NA	84414	78065	6349	7.5
CN0100500000000	01	005	Barbour County, AL	2012	NA	9362	8283	1079	11.5
CN0100700000000	01	007	Bibb County, AL	2012	NA	8798	8047	751	8.5
CN0100900000000	01	009	Blount County, AL	2012	NA	24960	23244	1716	6.9
CN0101100000000	01	011	Bullock County, AL	2012	NA	4736	4245	491	10.4
CN0101300000000	01	013	Butler County, AL	2012	NA	9088	8039	1049	11.5
CN0101500000000	01	015	Calhoun County, AL	2012	NA	49649	45252	4397	8.9
CN0101700000000	01	017	Chambers County, AL	2012	NA	15140	13646	1494	9.9
CN0101900000000	01	019	Cherokee County, AL	2012	NA	11268	10363	905	8
CN0102100000000	01	021	Chilton County, AL	2012	NA	19383	17982	1401	7.2
CN0102300000000	01	023	Choctaw County, AL	2012	NA	4791	4297	494	10.3
CN0102500000000	01	025	Clarke County, AL	2012	NA	8374	7116	1258	15
CN0102700000000	01	027	Clay County, AL	2012	NA	5413	4905	508	9.4
CN0102900000000	01	029	Cleburne County, AL	2012	NA	5838	5358	480	8.2
CN0103100000000	01	031	Coffee County, AL	2012	NA	20612	19159	1453	7
CN0103300000000	01	033	Colbert County, AL	2012	NA	24026	21922	2104	8.8
CN0103500000000	01	035	Conecuh County, AL	2012	NA	4635	4082	553	11.9
CN0103700000000	01	037	Coosa County, AL	2012	NA	4445	4029	416	9.4
CN0103900000000	01	039	Covington County, AL	2012	NA	16345	14978	1367	8.4
CN0104100000000	01	041	Crenshaw County, AL	2012	NA	6251	5732	519	8.3
CN0104300000000	01	043	Cullman County, AL	2012	NA	35568	32835	2733	7.7
CN0104500000000	01	045	Dale County, AL	2012	NA	21370	19781	1589	7.4
CN0104700000000	01	047	Dallas County, AL	2012	NA	16746	14583	2163	12.9
CN0104900000000	01	049	DeKalb County, AL	2012	NA	28833	26224	2609	9
CN0105100000000	01	051	Elmore County, AL	2012	NA	36629	34087	2542	6.9
CN0105300000000	01	053	Escambia County, AL	2012	NA	14732	13374	1358	9.2
CN0105500000000	01	055	Etowah County, AL	2012	NA	44232	40589	3643	8.2
CN0105700000000	01	057	Fayette County, AL	2012	NA	6503	5943	560	8.6
CN0105900000000	01	059	Franklin County, AL	2012	NA	13976	12806	1170	8.4
CN0106100000000	01	061	Geneva County, AL	2012	NA	11274	10421	853	7.6
CN0106300000000	01	063	Greene County, AL	2012	NA	3125	2701	424	13.6
CN0106500000000	01	065	Hale County, AL	2012	NA	6212	5499	713	11.5
CN0106700000000	01	067	Henry County, AL	2012	NA	7030	6447	583	8.3
CN0106900000000	01	069	Houston County, AL	2012	NA	46054	42578	3476	7.5
CN0107100000000	01	071	Jackson County, AL	2012	NA	23731	21695	2036	8.6
CN0107300000000	01	073	Jefferson County, AL	2012	NA	316511	293020	23491	7.4
CN0107500000000	01	075	Lamar County, AL	2012	NA	5806	5369	437	7.5
CN0107700000000	01	077	Lauderdale County, AL	2012	NA	43409	40084	3325	7.7
CN0107900000000	01	079	Lawrence County, AL	2012	NA	14391	13094	1297	9
CN0108100000000	01	081	Lee County, AL	2012	NA	68918	64247	4671	6.8
CN0108300000000	01	083	Limestone County, AL	2012	NA	38990	36311	2679	6.9
CN0108500000000	01	085	Lowndes County, AL	2012	NA	4081	3452	629	15.4
CN0108700000000	01	087	Macon County, AL	2012	NA	8286	7397	889	10.7
CN0108900000000	01	089	Madison County, AL	2012	NA	170209	158399	11810	6.9
CN0109100000000	01	091	Marengo County, AL	2012	NA	7650	6873	777	10.2
CN0109300000000	01	093	Marion County, AL	2012	NA	12451	11340	1111	8.9
CN0109500000000	01	095	Marshall County, AL	2012	NA	40686	37523	3163	7.8
CN0109700000000	01	097	Mobile County, AL	2012	NA	188626	171312	17314	9.2
CN0109900000000	01	099	Monroe County, AL	2012	NA	7971	6971	1000	12.5
CN0110100000000	01	101	Montgomery County, AL	2012	NA	107320	98666	8654	8.1
CN0110300000000	01	103	Morgan County, AL	2012	NA	57410	52931	4479	7.8
CN0110500000000	01	105	Perry County, AL	2012	NA	3683	3192	491	13.3
CN0110700000000	01	107	Pickens County, AL	2012	NA	7467	6709	758	10.2
CN0110900000000	01	109	Pike County, AL	2012	NA	15017	13819	1198	8
CN0111100000000	01	111	Randolph County, AL	2012	NA	9143	8304	839	9.2
CN0111300000000	01	113	Russell County, AL	2012	NA	24911	22725	2186	8.8
CN0111500000000	01	115	St. Clair County, AL	2012	NA	38516	35871	2645	6.9
CN0111700000000	01	117	Shelby County, AL	2012	NA	105458	100158	5300	5
CN0111900000000	01	119	Sumter County, AL	2012	NA	5417	4848	569	10.5
CN0112100000000	01	121	Talladega County, AL	2012	NA	35013	31731	3282	9.4
CN0112300000000	01	123	Tallapoosa County, AL	2012	NA	18441	16850	1591	8.6
CN0112500000000	01	125	Tuscaloosa County, AL	2012	NA	95340	88683	6657	7
CN0112700000000	01	127	Walker County, AL	2012	NA	26574	24136	2438	9.2
CN0112900000000	01	129	Washington County, AL	2012	NA	6875	6054	821	11.9
CN0113100000000	01	131	Wilcox County, AL	2012	NA	2883	2308	575	19.9
CN0113300000000	01	133	Winston County, AL	2012	NA	9607	8647	960	10
CN0201300000000	02	013	Aleutians East Borough, AK	2012	NA	2138	1993	145	6.8
CN0201600000000	02	016	Aleutians West Census Area, AK	2012	NA	4268	3972	296	6.9
CN0202000000000	02	020	Anchorage Borough/municipality, AK	2012	NA	158380	149897	8483	5.4
CN0205000000000	02	050	Bethel Census Area, AK	2012	NA	7211	6103	1108	15.4
CN0206000000000	02	060	Bristol Bay Borough, AK	2012	NA	481	434	47	9.8
CN0206800000000	02	068	Denali Borough, AK	2012	NA	1047	903	144	13.8
CN0207000000000	02	070	Dillingham Census Area, AK	2012	NA	2132	1921	211	9.9
CN0209000000000	02	090	Fairbanks North Star Borough, AK	2012	NA	48197	45264	2933	6.1
CN0210000000000	02	100	Haines Borough, AK	2012	NA	1108	997	111	10
CN0210500000000	02	105	Hoonah-Angoon Census Area, AK	2012	NA	1109	950	159	14.3
CN0211000000000	02	110	Juneau Borough/city, AK	2012	NA	17904	16991	913	5.1
CN0212200000000	02	122	Kenai Peninsula Borough, AK	2012	NA	27367	25003	2364	8.6
CN0213000000000	02	130	Ketchikan Gateway Borough, AK	2012	NA	7177	6594	583	8.1
CN0215000000000	02	150	Kodiak Island Borough, AK	2012	NA	6717	6268	449	6.7
CN0215800000000	02	158	Kusilvak Census Area, AK	2012	NA	2768	2156	612	22.1
CN0216400000000	02	164	Lake and Peninsula Borough, AK	2012	NA	637	540	97	15.2
CN0217000000000	02	170	Matanuska-Susitna Borough, AK	2012	NA	43757	39968	3789	8.7
CN0218000000000	02	180	Nome Census Area, AK	2012	NA	4178	3690	488	11.7
CN0218500000000	02	185	North Slope Borough, AK	2012	NA	4027	3715	312	7.7
CN0218800000000	02	188	Northwest Arctic Borough, AK	2012	NA	3031	2554	477	15.7
CN0219500000000	02	195	Petersburg Borough, AK	2012	NA	1878	1725	153	8.1
CN0219800000000	02	198	Prince of Wales-Hyder Census Area, AK	2012	NA	2591	2247	344	13.3
CN0222000000000	02	220	Sitka Borough/city, AK	2012	NA	4647	4384	263	5.7
CN0223000000000	02	230	Skagway Municipality, AK	2012	NA	754	648	106	14.1
CN0224000000000	02	240	Southeast Fairbanks Census Area, AK	2012	NA	3038	2647	391	12.9
CN0226100000000	02	261	Valdez-Cordova Census Area, AK	2012	NA	4894	4419	475	9.7
CN0227500000000	02	275	Wrangell Borough/city, AK	2012	NA	1026	942	84	8.2
CN0228200000000	02	282	Yakutat Borough/city, AK	2012	NA	288	260	28	9.7
CN0229000000000	02	290	Yukon-Koyukuk Census Area, AK	2012	NA	2773	2291	482	17.4
CN0400100000000	04	001	Apache County, AZ	2012	NA	22806	18482	4324	19
CN0400300000000	04	003	Cochise County, AZ	2012	NA	53898	49027	4871	9
CN0400500000000	04	005	Coconino County, AZ	2012	NA	71032	64922	6110	8.6
CN0400700000000	04	007	Gila County, AZ	2012	NA	20923	18786	2137	10.2
CN0400900000000	04	009	Graham County, AZ	2012	NA	14472	13242	1230	8.5
CN0401100000000	04	011	Greenlee County, AZ	2012	NA	3553	3261	292	8.2
CN0401200000000	04	012	La Paz County, AZ	2012	NA	8137	7441	696	8.6
CN0401300000000	04	013	Maricopa County, AZ	2012	NA	1895634	1757601	138033	7.3
CN0401500000000	04	015	Mohave County, AZ	2012	NA	77570	69021	8549	11
CN0401700000000	04	017	Navajo County, AZ	2012	NA	42957	36890	6067	14.1
CN0401900000000	04	019	Pima County, AZ	2012	NA	462896	428796	34100	7.4
CN0402100000000	04	021	Pinal County, AZ	2012	NA	148689	135995	12694	8.5
CN0402300000000	04	023	Santa Cruz County, AZ	2012	NA	20121	17014	3107	15.4
CN0402500000000	04	025	Yavapai County, AZ	2012	NA	92384	84442	7942	8.6
CN0402700000000	04	027	Yuma County, AZ	2012	NA	93806	71429	22377	23.9
CN0500100000000	05	001	Arkansas County, AR	2012	NA	9911	9042	869	8.8
CN0500300000000	05	003	Ashley County, AR	2012	NA	9462	8323	1139	12
CN0500500000000	05	005	Baxter County, AR	2012	NA	16365	14986	1379	8.4
CN0500700000000	05	007	Benton County, AR	2012	NA	110633	103974	6659	6
CN0500900000000	05	009	Boone County, AR	2012	NA	16503	15244	1259	7.6
CN0501100000000	05	011	Bradley County, AR	2012	NA	4512	4027	485	10.7
CN0501300000000	05	013	Calhoun County, AR	2012	NA	2527	2298	229	9.1
CN0501500000000	05	015	Carroll County, AR	2012	NA	12465	11676	789	6.3
CN0501700000000	05	017	Chicot County, AR	2012	NA	4059	3597	462	11.4
CN0501900000000	05	019	Clark County, AR	2012	NA	10296	9274	1022	9.9
CN0502100000000	05	021	Clay County, AR	2012	NA	6857	6103	754	11
CN0502300000000	05	023	Cleburne County, AR	2012	NA	10407	9521	886	8.5
CN0502500000000	05	025	Cleveland County, AR	2012	NA	3747	3471	276	7.4
CN0502700000000	05	027	Columbia County, AR	2012	NA	10113	9202	911	9
CN0502900000000	05	029	Conway County, AR	2012	NA	8701	7899	802	9.2
CN0503100000000	05	031	Craighead County, AR	2012	NA	49000	45629	3371	6.9
CN0503300000000	05	033	Crawford County, AR	2012	NA	27577	25379	2198	8
CN0503500000000	05	035	Crittenden County, AR	2012	NA	22077	19961	2116	9.6
CN0503700000000	05	037	Cross County, AR	2012	NA	8523	7846	677	7.9
CN0503900000000	05	039	Dallas County, AR	2012	NA	3292	2926	366	11.1
CN0504100000000	05	041	Desha County, AR	2012	NA	5932	5345	587	9.9
CN0504300000000	05	043	Drew County, AR	2012	NA	8483	7590	893	10.5
CN0504500000000	05	045	Faulkner County, AR	2012	NA	59651	55694	3957	6.6
CN0504700000000	05	047	Franklin County, AR	2012	NA	7660	7116	544	7.1
CN0504900000000	05	049	Fulton County, AR	2012	NA	5101	4734	367	7.2
CN0505100000000	05	051	Garland County, AR	2012	NA	41154	37900	3254	7.9
CN0505300000000	05	053	Grant County, AR	2012	NA	8415	7842	573	6.8
CN0505500000000	05	055	Greene County, AR	2012	NA	19986	18254	1732	8.7
CN0505700000000	05	057	Hempstead County, AR	2012	NA	10867	10076	791	7.3
CN0505900000000	05	059	Hot Spring County, AR	2012	NA	14520	13476	1044	7.2
CN0506100000000	05	061	Howard County, AR	2012	NA	6460	6029	431	6.7
CN0506300000000	05	063	Independence County, AR	2012	NA	16061	14583	1478	9.2
CN0506500000000	05	065	Izard County, AR	2012	NA	5161	4707	454	8.8
CN0506700000000	05	067	Jackson County, AR	2012	NA	6465	5769	696	10.8
CN0506900000000	05	069	Jefferson County, AR	2012	NA	32431	29184	3247	10
CN0507100000000	05	071	Johnson County, AR	2012	NA	10820	10024	796	7.4
CN0507300000000	05	073	Lafayette County, AR	2012	NA	2914	2640	274	9.4
CN0507500000000	05	075	Lawrence County, AR	2012	NA	7266	6607	659	9.1
CN0507700000000	05	077	Lee County, AR	2012	NA	3518	3184	334	9.5
CN0507900000000	05	079	Lincoln County, AR	2012	NA	4580	4179	401	8.8
CN0508100000000	05	081	Little River County, AR	2012	NA	5972	5536	436	7.3
CN0508300000000	05	083	Logan County, AR	2012	NA	9615	8846	769	8
CN0508500000000	05	085	Lonoke County, AR	2012	NA	33043	30942	2101	6.4
CN0508700000000	05	087	Madison County, AR	2012	NA	6962	6554	408	5.9
CN0508900000000	05	089	Marion County, AR	2012	NA	6601	6057	544	8.2
CN0509100000000	05	091	Miller County, AR	2012	NA	20236	19031	1205	6
CN0509300000000	05	093	Mississippi County, AR	2012	NA	20244	18023	2221	11
CN0509500000000	05	095	Monroe County, AR	2012	NA	3271	2975	296	9
CN0509700000000	05	097	Montgomery County, AR	2012	NA	3602	3298	304	8.4
CN0509900000000	05	099	Nevada County, AR	2012	NA	4136	3815	321	7.8
CN0510100000000	05	101	Newton County, AR	2012	NA	3624	3358	266	7.3
CN0510300000000	05	103	Ouachita County, AR	2012	NA	10571	9468	1103	10.4
CN0510500000000	05	105	Perry County, AR	2012	NA	4410	4009	401	9.1
CN0510700000000	05	107	Phillips County, AR	2012	NA	7961	7039	922	11.6
CN0510900000000	05	109	Pike County, AR	2012	NA	4415	4018	397	9
CN0511100000000	05	111	Poinsett County, AR	2012	NA	10375	9474	901	8.7
CN0511300000000	05	113	Polk County, AR	2012	NA	8725	8078	647	7.4
CN0511500000000	05	115	Pope County, AR	2012	NA	30033	27849	2184	7.3
CN0511700000000	05	117	Prairie County, AR	2012	NA	3822	3533	289	7.6
CN0511900000000	05	119	Pulaski County, AR	2012	NA	188257	175325	12932	6.9
CN0512100000000	05	121	Randolph County, AR	2012	NA	6865	6122	743	10.8
CN0512300000000	05	123	St. Francis County, AR	2012	NA	9490	8463	1027	10.8
CN0512500000000	05	125	Saline County, AR	2012	NA	54322	51001	3321	6.1
CN0512700000000	05	127	Scott County, AR	2012	NA	4683	4371	312	6.7
CN0512900000000	05	129	Searcy County, AR	2012	NA	3216	2952	264	8.2
CN0513100000000	05	131	Sebastian County, AR	2012	NA	58955	54321	4634	7.9
CN0513300000000	05	133	Sevier County, AR	2012	NA	6195	5657	538	8.7
CN0513500000000	05	135	Sharp County, AR	2012	NA	6100	5481	619	10.1
CN0513700000000	05	137	Stone County, AR	2012	NA	5046	4630	416	8.2
CN0513900000000	05	139	Union County, AR	2012	NA	16794	15250	1544	9.2
CN0514100000000	05	141	Van Buren County, AR	2012	NA	6598	5929	669	10.1
CN0514300000000	05	143	Washington County, AR	2012	NA	105256	99336	5920	5.6
CN0514500000000	05	145	White County, AR	2012	NA	36244	33394	2850	7.9
CN0514700000000	05	147	Woodruff County, AR	2012	NA	3381	3036	345	10.2
CN0514900000000	05	149	Yell County, AR	2012	NA	9275	8651	624	6.7
CN0600100000000	06	001	Alameda County, CA	2012	NA	798416	729049	69367	8.7
CN0600300000000	06	003	Alpine County, CA	2012	NA	545	484	61	11.2
CN0600500000000	06	005	Amador County, CA	2012	NA	14672	12873	1799	12.3
CN0600700000000	06	007	Butte County, CA	2012	NA	100990	88718	12272	12.2
CN0600900000000	06	009	Calaveras County, CA	2012	NA	20201	17705	2496	12.4
CN0601100000000	06	011	Colusa County, CA	2012	NA	11272	8935	2337	20.7
CN0601300000000	06	013	Contra Costa County, CA	2012	NA	535786	487887	47899	8.9
CN0601500000000	06	015	Del Norte County, CA	2012	NA	10496	9076	1420	13.5
CN0601700000000	06	017	El Dorado County, CA	2012	NA	89051	79958	9093	10.2
CN0601900000000	06	019	Fresno County, CA	2012	NA	440031	373457	66574	15.1
CN0602100000000	06	021	Glenn County, CA	2012	NA	13148	11283	1865	14.2
CN0602300000000	06	023	Humboldt County, CA	2012	NA	64279	58120	6159	9.6
CN0602500000000	06	025	Imperial County, CA	2012	NA	79265	57586	21679	27.4
CN0602700000000	06	027	Inyo County, CA	2012	NA	9557	8690	867	9.1
CN0602900000000	06	029	Kern County, CA	2012	NA	391888	340355	51533	13.1
CN0603100000000	06	031	Kings County, CA	2012	NA	58807	50049	8758	14.9
CN0603300000000	06	033	Lake County, CA	2012	NA	29509	25738	3771	12.8
CN0603500000000	06	035	Lassen County, CA	2012	NA	11471	10042	1429	12.5
CN0603700000000	06	037	Los Angeles County, CA	2012	NA	4915263	4378392	536871	10.9
CN0603900000000	06	039	Madera County, CA	2012	NA	62530	53495	9035	14.4
CN0604100000000	06	041	Marin County, CA	2012	NA	136911	128310	8601	6.3
CN0604300000000	06	043	Mariposa County, CA	2012	NA	8375	7352	1023	12.2
CN0604500000000	06	045	Mendocino County, CA	2012	NA	40953	36841	4112	10
CN0604700000000	06	047	Merced County, CA	2012	NA	115016	96236	18780	16.3
CN0604900000000	06	049	Modoc County, CA	2012	NA	3612	3092	520	14.4
CN0605100000000	06	051	Mono County, CA	2012	NA	8401	7532	869	10.3
CN0605300000000	06	053	Monterey County, CA	2012	NA	217796	192600	25196	11.6
CN0605500000000	06	055	Napa County, CA	2012	NA	71816	65755	6061	8.4
CN0605700000000	06	057	Nevada County, CA	2012	NA	48363	43649	4714	9.7
CN0605900000000	06	059	Orange County, CA	2012	NA	1562136	1439270	122866	7.9
CN0606100000000	06	061	Placer County, CA	2012	NA	174919	158545	16374	9.4
CN0606300000000	06	063	Plumas County, CA	2012	NA	8485	7115	1370	16.1
CN0606500000000	06	065	Riverside County, CA	2012	NA	987076	872251	114825	11.6
CN0606700000000	06	067	Sacramento County, CA	2012	NA	681281	609691	71590	10.5
CN0606900000000	06	069	San Benito County, CA	2012	NA	28677	24936	3741	13
CN0607100000000	06	071	San Bernardino County, CA	2012	NA	892212	790420	101792	11.4
CN0607300000000	06	073	San Diego County, CA	2012	NA	1540440	1399878	140562	9.1
CN0607500000000	06	075	San Francisco County/city, CA	2012	NA	509444	474933	34511	6.8
CN0607700000000	06	077	San Joaquin County, CA	2012	NA	311818	267059	44759	14.4
CN0607900000000	06	079	San Luis Obispo County, CA	2012	NA	137362	126037	11325	8.2
CN0608100000000	06	081	San Mateo County, CA	2012	NA	412056	385661	26395	6.4
CN0608300000000	06	083	Santa Barbara County, CA	2012	NA	216005	197919	18086	8.4
CN0608500000000	06	085	Santa Clara County, CA	2012	NA	958281	882982	75299	7.9
CN0608700000000	06	087	Santa Cruz County, CA	2012	NA	142063	125257	16806	11.8
CN0608900000000	06	089	Shasta County, CA	2012	NA	76009	65229	10780	14.2
CN0609100000000	06	091	Sierra County, CA	2012	NA	1469	1258	211	14.4
CN0609300000000	06	093	Siskiyou County, CA	2012	NA	18876	15929	2947	15.6
CN0609500000000	06	095	Solano County, CA	2012	NA	202661	180984	21677	10.7
CN0609700000000	06	097	Sonoma County, CA	2012	NA	246281	224462	21819	8.9
CN0609900000000	06	099	Stanislaus County, CA	2012	NA	241965	205940	36025	14.9
CN0610100000000	06	101	Sutter County, CA	2012	NA	45557	37901	7656	16.8
CN0610300000000	06	103	Tehama County, CA	2012	NA	25248	21780	3468	13.7
CN0610500000000	06	105	Trinity County, CA	2012	NA	5330	4550	780	14.6
CN0610700000000	06	107	Tulare County, CA	2012	NA	201287	168764	32523	16.2
CN0610900000000	06	109	Tuolumne County, CA	2012	NA	22315	19419	2896	13
CN0611100000000	06	111	Ventura County, CA	2012	NA	434681	395158	39523	9.1
CN0611300000000	06	113	Yolo County, CA	2012	NA	102610	91689	10921	10.6
CN0611500000000	06	115	Yuba County, CA	2012	NA	28832	24395	4437	15.4
CN0800100000000	08	001	Adams County, CO	2012	NA	239471	216923	22548	9.4
CN0800300000000	08	003	Alamosa County, CO	2012	NA	7753	6943	810	10.4
CN0800500000000	08	005	Arapahoe County, CO	2012	NA	322881	297947	24934	7.7
CN0800700000000	08	007	Archuleta County, CO	2012	NA	5736	5160	576	10
CN0800900000000	08	009	Baca County, CO	2012	NA	2015	1924	91	4.5
CN0801100000000	08	011	Bent County, CO	2012	NA	1722	1578	144	8.4
CN0801300000000	08	013	Boulder County, CO	2012	NA	174313	163471	10842	6.2
CN0801400000000	08	014	Broomfield County/city, CO	2012	NA	32275	30129	2146	6.6
CN0801500000000	08	015	Chaffee County, CO	2012	NA	8367	7796	571	6.8
CN0801700000000	08	017	Cheyenne County, CO	2012	NA	1010	964	46	4.6
CN0801900000000	08	019	Clear Creek County, CO	2012	NA	5486	5100	386	7
CN0802100000000	08	021	Conejos County, CO	2012	NA	3711	3317	394	10.6
CN0802300000000	08	023	Costilla County, CO	2012	NA	1603	1420	183	11.4
CN0802500000000	08	025	Crowley County, CO	2012	NA	1362	1252	110	8.1
CN0802700000000	08	027	Custer County, CO	2012	NA	1986	1860	126	6.3
CN0802900000000	08	029	Delta County, CO	2012	NA	14406	13010	1396	9.7
CN0803100000000	08	031	Denver County/city, CO	2012	NA	357670	329577	28093	7.9
CN0803300000000	08	033	Dolores County, CO	2012	NA	949	852	97	10.2
CN0803500000000	08	035	Douglas County, CO	2012	NA	160907	151248	9659	6
CN0803700000000	08	037	Eagle County, CO	2012	NA	32349	30032	2317	7.2
CN0803900000000	08	039	Elbert County, CO	2012	NA	12692	11789	903	7.1
CN0804100000000	08	041	El Paso County, CO	2012	NA	307002	279826	27176	8.9
CN0804300000000	08	043	Fremont County, CO	2012	NA	15633	13810	1823	11.7
CN0804500000000	08	045	Garfield County, CO	2012	NA	31490	28813	2677	8.5
CN0804700000000	08	047	Gilpin County, CO	2012	NA	3267	3049	218	6.7
CN0804900000000	08	049	Grand County, CO	2012	NA	8747	8113	634	7.2
CN0805100000000	08	051	Gunnison County, CO	2012	NA	9832	9244	588	6
CN0805300000000	08	053	Hinsdale County, CO	2012	NA	436	415	21	4.8
CN0805500000000	08	055	Huerfano County, CO	2012	NA	2634	2259	375	14.2
CN0805700000000	08	057	Jackson County, CO	2012	NA	826	783	43	5.2
CN0805900000000	08	059	Jefferson County, CO	2012	NA	304298	281809	22489	7.4
CN0806100000000	08	061	Kiowa County, CO	2012	NA	817	780	37	4.5
CN0806300000000	08	063	Kit Carson County, CO	2012	NA	4229	4041	188	4.4
CN0806500000000	08	065	Lake County, CO	2012	NA	4523	4133	390	8.6
CN0806700000000	08	067	La Plata County, CO	2012	NA	29663	27693	1970	6.6
CN0806900000000	08	069	Larimer County, CO	2012	NA	172883	161287	11596	6.7
CN0807100000000	08	071	Las Animas County, CO	2012	NA	6963	6127	836	12
CN0807300000000	08	073	Lincoln County, CO	2012	NA	2157	2017	140	6.5
CN0807500000000	08	075	Logan County, CO	2012	NA	11067	10405	662	6
CN0807700000000	08	077	Mesa County, CO	2012	NA	74945	67680	7265	9.7
CN0807900000000	08	079	Mineral County, CO	2012	NA	444	420	24	5.4
CN0808100000000	08	081	Moffat County, CO	2012	NA	7743	7104	639	8.3
CN0808300000000	08	083	Montezuma County, CO	2012	NA	12917	11813	1104	8.5
CN0808500000000	08	085	Montrose County, CO	2012	NA	19836	17787	2049	10.3
CN0808700000000	08	087	Morgan County, CO	2012	NA	14981	13967	1014	6.8
CN0808900000000	08	089	Otero County, CO	2012	NA	8401	7538	863	10.3
CN0809100000000	08	091	Ouray County, CO	2012	NA	2085	1890	195	9.4
CN0809300000000	08	093	Park County, CO	2012	NA	9302	8662	640	6.9
CN0809500000000	08	095	Phillips County, CO	2012	NA	2141	2031	110	5.1
CN0809700000000	08	097	Pitkin County, CO	2012	NA	10911	10126	785	7.2
CN0809900000000	08	099	Prowers County, CO	2012	NA	6097	5671	426	7
CN0810100000000	08	101	Pueblo County, CO	2012	NA	74490	66523	7967	10.7
CN0810300000000	08	103	Rio Blanco County, CO	2012	NA	3091	2833	258	8.3
CN0810500000000	08	105	Rio Grande County, CO	2012	NA	5104	4481	623	12.2
CN0810700000000	08	107	Routt County, CO	2012	NA	14373	13338	1035	7.2
CN0810900000000	08	109	Saguache County, CO	2012	NA	3055	2716	339	11.1
CN0811100000000	08	111	San Juan County, CO	2012	NA	535	482	53	9.9
CN0811300000000	08	113	San Miguel County, CO	2012	NA	4856	4475	381	7.8
CN0811500000000	08	115	Sedgwick County, CO	2012	NA	1119	1041	78	7
CN0811700000000	08	117	Summit County, CO	2012	NA	19325	18158	1167	6
CN0811900000000	08	119	Teller County, CO	2012	NA	11912	10912	1000	8.4
CN0812100000000	08	121	Washington County, CO	2012	NA	2636	2507	129	4.9
CN0812300000000	08	123	Weld County, CO	2012	NA	136906	126256	10650	7.8
CN0812500000000	08	125	Yuma County, CO	2012	NA	4884	4633	251	5.1
CN0900100000000	09	001	Fairfield County, CT	2012	NA	472552	435746	36806	7.8
CN0900300000000	09	003	Hartford County, CT	2012	NA	472634	432313	40321	8.5
CN0900500000000	09	005	Litchfield County, CT	2012	NA	106129	98061	8068	7.6
CN0900700000000	09	007	Middlesex County, CT	2012	NA	92029	85444	6585	7.2
CN0900900000000	09	009	New Haven County, CT	2012	NA	456593	415055	41538	9.1
CN0901100000000	09	011	New London County, CT	2012	NA	139586	127500	12086	8.7
CN0901300000000	09	013	Tolland County, CT	2012	NA	84707	78493	6214	7.3
CN0901500000000	09	015	Windham County, CT	2012	NA	63190	57228	5962	9.4
CN1000100000000	10	001	Kent County, DE	2012	NA	74287	68394	5893	7.9
CN1000300000000	10	003	New Castle County, DE	2012	NA	278342	258855	19487	7
CN1000500000000	10	005	Sussex County, DE	2012	NA	92942	86207	6735	7.2
CN1100100000000	11	001	District of Columbia	2012	NA	364989	331984	33005	9
CN1200100000000	12	001	Alachua County, FL	2012	NA	130007	121373	8634	6.6
CN1200300000000	12	003	Baker County, FL	2012	NA	11347	10374	973	8.6
CN1200500000000	12	005	Bay County, FL	2012	NA	86694	79206	7488	8.6
CN1200700000000	12	007	Bradford County, FL	2012	NA	11152	10307	845	7.6
CN1200900000000	12	009	Brevard County, FL	2012	NA	262648	237972	24676	9.4
CN1201100000000	12	011	Broward County, FL	2012	NA	963563	886780	76783	8
CN1201300000000	12	013	Calhoun County, FL	2012	NA	5093	4627	466	9.1
CN1201500000000	12	015	Charlotte County, FL	2012	NA	65886	59621	6265	9.5
CN1201700000000	12	017	Citrus County, FL	2012	NA	51550	46006	5544	10.8
CN1201900000000	12	019	Clay County, FL	2012	NA	96340	89002	7338	7.6
CN1202100000000	12	021	Collier County, FL	2012	NA	152762	139883	12879	8.4
CN1202300000000	12	023	Columbia County, FL	2012	NA	28041	25567	2474	8.8
CN1202700000000	12	027	DeSoto County, FL	2012	NA	12899	11616	1283	9.9
CN1202900000000	12	029	Dixie County, FL	2012	NA	5809	5215	594	10.2
CN1203100000000	12	031	Duval County, FL	2012	NA	456398	416680	39718	8.7
CN1203300000000	12	033	Escambia County, FL	2012	NA	139701	127948	11753	8.4
CN1203500000000	12	035	Flagler County, FL	2012	NA	42156	37998	4158	9.9
CN1203700000000	12	037	Franklin County, FL	2012	NA	5051	4724	327	6.5
CN1203900000000	12	039	Gadsden County, FL	2012	NA	18900	16952	1948	10.3
CN1204100000000	12	041	Gilchrist County, FL	2012	NA	6717	6108	609	9.1
CN1204300000000	12	043	Glades County, FL	2012	NA	5701	5262	439	7.7
CN1204500000000	12	045	Gulf County, FL	2012	NA	6091	5598	493	8.1
CN1204700000000	12	047	Hamilton County, FL	2012	NA	5175	4717	458	8.9
CN1204900000000	12	049	Hardee County, FL	2012	NA	11844	10792	1052	8.9
CN1205100000000	12	051	Hendry County, FL	2012	NA	17004	14830	2174	12.8
CN1205300000000	12	053	Hernando County, FL	2012	NA	66289	59281	7008	10.6
CN1205500000000	12	055	Highlands County, FL	2012	NA	37385	33542	3843	10.3
CN1205700000000	12	057	Hillsborough County, FL	2012	NA	668540	615740	52800	7.9
CN1205900000000	12	059	Holmes County, FL	2012	NA	7166	6534	632	8.8
CN1206100000000	12	061	Indian River County, FL	2012	NA	62012	55217	6795	11
CN1206300000000	12	063	Jackson County, FL	2012	NA	18067	16502	1565	8.7
CN1206500000000	12	065	Jefferson County, FL	2012	NA	5505	4996	509	9.2
CN1206700000000	12	067	Lafayette County, FL	2012	NA	3485	3286	199	5.7
CN1206900000000	12	069	Lake County, FL	2012	NA	134048	122203	11845	8.8
CN1207100000000	12	071	Lee County, FL	2012	NA	292354	266535	25819	8.8
CN1207300000000	12	073	Leon County, FL	2012	NA	149342	138903	10439	7
CN1207500000000	12	075	Levy County, FL	2012	NA	16732	15176	1556	9.3
CN1207700000000	12	077	Liberty County, FL	2012	NA	2747	2529	218	7.9
CN1207900000000	12	079	Madison County, FL	2012	NA	7999	7313	686	8.6
CN1208100000000	12	081	Manatee County, FL	2012	NA	150763	138509	12254	8.1
CN1208300000000	12	083	Marion County, FL	2012	NA	130450	117140	13310	10.2
CN1208500000000	12	085	Martin County, FL	2012	NA	67147	61568	5579	8.3
CN1208600000000	12	086	Miami-Dade County, FL	2012	NA	1282458	1176385	106073	8.3
CN1208700000000	12	087	Monroe County, FL	2012	NA	43928	41431	2497	5.7
CN1208900000000	12	089	Nassau County, FL	2012	NA	35950	33059	2891	8
CN1209100000000	12	091	Okaloosa County, FL	2012	NA	91453	85311	6142	6.7
CN1209300000000	12	093	Okeechobee County, FL	2012	NA	18321	16495	1826	10
CN1209500000000	12	095	Orange County, FL	2012	NA	653886	600251	53635	8.2
CN1209700000000	12	097	Osceola County, FL	2012	NA	143550	129979	13571	9.5
CN1209900000000	12	099	Palm Beach County, FL	2012	NA	660634	604549	56085	8.5
CN1210100000000	12	101	Pasco County, FL	2012	NA	208712	189824	18888	9
CN1210300000000	12	103	Pinellas County, FL	2012	NA	467029	429860	37169	8
CN1210500000000	12	105	Polk County, FL	2012	NA	277091	250458	26633	9.6
CN1210700000000	12	107	Putnam County, FL	2012	NA	28930	25513	3417	11.8
CN1210900000000	12	109	St. Johns County, FL	2012	NA	104055	97255	6800	6.5
CN1211100000000	12	111	St. Lucie County, FL	2012	NA	129091	114967	14124	10.9
CN1211300000000	12	113	Santa Rosa County, FL	2012	NA	72665	67192	5473	7.5
CN1211500000000	12	115	Sarasota County, FL	2012	NA	168019	153858	14161	8.4
CN1211700000000	12	117	Seminole County, FL	2012	NA	231131	212462	18669	8.1
CN1211900000000	12	119	Sumter County, FL	2012	NA	26860	24028	2832	10.5
CN1212100000000	12	121	Suwannee County, FL	2012	NA	18342	16871	1471	8
CN1212300000000	12	123	Taylor County, FL	2012	NA	9408	8564	844	9
CN1212500000000	12	125	Union County, FL	2012	NA	5087	4720	367	7.2
CN1212700000000	12	127	Volusia County, FL	2012	NA	237385	214879	22506	9.5
CN1212900000000	12	129	Wakulla County, FL	2012	NA	14121	13092	1029	7.3
CN1213100000000	12	131	Walton County, FL	2012	NA	26271	24360	1911	7.3
CN1213300000000	12	133	Washington County, FL	2012	NA	10064	9176	888	8.8
CN1300100000000	13	001	Appling County, GA	2012	NA	8982	7975	1007	11.2
CN1300300000000	13	003	Atkinson County, GA	2012	NA	3446	3048	398	11.5
CN1300500000000	13	005	Bacon County, GA	2012	NA	4557	4116	441	9.7
CN1300700000000	13	007	Baker County, GA	2012	NA	1172	1043	129	11
CN1300900000000	13	009	Baldwin County, GA	2012	NA	18881	16689	2192	11.6
CN1301100000000	13	011	Banks County, GA	2012	NA	8591	7885	706	8.2
CN1301300000000	13	013	Barrow County, GA	2012	NA	34566	31581	2985	8.6
CN1301500000000	13	015	Bartow County, GA	2012	NA	47422	42716	4706	9.9
CN1301700000000	13	017	Ben Hill County, GA	2012	NA	6183	5321	862	13.9
CN1301900000000	13	019	Berrien County, GA	2012	NA	7859	7054	805	10.2
CN1302100000000	13	021	Bibb County, GA	2012	NA	71737	64176	7561	10.5
CN1302300000000	13	023	Bleckley County, GA	2012	NA	5282	4617	665	12.6
CN1302500000000	13	025	Brantley County, GA	2012	NA	7440	6546	894	12
CN1302700000000	13	027	Brooks County, GA	2012	NA	6808	6184	624	9.2
CN1302900000000	13	029	Bryan County, GA	2012	NA	15153	13896	1257	8.3
CN1303100000000	13	031	Bulloch County, GA	2012	NA	33926	30602	3324	9.8
CN1303300000000	13	033	Burke County, GA	2012	NA	9718	8517	1201	12.4
CN1303500000000	13	035	Butts County, GA	2012	NA	10375	9311	1064	10.3
CN1303700000000	13	037	Calhoun County, GA	2012	NA	2375	2190	185	7.8
CN1303900000000	13	039	Camden County, GA	2012	NA	21882	20003	1879	8.6
CN1304300000000	13	043	Candler County, GA	2012	NA	5187	4737	450	8.7
CN1304500000000	13	045	Carroll County, GA	2012	NA	52013	46676	5337	10.3
CN1304700000000	13	047	Catoosa County, GA	2012	NA	32250	29840	2410	7.5
CN1304900000000	13	049	Charlton County, GA	2012	NA	4980	4515	465	9.3
CN1305100000000	13	051	Chatham County, GA	2012	NA	131983	119798	12185	9.2
CN1305300000000	13	053	Chattahoochee County, GA	2012	NA	2601	2296	305	11.7
CN1305500000000	13	055	Chattooga County, GA	2012	NA	10642	9552	1090	10.2
CN1305700000000	13	057	Cherokee County, GA	2012	NA	115046	106895	8151	7.1
CN1305900000000	13	059	Clarke County, GA	2012	NA	58146	53081	5065	8.7
CN1306100000000	13	061	Clay County, GA	2012	NA	1009	883	126	12.5
CN1306300000000	13	063	Clayton County, GA	2012	NA	127655	112298	15357	12
CN1306500000000	13	065	Clinch County, GA	2012	NA	2917	2634	283	9.7
CN1306700000000	13	067	Cobb County, GA	2012	NA	388649	358646	30003	7.7
CN1306900000000	13	069	Coffee County, GA	2012	NA	17477	15483	1994	11.4
CN1307100000000	13	071	Colquitt County, GA	2012	NA	21009	19162	1847	8.8
CN1307300000000	13	073	Columbia County, GA	2012	NA	64708	60188	4520	7
CN1307500000000	13	075	Cook County, GA	2012	NA	7534	6821	713	9.5
CN1307700000000	13	077	Coweta County, GA	2012	NA	65493	60271	5222	8
CN1307900000000	13	079	Crawford County, GA	2012	NA	5831	5259	572	9.8
CN1308100000000	13	081	Crisp County, GA	2012	NA	9177	8030	1147	12.5
CN1308300000000	13	083	Dade County, GA	2012	NA	8386	7747	639	7.6
CN1308500000000	13	085	Dawson County, GA	2012	NA	10859	9928	931	8.6
CN1308700000000	13	087	Decatur County, GA	2012	NA	12246	11006	1240	10.1
CN1308900000000	13	089	DeKalb County, GA	2012	NA	370150	335318	34832	9.4
CN1309100000000	13	091	Dodge County, GA	2012	NA	8152	7212	940	11.5
CN1309300000000	13	093	Dooly County, GA	2012	NA	4813	4260	553	11.5
CN1309500000000	13	095	Dougherty County, GA	2012	NA	40905	36288	4617	11.3
CN1309700000000	13	097	Douglas County, GA	2012	NA	66984	60547	6437	9.6
CN1309900000000	13	099	Early County, GA	2012	NA	4489	4033	456	10.2
CN1310100000000	13	101	Echols County, GA	2012	NA	1807	1674	133	7.4
CN1310300000000	13	103	Effingham County, GA	2012	NA	25958	23786	2172	8.4
CN1310500000000	13	105	Elbert County, GA	2012	NA	8557	7481	1076	12.6
CN1310700000000	13	107	Emanuel County, GA	2012	NA	9090	7967	1123	12.4
CN1310900000000	13	109	Evans County, GA	2012	NA	4804	4393	411	8.6
CN1311100000000	13	111	Fannin County, GA	2012	NA	10020	8996	1024	10.2
CN1311300000000	13	113	Fayette County, GA	2012	NA	53498	49458	4040	7.6
CN1311500000000	13	115	Floyd County, GA	2012	NA	44808	39913	4895	10.9
CN1311700000000	13	117	Forsyth County, GA	2012	NA	93750	87542	6208	6.6
CN1311900000000	13	119	Franklin County, GA	2012	NA	9543	8466	1077	11.3
CN1312100000000	13	121	Fulton County, GA	2012	NA	511185	464673	46512	9.1
CN1312300000000	13	123	Gilmer County, GA	2012	NA	12158	10874	1284	10.6
CN1312500000000	13	125	Glascock County, GA	2012	NA	1322	1194	128	9.7
CN1312700000000	13	127	Glynn County, GA	2012	NA	38791	35114	3677	9.5
CN1312900000000	13	129	Gordon County, GA	2012	NA	26845	24216	2629	9.8
CN1313100000000	13	131	Grady County, GA	2012	NA	10831	9902	929	8.6
CN1313300000000	13	133	Greene County, GA	2012	NA	6420	5708	712	11.1
CN1313500000000	13	135	Gwinnett County, GA	2012	NA	434145	400458	33687	7.8
CN1313700000000	13	137	Habersham County, GA	2012	NA	18427	16673	1754	9.5
CN1313900000000	13	139	Hall County, GA	2012	NA	89115	82180	6935	7.8
CN1314100000000	13	141	Hancock County, GA	2012	NA	2758	2290	468	17
CN1314300000000	13	143	Haralson County, GA	2012	NA	12101	10863	1238	10.2
CN1314500000000	13	145	Harris County, GA	2012	NA	16275	15102	1173	7.2
CN1314700000000	13	147	Hart County, GA	2012	NA	10823	9709	1114	10.3
CN1314900000000	13	149	Heard County, GA	2012	NA	5122	4593	529	10.3
CN1315100000000	13	151	Henry County, GA	2012	NA	103207	93513	9694	9.4
CN1315300000000	13	153	Houston County, GA	2012	NA	68742	63212	5530	8
CN1315500000000	13	155	Irwin County, GA	2012	NA	3543	3127	416	11.7
CN1315700000000	13	157	Jackson County, GA	2012	NA	29412	26995	2417	8.2
CN1315900000000	13	159	Jasper County, GA	2012	NA	6666	6013	653	9.8
CN1316100000000	13	161	Jeff Davis County, GA	2012	NA	6382	5645	737	11.5
CN1316300000000	13	163	Jefferson County, GA	2012	NA	7085	6148	937	13.2
CN1316500000000	13	165	Jenkins County, GA	2012	NA	3364	2902	462	13.7
CN1316700000000	13	167	Johnson County, GA	2012	NA	4065	3660	405	10
CN1316900000000	13	169	Jones County, GA	2012	NA	13879	12700	1179	8.5
CN1317100000000	13	171	Lamar County, GA	2012	NA	7968	7005	963	12.1
CN1317300000000	13	173	Lanier County, GA	2012	NA	3910	3544	366	9.4
CN1317500000000	13	175	Laurens County, GA	2012	NA	19799	17372	2427	12.3
CN1317700000000	13	177	Lee County, GA	2012	NA	14324	13227	1097	7.7
CN1317900000000	13	179	Liberty County, GA	2012	NA	27156	24736	2420	8.9
CN1318100000000	13	181	Lincoln County, GA	2012	NA	3538	3156	382	10.8
CN1318300000000	13	183	Long County, GA	2012	NA	6647	6079	568	8.5
CN1318500000000	13	185	Lowndes County, GA	2012	NA	52459	47676	4783	9.1
CN1318700000000	13	187	Lumpkin County, GA	2012	NA	15178	13910	1268	8.4
CN1318900000000	13	189	McDuffie County, GA	2012	NA	9332	8154	1178	12.6
CN1319100000000	13	191	McIntosh County, GA	2012	NA	6033	5444	589	9.8
CN1319300000000	13	193	Macon County, GA	2012	NA	5173	4485	688	13.3
CN1319500000000	13	195	Madison County, GA	2012	NA	13127	11955	1172	8.9
CN1319700000000	13	197	Marion County, GA	2012	NA	3612	3251	361	10
CN1319900000000	13	199	Meriwether County, GA	2012	NA	9031	7946	1085	12
CN1320100000000	13	201	Miller County, GA	2012	NA	2700	2479	221	8.2
CN1320500000000	13	205	Mitchell County, GA	2012	NA	9615	8761	854	8.9
CN1320700000000	13	207	Monroe County, GA	2012	NA	12821	11712	1109	8.6
CN1320900000000	13	209	Montgomery County, GA	2012	NA	3900	3447	453	11.6
CN1321100000000	13	211	Morgan County, GA	2012	NA	8541	7770	771	9
CN1321300000000	13	213	Murray County, GA	2012	NA	16406	14306	2100	12.8
CN1321500000000	13	215	Muscogee County, GA	2012	NA	83617	75432	8185	9.8
CN1321700000000	13	217	Newton County, GA	2012	NA	48311	42993	5318	11
CN1321900000000	13	219	Oconee County, GA	2012	NA	17068	15992	1076	6.3
CN1322100000000	13	221	Oglethorpe County, GA	2012	NA	6893	6305	588	8.5
CN1322300000000	13	223	Paulding County, GA	2012	NA	74473	68282	6191	8.3
CN1322500000000	13	225	Peach County, GA	2012	NA	12548	11149	1399	11.1
CN1322700000000	13	227	Pickens County, GA	2012	NA	13899	12637	1262	9.1
CN1322900000000	13	229	Pierce County, GA	2012	NA	8338	7550	788	9.5
CN1323100000000	13	231	Pike County, GA	2012	NA	8422	7643	779	9.2
CN1323300000000	13	233	Polk County, GA	2012	NA	18793	16917	1876	10
CN1323500000000	13	235	Pulaski County, GA	2012	NA	4380	3987	393	9
CN1323700000000	13	237	Putnam County, GA	2012	NA	8292	7336	956	11.5
CN1323900000000	13	239	Quitman County, GA	2012	NA	943	853	90	9.5
CN1324100000000	13	241	Rabun County, GA	2012	NA	6939	6144	795	11.5
CN1324300000000	13	243	Randolph County, GA	2012	NA	2836	2481	355	12.5
CN1324500000000	13	245	Richmond County, GA	2012	NA	88450	79050	9400	10.6
CN1324700000000	13	247	Rockdale County, GA	2012	NA	42138	37844	4294	10.2
CN1324900000000	13	249	Schley County, GA	2012	NA	2176	1949	227	10.4
CN1325100000000	13	251	Screven County, GA	2012	NA	5694	4908	786	13.8
CN1325300000000	13	253	Seminole County, GA	2012	NA	3254	2899	355	10.9
CN1325500000000	13	255	Spalding County, GA	2012	NA	28196	24658	3538	12.5
CN1325700000000	13	257	Stephens County, GA	2012	NA	11763	10528	1235	10.5
CN1325900000000	13	259	Stewart County, GA	2012	NA	2320	2105	215	9.3
CN1326100000000	13	261	Sumter County, GA	2012	NA	13960	12300	1660	11.9
CN1326300000000	13	263	Talbot County, GA	2012	NA	2922	2628	294	10.1
CN1326500000000	13	265	Taliaferro County, GA	2012	NA	607	521	86	14.2
CN1326700000000	13	267	Tattnall County, GA	2012	NA	9814	8997	817	8.3
CN1326900000000	13	269	Taylor County, GA	2012	NA	3116	2699	417	13.4
CN1327100000000	13	271	Telfair County, GA	2012	NA	5344	4715	629	11.8
CN1327300000000	13	273	Terrell County, GA	2012	NA	3755	3345	410	10.9
CN1327500000000	13	275	Thomas County, GA	2012	NA	18487	16696	1791	9.7
CN1327700000000	13	277	Tift County, GA	2012	NA	19159	17226	1933	10.1
CN1327900000000	13	279	Toombs County, GA	2012	NA	12517	11045	1472	11.8
CN1328100000000	13	281	Towns County, GA	2012	NA	4440	3939	501	11.3
CN1328300000000	13	283	Treutlen County, GA	2012	NA	2905	2514	391	13.5
CN1328500000000	13	285	Troup County, GA	2012	NA	35610	32110	3500	9.8
CN1328700000000	13	287	Turner County, GA	2012	NA	3460	3055	405	11.7
CN1328900000000	13	289	Twiggs County, GA	2012	NA	3174	2702	472	14.9
CN1329100000000	13	291	Union County, GA	2012	NA	9661	8807	854	8.8
CN1329300000000	13	293	Upson County, GA	2012	NA	11994	10713	1281	10.7
CN1329500000000	13	295	Walker County, GA	2012	NA	30923	28145	2778	9
CN1329700000000	13	297	Walton County, GA	2012	NA	41141	37400	3741	9.1
CN1329900000000	13	299	Ware County, GA	2012	NA	15485	13915	1570	10.1
CN1330100000000	13	301	Warren County, GA	2012	NA	2653	2256	397	15
CN1330300000000	13	303	Washington County, GA	2012	NA	8083	7247	836	10.3
CN1330500000000	13	305	Wayne County, GA	2012	NA	12611	11262	1349	10.7
CN1330700000000	13	307	Webster County, GA	2012	NA	1061	956	105	9.9
CN1330900000000	13	309	Wheeler County, GA	2012	NA	1958	1697	261	13.3
CN1331100000000	13	311	White County, GA	2012	NA	13570	12396	1174	8.7
CN1331300000000	13	313	Whitfield County, GA	2012	NA	45754	40886	4868	10.6
CN1331500000000	13	315	Wilcox County, GA	2012	NA	2867	2533	334	11.6
CN1331700000000	13	317	Wilkes County, GA	2012	NA	3841	3372	469	12.2
CN1331900000000	13	319	Wilkinson County, GA	2012	NA	3738	3308	430	11.5
CN1332100000000	13	321	Worth County, GA	2012	NA	9622	8643	979	10.2
CN1500100000000	15	001	Hawaii County, HI	2012	NA	86915	79749	7166	8.2
CN1500300000000	15	003	Honolulu County/city, HI	2012	NA	445702	421553	24149	5.4
CN1500700000000	15	007	Kauai County, HI	2012	NA	34563	32081	2482	7.2
CN1500900000000	15	009	Maui County, HI	2012	NA	80005	74918	5087	6.4
CN1600100000000	16	001	Ada County, ID	2012	NA	204353	191714	12639	6.2
CN1600300000000	16	003	Adams County, ID	2012	NA	1743	1483	260	14.9
CN1600500000000	16	005	Bannock County, ID	2012	NA	41203	38349	2854	6.9
CN1600700000000	16	007	Bear Lake County, ID	2012	NA	2882	2721	161	5.6
CN1600900000000	16	009	Benewah County, ID	2012	NA	4159	3653	506	12.2
CN1601100000000	16	011	Bingham County, ID	2012	NA	22774	21319	1455	6.4
CN1601300000000	16	013	Blaine County, ID	2012	NA	11726	10903	823	7
CN1601500000000	16	015	Boise County, ID	2012	NA	2968	2685	283	9.5
CN1601700000000	16	017	Bonner County, ID	2012	NA	18610	16662	1948	10.5
CN1601900000000	16	019	Bonneville County, ID	2012	NA	49127	46022	3105	6.3
CN1602100000000	16	021	Boundary County, ID	2012	NA	5221	4729	492	9.4
CN1602300000000	16	023	Butte County, ID	2012	NA	1336	1227	109	8.2
CN1602500000000	16	025	Camas County, ID	2012	NA	668	607	61	9.1
CN1602700000000	16	027	Canyon County, ID	2012	NA	86977	79059	7918	9.1
CN1602900000000	16	029	Caribou County, ID	2012	NA	3973	3731	242	6.1
CN1603100000000	16	031	Cassia County, ID	2012	NA	11116	10472	644	5.8
CN1603300000000	16	033	Clark County, ID	2012	NA	424	392	32	7.5
CN1603500000000	16	035	Clearwater County, ID	2012	NA	3272	2860	412	12.6
CN1603700000000	16	037	Custer County, ID	2012	NA	2336	2147	189	8.1
CN1603900000000	16	039	Elmore County, ID	2012	NA	10678	9874	804	7.5
CN1604100000000	16	041	Franklin County, ID	2012	NA	6311	6020	291	4.6
CN1604300000000	16	043	Fremont County, ID	2012	NA	6928	6500	428	6.2
CN1604500000000	16	045	Gem County, ID	2012	NA	7614	6898	716	9.4
CN1604700000000	16	047	Gooding County, ID	2012	NA	8093	7631	462	5.7
CN1604900000000	16	049	Idaho County, ID	2012	NA	6650	5922	728	10.9
CN1605100000000	16	051	Jefferson County, ID	2012	NA	12197	11447	750	6.1
CN1605300000000	16	053	Jerome County, ID	2012	NA	10878	10173	705	6.5
CN1605500000000	16	055	Kootenai County, ID	2012	NA	68654	62636	6018	8.8
CN1605700000000	16	057	Latah County, ID	2012	NA	19634	18489	1145	5.8
CN1605900000000	16	059	Lemhi County, ID	2012	NA	3569	3218	351	9.8
CN1606100000000	16	061	Lewis County, ID	2012	NA	1597	1511	86	5.4
CN1606300000000	16	063	Lincoln County, ID	2012	NA	2699	2452	247	9.2
CN1606500000000	16	065	Madison County, ID	2012	NA	18434	17593	841	4.6
CN1606700000000	16	067	Minidoka County, ID	2012	NA	10383	9752	631	6.1
CN1606900000000	16	069	Nez Perce County, ID	2012	NA	19881	18737	1144	5.8
CN1607100000000	16	071	Oneida County, ID	2012	NA	2093	1990	103	4.9
CN1607300000000	16	073	Owyhee County, ID	2012	NA	5104	4893	211	4.1
CN1607500000000	16	075	Payette County, ID	2012	NA	10843	9991	852	7.9
CN1607700000000	16	077	Power County, ID	2012	NA	4089	3771	318	7.8
CN1607900000000	16	079	Shoshone County, ID	2012	NA	5609	4873	736	13.1
CN1608100000000	16	081	Teton County, ID	2012	NA	5315	5002	313	5.9
CN1608300000000	16	083	Twin Falls County, ID	2012	NA	37673	35064	2609	6.9
CN1608500000000	16	085	Valley County, ID	2012	NA	4674	4150	524	11.2
CN1608700000000	16	087	Washington County, ID	2012	NA	4786	4383	403	8.4
CN1700100000000	17	001	Adams County, IL	2012	NA	33891	31679	2212	6.5
CN1700300000000	17	003	Alexander County, IL	2012	NA	2759	2430	329	11.9
CN1700500000000	17	005	Bond County, IL	2012	NA	8279	7538	741	9
CN1700700000000	17	007	Boone County, IL	2012	NA	26839	24044	2795	10.4
CN1700900000000	17	009	Brown County, IL	2012	NA	2629	2473	156	5.9
CN1701100000000	17	011	Bureau County, IL	2012	NA	18209	16536	1673	9.2
CN1701300000000	17	013	Calhoun County, IL	2012	NA	2448	2203	245	10
CN1701500000000	17	015	Carroll County, IL	2012	NA	8063	7404	659	8.2
CN1701700000000	17	017	Cass County, IL	2012	NA	6604	6045	559	8.5
CN1701900000000	17	019	Champaign County, IL	2012	NA	107670	100071	7599	7.1
CN1702100000000	17	021	Christian County, IL	2012	NA	16506	14963	1543	9.3
CN1702300000000	17	023	Clark County, IL	2012	NA	8033	7263	770	9.6
CN1702500000000	17	025	Clay County, IL	2012	NA	6652	6012	640	9.6
CN1702700000000	17	027	Clinton County, IL	2012	NA	20370	19017	1353	6.6
CN1702900000000	17	029	Coles County, IL	2012	NA	24847	22669	2178	8.8
CN1703100000000	17	031	Cook County, IL	2012	NA	2653324	2397790	255534	9.6
CN1703300000000	17	033	Crawford County, IL	2012	NA	10445	9641	804	7.7
CN1703500000000	17	035	Cumberland County, IL	2012	NA	5963	5500	463	7.8
CN1703700000000	17	037	DeKalb County, IL	2012	NA	55702	51009	4693	8.4
CN1703900000000	17	039	De Witt County, IL	2012	NA	8519	7834	685	8
CN1704100000000	17	041	Douglas County, IL	2012	NA	10027	9307	720	7.2
CN1704300000000	17	043	DuPage County, IL	2012	NA	506425	468487	37938	7.5
CN1704500000000	17	045	Edgar County, IL	2012	NA	9128	8245	883	9.7
CN1704700000000	17	047	Edwards County, IL	2012	NA	3059	2820	239	7.8
CN1704900000000	17	049	Effingham County, IL	2012	NA	18521	17310	1211	6.5
CN1705100000000	17	051	Fayette County, IL	2012	NA	10697	9737	960	9
CN1705300000000	17	053	Ford County, IL	2012	NA	6990	6470	520	7.4
CN1705500000000	17	055	Franklin County, IL	2012	NA	17404	15554	1850	10.6
CN1705700000000	17	057	Fulton County, IL	2012	NA	16953	15274	1679	9.9
CN1705900000000	17	059	Gallatin County, IL	2012	NA	2526	2314	212	8.4
CN1706100000000	17	061	Greene County, IL	2012	NA	6483	5937	546	8.4
CN1706300000000	17	063	Grundy County, IL	2012	NA	25754	22796	2958	11.5
CN1706500000000	17	065	Hamilton County, IL	2012	NA	3924	3612	312	8
CN1706700000000	17	067	Hancock County, IL	2012	NA	9276	8508	768	8.3
CN1706900000000	17	069	Hardin County, IL	2012	NA	1736	1553	183	10.5
CN1707100000000	17	071	Henderson County, IL	2012	NA	3731	3434	297	8
CN1707300000000	17	073	Henry County, IL	2012	NA	26261	24321	1940	7.4
CN1707500000000	17	075	Iroquois County, IL	2012	NA	15236	13931	1305	8.6
CN1707700000000	17	077	Jackson County, IL	2012	NA	29201	26918	2283	7.8
CN1707900000000	17	079	Jasper County, IL	2012	NA	4940	4563	377	7.6
CN1708100000000	17	081	Jefferson County, IL	2012	NA	17895	16250	1645	9.2
CN1708300000000	17	083	Jersey County, IL	2012	NA	11400	10373	1027	9
CN1708500000000	17	085	Jo Daviess County, IL	2012	NA	11884	10986	898	7.6
CN1708700000000	17	087	Johnson County, IL	2012	NA	4305	3807	498	11.6
CN1708900000000	17	089	Kane County, IL	2012	NA	268052	244255	23797	8.9
CN1709100000000	17	091	Kankakee County, IL	2012	NA	55602	49724	5878	10.6
CN1709300000000	17	093	Kendall County, IL	2012	NA	63486	58179	5307	8.4
CN1709500000000	17	095	Knox County, IL	2012	NA	24401	22372	2029	8.3
CN1709700000000	17	097	Lake County, IL	2012	NA	367160	337379	29781	8.1
CN1709900000000	17	099	LaSalle County, IL	2012	NA	59555	53579	5976	10
CN1710100000000	17	101	Lawrence County, IL	2012	NA	6481	5821	660	10.2
CN1710300000000	17	103	Lee County, IL	2012	NA	18237	16726	1511	8.3
CN1710500000000	17	105	Livingston County, IL	2012	NA	18226	16817	1409	7.7
CN1710700000000	17	107	Logan County, IL	2012	NA	13512	12499	1013	7.5
CN1710900000000	17	109	McDonough County, IL	2012	NA	15016	13867	1149	7.7
CN1711100000000	17	111	McHenry County, IL	2012	NA	167013	152015	14998	9
CN1711300000000	17	113	McLean County, IL	2012	NA	94936	88904	6032	6.4
CN1711500000000	17	115	Macon County, IL	2012	NA	54579	49194	5385	9.9
CN1711700000000	17	117	Macoupin County, IL	2012	NA	24067	21785	2282	9.5
CN1711900000000	17	119	Madison County, IL	2012	NA	135675	123737	11938	8.8
CN1712100000000	17	121	Marion County, IL	2012	NA	18672	16846	1826	9.8
CN1712300000000	17	123	Marshall County, IL	2012	NA	6221	5705	516	8.3
CN1712500000000	17	125	Mason County, IL	2012	NA	7013	6310	703	10
CN1712700000000	17	127	Massac County, IL	2012	NA	6575	5944	631	9.6
CN1712900000000	17	129	Menard County, IL	2012	NA	6883	6392	491	7.1
CN1713100000000	17	131	Mercer County, IL	2012	NA	8671	8002	669	7.7
CN1713300000000	17	133	Monroe County, IL	2012	NA	17943	16735	1208	6.7
CN1713500000000	17	135	Montgomery County, IL	2012	NA	13170	11695	1475	11.2
CN1713700000000	17	137	Morgan County, IL	2012	NA	17730	16363	1367	7.7
CN1713900000000	17	139	Moultrie County, IL	2012	NA	7399	6872	527	7.1
CN1714100000000	17	141	Ogle County, IL	2012	NA	26641	23953	2688	10.1
CN1714300000000	17	143	Peoria County, IL	2012	NA	96178	88122	8056	8.4
CN1714500000000	17	145	Perry County, IL	2012	NA	9231	8253	978	10.6
CN1714700000000	17	147	Piatt County, IL	2012	NA	8849	8254	595	6.7
CN1714900000000	17	149	Pike County, IL	2012	NA	7798	7210	588	7.5
CN1715100000000	17	151	Pope County, IL	2012	NA	1892	1730	162	8.6
CN1715300000000	17	153	Pulaski County, IL	2012	NA	2377	2107	270	11.4
CN1715500000000	17	155	Putnam County, IL	2012	NA	3137	2845	292	9.3
CN1715700000000	17	157	Randolph County, IL	2012	NA	14614	13391	1223	8.4
CN1715900000000	17	159	Richland County, IL	2012	NA	7549	6944	605	8
CN1716100000000	17	161	Rock Island County, IL	2012	NA	75652	69602	6050	8
CN1716300000000	17	163	St. Clair County, IL	2012	NA	130402	117960	12442	9.5
CN1716500000000	17	165	Saline County, IL	2012	NA	11652	10595	1057	9.1
CN1716700000000	17	167	Sangamon County, IL	2012	NA	105408	97621	7787	7.4
CN1716900000000	17	169	Schuyler County, IL	2012	NA	3627	3342	285	7.9
CN1717100000000	17	171	Scott County, IL	2012	NA	2705	2470	235	8.7
CN1717300000000	17	173	Shelby County, IL	2012	NA	10803	9879	924	8.6
CN1717500000000	17	175	Stark County, IL	2012	NA	3002	2758	244	8.1
CN1717700000000	17	177	Stephenson County, IL	2012	NA	23515	21394	2121	9
CN1717900000000	17	179	Tazewell County, IL	2012	NA	71467	66126	5341	7.5
CN1718100000000	17	181	Union County, IL	2012	NA	7582	6754	828	10.9
CN1718300000000	17	183	Vermilion County, IL	2012	NA	36961	33535	3426	9.3
CN1718500000000	17	185	Wabash County, IL	2012	NA	5774	5316	458	7.9
CN1718700000000	17	187	Warren County, IL	2012	NA	8934	8300	634	7.1
CN1718900000000	17	189	Washington County, IL	2012	NA	9151	8571	580	6.3
CN1719100000000	17	191	Wayne County, IL	2012	NA	8033	7417	616	7.7
CN1719300000000	17	193	White County, IL	2012	NA	7279	6729	550	7.6
CN1719500000000	17	195	Whiteside County, IL	2012	NA	29502	26910	2592	8.8
CN1719700000000	17	197	Will County, IL	2012	NA	356094	321291	34803	9.8
CN1719900000000	17	199	Williamson County, IL	2012	NA	31863	29113	2750	8.6
CN1720100000000	17	201	Winnebago County, IL	2012	NA	145923	130539	15384	10.5
CN1720300000000	17	203	Woodford County, IL	2012	NA	20501	19274	1227	6
CN1800100000000	18	001	Adams County, IN	2012	NA	15884	14765	1119	7
CN1800300000000	18	003	Allen County, IN	2012	NA	173799	159246	14553	8.4
CN1800500000000	18	005	Bartholomew County, IN	2012	NA	41408	38762	2646	6.4
CN1800700000000	18	007	Benton County, IN	2012	NA	4550	4211	339	7.5
CN1800900000000	18	009	Blackford County, IN	2012	NA	5461	4836	625	11.4
CN1801100000000	18	011	Boone County, IN	2012	NA	30227	28388	1839	6.1
CN1801300000000	18	013	Brown County, IN	2012	NA	7322	6736	586	8
CN1801500000000	18	015	Carroll County, IN	2012	NA	9985	9251	734	7.4
CN1801700000000	18	017	Cass County, IN	2012	NA	17781	16249	1532	8.6
CN1801900000000	18	019	Clark County, IN	2012	NA	55404	51070	4334	7.8
CN1802100000000	18	021	Clay County, IN	2012	NA	12808	11545	1263	9.9
CN1802300000000	18	023	Clinton County, IN	2012	NA	16568	15239	1329	8
CN1802500000000	18	025	Crawford County, IN	2012	NA	4791	4282	509	10.6
CN1802700000000	18	027	Daviess County, IN	2012	NA	14790	13900	890	6
CN1802900000000	18	029	Dearborn County, IN	2012	NA	24979	22755	2224	8.9
CN1803100000000	18	031	Decatur County, IN	2012	NA	13583	12481	1102	8.1
CN1803300000000	18	033	DeKalb County, IN	2012	NA	20569	18852	1717	8.3
CN1803500000000	18	035	Delaware County, IN	2012	NA	54898	49755	5143	9.4
CN1803700000000	18	037	Dubois County, IN	2012	NA	21582	20351	1231	5.7
CN1803900000000	18	039	Elkhart County, IN	2012	NA	96848	88195	8653	8.9
CN1804100000000	18	041	Fayette County, IN	2012	NA	9165	8144	1021	11.1
CN1804300000000	18	043	Floyd County, IN	2012	NA	37784	35095	2689	7.1
CN1804500000000	18	045	Fountain County, IN	2012	NA	8532	7815	717	8.4
CN1804700000000	18	047	Franklin County, IN	2012	NA	10558	9553	1005	9.5
CN1804900000000	18	049	Fulton County, IN	2012	NA	10083	9238	845	8.4
CN1805100000000	18	051	Gibson County, IN	2012	NA	17396	16205	1191	6.8
CN1805300000000	18	053	Grant County, IN	2012	NA	32336	29189	3147	9.7
CN1805500000000	18	055	Greene County, IN	2012	NA	13811	12367	1444	10.5
CN1805700000000	18	057	Hamilton County, IN	2012	NA	151112	143091	8021	5.3
CN1805900000000	18	059	Hancock County, IN	2012	NA	35729	33107	2622	7.3
CN1806100000000	18	061	Harrison County, IN	2012	NA	18557	17124	1433	7.7
CN1806300000000	18	063	Hendricks County, IN	2012	NA	76893	72027	4866	6.3
CN1806500000000	18	065	Henry County, IN	2012	NA	21143	19018	2125	10.1
CN1806700000000	18	067	Howard County, IN	2012	NA	35916	32658	3258	9.1
CN1806900000000	18	069	Huntington County, IN	2012	NA	18587	16950	1637	8.8
CN1807100000000	18	071	Jackson County, IN	2012	NA	20486	18957	1529	7.5
CN1807300000000	18	073	Jasper County, IN	2012	NA	15970	14674	1296	8.1
CN1807500000000	18	075	Jay County, IN	2012	NA	10084	9285	799	7.9
CN1807700000000	18	077	Jefferson County, IN	2012	NA	15221	13930	1291	8.5
CN1807900000000	18	079	Jennings County, IN	2012	NA	13111	11760	1351	10.3
CN1808100000000	18	081	Johnson County, IN	2012	NA	72543	67491	5052	7
CN1808300000000	18	083	Knox County, IN	2012	NA	18717	17381	1336	7.1
CN1808500000000	18	085	Kosciusko County, IN	2012	NA	38740	35758	2982	7.7
CN1808700000000	18	087	LaGrange County, IN	2012	NA	17001	15792	1209	7.1
CN1808900000000	18	089	Lake County, IN	2012	NA	228905	208032	20873	9.1
CN1809100000000	18	091	LaPorte County, IN	2012	NA	49697	44849	4848	9.8
CN1809300000000	18	093	Lawrence County, IN	2012	NA	20554	18301	2253	11
CN1809500000000	18	095	Madison County, IN	2012	NA	57995	52201	5794	10
CN1809700000000	18	097	Marion County, IN	2012	NA	458377	416087	42290	9.2
CN1809900000000	18	099	Marshall County, IN	2012	NA	22963	21074	1889	8.2
CN1810100000000	18	101	Martin County, IN	2012	NA	5077	4717	360	7.1
CN1810300000000	18	103	Miami County, IN	2012	NA	15633	14113	1520	9.7
CN1810500000000	18	105	Monroe County, IN	2012	NA	66747	61899	4848	7.3
CN1810700000000	18	107	Montgomery County, IN	2012	NA	18594	17072	1522	8.2
CN1810900000000	18	109	Morgan County, IN	2012	NA	34688	31769	2919	8.4
CN1811100000000	18	111	Newton County, IN	2012	NA	6923	6258	665	9.6
CN1811300000000	18	113	Noble County, IN	2012	NA	22618	20671	1947	8.6
CN1811500000000	18	115	Ohio County, IN	2012	NA	3181	2898	283	8.9
CN1811700000000	18	117	Orange County, IN	2012	NA	8776	7831	945	10.8
CN1811900000000	18	119	Owen County, IN	2012	NA	9827	8762	1065	10.8
CN1812100000000	18	121	Parke County, IN	2012	NA	6990	6274	716	10.2
CN1812300000000	18	123	Perry County, IN	2012	NA	8873	8128	745	8.4
CN1812500000000	18	125	Pike County, IN	2012	NA	6130	5679	451	7.4
CN1812700000000	18	127	Porter County, IN	2012	NA	82382	76116	6266	7.6
CN1812900000000	18	129	Posey County, IN	2012	NA	13190	12299	891	6.8
CN1813100000000	18	131	Pulaski County, IN	2012	NA	6271	5808	463	7.4
CN1813300000000	18	133	Putnam County, IN	2012	NA	16338	14721	1617	9.9
CN1813500000000	18	135	Randolph County, IN	2012	NA	12761	11541	1220	9.6
CN1813700000000	18	137	Ripley County, IN	2012	NA	13847	12602	1245	9
CN1813900000000	18	139	Rush County, IN	2012	NA	8377	7665	712	8.5
CN1814100000000	18	141	St. Joseph County, IN	2012	NA	127769	115689	12080	9.5
CN1814300000000	18	143	Scott County, IN	2012	NA	10181	9133	1048	10.3
CN1814500000000	18	145	Shelby County, IN	2012	NA	22318	20453	1865	8.4
CN1814700000000	18	147	Spencer County, IN	2012	NA	10791	10012	779	7.2
CN1814900000000	18	149	Starke County, IN	2012	NA	10108	9036	1072	10.6
CN1815100000000	18	151	Steuben County, IN	2012	NA	18914	17536	1378	7.3
CN1815300000000	18	153	Sullivan County, IN	2012	NA	8803	7982	821	9.3
CN1815500000000	18	155	Switzerland County, IN	2012	NA	4890	4512	378	7.7
CN1815700000000	18	157	Tippecanoe County, IN	2012	NA	88448	82294	6154	7
CN1815900000000	18	159	Tipton County, IN	2012	NA	8009	7387	622	7.8
CN1816100000000	18	161	Union County, IN	2012	NA	3557	3270	287	8.1
CN1816300000000	18	163	Vanderburgh County, IN	2012	NA	91824	84785	7039	7.7
CN1816500000000	18	165	Vermillion County, IN	2012	NA	7468	6617	851	11.4
CN1816700000000	18	167	Vigo County, IN	2012	NA	50131	45159	4972	9.9
CN1816900000000	18	169	Wabash County, IN	2012	NA	15693	14361	1332	8.5
CN1817100000000	18	171	Warren County, IN	2012	NA	4198	3888	310	7.4
CN1817300000000	18	173	Warrick County, IN	2012	NA	30814	28718	2096	6.8
CN1817500000000	18	175	Washington County, IN	2012	NA	13174	11930	1244	9.4
CN1817700000000	18	177	Wayne County, IN	2012	NA	30691	27655	3036	9.9
CN1817900000000	18	179	Wells County, IN	2012	NA	13711	12727	984	7.2
CN1818100000000	18	181	White County, IN	2012	NA	13028	12013	1015	7.8
CN1818300000000	18	183	Whitley County, IN	2012	NA	16903	15557	1346	8
CN1900100000000	19	001	Adair County, IA	2012	NA	4047	3870	177	4.4
CN1900300000000	19	003	Adams County, IA	2012	NA	2183	2096	87	4
CN1900500000000	19	005	Allamakee County, IA	2012	NA	7593	7104	489	6.4
CN1900700000000	19	007	Appanoose County, IA	2012	NA	5986	5596	390	6.5
CN1900900000000	19	009	Audubon County, IA	2012	NA	3215	3061	154	4.8
CN1901100000000	19	011	Benton County, IA	2012	NA	13771	13040	731	5.3
CN1901300000000	19	013	Black Hawk County, IA	2012	NA	71210	67341	3869	5.4
CN1901500000000	19	015	Boone County, IA	2012	NA	14568	13937	631	4.3
CN1901700000000	19	017	Bremer County, IA	2012	NA	13864	13332	532	3.8
CN1901900000000	19	019	Buchanan County, IA	2012	NA	11023	10493	530	4.8
CN1902100000000	19	021	Buena Vista County, IA	2012	NA	11224	10757	467	4.2
CN1902300000000	19	023	Butler County, IA	2012	NA	8210	7839	371	4.5
CN1902500000000	19	025	Calhoun County, IA	2012	NA	4427	4183	244	5.5
CN1902700000000	19	027	Carroll County, IA	2012	NA	11335	10910	425	3.7
CN1902900000000	19	029	Cass County, IA	2012	NA	7192	6818	374	5.2
CN1903100000000	19	031	Cedar County, IA	2012	NA	10662	10177	485	4.5
CN1903300000000	19	033	Cerro Gordo County, IA	2012	NA	23718	22393	1325	5.6
CN1903500000000	19	035	Cherokee County, IA	2012	NA	6855	6558	297	4.3
CN1903700000000	19	037	Chickasaw County, IA	2012	NA	6294	5967	327	5.2
CN1903900000000	19	039	Clarke County, IA	2012	NA	4609	4332	277	6
CN1904100000000	19	041	Clay County, IA	2012	NA	8882	8434	448	5
CN1904300000000	19	043	Clayton County, IA	2012	NA	10164	9586	578	5.7
CN1904500000000	19	045	Clinton County, IA	2012	NA	25089	23547	1542	6.1
CN1904700000000	19	047	Crawford County, IA	2012	NA	8755	8364	391	4.5
CN1904900000000	19	049	Dallas County, IA	2012	NA	39157	37627	1530	3.9
CN1905100000000	19	051	Davis County, IA	2012	NA	4090	3854	236	5.8
CN1905300000000	19	053	Decatur County, IA	2012	NA	4242	4054	188	4.4
CN1905500000000	19	055	Delaware County, IA	2012	NA	10254	9795	459	4.5
CN1905700000000	19	057	Des Moines County, IA	2012	NA	20088	18853	1235	6.1
CN1905900000000	19	059	Dickinson County, IA	2012	NA	9177	8659	518	5.6
CN1906100000000	19	061	Dubuque County, IA	2012	NA	54612	52139	2473	4.5
CN1906300000000	19	063	Emmet County, IA	2012	NA	5712	5457	255	4.5
CN1906500000000	19	065	Fayette County, IA	2012	NA	10792	10205	587	5.4
CN1906700000000	19	067	Floyd County, IA	2012	NA	8123	7616	507	6.2
CN1906900000000	19	069	Franklin County, IA	2012	NA	5811	5551	260	4.5
CN1907100000000	19	071	Fremont County, IA	2012	NA	4008	3803	205	5.1
CN1907300000000	19	073	Greene County, IA	2012	NA	5116	4862	254	5
CN1907500000000	19	075	Grundy County, IA	2012	NA	6650	6347	303	4.6
CN1907700000000	19	077	Guthrie County, IA	2012	NA	5554	5242	312	5.6
CN1907900000000	19	079	Hamilton County, IA	2012	NA	7046	6560	486	6.9
CN1908100000000	19	081	Hancock County, IA	2012	NA	5980	5707	273	4.6
CN1908300000000	19	083	Hardin County, IA	2012	NA	8755	8287	468	5.3
CN1908500000000	19	085	Harrison County, IA	2012	NA	7535	7155	380	5
CN1908700000000	19	087	Henry County, IA	2012	NA	9619	9048	571	5.9
CN1908900000000	19	089	Howard County, IA	2012	NA	5199	4959	240	4.6
CN1909100000000	19	091	Humboldt County, IA	2012	NA	5156	4938	218	4.2
CN1909300000000	19	093	Ida County, IA	2012	NA	3772	3620	152	4
CN1909500000000	19	095	Iowa County, IA	2012	NA	9593	9161	432	4.5
CN1909700000000	19	097	Jackson County, IA	2012	NA	10816	10225	591	5.5
CN1909900000000	19	099	Jasper County, IA	2012	NA	18539	17436	1103	5.9
CN1910100000000	19	101	Jefferson County, IA	2012	NA	8759	8299	460	5.3
CN1910300000000	19	103	Johnson County, IA	2012	NA	80279	77324	2955	3.7
CN1910500000000	19	105	Jones County, IA	2012	NA	10674	10112	562	5.3
CN1910700000000	19	107	Keokuk County, IA	2012	NA	5423	5126	297	5.5
CN1910900000000	19	109	Kossuth County, IA	2012	NA	8383	8058	325	3.9
CN1911100000000	19	111	Lee County, IA	2012	NA	17477	16219	1258	7.2
CN1911300000000	19	113	Linn County, IA	2012	NA	118866	112662	6204	5.2
CN1911500000000	19	115	Louisa County, IA	2012	NA	5787	5470	317	5.5
CN1911700000000	19	117	Lucas County, IA	2012	NA	4183	3984	199	4.8
CN1911900000000	19	119	Lyon County, IA	2012	NA	6832	6630	202	3
CN1912100000000	19	121	Madison County, IA	2012	NA	8134	7681	453	5.6
CN1912300000000	19	123	Mahaska County, IA	2012	NA	11635	11032	603	5.2
CN1912500000000	19	125	Marion County, IA	2012	NA	17061	16241	820	4.8
CN1912700000000	19	127	Marshall County, IA	2012	NA	19796	18525	1271	6.4
CN1912900000000	19	129	Mills County, IA	2012	NA	7263	6929	334	4.6
CN1913100000000	19	131	Mitchell County, IA	2012	NA	5551	5298	253	4.6
CN1913300000000	19	133	Monona County, IA	2012	NA	4534	4244	290	6.4
CN1913500000000	19	135	Monroe County, IA	2012	NA	3978	3749	229	5.8
CN1913700000000	19	137	Montgomery County, IA	2012	NA	5031	4775	256	5.1
CN1913900000000	19	139	Muscatine County, IA	2012	NA	21234	20018	1216	5.7
CN1914100000000	19	141	O'Brien County, IA	2012	NA	8039	7733	306	3.8
CN1914300000000	19	143	Osceola County, IA	2012	NA	3383	3243	140	4.1
CN1914500000000	19	145	Page County, IA	2012	NA	6674	6315	359	5.4
CN1914700000000	19	147	Palo Alto County, IA	2012	NA	4756	4553	203	4.3
CN1914900000000	19	149	Plymouth County, IA	2012	NA	14189	13608	581	4.1
CN1915100000000	19	151	Pocahontas County, IA	2012	NA	4161	3993	168	4
CN1915300000000	19	153	Polk County, IA	2012	NA	244092	231443	12649	5.2
CN1915500000000	19	155	Pottawattamie County, IA	2012	NA	48451	46000	2451	5.1
CN1915700000000	19	157	Poweshiek County, IA	2012	NA	10155	9661	494	4.9
CN1915900000000	19	159	Ringgold County, IA	2012	NA	2537	2425	112	4.4
CN1916100000000	19	161	Sac County, IA	2012	NA	5502	5269	233	4.2
CN1916300000000	19	163	Scott County, IA	2012	NA	87236	82233	5003	5.7
CN1916500000000	19	165	Shelby County, IA	2012	NA	6990	6727	263	3.8
CN1916700000000	19	167	Sioux County, IA	2012	NA	19371	18702	669	3.5
CN1916900000000	19	169	Story County, IA	2012	NA	53316	51414	1902	3.6
CN1917100000000	19	171	Tama County, IA	2012	NA	9087	8542	545	6
CN1917300000000	19	173	Taylor County, IA	2012	NA	3142	3014	128	4.1
CN1917500000000	19	175	Union County, IA	2012	NA	6852	6505	347	5.1
CN1917700000000	19	177	Van Buren County, IA	2012	NA	3799	3579	220	5.8
CN1917900000000	19	179	Wapello County, IA	2012	NA	17888	16645	1243	6.9
CN1918100000000	19	181	Warren County, IA	2012	NA	25880	24645	1235	4.8
CN1918300000000	19	183	Washington County, IA	2012	NA	12148	11637	511	4.2
CN1918500000000	19	185	Wayne County, IA	2012	NA	2792	2640	152	5.4
CN1918700000000	19	187	Webster County, IA	2012	NA	19273	18056	1217	6.3
CN1918900000000	19	189	Winnebago County, IA	2012	NA	5115	4842	273	5.3
CN1919100000000	19	191	Winneshiek County, IA	2012	NA	11884	11336	548	4.6
CN1919300000000	19	193	Woodbury County, IA	2012	NA	54272	51436	2836	5.2
CN1919500000000	19	195	Worth County, IA	2012	NA	4220	3990	230	5.5
CN1919700000000	19	197	Wright County, IA	2012	NA	6790	6426	364	5.4
CN2000100000000	20	001	Allen County, KS	2012	NA	6863	6372	491	7.2
CN2000300000000	20	003	Anderson County, KS	2012	NA	4300	4020	280	6.5
CN2000500000000	20	005	Atchison County, KS	2012	NA	7836	7229	607	7.7
CN2000700000000	20	007	Barber County, KS	2012	NA	2730	2624	106	3.9
CN2000900000000	20	009	Barton County, KS	2012	NA	14963	14289	674	4.5
CN2001100000000	20	011	Bourbon County, KS	2012	NA	6715	6199	516	7.7
CN2001300000000	20	013	Brown County, KS	2012	NA	5236	4955	281	5.4
CN2001500000000	20	015	Butler County, KS	2012	NA	31996	30002	1994	6.2
CN2001700000000	20	017	Chase County, KS	2012	NA	1325	1255	70	5.3
CN2001900000000	20	019	Chautauqua County, KS	2012	NA	1695	1584	111	6.5
CN2002100000000	20	021	Cherokee County, KS	2012	NA	10571	9745	826	7.8
CN2002300000000	20	023	Cheyenne County, KS	2012	NA	1330	1282	48	3.6
CN2002500000000	20	025	Clark County, KS	2012	NA	1201	1159	42	3.5
CN2002700000000	20	027	Clay County, KS	2012	NA	4246	4027	219	5.2
CN2002900000000	20	029	Cloud County, KS	2012	NA	4573	4345	228	5
CN2003100000000	20	031	Coffey County, KS	2012	NA	4519	4203	316	7
CN2003300000000	20	033	Comanche County, KS	2012	NA	999	960	39	3.9
CN2003500000000	20	035	Cowley County, KS	2012	NA	17215	16152	1063	6.2
CN2003700000000	20	037	Crawford County, KS	2012	NA	19284	18004	1280	6.6
CN2003900000000	20	039	Decatur County, KS	2012	NA	1401	1339	62	4.4
CN2004100000000	20	041	Dickinson County, KS	2012	NA	10060	9452	608	6
CN2004300000000	20	043	Doniphan County, KS	2012	NA	4392	4117	275	6.3
CN2004500000000	20	045	Douglas County, KS	2012	NA	63496	60235	3261	5.1
CN2004700000000	20	047	Edwards County, KS	2012	NA	1642	1576	66	4
CN2004900000000	20	049	Elk County, KS	2012	NA	1348	1256	92	6.8
CN2005100000000	20	051	Ellis County, KS	2012	NA	18020	17403	617	3.4
CN2005300000000	20	053	Ellsworth County, KS	2012	NA	3487	3365	122	3.5
CN2005500000000	20	055	Finney County, KS	2012	NA	20154	19254	900	4.5
CN2005700000000	20	057	Ford County, KS	2012	NA	18822	18095	727	3.9
CN2005900000000	20	059	Franklin County, KS	2012	NA	13977	12960	1017	7.3
CN2006100000000	20	061	Geary County, KS	2012	NA	12807	11697	1110	8.7
CN2006300000000	20	063	Gove County, KS	2012	NA	1513	1468	45	3
CN2006500000000	20	065	Graham County, KS	2012	NA	1386	1339	47	3.4
CN2006700000000	20	067	Grant County, KS	2012	NA	3987	3832	155	3.9
CN2006900000000	20	069	Gray County, KS	2012	NA	3562	3451	111	3.1
CN2007100000000	20	071	Greeley County, KS	2012	NA	884	857	27	3.1
CN2007300000000	20	073	Greenwood County, KS	2012	NA	3426	3234	192	5.6
CN2007500000000	20	075	Hamilton County, KS	2012	NA	1825	1776	49	2.7
CN2007700000000	20	077	Harper County, KS	2012	NA	3107	2972	135	4.3
CN2007900000000	20	079	Harvey County, KS	2012	NA	17249	16312	937	5.4
CN2008100000000	20	081	Haskell County, KS	2012	NA	2462	2379	83	3.4
CN2008300000000	20	083	Hodgeman County, KS	2012	NA	1111	1073	38	3.4
CN2008500000000	20	085	Jackson County, KS	2012	NA	7345	6932	413	5.6
CN2008700000000	20	087	Jefferson County, KS	2012	NA	10240	9620	620	6.1
CN2008900000000	20	089	Jewell County, KS	2012	NA	1449	1387	62	4.3
CN2009100000000	20	091	Johnson County, KS	2012	NA	310263	296014	14249	4.6
CN2009300000000	20	093	Kearny County, KS	2012	NA	2170	2084	86	4
CN2009500000000	20	095	Kingman County, KS	2012	NA	3768	3537	231	6.1
CN2009700000000	20	097	Kiowa County, KS	2012	NA	1407	1354	53	3.8
CN2009900000000	20	099	Labette County, KS	2012	NA	10711	9858	853	8
CN2010100000000	20	101	Lane County, KS	2012	NA	900	859	41	4.6
CN2010300000000	20	103	Leavenworth County, KS	2012	NA	34446	32240	2206	6.4
CN2010500000000	20	105	Lincoln County, KS	2012	NA	1847	1757	90	4.9
CN2010700000000	20	107	Linn County, KS	2012	NA	4382	3949	433	9.9
CN2010900000000	20	109	Logan County, KS	2012	NA	1754	1701	53	3
CN2011100000000	20	111	Lyon County, KS	2012	NA	17227	16227	1000	5.8
CN2011300000000	20	113	McPherson County, KS	2012	NA	16654	15969	685	4.1
CN2011500000000	20	115	Marion County, KS	2012	NA	6344	6019	325	5.1
CN2011700000000	20	117	Marshall County, KS	2012	NA	6084	5830	254	4.2
CN2011900000000	20	119	Meade County, KS	2012	NA	2470	2387	83	3.4
CN2012100000000	20	121	Miami County, KS	2012	NA	16755	15694	1061	6.3
CN2012300000000	20	123	Mitchell County, KS	2012	NA	3868	3752	116	3
CN2012500000000	20	125	Montgomery County, KS	2012	NA	18407	16984	1423	7.7
CN2012700000000	20	127	Morris County, KS	2012	NA	3203	3008	195	6.1
CN2012900000000	20	129	Morton County, KS	2012	NA	1655	1594	61	3.7
CN2013100000000	20	131	Nemaha County, KS	2012	NA	5997	5780	217	3.6
CN2013300000000	20	133	Neosho County, KS	2012	NA	6895	6288	607	8.8
CN2013500000000	20	135	Ness County, KS	2012	NA	1626	1573	53	3.3
CN2013700000000	20	137	Norton County, KS	2012	NA	3144	3046	98	3.1
CN2013900000000	20	139	Osage County, KS	2012	NA	8343	7738	605	7.3
CN2014100000000	20	141	Osborne County, KS	2012	NA	2172	2079	93	4.3
CN2014300000000	20	143	Ottawa County, KS	2012	NA	3220	3046	174	5.4
CN2014500000000	20	145	Pawnee County, KS	2012	NA	3421	3281	140	4.1
CN2014700000000	20	147	Phillips County, KS	2012	NA	3012	2877	135	4.5
CN2014900000000	20	149	Pottawatomie County, KS	2012	NA	11582	11038	544	4.7
CN2015100000000	20	151	Pratt County, KS	2012	NA	5436	5192	244	4.5
CN2015300000000	20	153	Rawlins County, KS	2012	NA	1569	1526	43	2.7
CN2015500000000	20	155	Reno County, KS	2012	NA	32067	30318	1749	5.5
CN2015700000000	20	157	Republic County, KS	2012	NA	2611	2511	100	3.8
CN2015900000000	20	159	Rice County, KS	2012	NA	5403	5162	241	4.5
CN2016100000000	20	161	Riley County, KS	2012	NA	36247	34667	1580	4.4
CN2016300000000	20	163	Rooks County, KS	2012	NA	2767	2639	128	4.6
CN2016500000000	20	165	Rush County, KS	2012	NA	1891	1803	88	4.7
CN2016700000000	20	167	Russell County, KS	2012	NA	3808	3652	156	4.1
CN2016900000000	20	169	Saline County, KS	2012	NA	30708	28940	1768	5.8
CN2017100000000	20	171	Scott County, KS	2012	NA	2775	2690	85	3.1
CN2017300000000	20	173	Sedgwick County, KS	2012	NA	246743	229760	16983	6.9
CN2017500000000	20	175	Seward County, KS	2012	NA	10828	10383	445	4.1
CN2017700000000	20	177	Shawnee County, KS	2012	NA	91978	86288	5690	6.2
CN2017900000000	20	179	Sheridan County, KS	2012	NA	1546	1503	43	2.8
CN2018100000000	20	181	Sherman County, KS	2012	NA	3217	3094	123	3.8
CN2018300000000	20	183	Smith County, KS	2012	NA	2215	2128	87	3.9
CN2018500000000	20	185	Stafford County, KS	2012	NA	2218	2115	103	4.6
CN2018700000000	20	187	Stanton County, KS	2012	NA	1048	1011	37	3.5
CN2018900000000	20	189	Stevens County, KS	2012	NA	2886	2784	102	3.5
CN2019100000000	20	191	Sumner County, KS	2012	NA	11298	10578	720	6.4
CN2019300000000	20	193	Thomas County, KS	2012	NA	4542	4385	157	3.5
CN2019500000000	20	195	Trego County, KS	2012	NA	1509	1444	65	4.3
CN2019700000000	20	197	Wabaunsee County, KS	2012	NA	3786	3581	205	5.4
CN2019900000000	20	199	Wallace County, KS	2012	NA	872	835	37	4.2
CN2020100000000	20	201	Washington County, KS	2012	NA	3248	3113	135	4.2
CN2020300000000	20	203	Wichita County, KS	2012	NA	1332	1262	70	5.3
CN2020500000000	20	205	Wilson County, KS	2012	NA	4188	3772	416	9.9
CN2020700000000	20	207	Woodson County, KS	2012	NA	1644	1542	102	6.2
CN2020900000000	20	209	Wyandotte County, KS	2012	NA	74381	68103	6278	8.4
CN2100100000000	21	001	Adair County, KY	2012	NA	7826	7083	743	9.5
CN2100300000000	21	003	Allen County, KY	2012	NA	9024	8302	722	8
CN2100500000000	21	005	Anderson County, KY	2012	NA	11540	10744	796	6.9
CN2100700000000	21	007	Ballard County, KY	2012	NA	3881	3527	354	9.1
CN2100900000000	21	009	Barren County, KY	2012	NA	19833	18273	1560	7.9
CN2101100000000	21	011	Bath County, KY	2012	NA	4890	4382	508	10.4
CN2101300000000	21	013	Bell County, KY	2012	NA	10269	9043	1226	11.9
CN2101500000000	21	015	Boone County, KY	2012	NA	65398	60924	4474	6.8
CN2101700000000	21	017	Bourbon County, KY	2012	NA	9847	9132	715	7.3
CN2101900000000	21	019	Boyd County, KY	2012	NA	20080	18210	1870	9.3
CN2102100000000	21	021	Boyle County, KY	2012	NA	13074	11900	1174	9
CN2102300000000	21	023	Bracken County, KY	2012	NA	3950	3577	373	9.4
CN2102500000000	21	025	Breathitt County, KY	2012	NA	4538	3882	656	14.5
CN2102700000000	21	027	Breckinridge County, KY	2012	NA	8282	7482	800	9.7
CN2102900000000	21	029	Bullitt County, KY	2012	NA	39265	36099	3166	8.1
CN2103100000000	21	031	Butler County, KY	2012	NA	5411	4925	486	9
CN2103300000000	21	033	Caldwell County, KY	2012	NA	5677	5205	472	8.3
CN2103500000000	21	035	Calloway County, KY	2012	NA	18306	17014	1292	7.1
CN2103700000000	21	037	Campbell County, KY	2012	NA	48813	45437	3376	6.9
CN2103900000000	21	039	Carlisle County, KY	2012	NA	2341	2154	187	8
CN2104100000000	21	041	Carroll County, KY	2012	NA	5065	4547	518	10.2
CN2104300000000	21	043	Carter County, KY	2012	NA	11492	10056	1436	12.5
CN2104500000000	21	045	Casey County, KY	2012	NA	6861	6287	574	8.4
CN2104700000000	21	047	Christian County, KY	2012	NA	26742	24249	2493	9.3
CN2104900000000	21	049	Clark County, KY	2012	NA	17416	15998	1418	8.1
CN2105100000000	21	051	Clay County, KY	2012	NA	5956	5123	833	14
CN2105300000000	21	053	Clinton County, KY	2012	NA	4250	3788	462	10.9
CN2105500000000	21	055	Crittenden County, KY	2012	NA	4159	3839	320	7.7
CN2105700000000	21	057	Cumberland County, KY	2012	NA	3119	2783	336	10.8
CN2105900000000	21	059	Daviess County, KY	2012	NA	48254	44882	3372	7
CN2106100000000	21	061	Edmonson County, KY	2012	NA	5033	4532	501	10
CN2106300000000	21	063	Elliott County, KY	2012	NA	2304	1973	331	14.4
CN2106500000000	21	065	Estill County, KY	2012	NA	5619	5058	561	10
CN2106700000000	21	067	Fayette County, KY	2012	NA	166267	156579	9688	5.8
CN2106900000000	21	069	Fleming County, KY	2012	NA	6478	5892	586	9
CN2107100000000	21	071	Floyd County, KY	2012	NA	13738	12144	1594	11.6
CN2107300000000	21	073	Franklin County, KY	2012	NA	24555	22914	1641	6.7
CN2107500000000	21	075	Fulton County, KY	2012	NA	2483	2202	281	11.3
CN2107700000000	21	077	Gallatin County, KY	2012	NA	3944	3576	368	9.3
CN2107900000000	21	079	Garrard County, KY	2012	NA	7752	7098	654	8.4
CN2108100000000	21	081	Grant County, KY	2012	NA	11501	10462	1039	9
CN2108300000000	21	083	Graves County, KY	2012	NA	16667	15293	1374	8.2
CN2108500000000	21	085	Grayson County, KY	2012	NA	11312	10150	1162	10.3
CN2108700000000	21	087	Green County, KY	2012	NA	5454	5000	454	8.3
CN2108900000000	21	089	Greenup County, KY	2012	NA	15042	13553	1489	9.9
CN2109100000000	21	091	Hancock County, KY	2012	NA	4150	3853	297	7.2
CN2109300000000	21	093	Hardin County, KY	2012	NA	47576	43682	3894	8.2
CN2109500000000	21	095	Harlan County, KY	2012	NA	9926	8527	1399	14.1
CN2109700000000	21	097	Harrison County, KY	2012	NA	8901	8199	702	7.9
CN2109900000000	21	099	Hart County, KY	2012	NA	8138	7464	674	8.3
CN2110100000000	21	101	Henderson County, KY	2012	NA	22636	20932	1704	7.5
CN2110300000000	21	103	Henry County, KY	2012	NA	7700	7138	562	7.3
CN2110500000000	21	105	Hickman County, KY	2012	NA	2165	1990	175	8.1
CN2110700000000	21	107	Hopkins County, KY	2012	NA	21582	19918	1664	7.7
CN2110900000000	21	109	Jackson County, KY	2012	NA	5177	4568	609	11.8
CN2111100000000	21	111	Jefferson County, KY	2012	NA	382602	352234	30368	7.9
CN2111300000000	21	113	Jessamine County, KY	2012	NA	24812	23151	1661	6.7
CN2111500000000	21	115	Johnson County, KY	2012	NA	8597	7724	873	10.2
CN2111700000000	21	117	Kenton County, KY	2012	NA	84380	78150	6230	7.4
CN2111900000000	21	119	Knott County, KY	2012	NA	5829	5025	804	13.8
CN2112100000000	21	121	Knox County, KY	2012	NA	10555	9201	1354	12.8
CN2112300000000	21	123	Larue County, KY	2012	NA	5950	5440	510	8.6
CN2112500000000	21	125	Laurel County, KY	2012	NA	24895	22361	2534	10.2
CN2112700000000	21	127	Lawrence County, KY	2012	NA	5636	5039	597	10.6
CN2112900000000	21	129	Lee County, KY	2012	NA	2431	2124	307	12.6
CN2113100000000	21	131	Leslie County, KY	2012	NA	3594	3081	513	14.3
CN2113300000000	21	133	Letcher County, KY	2012	NA	8582	7425	1157	13.5
CN2113500000000	21	135	Lewis County, KY	2012	NA	5382	4755	627	11.6
CN2113700000000	21	137	Lincoln County, KY	2012	NA	10102	9062	1040	10.3
CN2113900000000	21	139	Livingston County, KY	2012	NA	3973	3588	385	9.7
CN2114100000000	21	141	Logan County, KY	2012	NA	12192	11271	921	7.6
CN2114300000000	21	143	Lyon County, KY	2012	NA	3102	2817	285	9.2
CN2114500000000	21	145	McCracken County, KY	2012	NA	30912	28451	2461	8
CN2114700000000	21	147	McCreary County, KY	2012	NA	5475	4753	722	13.2
CN2114900000000	21	149	McLean County, KY	2012	NA	4560	4212	348	7.6
CN2115100000000	21	151	Madison County, KY	2012	NA	44628	41617	3011	6.7
CN2115300000000	21	153	Magoffin County, KY	2012	NA	4036	3343	693	17.2
CN2115500000000	21	155	Marion County, KY	2012	NA	9175	8363	812	8.9
CN2115700000000	21	157	Marshall County, KY	2012	NA	15369	14125	1244	8.1
CN2115900000000	21	159	Martin County, KY	2012	NA	3768	3424	344	9.1
CN2116100000000	21	161	Mason County, KY	2012	NA	7619	6901	718	9.4
CN2116300000000	21	163	Meade County, KY	2012	NA	12631	11398	1233	9.8
CN2116500000000	21	165	Menifee County, KY	2012	NA	2545	2249	296	11.6
CN2116700000000	21	167	Mercer County, KY	2012	NA	10246	9401	845	8.2
CN2116900000000	21	169	Metcalfe County, KY	2012	NA	4426	4074	352	8
CN2117100000000	21	171	Monroe County, KY	2012	NA	4800	4454	346	7.2
CN2117300000000	21	173	Montgomery County, KY	2012	NA	12326	11237	1089	8.8
CN2117500000000	21	175	Morgan County, KY	2012	NA	5221	4666	555	10.6
CN2117700000000	21	177	Muhlenberg County, KY	2012	NA	12413	11198	1215	9.8
CN2117900000000	21	179	Nelson County, KY	2012	NA	21897	20086	1811	8.3
CN2118100000000	21	181	Nicholas County, KY	2012	NA	3535	3244	291	8.2
CN2118300000000	21	183	Ohio County, KY	2012	NA	10383	9482	901	8.7
CN2118500000000	21	185	Oldham County, KY	2012	NA	29797	28045	1752	5.9
CN2118700000000	21	187	Owen County, KY	2012	NA	5750	5373	377	6.6
CN2118900000000	21	189	Owsley County, KY	2012	NA	1327	1157	170	12.8
CN2119100000000	21	191	Pendleton County, KY	2012	NA	7064	6440	624	8.8
CN2119300000000	21	193	Perry County, KY	2012	NA	10957	9582	1375	12.5
CN2119500000000	21	195	Pike County, KY	2012	NA	24197	21855	2342	9.7
CN2119700000000	21	197	Powell County, KY	2012	NA	5069	4516	553	10.9
CN2119900000000	21	199	Pulaski County, KY	2012	NA	27305	24725	2580	9.4
CN2120100000000	21	201	Robertson County, KY	2012	NA	849	762	87	10.2
CN2120300000000	21	203	Rockcastle County, KY	2012	NA	7190	6457	733	10.2
CN2120500000000	21	205	Rowan County, KY	2012	NA	11189	10258	931	8.3
CN2120700000000	21	207	Russell County, KY	2012	NA	7224	6478	746	10.3
CN2120900000000	21	209	Scott County, KY	2012	NA	25810	24124	1686	6.5
CN2121100000000	21	211	Shelby County, KY	2012	NA	22277	20888	1389	6.2
CN2121300000000	21	213	Simpson County, KY	2012	NA	8965	8200	765	8.5
CN2121500000000	21	215	Spencer County, KY	2012	NA	9263	8611	652	7
CN2121700000000	21	217	Taylor County, KY	2012	NA	11685	10565	1120	9.6
CN2121900000000	21	219	Todd County, KY	2012	NA	5674	5243	431	7.6
CN2122100000000	21	221	Trigg County, KY	2012	NA	6034	5469	565	9.4
CN2122300000000	21	223	Trimble County, KY	2012	NA	3988	3628	360	9
CN2122500000000	21	225	Union County, KY	2012	NA	7024	6476	548	7.8
CN2122700000000	21	227	Warren County, KY	2012	NA	59961	55795	4166	6.9
CN2122900000000	21	229	Washington County, KY	2012	NA	6211	5746	465	7.5
CN2123100000000	21	231	Wayne County, KY	2012	NA	7733	6730	1003	13
CN2123300000000	21	233	Webster County, KY	2012	NA	6252	5808	444	7.1
CN2123500000000	21	235	Whitley County, KY	2012	NA	13879	12400	1479	10.7
CN2123700000000	21	237	Wolfe County, KY	2012	NA	2103	1804	299	14.2
CN2123900000000	21	239	Woodford County, KY	2012	NA	14127	13369	758	5.4
CN2200100000000	22	001	Acadia Parish, LA	2012	NA	26135	24571	1564	6
CN2200300000000	22	003	Allen Parish, LA	2012	NA	9098	8372	726	8
CN2200500000000	22	005	Ascension Parish, LA	2012	NA	54849	51502	3347	6.1
CN2200700000000	22	007	Assumption Parish, LA	2012	NA	9950	8988	962	9.7
CN2200900000000	22	009	Avoyelles Parish, LA	2012	NA	16369	15130	1239	7.6
CN2201100000000	22	011	Beauregard Parish, LA	2012	NA	14413	13327	1086	7.5
CN2201300000000	22	013	Bienville Parish, LA	2012	NA	5954	5417	537	9
CN2201500000000	22	015	Bossier Parish, LA	2012	NA	57312	54006	3306	5.8
CN2201700000000	22	017	Caddo Parish, LA	2012	NA	113533	104787	8746	7.7
CN2201900000000	22	019	Calcasieu Parish, LA	2012	NA	87905	81839	6066	6.9
CN2202100000000	22	021	Caldwell Parish, LA	2012	NA	4003	3653	350	8.7
CN2202300000000	22	023	Cameron Parish, LA	2012	NA	3226	3057	169	5.2
CN2202500000000	22	025	Catahoula Parish, LA	2012	NA	3918	3568	350	8.9
CN2202700000000	22	027	Claiborne Parish, LA	2012	NA	7021	6498	523	7.4
CN2202900000000	22	029	Concordia Parish, LA	2012	NA	7827	7137	690	8.8
CN2203100000000	22	031	De Soto Parish, LA	2012	NA	11195	10188	1007	9
CN2203300000000	22	033	East Baton Rouge Parish, LA	2012	NA	222248	207284	14964	6.7
CN2203500000000	22	035	East Carroll Parish, LA	2012	NA	2190	1751	439	20
CN2203700000000	22	037	East Feliciana Parish, LA	2012	NA	7960	7361	599	7.5
CN2203900000000	22	039	Evangeline Parish, LA	2012	NA	12833	11882	951	7.4
CN2204100000000	22	041	Franklin Parish, LA	2012	NA	7696	6896	800	10.4
CN2204300000000	22	043	Grant Parish, LA	2012	NA	8224	7574	650	7.9
CN2204500000000	22	045	Iberia Parish, LA	2012	NA	32236	30056	2180	6.8
CN2204700000000	22	047	Iberville Parish, LA	2012	NA	13892	12589	1303	9.4
CN2204900000000	22	049	Jackson Parish, LA	2012	NA	6831	6366	465	6.8
CN2205100000000	22	051	Jefferson Parish, LA	2012	NA	212225	198018	14207	6.7
CN2205300000000	22	053	Jefferson Davis Parish, LA	2012	NA	12975	12131	844	6.5
CN2205500000000	22	055	Lafayette Parish, LA	2012	NA	116591	110733	5858	5
CN2205700000000	22	057	Lafourche Parish, LA	2012	NA	45425	43027	2398	5.3
CN2205900000000	22	059	LaSalle Parish, LA	2012	NA	6737	6395	342	5.1
CN2206100000000	22	061	Lincoln Parish, LA	2012	NA	19485	17806	1679	8.6
CN2206300000000	22	063	Livingston Parish, LA	2012	NA	62147	58167	3980	6.4
CN2206500000000	22	065	Madison Parish, LA	2012	NA	3891	3422	469	12.1
CN2206700000000	22	067	Morehouse Parish, LA	2012	NA	11243	9778	1465	13
CN2206900000000	22	069	Natchitoches Parish, LA	2012	NA	16036	14601	1435	8.9
CN2207100000000	22	071	Orleans Parish, LA	2012	NA	168791	155488	13303	7.9
CN2207300000000	22	073	Ouachita Parish, LA	2012	NA	70713	65263	5450	7.7
CN2207500000000	22	075	Plaquemines Parish, LA	2012	NA	10126	9525	601	5.9
CN2207700000000	22	077	Pointe Coupee Parish, LA	2012	NA	9883	9074	809	8.2
CN2207900000000	22	079	Rapides Parish, LA	2012	NA	57231	53206	4025	7
CN2208100000000	22	081	Red River Parish, LA	2012	NA	3946	3657	289	7.3
CN2208300000000	22	083	Richland Parish, LA	2012	NA	8666	7823	843	9.7
CN2208500000000	22	085	Sabine Parish, LA	2012	NA	9213	8572	641	7
CN2208700000000	22	087	St. Bernard Parish, LA	2012	NA	17640	16235	1405	8
CN2208900000000	22	089	St. Charles Parish, LA	2012	NA	24715	23094	1621	6.6
CN2209100000000	22	091	St. Helena Parish, LA	2012	NA	4600	4045	555	12.1
CN2209300000000	22	093	St. James Parish, LA	2012	NA	9661	8684	977	10.1
CN2209500000000	22	095	St. John the Baptist Parish, LA	2012	NA	20513	18611	1902	9.3
CN2209700000000	22	097	St. Landry Parish, LA	2012	NA	33401	30626	2775	8.3
CN2209900000000	22	099	St. Martin Parish, LA	2012	NA	24223	22716	1507	6.2
CN2210100000000	22	101	St. Mary Parish, LA	2012	NA	25413	23510	1903	7.5
CN2210300000000	22	103	St. Tammany Parish, LA	2012	NA	108755	102332	6423	5.9
CN2210500000000	22	105	Tangipahoa Parish, LA	2012	NA	53029	48506	4523	8.5
CN2210700000000	22	107	Tensas Parish, LA	2012	NA	1815	1619	196	10.8
CN2210900000000	22	109	Terrebonne Parish, LA	2012	NA	51017	48306	2711	5.3
CN2211100000000	22	111	Union Parish, LA	2012	NA	9220	8457	763	8.3
CN2211300000000	22	113	Vermilion Parish, LA	2012	NA	25807	24326	1481	5.7
CN2211500000000	22	115	Vernon Parish, LA	2012	NA	18881	17320	1561	8.3
CN2211700000000	22	117	Washington Parish, LA	2012	NA	16478	15026	1452	8.8
CN2211900000000	22	119	Webster Parish, LA	2012	NA	16084	14536	1548	9.6
CN2212100000000	22	121	West Baton Rouge Parish, LA	2012	NA	11908	11088	820	6.9
CN2212300000000	22	123	West Carroll Parish, LA	2012	NA	4160	3594	566	13.6
CN2212500000000	22	125	West Feliciana Parish, LA	2012	NA	5131	4820	311	6.1
CN2212700000000	22	127	Winn Parish, LA	2012	NA	5690	5205	485	8.5
CN2300100000000	23	001	Androscoggin County, ME	2012	NA	56388	52019	4369	7.7
CN2300300000000	23	003	Aroostook County, ME	2012	NA	34192	31008	3184	9.3
CN2300500000000	23	005	Cumberland County, ME	2012	NA	159792	150251	9541	6
CN2300700000000	23	007	Franklin County, ME	2012	NA	15486	14145	1341	8.7
CN2300900000000	23	009	Hancock County, ME	2012	NA	29970	27377	2593	8.7
CN2301100000000	23	011	Kennebec County, ME	2012	NA	63164	58636	4528	7.2
CN2301300000000	23	013	Knox County, ME	2012	NA	20617	19190	1427	6.9
CN2301500000000	23	015	Lincoln County, ME	2012	NA	17256	15993	1263	7.3
CN2301700000000	23	017	Oxford County, ME	2012	NA	27903	25196	2707	9.7
CN2301900000000	23	019	Penobscot County, ME	2012	NA	79928	73723	6205	7.8
CN2302100000000	23	021	Piscataquis County, ME	2012	NA	7880	7132	748	9.5
CN2302300000000	23	023	Sagadahoc County, ME	2012	NA	19210	17941	1269	6.6
CN2302500000000	23	025	Somerset County, ME	2012	NA	24628	22162	2466	10
CN2302700000000	23	027	Waldo County, ME	2012	NA	20684	18977	1707	8.3
CN2302900000000	23	029	Washington County, ME	2012	NA	14751	13227	1524	10.3
CN2303100000000	23	031	York County, ME	2012	NA	110789	103143	7646	6.9
CN2400100000000	24	001	Allegany County, MD	2012	NA	33848	30831	3017	8.9
CN2400300000000	24	003	Anne Arundel County, MD	2012	NA	293697	276068	17629	6
CN2400500000000	24	005	Baltimore County, MD	2012	NA	440264	407899	32365	7.4
CN2400900000000	24	009	Calvert County, MD	2012	NA	47708	44717	2991	6.3
CN2401100000000	24	011	Caroline County, MD	2012	NA	17611	16248	1363	7.7
CN2401300000000	24	013	Carroll County, MD	2012	NA	93264	87757	5507	5.9
CN2401500000000	24	015	Cecil County, MD	2012	NA	51886	47561	4325	8.3
CN2401700000000	24	017	Charles County, MD	2012	NA	79556	74251	5305	6.7
CN2401900000000	24	019	Dorchester County, MD	2012	NA	16173	14420	1753	10.8
CN2402100000000	24	021	Frederick County, MD	2012	NA	128608	120759	7849	6.1
CN2402300000000	24	023	Garrett County, MD	2012	NA	15829	14517	1312	8.3
CN2402500000000	24	025	Harford County, MD	2012	NA	135560	126145	9415	6.9
CN2402700000000	24	027	Howard County, MD	2012	NA	168218	159781	8437	5
CN2402900000000	24	029	Kent County, MD	2012	NA	10629	9819	810	7.6
CN2403100000000	24	031	Montgomery County, MD	2012	NA	540440	512451	27989	5.2
CN2403300000000	24	033	Prince George's County, MD	2012	NA	484976	449677	35299	7.3
CN2403500000000	24	035	Queen Anne's County, MD	2012	NA	26732	25042	1690	6.3
CN2403700000000	24	037	St. Mary's County, MD	2012	NA	54491	51103	3388	6.2
CN2403900000000	24	039	Somerset County, MD	2012	NA	9740	8643	1097	11.3
CN2404100000000	24	041	Talbot County, MD	2012	NA	19414	18016	1398	7.2
CN2404300000000	24	043	Washington County, MD	2012	NA	77166	71120	6046	7.8
CN2404500000000	24	045	Wicomico County, MD	2012	NA	50475	45732	4743	9.4
CN2404700000000	24	047	Worcester County, MD	2012	NA	26118	22743	3375	12.9
CN2451000000000	24	510	Baltimore city, MD	2012	NA	297246	267009	30237	10.2
CN2500100000000	25	001	Barnstable County, MA	2012	NA	108240	99066	9174	8.5
CN2500300000000	25	003	Berkshire County, MA	2012	NA	66079	61222	4857	7.4
CN2500500000000	25	005	Bristol County, MA	2012	NA	285365	260513	24852	8.7
CN2500700000000	25	007	Dukes County, MA	2012	NA	9327	8502	825	8.8
CN2500900000000	25	009	Essex County, MA	2012	NA	395468	367509	27959	7.1
CN2501100000000	25	011	Franklin County, MA	2012	NA	39591	37186	2405	6.1
CN2501300000000	25	013	Hampden County, MA	2012	NA	219167	200394	18773	8.6
CN2501500000000	25	015	Hampshire County, MA	2012	NA	85257	80310	4947	5.8
CN2501700000000	25	017	Middlesex County, MA	2012	NA	831742	786717	45025	5.4
CN2501900000000	25	019	Nantucket County/town, MA	2012	NA	6385	5886	499	7.8
CN2502100000000	25	021	Norfolk County, MA	2012	NA	358841	338415	20426	5.7
CN2502300000000	25	023	Plymouth County, MA	2012	NA	260344	242112	18232	7
CN2502500000000	25	025	Suffolk County, MA	2012	NA	401375	376763	24612	6.1
CN2502700000000	25	027	Worcester County, MA	2012	NA	417980	387936	30044	7.2
CN2600100000000	26	001	Alcona County, MI	2012	NA	3711	3240	471	12.7
CN2600300000000	26	003	Alger County, MI	2012	NA	3433	3024	409	11.9
CN2600500000000	26	005	Allegan County, MI	2012	NA	56649	52482	4167	7.4
CN2600700000000	26	007	Alpena County, MI	2012	NA	13386	12084	1302	9.7
CN2600900000000	26	009	Antrim County, MI	2012	NA	10001	8848	1153	11.5
CN2601100000000	26	011	Arenac County, MI	2012	NA	6528	5694	834	12.8
CN2601300000000	26	013	Baraga County, MI	2012	NA	3533	3036	497	14.1
CN2601500000000	26	015	Barry County, MI	2012	NA	28950	26968	1982	6.8
CN2601700000000	26	017	Bay County, MI	2012	NA	52851	48230	4621	8.7
CN2601900000000	26	019	Benzie County, MI	2012	NA	8523	7631	892	10.5
CN2602100000000	26	021	Berrien County, MI	2012	NA	73289	66664	6625	9
CN2602300000000	26	023	Branch County, MI	2012	NA	18642	16992	1650	8.9
CN2602500000000	26	025	Calhoun County, MI	2012	NA	62221	57015	5206	8.4
CN2602700000000	26	027	Cass County, MI	2012	NA	23748	21744	2004	8.4
CN2602900000000	26	029	Charlevoix County, MI	2012	NA	12909	11515	1394	10.8
CN2603100000000	26	031	Cheboygan County, MI	2012	NA	10499	9255	1244	11.8
CN2603300000000	26	033	Chippewa County, MI	2012	NA	17105	15386	1719	10
CN2603500000000	26	035	Clare County, MI	2012	NA	11961	10545	1416	11.8
CN2603700000000	26	037	Clinton County, MI	2012	NA	38504	36153	2351	6.1
CN2603900000000	26	039	Crawford County, MI	2012	NA	5368	4736	632	11.8
CN2604100000000	26	041	Delta County, MI	2012	NA	17505	15777	1728	9.9
CN2604300000000	26	043	Dickinson County, MI	2012	NA	12633	11566	1067	8.4
CN2604500000000	26	045	Eaton County, MI	2012	NA	54878	51079	3799	6.9
CN2604700000000	26	047	Emmet County, MI	2012	NA	17792	15666	2126	11.9
CN2604900000000	26	049	Genesee County, MI	2012	NA	181201	163066	18135	10
CN2605100000000	26	051	Gladwin County, MI	2012	NA	9926	8752	1174	11.8
CN2605300000000	26	053	Gogebic County, MI	2012	NA	6786	6033	753	11.1
CN2605500000000	26	055	Grand Traverse County, MI	2012	NA	46358	42529	3829	8.3
CN2605700000000	26	057	Gratiot County, MI	2012	NA	18575	16905	1670	9
CN2605900000000	26	059	Hillsdale County, MI	2012	NA	20458	18586	1872	9.2
CN2606100000000	26	061	Houghton County, MI	2012	NA	16904	15390	1514	9
CN2606300000000	26	063	Huron County, MI	2012	NA	16389	15069	1320	8.1
CN2606500000000	26	065	Ingham County, MI	2012	NA	143174	131953	11221	7.8
CN2606700000000	26	067	Ionia County, MI	2012	NA	28620	26190	2430	8.5
CN2606900000000	26	069	Iosco County, MI	2012	NA	10148	9010	1138	11.2
CN2607100000000	26	071	Iron County, MI	2012	NA	5079	4594	485	9.5
CN2607300000000	26	073	Isabella County, MI	2012	NA	34701	32136	2565	7.4
CN2607500000000	26	075	Jackson County, MI	2012	NA	71562	65453	6109	8.5
CN2607700000000	26	077	Kalamazoo County, MI	2012	NA	124591	115564	9027	7.2
CN2607900000000	26	079	Kalkaska County, MI	2012	NA	7429	6588	841	11.3
CN2608100000000	26	081	Kent County, MI	2012	NA	319697	297920	21777	6.8
CN2608300000000	26	083	Keweenaw County, MI	2012	NA	984	859	125	12.7
CN2608500000000	26	085	Lake County, MI	2012	NA	3661	3183	478	13.1
CN2608700000000	26	087	Lapeer County, MI	2012	NA	39714	35095	4619	11.6
CN2608900000000	26	089	Leelanau County, MI	2012	NA	10163	9347	816	8
CN2609100000000	26	091	Lenawee County, MI	2012	NA	47498	43522	3976	8.4
CN2609300000000	26	093	Livingston County, MI	2012	NA	93153	85806	7347	7.9
CN2609500000000	26	095	Luce County, MI	2012	NA	2366	2107	259	10.9
CN2609700000000	26	097	Mackinac County, MI	2012	NA	5187	4560	627	12.1
CN2609900000000	26	099	Macomb County, MI	2012	NA	411719	371286	40433	9.8
CN2610100000000	26	101	Manistee County, MI	2012	NA	10494	9359	1135	10.8
CN2610300000000	26	103	Marquette County, MI	2012	NA	33986	31240	2746	8.1
CN2610500000000	26	105	Mason County, MI	2012	NA	14338	12952	1386	9.7
CN2610700000000	26	107	Mecosta County, MI	2012	NA	18822	16916	1906	10.1
CN2610900000000	26	109	Menominee County, MI	2012	NA	11755	10809	946	8
CN2611100000000	26	111	Midland County, MI	2012	NA	40668	37507	3161	7.8
CN2611300000000	26	113	Missaukee County, MI	2012	NA	6910	6242	668	9.7
CN2611500000000	26	115	Monroe County, MI	2012	NA	73606	67904	5702	7.7
CN2611700000000	26	117	Montcalm County, MI	2012	NA	27253	24473	2780	10.2
CN2611900000000	26	119	Montmorency County, MI	2012	NA	3234	2709	525	16.2
CN2612100000000	26	121	Muskegon County, MI	2012	NA	75633	68034	7599	10
CN2612300000000	26	123	Newaygo County, MI	2012	NA	22013	19993	2020	9.2
CN2612500000000	26	125	Oakland County, MI	2012	NA	616205	565454	50751	8.2
CN2612700000000	26	127	Oceana County, MI	2012	NA	12824	11202	1622	12.6
CN2612900000000	26	129	Ogemaw County, MI	2012	NA	8623	7639	984	11.4
CN2613100000000	26	131	Ontonagon County, MI	2012	NA	2578	2233	345	13.4
CN2613300000000	26	133	Osceola County, MI	2012	NA	9968	8975	993	10
CN2613500000000	26	135	Oscoda County, MI	2012	NA	2985	2518	467	15.6
CN2613700000000	26	137	Otsego County, MI	2012	NA	11187	9989	1198	10.7
CN2613900000000	26	139	Ottawa County, MI	2012	NA	141570	132241	9329	6.6
CN2614100000000	26	141	Presque Isle County, MI	2012	NA	5536	4734	802	14.5
CN2614300000000	26	143	Roscommon County, MI	2012	NA	8101	7012	1089	13.4
CN2614500000000	26	145	Saginaw County, MI	2012	NA	88770	80580	8190	9.2
CN2614700000000	26	147	St. Clair County, MI	2012	NA	73736	65066	8670	11.8
CN2614900000000	26	149	St. Joseph County, MI	2012	NA	27438	24989	2449	8.9
CN2615100000000	26	151	Sanilac County, MI	2012	NA	19300	17274	2026	10.5
CN2615300000000	26	153	Schoolcraft County, MI	2012	NA	3534	3090	444	12.6
CN2615500000000	26	155	Shiawassee County, MI	2012	NA	33156	29986	3170	9.6
CN2615700000000	26	157	Tuscola County, MI	2012	NA	24683	22078	2605	10.6
CN2615900000000	26	159	Van Buren County, MI	2012	NA	35208	31496	3712	10.5
CN2616100000000	26	161	Washtenaw County, MI	2012	NA	181611	170803	10808	6
CN2616300000000	26	163	Wayne County, MI	2012	NA	771845	681453	90392	11.7
CN2616500000000	26	165	Wexford County, MI	2012	NA	14469	12876	1593	11
CN2700100000000	27	001	Aitkin County, MN	2012	NA	6904	6345	559	8.1
CN2700300000000	27	003	Anoka County, MN	2012	NA	187260	176226	11034	5.9
CN2700500000000	27	005	Becker County, MN	2012	NA	17873	16836	1037	5.8
CN2700700000000	27	007	Beltrami County, MN	2012	NA	22840	21245	1595	7
CN2700900000000	27	009	Benton County, MN	2012	NA	21197	19844	1353	6.4
CN2701100000000	27	011	Big Stone County, MN	2012	NA	2830	2682	148	5.2
CN2701300000000	27	013	Blue Earth County, MN	2012	NA	38316	36479	1837	4.8
CN2701500000000	27	015	Brown County, MN	2012	NA	14817	13982	835	5.6
CN2701700000000	27	017	Carlton County, MN	2012	NA	17472	16272	1200	6.9
CN2701900000000	27	019	Carver County, MN	2012	NA	52427	49897	2530	4.8
CN2702100000000	27	021	Cass County, MN	2012	NA	13852	12623	1229	8.9
CN2702300000000	27	023	Chippewa County, MN	2012	NA	7058	6685	373	5.3
CN2702500000000	27	025	Chisago County, MN	2012	NA	28561	26684	1877	6.6
CN2702700000000	27	027	Clay County, MN	2012	NA	35023	33334	1689	4.8
CN2702900000000	27	029	Clearwater County, MN	2012	NA	4409	3944	465	10.5
CN2703100000000	27	031	Cook County, MN	2012	NA	3048	2858	190	6.2
CN2703300000000	27	033	Cottonwood County, MN	2012	NA	5947	5561	386	6.5
CN2703500000000	27	035	Crow Wing County, MN	2012	NA	30912	28538	2374	7.7
CN2703700000000	27	037	Dakota County, MN	2012	NA	228036	216129	11907	5.2
CN2703900000000	27	039	Dodge County, MN	2012	NA	11339	10768	571	5
CN2704100000000	27	041	Douglas County, MN	2012	NA	19810	18812	998	5
CN2704300000000	27	043	Faribault County, MN	2012	NA	7771	7318	453	5.8
CN2704500000000	27	045	Fillmore County, MN	2012	NA	11274	10650	624	5.5
CN2704700000000	27	047	Freeborn County, MN	2012	NA	16675	15707	968	5.8
CN2704900000000	27	049	Goodhue County, MN	2012	NA	26709	25333	1376	5.2
CN2705100000000	27	051	Grant County, MN	2012	NA	3337	3133	204	6.1
CN2705300000000	27	053	Hennepin County, MN	2012	NA	659812	625310	34502	5.2
CN2705500000000	27	055	Houston County, MN	2012	NA	10571	9957	614	5.8
CN2705700000000	27	057	Hubbard County, MN	2012	NA	9540	8773	767	8
CN2705900000000	27	059	Isanti County, MN	2012	NA	20351	18929	1422	7
CN2706100000000	27	061	Itasca County, MN	2012	NA	22248	20502	1746	7.8
CN2706300000000	27	063	Jackson County, MN	2012	NA	6206	5924	282	4.5
CN2706500000000	27	065	Kanabec County, MN	2012	NA	8732	7947	785	9
CN2706700000000	27	067	Kandiyohi County, MN	2012	NA	23494	22267	1227	5.2
CN2706900000000	27	069	Kittson County, MN	2012	NA	2563	2414	149	5.8
CN2707100000000	27	071	Koochiching County, MN	2012	NA	6702	6167	535	8
CN2707300000000	27	073	Lac qui Parle County, MN	2012	NA	3856	3662	194	5
CN2707500000000	27	075	Lake County, MN	2012	NA	5828	5478	350	6
CN2707700000000	27	077	Lake of the Woods County, MN	2012	NA	2347	2204	143	6.1
CN2707900000000	27	079	Le Sueur County, MN	2012	NA	15488	14482	1006	6.5
CN2708100000000	27	081	Lincoln County, MN	2012	NA	3422	3260	162	4.7
CN2708300000000	27	083	Lyon County, MN	2012	NA	15230	14558	672	4.4
CN2708500000000	27	085	McLeod County, MN	2012	NA	19931	18580	1351	6.8
CN2708700000000	27	087	Mahnomen County, MN	2012	NA	2478	2306	172	6.9
CN2708900000000	27	089	Marshall County, MN	2012	NA	5746	5306	440	7.7
CN2709100000000	27	091	Martin County, MN	2012	NA	10873	10263	610	5.6
CN2709300000000	27	093	Meeker County, MN	2012	NA	12736	11897	839	6.6
CN2709500000000	27	095	Mille Lacs County, MN	2012	NA	12693	11634	1059	8.3
CN2709700000000	27	097	Morrison County, MN	2012	NA	17936	16670	1266	7.1
CN2709900000000	27	099	Mower County, MN	2012	NA	20661	19630	1031	5
CN2710100000000	27	101	Murray County, MN	2012	NA	4995	4735	260	5.2
CN2710300000000	27	103	Nicollet County, MN	2012	NA	19739	18839	900	4.6
CN2710500000000	27	105	Nobles County, MN	2012	NA	11289	10799	490	4.3
CN2710700000000	27	107	Norman County, MN	2012	NA	3522	3314	208	5.9
CN2710900000000	27	109	Olmsted County, MN	2012	NA	82541	78892	3649	4.4
CN2711100000000	27	111	Otter Tail County, MN	2012	NA	30777	29067	1710	5.6
CN2711300000000	27	113	Pennington County, MN	2012	NA	8589	8022	567	6.6
CN2711500000000	27	115	Pine County, MN	2012	NA	14881	13761	1120	7.5
CN2711700000000	27	117	Pipestone County, MN	2012	NA	4906	4662	244	5
CN2711900000000	27	119	Polk County, MN	2012	NA	17506	16418	1088	6.2
CN2712100000000	27	121	Pope County, MN	2012	NA	5944	5667	277	4.7
CN2712300000000	27	123	Ramsey County, MN	2012	NA	272944	257259	15685	5.7
CN2712500000000	27	125	Red Lake County, MN	2012	NA	2340	2171	169	7.2
CN2712700000000	27	127	Redwood County, MN	2012	NA	8205	7752	453	5.5
CN2712900000000	27	129	Renville County, MN	2012	NA	8426	7855	571	6.8
CN2713100000000	27	131	Rice County, MN	2012	NA	34862	32836	2026	5.8
CN2713300000000	27	133	Rock County, MN	2012	NA	5546	5344	202	3.6
CN2713500000000	27	135	Roseau County, MN	2012	NA	8537	8134	403	4.7
CN2713700000000	27	137	St. Louis County, MN	2012	NA	101564	94964	6600	6.5
CN2713900000000	27	139	Scott County, MN	2012	NA	75799	72024	3775	5
CN2714100000000	27	141	Sherburne County, MN	2012	NA	48620	45611	3009	6.2
CN2714300000000	27	143	Sibley County, MN	2012	NA	8418	7915	503	6
CN2714500000000	27	145	Stearns County, MN	2012	NA	86268	81613	4655	5.4
CN2714700000000	27	147	Steele County, MN	2012	NA	21570	20400	1170	5.4
CN2714900000000	27	149	Stevens County, MN	2012	NA	5606	5369	237	4.2
CN2715100000000	27	151	Swift County, MN	2012	NA	5084	4771	313	6.2
CN2715300000000	27	153	Todd County, MN	2012	NA	13033	12277	756	5.8
CN2715500000000	27	155	Traverse County, MN	2012	NA	1775	1686	89	5
CN2715700000000	27	157	Wabasha County, MN	2012	NA	11959	11340	619	5.2
CN2715900000000	27	159	Wadena County, MN	2012	NA	6229	5743	486	7.8
CN2716100000000	27	161	Waseca County, MN	2012	NA	10213	9625	588	5.8
CN2716300000000	27	163	Washington County, MN	2012	NA	133686	126811	6875	5.1
CN2716500000000	27	165	Watonwan County, MN	2012	NA	6285	5932	353	5.6
CN2716700000000	27	167	Wilkin County, MN	2012	NA	3781	3603	178	4.7
CN2716900000000	27	169	Winona County, MN	2012	NA	29823	28363	1460	4.9
CN2717100000000	27	171	Wright County, MN	2012	NA	70288	66174	4114	5.9
CN2717300000000	27	173	Yellow Medicine County, MN	2012	NA	5679	5394	285	5
CN2800100000000	28	001	Adams County, MS	2012	NA	12366	11141	1225	9.9
CN2800300000000	28	003	Alcorn County, MS	2012	NA	16001	14608	1393	8.7
CN2800500000000	28	005	Amite County, MS	2012	NA	4762	4284	478	10
CN2800700000000	28	007	Attala County, MS	2012	NA	7585	6841	744	9.8
CN2800900000000	28	009	Benton County, MS	2012	NA	3290	2941	349	10.6
CN2801100000000	28	011	Bolivar County, MS	2012	NA	14400	12871	1529	10.6
CN2801300000000	28	013	Calhoun County, MS	2012	NA	6746	6185	561	8.3
CN2801500000000	28	015	Carroll County, MS	2012	NA	3676	3271	405	11
CN2801700000000	28	017	Chickasaw County, MS	2012	NA	7992	7174	818	10.2
CN2801900000000	28	019	Choctaw County, MS	2012	NA	3724	3386	338	9.1
CN2802100000000	28	021	Claiborne County, MS	2012	NA	3530	2986	544	15.4
CN2802300000000	28	023	Clarke County, MS	2012	NA	6729	6005	724	10.8
CN2802500000000	28	025	Clay County, MS	2012	NA	8587	7379	1208	14.1
CN2802700000000	28	027	Coahoma County, MS	2012	NA	10217	8931	1286	12.6
CN2802900000000	28	029	Copiah County, MS	2012	NA	11873	10562	1311	11
CN2803100000000	28	031	Covington County, MS	2012	NA	8359	7651	708	8.5
CN2803300000000	28	033	DeSoto County, MS	2012	NA	83109	77739	5370	6.5
CN2803500000000	28	035	Forrest County, MS	2012	NA	34419	31315	3104	9
CN2803700000000	28	037	Franklin County, MS	2012	NA	3071	2771	300	9.8
CN2803900000000	28	039	George County, MS	2012	NA	8823	7919	904	10.2
CN2804100000000	28	041	Greene County, MS	2012	NA	4568	4055	513	11.2
CN2804300000000	28	043	Grenada County, MS	2012	NA	9612	8726	886	9.2
CN2804500000000	28	045	Hancock County, MS	2012	NA	19597	17941	1656	8.5
CN2804700000000	28	047	Harrison County, MS	2012	NA	88960	81688	7272	8.2
CN2804900000000	28	049	Hinds County, MS	2012	NA	115704	105543	10161	8.8
CN2805100000000	28	051	Holmes County, MS	2012	NA	6618	5524	1094	16.5
CN2805300000000	28	053	Humphreys County, MS	2012	NA	3171	2567	604	19
CN2805500000000	28	055	Issaquena County, MS	2012	NA	471	388	83	17.6
CN2805700000000	28	057	Itawamba County, MS	2012	NA	10415	9540	875	8.4
CN2805900000000	28	059	Jackson County, MS	2012	NA	63232	57255	5977	9.5
CN2806100000000	28	061	Jasper County, MS	2012	NA	6893	6193	700	10.2
CN2806300000000	28	063	Jefferson County, MS	2012	NA	2517	2080	437	17.4
CN2806500000000	28	065	Jefferson Davis County, MS	2012	NA	4459	3883	576	12.9
CN2806700000000	28	067	Jones County, MS	2012	NA	28735	26560	2175	7.6
CN2806900000000	28	069	Kemper County, MS	2012	NA	3971	3450	521	13.1
CN2807100000000	28	071	Lafayette County, MS	2012	NA	23351	21550	1801	7.7
CN2807300000000	28	073	Lamar County, MS	2012	NA	28145	26328	1817	6.5
CN2807500000000	28	075	Lauderdale County, MS	2012	NA	34574	31447	3127	9
CN2807700000000	28	077	Lawrence County, MS	2012	NA	4941	4433	508	10.3
CN2807900000000	28	079	Leake County, MS	2012	NA	8405	7629	776	9.2
CN2808100000000	28	081	Lee County, MS	2012	NA	41050	37628	3422	8.3
CN2808300000000	28	083	Leflore County, MS	2012	NA	11210	9637	1573	14
CN2808500000000	28	085	Lincoln County, MS	2012	NA	14412	13168	1244	8.6
CN2808700000000	28	087	Lowndes County, MS	2012	NA	27522	25005	2517	9.1
CN2808900000000	28	089	Madison County, MS	2012	NA	50411	47262	3149	6.2
CN2809100000000	28	091	Marion County, MS	2012	NA	10334	9276	1058	10.2
CN2809300000000	28	093	Marshall County, MS	2012	NA	15396	13725	1671	10.9
CN2809500000000	28	095	Monroe County, MS	2012	NA	16142	14356	1786	11.1
CN2809700000000	28	097	Montgomery County, MS	2012	NA	4544	4014	530	11.7
CN2809900000000	28	099	Neshoba County, MS	2012	NA	11654	10680	974	8.4
CN2810100000000	28	101	Newton County, MS	2012	NA	9262	8524	738	8
CN2810300000000	28	103	Noxubee County, MS	2012	NA	4211	3659	552	13.1
CN2810500000000	28	105	Oktibbeha County, MS	2012	NA	22784	20874	1910	8.4
CN2810700000000	28	107	Panola County, MS	2012	NA	14307	12570	1737	12.1
CN2810900000000	28	109	Pearl River County, MS	2012	NA	23776	21819	1957	8.2
CN2811100000000	28	111	Perry County, MS	2012	NA	4436	3927	509	11.5
CN2811300000000	28	113	Pike County, MS	2012	NA	15271	13663	1608	10.5
CN2811500000000	28	115	Pontotoc County, MS	2012	NA	14081	12980	1101	7.8
CN2811700000000	28	117	Prentiss County, MS	2012	NA	11423	10438	985	8.6
CN2811900000000	28	119	Quitman County, MS	2012	NA	2971	2557	414	13.9
CN2812100000000	28	121	Rankin County, MS	2012	NA	72785	68604	4181	5.7
CN2812300000000	28	123	Scott County, MS	2012	NA	13093	12096	997	7.6
CN2812500000000	28	125	Sharkey County, MS	2012	NA	1938	1675	263	13.6
CN2812700000000	28	127	Simpson County, MS	2012	NA	11285	10355	930	8.2
CN2812900000000	28	129	Smith County, MS	2012	NA	7096	6580	516	7.3
CN2813100000000	28	131	Stone County, MS	2012	NA	6694	6004	690	10.3
CN2813300000000	28	133	Sunflower County, MS	2012	NA	9485	8123	1362	14.4
CN2813500000000	28	135	Tallahatchie County, MS	2012	NA	5775	5124	651	11.3
CN2813700000000	28	137	Tate County, MS	2012	NA	12430	11281	1149	9.2
CN2813900000000	28	139	Tippah County, MS	2012	NA	9038	8127	911	10.1
CN2814100000000	28	141	Tishomingo County, MS	2012	NA	7890	7076	814	10.3
CN2814300000000	28	143	Tunica County, MS	2012	NA	4902	4297	605	12.3
CN2814500000000	28	145	Union County, MS	2012	NA	13548	12460	1088	8
CN2814700000000	28	147	Walthall County, MS	2012	NA	5574	4948	626	11.2
CN2814900000000	28	149	Warren County, MS	2012	NA	23257	21161	2096	9
CN2815100000000	28	151	Washington County, MS	2012	NA	20027	17118	2909	14.5
CN2815300000000	28	153	Wayne County, MS	2012	NA	8443	7504	939	11.1
CN2815500000000	28	155	Webster County, MS	2012	NA	4233	3846	387	9.1
CN2815700000000	28	157	Wilkinson County, MS	2012	NA	3263	2862	401	12.3
CN2815900000000	28	159	Winston County, MS	2012	NA	7724	6837	887	11.5
CN2816100000000	28	161	Yalobusha County, MS	2012	NA	5433	4885	548	10.1
CN2816300000000	28	163	Yazoo County, MS	2012	NA	9844	8739	1105	11.2
CN2900100000000	29	001	Adair County, MO	2012	NA	10749	9994	755	7
CN2900300000000	29	003	Andrew County, MO	2012	NA	9908	9378	530	5.3
CN2900500000000	29	005	Atchison County, MO	2012	NA	2879	2696	183	6.4
CN2900700000000	29	007	Audrain County, MO	2012	NA	11355	10616	739	6.5
CN2900900000000	29	009	Barry County, MO	2012	NA	15129	14059	1070	7.1
CN2901100000000	29	011	Barton County, MO	2012	NA	5544	5133	411	7.4
CN2901300000000	29	013	Bates County, MO	2012	NA	8185	7511	674	8.2
CN2901500000000	29	015	Benton County, MO	2012	NA	7146	6499	647	9.1
CN2901700000000	29	017	Bollinger County, MO	2012	NA	5724	5322	402	7
CN2901900000000	29	019	Boone County, MO	2012	NA	96446	92078	4368	4.5
CN2902100000000	29	021	Buchanan County, MO	2012	NA	46745	43810	2935	6.3
CN2902300000000	29	023	Butler County, MO	2012	NA	18688	17157	1531	8.2
CN2902500000000	29	025	Caldwell County, MO	2012	NA	4401	4093	308	7
CN2902700000000	29	027	Callaway County, MO	2012	NA	21834	20482	1352	6.2
CN2902900000000	29	029	Camden County, MO	2012	NA	18967	17154	1813	9.6
CN2903100000000	29	031	Cape Girardeau County, MO	2012	NA	40815	38558	2257	5.5
CN2903300000000	29	033	Carroll County, MO	2012	NA	4598	4215	383	8.3
CN2903500000000	29	035	Carter County, MO	2012	NA	2547	2306	241	9.5
CN2903700000000	29	037	Cass County, MO	2012	NA	52827	49305	3522	6.7
CN2903900000000	29	039	Cedar County, MO	2012	NA	5799	5368	431	7.4
CN2904100000000	29	041	Chariton County, MO	2012	NA	4033	3769	264	6.5
CN2904300000000	29	043	Christian County, MO	2012	NA	40817	38442	2375	5.8
CN2904500000000	29	045	Clark County, MO	2012	NA	3346	3076	270	8.1
CN2904700000000	29	047	Clay County, MO	2012	NA	126525	118815	7710	6.1
CN2904900000000	29	049	Clinton County, MO	2012	NA	10855	10094	761	7
CN2905100000000	29	051	Cole County, MO	2012	NA	39901	37846	2055	5.2
CN2905300000000	29	053	Cooper County, MO	2012	NA	7814	7255	559	7.2
CN2905500000000	29	055	Crawford County, MO	2012	NA	10740	9794	946	8.8
CN2905700000000	29	057	Dade County, MO	2012	NA	3368	3116	252	7.5
CN2905900000000	29	059	Dallas County, MO	2012	NA	7110	6463	647	9.1
CN2906100000000	29	061	Daviess County, MO	2012	NA	4068	3786	282	6.9
CN2906300000000	29	063	DeKalb County, MO	2012	NA	5055	4755	300	5.9
CN2906500000000	29	065	Dent County, MO	2012	NA	6010	5519	491	8.2
CN2906700000000	29	067	Douglas County, MO	2012	NA	5151	4645	506	9.8
CN2906900000000	29	069	Dunklin County, MO	2012	NA	12199	10931	1268	10.4
CN2907100000000	29	071	Franklin County, MO	2012	NA	52013	47919	4094	7.9
CN2907300000000	29	073	Gasconade County, MO	2012	NA	7542	7010	532	7.1
CN2907500000000	29	075	Gentry County, MO	2012	NA	3593	3402	191	5.3
CN2907700000000	29	077	Greene County, MO	2012	NA	144032	135502	8530	5.9
CN2907900000000	29	079	Grundy County, MO	2012	NA	4948	4629	319	6.4
CN2908100000000	29	081	Harrison County, MO	2012	NA	3970	3682	288	7.3
CN2908300000000	29	083	Henry County, MO	2012	NA	9849	9084	765	7.8
CN2908500000000	29	085	Hickory County, MO	2012	NA	3622	3188	434	12
CN2908700000000	29	087	Holt County, MO	2012	NA	2693	2552	141	5.2
CN2908900000000	29	089	Howard County, MO	2012	NA	4844	4516	328	6.8
CN2909100000000	29	091	Howell County, MO	2012	NA	16554	15206	1348	8.1
CN2909300000000	29	093	Iron County, MO	2012	NA	3748	3321	427	11.4
CN2909500000000	29	095	Jackson County, MO	2012	NA	355862	328189	27673	7.8
CN2909700000000	29	097	Jasper County, MO	2012	NA	58257	54818	3439	5.9
CN2909900000000	29	099	Jefferson County, MO	2012	NA	115282	107002	8280	7.2
CN2910100000000	29	101	Johnson County, MO	2012	NA	23079	21311	1768	7.7
CN2910300000000	29	103	Knox County, MO	2012	NA	1970	1859	111	5.6
CN2910500000000	29	105	Laclede County, MO	2012	NA	15794	14334	1460	9.2
CN2910700000000	29	107	Lafayette County, MO	2012	NA	17249	16025	1224	7.1
CN2910900000000	29	109	Lawrence County, MO	2012	NA	17317	16189	1128	6.5
CN2911100000000	29	111	Lewis County, MO	2012	NA	5166	4881	285	5.5
CN2911300000000	29	113	Lincoln County, MO	2012	NA	26361	24169	2192	8.3
CN2911500000000	29	115	Linn County, MO	2012	NA	5179	4700	479	9.2
CN2911700000000	29	117	Livingston County, MO	2012	NA	7228	6780	448	6.2
CN2911900000000	29	119	McDonald County, MO	2012	NA	10186	9507	679	6.7
CN2912100000000	29	121	Macon County, MO	2012	NA	7509	7004	505	6.7
CN2912300000000	29	123	Madison County, MO	2012	NA	5379	4935	444	8.3
CN2912500000000	29	125	Maries County, MO	2012	NA	4152	3852	300	7.2
CN2912700000000	29	127	Marion County, MO	2012	NA	14494	13611	883	6.1
CN2912900000000	29	129	Mercer County, MO	2012	NA	1835	1740	95	5.2
CN2913100000000	29	131	Miller County, MO	2012	NA	11373	10346	1027	9
CN2913300000000	29	133	Mississippi County, MO	2012	NA	6154	5667	487	7.9
CN2913500000000	29	135	Moniteau County, MO	2012	NA	7325	6841	484	6.6
CN2913700000000	29	137	Monroe County, MO	2012	NA	4060	3749	311	7.7
CN2913900000000	29	139	Montgomery County, MO	2012	NA	5806	5350	456	7.9
CN2914100000000	29	141	Morgan County, MO	2012	NA	7810	7034	776	9.9
CN2914300000000	29	143	New Madrid County, MO	2012	NA	8134	7479	655	8.1
CN2914500000000	29	145	Newton County, MO	2012	NA	29400	27590	1810	6.2
CN2914700000000	29	147	Nodaway County, MO	2012	NA	11730	11077	653	5.6
CN2914900000000	29	149	Oregon County, MO	2012	NA	4052	3733	319	7.9
CN2915100000000	29	151	Osage County, MO	2012	NA	7334	6965	369	5
CN2915300000000	29	153	Ozark County, MO	2012	NA	3595	3230	365	10.2
CN2915500000000	29	155	Pemiscot County, MO	2012	NA	7109	6425	684	9.6
CN2915700000000	29	157	Perry County, MO	2012	NA	10008	9495	513	5.1
CN2915900000000	29	159	Pettis County, MO	2012	NA	19995	18584	1411	7.1
CN2916100000000	29	161	Phelps County, MO	2012	NA	19677	18286	1391	7.1
CN2916300000000	29	163	Pike County, MO	2012	NA	8136	7579	557	6.8
CN2916500000000	29	165	Platte County, MO	2012	NA	52486	49603	2883	5.5
CN2916700000000	29	167	Polk County, MO	2012	NA	14083	12998	1085	7.7
CN2916900000000	29	169	Pulaski County, MO	2012	NA	15884	14591	1293	8.1
CN2917100000000	29	171	Putnam County, MO	2012	NA	2353	2213	140	5.9
CN2917300000000	29	173	Ralls County, MO	2012	NA	5631	5271	360	6.4
CN2917500000000	29	175	Randolph County, MO	2012	NA	10673	9744	929	8.7
CN2917700000000	29	177	Ray County, MO	2012	NA	11313	10383	930	8.2
CN2917900000000	29	179	Reynolds County, MO	2012	NA	2268	2020	248	10.9
CN2918100000000	29	181	Ripley County, MO	2012	NA	5511	4935	576	10.5
CN2918300000000	29	183	St. Charles County, MO	2012	NA	205708	194204	11504	5.6
CN2918500000000	29	185	St. Clair County, MO	2012	NA	3918	3608	310	7.9
CN2918600000000	29	186	Ste. Genevieve County, MO	2012	NA	9034	8375	659	7.3
CN2918700000000	29	187	St. Francois County, MO	2012	NA	26004	23694	2310	8.9
CN2918900000000	29	189	St. Louis County, MO	2012	NA	527539	493385	34154	6.5
CN2919500000000	29	195	Saline County, MO	2012	NA	11030	10302	728	6.6
CN2919700000000	29	197	Schuyler County, MO	2012	NA	1891	1752	139	7.4
CN2919900000000	29	199	Scotland County, MO	2012	NA	2347	2229	118	5
CN2920100000000	29	201	Scott County, MO	2012	NA	19858	18474	1384	7
CN2920300000000	29	203	Shannon County, MO	2012	NA	3062	2725	337	11
CN2920500000000	29	205	Shelby County, MO	2012	NA	3126	2938	188	6
CN2920700000000	29	207	Stoddard County, MO	2012	NA	13488	12319	1169	8.7
CN2920900000000	29	209	Stone County, MO	2012	NA	13690	12164	1526	11.1
CN2921100000000	29	211	Sullivan County, MO	2012	NA	2780	2590	190	6.8
CN2921300000000	29	213	Taney County, MO	2012	NA	25475	22601	2874	11.3
CN2921500000000	29	215	Texas County, MO	2012	NA	9649	8859	790	8.2
CN2921700000000	29	217	Vernon County, MO	2012	NA	9622	9059	563	5.9
CN2921900000000	29	219	Warren County, MO	2012	NA	16945	15678	1267	7.5
CN2922100000000	29	221	Washington County, MO	2012	NA	9981	8924	1057	10.6
CN2922300000000	29	223	Wayne County, MO	2012	NA	5329	4848	481	9
CN2922500000000	29	225	Webster County, MO	2012	NA	15944	14812	1132	7.1
CN2922700000000	29	227	Worth County, MO	2012	NA	1246	1194	52	4.2
CN2922900000000	29	229	Wright County, MO	2012	NA	7588	6950	638	8.4
CN2951000000000	29	510	St. Louis city, MO	2012	NA	161177	147450	13727	8.5
CN3000100000000	30	001	Beaverhead County, MT	2012	NA	4908	4643	265	5.4
CN3000300000000	30	003	Big Horn County, MT	2012	NA	5531	4862	669	12.1
CN3000500000000	30	005	Blaine County, MT	2012	NA	2486	2327	159	6.4
CN3000700000000	30	007	Broadwater County, MT	2012	NA	2481	2295	186	7.5
CN3000900000000	30	009	Carbon County, MT	2012	NA	5331	5081	250	4.7
CN3001100000000	30	011	Carter County, MT	2012	NA	685	663	22	3.2
CN3001300000000	30	013	Cascade County, MT	2012	NA	38376	36245	2131	5.6
CN3001500000000	30	015	Chouteau County, MT	2012	NA	2668	2563	105	3.9
CN3001700000000	30	017	Custer County, MT	2012	NA	6538	6304	234	3.6
CN3001900000000	30	019	Daniels County, MT	2012	NA	941	911	30	3.2
CN3002100000000	30	021	Dawson County, MT	2012	NA	4647	4494	153	3.3
CN3002300000000	30	023	Deer Lodge County, MT	2012	NA	5189	4901	288	5.6
CN3002500000000	30	025	Fallon County, MT	2012	NA	2033	1991	42	2.1
CN3002700000000	30	027	Fergus County, MT	2012	NA	5855	5541	314	5.4
CN3002900000000	30	029	Flathead County, MT	2012	NA	43332	39419	3913	9
CN3003100000000	30	031	Gallatin County, MT	2012	NA	52488	49805	2683	5.1
CN3003300000000	30	033	Garfield County, MT	2012	NA	768	744	24	3.1
CN3003500000000	30	035	Glacier County, MT	2012	NA	6347	5720	627	9.9
CN3003700000000	30	037	Golden Valley County, MT	2012	NA	390	372	18	4.6
CN3003900000000	30	039	Granite County, MT	2012	NA	1473	1353	120	8.1
CN3004100000000	30	041	Hill County, MT	2012	NA	8035	7567	468	5.8
CN3004300000000	30	043	Jefferson County, MT	2012	NA	5601	5292	309	5.5
CN3004500000000	30	045	Judith Basin County, MT	2012	NA	991	939	52	5.2
CN3004700000000	30	047	Lake County, MT	2012	NA	12437	11480	957	7.7
CN3004900000000	30	049	Lewis and Clark County, MT	2012	NA	34919	33225	1694	4.9
CN3005100000000	30	051	Liberty County, MT	2012	NA	1036	993	43	4.2
CN3005300000000	30	053	Lincoln County, MT	2012	NA	8210	7181	1029	12.5
CN3005500000000	30	055	McCone County, MT	2012	NA	1089	1057	32	2.9
CN3005700000000	30	057	Madison County, MT	2012	NA	4113	3856	257	6.2
CN3005900000000	30	059	Meagher County, MT	2012	NA	930	879	51	5.5
CN3006100000000	30	061	Mineral County, MT	2012	NA	1768	1575	193	10.9
CN3006300000000	30	063	Missoula County, MT	2012	NA	59139	55667	3472	5.9
CN3006500000000	30	065	Musselshell County, MT	2012	NA	2416	2286	130	5.4
CN3006700000000	30	067	Park County, MT	2012	NA	8025	7465	560	7
CN3006900000000	30	069	Petroleum County, MT	2012	NA	299	286	13	4.3
CN3007100000000	30	071	Phillips County, MT	2012	NA	2060	1937	123	6
CN3007300000000	30	073	Pondera County, MT	2012	NA	2940	2796	144	4.9
CN3007500000000	30	075	Powder River County, MT	2012	NA	1077	1037	40	3.7
CN3007700000000	30	077	Powell County, MT	2012	NA	3015	2820	195	6.5
CN3007900000000	30	079	Prairie County, MT	2012	NA	529	506	23	4.3
CN3008100000000	30	081	Ravalli County, MT	2012	NA	18716	17290	1426	7.6
CN3008300000000	30	083	Richland County, MT	2012	NA	6714	6526	188	2.8
CN3008500000000	30	085	Roosevelt County, MT	2012	NA	4821	4503	318	6.6
CN3008700000000	30	087	Rosebud County, MT	2012	NA	4454	4152	302	6.8
CN3008900000000	30	089	Sanders County, MT	2012	NA	4795	4244	551	11.5
CN3009100000000	30	091	Sheridan County, MT	2012	NA	2059	1998	61	3
CN3009300000000	30	093	Silver Bow County, MT	2012	NA	17215	16170	1045	6.1
CN3009500000000	30	095	Stillwater County, MT	2012	NA	4954	4732	222	4.5
CN3009700000000	30	097	Sweet Grass County, MT	2012	NA	1747	1679	68	3.9
CN3009900000000	30	099	Teton County, MT	2012	NA	2940	2797	143	4.9
CN3010100000000	30	101	Toole County, MT	2012	NA	2501	2395	106	4.2
CN3010300000000	30	103	Treasure County, MT	2012	NA	379	360	19	5
CN3010500000000	30	105	Valley County, MT	2012	NA	4024	3857	167	4.2
CN3010700000000	30	107	Wheatland County, MT	2012	NA	838	785	53	6.3
CN3010900000000	30	109	Wibaux County, MT	2012	NA	561	543	18	3.2
CN3011100000000	30	111	Yellowstone County, MT	2012	NA	78680	75067	3613	4.6
CN3100100000000	31	001	Adams County, NE	2012	NA	16887	16242	645	3.8
CN3100300000000	31	003	Antelope County, NE	2012	NA	3581	3464	117	3.3
CN3100500000000	31	005	Arthur County, NE	2012	NA	230	215	15	6.5
CN3100700000000	31	007	Banner County, NE	2012	NA	438	418	20	4.6
CN3100900000000	31	009	Blaine County, NE	2012	NA	284	269	15	5.3
CN3101100000000	31	011	Boone County, NE	2012	NA	3042	2948	94	3.1
CN3101300000000	31	013	Box Butte County, NE	2012	NA	5977	5737	240	4
CN3101500000000	31	015	Boyd County, NE	2012	NA	1147	1102	45	3.9
CN3101700000000	31	017	Brown County, NE	2012	NA	1453	1394	59	4.1
CN3101900000000	31	019	Buffalo County, NE	2012	NA	27306	26405	901	3.3
CN3102100000000	31	021	Burt County, NE	2012	NA	3678	3504	174	4.7
CN3102300000000	31	023	Butler County, NE	2012	NA	4744	4586	158	3.3
CN3102500000000	31	025	Cass County, NE	2012	NA	13313	12694	619	4.6
CN3102700000000	31	027	Cedar County, NE	2012	NA	4741	4603	138	2.9
CN3102900000000	31	029	Chase County, NE	2012	NA	2374	2317	57	2.4
CN3103100000000	31	031	Cherry County, NE	2012	NA	3482	3382	100	2.9
CN3103300000000	31	033	Cheyenne County, NE	2012	NA	5789	5628	161	2.8
CN3103500000000	31	035	Clay County, NE	2012	NA	3486	3356	130	3.7
CN3103700000000	31	037	Colfax County, NE	2012	NA	5664	5463	201	3.5
CN3103900000000	31	039	Cuming County, NE	2012	NA	4915	4763	152	3.1
CN3104100000000	31	041	Custer County, NE	2012	NA	6109	5934	175	2.9
CN3104300000000	31	043	Dakota County, NE	2012	NA	11197	10550	647	5.8
CN3104500000000	31	045	Dawes County, NE	2012	NA	5415	5218	197	3.6
CN3104700000000	31	047	Dawson County, NE	2012	NA	13279	12698	581	4.4
CN3104900000000	31	049	Deuel County, NE	2012	NA	1192	1153	39	3.3
CN3105100000000	31	051	Dixon County, NE	2012	NA	3141	3011	130	4.1
CN3105300000000	31	053	Dodge County, NE	2012	NA	19272	18400	872	4.5
CN3105500000000	31	055	Douglas County, NE	2012	NA	285676	272913	12763	4.5
CN3105700000000	31	057	Dundy County, NE	2012	NA	1282	1244	38	3
CN3105900000000	31	059	Fillmore County, NE	2012	NA	3320	3212	108	3.3
CN3106100000000	31	061	Franklin County, NE	2012	NA	1644	1584	60	3.6
CN3106300000000	31	063	Frontier County, NE	2012	NA	1613	1561	52	3.2
CN3106500000000	31	065	Furnas County, NE	2012	NA	2688	2593	95	3.5
CN3106700000000	31	067	Gage County, NE	2012	NA	11179	10624	555	5
CN3106900000000	31	069	Garden County, NE	2012	NA	1262	1221	41	3.2
CN3107100000000	31	071	Garfield County, NE	2012	NA	1220	1183	37	3
CN3107300000000	31	073	Gosper County, NE	2012	NA	1145	1111	34	3
CN3107500000000	31	075	Grant County, NE	2012	NA	439	424	15	3.4
CN3107700000000	31	077	Greeley County, NE	2012	NA	1299	1252	47	3.6
CN3107900000000	31	079	Hall County, NE	2012	NA	32657	31357	1300	4
CN3108100000000	31	081	Hamilton County, NE	2012	NA	4844	4682	162	3.3
CN3108300000000	31	083	Harlan County, NE	2012	NA	1878	1817	61	3.2
CN3108500000000	31	085	Hayes County, NE	2012	NA	664	644	20	3
CN3108700000000	31	087	Hitchcock County, NE	2012	NA	1359	1303	56	4.1
CN3108900000000	31	089	Holt County, NE	2012	NA	5972	5781	191	3.2
CN3109100000000	31	091	Hooker County, NE	2012	NA	438	418	20	4.6
CN3109300000000	31	093	Howard County, NE	2012	NA	3423	3299	124	3.6
CN3109500000000	31	095	Jefferson County, NE	2012	NA	4321	4158	163	3.8
CN3109700000000	31	097	Johnson County, NE	2012	NA	2193	2098	95	4.3
CN3109900000000	31	099	Kearney County, NE	2012	NA	3934	3821	113	2.9
CN3110100000000	31	101	Keith County, NE	2012	NA	4664	4491	173	3.7
CN3110300000000	31	103	Keya Paha County, NE	2012	NA	607	588	19	3.1
CN3110500000000	31	105	Kimball County, NE	2012	NA	2223	2150	73	3.3
CN3110700000000	31	107	Knox County, NE	2012	NA	4791	4630	161	3.4
CN3110900000000	31	109	Lancaster County, NE	2012	NA	167607	161556	6051	3.6
CN3111100000000	31	111	Lincoln County, NE	2012	NA	19276	18517	759	3.9
CN3111300000000	31	113	Logan County, NE	2012	NA	506	490	16	3.2
CN3111500000000	31	115	Loup County, NE	2012	NA	392	377	15	3.8
CN3111700000000	31	117	McPherson County, NE	2012	NA	361	348	13	3.6
CN3111900000000	31	119	Madison County, NE	2012	NA	19209	18500	709	3.7
CN3112100000000	31	121	Merrick County, NE	2012	NA	4232	4077	155	3.7
CN3112300000000	31	123	Morrill County, NE	2012	NA	2703	2617	86	3.2
CN3112500000000	31	125	Nance County, NE	2012	NA	2099	2029	70	3.3
CN3112700000000	31	127	Nemaha County, NE	2012	NA	3886	3698	188	4.8
CN3112900000000	31	129	Nuckolls County, NE	2012	NA	2477	2391	86	3.5
CN3113100000000	31	131	Otoe County, NE	2012	NA	8512	8128	384	4.5
CN3113300000000	31	133	Pawnee County, NE	2012	NA	1640	1586	54	3.3
CN3113500000000	31	135	Perkins County, NE	2012	NA	1830	1781	49	2.7
CN3113700000000	31	137	Phelps County, NE	2012	NA	5049	4897	152	3
CN3113900000000	31	139	Pierce County, NE	2012	NA	4197	4057	140	3.3
CN3114100000000	31	141	Platte County, NE	2012	NA	18047	17387	660	3.7
CN3114300000000	31	143	Polk County, NE	2012	NA	2993	2901	92	3.1
CN3114500000000	31	145	Red Willow County, NE	2012	NA	6357	6150	207	3.3
CN3114700000000	31	147	Richardson County, NE	2012	NA	4408	4182	226	5.1
CN3114900000000	31	149	Rock County, NE	2012	NA	880	858	22	2.5
CN3115100000000	31	151	Saline County, NE	2012	NA	7364	7044	320	4.3
CN3115300000000	31	153	Sarpy County, NE	2012	NA	88075	84673	3402	3.9
CN3115500000000	31	155	Saunders County, NE	2012	NA	11191	10717	474	4.2
CN3115700000000	31	157	Scotts Bluff County, NE	2012	NA	19236	18334	902	4.7
CN3115900000000	31	159	Seward County, NE	2012	NA	8957	8642	315	3.5
CN3116100000000	31	161	Sheridan County, NE	2012	NA	2807	2707	100	3.6
CN3116300000000	31	163	Sherman County, NE	2012	NA	1751	1685	66	3.8
CN3116500000000	31	165	Sioux County, NE	2012	NA	841	811	30	3.6
CN3116700000000	31	167	Stanton County, NE	2012	NA	3675	3547	128	3.5
CN3116900000000	31	169	Thayer County, NE	2012	NA	3008	2916	92	3.1
CN3117100000000	31	171	Thomas County, NE	2012	NA	428	411	17	4
CN3117300000000	31	173	Thurston County, NE	2012	NA	3146	2872	274	8.7
CN3117500000000	31	175	Valley County, NE	2012	NA	2152	2077	75	3.5
CN3117700000000	31	177	Washington County, NE	2012	NA	11230	10806	424	3.8
CN3117900000000	31	179	Wayne County, NE	2012	NA	5727	5543	184	3.2
CN3118100000000	31	181	Webster County, NE	2012	NA	1747	1683	64	3.7
CN3118300000000	31	183	Wheeler County, NE	2012	NA	523	505	18	3.4
CN3118500000000	31	185	York County, NE	2012	NA	7601	7320	281	3.7
CN3200100000000	32	001	Churchill County, NV	2012	NA	11113	9889	1224	11
CN3200300000000	32	003	Clark County, NV	2012	NA	999325	886826	112499	11.3
CN3200500000000	32	005	Douglas County, NV	2012	NA	22776	20167	2609	11.5
CN3200700000000	32	007	Elko County, NV	2012	NA	29116	27266	1850	6.4
CN3200900000000	32	009	Esmeralda County, NV	2012	NA	477	444	33	6.9
CN3201100000000	32	011	Eureka County, NV	2012	NA	1101	1034	67	6.1
CN3201300000000	32	013	Humboldt County, NV	2012	NA	9133	8531	602	6.6
CN3201500000000	32	015	Lander County, NV	2012	NA	3435	3181	254	7.4
CN3201700000000	32	017	Lincoln County, NV	2012	NA	2106	1886	220	10.4
CN3201900000000	32	019	Lyon County, NV	2012	NA	22555	19230	3325	14.7
CN3202100000000	32	021	Mineral County, NV	2012	NA	1906	1647	259	13.6
CN3202300000000	32	023	Nye County, NV	2012	NA	16712	14304	2408	14.4
CN3202700000000	32	027	Pershing County, NV	2012	NA	2610	2358	252	9.7
CN3202900000000	32	029	Storey County, NV	2012	NA	1916	1661	255	13.3
CN3203100000000	32	031	Washoe County, NV	2012	NA	221128	196740	24388	11
CN3203300000000	32	033	White Pine County, NV	2012	NA	5064	4677	387	7.6
CN3251000000000	32	510	Carson City, NV	2012	NA	25910	22869	3041	11.7
CN3300100000000	33	001	Belknap County, NH	2012	NA	32057	30320	1737	5.4
CN3300300000000	33	003	Carroll County, NH	2012	NA	24673	23373	1300	5.3
CN3300500000000	33	005	Cheshire County, NH	2012	NA	42615	40450	2165	5.1
CN3300700000000	33	007	Coos County, NH	2012	NA	16095	14904	1191	7.4
CN3300900000000	33	009	Grafton County, NH	2012	NA	48731	46564	2167	4.4
CN3301100000000	33	011	Hillsborough County, NH	2012	NA	226905	213782	13123	5.8
CN3301300000000	33	013	Merrimack County, NH	2012	NA	81158	77143	4015	4.9
CN3301500000000	33	015	Rockingham County, NH	2012	NA	174767	164607	10160	5.8
CN3301700000000	33	017	Strafford County, NH	2012	NA	70054	66264	3790	5.4
CN3301900000000	33	019	Sullivan County, NH	2012	NA	24042	22963	1079	4.5
CN3400100000000	34	001	Atlantic County, NJ	2012	NA	140718	122847	17871	12.7
CN3400300000000	34	003	Bergen County, NJ	2012	NA	484699	447462	37237	7.7
CN3400500000000	34	005	Burlington County, NJ	2012	NA	236082	215621	20461	8.7
CN3400700000000	34	007	Camden County, NJ	2012	NA	262541	234387	28154	10.7
CN3400900000000	34	009	Cape May County, NJ	2012	NA	49960	42251	7709	15.4
CN3401100000000	34	011	Cumberland County, NJ	2012	NA	71417	62044	9373	13.1
CN3401300000000	34	013	Essex County, NJ	2012	NA	384092	342808	41284	10.7
CN3401500000000	34	015	Gloucester County, NJ	2012	NA	152000	136643	15357	10.1
CN3401700000000	34	017	Hudson County, NJ	2012	NA	360706	328634	32072	8.9
CN3401900000000	34	019	Hunterdon County, NJ	2012	NA	67533	62907	4626	6.8
CN3402100000000	34	021	Mercer County, NJ	2012	NA	194177	178129	16048	8.3
CN3402300000000	34	023	Middlesex County, NJ	2012	NA	431380	394215	37165	8.6
CN3402500000000	34	025	Monmouth County, NJ	2012	NA	331413	302512	28901	8.7
CN3402700000000	34	027	Morris County, NJ	2012	NA	267446	248414	19032	7.1
CN3402900000000	34	029	Ocean County, NJ	2012	NA	268625	240095	28530	10.6
CN3403100000000	34	031	Passaic County, NJ	2012	NA	254010	225913	28097	11.1
CN3403300000000	34	033	Salem County, NJ	2012	NA	32237	28434	3803	11.8
CN3403500000000	34	035	Somerset County, NJ	2012	NA	175899	162799	13100	7.4
CN3403700000000	34	037	Sussex County, NJ	2012	NA	81245	73919	7326	9
CN3403900000000	34	039	Union County, NJ	2012	NA	283098	256325	26773	9.5
CN3404100000000	34	041	Warren County, NJ	2012	NA	58756	53626	5130	8.7
CN3500100000000	35	001	Bernalillo County, NM	2012	NA	321012	299201	21811	6.8
CN3500300000000	35	003	Catron County, NM	2012	NA	1247	1128	119	9.5
CN3500500000000	35	005	Chaves County, NM	2012	NA	26971	25219	1752	6.5
CN3500600000000	35	006	Cibola County, NM	2012	NA	9290	8493	797	8.6
CN3500700000000	35	007	Colfax County, NM	2012	NA	6129	5649	480	7.8
CN3500900000000	35	009	Curry County, NM	2012	NA	21579	20510	1069	5
CN3501100000000	35	011	De Baca County, NM	2012	NA	822	787	35	4.3
CN3501300000000	35	013	Dona Ana County, NM	2012	NA	93767	86906	6861	7.3
CN3501500000000	35	015	Eddy County, NM	2012	NA	26831	25576	1255	4.7
CN3501700000000	35	017	Grant County, NM	2012	NA	13006	12141	865	6.7
CN3501900000000	35	019	Guadalupe County, NM	2012	NA	1646	1481	165	10
CN3502100000000	35	021	Harding County, NM	2012	NA	293	274	19	6.5
CN3502300000000	35	023	Hidalgo County, NM	2012	NA	2338	2166	172	7.4
CN3502500000000	35	025	Lea County, NM	2012	NA	28325	26988	1337	4.7
CN3502700000000	35	027	Lincoln County, NM	2012	NA	8964	8379	585	6.5
CN3502800000000	35	028	Los Alamos County, NM	2012	NA	8999	8649	350	3.9
CN3502900000000	35	029	Luna County, NM	2012	NA	11461	9171	2290	20
CN3503100000000	35	031	McKinley County, NM	2012	NA	24915	22523	2392	9.6
CN3503300000000	35	033	Mora County, NM	2012	NA	2316	2061	255	11
CN3503500000000	35	035	Otero County, NM	2012	NA	25049	23419	1630	6.5
CN3503700000000	35	037	Quay County, NM	2012	NA	3389	3115	274	8.1
CN3503900000000	35	039	Rio Arriba County, NM	2012	NA	16860	15291	1569	9.3
CN3504100000000	35	041	Roosevelt County, NM	2012	NA	8344	7878	466	5.6
CN3504300000000	35	043	Sandoval County, NM	2012	NA	60524	55816	4708	7.8
CN3504500000000	35	045	San Juan County, NM	2012	NA	55309	51384	3925	7.1
CN3504700000000	35	047	San Miguel County, NM	2012	NA	11103	10115	988	8.9
CN3504900000000	35	049	Santa Fe County, NM	2012	NA	73658	69401	4257	5.8
CN3505100000000	35	051	Sierra County, NM	2012	NA	3973	3583	390	9.8
CN3505300000000	35	053	Socorro County, NM	2012	NA	6819	6343	476	7
CN3505500000000	35	055	Taos County, NM	2012	NA	15003	13434	1569	10.5
CN3505700000000	35	057	Torrance County, NM	2012	NA	5764	5152	612	10.6
CN3505900000000	35	059	Union County, NM	2012	NA	1872	1790	82	4.4
CN3506100000000	35	061	Valencia County, NM	2012	NA	30216	27595	2621	8.7
CN3600100000000	36	001	Albany County, NY	2012	NA	160657	149260	11397	7.1
CN3600300000000	36	003	Allegany County, NY	2012	NA	23691	21697	1994	8.4
CN3600500000000	36	005	Bronx County, NY	2012	NA	594943	520987	73956	12.4
CN3600700000000	36	007	Broome County, NY	2012	NA	94012	85835	8177	8.7
CN3600900000000	36	009	Cattaraugus County, NY	2012	NA	38308	34733	3575	9.3
CN3601100000000	36	011	Cayuga County, NY	2012	NA	39113	35884	3229	8.3
CN3601300000000	36	013	Chautauqua County, NY	2012	NA	61278	56055	5223	8.5
CN3601500000000	36	015	Chemung County, NY	2012	NA	40553	37142	3411	8.4
CN3601700000000	36	017	Chenango County, NY	2012	NA	24127	22044	2083	8.6
CN3601900000000	36	019	Clinton County, NY	2012	NA	37998	34424	3574	9.4
CN3602100000000	36	021	Columbia County, NY	2012	NA	31681	29451	2230	7
CN3602300000000	36	023	Cortland County, NY	2012	NA	24476	22365	2111	8.6
CN3602500000000	36	025	Delaware County, NY	2012	NA	21589	19702	1887	8.7
CN3602700000000	36	027	Dutchess County, NY	2012	NA	146383	134988	11395	7.8
CN3602900000000	36	029	Erie County, NY	2012	NA	461760	423403	38357	8.3
CN3603100000000	36	031	Essex County, NY	2012	NA	18176	16437	1739	9.6
CN3603300000000	36	033	Franklin County, NY	2012	NA	21796	19712	2084	9.6
CN3603500000000	36	035	Fulton County, NY	2012	NA	25392	22595	2797	11
CN3603700000000	36	037	Genesee County, NY	2012	NA	30885	28443	2442	7.9
CN3603900000000	36	039	Greene County, NY	2012	NA	21547	19406	2141	9.9
CN3604100000000	36	041	Hamilton County, NY	2012	NA	2449	2187	262	10.7
CN3604300000000	36	043	Herkimer County, NY	2012	NA	30538	27861	2677	8.8
CN3604500000000	36	045	Jefferson County, NY	2012	NA	48426	43648	4778	9.9
CN3604700000000	36	047	Kings County, NY	2012	NA	1190125	1073762	116363	9.8
CN3604900000000	36	049	Lewis County, NY	2012	NA	12269	11043	1226	10
CN3605100000000	36	051	Livingston County, NY	2012	NA	32147	29625	2522	7.8
CN3605300000000	36	053	Madison County, NY	2012	NA	34620	31675	2945	8.5
CN3605500000000	36	055	Monroe County, NY	2012	NA	376288	346636	29652	7.9
CN3605700000000	36	057	Montgomery County, NY	2012	NA	23451	21011	2440	10.4
CN3605900000000	36	059	Nassau County, NY	2012	NA	693607	644803	48804	7
CN3606100000000	36	061	New York County, NY	2012	NA	894987	823126	71861	8
CN3606300000000	36	063	Niagara County, NY	2012	NA	105750	95894	9856	9.3
CN3606500000000	36	065	Oneida County, NY	2012	NA	108562	99615	8947	8.2
CN3606700000000	36	067	Onondaga County, NY	2012	NA	232973	214624	18349	7.9
CN3606900000000	36	069	Ontario County, NY	2012	NA	56046	51971	4075	7.3
CN3607100000000	36	071	Orange County, NY	2012	NA	179621	165414	14207	7.9
CN3607300000000	36	073	Orleans County, NY	2012	NA	18873	17045	1828	9.7
CN3607500000000	36	075	Oswego County, NY	2012	NA	57942	51585	6357	11
CN3607700000000	36	077	Otsego County, NY	2012	NA	31460	28988	2472	7.9
CN3607900000000	36	079	Putnam County, NY	2012	NA	51603	47899	3704	7.2
CN3608100000000	36	081	Queens County, NY	2012	NA	1124169	1031021	93148	8.3
CN3608300000000	36	083	Rensselaer County, NY	2012	NA	83602	77126	6476	7.7
CN3608500000000	36	085	Richmond County, NY	2012	NA	218237	197583	20654	9.5
CN3608700000000	36	087	Rockland County, NY	2012	NA	150454	139454	11000	7.3
CN3608900000000	36	089	St. Lawrence County, NY	2012	NA	48589	43627	4962	10.2
CN3609100000000	36	091	Saratoga County, NY	2012	NA	117525	109520	8005	6.8
CN3609300000000	36	093	Schenectady County, NY	2012	NA	78052	72058	5994	7.7
CN3609500000000	36	095	Schoharie County, NY	2012	NA	15455	14034	1421	9.2
CN3609700000000	36	097	Schuyler County, NY	2012	NA	9032	8184	848	9.4
CN3609900000000	36	099	Seneca County, NY	2012	NA	16242	14946	1296	8
CN3610100000000	36	101	Steuben County, NY	2012	NA	45823	41544	4279	9.3
CN3610300000000	36	103	Suffolk County, NY	2012	NA	779400	718733	60667	7.8
CN3610500000000	36	105	Sullivan County, NY	2012	NA	35311	32093	3218	9.1
CN3610700000000	36	107	Tioga County, NY	2012	NA	25466	23457	2009	7.9
CN3610900000000	36	109	Tompkins County, NY	2012	NA	55074	51699	3375	6.1
CN3611100000000	36	111	Ulster County, NY	2012	NA	91045	83508	7537	8.3
CN3611300000000	36	113	Warren County, NY	2012	NA	33761	30660	3101	9.2
CN3611500000000	36	115	Washington County, NY	2012	NA	29899	27426	2473	8.3
CN3611700000000	36	117	Wayne County, NY	2012	NA	46529	42536	3993	8.6
CN3611900000000	36	119	Westchester County, NY	2012	NA	477481	442827	34654	7.3
CN3612100000000	36	121	Wyoming County, NY	2012	NA	18902	17229	1673	8.9
CN3612300000000	36	123	Yates County, NY	2012	NA	12090	11147	943	7.8
CN3700100000000	37	001	Alamance County, NC	2012	NA	78000	71344	6656	8.5
CN3700300000000	37	003	Alexander County, NC	2012	NA	17674	15981	1693	9.6
CN3700500000000	37	005	Alleghany County, NC	2012	NA	4604	4123	481	10.4
CN3700700000000	37	007	Anson County, NC	2012	NA	11057	9850	1207	10.9
CN3700900000000	37	009	Ashe County, NC	2012	NA	13186	11810	1376	10.4
CN3701100000000	37	011	Avery County, NC	2012	NA	7743	6920	823	10.6
CN3701300000000	37	013	Beaufort County, NC	2012	NA	21047	18820	2227	10.6
CN3701500000000	37	015	Bertie County, NC	2012	NA	8668	7679	989	11.4
CN3701700000000	37	017	Bladen County, NC	2012	NA	14450	12615	1835	12.7
CN3701900000000	37	019	Brunswick County, NC	2012	NA	47348	42027	5321	11.2
CN3702100000000	37	021	Buncombe County, NC	2012	NA	126437	117278	9159	7.2
CN3702300000000	37	023	Burke County, NC	2012	NA	40692	36687	4005	9.8
CN3702500000000	37	025	Cabarrus County, NC	2012	NA	91361	83139	8222	9
CN3702700000000	37	027	Caldwell County, NC	2012	NA	36895	32613	4282	11.6
CN3702900000000	37	029	Camden County, NC	2012	NA	4521	4166	355	7.9
CN3703100000000	37	031	Carteret County, NC	2012	NA	31502	28685	2817	8.9
CN3703300000000	37	033	Caswell County, NC	2012	NA	9961	8901	1060	10.6
CN3703500000000	37	035	Catawba County, NC	2012	NA	76572	68806	7766	10.1
CN3703700000000	37	037	Chatham County, NC	2012	NA	31617	29137	2480	7.8
CN3703900000000	37	039	Cherokee County, NC	2012	NA	11423	10171	1252	11
CN3704100000000	37	041	Chowan County, NC	2012	NA	5905	5262	643	10.9
CN3704300000000	37	043	Clay County, NC	2012	NA	4168	3736	432	10.4
CN3704500000000	37	045	Cleveland County, NC	2012	NA	45749	40700	5049	11
CN3704700000000	37	047	Columbus County, NC	2012	NA	23183	20341	2842	12.3
CN3704900000000	37	049	Craven County, NC	2012	NA	41875	37905	3970	9.5
CN3705100000000	37	051	Cumberland County, NC	2012	NA	132432	118538	13894	10.5
CN3705300000000	37	053	Currituck County, NC	2012	NA	12460	11395	1065	8.5
CN3705500000000	37	055	Dare County, NC	2012	NA	20718	18156	2562	12.4
CN3705700000000	37	057	Davidson County, NC	2012	NA	79611	71892	7719	9.7
CN3705900000000	37	059	Davie County, NC	2012	NA	19996	18183	1813	9.1
CN3706100000000	37	061	Duplin County, NC	2012	NA	26421	24011	2410	9.1
CN3706300000000	37	063	Durham County, NC	2012	NA	148700	137697	11003	7.4
CN3706500000000	37	065	Edgecombe County, NC	2012	NA	24358	20871	3487	14.3
CN3706700000000	37	067	Forsyth County, NC	2012	NA	176410	160794	15616	8.9
CN3706900000000	37	069	Franklin County, NC	2012	NA	28165	25436	2729	9.7
CN3707100000000	37	071	Gaston County, NC	2012	NA	100997	90442	10555	10.5
CN3707300000000	37	073	Gates County, NC	2012	NA	5357	4946	411	7.7
CN3707500000000	37	075	Graham County, NC	2012	NA	3576	2944	632	17.7
CN3707700000000	37	077	Granville County, NC	2012	NA	28301	26036	2265	8
CN3707900000000	37	079	Greene County, NC	2012	NA	9652	8822	830	8.6
CN3708100000000	37	081	Guilford County, NC	2012	NA	254739	230428	24311	9.5
CN3708300000000	37	083	Halifax County, NC	2012	NA	21942	18972	2970	13.5
CN3708500000000	37	085	Harnett County, NC	2012	NA	49719	44443	5276	10.6
CN3708700000000	37	087	Haywood County, NC	2012	NA	27515	25008	2507	9.1
CN3708900000000	37	089	Henderson County, NC	2012	NA	48589	44949	3640	7.5
CN3709100000000	37	091	Hertford County, NC	2012	NA	9574	8543	1031	10.8
CN3709300000000	37	093	Hoke County, NC	2012	NA	19831	17715	2116	10.7
CN3709500000000	37	095	Hyde County, NC	2012	NA	2131	1845	286	13.4
CN3709700000000	37	097	Iredell County, NC	2012	NA	79259	71394	7865	9.9
CN3709900000000	37	099	Jackson County, NC	2012	NA	18073	16161	1912	10.6
CN3710100000000	37	101	Johnston County, NC	2012	NA	83522	76485	7037	8.4
CN3710300000000	37	103	Jones County, NC	2012	NA	4589	4134	455	9.9
CN3710500000000	37	105	Lee County, NC	2012	NA	27094	24014	3080	11.4
CN3710700000000	37	107	Lenoir County, NC	2012	NA	28489	25696	2793	9.8
CN3710900000000	37	109	Lincoln County, NC	2012	NA	39941	36103	3838	9.6
CN3711100000000	37	111	McDowell County, NC	2012	NA	20596	18366	2230	10.8
CN3711300000000	37	113	Macon County, NC	2012	NA	15483	13840	1643	10.6
CN3711500000000	37	115	Madison County, NC	2012	NA	9489	8563	926	9.8
CN3711700000000	37	117	Martin County, NC	2012	NA	10431	9179	1252	12
CN3711900000000	37	119	Mecklenburg County, NC	2012	NA	527788	481623	46165	8.7
CN3712100000000	37	121	Mitchell County, NC	2012	NA	6649	5836	813	12.2
CN3712300000000	37	123	Montgomery County, NC	2012	NA	11554	10331	1223	10.6
CN3712500000000	37	125	Moore County, NC	2012	NA	37474	34181	3293	8.8
CN3712700000000	37	127	Nash County, NC	2012	NA	46110	40796	5314	11.5
CN3712900000000	37	129	New Hanover County, NC	2012	NA	108852	99450	9402	8.6
CN3713100000000	37	131	Northampton County, NC	2012	NA	8297	7345	952	11.5
CN3713300000000	37	133	Onslow County, NC	2012	NA	63599	58505	5094	8
CN3713500000000	37	135	Orange County, NC	2012	NA	72076	67675	4401	6.1
CN3713700000000	37	137	Pamlico County, NC	2012	NA	5371	4887	484	9
CN3713900000000	37	139	Pasquotank County, NC	2012	NA	18123	16303	1820	10
CN3714100000000	37	141	Pender County, NC	2012	NA	24880	22285	2595	10.4
CN3714300000000	37	143	Perquimans County, NC	2012	NA	5266	4717	549	10.4
CN3714500000000	37	145	Person County, NC	2012	NA	18394	16365	2029	11
CN3714700000000	37	147	Pitt County, NC	2012	NA	87721	79725	7996	9.1
CN3714900000000	37	149	Polk County, NC	2012	NA	8349	7640	709	8.5
CN3715100000000	37	151	Randolph County, NC	2012	NA	68475	61672	6803	9.9
CN3715300000000	37	153	Richmond County, NC	2012	NA	17929	15530	2399	13.4
CN3715500000000	37	155	Robeson County, NC	2012	NA	52819	45822	6997	13.2
CN3715700000000	37	157	Rockingham County, NC	2012	NA	43033	38186	4847	11.3
CN3715900000000	37	159	Rowan County, NC	2012	NA	63310	56426	6884	10.9
CN3716100000000	37	161	Rutherford County, NC	2012	NA	26780	23245	3535	13.2
CN3716300000000	37	163	Sampson County, NC	2012	NA	29697	26932	2765	9.3
CN3716500000000	37	165	Scotland County, NC	2012	NA	12462	10324	2138	17.2
CN3716700000000	37	167	Stanly County, NC	2012	NA	28752	25893	2859	9.9
CN3716900000000	37	169	Stokes County, NC	2012	NA	22391	20309	2082	9.3
CN3717100000000	37	171	Surry County, NC	2012	NA	33651	30410	3241	9.6
CN3717300000000	37	173	Swain County, NC	2012	NA	6522	5562	960	14.7
CN3717500000000	37	175	Transylvania County, NC	2012	NA	13456	12286	1170	8.7
CN3717700000000	37	177	Tyrrell County, NC	2012	NA	1583	1367	216	13.6
CN3717900000000	37	179	Union County, NC	2012	NA	104230	96045	8185	7.9
CN3718100000000	37	181	Vance County, NC	2012	NA	18486	15985	2501	13.5
CN3718300000000	37	183	Wake County, NC	2012	NA	502454	466623	35831	7.1
CN3718500000000	37	185	Warren County, NC	2012	NA	7578	6635	943	12.4
CN3718700000000	37	187	Washington County, NC	2012	NA	4871	4124	747	15.3
CN3718900000000	37	189	Watauga County, NC	2012	NA	27059	25062	1997	7.4
CN3719100000000	37	191	Wayne County, NC	2012	NA	55377	50689	4688	8.5
CN3719300000000	37	193	Wilkes County, NC	2012	NA	30585	27411	3174	10.4
CN3719500000000	37	195	Wilson County, NC	2012	NA	38327	33345	4982	13
CN3719700000000	37	197	Yadkin County, NC	2012	NA	17964	16315	1649	9.2
CN3719900000000	37	199	Yancey County, NC	2012	NA	7975	7123	852	10.7
CN3800100000000	38	001	Adams County, ND	2012	NA	1112	1080	32	2.9
CN3800300000000	38	003	Barnes County, ND	2012	NA	5753	5556	197	3.4
CN3800500000000	38	005	Benson County, ND	2012	NA	2775	2581	194	7
CN3800700000000	38	007	Billings County, ND	2012	NA	474	458	16	3.4
CN3800900000000	38	009	Bottineau County, ND	2012	NA	3409	3293	116	3.4
CN3801100000000	38	011	Bowman County, ND	2012	NA	1918	1883	35	1.8
CN3801300000000	38	013	Burke County, ND	2012	NA	1375	1348	27	2
CN3801500000000	38	015	Burleigh County, ND	2012	NA	46608	45293	1315	2.8
CN3801700000000	38	017	Cass County, ND	2012	NA	89610	86980	2630	2.9
CN3801900000000	38	019	Cavalier County, ND	2012	NA	2148	2080	68	3.2
CN3802100000000	38	021	Dickey County, ND	2012	NA	2709	2635	74	2.7
CN3802300000000	38	023	Divide County, ND	2012	NA	1787	1760	27	1.5
CN3802500000000	38	025	Dunn County, ND	2012	NA	3680	3622	58	1.6
CN3802700000000	38	027	Eddy County, ND	2012	NA	1250	1186	64	5.1
CN3802900000000	38	029	Emmons County, ND	2012	NA	1648	1559	89	5.4
CN3803100000000	38	031	Foster County, ND	2012	NA	1684	1631	53	3.1
CN3803300000000	38	033	Golden Valley County, ND	2012	NA	981	957	24	2.4
CN3803500000000	38	035	Grand Forks County, ND	2012	NA	37306	36043	1263	3.4
CN3803700000000	38	037	Grant County, ND	2012	NA	1300	1259	41	3.2
CN3803900000000	38	039	Griggs County, ND	2012	NA	1225	1192	33	2.7
CN3804100000000	38	041	Hettinger County, ND	2012	NA	1454	1415	39	2.7
CN3804300000000	38	043	Kidder County, ND	2012	NA	1264	1199	65	5.1
CN3804500000000	38	045	LaMoure County, ND	2012	NA	2277	2220	57	2.5
CN3804700000000	38	047	Logan County, ND	2012	NA	908	880	28	3.1
CN3804900000000	38	049	McHenry County, ND	2012	NA	3284	3143	141	4.3
CN3805100000000	38	051	McIntosh County, ND	2012	NA	1248	1208	40	3.2
CN3805300000000	38	053	McKenzie County, ND	2012	NA	6098	6005	93	1.5
CN3805500000000	38	055	McLean County, ND	2012	NA	4755	4546	209	4.4
CN3805700000000	38	057	Mercer County, ND	2012	NA	4037	3822	215	5.3
CN3805900000000	38	059	Morton County, ND	2012	NA	15505	14950	555	3.6
CN3806100000000	38	061	Mountrail County, ND	2012	NA	7412	7291	121	1.6
CN3806300000000	38	063	Nelson County, ND	2012	NA	1547	1483	64	4.1
CN3806500000000	38	065	Oliver County, ND	2012	NA	891	831	60	6.7
CN3806700000000	38	067	Pembina County, ND	2012	NA	3709	3471	238	6.4
CN3806900000000	38	069	Pierce County, ND	2012	NA	1875	1794	81	4.3
CN3807100000000	38	071	Ramsey County, ND	2012	NA	5827	5586	241	4.1
CN3807300000000	38	073	Ransom County, ND	2012	NA	2799	2715	84	3
CN3807500000000	38	075	Renville County, ND	2012	NA	1445	1412	33	2.3
CN3807700000000	38	077	Richland County, ND	2012	NA	8565	8253	312	3.6
CN3807900000000	38	079	Rolette County, ND	2012	NA	5022	4493	529	10.5
CN3808100000000	38	081	Sargent County, ND	2012	NA	2147	2090	57	2.7
CN3808300000000	38	083	Sheridan County, ND	2012	NA	737	710	27	3.7
CN3808500000000	38	085	Sioux County, ND	2012	NA	1307	1239	68	5.2
CN3808700000000	38	087	Slope County, ND	2012	NA	529	518	11	2.1
CN3808900000000	38	089	Stark County, ND	2012	NA	18262	17929	333	1.8
CN3809100000000	38	091	Steele County, ND	2012	NA	1049	1021	28	2.7
CN3809300000000	38	093	Stutsman County, ND	2012	NA	10425	10067	358	3.4
CN3809500000000	38	095	Towner County, ND	2012	NA	1260	1218	42	3.3
CN3809700000000	38	097	Traill County, ND	2012	NA	4532	4389	143	3.2
CN3809900000000	38	099	Walsh County, ND	2012	NA	5666	5389	277	4.9
CN3810100000000	38	101	Ward County, ND	2012	NA	33955	33055	900	2.7
CN3810300000000	38	103	Wells County, ND	2012	NA	2228	2139	89	4
CN3810500000000	38	105	Williams County, ND	2012	NA	27098	26795	303	1.1
CN3900100000000	39	001	Adams County, OH	2012	NA	10770	9416	1354	12.6
CN3900300000000	39	003	Allen County, OH	2012	NA	49937	46089	3848	7.7
CN3900500000000	39	005	Ashland County, OH	2012	NA	25820	23745	2075	8
CN3900700000000	39	007	Ashtabula County, OH	2012	NA	46433	42062	4371	9.4
CN3900900000000	39	009	Athens County, OH	2012	NA	27585	25235	2350	8.5
CN3901100000000	39	011	Auglaize County, OH	2012	NA	23945	22465	1480	6.2
CN3901300000000	39	013	Belmont County, OH	2012	NA	31728	29111	2617	8.2
CN3901500000000	39	015	Brown County, OH	2012	NA	20144	18130	2014	10
CN3901700000000	39	017	Butler County, OH	2012	NA	186468	172183	14285	7.7
CN3901900000000	39	019	Carroll County, OH	2012	NA	13791	12696	1095	7.9
CN3902100000000	39	021	Champaign County, OH	2012	NA	19372	17942	1430	7.4
CN3902300000000	39	023	Clark County, OH	2012	NA	65847	60730	5117	7.8
CN3902500000000	39	025	Clermont County, OH	2012	NA	102086	94484	7602	7.4
CN3902700000000	39	027	Clinton County, OH	2012	NA	17282	15425	1857	10.7
CN3902900000000	39	029	Columbiana County, OH	2012	NA	50892	46694	4198	8.2
CN3903100000000	39	031	Coshocton County, OH	2012	NA	16205	14575	1630	10.1
CN3903300000000	39	033	Crawford County, OH	2012	NA	20305	18466	1839	9.1
CN3903500000000	39	035	Cuyahoga County, OH	2012	NA	619168	577178	41990	6.8
CN3903700000000	39	037	Darke County, OH	2012	NA	26561	24638	1923	7.2
CN3903900000000	39	039	Defiance County, OH	2012	NA	18986	17531	1455	7.7
CN3904100000000	39	041	Delaware County, OH	2012	NA	95949	90968	4981	5.2
CN3904300000000	39	043	Erie County, OH	2012	NA	38623	35530	3093	8
CN3904500000000	39	045	Fairfield County, OH	2012	NA	73311	68444	4867	6.6
CN3904700000000	39	047	Fayette County, OH	2012	NA	14112	12942	1170	8.3
CN3904900000000	39	049	Franklin County, OH	2012	NA	630055	589581	40474	6.4
CN3905100000000	39	051	Fulton County, OH	2012	NA	22419	20685	1734	7.7
CN3905300000000	39	053	Gallia County, OH	2012	NA	12647	11424	1223	9.7
CN3905500000000	39	055	Geauga County, OH	2012	NA	48839	46234	2605	5.3
CN3905700000000	39	057	Greene County, OH	2012	NA	80619	75067	5552	6.9
CN3905900000000	39	059	Guernsey County, OH	2012	NA	18227	16592	1635	9
CN3906100000000	39	061	Hamilton County, OH	2012	NA	401987	372343	29644	7.4
CN3906300000000	39	063	Hancock County, OH	2012	NA	39785	37240	2545	6.4
CN3906500000000	39	065	Hardin County, OH	2012	NA	14887	13776	1111	7.5
CN3906700000000	39	067	Harrison County, OH	2012	NA	6973	6377	596	8.5
CN3906900000000	39	069	Henry County, OH	2012	NA	14117	12882	1235	8.7
CN3907100000000	39	071	Highland County, OH	2012	NA	17605	15771	1834	10.4
CN3907300000000	39	073	Hocking County, OH	2012	NA	13547	12427	1120	8.3
CN3907500000000	39	075	Holmes County, OH	2012	NA	19745	18730	1015	5.1
CN3907700000000	39	077	Huron County, OH	2012	NA	28946	26079	2867	9.9
CN3907900000000	39	079	Jackson County, OH	2012	NA	13718	12301	1417	10.3
CN3908100000000	39	081	Jefferson County, OH	2012	NA	31258	27863	3395	10.9
CN3908300000000	39	083	Knox County, OH	2012	NA	30142	28047	2095	7
CN3908500000000	39	085	Lake County, OH	2012	NA	124495	117089	7406	5.9
CN3908700000000	39	087	Lawrence County, OH	2012	NA	26501	24251	2250	8.5
CN3908900000000	39	089	Licking County, OH	2012	NA	86002	80186	5816	6.8
CN3909100000000	39	091	Logan County, OH	2012	NA	22594	20979	1615	7.1
CN3909300000000	39	093	Lorain County, OH	2012	NA	149175	138642	10533	7.1
CN3909500000000	39	095	Lucas County, OH	2012	NA	210372	192835	17537	8.3
CN3909700000000	39	097	Madison County, OH	2012	NA	20082	18800	1282	6.4
CN3909900000000	39	099	Mahoning County, OH	2012	NA	110705	101514	9191	8.3
CN3910100000000	39	101	Marion County, OH	2012	NA	28880	26595	2285	7.9
CN3910300000000	39	103	Medina County, OH	2012	NA	93623	88480	5143	5.5
CN3910500000000	39	105	Meigs County, OH	2012	NA	9502	8404	1098	11.6
CN3910700000000	39	107	Mercer County, OH	2012	NA	22129	20999	1130	5.1
CN3910900000000	39	109	Miami County, OH	2012	NA	52314	48510	3804	7.3
CN3911100000000	39	111	Monroe County, OH	2012	NA	6492	5947	545	8.4
CN3911300000000	39	113	Montgomery County, OH	2012	NA	254447	233575	20872	8.2
CN3911500000000	39	115	Morgan County, OH	2012	NA	6698	6035	663	9.9
CN3911700000000	39	117	Morrow County, OH	2012	NA	16894	15521	1373	8.1
CN3911900000000	39	119	Muskingum County, OH	2012	NA	40358	36657	3701	9.2
CN3912100000000	39	121	Noble County, OH	2012	NA	4779	4253	526	11
CN3912300000000	39	123	Ottawa County, OH	2012	NA	21991	19896	2095	9.5
CN3912500000000	39	125	Paulding County, OH	2012	NA	9210	8502	708	7.7
CN3912700000000	39	127	Perry County, OH	2012	NA	16086	14512	1574	9.8
CN3912900000000	39	129	Pickaway County, OH	2012	NA	25692	23779	1913	7.4
CN3913100000000	39	131	Pike County, OH	2012	NA	10566	9188	1378	13
CN3913300000000	39	133	Portage County, OH	2012	NA	87954	81546	6408	7.3
CN3913500000000	39	135	Preble County, OH	2012	NA	21470	19811	1659	7.7
CN3913700000000	39	137	Putnam County, OH	2012	NA	18791	17700	1091	5.8
CN3913900000000	39	139	Richland County, OH	2012	NA	55858	50987	4871	8.7
CN3914100000000	39	141	Ross County, OH	2012	NA	34037	31175	2862	8.4
CN3914300000000	39	143	Sandusky County, OH	2012	NA	31758	29368	2390	7.5
CN3914500000000	39	145	Scioto County, OH	2012	NA	31080	27567	3513	11.3
CN3914700000000	39	147	Seneca County, OH	2012	NA	27788	25575	2213	8
CN3914900000000	39	149	Shelby County, OH	2012	NA	23834	22097	1737	7.3
CN3915100000000	39	151	Stark County, OH	2012	NA	187871	173824	14047	7.5
CN3915300000000	39	153	Summit County, OH	2012	NA	272305	251990	20315	7.5
CN3915500000000	39	155	Trumbull County, OH	2012	NA	95305	86681	8624	9
CN3915700000000	39	157	Tuscarawas County, OH	2012	NA	44972	41665	3307	7.4
CN3915900000000	39	159	Union County, OH	2012	NA	26329	24816	1513	5.7
CN3916100000000	39	161	Van Wert County, OH	2012	NA	14150	13082	1068	7.5
CN3916300000000	39	163	Vinton County, OH	2012	NA	5548	4948	600	10.8
CN3916500000000	39	165	Warren County, OH	2012	NA	109019	101929	7090	6.5
CN3916700000000	39	167	Washington County, OH	2012	NA	28412	25954	2458	8.7
CN3916900000000	39	169	Wayne County, OH	2012	NA	59042	55431	3611	6.1
CN3917100000000	39	171	Williams County, OH	2012	NA	18853	17363	1490	7.9
CN3917300000000	39	173	Wood County, OH	2012	NA	68668	63951	4717	6.9
CN3917500000000	39	175	Wyandot County, OH	2012	NA	12133	11303	830	6.8
CN4000100000000	40	001	Adair County, OK	2012	NA	8503	7727	776	9.1
CN4000300000000	40	003	Alfalfa County, OK	2012	NA	2919	2836	83	2.8
CN4000500000000	40	005	Atoka County, OK	2012	NA	5004	4665	339	6.8
CN4000700000000	40	007	Beaver County, OK	2012	NA	3129	3035	94	3
CN4000900000000	40	009	Beckham County, OK	2012	NA	12561	12181	380	3
CN4001100000000	40	011	Blaine County, OK	2012	NA	4378	4208	170	3.9
CN4001300000000	40	013	Bryan County, OK	2012	NA	17629	16684	945	5.4
CN4001500000000	40	015	Caddo County, OK	2012	NA	11713	11012	701	6
CN4001700000000	40	017	Canadian County, OK	2012	NA	63528	61050	2478	3.9
CN4001900000000	40	019	Carter County, OK	2012	NA	21939	20727	1212	5.5
CN4002100000000	40	021	Cherokee County, OK	2012	NA	18987	17652	1335	7
CN4002300000000	40	023	Choctaw County, OK	2012	NA	5834	5341	493	8.5
CN4002500000000	40	025	Cimarron County, OK	2012	NA	1292	1250	42	3.3
CN4002700000000	40	027	Cleveland County, OK	2012	NA	136363	130724	5639	4.1
CN4002900000000	40	029	Coal County, OK	2012	NA	2368	2200	168	7.1
CN4003100000000	40	031	Comanche County, OK	2012	NA	50862	47845	3017	5.9
CN4003300000000	40	033	Cotton County, OK	2012	NA	2887	2724	163	5.6
CN4003500000000	40	035	Craig County, OK	2012	NA	6365	6006	359	5.6
CN4003700000000	40	037	Creek County, OK	2012	NA	31618	29712	1906	6
CN4003900000000	40	039	Custer County, OK	2012	NA	15691	15132	559	3.6
CN4004100000000	40	041	Delaware County, OK	2012	NA	17140	16010	1130	6.6
CN4004300000000	40	043	Dewey County, OK	2012	NA	2383	2307	76	3.2
CN4004500000000	40	045	Ellis County, OK	2012	NA	2282	2217	65	2.8
CN4004700000000	40	047	Garfield County, OK	2012	NA	29555	28358	1197	4.1
CN4004900000000	40	049	Garvin County, OK	2012	NA	12526	11904	622	5
CN4005100000000	40	051	Grady County, OK	2012	NA	25585	24367	1218	4.8
CN4005300000000	40	053	Grant County, OK	2012	NA	2653	2563	90	3.4
CN4005500000000	40	055	Greer County, OK	2012	NA	2076	1965	111	5.3
CN4005700000000	40	057	Harmon County, OK	2012	NA	1415	1349	66	4.7
CN4005900000000	40	059	Harper County, OK	2012	NA	1920	1859	61	3.2
CN4006100000000	40	061	Haskell County, OK	2012	NA	4624	4213	411	8.9
CN4006300000000	40	063	Hughes County, OK	2012	NA	5778	5314	464	8
CN4006500000000	40	065	Jackson County, OK	2012	NA	11084	10516	568	5.1
CN4006700000000	40	067	Jefferson County, OK	2012	NA	2605	2477	128	4.9
CN4006900000000	40	069	Johnston County, OK	2012	NA	3652	3368	284	7.8
CN4007100000000	40	071	Kay County, OK	2012	NA	20316	18874	1442	7.1
CN4007300000000	40	073	Kingfisher County, OK	2012	NA	7704	7446	258	3.3
CN4007500000000	40	075	Kiowa County, OK	2012	NA	4275	4074	201	4.7
CN4007700000000	40	077	Latimer County, OK	2012	NA	4555	4168	387	8.5
CN4007900000000	40	079	Le Flore County, OK	2012	NA	20119	18383	1736	8.6
CN4008100000000	40	081	Lincoln County, OK	2012	NA	15570	14796	774	5
CN4008300000000	40	083	Logan County, OK	2012	NA	20619	19718	901	4.4
CN4008500000000	40	085	Love County, OK	2012	NA	5116	4899	217	4.2
CN4008700000000	40	087	McClain County, OK	2012	NA	17588	16852	736	4.2
CN4008900000000	40	089	McCurtain County, OK	2012	NA	14471	13096	1375	9.5
CN4009100000000	40	091	McIntosh County, OK	2012	NA	7432	6677	755	10.2
CN4009300000000	40	093	Major County, OK	2012	NA	4078	3935	143	3.5
CN4009500000000	40	095	Marshall County, OK	2012	NA	6820	6423	397	5.8
CN4009700000000	40	097	Mayes County, OK	2012	NA	18499	17368	1131	6.1
CN4009900000000	40	099	Murray County, OK	2012	NA	6682	6374	308	4.6
CN4010100000000	40	101	Muskogee County, OK	2012	NA	30141	28116	2025	6.7
CN4010300000000	40	103	Noble County, OK	2012	NA	5497	5254	243	4.4
CN4010500000000	40	105	Nowata County, OK	2012	NA	4921	4585	336	6.8
CN4010700000000	40	107	Okfuskee County, OK	2012	NA	4416	4079	337	7.6
CN4010900000000	40	109	Oklahoma County, OK	2012	NA	365892	348402	17490	4.8
CN4011100000000	40	111	Okmulgee County, OK	2012	NA	16557	15245	1312	7.9
CN4011300000000	40	113	Osage County, OK	2012	NA	21335	20089	1246	5.8
CN4011500000000	40	115	Ottawa County, OK	2012	NA	14573	13429	1144	7.9
CN4011700000000	40	117	Pawnee County, OK	2012	NA	7508	7015	493	6.6
CN4011900000000	40	119	Payne County, OK	2012	NA	37929	36149	1780	4.7
CN4012100000000	40	121	Pittsburg County, OK	2012	NA	19047	17719	1328	7
CN4012300000000	40	123	Pontotoc County, OK	2012	NA	18279	17351	928	5.1
CN4012500000000	40	125	Pottawatomie County, OK	2012	NA	32072	30370	1702	5.3
CN4012700000000	40	127	Pushmataha County, OK	2012	NA	4866	4514	352	7.2
CN4012900000000	40	129	Roger Mills County, OK	2012	NA	2107	2047	60	2.8
CN4013100000000	40	131	Rogers County, OK	2012	NA	43833	41652	2181	5
CN4013300000000	40	133	Seminole County, OK	2012	NA	10003	9219	784	7.8
CN4013500000000	40	135	Sequoyah County, OK	2012	NA	17245	15807	1438	8.3
CN4013700000000	40	137	Stephens County, OK	2012	NA	20591	19580	1011	4.9
CN4013900000000	40	139	Texas County, OK	2012	NA	8991	8617	374	4.2
CN4014100000000	40	141	Tillman County, OK	2012	NA	3415	3250	165	4.8
CN4014300000000	40	143	Tulsa County, OK	2012	NA	310018	294043	15975	5.2
CN4014500000000	40	145	Wagoner County, OK	2012	NA	36015	34148	1867	5.2
CN4014700000000	40	147	Washington County, OK	2012	NA	24602	23416	1186	4.8
CN4014900000000	40	149	Washita County, OK	2012	NA	5651	5426	225	4
CN4015100000000	40	151	Woods County, OK	2012	NA	5075	4934	141	2.8
CN4015300000000	40	153	Woodward County, OK	2012	NA	10597	10225	372	3.5
CN4100100000000	41	001	Baker County, OR	2012	NA	7096	6347	749	10.6
CN4100300000000	41	003	Benton County, OR	2012	NA	44962	42263	2699	6
CN4100500000000	41	005	Clackamas County, OR	2012	NA	200407	184288	16119	8
CN4100700000000	41	007	Clatsop County, OR	2012	NA	18539	16918	1621	8.7
CN4100900000000	41	009	Columbia County, OR	2012	NA	22920	20464	2456	10.7
CN4101100000000	41	011	Coos County, OR	2012	NA	27096	24091	3005	11.1
CN4101300000000	41	013	Crook County, OR	2012	NA	9226	7975	1251	13.6
CN4101500000000	41	015	Curry County, OR	2012	NA	8951	7897	1054	11.8
CN4101700000000	41	017	Deschutes County, OR	2012	NA	78730	69871	8859	11.3
CN4101900000000	41	019	Douglas County, OR	2012	NA	45703	40242	5461	11.9
CN4102100000000	41	021	Gilliam County, OR	2012	NA	937	842	95	10.1
CN4102300000000	41	023	Grant County, OR	2012	NA	3306	2843	463	14
CN4102500000000	41	025	Harney County, OR	2012	NA	3516	3102	414	11.8
CN4102700000000	41	027	Hood River County, OR	2012	NA	14039	13021	1018	7.3
CN4102900000000	41	029	Jackson County, OR	2012	NA	98382	87465	10917	11.1
CN4103100000000	41	031	Jefferson County, OR	2012	NA	9588	8456	1132	11.8
CN4103300000000	41	033	Josephine County, OR	2012	NA	33355	29299	4056	12.2
CN4103500000000	41	035	Klamath County, OR	2012	NA	29978	26465	3513	11.7
CN4103700000000	41	037	Lake County, OR	2012	NA	3627	3157	470	13
CN4103900000000	41	039	Lane County, OR	2012	NA	172255	156906	15349	8.9
CN4104100000000	41	041	Lincoln County, OR	2012	NA	21344	19226	2118	9.9
CN4104300000000	41	043	Linn County, OR	2012	NA	55287	49347	5940	10.7
CN4104500000000	41	045	Malheur County, OR	2012	NA	12825	11624	1201	9.4
CN4104700000000	41	047	Marion County, OR	2012	NA	150568	135549	15019	10
CN4104900000000	41	049	Morrow County, OR	2012	NA	5642	5185	457	8.1
CN4105100000000	41	051	Multnomah County, OR	2012	NA	419500	387585	31915	7.6
CN4105300000000	41	053	Polk County, OR	2012	NA	35226	32092	3134	8.9
CN4105500000000	41	055	Sherman County, OR	2012	NA	895	799	96	10.7
CN4105700000000	41	057	Tillamook County, OR	2012	NA	11169	10085	1084	9.7
CN4105900000000	41	059	Umatilla County, OR	2012	NA	36674	33354	3320	9.1
CN4106100000000	41	061	Union County, OR	2012	NA	12211	11060	1151	9.4
CN4106300000000	41	063	Wallowa County, OR	2012	NA	3351	2966	385	11.5
CN4106500000000	41	065	Wasco County, OR	2012	NA	13801	12639	1162	8.4
CN4106700000000	41	067	Washington County, OR	2012	NA	291013	270395	20618	7.1
CN4106900000000	41	069	Wheeler County, OR	2012	NA	781	727	54	6.9
CN4107100000000	41	071	Yamhill County, OR	2012	NA	50544	46248	4296	8.5
CN4200100000000	42	001	Adams County, PA	2012	NA	54757	51253	3504	6.4
CN4200300000000	42	003	Allegheny County, PA	2012	NA	653230	607825	45405	7
CN4200500000000	42	005	Armstrong County, PA	2012	NA	33904	31182	2722	8
CN4200700000000	42	007	Beaver County, PA	2012	NA	86891	80348	6543	7.5
CN4200900000000	42	009	Bedford County, PA	2012	NA	25078	22915	2163	8.6
CN4201100000000	42	011	Berks County, PA	2012	NA	211799	195566	16233	7.7
CN4201300000000	42	013	Blair County, PA	2012	NA	61849	57250	4599	7.4
CN4201500000000	42	015	Bradford County, PA	2012	NA	32637	30393	2244	6.9
CN4201700000000	42	017	Bucks County, PA	2012	NA	338749	314432	24317	7.2
CN4201900000000	42	019	Butler County, PA	2012	NA	97983	91690	6293	6.4
CN4202100000000	42	021	Cambria County, PA	2012	NA	65983	60187	5796	8.8
CN4202300000000	42	023	Cameron County, PA	2012	NA	2454	2202	252	10.3
CN4202500000000	42	025	Carbon County, PA	2012	NA	32308	29076	3232	10
CN4202700000000	42	027	Centre County, PA	2012	NA	77567	73313	4254	5.5
CN4202900000000	42	029	Chester County, PA	2012	NA	272982	257629	15353	5.6
CN4203100000000	42	031	Clarion County, PA	2012	NA	19002	17297	1705	9
CN4203300000000	42	033	Clearfield County, PA	2012	NA	38233	34658	3575	9.4
CN4203500000000	42	035	Clinton County, PA	2012	NA	19462	17742	1720	8.8
CN4203700000000	42	037	Columbia County, PA	2012	NA	35513	32551	2962	8.3
CN4203900000000	42	039	Crawford County, PA	2012	NA	41985	38783	3202	7.6
CN4204100000000	42	041	Cumberland County, PA	2012	NA	125782	117992	7790	6.2
CN4204300000000	42	043	Dauphin County, PA	2012	NA	141155	130686	10469	7.4
CN4204500000000	42	045	Delaware County, PA	2012	NA	289584	267294	22290	7.7
CN4204700000000	42	047	Elk County, PA	2012	NA	16887	15712	1175	7
CN4204900000000	42	049	Erie County, PA	2012	NA	137424	126709	10715	7.8
CN4205100000000	42	051	Fayette County, PA	2012	NA	60257	54273	5984	9.9
CN4205300000000	42	053	Forest County, PA	2012	NA	2015	1817	198	9.8
CN4205500000000	42	055	Franklin County, PA	2012	NA	76336	70983	5353	7
CN4205700000000	42	057	Fulton County, PA	2012	NA	7442	6756	686	9.2
CN4205900000000	42	059	Greene County, PA	2012	NA	19075	17684	1391	7.3
CN4206100000000	42	061	Huntingdon County, PA	2012	NA	20774	18711	2063	9.9
CN4206300000000	42	063	Indiana County, PA	2012	NA	44758	41131	3627	8.1
CN4206500000000	42	065	Jefferson County, PA	2012	NA	21756	19946	1810	8.3
CN4206700000000	42	067	Juniata County, PA	2012	NA	12048	11174	874	7.3
CN4206900000000	42	069	Lackawanna County, PA	2012	NA	107642	98123	9519	8.8
CN4207100000000	42	071	Lancaster County, PA	2012	NA	269195	251661	17534	6.5
CN4207300000000	42	073	Lawrence County, PA	2012	NA	43331	39906	3425	7.9
CN4207500000000	42	075	Lebanon County, PA	2012	NA	70908	66177	4731	6.7
CN4207700000000	42	077	Lehigh County, PA	2012	NA	182830	167319	15511	8.5
CN4207900000000	42	079	Luzerne County, PA	2012	NA	160859	145107	15752	9.8
CN4208100000000	42	081	Lycoming County, PA	2012	NA	62753	57816	4937	7.9
CN4208300000000	42	083	McKean County, PA	2012	NA	20271	18571	1700	8.4
CN4208500000000	42	085	Mercer County, PA	2012	NA	53940	49864	4076	7.6
CN4208700000000	42	087	Mifflin County, PA	2012	NA	21130	19302	1828	8.7
CN4208900000000	42	089	Monroe County, PA	2012	NA	82408	74360	8048	9.8
CN4209100000000	42	091	Montgomery County, PA	2012	NA	435606	407910	27696	6.4
CN4209300000000	42	093	Montour County, PA	2012	NA	9444	8894	550	5.8
CN4209500000000	42	095	Northampton County, PA	2012	NA	155392	142799	12593	8.1
CN4209700000000	42	097	Northumberland County, PA	2012	NA	45087	40981	4106	9.1
CN4209900000000	42	099	Perry County, PA	2012	NA	24659	22871	1788	7.3
CN4210100000000	42	101	Philadelphia County/city, PA	2012	NA	699340	623262	76078	10.9
CN4210300000000	42	103	Pike County, PA	2012	NA	26007	23374	2633	10.1
CN4210500000000	42	105	Potter County, PA	2012	NA	7929	7206	723	9.1
CN4210700000000	42	107	Schuylkill County, PA	2012	NA	70985	64079	6906	9.7
CN4210900000000	42	109	Snyder County, PA	2012	NA	19836	18329	1507	7.6
CN4211100000000	42	111	Somerset County, PA	2012	NA	36585	33344	3241	8.9
CN4211300000000	42	113	Sullivan County, PA	2012	NA	3102	2860	242	7.8
CN4211500000000	42	115	Susquehanna County, PA	2012	NA	22508	20797	1711	7.6
CN4211700000000	42	117	Tioga County, PA	2012	NA	21728	20072	1656	7.6
CN4211900000000	42	119	Union County, PA	2012	NA	19130	17901	1229	6.4
CN4212100000000	42	121	Venango County, PA	2012	NA	26300	24284	2016	7.7
CN4212300000000	42	123	Warren County, PA	2012	NA	20589	19180	1409	6.8
CN4212500000000	42	125	Washington County, PA	2012	NA	107442	99720	7722	7.2
CN4212700000000	42	127	Wayne County, PA	2012	NA	23119	21258	1861	8
CN4212900000000	42	129	Westmoreland County, PA	2012	NA	187628	173806	13822	7.4
CN4213100000000	42	131	Wyoming County, PA	2012	NA	14394	13106	1288	8.9
CN4213300000000	42	133	York County, PA	2012	NA	233209	215917	17292	7.4
CN4400100000000	44	001	Bristol County, RI	2012	NA	26196	23844	2352	9
CN4400300000000	44	003	Kent County, RI	2012	NA	92213	83042	9171	9.9
CN4400500000000	44	005	Newport County, RI	2012	NA	44227	40118	4109	9.3
CN4400700000000	44	007	Providence County, RI	2012	NA	325794	290145	35649	10.9
CN4400900000000	44	009	Washington County, RI	2012	NA	70058	63285	6773	9.7
CN4500100000000	45	001	Abbeville County, SC	2012	NA	10684	9549	1135	10.6
CN4500300000000	45	003	Aiken County, SC	2012	NA	72956	66682	6274	8.6
CN4500500000000	45	005	Allendale County, SC	2012	NA	3133	2603	530	16.9
CN4500700000000	45	007	Anderson County, SC	2012	NA	85577	77998	7579	8.9
CN4500900000000	45	009	Bamberg County, SC	2012	NA	5800	4877	923	15.9
CN4501100000000	45	011	Barnwell County, SC	2012	NA	8959	7716	1243	13.9
CN4501300000000	45	013	Beaufort County, SC	2012	NA	65919	60939	4980	7.6
CN4501500000000	45	015	Berkeley County, SC	2012	NA	88403	80977	7426	8.4
CN4501700000000	45	017	Calhoun County, SC	2012	NA	6951	6173	778	11.2
CN4501900000000	45	019	Charleston County, SC	2012	NA	186506	173166	13340	7.2
CN4502100000000	45	021	Cherokee County, SC	2012	NA	23751	20705	3046	12.8
CN4502300000000	45	023	Chester County, SC	2012	NA	14035	11961	2074	14.8
CN4502500000000	45	025	Chesterfield County, SC	2012	NA	21047	18655	2392	11.4
CN4502700000000	45	027	Clarendon County, SC	2012	NA	13282	11578	1704	12.8
CN4502900000000	45	029	Colleton County, SC	2012	NA	16455	14465	1990	12.1
CN4503100000000	45	031	Darlington County, SC	2012	NA	30412	27048	3364	11.1
CN4503300000000	45	033	Dillon County, SC	2012	NA	13203	11338	1865	14.1
CN4503500000000	45	035	Dorchester County, SC	2012	NA	68192	62864	5328	7.8
CN4503700000000	45	037	Edgefield County, SC	2012	NA	10643	9638	1005	9.4
CN4503900000000	45	039	Fairfield County, SC	2012	NA	10392	9039	1353	13
CN4504100000000	45	041	Florence County, SC	2012	NA	64973	58697	6276	9.7
CN4504300000000	45	043	Georgetown County, SC	2012	NA	24672	21718	2954	12
CN4504500000000	45	045	Greenville County, SC	2012	NA	226950	210086	16864	7.4
CN4504700000000	45	047	Greenwood County, SC	2012	NA	32049	28798	3251	10.1
CN4504900000000	45	049	Hampton County, SC	2012	NA	8421	7480	941	11.2
CN4505100000000	45	051	Horry County, SC	2012	NA	132681	118938	13743	10.4
CN4505300000000	45	053	Jasper County, SC	2012	NA	10962	10033	929	8.5
CN4505500000000	45	055	Kershaw County, SC	2012	NA	28126	25448	2678	9.5
CN4505700000000	45	057	Lancaster County, SC	2012	NA	34350	30478	3872	11.3
CN4505900000000	45	059	Laurens County, SC	2012	NA	30028	26938	3090	10.3
CN4506100000000	45	061	Lee County, SC	2012	NA	6728	5782	946	14.1
CN4506300000000	45	063	Lexington County, SC	2012	NA	136586	127020	9566	7
CN4506500000000	45	065	McCormick County, SC	2012	NA	3571	3150	421	11.8
CN4506700000000	45	067	Marion County, SC	2012	NA	13509	11361	2148	15.9
CN4506900000000	45	069	Marlboro County, SC	2012	NA	10799	8900	1899	17.6
CN4507100000000	45	071	Newberry County, SC	2012	NA	18232	16622	1610	8.8
CN4507300000000	45	073	Oconee County, SC	2012	NA	33388	30452	2936	8.8
CN4507500000000	45	075	Orangeburg County, SC	2012	NA	39379	33761	5618	14.3
CN4507700000000	45	077	Pickens County, SC	2012	NA	54754	49844	4910	9
CN4507900000000	45	079	Richland County, SC	2012	NA	189352	173861	15491	8.2
CN4508100000000	45	081	Saluda County, SC	2012	NA	8595	7866	729	8.5
CN4508300000000	45	083	Spartanburg County, SC	2012	NA	134781	122074	12707	9.4
CN4508500000000	45	085	Sumter County, SC	2012	NA	44730	39963	4767	10.7
CN4508700000000	45	087	Union County, SC	2012	NA	11963	10332	1631	13.6
CN4508900000000	45	089	Williamsburg County, SC	2012	NA	12435	10471	1964	15.8
CN4509100000000	45	091	York County, SC	2012	NA	118566	107576	10990	9.3
CN4600300000000	46	003	Aurora County, SD	2012	NA	1683	1633	50	3
CN4600500000000	46	005	Beadle County, SD	2012	NA	9567	9234	333	3.5
CN4600700000000	46	007	Bennett County, SD	2012	NA	1199	1118	81	6.8
CN4600900000000	46	009	Bon Homme County, SD	2012	NA	3036	2917	119	3.9
CN4601100000000	46	011	Brookings County, SD	2012	NA	17682	16990	692	3.9
CN4601300000000	46	013	Brown County, SD	2012	NA	20860	20115	745	3.6
CN4601500000000	46	015	Brule County, SD	2012	NA	2648	2552	96	3.6
CN4601700000000	46	017	Buffalo County, SD	2012	NA	746	674	72	9.7
CN4601900000000	46	019	Butte County, SD	2012	NA	4974	4742	232	4.7
CN4602100000000	46	021	Campbell County, SD	2012	NA	860	829	31	3.6
CN4602300000000	46	023	Charles Mix County, SD	2012	NA	4056	3855	201	5
CN4602500000000	46	025	Clark County, SD	2012	NA	1921	1838	83	4.3
CN4602700000000	46	027	Clay County, SD	2012	NA	7426	7142	284	3.8
CN4602900000000	46	029	Codington County, SD	2012	NA	15486	14884	602	3.9
CN4603100000000	46	031	Corson County, SD	2012	NA	1512	1391	121	8
CN4603300000000	46	033	Custer County, SD	2012	NA	4017	3801	216	5.4
CN4603500000000	46	035	Davison County, SD	2012	NA	11204	10830	374	3.3
CN4603700000000	46	037	Day County, SD	2012	NA	2948	2778	170	5.8
CN4603900000000	46	039	Deuel County, SD	2012	NA	2479	2332	147	5.9
CN4604100000000	46	041	Dewey County, SD	2012	NA	2414	2027	387	16
CN4604300000000	46	043	Douglas County, SD	2012	NA	1693	1636	57	3.4
CN4604500000000	46	045	Edmunds County, SD	2012	NA	2305	2236	69	3
CN4604700000000	46	047	Fall River County, SD	2012	NA	3121	2943	178	5.7
CN4604900000000	46	049	Faulk County, SD	2012	NA	1144	1098	46	4
CN4605100000000	46	051	Grant County, SD	2012	NA	4516	4317	199	4.4
CN4605300000000	46	053	Gregory County, SD	2012	NA	2130	2037	93	4.4
CN4605500000000	46	055	Haakon County, SD	2012	NA	1097	1062	35	3.2
CN4605700000000	46	057	Hamlin County, SD	2012	NA	3125	3002	123	3.9
CN4605900000000	46	059	Hand County, SD	2012	NA	1832	1776	56	3.1
CN4606100000000	46	061	Hanson County, SD	2012	NA	1809	1725	84	4.6
CN4606300000000	46	063	Harding County, SD	2012	NA	807	777	30	3.7
CN4606500000000	46	065	Hughes County, SD	2012	NA	9916	9588	328	3.3
CN4606700000000	46	067	Hutchinson County, SD	2012	NA	3712	3583	129	3.5
CN4606900000000	46	069	Hyde County, SD	2012	NA	765	738	27	3.5
CN4607100000000	46	071	Jackson County, SD	2012	NA	1340	1246	94	7
CN4607300000000	46	073	Jerauld County, SD	2012	NA	1216	1178	38	3.1
CN4607500000000	46	075	Jones County, SD	2012	NA	626	602	24	3.8
CN4607700000000	46	077	Kingsbury County, SD	2012	NA	2971	2865	106	3.6
CN4607900000000	46	079	Lake County, SD	2012	NA	6263	5997	266	4.2
CN4608100000000	46	081	Lawrence County, SD	2012	NA	12643	12075	568	4.5
CN4608300000000	46	083	Lincoln County, SD	2012	NA	27813	26913	900	3.2
CN4608500000000	46	085	Lyman County, SD	2012	NA	1879	1768	111	5.9
CN4608700000000	46	087	McCook County, SD	2012	NA	3169	3049	120	3.8
CN4608900000000	46	089	McPherson County, SD	2012	NA	1144	1091	53	4.6
CN4609100000000	46	091	Marshall County, SD	2012	NA	2499	2379	120	4.8
CN4609300000000	46	093	Meade County, SD	2012	NA	13173	12595	578	4.4
CN4609500000000	46	095	Mellette County, SD	2012	NA	856	789	67	7.8
CN4609700000000	46	097	Miner County, SD	2012	NA	1260	1214	46	3.7
CN4609900000000	46	099	Minnehaha County, SD	2012	NA	100905	96904	4001	4
CN4610100000000	46	101	Moody County, SD	2012	NA	4004	3785	219	5.5
CN4610200000000	46	102	Oglala Lakota County, SD	2012	NA	3756	3221	535	14.2
CN4610300000000	46	103	Pennington County, SD	2012	NA	53290	50948	2342	4.4
CN4610500000000	46	105	Perkins County, SD	2012	NA	1533	1472	61	4
CN4610700000000	46	107	Potter County, SD	2012	NA	1210	1161	49	4
CN4610900000000	46	109	Roberts County, SD	2012	NA	4922	4640	282	5.7
CN4611100000000	46	111	Sanborn County, SD	2012	NA	1295	1250	45	3.5
CN4611500000000	46	115	Spink County, SD	2012	NA	3397	3258	139	4.1
CN4611700000000	46	117	Stanley County, SD	2012	NA	1858	1802	56	3
CN4611900000000	46	119	Sully County, SD	2012	NA	880	853	27	3.1
CN4612100000000	46	121	Todd County, SD	2012	NA	3230	2917	313	9.7
CN4612300000000	46	123	Tripp County, SD	2012	NA	3145	3028	117	3.7
CN4612500000000	46	125	Turner County, SD	2012	NA	4730	4565	165	3.5
CN4612700000000	46	127	Union County, SD	2012	NA	7803	7432	371	4.8
CN4612900000000	46	129	Walworth County, SD	2012	NA	2325	2182	143	6.2
CN4613500000000	46	135	Yankton County, SD	2012	NA	11567	11142	425	3.7
CN4613700000000	46	137	Ziebach County, SD	2012	NA	1055	982	73	6.9
CN4700100000000	47	001	Anderson County, TN	2012	NA	34512	31781	2731	7.9
CN4700300000000	47	003	Bedford County, TN	2012	NA	20297	18313	1984	9.8
CN4700500000000	47	005	Benton County, TN	2012	NA	6963	6280	683	9.8
CN4700700000000	47	007	Bledsoe County, TN	2012	NA	4309	3862	447	10.4
CN4700900000000	47	009	Blount County, TN	2012	NA	60433	56162	4271	7.1
CN4701100000000	47	011	Bradley County, TN	2012	NA	48773	45184	3589	7.4
CN4701300000000	47	013	Campbell County, TN	2012	NA	15736	13996	1740	11.1
CN4701500000000	47	015	Cannon County, TN	2012	NA	6029	5517	512	8.5
CN4701700000000	47	017	Carroll County, TN	2012	NA	13384	11920	1464	10.9
CN4701900000000	47	019	Carter County, TN	2012	NA	25500	23225	2275	8.9
CN4702100000000	47	021	Cheatham County, TN	2012	NA	20176	18721	1455	7.2
CN4702300000000	47	023	Chester County, TN	2012	NA	8376	7720	656	7.8
CN4702500000000	47	025	Claiborne County, TN	2012	NA	13333	12019	1314	9.9
CN4702700000000	47	027	Clay County, TN	2012	NA	3321	2989	332	10
CN4702900000000	47	029	Cocke County, TN	2012	NA	15470	13697	1773	11.5
CN4703100000000	47	031	Coffee County, TN	2012	NA	24650	22623	2027	8.2
CN4703300000000	47	033	Crockett County, TN	2012	NA	7215	6554	661	9.2
CN4703500000000	47	035	Cumberland County, TN	2012	NA	23834	21689	2145	9
CN4703700000000	47	037	Davidson County, TN	2012	NA	353385	331459	21926	6.2
CN4703900000000	47	039	Decatur County, TN	2012	NA	5214	4676	538	10.3
CN4704100000000	47	041	DeKalb County, TN	2012	NA	8043	7272	771	9.6
CN4704300000000	47	043	Dickson County, TN	2012	NA	24197	22185	2012	8.3
CN4704500000000	47	045	Dyer County, TN	2012	NA	17486	15564	1922	11
CN4704700000000	47	047	Fayette County, TN	2012	NA	18417	16858	1559	8.5
CN4704900000000	47	049	Fentress County, TN	2012	NA	7474	6746	728	9.7
CN4705100000000	47	051	Franklin County, TN	2012	NA	19475	17961	1514	7.8
CN4705300000000	47	053	Gibson County, TN	2012	NA	22887	20532	2355	10.3
CN4705500000000	47	055	Giles County, TN	2012	NA	14038	12856	1182	8.4
CN4705700000000	47	057	Grainger County, TN	2012	NA	9686	8690	996	10.3
CN4705900000000	47	059	Greene County, TN	2012	NA	30080	27025	3055	10.2
CN4706100000000	47	061	Grundy County, TN	2012	NA	5532	4976	556	10.1
CN4706300000000	47	063	Hamblen County, TN	2012	NA	27603	25007	2596	9.4
CN4706500000000	47	065	Hamilton County, TN	2012	NA	171034	159238	11796	6.9
CN4706700000000	47	067	Hancock County, TN	2012	NA	2257	1991	266	11.8
CN4706900000000	47	069	Hardeman County, TN	2012	NA	9999	8909	1090	10.9
CN4707100000000	47	071	Hardin County, TN	2012	NA	11148	10027	1121	10.1
CN4707300000000	47	073	Hawkins County, TN	2012	NA	25096	22883	2213	8.8
CN4707500000000	47	075	Haywood County, TN	2012	NA	8229	7279	950	11.5
CN4707700000000	47	077	Henderson County, TN	2012	NA	13206	11930	1276	9.7
CN4707900000000	47	079	Henry County, TN	2012	NA	14296	12950	1346	9.4
CN4708100000000	47	081	Hickman County, TN	2012	NA	10652	9707	945	8.9
CN4708300000000	47	083	Houston County, TN	2012	NA	3519	3126	393	11.2
CN4708500000000	47	085	Humphreys County, TN	2012	NA	8660	7837	823	9.5
CN4708700000000	47	087	Jackson County, TN	2012	NA	4588	4108	480	10.5
CN4708900000000	47	089	Jefferson County, TN	2012	NA	24000	21752	2248	9.4
CN4709100000000	47	091	Johnson County, TN	2012	NA	7353	6658	695	9.5
CN4709300000000	47	093	Knox County, TN	2012	NA	230959	216796	14163	6.1
CN4709500000000	47	095	Lake County, TN	2012	NA	2208	1978	230	10.4
CN4709700000000	47	097	Lauderdale County, TN	2012	NA	10525	9377	1148	10.9
CN4709900000000	47	099	Lawrence County, TN	2012	NA	18710	16927	1783	9.5
CN4710100000000	47	101	Lewis County, TN	2012	NA	5046	4501	545	10.8
CN4710300000000	47	103	Lincoln County, TN	2012	NA	15595	14645	950	6.1
CN4710500000000	47	105	Loudon County, TN	2012	NA	22335	20646	1689	7.6
CN4710700000000	47	107	McMinn County, TN	2012	NA	23623	21462	2161	9.1
CN4710900000000	47	109	McNairy County, TN	2012	NA	9768	8766	1002	10.3
CN4711100000000	47	111	Macon County, TN	2012	NA	10139	9299	840	8.3
CN4711300000000	47	113	Madison County, TN	2012	NA	48531	44585	3946	8.1
CN4711500000000	47	115	Marion County, TN	2012	NA	12282	11163	1119	9.1
CN4711700000000	47	117	Marshall County, TN	2012	NA	14300	12959	1341	9.4
CN4711900000000	47	119	Maury County, TN	2012	NA	40673	37487	3186	7.8
CN4712100000000	47	121	Meigs County, TN	2012	NA	5063	4541	522	10.3
CN4712300000000	47	123	Monroe County, TN	2012	NA	19478	17540	1938	9.9
CN4712500000000	47	125	Montgomery County, TN	2012	NA	78041	72126	5915	7.6
CN4712700000000	47	127	Moore County, TN	2012	NA	3395	3198	197	5.8
CN4712900000000	47	129	Morgan County, TN	2012	NA	8325	7472	853	10.2
CN4713100000000	47	131	Obion County, TN	2012	NA	14349	12422	1927	13.4
CN4713300000000	47	133	Overton County, TN	2012	NA	9738	8870	868	8.9
CN4713500000000	47	135	Perry County, TN	2012	NA	3115	2811	304	9.8
CN4713700000000	47	137	Pickett County, TN	2012	NA	2448	2218	230	9.4
CN4713900000000	47	139	Polk County, TN	2012	NA	7486	6752	734	9.8
CN4714100000000	47	141	Putnam County, TN	2012	NA	32924	30279	2645	8
CN4714300000000	47	143	Rhea County, TN	2012	NA	13503	12120	1383	10.2
CN4714500000000	47	145	Roane County, TN	2012	NA	23894	21834	2060	8.6
CN4714700000000	47	147	Robertson County, TN	2012	NA	33744	31371	2373	7
CN4714900000000	47	149	Rutherford County, TN	2012	NA	145170	135724	9446	6.5
CN4715100000000	47	151	Scott County, TN	2012	NA	8774	7411	1363	15.5
CN4715300000000	47	153	Sequatchie County, TN	2012	NA	5960	5460	500	8.4
CN4715500000000	47	155	Sevier County, TN	2012	NA	49488	45160	4328	8.7
CN4715700000000	47	157	Shelby County, TN	2012	NA	446126	407723	38403	8.6
CN4715900000000	47	159	Smith County, TN	2012	NA	8670	7963	707	8.2
CN4716100000000	47	161	Stewart County, TN	2012	NA	5542	4931	611	11
CN4716300000000	47	163	Sullivan County, TN	2012	NA	72944	67447	5497	7.5
CN4716500000000	47	165	Sumner County, TN	2012	NA	85031	79493	5538	6.5
CN4716700000000	47	167	Tipton County, TN	2012	NA	28320	25811	2509	8.9
CN4716900000000	47	169	Trousdale County, TN	2012	NA	3684	3366	318	8.6
CN4717100000000	47	171	Unicoi County, TN	2012	NA	7710	6916	794	10.3
CN4717300000000	47	173	Union County, TN	2012	NA	7627	6907	720	9.4
CN4717500000000	47	175	Van Buren County, TN	2012	NA	2245	1987	258	11.5
CN4717700000000	47	177	Warren County, TN	2012	NA	17498	15964	1534	8.8
CN4717900000000	47	179	Washington County, TN	2012	NA	60304	56033	4271	7.1
CN4718100000000	47	181	Wayne County, TN	2012	NA	6662	6031	631	9.5
CN4718300000000	47	183	Weakley County, TN	2012	NA	16946	15094	1852	10.9
CN4718500000000	47	185	White County, TN	2012	NA	12213	11020	1193	9.8
CN4718700000000	47	187	Williamson County, TN	2012	NA	99015	94106	4909	5
CN4718900000000	47	189	Wilson County, TN	2012	NA	60691	56806	3885	6.4
CN4800100000000	48	001	Anderson County, TX	2012	NA	22391	20974	1417	6.3
CN4800300000000	48	003	Andrews County, TX	2012	NA	8544	8203	341	4
CN4800500000000	48	005	Angelina County, TX	2012	NA	37870	35257	2613	6.9
CN4800700000000	48	007	Aransas County, TX	2012	NA	9944	9251	693	7
CN4800900000000	48	009	Archer County, TX	2012	NA	4370	4131	239	5.5
CN4801100000000	48	011	Armstrong County, TX	2012	NA	1027	981	46	4.5
CN4801300000000	48	013	Atascosa County, TX	2012	NA	20072	18719	1353	6.7
CN4801500000000	48	015	Austin County, TX	2012	NA	14093	13192	901	6.4
CN4801700000000	48	017	Bailey County, TX	2012	NA	3183	2963	220	6.9
CN4801900000000	48	019	Bandera County, TX	2012	NA	9128	8530	598	6.6
CN4802100000000	48	021	Bastrop County, TX	2012	NA	35304	32944	2360	6.7
CN4802300000000	48	023	Baylor County, TX	2012	NA	1866	1771	95	5.1
CN4802500000000	48	025	Bee County, TX	2012	NA	10853	10090	763	7
CN4802700000000	48	027	Bell County, TX	2012	NA	134133	124194	9939	7.4
CN4802900000000	48	029	Bexar County, TX	2012	NA	840497	787214	53283	6.3
CN4803100000000	48	031	Blanco County, TX	2012	NA	5493	5210	283	5.2
CN4803300000000	48	033	Borden County, TX	2012	NA	419	401	18	4.3
CN4803500000000	48	035	Bosque County, TX	2012	NA	8191	7599	592	7.2
CN4803700000000	48	037	Bowie County, TX	2012	NA	41556	38465	3091	7.4
CN4803900000000	48	039	Brazoria County, TX	2012	NA	161209	150457	10752	6.7
CN4804100000000	48	041	Brazos County, TX	2012	NA	99833	94566	5267	5.3
CN4804300000000	48	043	Brewster County, TX	2012	NA	4563	4331	232	5.1
CN4804500000000	48	045	Briscoe County, TX	2012	NA	643	608	35	5.4
CN4804700000000	48	047	Brooks County, TX	2012	NA	2721	2484	237	8.7
CN4804900000000	48	049	Brown County, TX	2012	NA	16071	14981	1090	6.8
CN4805100000000	48	051	Burleson County, TX	2012	NA	7666	7184	482	6.3
CN4805300000000	48	053	Burnet County, TX	2012	NA	20426	19209	1217	6
CN4805500000000	48	055	Caldwell County, TX	2012	NA	16844	15636	1208	7.2
CN4805700000000	48	057	Calhoun County, TX	2012	NA	10423	9658	765	7.3
CN4805900000000	48	059	Callahan County, TX	2012	NA	5933	5572	361	6.1
CN4806100000000	48	061	Cameron County, TX	2012	NA	166314	149171	17143	10.3
CN4806300000000	48	063	Camp County, TX	2012	NA	5505	5064	441	8
CN4806500000000	48	065	Carson County, TX	2012	NA	3291	3141	150	4.6
CN4806700000000	48	067	Cass County, TX	2012	NA	12827	11650	1177	9.2
CN4806900000000	48	069	Castro County, TX	2012	NA	4060	3882	178	4.4
CN4807100000000	48	071	Chambers County, TX	2012	NA	17150	15771	1379	8
CN4807300000000	48	073	Cherokee County, TX	2012	NA	21979	20388	1591	7.2
CN4807500000000	48	075	Childress County, TX	2012	NA	2969	2838	131	4.4
CN4807700000000	48	077	Clay County, TX	2012	NA	5319	5021	298	5.6
CN4807900000000	48	079	Cochran County, TX	2012	NA	1447	1338	109	7.5
CN4808100000000	48	081	Coke County, TX	2012	NA	1473	1398	75	5.1
CN4808300000000	48	083	Coleman County, TX	2012	NA	3316	3067	249	7.5
CN4808500000000	48	085	Collin County, TX	2012	NA	446733	420419	26314	5.9
CN4808700000000	48	087	Collingsworth County, TX	2012	NA	1248	1186	62	5
CN4808900000000	48	089	Colorado County, TX	2012	NA	10184	9536	648	6.4
CN4809100000000	48	091	Comal County, TX	2012	NA	55918	52535	3383	6
CN4809300000000	48	093	Comanche County, TX	2012	NA	5790	5421	369	6.4
CN4809500000000	48	095	Concho County, TX	2012	NA	1512	1448	64	4.2
CN4809700000000	48	097	Cooke County, TX	2012	NA	20693	19653	1040	5
CN4809900000000	48	099	Coryell County, TX	2012	NA	25396	23528	1868	7.4
CN4810100000000	48	101	Cottle County, TX	2012	NA	666	616	50	7.5
CN4810300000000	48	103	Crane County, TX	2012	NA	2060	1960	100	4.9
CN4810500000000	48	105	Crockett County, TX	2012	NA	1774	1685	89	5
CN4810700000000	48	107	Crosby County, TX	2012	NA	2911	2702	209	7.2
CN4810900000000	48	109	Culberson County, TX	2012	NA	989	929	60	6.1
CN4811100000000	48	111	Dallam County, TX	2012	NA	4021	3873	148	3.7
CN4811300000000	48	113	Dallas County, TX	2012	NA	1223343	1136230	87113	7.1
CN4811500000000	48	115	Dawson County, TX	2012	NA	5080	4754	326	6.4
CN4811700000000	48	117	Deaf Smith County, TX	2012	NA	9325	8887	438	4.7
CN4811900000000	48	119	Delta County, TX	2012	NA	2625	2448	177	6.7
CN4812100000000	48	121	Denton County, TX	2012	NA	388543	366353	22190	5.7
CN4812300000000	48	123	DeWitt County, TX	2012	NA	9741	9275	466	4.8
CN4812500000000	48	125	Dickens County, TX	2012	NA	833	744	89	10.7
CN4812700000000	48	127	Dimmit County, TX	2012	NA	5764	5428	336	5.8
CN4812900000000	48	129	Donley County, TX	2012	NA	1710	1609	101	5.9
CN4813100000000	48	131	Duval County, TX	2012	NA	5431	5050	381	7
CN4813300000000	48	133	Eastland County, TX	2012	NA	8267	7716	551	6.7
CN4813500000000	48	135	Ector County, TX	2012	NA	77060	73523	3537	4.6
CN4813700000000	48	137	Edwards County, TX	2012	NA	926	867	59	6.4
CN4813900000000	48	139	Ellis County, TX	2012	NA	76794	71601	5193	6.8
CN4814100000000	48	141	El Paso County, TX	2012	NA	347513	317841	29672	8.5
CN4814300000000	48	143	Erath County, TX	2012	NA	20056	18941	1115	5.6
CN4814500000000	48	145	Falls County, TX	2012	NA	6917	6410	507	7.3
CN4814700000000	48	147	Fannin County, TX	2012	NA	15068	14004	1064	7.1
CN4814900000000	48	149	Fayette County, TX	2012	NA	12525	11919	606	4.8
CN4815100000000	48	151	Fisher County, TX	2012	NA	1908	1805	103	5.4
CN4815300000000	48	153	Floyd County, TX	2012	NA	3198	2992	206	6.4
CN4815500000000	48	155	Foard County, TX	2012	NA	622	586	36	5.8
CN4815700000000	48	157	Fort Bend County, TX	2012	NA	319114	300119	18995	6
CN4815900000000	48	159	Franklin County, TX	2012	NA	4630	4288	342	7.4
CN4816100000000	48	161	Freestone County, TX	2012	NA	8062	7519	543	6.7
CN4816300000000	48	163	Frio County, TX	2012	NA	8673	8236	437	5
CN4816500000000	48	165	Gaines County, TX	2012	NA	8785	8412	373	4.2
CN4816700000000	48	167	Galveston County, TX	2012	NA	153148	141451	11697	7.6
CN4816900000000	48	169	Garza County, TX	2012	NA	2196	2087	109	5
CN4817100000000	48	171	Gillespie County, TX	2012	NA	12331	11752	579	4.7
CN4817300000000	48	173	Glasscock County, TX	2012	NA	763	732	31	4.1
CN4817500000000	48	175	Goliad County, TX	2012	NA	3480	3289	191	5.5
CN4817700000000	48	177	Gonzales County, TX	2012	NA	9457	8977	480	5.1
CN4817900000000	48	179	Gray County, TX	2012	NA	9699	9155	544	5.6
CN4818100000000	48	181	Grayson County, TX	2012	NA	60023	55913	4110	6.8
CN4818300000000	48	183	Gregg County, TX	2012	NA	61643	57824	3819	6.2
CN4818500000000	48	185	Grimes County, TX	2012	NA	11814	11054	760	6.4
CN4818700000000	48	187	Guadalupe County, TX	2012	NA	68312	64435	3877	5.7
CN4818900000000	48	189	Hale County, TX	2012	NA	15861	14764	1097	6.9
CN4819100000000	48	191	Hall County, TX	2012	NA	1343	1239	104	7.7
CN4819300000000	48	193	Hamilton County, TX	2012	NA	3750	3532	218	5.8
CN4819500000000	48	195	Hansford County, TX	2012	NA	3055	2951	104	3.4
CN4819700000000	48	197	Hardeman County, TX	2012	NA	1763	1659	104	5.9
CN4819900000000	48	199	Hardin County, TX	2012	NA	25880	23700	2180	8.4
CN4820100000000	48	201	Harris County, TX	2012	NA	2156942	2013828	143114	6.6
CN4820300000000	48	203	Harrison County, TX	2012	NA	31972	29608	2364	7.4
CN4820500000000	48	205	Hartley County, TX	2012	NA	2903	2806	97	3.3
CN4820700000000	48	207	Haskell County, TX	2012	NA	2775	2627	148	5.3
CN4820900000000	48	209	Hays County, TX	2012	NA	85818	80810	5008	5.8
CN4821100000000	48	211	Hemphill County, TX	2012	NA	2547	2473	74	2.9
CN4821300000000	48	213	Henderson County, TX	2012	NA	34547	31932	2615	7.6
CN4821500000000	48	215	Hidalgo County, TX	2012	NA	328096	293300	34796	10.6
CN4821700000000	48	217	Hill County, TX	2012	NA	15805	14711	1094	6.9
CN4821900000000	48	219	Hockley County, TX	2012	NA	11790	11167	623	5.3
CN4822100000000	48	221	Hood County, TX	2012	NA	23783	22233	1550	6.5
CN4822300000000	48	223	Hopkins County, TX	2012	NA	17087	15981	1106	6.5
CN4822500000000	48	225	Houston County, TX	2012	NA	10081	9366	715	7.1
CN4822700000000	48	227	Howard County, TX	2012	NA	13403	12651	752	5.6
CN4822900000000	48	229	Hudspeth County, TX	2012	NA	1326	1227	99	7.5
CN4823100000000	48	231	Hunt County, TX	2012	NA	38424	35243	3181	8.3
CN4823300000000	48	233	Hutchinson County, TX	2012	NA	9828	9190	638	6.5
CN4823500000000	48	235	Irion County, TX	2012	NA	852	813	39	4.6
CN4823700000000	48	237	Jack County, TX	2012	NA	3804	3585	219	5.8
CN4823900000000	48	239	Jackson County, TX	2012	NA	7438	7057	381	5.1
CN4824100000000	48	241	Jasper County, TX	2012	NA	14917	13329	1588	10.6
CN4824300000000	48	243	Jeff Davis County, TX	2012	NA	1215	1156	59	4.9
CN4824500000000	48	245	Jefferson County, TX	2012	NA	113611	101055	12556	11.1
CN4824700000000	48	247	Jim Hogg County, TX	2012	NA	2351	2196	155	6.6
CN4824900000000	48	249	Jim Wells County, TX	2012	NA	20652	19378	1274	6.2
CN4825100000000	48	251	Johnson County, TX	2012	NA	73166	68305	4861	6.6
CN4825300000000	48	253	Jones County, TX	2012	NA	5905	5480	425	7.2
CN4825500000000	48	255	Karnes County, TX	2012	NA	5288	4966	322	6.1
CN4825700000000	48	257	Kaufman County, TX	2012	NA	51625	48037	3588	7
CN4825900000000	48	259	Kendall County, TX	2012	NA	17476	16531	945	5.4
CN4826100000000	48	261	Kenedy County, TX	2012	NA	254	241	13	5.1
CN4826300000000	48	263	Kent County, TX	2012	NA	553	531	22	4
CN4826500000000	48	265	Kerr County, TX	2012	NA	21698	20432	1266	5.8
CN4826700000000	48	267	Kimble County, TX	2012	NA	2189	2082	107	4.9
CN4826900000000	48	269	King County, TX	2012	NA	247	236	11	4.5
CN4827100000000	48	271	Kinney County, TX	2012	NA	1263	1152	111	8.8
CN4827300000000	48	273	Kleberg County, TX	2012	NA	15418	14358	1060	6.9
CN4827500000000	48	275	Knox County, TX	2012	NA	1817	1722	95	5.2
CN4827700000000	48	277	Lamar County, TX	2012	NA	22646	20561	2085	9.2
CN4827900000000	48	279	Lamb County, TX	2012	NA	6466	5951	515	8
CN4828100000000	48	281	Lampasas County, TX	2012	NA	9092	8445	647	7.1
CN4828300000000	48	283	La Salle County, TX	2012	NA	3670	3507	163	4.4
CN4828500000000	48	285	Lavaca County, TX	2012	NA	9482	9024	458	4.8
CN4828700000000	48	287	Lee County, TX	2012	NA	9138	8645	493	5.4
CN4828900000000	48	289	Leon County, TX	2012	NA	6955	6442	513	7.4
CN4829100000000	48	291	Liberty County, TX	2012	NA	30881	27924	2957	9.6
CN4829300000000	48	293	Limestone County, TX	2012	NA	9606	8945	661	6.9
CN4829500000000	48	295	Lipscomb County, TX	2012	NA	1758	1690	68	3.9
CN4829700000000	48	297	Live Oak County, TX	2012	NA	5768	5505	263	4.6
CN4829900000000	48	299	Llano County, TX	2012	NA	8067	7519	548	6.8
CN4830100000000	48	301	Loving County, TX	2012	NA	67	63	4	6
CN4830300000000	48	303	Lubbock County, TX	2012	NA	145628	137841	7787	5.3
CN4830500000000	48	305	Lynn County, TX	2012	NA	2953	2775	178	6
CN4830700000000	48	307	McCulloch County, TX	2012	NA	4402	4165	237	5.4
CN4830900000000	48	309	McLennan County, TX	2012	NA	112372	104910	7462	6.6
CN4831100000000	48	311	McMullen County, TX	2012	NA	745	727	18	2.4
CN4831300000000	48	313	Madison County, TX	2012	NA	4654	4325	329	7.1
CN4831500000000	48	315	Marion County, TX	2012	NA	4351	3954	397	9.1
CN4831700000000	48	317	Martin County, TX	2012	NA	2416	2307	109	4.5
CN4831900000000	48	319	Mason County, TX	2012	NA	1970	1867	103	5.2
CN4832100000000	48	321	Matagorda County, TX	2012	NA	17106	15374	1732	10.1
CN4832300000000	48	323	Maverick County, TX	2012	NA	23373	20445	2928	12.5
CN4832500000000	48	325	Medina County, TX	2012	NA	20208	18884	1324	6.6
CN4832700000000	48	327	Menard County, TX	2012	NA	972	911	61	6.3
CN4832900000000	48	329	Midland County, TX	2012	NA	82219	79026	3193	3.9
CN4833100000000	48	331	Milam County, TX	2012	NA	10280	9398	882	8.6
CN4833300000000	48	333	Mills County, TX	2012	NA	2101	1987	114	5.4
CN4833500000000	48	335	Mitchell County, TX	2012	NA	2878	2706	172	6
CN4833700000000	48	337	Montague County, TX	2012	NA	9852	9319	533	5.4
CN4833900000000	48	339	Montgomery County, TX	2012	NA	239219	225006	14213	5.9
CN4834100000000	48	341	Moore County, TX	2012	NA	11589	11088	501	4.3
CN4834300000000	48	343	Morris County, TX	2012	NA	5837	5268	569	9.7
CN4834500000000	48	345	Motley County, TX	2012	NA	522	491	31	5.9
CN4834700000000	48	347	Nacogdoches County, TX	2012	NA	29573	27609	1964	6.6
CN4834900000000	48	349	Navarro County, TX	2012	NA	23250	21561	1689	7.3
CN4835100000000	48	351	Newton County, TX	2012	NA	5805	5163	642	11.1
CN4835300000000	48	353	Nolan County, TX	2012	NA	7092	6672	420	5.9
CN4835500000000	48	355	Nueces County, TX	2012	NA	167030	156062	10968	6.6
CN4835700000000	48	357	Ochiltree County, TX	2012	NA	5320	5115	205	3.9
CN4835900000000	48	359	Oldham County, TX	2012	NA	951	910	41	4.3
CN4836100000000	48	361	Orange County, TX	2012	NA	38882	34818	4064	10.5
CN4836300000000	48	363	Palo Pinto County, TX	2012	NA	13418	12514	904	6.7
CN4836500000000	48	365	Panola County, TX	2012	NA	12322	11477	845	6.9
CN4836700000000	48	367	Parker County, TX	2012	NA	57922	54485	3437	5.9
CN4836900000000	48	369	Parmer County, TX	2012	NA	5006	4800	206	4.1
CN4837100000000	48	371	Pecos County, TX	2012	NA	6993	6635	358	5.1
CN4837300000000	48	373	Polk County, TX	2012	NA	17542	16136	1406	8
CN4837500000000	48	375	Potter County, TX	2012	NA	58335	55218	3117	5.3
CN4837700000000	48	377	Presidio County, TX	2012	NA	3827	3319	508	13.3
CN4837900000000	48	379	Rains County, TX	2012	NA	5232	4866	366	7
CN4838100000000	48	381	Randall County, TX	2012	NA	68125	65112	3013	4.4
CN4838300000000	48	383	Reagan County, TX	2012	NA	2078	2007	71	3.4
CN4838500000000	48	385	Real County, TX	2012	NA	1067	967	100	9.4
CN4838700000000	48	387	Red River County, TX	2012	NA	5263	4700	563	10.7
CN4838900000000	48	389	Reeves County, TX	2012	NA	5345	4984	361	6.8
CN4839100000000	48	391	Refugio County, TX	2012	NA	3509	3298	211	6
CN4839300000000	48	393	Roberts County, TX	2012	NA	472	448	24	5.1
CN4839500000000	48	395	Robertson County, TX	2012	NA	7290	6704	586	8
CN4839700000000	48	397	Rockwall County, TX	2012	NA	41195	38649	2546	6.2
CN4839900000000	48	399	Runnels County, TX	2012	NA	5061	4781	280	5.5
CN4840100000000	48	401	Rusk County, TX	2012	NA	24590	23046	1544	6.3
CN4840300000000	48	403	Sabine County, TX	2012	NA	3388	2895	493	14.6
CN4840500000000	48	405	San Augustine County, TX	2012	NA	3027	2660	367	12.1
CN4840700000000	48	407	San Jacinto County, TX	2012	NA	11474	10529	945	8.2
CN4840900000000	48	409	San Patricio County, TX	2012	NA	30435	28129	2306	7.6
CN4841100000000	48	411	San Saba County, TX	2012	NA	2295	2152	143	6.2
CN4841300000000	48	413	Schleicher County, TX	2012	NA	1781	1710	71	4
CN4841500000000	48	415	Scurry County, TX	2012	NA	8118	7755	363	4.5
CN4841700000000	48	417	Shackelford County, TX	2012	NA	2214	2136	78	3.5
CN4841900000000	48	419	Shelby County, TX	2012	NA	12126	11246	880	7.3
CN4842100000000	48	421	Sherman County, TX	2012	NA	1504	1441	63	4.2
CN4842300000000	48	423	Smith County, TX	2012	NA	101770	94614	7156	7
CN4842500000000	48	425	Somervell County, TX	2012	NA	4143	3869	274	6.6
CN4842700000000	48	427	Starr County, TX	2012	NA	26036	22252	3784	14.5
CN4842900000000	48	429	Stephens County, TX	2012	NA	4384	4124	260	5.9
CN4843100000000	48	431	Sterling County, TX	2012	NA	720	695	25	3.5
CN4843300000000	48	433	Stonewall County, TX	2012	NA	748	715	33	4.4
CN4843500000000	48	435	Sutton County, TX	2012	NA	2012	1917	95	4.7
CN4843700000000	48	437	Swisher County, TX	2012	NA	3050	2869	181	5.9
CN4843900000000	48	439	Tarrant County, TX	2012	NA	966259	903315	62944	6.5
CN4844100000000	48	441	Taylor County, TX	2012	NA	64485	60834	3651	5.7
CN4844300000000	48	443	Terrell County, TX	2012	NA	549	523	26	4.7
CN4844500000000	48	445	Terry County, TX	2012	NA	5666	5295	371	6.5
CN4844700000000	48	447	Throckmorton County, TX	2012	NA	830	786	44	5.3
CN4844900000000	48	449	Titus County, TX	2012	NA	13267	12272	995	7.5
CN4845100000000	48	451	Tom Green County, TX	2012	NA	53790	50921	2869	5.3
CN4845300000000	48	453	Travis County, TX	2012	NA	612264	578608	33656	5.5
CN4845500000000	48	455	Trinity County, TX	2012	NA	5574	5118	456	8.2
CN4845700000000	48	457	Tyler County, TX	2012	NA	7580	6770	810	10.7
CN4845900000000	48	459	Upshur County, TX	2012	NA	18727	17465	1262	6.7
CN4846100000000	48	461	Upton County, TX	2012	NA	1591	1527	64	4
CN4846300000000	48	463	Uvalde County, TX	2012	NA	11952	11004	948	7.9
CN4846500000000	48	465	Val Verde County, TX	2012	NA	20013	18489	1524	7.6
CN4846700000000	48	467	Van Zandt County, TX	2012	NA	23620	21982	1638	6.9
CN4846900000000	48	469	Victoria County, TX	2012	NA	45250	42723	2527	5.6
CN4847100000000	48	471	Walker County, TX	2012	NA	23153	21545	1608	6.9
CN4847300000000	48	473	Waller County, TX	2012	NA	20499	19065	1434	7
CN4847500000000	48	475	Ward County, TX	2012	NA	5356	5098	258	4.8
CN4847700000000	48	477	Washington County, TX	2012	NA	15646	14766	880	5.6
CN4847900000000	48	479	Webb County, TX	2012	NA	109145	102072	7073	6.5
CN4848100000000	48	481	Wharton County, TX	2012	NA	21437	19987	1450	6.8
CN4848300000000	48	483	Wheeler County, TX	2012	NA	2895	2769	126	4.4
CN4848500000000	48	485	Wichita County, TX	2012	NA	58468	54914	3554	6.1
CN4848700000000	48	487	Wilbarger County, TX	2012	NA	5924	5568	356	6
CN4848900000000	48	489	Willacy County, TX	2012	NA	7428	6254	1174	15.8
CN4849100000000	48	491	Williamson County, TX	2012	NA	237421	223585	13836	5.8
CN4849300000000	48	493	Wilson County, TX	2012	NA	21732	20528	1204	5.5
CN4849500000000	48	495	Winkler County, TX	2012	NA	3186	3006	180	5.6
CN4849700000000	48	497	Wise County, TX	2012	NA	28255	26432	1823	6.5
CN4849900000000	48	499	Wood County, TX	2012	NA	16735	15420	1315	7.9
CN4850100000000	48	501	Yoakum County, TX	2012	NA	4336	4162	174	4
CN4850300000000	48	503	Young County, TX	2012	NA	8570	8081	489	5.7
CN4850500000000	48	505	Zapata County, TX	2012	NA	6819	6387	432	6.3
CN4850700000000	48	507	Zavala County, TX	2012	NA	4390	3797	593	13.5
CN4900100000000	49	001	Beaver County, UT	2012	NA	2902	2725	177	6.1
CN4900300000000	49	003	Box Elder County, UT	2012	NA	22948	21626	1322	5.8
CN4900500000000	49	005	Cache County, UT	2012	NA	56972	54422	2550	4.5
CN4900700000000	49	007	Carbon County, UT	2012	NA	9263	8610	653	7
CN4900900000000	49	009	Daggett County, UT	2012	NA	436	414	22	5
CN4901100000000	49	011	Davis County, UT	2012	NA	148630	141372	7258	4.9
CN4901300000000	49	013	Duchesne County, UT	2012	NA	9150	8720	430	4.7
CN4901500000000	49	015	Emery County, UT	2012	NA	4746	4405	341	7.2
CN4901700000000	49	017	Garfield County, UT	2012	NA	2857	2586	271	9.5
CN4901900000000	49	019	Grand County, UT	2012	NA	5409	4954	455	8.4
CN4902100000000	49	021	Iron County, UT	2012	NA	19470	18140	1330	6.8
CN4902300000000	49	023	Juab County, UT	2012	NA	4625	4343	282	6.1
CN4902500000000	49	025	Kane County, UT	2012	NA	3462	3232	230	6.6
CN4902700000000	49	027	Millard County, UT	2012	NA	5938	5661	277	4.7
CN4902900000000	49	029	Morgan County, UT	2012	NA	4333	4120	213	4.9
CN4903100000000	49	031	Piute County, UT	2012	NA	492	451	41	8.3
CN4903300000000	49	033	Rich County, UT	2012	NA	946	896	50	5.3
CN4903500000000	49	035	Salt Lake County, UT	2012	NA	556484	527250	29234	5.3
CN4903700000000	49	037	San Juan County, UT	2012	NA	5695	5193	502	8.8
CN4903900000000	49	039	Sanpete County, UT	2012	NA	11253	10532	721	6.4
CN4904100000000	49	041	Sevier County, UT	2012	NA	9421	8844	577	6.1
CN4904300000000	49	043	Summit County, UT	2012	NA	21523	20463	1060	4.9
CN4904500000000	49	045	Tooele County, UT	2012	NA	27746	26087	1659	6
CN4904700000000	49	047	Uintah County, UT	2012	NA	15981	15271	710	4.4
CN4904900000000	49	049	Utah County, UT	2012	NA	238745	226892	11853	5
CN4905100000000	49	051	Wasatch County, UT	2012	NA	11651	10981	670	5.8
CN4905300000000	49	053	Washington County, UT	2012	NA	57216	53281	3935	6.9
CN4905500000000	49	055	Wayne County, UT	2012	NA	1355	1209	146	10.8
CN4905700000000	49	057	Weber County, UT	2012	NA	113321	106127	7194	6.3
CN5000100000000	50	001	Addison County, VT	2012	NA	20868	19926	942	4.5
CN5000300000000	50	003	Bennington County, VT	2012	NA	19662	18505	1157	5.9
CN5000500000000	50	005	Caledonia County, VT	2012	NA	16137	15130	1007	6.2
CN5000700000000	50	007	Chittenden County, VT	2012	NA	95835	92217	3618	3.8
CN5000900000000	50	009	Essex County, VT	2012	NA	2933	2697	236	8
CN5001100000000	50	011	Franklin County, VT	2012	NA	27854	26607	1247	4.5
CN5001300000000	50	013	Grand Isle County, VT	2012	NA	4132	3909	223	5.4
CN5001500000000	50	015	Lamoille County, VT	2012	NA	14041	13148	893	6.4
CN5001700000000	50	017	Orange County, VT	2012	NA	16450	15676	774	4.7
CN5001900000000	50	019	Orleans County, VT	2012	NA	14120	13028	1092	7.7
CN5002100000000	50	021	Rutland County, VT	2012	NA	32799	30755	2044	6.2
CN5002300000000	50	023	Washington County, VT	2012	NA	34630	32998	1632	4.7
CN5002500000000	50	025	Windham County, VT	2012	NA	24668	23393	1275	5.2
CN5002700000000	50	027	Windsor County, VT	2012	NA	30725	29295	1430	4.7
CN5100100000000	51	001	Accomack County, VA	2012	NA	16419	15126	1293	7.9
CN5100300000000	51	003	Albemarle County, VA	2012	NA	52640	49887	2753	5.2
CN5100500000000	51	005	Alleghany County, VA	2012	NA	7802	7249	553	7.1
CN5100700000000	51	007	Amelia County, VA	2012	NA	6219	5813	406	6.5
CN5100900000000	51	009	Amherst County, VA	2012	NA	16069	14993	1076	6.7
CN5101100000000	51	011	Appomattox County, VA	2012	NA	7222	6685	537	7.4
CN5101300000000	51	013	Arlington County, VA	2012	NA	144012	139012	5000	3.5
CN5101500000000	51	015	Augusta County, VA	2012	NA	37041	34897	2144	5.8
CN5101700000000	51	017	Bath County, VA	2012	NA	2587	2436	151	5.8
CN5101900000000	51	019	Bedford County, VA	2012	NA	38326	36038	2288	6
CN5102100000000	51	021	Bland County, VA	2012	NA	2876	2674	202	7
CN5102300000000	51	023	Botetourt County, VA	2012	NA	17727	16756	971	5.5
CN5102500000000	51	025	Brunswick County, VA	2012	NA	6732	6052	680	10.1
CN5102700000000	51	027	Buchanan County, VA	2012	NA	8589	7807	782	9.1
CN5102900000000	51	029	Buckingham County, VA	2012	NA	6474	5922	552	8.5
CN5103100000000	51	031	Campbell County, VA	2012	NA	27088	25336	1752	6.5
CN5103300000000	51	033	Caroline County, VA	2012	NA	14504	13373	1131	7.8
CN5103500000000	51	035	Carroll County, VA	2012	NA	13494	12343	1151	8.5
CN5103600000000	51	036	Charles City County, VA	2012	NA	3854	3552	302	7.8
CN5103700000000	51	037	Charlotte County, VA	2012	NA	5365	4898	467	8.7
CN5104100000000	51	041	Chesterfield County, VA	2012	NA	172990	162433	10557	6.1
CN5104300000000	51	043	Clarke County, VA	2012	NA	7737	7332	405	5.2
CN5104500000000	51	045	Craig County, VA	2012	NA	2465	2292	173	7
CN5104700000000	51	047	Culpeper County, VA	2012	NA	23362	22034	1328	5.7
CN5104900000000	51	049	Cumberland County, VA	2012	NA	4528	4205	323	7.1
CN5105100000000	51	051	Dickenson County, VA	2012	NA	5217	4661	556	10.7
CN5105300000000	51	053	Dinwiddie County, VA	2012	NA	13637	12603	1034	7.6
CN5105700000000	51	057	Essex County, VA	2012	NA	5742	5321	421	7.3
CN5105900000000	51	059	Fairfax County, VA	2012	NA	623843	595687	28156	4.5
CN5106100000000	51	061	Fauquier County, VA	2012	NA	36022	34169	1853	5.1
CN5106300000000	51	063	Floyd County, VA	2012	NA	8378	7903	475	5.7
CN5106500000000	51	065	Fluvanna County, VA	2012	NA	13178	12486	692	5.3
CN5106700000000	51	067	Franklin County, VA	2012	NA	27427	25623	1804	6.6
CN5106900000000	51	069	Frederick County, VA	2012	NA	43479	40967	2512	5.8
CN5107100000000	51	071	Giles County, VA	2012	NA	8242	7643	599	7.3
CN5107300000000	51	073	Gloucester County, VA	2012	NA	19375	18282	1093	5.6
CN5107500000000	51	075	Goochland County, VA	2012	NA	10281	9707	574	5.6
CN5107700000000	51	077	Grayson County, VA	2012	NA	7000	6330	670	9.6
CN5107900000000	51	079	Greene County, VA	2012	NA	9800	9256	544	5.6
CN5108100000000	51	081	Greensville County, VA	2012	NA	4468	4083	385	8.6
CN5108300000000	51	083	Halifax County, VA	2012	NA	16051	14528	1523	9.5
CN5108500000000	51	085	Hanover County, VA	2012	NA	55152	52111	3041	5.5
CN5108700000000	51	087	Henrico County, VA	2012	NA	172595	162158	10437	6
CN5108900000000	51	089	Henry County, VA	2012	NA	22753	20351	2402	10.6
CN5109100000000	51	091	Highland County, VA	2012	NA	1461	1390	71	4.9
CN5109300000000	51	093	Isle of Wight County, VA	2012	NA	18766	17578	1188	6.3
CN5109500000000	51	095	James City County, VA	2012	NA	32988	31101	1887	5.7
CN5109700000000	51	097	King and Queen County, VA	2012	NA	3673	3430	243	6.6
CN5109900000000	51	099	King George County, VA	2012	NA	11735	10974	761	6.5
CN5110100000000	51	101	King William County, VA	2012	NA	8686	8137	549	6.3
CN5110300000000	51	103	Lancaster County, VA	2012	NA	5522	5082	440	8
CN5110500000000	51	105	Lee County, VA	2012	NA	9794	8985	809	8.3
CN5110700000000	51	107	Loudoun County, VA	2012	NA	186073	177798	8275	4.4
CN5110900000000	51	109	Louisa County, VA	2012	NA	17965	16845	1120	6.2
CN5111100000000	51	111	Lunenburg County, VA	2012	NA	5385	4978	407	7.6
CN5111300000000	51	113	Madison County, VA	2012	NA	7261	6912	349	4.8
CN5111500000000	51	115	Mathews County, VA	2012	NA	4176	3938	238	5.7
CN5111700000000	51	117	Mecklenburg County, VA	2012	NA	13540	12263	1277	9.4
CN5111900000000	51	119	Middlesex County, VA	2012	NA	5136	4824	312	6.1
CN5112100000000	51	121	Montgomery County, VA	2012	NA	49165	46242	2923	5.9
CN5112500000000	51	125	Nelson County, VA	2012	NA	7465	7030	435	5.8
CN5112700000000	51	127	New Kent County, VA	2012	NA	10615	10023	592	5.6
CN5113100000000	51	131	Northampton County, VA	2012	NA	6198	5624	574	9.3
CN5113300000000	51	133	Northumberland County, VA	2012	NA	5893	5412	481	8.2
CN5113500000000	51	135	Nottoway County, VA	2012	NA	6879	6441	438	6.4
CN5113700000000	51	137	Orange County, VA	2012	NA	15878	14817	1061	6.7
CN5113900000000	51	139	Page County, VA	2012	NA	12202	10957	1245	10.2
CN5114100000000	51	141	Patrick County, VA	2012	NA	7985	7256	729	9.1
CN5114300000000	51	143	Pittsylvania County, VA	2012	NA	30740	28350	2390	7.8
CN5114500000000	51	145	Powhatan County, VA	2012	NA	13559	12794	765	5.6
CN5114700000000	51	147	Prince Edward County, VA	2012	NA	10285	9411	874	8.5
CN5114900000000	51	149	Prince George County, VA	2012	NA	14664	13577	1087	7.4
CN5115300000000	51	153	Prince William County, VA	2012	NA	228830	216748	12082	5.3
CN5115500000000	51	155	Pulaski County, VA	2012	NA	16887	15631	1256	7.4
CN5115700000000	51	157	Rappahannock County, VA	2012	NA	3963	3748	215	5.4
CN5115900000000	51	159	Richmond County, VA	2012	NA	3926	3675	251	6.4
CN5116100000000	51	161	Roanoke County, VA	2012	NA	49569	46975	2594	5.2
CN5116300000000	51	163	Rockbridge County, VA	2012	NA	10768	10112	656	6.1
CN5116500000000	51	165	Rockingham County, VA	2012	NA	40874	38557	2317	5.7
CN5116700000000	51	167	Russell County, VA	2012	NA	11782	10762	1020	8.7
CN5116900000000	51	169	Scott County, VA	2012	NA	10087	9326	761	7.5
CN5117100000000	51	171	Shenandoah County, VA	2012	NA	20834	19508	1326	6.4
CN5117300000000	51	173	Smyth County, VA	2012	NA	13516	12221	1295	9.6
CN5117500000000	51	175	Southampton County, VA	2012	NA	9494	8898	596	6.3
CN5117700000000	51	177	Spotsylvania County, VA	2012	NA	64141	60232	3909	6.1
CN5117900000000	51	179	Stafford County, VA	2012	NA	65515	61724	3791	5.8
CN5118100000000	51	181	Surry County, VA	2012	NA	3690	3402	288	7.8
CN5118300000000	51	183	Sussex County, VA	2012	NA	4277	3861	416	9.7
CN5118500000000	51	185	Tazewell County, VA	2012	NA	17974	16489	1485	8.3
CN5118700000000	51	187	Warren County, VA	2012	NA	20060	18716	1344	6.7
CN5119100000000	51	191	Washington County, VA	2012	NA	27772	25902	1870	6.7
CN5119300000000	51	193	Westmoreland County, VA	2012	NA	9152	8487	665	7.3
CN5119500000000	51	195	Wise County, VA	2012	NA	16013	14583	1430	8.9
CN5119700000000	51	197	Wythe County, VA	2012	NA	14125	13031	1094	7.7
CN5119900000000	51	199	York County, VA	2012	NA	31718	29883	1835	5.8
CN5151000000000	51	510	Alexandria city, VA	2012	NA	93257	89443	3814	4.1
CN5152000000000	51	520	Bristol city, VA	2012	NA	8003	7419	584	7.3
CN5153000000000	51	530	Buena Vista city, VA	2012	NA	3263	3005	258	7.9
CN5154000000000	51	540	Charlottesville city, VA	2012	NA	23430	22230	1200	5.1
CN5155000000000	51	550	Chesapeake city, VA	2012	NA	115188	107798	7390	6.4
CN5157000000000	51	570	Colonial Heights city, VA	2012	NA	8617	8018	599	7
CN5158000000000	51	580	Covington city, VA	2012	NA	2644	2407	237	9
CN5159000000000	51	590	Danville city, VA	2012	NA	19971	17906	2065	10.3
CN5159500000000	51	595	Emporia city, VA	2012	NA	2471	2210	261	10.6
CN5160000000000	51	600	Fairfax city, VA	2012	NA	12933	12376	557	4.3
CN5161000000000	51	610	Falls Church city, VA	2012	NA	7728	7419	309	4
CN5162000000000	51	620	Franklin city, VA	2012	NA	3729	3357	372	10
CN5163000000000	51	630	Fredericksburg city, VA	2012	NA	13600	12641	959	7.1
CN5164000000000	51	640	Galax city, VA	2012	NA	3058	2787	271	8.9
CN5165000000000	51	650	Hampton city, VA	2012	NA	65983	60542	5441	8.2
CN5166000000000	51	660	Harrisonburg city, VA	2012	NA	24127	22350	1777	7.4
CN5167000000000	51	670	Hopewell city, VA	2012	NA	9742	8762	980	10.1
CN5167800000000	51	678	Lexington city, VA	2012	NA	2284	2084	200	8.8
CN5168000000000	51	680	Lynchburg city, VA	2012	NA	35600	32940	2660	7.5
CN5168300000000	51	683	Manassas city, VA	2012	NA	21926	20699	1227	5.6
CN5168500000000	51	685	Manassas Park city, VA	2012	NA	8754	8291	463	5.3
CN5169000000000	51	690	Martinsville city, VA	2012	NA	5746	5010	736	12.8
CN5170000000000	51	700	Newport News city, VA	2012	NA	90033	83286	6747	7.5
CN5171000000000	51	710	Norfolk city, VA	2012	NA	112848	104251	8597	7.6
CN5172000000000	51	720	Norton city, VA	2012	NA	1994	1841	153	7.7
CN5173000000000	51	730	Petersburg city, VA	2012	NA	13623	11995	1628	12
CN5173500000000	51	735	Poquoson city, VA	2012	NA	6361	6017	344	5.4
CN5174000000000	51	740	Portsmouth city, VA	2012	NA	45724	41698	4026	8.8
CN5175000000000	51	750	Radford city, VA	2012	NA	8109	7465	644	7.9
CN5176000000000	51	760	Richmond city, VA	2012	NA	109323	101135	8188	7.5
CN5177000000000	51	770	Roanoke city, VA	2012	NA	49653	46074	3579	7.2
CN5177500000000	51	775	Salem city, VA	2012	NA	12915	12148	767	5.9
CN5179000000000	51	790	Staunton city, VA	2012	NA	11825	11066	759	6.4
CN5180000000000	51	800	Suffolk city, VA	2012	NA	41803	38869	2934	7
CN5181000000000	51	810	Virginia Beach city, VA	2012	NA	229035	215892	13143	5.7
CN5182000000000	51	820	Waynesboro city, VA	2012	NA	10041	9335	706	7
CN5183000000000	51	830	Williamsburg city, VA	2012	NA	6845	6274	571	8.3
CN5184000000000	51	840	Winchester city, VA	2012	NA	14246	13294	952	6.7
CN5300100000000	53	001	Adams County, WA	2012	NA	8230	7482	748	9.1
CN5300300000000	53	003	Asotin County, WA	2012	NA	9763	9003	760	7.8
CN5300500000000	53	005	Benton County, WA	2012	NA	92041	83467	8574	9.3
CN5300700000000	53	007	Chelan County, WA	2012	NA	41395	38084	3311	8
CN5300900000000	53	009	Clallam County, WA	2012	NA	28153	25210	2943	10.5
CN5301100000000	53	011	Clark County, WA	2012	NA	209404	189704	19700	9.4
CN5301300000000	53	013	Columbia County, WA	2012	NA	1821	1670	151	8.3
CN5301500000000	53	015	Cowlitz County, WA	2012	NA	44553	39791	4762	10.7
CN5301700000000	53	017	Douglas County, WA	2012	NA	19262	17512	1750	9.1
CN5301900000000	53	019	Ferry County, WA	2012	NA	2444	2061	383	15.7
CN5302100000000	53	021	Franklin County, WA	2012	NA	39167	35366	3801	9.7
CN5302300000000	53	023	Garfield County, WA	2012	NA	1020	942	78	7.6
CN5302500000000	53	025	Grant County, WA	2012	NA	43914	39740	4174	9.5
CN5302700000000	53	027	Grays Harbor County, WA	2012	NA	28876	25129	3747	13
CN5302900000000	53	029	Island County, WA	2012	NA	32528	29879	2649	8.1
CN5303100000000	53	031	Jefferson County, WA	2012	NA	11930	10740	1190	10
CN5303300000000	53	033	King County, WA	2012	NA	1122834	1051837	70997	6.3
CN5303500000000	53	035	Kitsap County, WA	2012	NA	116110	106945	9165	7.9
CN5303700000000	53	037	Kittitas County, WA	2012	NA	20583	18773	1810	8.8
CN5303900000000	53	039	Klickitat County, WA	2012	NA	9939	8921	1018	10.2
CN5304100000000	53	041	Lewis County, WA	2012	NA	32233	28372	3861	12
CN5304300000000	53	043	Lincoln County, WA	2012	NA	5245	4863	382	7.3
CN5304500000000	53	045	Mason County, WA	2012	NA	23551	20983	2568	10.9
CN5304700000000	53	047	Okanogan County, WA	2012	NA	21146	19140	2006	9.5
CN5304900000000	53	049	Pacific County, WA	2012	NA	8193	7206	987	12
CN5305100000000	53	051	Pend Oreille County, WA	2012	NA	4813	4199	614	12.8
CN5305300000000	53	053	Pierce County, WA	2012	NA	386969	350908	36061	9.3
CN5305500000000	53	055	San Juan County, WA	2012	NA	8105	7584	521	6.4
CN5305700000000	53	057	Skagit County, WA	2012	NA	57112	51599	5513	9.7
CN5305900000000	53	059	Skamania County, WA	2012	NA	5033	4502	531	10.6
CN5306100000000	53	061	Snohomish County, WA	2012	NA	385500	356761	28739	7.5
CN5306300000000	53	063	Spokane County, WA	2012	NA	230421	209506	20915	9.1
CN5306500000000	53	065	Stevens County, WA	2012	NA	18222	16079	2143	11.8
CN5306700000000	53	067	Thurston County, WA	2012	NA	123207	112813	10394	8.4
CN5306900000000	53	069	Wahkiakum County, WA	2012	NA	1376	1201	175	12.7
CN5307100000000	53	071	Walla Walla County, WA	2012	NA	29564	27361	2203	7.5
CN5307300000000	53	073	Whatcom County, WA	2012	NA	103136	94735	8401	8.1
CN5307500000000	53	075	Whitman County, WA	2012	NA	22415	20940	1475	6.6
CN5307700000000	53	077	Yakima County, WA	2012	NA	121082	108267	12815	10.6
CN5400100000000	54	001	Barbour County, WV	2012	NA	6728	6168	560	8.3
CN5400300000000	54	003	Berkeley County, WV	2012	NA	52263	48774	3489	6.7
CN5400500000000	54	005	Boone County, WV	2012	NA	8921	7994	927	10.4
CN5400700000000	54	007	Braxton County, WV	2012	NA	5411	4826	585	10.8
CN5400900000000	54	009	Brooke County, WV	2012	NA	10649	9718	931	8.7
CN5401100000000	54	011	Cabell County, WV	2012	NA	43037	40228	2809	6.5
CN5401300000000	54	013	Calhoun County, WV	2012	NA	2843	2527	316	11.1
CN5401500000000	54	015	Clay County, WV	2012	NA	3530	3105	425	12
CN5401700000000	54	017	Doddridge County, WV	2012	NA	3405	3190	215	6.3
CN5401900000000	54	019	Fayette County, WV	2012	NA	17576	16054	1522	8.7
CN5402100000000	54	021	Gilmer County, WV	2012	NA	2771	2555	216	7.8
CN5402300000000	54	023	Grant County, WV	2012	NA	6171	5627	544	8.8
CN5402500000000	54	025	Greenbrier County, WV	2012	NA	15490	14254	1236	8
CN5402700000000	54	027	Hampshire County, WV	2012	NA	9736	8963	773	7.9
CN5402900000000	54	029	Hancock County, WV	2012	NA	13753	12476	1277	9.3
CN5403100000000	54	031	Hardy County, WV	2012	NA	5570	4979	591	10.6
CN5403300000000	54	033	Harrison County, WV	2012	NA	31407	29358	2049	6.5
CN5403500000000	54	035	Jackson County, WV	2012	NA	12015	10988	1027	8.5
CN5403700000000	54	037	Jefferson County, WV	2012	NA	27507	26019	1488	5.4
CN5403900000000	54	039	Kanawha County, WV	2012	NA	91341	85308	6033	6.6
CN5404100000000	54	041	Lewis County, WV	2012	NA	7381	6861	520	7
CN5404300000000	54	043	Lincoln County, WV	2012	NA	7706	6910	796	10.3
CN5404500000000	54	045	Logan County, WV	2012	NA	12904	11646	1258	9.7
CN5404700000000	54	047	McDowell County, WV	2012	NA	6599	5802	797	12.1
CN5404900000000	54	049	Marion County, WV	2012	NA	26833	25103	1730	6.4
CN5405100000000	54	051	Marshall County, WV	2012	NA	14325	13170	1155	8.1
CN5405300000000	54	053	Mason County, WV	2012	NA	10902	9826	1076	9.9
CN5405500000000	54	055	Mercer County, WV	2012	NA	23431	21470	1961	8.4
CN5405700000000	54	057	Mineral County, WV	2012	NA	12095	11071	1024	8.5
CN5405900000000	54	059	Mingo County, WV	2012	NA	8988	8115	873	9.7
CN5406100000000	54	061	Monongalia County, WV	2012	NA	49695	47114	2581	5.2
CN5406300000000	54	063	Monroe County, WV	2012	NA	5733	5318	415	7.2
CN5406500000000	54	065	Morgan County, WV	2012	NA	7589	7033	556	7.3
CN5406700000000	54	067	Nicholas County, WV	2012	NA	10832	9827	1005	9.3
CN5406900000000	54	069	Ohio County, WV	2012	NA	21355	19994	1361	6.4
CN5407100000000	54	071	Pendleton County, WV	2012	NA	3636	3389	247	6.8
CN5407300000000	54	073	Pleasants County, WV	2012	NA	2878	2627	251	8.7
CN5407500000000	54	075	Pocahontas County, WV	2012	NA	3623	3255	368	10.2
CN5407700000000	54	077	Preston County, WV	2012	NA	14778	13735	1043	7.1
CN5407900000000	54	079	Putnam County, WV	2012	NA	26373	24679	1694	6.4
CN5408100000000	54	081	Raleigh County, WV	2012	NA	32843	30456	2387	7.3
CN5408300000000	54	083	Randolph County, WV	2012	NA	12078	11023	1055	8.7
CN5408500000000	54	085	Ritchie County, WV	2012	NA	4382	4059	323	7.4
CN5408700000000	54	087	Roane County, WV	2012	NA	5326	4720	606	11.4
CN5408900000000	54	089	Summers County, WV	2012	NA	4637	4226	411	8.9
CN5409100000000	54	091	Taylor County, WV	2012	NA	7562	7045	517	6.8
CN5409300000000	54	093	Tucker County, WV	2012	NA	3192	2934	258	8.1
CN5409500000000	54	095	Tyler County, WV	2012	NA	3661	3325	336	9.2
CN5409700000000	54	097	Upshur County, WV	2012	NA	9986	9206	780	7.8
CN5409900000000	54	099	Wayne County, WV	2012	NA	16389	15143	1246	7.6
CN5410100000000	54	101	Webster County, WV	2012	NA	3604	3218	386	10.7
CN5410300000000	54	103	Wetzel County, WV	2012	NA	7262	6582	680	9.4
CN5410500000000	54	105	Wirt County, WV	2012	NA	2297	2045	252	11
CN5410700000000	54	107	Wood County, WV	2012	NA	38543	35739	2804	7.3
CN5410900000000	54	109	Wyoming County, WV	2012	NA	8379	7610	769	9.2
CN5500100000000	55	001	Adams County, WI	2012	NA	8984	8002	982	10.9
CN5500300000000	55	003	Ashland County, WI	2012	NA	8238	7474	764	9.3
CN5500500000000	55	005	Barron County, WI	2012	NA	23712	21840	1872	7.9
CN5500700000000	55	007	Bayfield County, WI	2012	NA	7797	6956	841	10.8
CN5500900000000	55	009	Brown County, WI	2012	NA	137675	128644	9031	6.6
CN5501100000000	55	011	Buffalo County, WI	2012	NA	6639	6223	416	6.3
CN5501300000000	55	013	Burnett County, WI	2012	NA	7541	6860	681	9
CN5501500000000	55	015	Calumet County, WI	2012	NA	27298	25839	1459	5.3
CN5501700000000	55	017	Chippewa County, WI	2012	NA	33265	31013	2252	6.8
CN5501900000000	55	019	Clark County, WI	2012	NA	17099	15830	1269	7.4
CN5502100000000	55	021	Columbia County, WI	2012	NA	31329	29059	2270	7.2
CN5502300000000	55	023	Crawford County, WI	2012	NA	8302	7599	703	8.5
CN5502500000000	55	025	Dane County, WI	2012	NA	297453	282956	14497	4.9
CN5502700000000	55	027	Dodge County, WI	2012	NA	47743	44329	3414	7.2
CN5502900000000	55	029	Door County, WI	2012	NA	15766	14147	1619	10.3
CN5503100000000	55	031	Douglas County, WI	2012	NA	23433	21827	1606	6.9
CN5503300000000	55	033	Dunn County, WI	2012	NA	23433	21892	1541	6.6
CN5503500000000	55	035	Eau Claire County, WI	2012	NA	58261	54883	3378	5.8
CN5503700000000	55	037	Florence County, WI	2012	NA	2211	2027	184	8.3
CN5503900000000	55	039	Fond du Lac County, WI	2012	NA	56125	52481	3644	6.5
CN5504100000000	55	041	Forest County, WI	2012	NA	4142	3687	455	11
CN5504300000000	55	043	Grant County, WI	2012	NA	27700	26044	1656	6
CN5504500000000	55	045	Green County, WI	2012	NA	20833	19532	1301	6.2
CN5504700000000	55	047	Green Lake County, WI	2012	NA	10315	9540	775	7.5
CN5504900000000	55	049	Iowa County, WI	2012	NA	13550	12647	903	6.7
CN5505100000000	55	051	Iron County, WI	2012	NA	2784	2493	291	10.5
CN5505300000000	55	053	Jackson County, WI	2012	NA	10315	9562	753	7.3
CN5505500000000	55	055	Jefferson County, WI	2012	NA	46219	43135	3084	6.7
CN5505700000000	55	057	Juneau County, WI	2012	NA	13585	12445	1140	8.4
CN5505900000000	55	059	Kenosha County, WI	2012	NA	86840	79746	7094	8.2
CN5506100000000	55	061	Kewaunee County, WI	2012	NA	11018	10297	721	6.5
CN5506300000000	55	063	La Crosse County, WI	2012	NA	66420	62807	3613	5.4
CN5506500000000	55	065	Lafayette County, WI	2012	NA	9400	8873	527	5.6
CN5506700000000	55	067	Langlade County, WI	2012	NA	9974	9047	927	9.3
CN5506900000000	55	069	Lincoln County, WI	2012	NA	15112	13731	1381	9.1
CN5507100000000	55	071	Manitowoc County, WI	2012	NA	43695	40301	3394	7.8
CN5507300000000	55	073	Marathon County, WI	2012	NA	71650	66404	5246	7.3
CN5507500000000	55	075	Marinette County, WI	2012	NA	21450	19660	1790	8.3
CN5507700000000	55	077	Marquette County, WI	2012	NA	7580	6911	669	8.8
CN5507800000000	55	078	Menominee County, WI	2012	NA	1589	1330	259	16.3
CN5507900000000	55	079	Milwaukee County, WI	2012	NA	476498	435452	41046	8.6
CN5508100000000	55	081	Monroe County, WI	2012	NA	22788	21128	1660	7.3
CN5508300000000	55	083	Oconto County, WI	2012	NA	20662	18928	1734	8.4
CN5508500000000	55	085	Oneida County, WI	2012	NA	19140	17475	1665	8.7
CN5508700000000	55	087	Outagamie County, WI	2012	NA	100339	93892	6447	6.4
CN5508900000000	55	089	Ozaukee County, WI	2012	NA	47382	44778	2604	5.5
CN5509100000000	55	091	Pepin County, WI	2012	NA	4076	3844	232	5.7
CN5509300000000	55	093	Pierce County, WI	2012	NA	23897	22578	1319	5.5
CN5509500000000	55	095	Polk County, WI	2012	NA	24003	22072	1931	8
CN5509700000000	55	097	Portage County, WI	2012	NA	38921	36074	2847	7.3
CN5509900000000	55	099	Price County, WI	2012	NA	7050	6520	530	7.5
CN5510100000000	55	101	Racine County, WI	2012	NA	100434	92039	8395	8.4
CN5510300000000	55	103	Richland County, WI	2012	NA	9710	9103	607	6.3
CN5510500000000	55	105	Rock County, WI	2012	NA	81440	74657	6783	8.3
CN5510700000000	55	107	Rusk County, WI	2012	NA	6782	6169	613	9
CN5510900000000	55	109	St. Croix County, WI	2012	NA	47488	44760	2728	5.7
CN5511100000000	55	111	Sauk County, WI	2012	NA	35640	33181	2459	6.9
CN5511300000000	55	113	Sawyer County, WI	2012	NA	8278	7387	891	10.8
CN5511500000000	55	115	Shawano County, WI	2012	NA	21623	19896	1727	8
CN5511700000000	55	117	Sheboygan County, WI	2012	NA	60311	56180	4131	6.8
CN5511900000000	55	119	Taylor County, WI	2012	NA	11081	10284	797	7.2
CN5512100000000	55	121	Trempealeau County, WI	2012	NA	16368	15434	934	5.7
CN5512300000000	55	123	Vernon County, WI	2012	NA	15044	14085	959	6.4
CN5512500000000	55	125	Vilas County, WI	2012	NA	10101	9088	1013	10
CN5512700000000	55	127	Walworth County, WI	2012	NA	56038	51979	4059	7.2
CN5512900000000	55	129	Washburn County, WI	2012	NA	8089	7450	639	7.9
CN5513100000000	55	131	Washington County, WI	2012	NA	75079	70469	4610	6.1
CN5513300000000	55	133	Waukesha County, WI	2012	NA	217605	205086	12519	5.8
CN5513500000000	55	135	Waupaca County, WI	2012	NA	27390	25312	2078	7.6
CN5513700000000	55	137	Waushara County, WI	2012	NA	12021	10969	1052	8.8
CN5513900000000	55	139	Winnebago County, WI	2012	NA	92515	86354	6161	6.7
CN5514100000000	55	141	Wood County, WI	2012	NA	39719	36725	2994	7.5
CN5600100000000	56	001	Albany County, WY	2012	NA	20736	19845	891	4.3
CN5600300000000	56	003	Big Horn County, WY	2012	NA	5637	5320	317	5.6
CN5600500000000	56	005	Campbell County, WY	2012	NA	26119	24907	1212	4.6
CN5600700000000	56	007	Carbon County, WY	2012	NA	8215	7790	425	5.2
CN5600900000000	56	009	Converse County, WY	2012	NA	7976	7634	342	4.3
CN5601100000000	56	011	Crook County, WY	2012	NA	3814	3628	186	4.9
CN5601300000000	56	013	Fremont County, WY	2012	NA	21271	19989	1282	6
CN5601500000000	56	015	Goshen County, WY	2012	NA	7511	7160	351	4.7
CN5601700000000	56	017	Hot Springs County, WY	2012	NA	2578	2456	122	4.7
CN5601900000000	56	019	Johnson County, WY	2012	NA	4472	4234	238	5.3
CN5602100000000	56	021	Laramie County, WY	2012	NA	47711	44967	2744	5.8
CN5602300000000	56	023	Lincoln County, WY	2012	NA	8274	7685	589	7.1
CN5602500000000	56	025	Natrona County, WY	2012	NA	42388	40242	2146	5.1
CN5602700000000	56	027	Niobrara County, WY	2012	NA	1381	1328	53	3.8
CN5602900000000	56	029	Park County, WY	2012	NA	16262	15360	902	5.5
CN5603100000000	56	031	Platte County, WY	2012	NA	4787	4553	234	4.9
CN5603300000000	56	033	Sheridan County, WY	2012	NA	15903	14916	987	6.2
CN5603500000000	56	035	Sublette County, WY	2012	NA	5572	5300	272	4.9
CN5603700000000	56	037	Sweetwater County, WY	2012	NA	24138	22986	1152	4.8
CN5603900000000	56	039	Teton County, WY	2012	NA	13805	12881	924	6.7
CN5604100000000	56	041	Uinta County, WY	2012	NA	10263	9689	574	5.6
CN5604300000000	56	043	Washakie County, WY	2012	NA	4487	4254	233	5.2
CN5604500000000	56	045	Weston County, WY	2012	NA	3972	3811	161	4.1
CN7200100000000	72	001	Adjuntas Municipio, PR	2012	NA	4976	3898	1078	21.7
CN7200300000000	72	003	Aguada Municipio, PR	2012	NA	12716	10387	2329	18.3
CN7200500000000	72	005	Aguadilla Municipio, PR	2012	NA	16155	13142	3013	18.7
CN7200700000000	72	007	Aguas Buenas Municipio, PR	2012	NA	7363	5995	1368	18.6
CN7200900000000	72	009	Aibonito Municipio, PR	2012	NA	7232	5856	1376	19
CN7201100000000	72	011	Anasco Municipio, PR	2012	NA	9355	7765	1590	17
CN7201300000000	72	013	Arecibo Municipio, PR	2012	NA	25539	21489	4050	15.9
CN7201500000000	72	015	Arroyo Municipio, PR	2012	NA	5724	4428	1296	22.6
CN7201700000000	72	017	Barceloneta Municipio, PR	2012	NA	6193	4995	1198	19.3
CN7201900000000	72	019	Barranquitas Municipio, PR	2012	NA	7863	6589	1274	16.2
CN7202100000000	72	021	Bayamon Municipio, PR	2012	NA	72108	64165	7943	11
CN7202300000000	72	023	Cabo Rojo Municipio, PR	2012	NA	14582	12333	2249	15.4
CN7202500000000	72	025	Caguas Municipio, PR	2012	NA	52230	45171	7059	13.5
CN7202700000000	72	027	Camuy Municipio, PR	2012	NA	9980	8551	1429	14.3
CN7202900000000	72	029	Canovanas Municipio, PR	2012	NA	16726	14402	2324	13.9
CN7203100000000	72	031	Carolina Municipio, PR	2012	NA	66781	59747	7034	10.5
CN7203300000000	72	033	Catano Municipio, PR	2012	NA	8713	7539	1174	13.5
CN7203500000000	72	035	Cayey Municipio, PR	2012	NA	17454	14860	2594	14.9
CN7203700000000	72	037	Ceiba Municipio, PR	2012	NA	4356	3527	829	19
CN7203900000000	72	039	Ciales Municipio, PR	2012	NA	4285	3356	929	21.7
CN7204100000000	72	041	Cidra Municipio, PR	2012	NA	16861	14413	2448	14.5
CN7204300000000	72	043	Coamo Municipio, PR	2012	NA	11816	9339	2477	21
CN7204500000000	72	045	Comerio Municipio, PR	2012	NA	5568	4434	1134	20.4
CN7204700000000	72	047	Corozal Municipio, PR	2012	NA	9832	8260	1572	16
CN7204900000000	72	049	Culebra Municipio, PR	2012	NA	840	792	48	5.7
CN7205100000000	72	051	Dorado Municipio, PR	2012	NA	12971	11790	1181	9.1
CN7205300000000	72	053	Fajardo Municipio, PR	2012	NA	12720	10430	2290	18
CN7205400000000	72	054	Florida Municipio, PR	2012	NA	3665	2962	703	19.2
CN7205500000000	72	055	Guanica Municipio, PR	2012	NA	4759	3577	1182	24.8
CN7205700000000	72	057	Guayama Municipio, PR	2012	NA	13371	10581	2790	20.9
CN7205900000000	72	059	Guayanilla Municipio, PR	2012	NA	5766	4532	1234	21.4
CN7206100000000	72	061	Guaynabo Municipio, PR	2012	NA	38890	36304	2586	6.6
CN7206300000000	72	063	Gurabo Municipio, PR	2012	NA	17314	15360	1954	11.3
CN7206500000000	72	065	Hatillo Municipio, PR	2012	NA	13435	11252	2183	16.2
CN7206700000000	72	067	Hormigueros Municipio, PR	2012	NA	5916	5036	880	14.9
CN7206900000000	72	069	Humacao Municipio, PR	2012	NA	19211	15422	3789	19.7
CN7207100000000	72	071	Isabela Municipio, PR	2012	NA	12597	10302	2295	18.2
CN7207300000000	72	073	Jayuya Municipio, PR	2012	NA	4569	3799	770	16.9
CN7207500000000	72	075	Juana Diaz Municipio, PR	2012	NA	16438	13747	2691	16.4
CN7207700000000	72	077	Juncos Municipio, PR	2012	NA	12888	10785	2103	16.3
CN7207900000000	72	079	Lajas Municipio, PR	2012	NA	6133	4715	1418	23.1
CN7208100000000	72	081	Lares Municipio, PR	2012	NA	7728	6217	1511	19.6
CN7208300000000	72	083	Las Marias Municipio, PR	2012	NA	3709	3108	601	16.2
CN7208500000000	72	085	Las Piedras Municipio, PR	2012	NA	12063	9790	2273	18.8
CN7208700000000	72	087	Loiza Municipio, PR	2012	NA	9377	8171	1206	12.9
CN7208900000000	72	089	Luquillo Municipio, PR	2012	NA	6981	5609	1372	19.7
CN7209100000000	72	091	Manati Municipio, PR	2012	NA	12481	10606	1875	15
CN7209300000000	72	093	Maricao Municipio, PR	2012	NA	2165	1765	400	18.5
CN7209500000000	72	095	Maunabo Municipio, PR	2012	NA	3339	2574	765	22.9
CN7209700000000	72	097	Mayaguez Municipio, PR	2012	NA	25685	21396	4289	16.7
CN7209900000000	72	099	Moca Municipio, PR	2012	NA	11402	9200	2202	19.3
CN7210100000000	72	101	Morovis Municipio, PR	2012	NA	8677	7088	1589	18.3
CN7210300000000	72	103	Naguabo Municipio, PR	2012	NA	8566	7105	1461	17.1
CN7210500000000	72	105	Naranjito Municipio, PR	2012	NA	7774	6460	1314	16.9
CN7210700000000	72	107	Orocovis Municipio, PR	2012	NA	5726	4588	1138	19.9
CN7210900000000	72	109	Patillas Municipio, PR	2012	NA	5462	4090	1372	25.1
CN7211100000000	72	111	Penuelas Municipio, PR	2012	NA	6843	5444	1399	20.4
CN7211300000000	72	113	Ponce Municipio, PR	2012	NA	52179	43880	8299	15.9
CN7211500000000	72	115	Quebradillas Municipio, PR	2012	NA	6372	5194	1178	18.5
CN7211700000000	72	117	Rincon Municipio, PR	2012	NA	4811	3912	899	18.7
CN7211900000000	72	119	Rio Grande Municipio, PR	2012	NA	17927	15704	2223	12.4
CN7212100000000	72	121	Sabana Grande Municipio, PR	2012	NA	7032	5563	1469	20.9
CN7212300000000	72	123	Salinas Municipio, PR	2012	NA	8978	6741	2237	24.9
CN7212500000000	72	125	San German Municipio, PR	2012	NA	11171	9128	2043	18.3
CN7212700000000	72	127	San Juan Municipio, PR	2012	NA	145024	132233	12791	8.8
CN7212900000000	72	129	San Lorenzo Municipio, PR	2012	NA	12713	10710	2003	15.8
CN7213100000000	72	131	San Sebastian Municipio, PR	2012	NA	11317	8813	2504	22.1
CN7213300000000	72	133	Santa Isabel Municipio, PR	2012	NA	9892	7914	1978	20
CN7213500000000	72	135	Toa Alta Municipio, PR	2012	NA	26636	23951	2685	10.1
CN7213700000000	72	137	Toa Baja Municipio, PR	2012	NA	31909	28534	3375	10.6
CN7213900000000	72	139	Trujillo Alto Municipio, PR	2012	NA	28626	26231	2395	8.4
CN7214100000000	72	141	Utuado Municipio, PR	2012	NA	7551	6088	1463	19.4
CN7214300000000	72	143	Vega Alta Municipio, PR	2012	NA	10301	8845	1456	14.1
CN7214500000000	72	145	Vega Baja Municipio, PR	2012	NA	14796	12435	2361	16
CN7214700000000	72	147	Vieques Municipio, PR	2012	NA	3043	2651	392	12.9
CN7214900000000	72	149	Villalba Municipio, PR	2012	NA	8308	6584	1724	20.8
CN7215100000000	72	151	Yabucoa Municipio, PR	2012	NA	10302	7903	2399	23.3
CN7215300000000	72	153	Yauco Municipio, PR	2012	NA	11531	9140	2391	20.7
NA	NA	NA	NA	NA	NA	NA	NA	NA	NA
SOURCE:  BLS, LAUS	NA	NA	NA	NA	NA	NA	NA	NA	NA
April 17, 2020	NA	NA	NA	NA	NA	NA	NA	NA	NA
