LAUS_CODE	STATE_FIPS	COUNTY_FIPS	COUNTY	YEAR	ESTIMATED	LABOR_FORCE	EMPLOYED	UNEMPLOYED_LEVEL	UNEMPLOYED_RATE
CN0100100000000	01	001	Autauga County, AL	2017	NA	26075	25062	1013	3.9
CN0100300000000	01	003	Baldwin County, AL	2017	NA	92456	88711	3745	4.1
CN0100500000000	01	005	Barbour County, AL	2017	NA	8349	7863	486	5.8
CN0100700000000	01	007	Bibb County, AL	2017	NA	8583	8208	375	4.4
CN0100900000000	01	009	Blount County, AL	2017	NA	24822	23824	998	4
CN0101100000000	01	011	Bullock County, AL	2017	NA	4852	4614	238	4.9
CN0101300000000	01	013	Butler County, AL	2017	NA	8975	8481	494	5.5
CN0101500000000	01	015	Calhoun County, AL	2017	NA	45950	43679	2271	4.9
CN0101700000000	01	017	Chambers County, AL	2017	NA	15260	14639	621	4.1
CN0101900000000	01	019	Cherokee County, AL	2017	NA	11385	10922	463	4.1
CN0102100000000	01	021	Chilton County, AL	2017	NA	19333	18547	786	4.1
CN0102300000000	01	023	Choctaw County, AL	2017	NA	4424	4145	279	6.3
CN0102500000000	01	025	Clarke County, AL	2017	NA	7765	7107	658	8.5
CN0102700000000	01	027	Clay County, AL	2017	NA	5819	5567	252	4.3
CN0102900000000	01	029	Cleburne County, AL	2017	NA	5747	5489	258	4.5
CN0103100000000	01	031	Coffee County, AL	2017	NA	20969	20049	920	4.4
CN0103300000000	01	033	Colbert County, AL	2017	NA	23343	22130	1213	5.2
CN0103500000000	01	035	Conecuh County, AL	2017	NA	4505	4230	275	6.1
CN0103700000000	01	037	Coosa County, AL	2017	NA	4396	4191	205	4.7
CN0103900000000	01	039	Covington County, AL	2017	NA	15779	14958	821	5.2
CN0104100000000	01	041	Crenshaw County, AL	2017	NA	6429	6138	291	4.5
CN0104300000000	01	043	Cullman County, AL	2017	NA	37976	36556	1420	3.7
CN0104500000000	01	045	Dale County, AL	2017	NA	20014	19120	894	4.5
CN0104700000000	01	047	Dallas County, AL	2017	NA	15084	13956	1128	7.5
CN0104900000000	01	049	DeKalb County, AL	2017	NA	29688	28357	1331	4.5
CN0105100000000	01	051	Elmore County, AL	2017	NA	37366	35990	1376	3.7
CN0105300000000	01	053	Escambia County, AL	2017	NA	14501	13779	722	5
CN0105500000000	01	055	Etowah County, AL	2017	NA	43233	41251	1982	4.6
CN0105700000000	01	057	Fayette County, AL	2017	NA	6579	6269	310	4.7
CN0105900000000	01	059	Franklin County, AL	2017	NA	14029	13430	599	4.3
CN0106100000000	01	061	Geneva County, AL	2017	NA	10826	10356	470	4.3
CN0106300000000	01	063	Greene County, AL	2017	NA	2861	2645	216	7.5
CN0106500000000	01	065	Hale County, AL	2017	NA	5968	5614	354	5.9
CN0106700000000	01	067	Henry County, AL	2017	NA	6739	6411	328	4.9
CN0106900000000	01	069	Houston County, AL	2017	NA	44882	42923	1959	4.4
CN0107100000000	01	071	Jackson County, AL	2017	NA	23198	22088	1110	4.8
CN0107300000000	01	073	Jefferson County, AL	2017	NA	311481	298227	13254	4.3
CN0107500000000	01	075	Lamar County, AL	2017	NA	5764	5523	241	4.2
CN0107700000000	01	077	Lauderdale County, AL	2017	NA	42218	40261	1957	4.6
CN0107900000000	01	079	Lawrence County, AL	2017	NA	13690	13015	675	4.9
CN0108100000000	01	081	Lee County, AL	2017	NA	73762	70836	2926	4
CN0108300000000	01	083	Limestone County, AL	2017	NA	41691	40016	1675	4
CN0108500000000	01	085	Lowndes County, AL	2017	NA	3672	3371	301	8.2
CN0108700000000	01	087	Macon County, AL	2017	NA	7916	7460	456	5.8
CN0108900000000	01	089	Madison County, AL	2017	NA	176562	169711	6851	3.9
CN0109100000000	01	091	Marengo County, AL	2017	NA	7724	7291	433	5.6
CN0109300000000	01	093	Marion County, AL	2017	NA	12567	11964	603	4.8
CN0109500000000	01	095	Marshall County, AL	2017	NA	42240	40616	1624	3.8
CN0109700000000	01	097	Mobile County, AL	2017	NA	187560	177819	9741	5.2
CN0109900000000	01	099	Monroe County, AL	2017	NA	7243	6756	487	6.7
CN0110100000000	01	101	Montgomery County, AL	2017	NA	106155	101555	4600	4.3
CN0110300000000	01	103	Morgan County, AL	2017	NA	55252	52986	2266	4.1
CN0110500000000	01	105	Perry County, AL	2017	NA	3449	3181	268	7.8
CN0110700000000	01	107	Pickens County, AL	2017	NA	7748	7333	415	5.4
CN0110900000000	01	109	Pike County, AL	2017	NA	15351	14606	745	4.9
CN0111100000000	01	111	Randolph County, AL	2017	NA	9521	9104	417	4.4
CN0111300000000	01	113	Russell County, AL	2017	NA	23481	22468	1013	4.3
CN0111500000000	01	115	St. Clair County, AL	2017	NA	39341	37780	1561	4
CN0111700000000	01	117	Shelby County, AL	2017	NA	111770	108172	3598	3.2
CN0111900000000	01	119	Sumter County, AL	2017	NA	4986	4659	327	6.6
CN0112100000000	01	121	Talladega County, AL	2017	NA	34780	33040	1740	5
CN0112300000000	01	123	Tallapoosa County, AL	2017	NA	18273	17505	768	4.2
CN0112500000000	01	125	Tuscaloosa County, AL	2017	NA	100259	96091	4168	4.2
CN0112700000000	01	127	Walker County, AL	2017	NA	24996	23738	1258	5
CN0112900000000	01	129	Washington County, AL	2017	NA	6717	6263	454	6.8
CN0113100000000	01	131	Wilcox County, AL	2017	NA	2812	2491	321	11.4
CN0113300000000	01	133	Winston County, AL	2017	NA	9730	9241	489	5
CN0201300000000	02	013	Aleutians East Borough, AK	2017	NA	2529	2466	63	2.5
CN0201600000000	02	016	Aleutians West Census Area, AK	2017	NA	3724	3587	137	3.7
CN0202000000000	02	020	Anchorage Borough/municipality, AK	2017	NA	153108	144255	8853	5.8
CN0205000000000	02	050	Bethel Census Area, AK	2017	NA	7326	6343	983	13.4
CN0206000000000	02	060	Bristol Bay Borough, AK	2017	NA	419	393	26	6.2
CN0206800000000	02	068	Denali Borough, AK	2017	NA	1144	1042	102	8.9
CN0207000000000	02	070	Dillingham Census Area, AK	2017	NA	2045	1863	182	8.9
CN0209000000000	02	090	Fairbanks North Star Borough, AK	2017	NA	46234	43429	2805	6.1
CN0210000000000	02	100	Haines Borough, AK	2017	NA	1077	982	95	8.8
CN0210500000000	02	105	Hoonah-Angoon Census Area, AK	2017	NA	1136	998	138	12.1
CN0211000000000	02	110	Juneau Borough/city, AK	2017	NA	17208	16417	791	4.6
CN0212200000000	02	122	Kenai Peninsula Borough, AK	2017	NA	26749	24551	2198	8.2
CN0213000000000	02	130	Ketchikan Gateway Borough, AK	2017	NA	7066	6634	432	6.1
CN0215000000000	02	150	Kodiak Island Borough, AK	2017	NA	6292	5977	315	5
CN0215800000000	02	158	Kusilvak Census Area, AK	2017	NA	2746	2209	537	19.6
CN0216400000000	02	164	Lake and Peninsula Borough, AK	2017	NA	716	632	84	11.7
CN0217000000000	02	170	Matanuska-Susitna Borough, AK	2017	NA	48126	44174	3952	8.2
CN0218000000000	02	180	Nome Census Area, AK	2017	NA	4089	3597	492	12
CN0218500000000	02	185	North Slope Borough, AK	2017	NA	3585	3321	264	7.4
CN0218800000000	02	188	Northwest Arctic Borough, AK	2017	NA	2951	2476	475	16.1
CN0219500000000	02	195	Petersburg Borough, AK	2017	NA	1411	1283	128	9.1
CN0219800000000	02	198	Prince of Wales-Hyder Census Area, AK	2017	NA	2840	2527	313	11
CN0222000000000	02	220	Sitka Borough/city, AK	2017	NA	4426	4227	199	4.5
CN0223000000000	02	230	Skagway Municipality, AK	2017	NA	826	742	84	10.2
CN0224000000000	02	240	Southeast Fairbanks Census Area, AK	2017	NA	2927	2629	298	10.2
CN0226100000000	02	261	Valdez-Cordova Census Area, AK	2017	NA	4856	4484	372	7.7
CN0227500000000	02	275	Wrangell Borough/city, AK	2017	NA	1045	966	79	7.6
CN0228200000000	02	282	Yakutat Borough/city, AK	2017	NA	232	211	21	9.1
CN0229000000000	02	290	Yukon-Koyukuk Census Area, AK	2017	NA	2466	2034	432	17.5
CN0400100000000	04	001	Apache County, AZ	2017	NA	20361	18274	2087	10.2
CN0400300000000	04	003	Cochise County, AZ	2017	NA	49327	46592	2735	5.5
CN0400500000000	04	005	Coconino County, AZ	2017	NA	75401	71251	4150	5.5
CN0400700000000	04	007	Gila County, AZ	2017	NA	21306	20025	1281	6
CN0400900000000	04	009	Graham County, AZ	2017	NA	14358	13581	777	5.4
CN0401100000000	04	011	Greenlee County, AZ	2017	NA	3983	3784	199	5
CN0401200000000	04	012	La Paz County, AZ	2017	NA	8681	8216	465	5.4
CN0401300000000	04	013	Maricopa County, AZ	2017	NA	2141365	2052091	89274	4.2
CN0401500000000	04	015	Mohave County, AZ	2017	NA	82349	77541	4808	5.8
CN0401700000000	04	017	Navajo County, AZ	2017	NA	40684	37591	3093	7.6
CN0401900000000	04	019	Pima County, AZ	2017	NA	475935	454630	21305	4.5
CN0402100000000	04	021	Pinal County, AZ	2017	NA	171474	162883	8591	5
CN0402300000000	04	023	Santa Cruz County, AZ	2017	NA	19051	17255	1796	9.4
CN0402500000000	04	025	Yavapai County, AZ	2017	NA	101851	97269	4582	4.5
CN0402700000000	04	027	Yuma County, AZ	2017	NA	95437	79266	16171	16.9
CN0500100000000	05	001	Arkansas County, AR	2017	NA	8960	8669	291	3.2
CN0500300000000	05	003	Ashley County, AR	2017	NA	7857	7420	437	5.6
CN0500500000000	05	005	Baxter County, AR	2017	NA	16350	15655	695	4.3
CN0500700000000	05	007	Benton County, AR	2017	NA	132347	128439	3908	3
CN0500900000000	05	009	Boone County, AR	2017	NA	15782	15242	540	3.4
CN0501100000000	05	011	Bradley County, AR	2017	NA	4454	4250	204	4.6
CN0501300000000	05	013	Calhoun County, AR	2017	NA	2408	2315	93	3.9
CN0501500000000	05	015	Carroll County, AR	2017	NA	12979	12548	431	3.3
CN0501700000000	05	017	Chicot County, AR	2017	NA	3462	3237	225	6.5
CN0501900000000	05	019	Clark County, AR	2017	NA	9566	9194	372	3.9
CN0502100000000	05	021	Clay County, AR	2017	NA	5876	5611	265	4.5
CN0502300000000	05	023	Cleburne County, AR	2017	NA	9276	8821	455	4.9
CN0502500000000	05	025	Cleveland County, AR	2017	NA	3324	3180	144	4.3
CN0502700000000	05	027	Columbia County, AR	2017	NA	9069	8612	457	5
CN0502900000000	05	029	Conway County, AR	2017	NA	8222	7830	392	4.8
CN0503100000000	05	031	Craighead County, AR	2017	NA	53541	51936	1605	3
CN0503300000000	05	033	Crawford County, AR	2017	NA	26904	25958	946	3.5
CN0503500000000	05	035	Crittenden County, AR	2017	NA	21357	20427	930	4.4
CN0503700000000	05	037	Cross County, AR	2017	NA	7648	7342	306	4
CN0503900000000	05	039	Dallas County, AR	2017	NA	2916	2788	128	4.4
CN0504100000000	05	041	Desha County, AR	2017	NA	5442	5181	261	4.8
CN0504300000000	05	043	Drew County, AR	2017	NA	7953	7550	403	5.1
CN0504500000000	05	045	Faulkner County, AR	2017	NA	61295	59256	2039	3.3
CN0504700000000	05	047	Franklin County, AR	2017	NA	7395	7135	260	3.5
CN0504900000000	05	049	Fulton County, AR	2017	NA	4713	4515	198	4.2
CN0505100000000	05	051	Garland County, AR	2017	NA	40296	38671	1625	4
CN0505300000000	05	053	Grant County, AR	2017	NA	8317	8049	268	3.2
CN0505500000000	05	055	Greene County, AR	2017	NA	19701	18977	724	3.7
CN0505700000000	05	057	Hempstead County, AR	2017	NA	9886	9546	340	3.4
CN0505900000000	05	059	Hot Spring County, AR	2017	NA	14106	13585	521	3.7
CN0506100000000	05	061	Howard County, AR	2017	NA	5982	5802	180	3
CN0506300000000	05	063	Independence County, AR	2017	NA	16126	15443	683	4.2
CN0506500000000	05	065	Izard County, AR	2017	NA	4875	4606	269	5.5
CN0506700000000	05	067	Jackson County, AR	2017	NA	5874	5530	344	5.9
CN0506900000000	05	069	Jefferson County, AR	2017	NA	27970	26522	1448	5.2
CN0507100000000	05	071	Johnson County, AR	2017	NA	10566	10115	451	4.3
CN0507300000000	05	073	Lafayette County, AR	2017	NA	2537	2409	128	5
CN0507500000000	05	075	Lawrence County, AR	2017	NA	6850	6593	257	3.8
CN0507700000000	05	077	Lee County, AR	2017	NA	2965	2823	142	4.8
CN0507900000000	05	079	Lincoln County, AR	2017	NA	4048	3880	168	4.2
CN0508100000000	05	081	Little River County, AR	2017	NA	5493	5228	265	4.8
CN0508300000000	05	083	Logan County, AR	2017	NA	8888	8548	340	3.8
CN0508500000000	05	085	Lonoke County, AR	2017	NA	33815	32711	1104	3.3
CN0508700000000	05	087	Madison County, AR	2017	NA	7363	7153	210	2.9
CN0508900000000	05	089	Marion County, AR	2017	NA	6473	6218	255	3.9
CN0509100000000	05	091	Miller County, AR	2017	NA	19740	18884	856	4.3
CN0509300000000	05	093	Mississippi County, AR	2017	NA	17764	16710	1054	5.9
CN0509500000000	05	095	Monroe County, AR	2017	NA	2796	2677	119	4.3
CN0509700000000	05	097	Montgomery County, AR	2017	NA	3088	2941	147	4.8
CN0509900000000	05	099	Nevada County, AR	2017	NA	3600	3473	127	3.5
CN0510100000000	05	101	Newton County, AR	2017	NA	3319	3199	120	3.6
CN0510300000000	05	103	Ouachita County, AR	2017	NA	9714	9270	444	4.6
CN0510500000000	05	105	Perry County, AR	2017	NA	4241	4066	175	4.1
CN0510700000000	05	107	Phillips County, AR	2017	NA	6525	6148	377	5.8
CN0510900000000	05	109	Pike County, AR	2017	NA	4290	4118	172	4
CN0511100000000	05	111	Poinsett County, AR	2017	NA	10247	9822	425	4.1
CN0511300000000	05	113	Polk County, AR	2017	NA	8020	7661	359	4.5
CN0511500000000	05	115	Pope County, AR	2017	NA	29065	27775	1290	4.4
CN0511700000000	05	117	Prairie County, AR	2017	NA	3693	3542	151	4.1
CN0511900000000	05	119	Pulaski County, AR	2017	NA	188293	181884	6409	3.4
CN0512100000000	05	121	Randolph County, AR	2017	NA	6916	6629	287	4.1
CN0512300000000	05	123	St. Francis County, AR	2017	NA	8353	7933	420	5
CN0512500000000	05	125	Saline County, AR	2017	NA	57432	55701	1731	3
CN0512700000000	05	127	Scott County, AR	2017	NA	4430	4277	153	3.5
CN0512900000000	05	129	Searcy County, AR	2017	NA	2933	2797	136	4.6
CN0513100000000	05	131	Sebastian County, AR	2017	NA	57164	55104	2060	3.6
CN0513300000000	05	133	Sevier County, AR	2017	NA	5659	5404	255	4.5
CN0513500000000	05	135	Sharp County, AR	2017	NA	5954	5656	298	5
CN0513700000000	05	137	Stone County, AR	2017	NA	4788	4560	228	4.8
CN0513900000000	05	139	Union County, AR	2017	NA	16079	15232	847	5.3
CN0514100000000	05	141	Van Buren County, AR	2017	NA	6034	5705	329	5.5
CN0514300000000	05	143	Washington County, AR	2017	NA	120584	117465	3119	2.6
CN0514500000000	05	145	White County, AR	2017	NA	33599	32074	1525	4.5
CN0514700000000	05	147	Woodruff County, AR	2017	NA	2922	2781	141	4.8
CN0514900000000	05	149	Yell County, AR	2017	NA	8551	8207	344	4
CN0600100000000	06	001	Alameda County, CA	2017	NA	839215	808382	30833	3.7
CN0600300000000	06	003	Alpine County, CA	2017	NA	548	515	33	6
CN0600500000000	06	005	Amador County, CA	2017	NA	14710	13980	730	5
CN0600700000000	06	007	Butte County, CA	2017	NA	102114	96209	5905	5.8
CN0600900000000	06	009	Calaveras County, CA	2017	NA	21040	20046	994	4.7
CN0601100000000	06	011	Colusa County, CA	2017	NA	10820	9282	1538	14.2
CN0601300000000	06	013	Contra Costa County, CA	2017	NA	558591	537156	21435	3.8
CN0601500000000	06	015	Del Norte County, CA	2017	NA	9707	9083	624	6.4
CN0601700000000	06	017	El Dorado County, CA	2017	NA	89824	85902	3922	4.4
CN0601900000000	06	019	Fresno County, CA	2017	NA	444862	406912	37950	8.5
CN0602100000000	06	021	Glenn County, CA	2017	NA	12816	11859	957	7.5
CN0602300000000	06	023	Humboldt County, CA	2017	NA	62559	59937	2622	4.2
CN0602500000000	06	025	Imperial County, CA	2017	NA	72060	57977	14083	19.5
CN0602700000000	06	027	Inyo County, CA	2017	NA	8615	8239	376	4.4
CN0602900000000	06	029	Kern County, CA	2017	NA	384402	349050	35352	9.2
CN0603100000000	06	031	Kings County, CA	2017	NA	57315	52216	5099	8.9
CN0603300000000	06	033	Lake County, CA	2017	NA	29336	27642	1694	5.8
CN0603500000000	06	035	Lassen County, CA	2017	NA	10037	9484	553	5.5
CN0603700000000	06	037	Los Angeles County, CA	2017	NA	5084014	4841864	242150	4.8
CN0603900000000	06	039	Madera County, CA	2017	NA	60966	56021	4945	8.1
CN0604100000000	06	041	Marin County, CA	2017	NA	139822	135799	4023	2.9
CN0604300000000	06	043	Mariposa County, CA	2017	NA	7662	7215	447	5.8
CN0604500000000	06	045	Mendocino County, CA	2017	NA	39584	37796	1788	4.5
CN0604700000000	06	047	Merced County, CA	2017	NA	115306	104497	10809	9.4
CN0604900000000	06	049	Modoc County, CA	2017	NA	3196	2937	259	8.1
CN0605100000000	06	051	Mono County, CA	2017	NA	8496	8119	377	4.4
CN0605300000000	06	053	Monterey County, CA	2017	NA	219706	203958	15748	7.2
CN0605500000000	06	055	Napa County, CA	2017	NA	73332	70661	2671	3.6
CN0605700000000	06	057	Nevada County, CA	2017	NA	48349	46362	1987	4.1
CN0605900000000	06	059	Orange County, CA	2017	NA	1607793	1551463	56330	3.5
CN0606100000000	06	061	Placer County, CA	2017	NA	181460	174454	7006	3.9
CN0606300000000	06	063	Plumas County, CA	2017	NA	7770	7081	689	8.9
CN0606500000000	06	065	Riverside County, CA	2017	NA	1072154	1015843	56311	5.3
CN0606700000000	06	067	Sacramento County, CA	2017	NA	697323	664782	32541	4.7
CN0606900000000	06	069	San Benito County, CA	2017	NA	30622	28857	1765	5.8
CN0607100000000	06	071	San Bernardino County, CA	2017	NA	943144	896687	46457	4.9
CN0607300000000	06	073	San Diego County, CA	2017	NA	1572801	1509574	63227	4
CN0607500000000	06	075	San Francisco County/city, CA	2017	NA	563815	547308	16507	2.9
CN0607700000000	06	077	San Joaquin County, CA	2017	NA	323289	300683	22606	7
CN0607900000000	06	079	San Luis Obispo County, CA	2017	NA	140434	135385	5049	3.6
CN0608100000000	06	081	San Mateo County, CA	2017	NA	445523	433416	12107	2.7
CN0608300000000	06	083	Santa Barbara County, CA	2017	NA	215214	205471	9743	4.5
CN0608500000000	06	085	Santa Clara County, CA	2017	NA	1038698	1005277	33421	3.2
CN0608700000000	06	087	Santa Cruz County, CA	2017	NA	142762	134637	8125	5.7
CN0608900000000	06	089	Shasta County, CA	2017	NA	73996	69705	4291	5.8
CN0609100000000	06	091	Sierra County, CA	2017	NA	1290	1206	84	6.5
CN0609300000000	06	093	Siskiyou County, CA	2017	NA	17803	16511	1292	7.3
CN0609500000000	06	095	Solano County, CA	2017	NA	208199	198274	9925	4.8
CN0609700000000	06	097	Sonoma County, CA	2017	NA	260114	251331	8783	3.4
CN0609900000000	06	099	Stanislaus County, CA	2017	NA	242212	224091	18121	7.5
CN0610100000000	06	101	Sutter County, CA	2017	NA	45005	41094	3911	8.7
CN0610300000000	06	103	Tehama County, CA	2017	NA	25539	23914	1625	6.4
CN0610500000000	06	105	Trinity County, CA	2017	NA	4809	4511	298	6.2
CN0610700000000	06	107	Tulare County, CA	2017	NA	204616	183249	21367	10.4
CN0610900000000	06	109	Tuolumne County, CA	2017	NA	21393	20240	1153	5.4
CN0611100000000	06	111	Ventura County, CA	2017	NA	424156	405104	19052	4.5
CN0611300000000	06	113	Yolo County, CA	2017	NA	106684	101244	5440	5.1
CN0611500000000	06	115	Yuba County, CA	2017	NA	28747	26612	2135	7.4
CN0800100000000	08	001	Adams County, CO	2017	NA	260525	252646	7879	3
CN0800300000000	08	003	Alamosa County, CO	2017	NA	8132	7855	277	3.4
CN0800500000000	08	005	Arapahoe County, CO	2017	NA	350170	340529	9641	2.8
CN0800700000000	08	007	Archuleta County, CO	2017	NA	6611	6412	199	3
CN0800900000000	08	009	Baca County, CO	2017	NA	2119	2085	34	1.6
CN0801100000000	08	011	Bent County, CO	2017	NA	1923	1870	53	2.8
CN0801300000000	08	013	Boulder County, CO	2017	NA	186420	181964	4456	2.4
CN0801400000000	08	014	Broomfield County/city, CO	2017	NA	38501	37505	996	2.6
CN0801500000000	08	015	Chaffee County, CO	2017	NA	9295	9079	216	2.3
CN0801700000000	08	017	Cheyenne County, CO	2017	NA	1132	1112	20	1.8
CN0801900000000	08	019	Clear Creek County, CO	2017	NA	5863	5712	151	2.6
CN0802100000000	08	021	Conejos County, CO	2017	NA	3921	3759	162	4.1
CN0802300000000	08	023	Costilla County, CO	2017	NA	1821	1757	64	3.5
CN0802500000000	08	025	Crowley County, CO	2017	NA	1469	1424	45	3.1
CN0802700000000	08	027	Custer County, CO	2017	NA	2031	1970	61	3
CN0802900000000	08	029	Delta County, CO	2017	NA	14271	13721	550	3.9
CN0803100000000	08	031	Denver County/city, CO	2017	NA	398590	387741	10849	2.7
CN0803300000000	08	033	Dolores County, CO	2017	NA	1128	1095	33	2.9
CN0803500000000	08	035	Douglas County, CO	2017	NA	184585	180221	4364	2.4
CN0803700000000	08	037	Eagle County, CO	2017	NA	34772	33970	802	2.3
CN0803900000000	08	039	Elbert County, CO	2017	NA	14379	14033	346	2.4
CN0804100000000	08	041	El Paso County, CO	2017	NA	325388	314855	10533	3.2
CN0804300000000	08	043	Fremont County, CO	2017	NA	14949	14314	635	4.2
CN0804500000000	08	045	Garfield County, CO	2017	NA	31499	30597	902	2.9
CN0804700000000	08	047	Gilpin County, CO	2017	NA	3597	3525	72	2
CN0804900000000	08	049	Grand County, CO	2017	NA	9532	9319	213	2.2
CN0805100000000	08	051	Gunnison County, CO	2017	NA	10678	10463	215	2
CN0805300000000	08	053	Hinsdale County, CO	2017	NA	473	462	11	2.3
CN0805500000000	08	055	Huerfano County, CO	2017	NA	2550	2404	146	5.7
CN0805700000000	08	057	Jackson County, CO	2017	NA	959	942	17	1.8
CN0805900000000	08	059	Jefferson County, CO	2017	NA	322789	314385	8404	2.6
CN0806100000000	08	061	Kiowa County, CO	2017	NA	922	906	16	1.7
CN0806300000000	08	063	Kit Carson County, CO	2017	NA	4375	4301	74	1.7
CN0806500000000	08	065	Lake County, CO	2017	NA	4707	4607	100	2.1
CN0806700000000	08	067	La Plata County, CO	2017	NA	31386	30626	760	2.4
CN0806900000000	08	069	Larimer County, CO	2017	NA	194947	190257	4690	2.4
CN0807100000000	08	071	Las Animas County, CO	2017	NA	6253	6004	249	4
CN0807300000000	08	073	Lincoln County, CO	2017	NA	2376	2327	49	2.1
CN0807500000000	08	075	Logan County, CO	2017	NA	11091	10833	258	2.3
CN0807700000000	08	077	Mesa County, CO	2017	NA	73596	70704	2892	3.9
CN0807900000000	08	079	Mineral County, CO	2017	NA	464	455	9	1.9
CN0808100000000	08	081	Moffat County, CO	2017	NA	7319	7077	242	3.3
CN0808300000000	08	083	Montezuma County, CO	2017	NA	12836	12332	504	3.9
CN0808500000000	08	085	Montrose County, CO	2017	NA	20790	20110	680	3.3
CN0808700000000	08	087	Morgan County, CO	2017	NA	15560	15186	374	2.4
CN0808900000000	08	089	Otero County, CO	2017	NA	8263	7924	339	4.1
CN0809100000000	08	091	Ouray County, CO	2017	NA	2259	2195	64	2.8
CN0809300000000	08	093	Park County, CO	2017	NA	10451	10206	245	2.3
CN0809500000000	08	095	Phillips County, CO	2017	NA	2570	2529	41	1.6
CN0809700000000	08	097	Pitkin County, CO	2017	NA	10974	10639	335	3.1
CN0809900000000	08	099	Prowers County, CO	2017	NA	6188	6028	160	2.6
CN0810100000000	08	101	Pueblo County, CO	2017	NA	74672	71495	3177	4.3
CN0810300000000	08	103	Rio Blanco County, CO	2017	NA	2782	2674	108	3.9
CN0810500000000	08	105	Rio Grande County, CO	2017	NA	5365	5135	230	4.3
CN0810700000000	08	107	Routt County, CO	2017	NA	15534	15167	367	2.4
CN0810900000000	08	109	Saguache County, CO	2017	NA	3433	3283	150	4.4
CN0811100000000	08	111	San Juan County, CO	2017	NA	527	515	12	2.3
CN0811300000000	08	113	San Miguel County, CO	2017	NA	5338	5187	151	2.8
CN0811500000000	08	115	Sedgwick County, CO	2017	NA	1189	1164	25	2.1
CN0811700000000	08	117	Summit County, CO	2017	NA	21813	21409	404	1.9
CN0811900000000	08	119	Teller County, CO	2017	NA	12230	11842	388	3.2
CN0812100000000	08	121	Washington County, CO	2017	NA	3024	2966	58	1.9
CN0812300000000	08	123	Weld County, CO	2017	NA	157550	153366	4184	2.7
CN0812500000000	08	125	Yuma County, CO	2017	NA	5668	5578	90	1.6
CN0900100000000	09	001	Fairfield County, CT	2017	NA	479458	457625	21833	4.6
CN0900300000000	09	003	Hartford County, CT	2017	NA	477390	454205	23185	4.9
CN0900500000000	09	005	Litchfield County, CT	2017	NA	104051	99522	4529	4.4
CN0900700000000	09	007	Middlesex County, CT	2017	NA	92583	88817	3766	4.1
CN0900900000000	09	009	New Haven County, CT	2017	NA	457800	434645	23155	5.1
CN0901100000000	09	011	New London County, CT	2017	NA	137470	131267	6203	4.5
CN0901300000000	09	013	Tolland County, CT	2017	NA	85802	82362	3440	4
CN0901500000000	09	015	Windham County, CT	2017	NA	63088	59886	3202	5.1
CN1000100000000	10	001	Kent County, DE	2017	NA	77446	73667	3779	4.9
CN1000300000000	10	003	New Castle County, DE	2017	NA	295508	282545	12963	4.4
CN1000500000000	10	005	Sussex County, DE	2017	NA	103317	98716	4601	4.5
CN1100100000000	11	001	District of Columbia	2017	NA	401021	376716	24305	6.1
CN1200100000000	12	001	Alachua County, FL	2017	NA	135590	130393	5197	3.8
CN1200300000000	12	003	Baker County, FL	2017	NA	11668	11178	490	4.2
CN1200500000000	12	005	Bay County, FL	2017	NA	88359	84675	3684	4.2
CN1200700000000	12	007	Bradford County, FL	2017	NA	11268	10855	413	3.7
CN1200900000000	12	009	Brevard County, FL	2017	NA	269221	257525	11696	4.3
CN1201100000000	12	011	Broward County, FL	2017	NA	1023413	982614	40799	4
CN1201300000000	12	013	Calhoun County, FL	2017	NA	4980	4736	244	4.9
CN1201500000000	12	015	Charlotte County, FL	2017	NA	70121	66783	3338	4.8
CN1201700000000	12	017	Citrus County, FL	2017	NA	47927	45097	2830	5.9
CN1201900000000	12	019	Clay County, FL	2017	NA	104297	100222	4075	3.9
CN1202100000000	12	021	Collier County, FL	2017	NA	173522	166305	7217	4.2
CN1202300000000	12	023	Columbia County, FL	2017	NA	29364	28076	1288	4.4
CN1202700000000	12	027	DeSoto County, FL	2017	NA	14067	13435	632	4.5
CN1202900000000	12	029	Dixie County, FL	2017	NA	5756	5481	275	4.8
CN1203100000000	12	031	Duval County, FL	2017	NA	478819	458384	20435	4.3
CN1203300000000	12	033	Escambia County, FL	2017	NA	142287	136297	5990	4.2
CN1203500000000	12	035	Flagler County, FL	2017	NA	46217	43985	2232	4.8
CN1203700000000	12	037	Franklin County, FL	2017	NA	4706	4535	171	3.6
CN1203900000000	12	039	Gadsden County, FL	2017	NA	18186	17184	1002	5.5
CN1204100000000	12	041	Gilchrist County, FL	2017	NA	6830	6526	304	4.5
CN1204300000000	12	043	Glades County, FL	2017	NA	4958	4691	267	5.4
CN1204500000000	12	045	Gulf County, FL	2017	NA	6021	5785	236	3.9
CN1204700000000	12	047	Hamilton County, FL	2017	NA	4319	4109	210	4.9
CN1204900000000	12	049	Hardee County, FL	2017	NA	8977	8448	529	5.9
CN1205100000000	12	051	Hendry County, FL	2017	NA	16027	14854	1173	7.3
CN1205300000000	12	053	Hernando County, FL	2017	NA	69483	65820	3663	5.3
CN1205500000000	12	055	Highlands County, FL	2017	NA	36449	34377	2072	5.7
CN1205700000000	12	057	Hillsborough County, FL	2017	NA	725510	696922	28588	3.9
CN1205900000000	12	059	Holmes County, FL	2017	NA	6901	6571	330	4.8
CN1206100000000	12	061	Indian River County, FL	2017	NA	64032	60796	3236	5.1
CN1206300000000	12	063	Jackson County, FL	2017	NA	17327	16542	785	4.5
CN1206500000000	12	065	Jefferson County, FL	2017	NA	5505	5264	241	4.4
CN1206700000000	12	067	Lafayette County, FL	2017	NA	2946	2835	111	3.8
CN1206900000000	12	069	Lake County, FL	2017	NA	151233	144851	6382	4.2
CN1207100000000	12	071	Lee County, FL	2017	NA	335681	321870	13811	4.1
CN1207300000000	12	073	Leon County, FL	2017	NA	152359	146378	5981	3.9
CN1207500000000	12	075	Levy County, FL	2017	NA	16800	16047	753	4.5
CN1207700000000	12	077	Liberty County, FL	2017	NA	2624	2504	120	4.6
CN1207900000000	12	079	Madison County, FL	2017	NA	7380	7050	330	4.5
CN1208100000000	12	081	Manatee County, FL	2017	NA	175030	168020	7010	4
CN1208300000000	12	083	Marion County, FL	2017	NA	133929	127142	6787	5.1
CN1208500000000	12	085	Martin County, FL	2017	NA	72163	69125	3038	4.2
CN1208600000000	12	086	Miami-Dade County, FL	2017	NA	1359864	1298510	61354	4.5
CN1208700000000	12	087	Monroe County, FL	2017	NA	45731	44232	1499	3.3
CN1208900000000	12	089	Nassau County, FL	2017	NA	39196	37662	1534	3.9
CN1209100000000	12	091	Okaloosa County, FL	2017	NA	94533	91236	3297	3.5
CN1209300000000	12	093	Okeechobee County, FL	2017	NA	18367	17559	808	4.4
CN1209500000000	12	095	Orange County, FL	2017	NA	730111	702466	27645	3.8
CN1209700000000	12	097	Osceola County, FL	2017	NA	173284	165753	7531	4.3
CN1209900000000	12	099	Palm Beach County, FL	2017	NA	723093	692769	30324	4.2
CN1210100000000	12	101	Pasco County, FL	2017	NA	228589	218330	10259	4.5
CN1210300000000	12	103	Pinellas County, FL	2017	NA	484810	466184	18626	3.8
CN1210500000000	12	105	Polk County, FL	2017	NA	293786	279636	14150	4.8
CN1210700000000	12	107	Putnam County, FL	2017	NA	27068	25587	1481	5.5
CN1210900000000	12	109	St. Johns County, FL	2017	NA	125066	120801	4265	3.4
CN1211100000000	12	111	St. Lucie County, FL	2017	NA	139386	132155	7231	5.2
CN1211300000000	12	113	Santa Rosa County, FL	2017	NA	79147	76050	3097	3.9
CN1211500000000	12	115	Sarasota County, FL	2017	NA	184887	177553	7334	4
CN1211700000000	12	117	Seminole County, FL	2017	NA	247566	238299	9267	3.7
CN1211900000000	12	119	Sumter County, FL	2017	NA	30299	28437	1862	6.1
CN1212100000000	12	121	Suwannee County, FL	2017	NA	18367	17580	787	4.3
CN1212300000000	12	123	Taylor County, FL	2017	NA	8781	8385	396	4.5
CN1212500000000	12	125	Union County, FL	2017	NA	4820	4638	182	3.8
CN1212700000000	12	127	Volusia County, FL	2017	NA	250050	238896	11154	4.5
CN1212900000000	12	129	Wakulla County, FL	2017	NA	14507	13983	524	3.6
CN1213100000000	12	131	Walton County, FL	2017	NA	30079	28972	1107	3.7
CN1213300000000	12	133	Washington County, FL	2017	NA	9798	9367	431	4.4
CN1300100000000	13	001	Appling County, GA	2017	NA	9245	8741	504	5.5
CN1300300000000	13	003	Atkinson County, GA	2017	NA	4158	3973	185	4.4
CN1300500000000	13	005	Bacon County, GA	2017	NA	5044	4821	223	4.4
CN1300700000000	13	007	Baker County, GA	2017	NA	1234	1158	76	6.2
CN1300900000000	13	009	Baldwin County, GA	2017	NA	17561	16538	1023	5.8
CN1301100000000	13	011	Banks County, GA	2017	NA	9256	8898	358	3.9
CN1301300000000	13	013	Barrow County, GA	2017	NA	39123	37548	1575	4
CN1301500000000	13	015	Bartow County, GA	2017	NA	49463	47201	2262	4.6
CN1301700000000	13	017	Ben Hill County, GA	2017	NA	5457	5036	421	7.7
CN1301900000000	13	019	Berrien County, GA	2017	NA	7375	7000	375	5.1
CN1302100000000	13	021	Bibb County, GA	2017	NA	69412	65754	3658	5.3
CN1302300000000	13	023	Bleckley County, GA	2017	NA	4572	4267	305	6.7
CN1302500000000	13	025	Brantley County, GA	2017	NA	7289	6876	413	5.7
CN1302700000000	13	027	Brooks County, GA	2017	NA	7030	6715	315	4.5
CN1302900000000	13	029	Bryan County, GA	2017	NA	17573	16841	732	4.2
CN1303100000000	13	031	Bulloch County, GA	2017	NA	36595	34764	1831	5
CN1303300000000	13	033	Burke County, GA	2017	NA	9316	8657	659	7.1
CN1303500000000	13	035	Butts County, GA	2017	NA	10597	10092	505	4.8
CN1303700000000	13	037	Calhoun County, GA	2017	NA	2243	2126	117	5.2
CN1303900000000	13	039	Camden County, GA	2017	NA	20810	19762	1048	5
CN1304300000000	13	043	Candler County, GA	2017	NA	5218	5006	212	4.1
CN1304500000000	13	045	Carroll County, GA	2017	NA	54782	52048	2734	5
CN1304700000000	13	047	Catoosa County, GA	2017	NA	32789	31445	1344	4.1
CN1304900000000	13	049	Charlton County, GA	2017	NA	4850	4608	242	5
CN1305100000000	13	051	Chatham County, GA	2017	NA	138565	132390	6175	4.5
CN1305300000000	13	053	Chattahoochee County, GA	2017	NA	1984	1850	134	6.8
CN1305500000000	13	055	Chattooga County, GA	2017	NA	10535	10042	493	4.7
CN1305700000000	13	057	Cherokee County, GA	2017	NA	130797	125939	4858	3.7
CN1305900000000	13	059	Clarke County, GA	2017	NA	60792	57928	2864	4.7
CN1306100000000	13	061	Clay County, GA	2017	NA	866	788	78	9
CN1306300000000	13	063	Clayton County, GA	2017	NA	134864	127048	7816	5.8
CN1306500000000	13	065	Clinch County, GA	2017	NA	2769	2618	151	5.5
CN1306700000000	13	067	Cobb County, GA	2017	NA	420122	403070	17052	4.1
CN1306900000000	13	069	Coffee County, GA	2017	NA	18415	17484	931	5.1
CN1307100000000	13	071	Colquitt County, GA	2017	NA	22032	21046	986	4.5
CN1307300000000	13	073	Columbia County, GA	2017	NA	74104	71074	3030	4.1
CN1307500000000	13	075	Cook County, GA	2017	NA	7699	7353	346	4.5
CN1307700000000	13	077	Coweta County, GA	2017	NA	72498	69481	3017	4.2
CN1307900000000	13	079	Crawford County, GA	2017	NA	5720	5440	280	4.9
CN1308100000000	13	081	Crisp County, GA	2017	NA	9382	8898	484	5.2
CN1308300000000	13	083	Dade County, GA	2017	NA	8190	7835	355	4.3
CN1308500000000	13	085	Dawson County, GA	2017	NA	11855	11399	456	3.8
CN1308700000000	13	087	Decatur County, GA	2017	NA	11635	10994	641	5.5
CN1308900000000	13	089	DeKalb County, GA	2017	NA	394399	375592	18807	4.8
CN1309100000000	13	091	Dodge County, GA	2017	NA	7117	6675	442	6.2
CN1309300000000	13	093	Dooly County, GA	2017	NA	5076	4821	255	5
CN1309500000000	13	095	Dougherty County, GA	2017	NA	38827	36503	2324	6
CN1309700000000	13	097	Douglas County, GA	2017	NA	71904	68410	3494	4.9
CN1309900000000	13	099	Early County, GA	2017	NA	4523	4279	244	5.4
CN1310100000000	13	101	Echols County, GA	2017	NA	1901	1827	74	3.9
CN1310300000000	13	103	Effingham County, GA	2017	NA	29406	28225	1181	4
CN1310500000000	13	105	Elbert County, GA	2017	NA	7844	7435	409	5.2
CN1310700000000	13	107	Emanuel County, GA	2017	NA	8576	8006	570	6.6
CN1310900000000	13	109	Evans County, GA	2017	NA	4881	4669	212	4.3
CN1311100000000	13	111	Fannin County, GA	2017	NA	10960	10439	521	4.8
CN1311300000000	13	113	Fayette County, GA	2017	NA	56870	54570	2300	4
CN1311500000000	13	115	Floyd County, GA	2017	NA	44121	41842	2279	5.2
CN1311700000000	13	117	Forsyth County, GA	2017	NA	116234	111910	4324	3.7
CN1311900000000	13	119	Franklin County, GA	2017	NA	10058	9582	476	4.7
CN1312100000000	13	121	Fulton County, GA	2017	NA	547741	521497	26244	4.8
CN1312300000000	13	123	Gilmer County, GA	2017	NA	11984	11384	600	5
CN1312500000000	13	125	Glascock County, GA	2017	NA	1297	1233	64	4.9
CN1312700000000	13	127	Glynn County, GA	2017	NA	39732	37868	1864	4.7
CN1312900000000	13	129	Gordon County, GA	2017	NA	26616	25396	1220	4.6
CN1313100000000	13	131	Grady County, GA	2017	NA	10726	10207	519	4.8
CN1313300000000	13	133	Greene County, GA	2017	NA	6816	6467	349	5.1
CN1313500000000	13	135	Gwinnett County, GA	2017	NA	481154	460937	20217	4.2
CN1313700000000	13	137	Habersham County, GA	2017	NA	19265	18393	872	4.5
CN1313900000000	13	139	Hall County, GA	2017	NA	100178	96297	3881	3.9
CN1314100000000	13	141	Hancock County, GA	2017	NA	2524	2346	178	7.1
CN1314300000000	13	143	Haralson County, GA	2017	NA	12360	11772	588	4.8
CN1314500000000	13	145	Harris County, GA	2017	NA	16614	15928	686	4.1
CN1314700000000	13	147	Hart County, GA	2017	NA	11228	10733	495	4.4
CN1314900000000	13	149	Heard County, GA	2017	NA	5157	4902	255	4.9
CN1315100000000	13	151	Henry County, GA	2017	NA	112194	106788	5406	4.8
CN1315300000000	13	153	Houston County, GA	2017	NA	69043	65803	3240	4.7
CN1315500000000	13	155	Irwin County, GA	2017	NA	3274	3047	227	6.9
CN1315700000000	13	157	Jackson County, GA	2017	NA	35227	33943	1284	3.6
CN1315900000000	13	159	Jasper County, GA	2017	NA	6842	6549	293	4.3
CN1316100000000	13	161	Jeff Davis County, GA	2017	NA	6117	5750	367	6
CN1316300000000	13	163	Jefferson County, GA	2017	NA	6732	6319	413	6.1
CN1316500000000	13	165	Jenkins County, GA	2017	NA	3159	2947	212	6.7
CN1316700000000	13	167	Johnson County, GA	2017	NA	4092	3886	206	5
CN1316900000000	13	169	Jones County, GA	2017	NA	13909	13311	598	4.3
CN1317100000000	13	171	Lamar County, GA	2017	NA	8031	7585	446	5.6
CN1317300000000	13	173	Lanier County, GA	2017	NA	3838	3644	194	5.1
CN1317500000000	13	175	Laurens County, GA	2017	NA	19240	18116	1124	5.8
CN1317700000000	13	177	Lee County, GA	2017	NA	15016	14397	619	4.1
CN1317900000000	13	179	Liberty County, GA	2017	NA	25450	24148	1302	5.1
CN1318100000000	13	181	Lincoln County, GA	2017	NA	3562	3377	185	5.2
CN1318300000000	13	183	Long County, GA	2017	NA	7959	7577	382	4.8
CN1318500000000	13	185	Lowndes County, GA	2017	NA	51590	49208	2382	4.6
CN1318700000000	13	187	Lumpkin County, GA	2017	NA	16701	16015	686	4.1
CN1318900000000	13	189	McDuffie County, GA	2017	NA	8877	8326	551	6.2
CN1319100000000	13	191	McIntosh County, GA	2017	NA	6125	5817	308	5
CN1319300000000	13	193	Macon County, GA	2017	NA	4708	4383	325	6.9
CN1319500000000	13	195	Madison County, GA	2017	NA	13535	12960	575	4.2
CN1319700000000	13	197	Marion County, GA	2017	NA	3418	3214	204	6
CN1319900000000	13	199	Meriwether County, GA	2017	NA	8845	8326	519	5.9
CN1320100000000	13	201	Miller County, GA	2017	NA	2815	2691	124	4.4
CN1320500000000	13	205	Mitchell County, GA	2017	NA	8478	7952	526	6.2
CN1320700000000	13	207	Monroe County, GA	2017	NA	13081	12501	580	4.4
CN1320900000000	13	209	Montgomery County, GA	2017	NA	3756	3510	246	6.5
CN1321100000000	13	211	Morgan County, GA	2017	NA	8971	8571	400	4.5
CN1321300000000	13	213	Murray County, GA	2017	NA	15827	14858	969	6.1
CN1321500000000	13	215	Muscogee County, GA	2017	NA	78847	74199	4648	5.9
CN1321700000000	13	217	Newton County, GA	2017	NA	51125	48427	2698	5.3
CN1321900000000	13	219	Oconee County, GA	2017	NA	19432	18750	682	3.5
CN1322100000000	13	221	Oglethorpe County, GA	2017	NA	7041	6739	302	4.3
CN1322300000000	13	223	Paulding County, GA	2017	NA	82651	79259	3392	4.1
CN1322500000000	13	225	Peach County, GA	2017	NA	11736	11053	683	5.8
CN1322700000000	13	227	Pickens County, GA	2017	NA	14948	14314	634	4.2
CN1322900000000	13	229	Pierce County, GA	2017	NA	8774	8379	395	4.5
CN1323100000000	13	231	Pike County, GA	2017	NA	8644	8261	383	4.4
CN1323300000000	13	233	Polk County, GA	2017	NA	18445	17487	958	5.2
CN1323500000000	13	235	Pulaski County, GA	2017	NA	4084	3871	213	5.2
CN1323700000000	13	237	Putnam County, GA	2017	NA	8156	7688	468	5.7
CN1323900000000	13	239	Quitman County, GA	2017	NA	832	783	49	5.9
CN1324100000000	13	241	Rabun County, GA	2017	NA	6892	6555	337	4.9
CN1324300000000	13	243	Randolph County, GA	2017	NA	2510	2348	162	6.5
CN1324500000000	13	245	Richmond County, GA	2017	NA	85796	80713	5083	5.9
CN1324700000000	13	247	Rockdale County, GA	2017	NA	44319	41991	2328	5.3
CN1324900000000	13	249	Schley County, GA	2017	NA	2207	2087	120	5.4
CN1325100000000	13	251	Screven County, GA	2017	NA	5258	4931	327	6.2
CN1325300000000	13	253	Seminole County, GA	2017	NA	3079	2883	196	6.4
CN1325500000000	13	255	Spalding County, GA	2017	NA	28269	26635	1634	5.8
CN1325700000000	13	257	Stephens County, GA	2017	NA	11008	10438	570	5.2
CN1325900000000	13	259	Stewart County, GA	2017	NA	2277	2142	135	5.9
CN1326100000000	13	261	Sumter County, GA	2017	NA	12874	12006	868	6.7
CN1326300000000	13	263	Talbot County, GA	2017	NA	2789	2619	170	6.1
CN1326500000000	13	265	Taliaferro County, GA	2017	NA	574	536	38	6.6
CN1326700000000	13	267	Tattnall County, GA	2017	NA	9575	9105	470	4.9
CN1326900000000	13	269	Taylor County, GA	2017	NA	2813	2570	243	8.6
CN1327100000000	13	271	Telfair County, GA	2017	NA	4774	4403	371	7.8
CN1327300000000	13	273	Terrell County, GA	2017	NA	3659	3441	218	6
CN1327500000000	13	275	Thomas County, GA	2017	NA	17178	16188	990	5.8
CN1327700000000	13	277	Tift County, GA	2017	NA	19092	18208	884	4.6
CN1327900000000	13	279	Toombs County, GA	2017	NA	11792	11027	765	6.5
CN1328100000000	13	281	Towns County, GA	2017	NA	3756	3511	245	6.5
CN1328300000000	13	283	Treutlen County, GA	2017	NA	2728	2546	182	6.7
CN1328500000000	13	285	Troup County, GA	2017	NA	37293	35663	1630	4.4
CN1328700000000	13	287	Turner County, GA	2017	NA	3268	3086	182	5.6
CN1328900000000	13	289	Twiggs County, GA	2017	NA	2962	2740	222	7.5
CN1329100000000	13	291	Union County, GA	2017	NA	10134	9680	454	4.5
CN1329300000000	13	293	Upson County, GA	2017	NA	11253	10642	611	5.4
CN1329500000000	13	295	Walker County, GA	2017	NA	30808	29427	1381	4.5
CN1329700000000	13	297	Walton County, GA	2017	NA	44646	42728	1918	4.3
CN1329900000000	13	299	Ware County, GA	2017	NA	15794	15083	711	4.5
CN1330100000000	13	301	Warren County, GA	2017	NA	2718	2560	158	5.8
CN1330300000000	13	303	Washington County, GA	2017	NA	7352	6922	430	5.8
CN1330500000000	13	305	Wayne County, GA	2017	NA	11333	10691	642	5.7
CN1330700000000	13	307	Webster County, GA	2017	NA	991	917	74	7.5
CN1330900000000	13	309	Wheeler County, GA	2017	NA	1735	1581	154	8.9
CN1331100000000	13	311	White County, GA	2017	NA	15672	15072	600	3.8
CN1331300000000	13	313	Whitfield County, GA	2017	NA	44842	42417	2425	5.4
CN1331500000000	13	315	Wilcox County, GA	2017	NA	2760	2601	159	5.8
CN1331700000000	13	317	Wilkes County, GA	2017	NA	3807	3594	213	5.6
CN1331900000000	13	319	Wilkinson County, GA	2017	NA	3802	3589	213	5.6
CN1332100000000	13	321	Worth County, GA	2017	NA	9249	8803	446	4.8
CN1500100000000	15	001	Hawaii County, HI	2017	NA	93566	90923	2643	2.8
CN1500300000000	15	003	Honolulu County/city, HI	2017	NA	464734	453882	10852	2.3
CN1500700000000	15	007	Kauai County, HI	2017	NA	37202	36317	885	2.4
CN1500900000000	15	009	Maui County, HI	2017	NA	88298	86033	2265	2.6
CN1600100000000	16	001	Ada County, ID	2017	NA	234405	227785	6620	2.8
CN1600300000000	16	003	Adams County, ID	2017	NA	1748	1647	101	5.8
CN1600500000000	16	005	Bannock County, ID	2017	NA	41490	40216	1274	3.1
CN1600700000000	16	007	Bear Lake County, ID	2017	NA	2830	2739	91	3.2
CN1600900000000	16	009	Benewah County, ID	2017	NA	4007	3781	226	5.6
CN1601100000000	16	011	Bingham County, ID	2017	NA	23025	22337	688	3
CN1601300000000	16	013	Blaine County, ID	2017	NA	12224	11908	316	2.6
CN1601500000000	16	015	Boise County, ID	2017	NA	3204	3050	154	4.8
CN1601700000000	16	017	Bonner County, ID	2017	NA	19255	18380	875	4.5
CN1601900000000	16	019	Bonneville County, ID	2017	NA	53538	52089	1449	2.7
CN1602100000000	16	021	Boundary County, ID	2017	NA	5150	4903	247	4.8
CN1602300000000	16	023	Butte County, ID	2017	NA	1332	1292	40	3
CN1602500000000	16	025	Camas County, ID	2017	NA	682	663	19	2.8
CN1602700000000	16	027	Canyon County, ID	2017	NA	96538	93030	3508	3.6
CN1602900000000	16	029	Caribou County, ID	2017	NA	3863	3741	122	3.2
CN1603100000000	16	031	Cassia County, ID	2017	NA	11718	11424	294	2.5
CN1603300000000	16	033	Clark County, ID	2017	NA	398	387	11	2.8
CN1603500000000	16	035	Clearwater County, ID	2017	NA	3006	2795	211	7
CN1603700000000	16	037	Custer County, ID	2017	NA	2158	2066	92	4.3
CN1603900000000	16	039	Elmore County, ID	2017	NA	11185	10774	411	3.7
CN1604100000000	16	041	Franklin County, ID	2017	NA	6751	6595	156	2.3
CN1604300000000	16	043	Fremont County, ID	2017	NA	7613	7410	203	2.7
CN1604500000000	16	045	Gem County, ID	2017	NA	7867	7552	315	4
CN1604700000000	16	047	Gooding County, ID	2017	NA	8021	7822	199	2.5
CN1604900000000	16	049	Idaho County, ID	2017	NA	6310	5996	314	5
CN1605100000000	16	051	Jefferson County, ID	2017	NA	13075	12742	333	2.5
CN1605300000000	16	053	Jerome County, ID	2017	NA	11637	11308	329	2.8
CN1605500000000	16	055	Kootenai County, ID	2017	NA	75707	72754	2953	3.9
CN1605700000000	16	057	Latah County, ID	2017	NA	20044	19509	535	2.7
CN1605900000000	16	059	Lemhi County, ID	2017	NA	3477	3295	182	5.2
CN1606100000000	16	061	Lewis County, ID	2017	NA	1614	1519	95	5.9
CN1606300000000	16	063	Lincoln County, ID	2017	NA	2702	2614	88	3.3
CN1606500000000	16	065	Madison County, ID	2017	NA	21172	20771	401	1.9
CN1606700000000	16	067	Minidoka County, ID	2017	NA	10988	10693	295	2.7
CN1606900000000	16	069	Nez Perce County, ID	2017	NA	21158	20552	606	2.9
CN1607100000000	16	071	Oneida County, ID	2017	NA	2255	2190	65	2.9
CN1607300000000	16	073	Owyhee County, ID	2017	NA	5304	5093	211	4
CN1607500000000	16	075	Payette County, ID	2017	NA	11484	11026	458	4
CN1607700000000	16	077	Power County, ID	2017	NA	3955	3819	136	3.4
CN1607900000000	16	079	Shoshone County, ID	2017	NA	5036	4716	320	6.4
CN1608100000000	16	081	Teton County, ID	2017	NA	6130	5973	157	2.6
CN1608300000000	16	083	Twin Falls County, ID	2017	NA	40114	38898	1216	3
CN1608500000000	16	085	Valley County, ID	2017	NA	5141	4912	229	4.5
CN1608700000000	16	087	Washington County, ID	2017	NA	4602	4385	217	4.7
CN1700100000000	17	001	Adams County, IL	2017	NA	32393	31129	1264	3.9
CN1700300000000	17	003	Alexander County, IL	2017	NA	2131	1954	177	8.3
CN1700500000000	17	005	Bond County, IL	2017	NA	7921	7570	351	4.4
CN1700700000000	17	007	Boone County, IL	2017	NA	26172	24412	1760	6.7
CN1700900000000	17	009	Brown County, IL	2017	NA	2861	2779	82	2.9
CN1701100000000	17	011	Bureau County, IL	2017	NA	17399	16544	855	4.9
CN1701300000000	17	013	Calhoun County, IL	2017	NA	2338	2210	128	5.5
CN1701500000000	17	015	Carroll County, IL	2017	NA	7622	7268	354	4.6
CN1701700000000	17	017	Cass County, IL	2017	NA	6155	5875	280	4.5
CN1701900000000	17	019	Champaign County, IL	2017	NA	106845	102259	4586	4.3
CN1702100000000	17	021	Christian County, IL	2017	NA	14782	13995	787	5.3
CN1702300000000	17	023	Clark County, IL	2017	NA	7880	7494	386	4.9
CN1702500000000	17	025	Clay County, IL	2017	NA	6649	6293	356	5.4
CN1702700000000	17	027	Clinton County, IL	2017	NA	20307	19583	724	3.6
CN1702900000000	17	029	Coles County, IL	2017	NA	24556	23404	1152	4.7
CN1703100000000	17	031	Cook County, IL	2017	NA	2632107	2497953	134154	5.1
CN1703300000000	17	033	Crawford County, IL	2017	NA	8834	8369	465	5.3
CN1703500000000	17	035	Cumberland County, IL	2017	NA	6127	5882	245	4
CN1703700000000	17	037	DeKalb County, IL	2017	NA	54841	52292	2549	4.6
CN1703900000000	17	039	De Witt County, IL	2017	NA	7697	7333	364	4.7
CN1704100000000	17	041	Douglas County, IL	2017	NA	10244	9823	421	4.1
CN1704300000000	17	043	DuPage County, IL	2017	NA	511412	491133	20279	4
CN1704500000000	17	045	Edgar County, IL	2017	NA	9459	8996	463	4.9
CN1704700000000	17	047	Edwards County, IL	2017	NA	2850	2718	132	4.6
CN1704900000000	17	049	Effingham County, IL	2017	NA	18893	18175	718	3.8
CN1705100000000	17	051	Fayette County, IL	2017	NA	9684	9147	537	5.5
CN1705300000000	17	053	Ford County, IL	2017	NA	6449	6137	312	4.8
CN1705500000000	17	055	Franklin County, IL	2017	NA	16544	15468	1076	6.5
CN1705700000000	17	057	Fulton County, IL	2017	NA	15485	14492	993	6.4
CN1705900000000	17	059	Gallatin County, IL	2017	NA	2467	2324	143	5.8
CN1706100000000	17	061	Greene County, IL	2017	NA	6021	5713	308	5.1
CN1706300000000	17	063	Grundy County, IL	2017	NA	25489	24017	1472	5.8
CN1706500000000	17	065	Hamilton County, IL	2017	NA	4464	4262	202	4.5
CN1706700000000	17	067	Hancock County, IL	2017	NA	8522	8082	440	5.2
CN1706900000000	17	069	Hardin County, IL	2017	NA	1353	1248	105	7.8
CN1707100000000	17	071	Henderson County, IL	2017	NA	3650	3462	188	5.2
CN1707300000000	17	073	Henry County, IL	2017	NA	25002	23718	1284	5.1
CN1707500000000	17	075	Iroquois County, IL	2017	NA	14598	13931	667	4.6
CN1707700000000	17	077	Jackson County, IL	2017	NA	28071	26806	1265	4.5
CN1707900000000	17	079	Jasper County, IL	2017	NA	4489	4263	226	5
CN1708100000000	17	081	Jefferson County, IL	2017	NA	17495	16534	961	5.5
CN1708300000000	17	083	Jersey County, IL	2017	NA	10953	10422	531	4.8
CN1708500000000	17	085	Jo Daviess County, IL	2017	NA	11062	10566	496	4.5
CN1708700000000	17	087	Johnson County, IL	2017	NA	4118	3808	310	7.5
CN1708900000000	17	089	Kane County, IL	2017	NA	269581	256477	13104	4.9
CN1709100000000	17	091	Kankakee County, IL	2017	NA	54826	51810	3016	5.5
CN1709300000000	17	093	Kendall County, IL	2017	NA	68053	65093	2960	4.3
CN1709500000000	17	095	Knox County, IL	2017	NA	22500	21327	1173	5.2
CN1709700000000	17	097	Lake County, IL	2017	NA	372571	355660	16911	4.5
CN1709900000000	17	099	LaSalle County, IL	2017	NA	56199	53039	3160	5.6
CN1710100000000	17	101	Lawrence County, IL	2017	NA	6067	5698	369	6.1
CN1710300000000	17	103	Lee County, IL	2017	NA	17822	17042	780	4.4
CN1710500000000	17	105	Livingston County, IL	2017	NA	16669	15920	749	4.5
CN1710700000000	17	107	Logan County, IL	2017	NA	12867	12272	595	4.6
CN1710900000000	17	109	McDonough County, IL	2017	NA	13527	12845	682	5
CN1711100000000	17	111	McHenry County, IL	2017	NA	166966	159616	7350	4.4
CN1711300000000	17	113	McLean County, IL	2017	NA	89332	85632	3700	4.1
CN1711500000000	17	115	Macon County, IL	2017	NA	49612	46851	2761	5.6
CN1711700000000	17	117	Macoupin County, IL	2017	NA	22985	21856	1129	4.9
CN1711900000000	17	119	Madison County, IL	2017	NA	134108	127724	6384	4.8
CN1712100000000	17	121	Marion County, IL	2017	NA	17686	16755	931	5.3
CN1712300000000	17	123	Marshall County, IL	2017	NA	5457	5162	295	5.4
CN1712500000000	17	125	Mason County, IL	2017	NA	6425	6034	391	6.1
CN1712700000000	17	127	Massac County, IL	2017	NA	5850	5469	381	6.5
CN1712900000000	17	129	Menard County, IL	2017	NA	6541	6265	276	4.2
CN1713100000000	17	131	Mercer County, IL	2017	NA	8070	7655	415	5.1
CN1713300000000	17	133	Monroe County, IL	2017	NA	18478	17854	624	3.4
CN1713500000000	17	135	Montgomery County, IL	2017	NA	11938	11252	686	5.7
CN1713700000000	17	137	Morgan County, IL	2017	NA	16438	15715	723	4.4
CN1713900000000	17	139	Moultrie County, IL	2017	NA	7334	7048	286	3.9
CN1714100000000	17	141	Ogle County, IL	2017	NA	25397	24092	1305	5.1
CN1714300000000	17	143	Peoria County, IL	2017	NA	86200	81123	5077	5.9
CN1714500000000	17	145	Perry County, IL	2017	NA	8403	7898	505	6
CN1714700000000	17	147	Piatt County, IL	2017	NA	8537	8190	347	4.1
CN1714900000000	17	149	Pike County, IL	2017	NA	7291	6962	329	4.5
CN1715100000000	17	151	Pope County, IL	2017	NA	1779	1667	112	6.3
CN1715300000000	17	153	Pulaski County, IL	2017	NA	2125	1956	169	8
CN1715500000000	17	155	Putnam County, IL	2017	NA	3005	2856	149	5
CN1715700000000	17	157	Randolph County, IL	2017	NA	14186	13557	629	4.4
CN1715900000000	17	159	Richland County, IL	2017	NA	7550	7188	362	4.8
CN1716100000000	17	161	Rock Island County, IL	2017	NA	71245	67587	3658	5.1
CN1716300000000	17	163	St. Clair County, IL	2017	NA	126412	120017	6395	5.1
CN1716500000000	17	165	Saline County, IL	2017	NA	9773	9140	633	6.5
CN1716700000000	17	167	Sangamon County, IL	2017	NA	102259	97745	4514	4.4
CN1716900000000	17	169	Schuyler County, IL	2017	NA	3336	3184	152	4.6
CN1717100000000	17	171	Scott County, IL	2017	NA	2456	2327	129	5.3
CN1717300000000	17	173	Shelby County, IL	2017	NA	10416	9953	463	4.4
CN1717500000000	17	175	Stark County, IL	2017	NA	2568	2405	163	6.3
CN1717700000000	17	177	Stephenson County, IL	2017	NA	21660	20642	1018	4.7
CN1717900000000	17	179	Tazewell County, IL	2017	NA	64655	61182	3473	5.4
CN1718100000000	17	181	Union County, IL	2017	NA	7361	6886	475	6.5
CN1718300000000	17	183	Vermilion County, IL	2017	NA	33974	31766	2208	6.5
CN1718500000000	17	185	Wabash County, IL	2017	NA	5633	5350	283	5
CN1718700000000	17	187	Warren County, IL	2017	NA	8661	8297	364	4.2
CN1718900000000	17	189	Washington County, IL	2017	NA	9640	9354	286	3
CN1719100000000	17	191	Wayne County, IL	2017	NA	6954	6523	431	6.2
CN1719300000000	17	193	White County, IL	2017	NA	6679	6354	325	4.9
CN1719500000000	17	195	Whiteside County, IL	2017	NA	28199	26834	1365	4.8
CN1719700000000	17	197	Will County, IL	2017	NA	359836	341728	18108	5
CN1719900000000	17	199	Williamson County, IL	2017	NA	31820	30172	1648	5.2
CN1720100000000	17	201	Winnebago County, IL	2017	NA	139076	130081	8995	6.5
CN1720300000000	17	203	Woodford County, IL	2017	NA	18935	18101	834	4.4
CN1800100000000	18	001	Adams County, IN	2017	NA	17259	16803	456	2.6
CN1800300000000	18	003	Allen County, IN	2017	NA	181214	175114	6100	3.4
CN1800500000000	18	005	Bartholomew County, IN	2017	NA	44510	43280	1230	2.8
CN1800700000000	18	007	Benton County, IN	2017	NA	4497	4342	155	3.4
CN1800900000000	18	009	Blackford County, IN	2017	NA	5341	5124	217	4.1
CN1801100000000	18	011	Boone County, IN	2017	NA	35397	34381	1016	2.9
CN1801300000000	18	013	Brown County, IN	2017	NA	7557	7297	260	3.4
CN1801500000000	18	015	Carroll County, IN	2017	NA	10074	9725	349	3.5
CN1801700000000	18	017	Cass County, IN	2017	NA	17894	17204	690	3.9
CN1801900000000	18	019	Clark County, IN	2017	NA	60899	58750	2149	3.5
CN1802100000000	18	021	Clay County, IN	2017	NA	12287	11825	462	3.8
CN1802300000000	18	023	Clinton County, IN	2017	NA	16979	16452	527	3.1
CN1802500000000	18	025	Crawford County, IN	2017	NA	4948	4726	222	4.5
CN1802700000000	18	027	Daviess County, IN	2017	NA	15944	15493	451	2.8
CN1802900000000	18	029	Dearborn County, IN	2017	NA	25762	24757	1005	3.9
CN1803100000000	18	031	Decatur County, IN	2017	NA	14700	14266	434	3
CN1803300000000	18	033	DeKalb County, IN	2017	NA	22268	21610	658	3
CN1803500000000	18	035	Delaware County, IN	2017	NA	54377	52034	2343	4.3
CN1803700000000	18	037	Dubois County, IN	2017	NA	23202	22596	606	2.6
CN1803900000000	18	039	Elkhart County, IN	2017	NA	112354	109475	2879	2.6
CN1804100000000	18	041	Fayette County, IN	2017	NA	9081	8620	461	5.1
CN1804300000000	18	043	Floyd County, IN	2017	NA	40895	39517	1378	3.4
CN1804500000000	18	045	Fountain County, IN	2017	NA	7913	7594	319	4
CN1804700000000	18	047	Franklin County, IN	2017	NA	11220	10811	409	3.6
CN1804900000000	18	049	Fulton County, IN	2017	NA	9768	9424	344	3.5
CN1805100000000	18	051	Gibson County, IN	2017	NA	19111	18543	568	3
CN1805300000000	18	053	Grant County, IN	2017	NA	31859	30608	1251	3.9
CN1805500000000	18	055	Greene County, IN	2017	NA	13611	12960	651	4.8
CN1805700000000	18	057	Hamilton County, IN	2017	NA	178349	173395	4954	2.8
CN1805900000000	18	059	Hancock County, IN	2017	NA	39147	37953	1194	3.1
CN1806100000000	18	061	Harrison County, IN	2017	NA	19927	19227	700	3.5
CN1806300000000	18	063	Hendricks County, IN	2017	NA	87212	84659	2553	2.9
CN1806500000000	18	065	Henry County, IN	2017	NA	22183	21363	820	3.7
CN1806700000000	18	067	Howard County, IN	2017	NA	37983	36519	1464	3.9
CN1806900000000	18	069	Huntington County, IN	2017	NA	18407	17743	664	3.6
CN1807100000000	18	071	Jackson County, IN	2017	NA	22453	21776	677	3
CN1807300000000	18	073	Jasper County, IN	2017	NA	16402	15687	715	4.4
CN1807500000000	18	075	Jay County, IN	2017	NA	9789	9440	349	3.6
CN1807700000000	18	077	Jefferson County, IN	2017	NA	15078	14513	565	3.7
CN1807900000000	18	079	Jennings County, IN	2017	NA	13247	12738	509	3.8
CN1808100000000	18	081	Johnson County, IN	2017	NA	80948	78529	2419	3
CN1808300000000	18	083	Knox County, IN	2017	NA	18631	17987	644	3.5
CN1808500000000	18	085	Kosciusko County, IN	2017	NA	41576	40430	1146	2.8
CN1808700000000	18	087	LaGrange County, IN	2017	NA	19988	19473	515	2.6
CN1808900000000	18	089	Lake County, IN	2017	NA	230191	218323	11868	5.2
CN1809100000000	18	091	LaPorte County, IN	2017	NA	47827	45672	2155	4.5
CN1809300000000	18	093	Lawrence County, IN	2017	NA	20825	19901	924	4.4
CN1809500000000	18	095	Madison County, IN	2017	NA	58574	56219	2355	4
CN1809700000000	18	097	Marion County, IN	2017	NA	483607	465932	17675	3.7
CN1809900000000	18	099	Marshall County, IN	2017	NA	23681	22948	733	3.1
CN1810100000000	18	101	Martin County, IN	2017	NA	5137	4982	155	3
CN1810300000000	18	103	Miami County, IN	2017	NA	15867	15239	628	4
CN1810500000000	18	105	Monroe County, IN	2017	NA	68512	65998	2514	3.7
CN1810700000000	18	107	Montgomery County, IN	2017	NA	18993	18407	586	3.1
CN1810900000000	18	109	Morgan County, IN	2017	NA	35875	34600	1275	3.6
CN1811100000000	18	111	Newton County, IN	2017	NA	7075	6733	342	4.8
CN1811300000000	18	113	Noble County, IN	2017	NA	23134	22414	720	3.1
CN1811500000000	18	115	Ohio County, IN	2017	NA	3153	3037	116	3.7
CN1811700000000	18	117	Orange County, IN	2017	NA	8718	8369	349	4
CN1811900000000	18	119	Owen County, IN	2017	NA	9194	8790	404	4.4
CN1812100000000	18	121	Parke County, IN	2017	NA	7192	6901	291	4
CN1812300000000	18	123	Perry County, IN	2017	NA	9267	8909	358	3.9
CN1812500000000	18	125	Pike County, IN	2017	NA	6450	6233	217	3.4
CN1812700000000	18	127	Porter County, IN	2017	NA	85992	82467	3525	4.1
CN1812900000000	18	129	Posey County, IN	2017	NA	13537	13127	410	3
CN1813100000000	18	131	Pulaski County, IN	2017	NA	6382	6158	224	3.5
CN1813300000000	18	133	Putnam County, IN	2017	NA	16599	15990	609	3.7
CN1813500000000	18	135	Randolph County, IN	2017	NA	11738	11245	493	4.2
CN1813700000000	18	137	Ripley County, IN	2017	NA	14070	13567	503	3.6
CN1813900000000	18	139	Rush County, IN	2017	NA	8933	8658	275	3.1
CN1814100000000	18	141	St. Joseph County, IN	2017	NA	134644	129779	4865	3.6
CN1814300000000	18	143	Scott County, IN	2017	NA	10469	10068	401	3.8
CN1814500000000	18	145	Shelby County, IN	2017	NA	22890	22120	770	3.4
CN1814700000000	18	147	Spencer County, IN	2017	NA	10921	10552	369	3.4
CN1814900000000	18	149	Starke County, IN	2017	NA	10458	9993	465	4.4
CN1815100000000	18	151	Steuben County, IN	2017	NA	19963	19376	587	2.9
CN1815300000000	18	153	Sullivan County, IN	2017	NA	8582	8198	384	4.5
CN1815500000000	18	155	Switzerland County, IN	2017	NA	4999	4797	202	4
CN1815700000000	18	157	Tippecanoe County, IN	2017	NA	95611	92504	3107	3.2
CN1815900000000	18	159	Tipton County, IN	2017	NA	8546	8283	263	3.1
CN1816100000000	18	161	Union County, IN	2017	NA	3611	3498	113	3.1
CN1816300000000	18	163	Vanderburgh County, IN	2017	NA	93726	90656	3070	3.3
CN1816500000000	18	165	Vermillion County, IN	2017	NA	7148	6759	389	5.4
CN1816700000000	18	167	Vigo County, IN	2017	NA	48974	46891	2083	4.3
CN1816900000000	18	169	Wabash County, IN	2017	NA	15134	14601	533	3.5
CN1817100000000	18	171	Warren County, IN	2017	NA	4092	3953	139	3.4
CN1817300000000	18	173	Warrick County, IN	2017	NA	32670	31634	1036	3.2
CN1817500000000	18	175	Washington County, IN	2017	NA	13633	13122	511	3.7
CN1817700000000	18	177	Wayne County, IN	2017	NA	30854	29686	1168	3.8
CN1817900000000	18	179	Wells County, IN	2017	NA	14120	13698	422	3
CN1818100000000	18	181	White County, IN	2017	NA	13351	12909	442	3.3
CN1818300000000	18	183	Whitley County, IN	2017	NA	17284	16772	512	3
CN1900100000000	19	001	Adair County, IA	2017	NA	4113	3998	115	2.8
CN1900300000000	19	003	Adams County, IA	2017	NA	2121	2071	50	2.4
CN1900500000000	19	005	Allamakee County, IA	2017	NA	7477	7177	300	4
CN1900700000000	19	007	Appanoose County, IA	2017	NA	6003	5775	228	3.8
CN1900900000000	19	009	Audubon County, IA	2017	NA	3140	3043	97	3.1
CN1901100000000	19	011	Benton County, IA	2017	NA	13287	12849	438	3.3
CN1901300000000	19	013	Black Hawk County, IA	2017	NA	68063	65496	2567	3.8
CN1901500000000	19	015	Boone County, IA	2017	NA	14756	14393	363	2.5
CN1901700000000	19	017	Bremer County, IA	2017	NA	13708	13323	385	2.8
CN1901900000000	19	019	Buchanan County, IA	2017	NA	11041	10687	354	3.2
CN1902100000000	19	021	Buena Vista County, IA	2017	NA	11487	11187	300	2.6
CN1902300000000	19	023	Butler County, IA	2017	NA	7818	7536	282	3.6
CN1902500000000	19	025	Calhoun County, IA	2017	NA	4270	4139	131	3.1
CN1902700000000	19	027	Carroll County, IA	2017	NA	10974	10721	253	2.3
CN1902900000000	19	029	Cass County, IA	2017	NA	7092	6836	256	3.6
CN1903100000000	19	031	Cedar County, IA	2017	NA	10738	10425	313	2.9
CN1903300000000	19	033	Cerro Gordo County, IA	2017	NA	23107	22396	711	3.1
CN1903500000000	19	035	Cherokee County, IA	2017	NA	6015	5863	152	2.5
CN1903700000000	19	037	Chickasaw County, IA	2017	NA	6338	6135	203	3.2
CN1903900000000	19	039	Clarke County, IA	2017	NA	4761	4612	149	3.1
CN1904100000000	19	041	Clay County, IA	2017	NA	8520	8200	320	3.8
CN1904300000000	19	043	Clayton County, IA	2017	NA	10128	9726	402	4
CN1904500000000	19	045	Clinton County, IA	2017	NA	23060	22118	942	4.1
CN1904700000000	19	047	Crawford County, IA	2017	NA	8211	7873	338	4.1
CN1904900000000	19	049	Dallas County, IA	2017	NA	46671	45671	1000	2.1
CN1905100000000	19	051	Davis County, IA	2017	NA	4242	4100	142	3.3
CN1905300000000	19	053	Decatur County, IA	2017	NA	4255	4142	113	2.7
CN1905500000000	19	055	Delaware County, IA	2017	NA	10447	10168	279	2.7
CN1905700000000	19	057	Des Moines County, IA	2017	NA	19545	18717	828	4.2
CN1905900000000	19	059	Dickinson County, IA	2017	NA	10051	9681	370	3.7
CN1906100000000	19	061	Dubuque County, IA	2017	NA	54245	52619	1626	3
CN1906300000000	19	063	Emmet County, IA	2017	NA	5375	5203	172	3.2
CN1906500000000	19	065	Fayette County, IA	2017	NA	10432	10050	382	3.7
CN1906700000000	19	067	Floyd County, IA	2017	NA	8731	8449	282	3.2
CN1906900000000	19	069	Franklin County, IA	2017	NA	5753	5595	158	2.7
CN1907100000000	19	071	Fremont County, IA	2017	NA	3791	3691	100	2.6
CN1907300000000	19	073	Greene County, IA	2017	NA	5400	5251	149	2.8
CN1907500000000	19	075	Grundy County, IA	2017	NA	6501	6311	190	2.9
CN1907700000000	19	077	Guthrie County, IA	2017	NA	5531	5352	179	3.2
CN1907900000000	19	079	Hamilton County, IA	2017	NA	7025	6797	228	3.2
CN1908100000000	19	081	Hancock County, IA	2017	NA	6099	5940	159	2.6
CN1908300000000	19	083	Hardin County, IA	2017	NA	8396	8126	270	3.2
CN1908500000000	19	085	Harrison County, IA	2017	NA	7266	7065	201	2.8
CN1908700000000	19	087	Henry County, IA	2017	NA	9621	9332	289	3
CN1908900000000	19	089	Howard County, IA	2017	NA	5071	4917	154	3
CN1909100000000	19	091	Humboldt County, IA	2017	NA	5233	5073	160	3.1
CN1909300000000	19	093	Ida County, IA	2017	NA	4003	3909	94	2.3
CN1909500000000	19	095	Iowa County, IA	2017	NA	10379	10106	273	2.6
CN1909700000000	19	097	Jackson County, IA	2017	NA	10828	10459	369	3.4
CN1909900000000	19	099	Jasper County, IA	2017	NA	19191	18588	603	3.1
CN1910100000000	19	101	Jefferson County, IA	2017	NA	9098	8816	282	3.1
CN1910300000000	19	103	Johnson County, IA	2017	NA	84952	82832	2120	2.5
CN1910500000000	19	105	Jones County, IA	2017	NA	10464	10080	384	3.7
CN1910700000000	19	107	Keokuk County, IA	2017	NA	5168	4982	186	3.6
CN1910900000000	19	109	Kossuth County, IA	2017	NA	8696	8489	207	2.4
CN1911100000000	19	111	Lee County, IA	2017	NA	16130	15248	882	5.5
CN1911300000000	19	113	Linn County, IA	2017	NA	118183	114206	3977	3.4
CN1911500000000	19	115	Louisa County, IA	2017	NA	6040	5841	199	3.3
CN1911700000000	19	117	Lucas County, IA	2017	NA	4343	4220	123	2.8
CN1911900000000	19	119	Lyon County, IA	2017	NA	6957	6835	122	1.8
CN1912100000000	19	121	Madison County, IA	2017	NA	8254	7955	299	3.6
CN1912300000000	19	123	Mahaska County, IA	2017	NA	11560	11187	373	3.2
CN1912500000000	19	125	Marion County, IA	2017	NA	17275	16818	457	2.6
CN1912700000000	19	127	Marshall County, IA	2017	NA	18126	17291	835	4.6
CN1912900000000	19	129	Mills County, IA	2017	NA	7274	7072	202	2.8
CN1913100000000	19	131	Mitchell County, IA	2017	NA	5742	5619	123	2.1
CN1913300000000	19	133	Monona County, IA	2017	NA	4492	4328	164	3.7
CN1913500000000	19	135	Monroe County, IA	2017	NA	3873	3725	148	3.8
CN1913700000000	19	137	Montgomery County, IA	2017	NA	4927	4771	156	3.2
CN1913900000000	19	139	Muscatine County, IA	2017	NA	21757	21039	718	3.3
CN1914100000000	19	141	O'Brien County, IA	2017	NA	7983	7790	193	2.4
CN1914300000000	19	143	Osceola County, IA	2017	NA	3572	3497	75	2.1
CN1914500000000	19	145	Page County, IA	2017	NA	6317	6069	248	3.9
CN1914700000000	19	147	Palo Alto County, IA	2017	NA	4868	4737	131	2.7
CN1914900000000	19	149	Plymouth County, IA	2017	NA	14597	14247	350	2.4
CN1915100000000	19	151	Pocahontas County, IA	2017	NA	4151	4051	100	2.4
CN1915300000000	19	153	Polk County, IA	2017	NA	258774	250800	7974	3.1
CN1915500000000	19	155	Pottawattamie County, IA	2017	NA	47306	45977	1329	2.8
CN1915700000000	19	157	Poweshiek County, IA	2017	NA	10363	10037	326	3.1
CN1915900000000	19	159	Ringgold County, IA	2017	NA	2536	2458	78	3.1
CN1916100000000	19	161	Sac County, IA	2017	NA	5313	5162	151	2.8
CN1916300000000	19	163	Scott County, IA	2017	NA	85963	82814	3149	3.7
CN1916500000000	19	165	Shelby County, IA	2017	NA	6645	6485	160	2.4
CN1916700000000	19	167	Sioux County, IA	2017	NA	20246	19837	409	2
CN1916900000000	19	169	Story County, IA	2017	NA	57045	55906	1139	2
CN1917100000000	19	171	Tama County, IA	2017	NA	9536	9204	332	3.5
CN1917300000000	19	173	Taylor County, IA	2017	NA	3219	3147	72	2.2
CN1917500000000	19	175	Union County, IA	2017	NA	6395	6196	199	3.1
CN1917700000000	19	177	Van Buren County, IA	2017	NA	3702	3588	114	3.1
CN1917900000000	19	179	Wapello County, IA	2017	NA	17547	16747	800	4.6
CN1918100000000	19	181	Warren County, IA	2017	NA	27050	26301	749	2.8
CN1918300000000	19	183	Washington County, IA	2017	NA	12168	11809	359	3
CN1918500000000	19	185	Wayne County, IA	2017	NA	2761	2676	85	3.1
CN1918700000000	19	187	Webster County, IA	2017	NA	19269	18545	724	3.8
CN1918900000000	19	189	Winnebago County, IA	2017	NA	5135	4972	163	3.2
CN1919100000000	19	191	Winneshiek County, IA	2017	NA	11780	11417	363	3.1
CN1919300000000	19	193	Woodbury County, IA	2017	NA	54129	52403	1726	3.2
CN1919500000000	19	195	Worth County, IA	2017	NA	4182	4055	127	3
CN1919700000000	19	197	Wright County, IA	2017	NA	6495	6271	224	3.4
CN2000100000000	20	001	Allen County, KS	2017	NA	6271	5966	305	4.9
CN2000300000000	20	003	Anderson County, KS	2017	NA	4144	3981	163	3.9
CN2000500000000	20	005	Atchison County, KS	2017	NA	7017	6651	366	5.2
CN2000700000000	20	007	Barber County, KS	2017	NA	2442	2373	69	2.8
CN2000900000000	20	009	Barton County, KS	2017	NA	14016	13508	508	3.6
CN2001100000000	20	011	Bourbon County, KS	2017	NA	7003	6693	310	4.4
CN2001300000000	20	013	Brown County, KS	2017	NA	5316	5145	171	3.2
CN2001500000000	20	015	Butler County, KS	2017	NA	31613	30418	1195	3.8
CN2001700000000	20	017	Chase County, KS	2017	NA	1423	1386	37	2.6
CN2001900000000	20	019	Chautauqua County, KS	2017	NA	1441	1373	68	4.7
CN2002100000000	20	021	Cherokee County, KS	2017	NA	10085	9690	395	3.9
CN2002300000000	20	023	Cheyenne County, KS	2017	NA	1310	1276	34	2.6
CN2002500000000	20	025	Clark County, KS	2017	NA	1082	1055	27	2.5
CN2002700000000	20	027	Clay County, KS	2017	NA	3802	3660	142	3.7
CN2002900000000	20	029	Cloud County, KS	2017	NA	3876	3709	167	4.3
CN2003100000000	20	031	Coffey County, KS	2017	NA	4102	3886	216	5.3
CN2003300000000	20	033	Comanche County, KS	2017	NA	903	877	26	2.9
CN2003500000000	20	035	Cowley County, KS	2017	NA	16901	16257	644	3.8
CN2003700000000	20	037	Crawford County, KS	2017	NA	19046	18244	802	4.2
CN2003900000000	20	039	Decatur County, KS	2017	NA	1276	1236	40	3.1
CN2004100000000	20	041	Dickinson County, KS	2017	NA	9235	8882	353	3.8
CN2004300000000	20	043	Doniphan County, KS	2017	NA	4182	4036	146	3.5
CN2004500000000	20	045	Douglas County, KS	2017	NA	65070	62984	2086	3.2
CN2004700000000	20	047	Edwards County, KS	2017	NA	1508	1461	47	3.1
CN2004900000000	20	049	Elk County, KS	2017	NA	1183	1133	50	4.2
CN2005100000000	20	051	Ellis County, KS	2017	NA	16921	16495	426	2.5
CN2005300000000	20	053	Ellsworth County, KS	2017	NA	2705	2622	83	3.1
CN2005500000000	20	055	Finney County, KS	2017	NA	20032	19481	551	2.8
CN2005700000000	20	057	Ford County, KS	2017	NA	17753	17249	504	2.8
CN2005900000000	20	059	Franklin County, KS	2017	NA	14124	13596	528	3.7
CN2006100000000	20	061	Geary County, KS	2017	NA	11454	10886	568	5
CN2006300000000	20	063	Gove County, KS	2017	NA	1419	1386	33	2.3
CN2006500000000	20	065	Graham County, KS	2017	NA	1110	1070	40	3.6
CN2006700000000	20	067	Grant County, KS	2017	NA	3456	3345	111	3.2
CN2006900000000	20	069	Gray County, KS	2017	NA	3394	3326	68	2
CN2007100000000	20	071	Greeley County, KS	2017	NA	867	851	16	1.8
CN2007300000000	20	073	Greenwood County, KS	2017	NA	3205	3069	136	4.2
CN2007500000000	20	075	Hamilton County, KS	2017	NA	1626	1587	39	2.4
CN2007700000000	20	077	Harper County, KS	2017	NA	2635	2537	98	3.7
CN2007900000000	20	079	Harvey County, KS	2017	NA	16788	16100	688	4.1
CN2008100000000	20	081	Haskell County, KS	2017	NA	2221	2171	50	2.3
CN2008300000000	20	083	Hodgeman County, KS	2017	NA	984	959	25	2.5
CN2008500000000	20	085	Jackson County, KS	2017	NA	7196	6970	226	3.1
CN2008700000000	20	087	Jefferson County, KS	2017	NA	10153	9792	361	3.6
CN2008900000000	20	089	Jewell County, KS	2017	NA	1298	1253	45	3.5
CN2009100000000	20	091	Johnson County, KS	2017	NA	332693	322568	10125	3
CN2009300000000	20	093	Kearny County, KS	2017	NA	2054	2003	51	2.5
CN2009500000000	20	095	Kingman County, KS	2017	NA	3378	3253	125	3.7
CN2009700000000	20	097	Kiowa County, KS	2017	NA	1340	1306	34	2.5
CN2009900000000	20	099	Labette County, KS	2017	NA	10302	9835	467	4.5
CN2010100000000	20	101	Lane County, KS	2017	NA	782	756	26	3.3
CN2010300000000	20	103	Leavenworth County, KS	2017	NA	36155	34734	1421	3.9
CN2010500000000	20	105	Lincoln County, KS	2017	NA	1678	1630	48	2.9
CN2010700000000	20	107	Linn County, KS	2017	NA	4391	4132	259	5.9
CN2010900000000	20	109	Logan County, KS	2017	NA	1667	1631	36	2.2
CN2011100000000	20	111	Lyon County, KS	2017	NA	16725	16090	635	3.8
CN2011300000000	20	113	McPherson County, KS	2017	NA	16244	15795	449	2.8
CN2011500000000	20	115	Marion County, KS	2017	NA	6238	6012	226	3.6
CN2011700000000	20	117	Marshall County, KS	2017	NA	5459	5306	153	2.8
CN2011900000000	20	119	Meade County, KS	2017	NA	2268	2212	56	2.5
CN2012100000000	20	121	Miami County, KS	2017	NA	17261	16613	648	3.8
CN2012300000000	20	123	Mitchell County, KS	2017	NA	3431	3337	94	2.7
CN2012500000000	20	125	Montgomery County, KS	2017	NA	14923	14138	785	5.3
CN2012700000000	20	127	Morris County, KS	2017	NA	2983	2889	94	3.2
CN2012900000000	20	129	Morton County, KS	2017	NA	1193	1148	45	3.8
CN2013100000000	20	131	Nemaha County, KS	2017	NA	5550	5416	134	2.4
CN2013300000000	20	133	Neosho County, KS	2017	NA	6022	5704	318	5.3
CN2013500000000	20	135	Ness County, KS	2017	NA	1352	1313	39	2.9
CN2013700000000	20	137	Norton County, KS	2017	NA	2801	2738	63	2.2
CN2013900000000	20	139	Osage County, KS	2017	NA	7924	7609	315	4
CN2014100000000	20	141	Osborne County, KS	2017	NA	2005	1950	55	2.7
CN2014300000000	20	143	Ottawa County, KS	2017	NA	3043	2949	94	3.1
CN2014500000000	20	145	Pawnee County, KS	2017	NA	3017	2916	101	3.3
CN2014700000000	20	147	Phillips County, KS	2017	NA	2798	2715	83	3
CN2014900000000	20	149	Pottawatomie County, KS	2017	NA	12150	11774	376	3.1
CN2015100000000	20	151	Pratt County, KS	2017	NA	4931	4770	161	3.3
CN2015300000000	20	153	Rawlins County, KS	2017	NA	1449	1417	32	2.2
CN2015500000000	20	155	Reno County, KS	2017	NA	29913	28749	1164	3.9
CN2015700000000	20	157	Republic County, KS	2017	NA	2446	2377	69	2.8
CN2015900000000	20	159	Rice County, KS	2017	NA	5371	5198	173	3.2
CN2016100000000	20	161	Riley County, KS	2017	NA	35002	33931	1071	3.1
CN2016300000000	20	163	Rooks County, KS	2017	NA	2484	2389	95	3.8
CN2016500000000	20	165	Rush County, KS	2017	NA	1644	1591	53	3.2
CN2016700000000	20	167	Russell County, KS	2017	NA	3491	3374	117	3.4
CN2016900000000	20	169	Saline County, KS	2017	NA	30489	29508	981	3.2
CN2017100000000	20	171	Scott County, KS	2017	NA	2838	2776	62	2.2
CN2017300000000	20	173	Sedgwick County, KS	2017	NA	244473	234077	10396	4.3
CN2017500000000	20	175	Seward County, KS	2017	NA	9788	9445	343	3.5
CN2017700000000	20	177	Shawnee County, KS	2017	NA	90931	87588	3343	3.7
CN2017900000000	20	179	Sheridan County, KS	2017	NA	1366	1335	31	2.3
CN2018100000000	20	181	Sherman County, KS	2017	NA	2883	2799	84	2.9
CN2018300000000	20	183	Smith County, KS	2017	NA	1962	1907	55	2.8
CN2018500000000	20	185	Stafford County, KS	2017	NA	1994	1928	66	3.3
CN2018700000000	20	187	Stanton County, KS	2017	NA	995	967	28	2.8
CN2018900000000	20	189	Stevens County, KS	2017	NA	2659	2574	85	3.2
CN2019100000000	20	191	Sumner County, KS	2017	NA	10667	10259	408	3.8
CN2019300000000	20	193	Thomas County, KS	2017	NA	4236	4127	109	2.6
CN2019500000000	20	195	Trego County, KS	2017	NA	1430	1382	48	3.4
CN2019700000000	20	197	Wabaunsee County, KS	2017	NA	3628	3512	116	3.2
CN2019900000000	20	199	Wallace County, KS	2017	NA	847	825	22	2.6
CN2020100000000	20	201	Washington County, KS	2017	NA	2942	2854	88	3
CN2020300000000	20	203	Wichita County, KS	2017	NA	1166	1137	29	2.5
CN2020500000000	20	205	Wilson County, KS	2017	NA	3975	3787	188	4.7
CN2020700000000	20	207	Woodson County, KS	2017	NA	1584	1514	70	4.4
CN2020900000000	20	209	Wyandotte County, KS	2017	NA	77120	73086	4034	5.2
CN2100100000000	21	001	Adair County, KY	2017	NA	7170	6735	435	6.1
CN2100300000000	21	003	Allen County, KY	2017	NA	8977	8606	371	4.1
CN2100500000000	21	005	Anderson County, KY	2017	NA	11834	11350	484	4.1
CN2100700000000	21	007	Ballard County, KY	2017	NA	3636	3357	279	7.7
CN2100900000000	21	009	Barren County, KY	2017	NA	19009	18128	881	4.6
CN2101100000000	21	011	Bath County, KY	2017	NA	4724	4349	375	7.9
CN2101300000000	21	013	Bell County, KY	2017	NA	8666	7978	688	7.9
CN2101500000000	21	015	Boone County, KY	2017	NA	69859	67153	2706	3.9
CN2101700000000	21	017	Bourbon County, KY	2017	NA	9887	9432	455	4.6
CN2101900000000	21	019	Boyd County, KY	2017	NA	18308	16990	1318	7.2
CN2102100000000	21	021	Boyle County, KY	2017	NA	12611	11970	641	5.1
CN2102300000000	21	023	Bracken County, KY	2017	NA	3833	3609	224	5.8
CN2102500000000	21	025	Breathitt County, KY	2017	NA	3745	3415	330	8.8
CN2102700000000	21	027	Breckinridge County, KY	2017	NA	8019	7537	482	6
CN2102900000000	21	029	Bullitt County, KY	2017	NA	41829	40053	1776	4.2
CN2103100000000	21	031	Butler County, KY	2017	NA	5187	4900	287	5.5
CN2103300000000	21	033	Caldwell County, KY	2017	NA	5339	5055	284	5.3
CN2103500000000	21	035	Calloway County, KY	2017	NA	18792	17961	831	4.4
CN2103700000000	21	037	Campbell County, KY	2017	NA	49860	47972	1888	3.8
CN2103900000000	21	039	Carlisle County, KY	2017	NA	2386	2220	166	7
CN2104100000000	21	041	Carroll County, KY	2017	NA	5004	4771	233	4.7
CN2104300000000	21	043	Carter County, KY	2017	NA	9922	8942	980	9.9
CN2104500000000	21	045	Casey County, KY	2017	NA	6684	6359	325	4.9
CN2104700000000	21	047	Christian County, KY	2017	NA	24477	22967	1510	6.2
CN2104900000000	21	049	Clark County, KY	2017	NA	17281	16477	804	4.7
CN2105100000000	21	051	Clay County, KY	2017	NA	5361	4887	474	8.8
CN2105300000000	21	053	Clinton County, KY	2017	NA	3862	3608	254	6.6
CN2105500000000	21	055	Crittenden County, KY	2017	NA	3982	3762	220	5.5
CN2105700000000	21	057	Cumberland County, KY	2017	NA	2940	2783	157	5.3
CN2105900000000	21	059	Daviess County, KY	2017	NA	47934	45832	2102	4.4
CN2106100000000	21	061	Edmonson County, KY	2017	NA	4862	4568	294	6
CN2106300000000	21	063	Elliott County, KY	2017	NA	2117	1891	226	10.7
CN2106500000000	21	065	Estill County, KY	2017	NA	5350	5028	322	6
CN2106700000000	21	067	Fayette County, KY	2017	NA	175315	168917	6398	3.6
CN2106900000000	21	069	Fleming County, KY	2017	NA	6064	5693	371	6.1
CN2107100000000	21	071	Floyd County, KY	2017	NA	11280	10335	945	8.4
CN2107300000000	21	073	Franklin County, KY	2017	NA	24772	23752	1020	4.1
CN2107500000000	21	075	Fulton County, KY	2017	NA	2067	1917	150	7.3
CN2107700000000	21	077	Gallatin County, KY	2017	NA	4038	3854	184	4.6
CN2107900000000	21	079	Garrard County, KY	2017	NA	7657	7283	374	4.9
CN2108100000000	21	081	Grant County, KY	2017	NA	11606	11037	569	4.9
CN2108300000000	21	083	Graves County, KY	2017	NA	15683	14741	942	6
CN2108500000000	21	085	Grayson County, KY	2017	NA	10895	10228	667	6.1
CN2108700000000	21	087	Green County, KY	2017	NA	5149	4909	240	4.7
CN2108900000000	21	089	Greenup County, KY	2017	NA	13600	12550	1050	7.7
CN2109100000000	21	091	Hancock County, KY	2017	NA	4104	3896	208	5.1
CN2109300000000	21	093	Hardin County, KY	2017	NA	48741	46498	2243	4.6
CN2109500000000	21	095	Harlan County, KY	2017	NA	6481	5833	648	10
CN2109700000000	21	097	Harrison County, KY	2017	NA	8686	8283	403	4.6
CN2109900000000	21	099	Hart County, KY	2017	NA	8099	7738	361	4.5
CN2110100000000	21	101	Henderson County, KY	2017	NA	21971	20967	1004	4.6
CN2110300000000	21	103	Henry County, KY	2017	NA	8133	7798	335	4.1
CN2110500000000	21	105	Hickman County, KY	2017	NA	1820	1683	137	7.5
CN2110700000000	21	107	Hopkins County, KY	2017	NA	19474	18499	975	5
CN2110900000000	21	109	Jackson County, KY	2017	NA	4103	3755	348	8.5
CN2111100000000	21	111	Jefferson County, KY	2017	NA	396486	378941	17545	4.4
CN2111300000000	21	113	Jessamine County, KY	2017	NA	26421	25415	1006	3.8
CN2111500000000	21	115	Johnson County, KY	2017	NA	6922	6323	599	8.7
CN2111700000000	21	117	Kenton County, KY	2017	NA	86597	83143	3454	4
CN2111900000000	21	119	Knott County, KY	2017	NA	4505	4120	385	8.5
CN2112100000000	21	121	Knox County, KY	2017	NA	10065	9297	768	7.6
CN2112300000000	21	123	Larue County, KY	2017	NA	6019	5733	286	4.8
CN2112500000000	21	125	Laurel County, KY	2017	NA	24665	23211	1454	5.9
CN2112700000000	21	127	Lawrence County, KY	2017	NA	5006	4550	456	9.1
CN2112900000000	21	129	Lee County, KY	2017	NA	1897	1735	162	8.5
CN2113100000000	21	131	Leslie County, KY	2017	NA	2736	2459	277	10.1
CN2113300000000	21	133	Letcher County, KY	2017	NA	6298	5706	592	9.4
CN2113500000000	21	135	Lewis County, KY	2017	NA	4707	4270	437	9.3
CN2113700000000	21	137	Lincoln County, KY	2017	NA	9375	8842	533	5.7
CN2113900000000	21	139	Livingston County, KY	2017	NA	3758	3473	285	7.6
CN2114100000000	21	141	Logan County, KY	2017	NA	12162	11625	537	4.4
CN2114300000000	21	143	Lyon County, KY	2017	NA	2993	2818	175	5.8
CN2114500000000	21	145	McCracken County, KY	2017	NA	29670	27864	1806	6.1
CN2114700000000	21	147	McCreary County, KY	2017	NA	4693	4368	325	6.9
CN2114900000000	21	149	McLean County, KY	2017	NA	4301	4070	231	5.4
CN2115100000000	21	151	Madison County, KY	2017	NA	46168	44181	1987	4.3
CN2115300000000	21	153	Magoffin County, KY	2017	NA	2994	2505	489	16.3
CN2115500000000	21	155	Marion County, KY	2017	NA	9461	9065	396	4.2
CN2115700000000	21	157	Marshall County, KY	2017	NA	15038	14139	899	6
CN2115900000000	21	159	Martin County, KY	2017	NA	3076	2840	236	7.7
CN2116100000000	21	161	Mason County, KY	2017	NA	7225	6772	453	6.3
CN2116300000000	21	163	Meade County, KY	2017	NA	12234	11600	634	5.2
CN2116500000000	21	165	Menifee County, KY	2017	NA	2368	2161	207	8.7
CN2116700000000	21	167	Mercer County, KY	2017	NA	9978	9485	493	4.9
CN2116900000000	21	169	Metcalfe County, KY	2017	NA	4180	4008	172	4.1
CN2117100000000	21	171	Monroe County, KY	2017	NA	4727	4541	186	3.9
CN2117300000000	21	173	Montgomery County, KY	2017	NA	11734	10954	780	6.6
CN2117500000000	21	175	Morgan County, KY	2017	NA	4510	4175	335	7.4
CN2117700000000	21	177	Muhlenberg County, KY	2017	NA	11248	10465	783	7
CN2117900000000	21	179	Nelson County, KY	2017	NA	22280	21292	988	4.4
CN2118100000000	21	181	Nicholas County, KY	2017	NA	3315	3129	186	5.6
CN2118300000000	21	183	Ohio County, KY	2017	NA	9790	9166	624	6.4
CN2118500000000	21	185	Oldham County, KY	2017	NA	32919	31761	1158	3.5
CN2118700000000	21	187	Owen County, KY	2017	NA	5451	5210	241	4.4
CN2118900000000	21	189	Owsley County, KY	2017	NA	1100	1008	92	8.4
CN2119100000000	21	191	Pendleton County, KY	2017	NA	6985	6654	331	4.7
CN2119300000000	21	193	Perry County, KY	2017	NA	8407	7706	701	8.3
CN2119500000000	21	195	Pike County, KY	2017	NA	20364	18777	1587	7.8
CN2119700000000	21	197	Powell County, KY	2017	NA	5028	4692	336	6.7
CN2119900000000	21	199	Pulaski County, KY	2017	NA	25392	23957	1435	5.7
CN2120100000000	21	201	Robertson County, KY	2017	NA	818	767	51	6.2
CN2120300000000	21	203	Rockcastle County, KY	2017	NA	6626	6239	387	5.8
CN2120500000000	21	205	Rowan County, KY	2017	NA	10657	10036	621	5.8
CN2120700000000	21	207	Russell County, KY	2017	NA	6260	5811	449	7.2
CN2120900000000	21	209	Scott County, KY	2017	NA	28711	27653	1058	3.7
CN2121100000000	21	211	Shelby County, KY	2017	NA	24702	23808	894	3.6
CN2121300000000	21	213	Simpson County, KY	2017	NA	8731	8331	400	4.6
CN2121500000000	21	215	Spencer County, KY	2017	NA	9948	9565	383	3.9
CN2121700000000	21	217	Taylor County, KY	2017	NA	12871	12306	565	4.4
CN2121900000000	21	219	Todd County, KY	2017	NA	5326	5101	225	4.2
CN2122100000000	21	221	Trigg County, KY	2017	NA	5945	5605	340	5.7
CN2122300000000	21	223	Trimble County, KY	2017	NA	3884	3689	195	5
CN2122500000000	21	225	Union County, KY	2017	NA	6105	5737	368	6
CN2122700000000	21	227	Warren County, KY	2017	NA	64010	61403	2607	4.1
CN2122900000000	21	229	Washington County, KY	2017	NA	6179	5919	260	4.2
CN2123100000000	21	231	Wayne County, KY	2017	NA	7411	6833	578	7.8
CN2123300000000	21	233	Webster County, KY	2017	NA	5808	5504	304	5.2
CN2123500000000	21	235	Whitley County, KY	2017	NA	13764	12966	798	5.8
CN2123700000000	21	237	Wolfe County, KY	2017	NA	1927	1750	177	9.2
CN2123900000000	21	239	Woodford County, KY	2017	NA	14963	14474	489	3.3
CN2200100000000	22	001	Acadia Parish, LA	2017	NA	24008	22590	1418	5.9
CN2200300000000	22	003	Allen Parish, LA	2017	NA	8966	8494	472	5.3
CN2200500000000	22	005	Ascension Parish, LA	2017	NA	62727	60050	2677	4.3
CN2200700000000	22	007	Assumption Parish, LA	2017	NA	8932	8276	656	7.3
CN2200900000000	22	009	Avoyelles Parish, LA	2017	NA	15600	14644	956	6.1
CN2201100000000	22	011	Beauregard Parish, LA	2017	NA	14654	13871	783	5.3
CN2201300000000	22	013	Bienville Parish, LA	2017	NA	5628	5291	337	6
CN2201500000000	22	015	Bossier Parish, LA	2017	NA	57569	55002	2567	4.5
CN2201700000000	22	017	Caddo Parish, LA	2017	NA	104766	98703	6063	5.8
CN2201900000000	22	019	Calcasieu Parish, LA	2017	NA	108343	104053	4290	4
CN2202100000000	22	021	Caldwell Parish, LA	2017	NA	3855	3635	220	5.7
CN2202300000000	22	023	Cameron Parish, LA	2017	NA	4002	3858	144	3.6
CN2202500000000	22	025	Catahoula Parish, LA	2017	NA	3431	3189	242	7.1
CN2202700000000	22	027	Claiborne Parish, LA	2017	NA	5853	5540	313	5.3
CN2202900000000	22	029	Concordia Parish, LA	2017	NA	7147	6586	561	7.8
CN2203100000000	22	031	De Soto Parish, LA	2017	NA	10773	10120	653	6.1
CN2203300000000	22	033	East Baton Rouge Parish, LA	2017	NA	231574	221405	10169	4.4
CN2203500000000	22	035	East Carroll Parish, LA	2017	NA	2053	1825	228	11.1
CN2203700000000	22	037	East Feliciana Parish, LA	2017	NA	7971	7589	382	4.8
CN2203900000000	22	039	Evangeline Parish, LA	2017	NA	12529	11789	740	5.9
CN2204100000000	22	041	Franklin Parish, LA	2017	NA	7300	6755	545	7.5
CN2204300000000	22	043	Grant Parish, LA	2017	NA	8177	7662	515	6.3
CN2204500000000	22	045	Iberia Parish, LA	2017	NA	28915	26803	2112	7.3
CN2204700000000	22	047	Iberville Parish, LA	2017	NA	14143	13272	871	6.2
CN2204900000000	22	049	Jackson Parish, LA	2017	NA	6978	6662	316	4.5
CN2205100000000	22	051	Jefferson Parish, LA	2017	NA	214803	205071	9732	4.5
CN2205300000000	22	053	Jefferson Davis Parish, LA	2017	NA	13609	12946	663	4.9
CN2205500000000	22	055	Lafayette Parish, LA	2017	NA	113004	107484	5520	4.9
CN2205700000000	22	057	Lafourche Parish, LA	2017	NA	41890	39713	2177	5.2
CN2205900000000	22	059	LaSalle Parish, LA	2017	NA	6137	5849	288	4.7
CN2206100000000	22	061	Lincoln Parish, LA	2017	NA	21542	20428	1114	5.2
CN2206300000000	22	063	Livingston Parish, LA	2017	NA	67654	64801	2853	4.2
CN2206500000000	22	065	Madison Parish, LA	2017	NA	3776	3470	306	8.1
CN2206700000000	22	067	Morehouse Parish, LA	2017	NA	10351	9526	825	8
CN2206900000000	22	069	Natchitoches Parish, LA	2017	NA	16327	15351	976	6
CN2207100000000	22	071	Orleans Parish, LA	2017	NA	178474	169295	9179	5.1
CN2207300000000	22	073	Ouachita Parish, LA	2017	NA	70556	66848	3708	5.3
CN2207500000000	22	075	Plaquemines Parish, LA	2017	NA	10002	9536	466	4.7
CN2207700000000	22	077	Pointe Coupee Parish, LA	2017	NA	9989	9431	558	5.6
CN2207900000000	22	079	Rapides Parish, LA	2017	NA	56029	52885	3144	5.6
CN2208100000000	22	081	Red River Parish, LA	2017	NA	3855	3655	200	5.2
CN2208300000000	22	083	Richland Parish, LA	2017	NA	8307	7798	509	6.1
CN2208500000000	22	085	Sabine Parish, LA	2017	NA	8819	8334	485	5.5
CN2208700000000	22	087	St. Bernard Parish, LA	2017	NA	19498	18477	1021	5.2
CN2208900000000	22	089	St. Charles Parish, LA	2017	NA	24880	23760	1120	4.5
CN2209100000000	22	091	St. Helena Parish, LA	2017	NA	4312	4026	286	6.6
CN2209300000000	22	093	St. James Parish, LA	2017	NA	9372	8749	623	6.6
CN2209500000000	22	095	St. John the Baptist Parish, LA	2017	NA	19697	18487	1210	6.1
CN2209700000000	22	097	St. Landry Parish, LA	2017	NA	32031	29894	2137	6.7
CN2209900000000	22	099	St. Martin Parish, LA	2017	NA	22515	21148	1367	6.1
CN2210100000000	22	101	St. Mary Parish, LA	2017	NA	20345	18745	1600	7.9
CN2210300000000	22	103	St. Tammany Parish, LA	2017	NA	117309	112291	5018	4.3
CN2210500000000	22	105	Tangipahoa Parish, LA	2017	NA	54760	51638	3122	5.7
CN2210700000000	22	107	Tensas Parish, LA	2017	NA	1550	1419	131	8.5
CN2210900000000	22	109	Terrebonne Parish, LA	2017	NA	46701	44045	2656	5.7
CN2211100000000	22	111	Union Parish, LA	2017	NA	9191	8681	510	5.5
CN2211300000000	22	113	Vermilion Parish, LA	2017	NA	24200	22750	1450	6
CN2211500000000	22	115	Vernon Parish, LA	2017	NA	16354	15290	1064	6.5
CN2211700000000	22	117	Washington Parish, LA	2017	NA	16910	15934	976	5.8
CN2211900000000	22	119	Webster Parish, LA	2017	NA	14747	13736	1011	6.9
CN2212100000000	22	121	West Baton Rouge Parish, LA	2017	NA	13474	12856	618	4.6
CN2212300000000	22	123	West Carroll Parish, LA	2017	NA	3995	3604	391	9.8
CN2212500000000	22	125	West Feliciana Parish, LA	2017	NA	5323	5101	222	4.2
CN2212700000000	22	127	Winn Parish, LA	2017	NA	5047	4722	325	6.4
CN2300100000000	23	001	Androscoggin County, ME	2017	NA	55498	53719	1779	3.2
CN2300300000000	23	003	Aroostook County, ME	2017	NA	31496	29946	1550	4.9
CN2300500000000	23	005	Cumberland County, ME	2017	NA	164393	160092	4301	2.6
CN2300700000000	23	007	Franklin County, ME	2017	NA	14430	13832	598	4.1
CN2300900000000	23	009	Hancock County, ME	2017	NA	29297	28147	1150	3.9
CN2301100000000	23	011	Kennebec County, ME	2017	NA	62653	60575	2078	3.3
CN2301300000000	23	013	Knox County, ME	2017	NA	20706	20038	668	3.2
CN2301500000000	23	015	Lincoln County, ME	2017	NA	17034	16470	564	3.3
CN2301700000000	23	017	Oxford County, ME	2017	NA	26808	25770	1038	3.9
CN2301900000000	23	019	Penobscot County, ME	2017	NA	76886	73943	2943	3.8
CN2302100000000	23	021	Piscataquis County, ME	2017	NA	7494	7187	307	4.1
CN2302300000000	23	023	Sagadahoc County, ME	2017	NA	19379	18844	535	2.8
CN2302500000000	23	025	Somerset County, ME	2017	NA	23053	21906	1147	5
CN2302700000000	23	027	Waldo County, ME	2017	NA	21145	20364	781	3.7
CN2302900000000	23	029	Washington County, ME	2017	NA	14039	13330	709	5.1
CN2303100000000	23	031	York County, ME	2017	NA	113240	109842	3398	3
CN2400100000000	24	001	Allegany County, MD	2017	NA	32285	30384	1901	5.9
CN2400300000000	24	003	Anne Arundel County, MD	2017	NA	309762	298524	11238	3.6
CN2400500000000	24	005	Baltimore County, MD	2017	NA	451094	431131	19963	4.4
CN2400900000000	24	009	Calvert County, MD	2017	NA	49408	47580	1828	3.7
CN2401100000000	24	011	Caroline County, MD	2017	NA	17996	17210	786	4.4
CN2401300000000	24	013	Carroll County, MD	2017	NA	94284	91030	3254	3.5
CN2401500000000	24	015	Cecil County, MD	2017	NA	52942	50350	2592	4.9
CN2401700000000	24	017	Charles County, MD	2017	NA	85739	82251	3488	4.1
CN2401900000000	24	019	Dorchester County, MD	2017	NA	15668	14754	914	5.8
CN2402100000000	24	021	Frederick County, MD	2017	NA	130982	126096	4886	3.7
CN2402300000000	24	023	Garrett County, MD	2017	NA	15521	14697	824	5.3
CN2402500000000	24	025	Harford County, MD	2017	NA	138436	132941	5495	4
CN2402700000000	24	027	Howard County, MD	2017	NA	183757	177894	5863	3.2
CN2402900000000	24	029	Kent County, MD	2017	NA	10243	9777	466	4.5
CN2403100000000	24	031	Montgomery County, MD	2017	NA	554246	535516	18730	3.4
CN2403300000000	24	033	Prince George's County, MD	2017	NA	507781	486103	21678	4.3
CN2403500000000	24	035	Queen Anne's County, MD	2017	NA	27390	26367	1023	3.7
CN2403700000000	24	037	St. Mary's County, MD	2017	NA	55146	52904	2242	4.1
CN2403900000000	24	039	Somerset County, MD	2017	NA	9300	8649	651	7
CN2404100000000	24	041	Talbot County, MD	2017	NA	19724	18926	798	4
CN2404300000000	24	043	Washington County, MD	2017	NA	75360	71778	3582	4.8
CN2404500000000	24	045	Wicomico County, MD	2017	NA	50920	47945	2975	5.8
CN2404700000000	24	047	Worcester County, MD	2017	NA	25473	23245	2228	8.7
CN2451000000000	24	510	Baltimore city, MD	2017	NA	291127	272834	18293	6.3
CN2500100000000	25	001	Barnstable County, MA	2017	NA	113143	107842	5301	4.7
CN2500300000000	25	003	Berkshire County, MA	2017	NA	64805	61939	2866	4.4
CN2500500000000	25	005	Bristol County, MA	2017	NA	296135	282014	14121	4.8
CN2500700000000	25	007	Dukes County, MA	2017	NA	9544	9076	468	4.9
CN2500900000000	25	009	Essex County, MA	2017	NA	417879	401927	15952	3.8
CN2501100000000	25	011	Franklin County, MA	2017	NA	40280	38925	1355	3.4
CN2501300000000	25	013	Hampden County, MA	2017	NA	225203	213721	11482	5.1
CN2501500000000	25	015	Hampshire County, MA	2017	NA	89070	85984	3086	3.5
CN2501700000000	25	017	Middlesex County, MA	2017	NA	892592	865126	27466	3.1
CN2501900000000	25	019	Nantucket County/town, MA	2017	NA	7195	6874	321	4.5
CN2502100000000	25	021	Norfolk County, MA	2017	NA	379497	366819	12678	3.3
CN2502300000000	25	023	Plymouth County, MA	2017	NA	275591	264740	10851	3.9
CN2502500000000	25	025	Suffolk County, MA	2017	NA	440368	425335	15033	3.4
CN2502700000000	25	027	Worcester County, MA	2017	NA	438265	421065	17200	3.9
CN2600100000000	26	001	Alcona County, MI	2017	NA	3833	3561	272	7.1
CN2600300000000	26	003	Alger County, MI	2017	NA	3285	3014	271	8.2
CN2600500000000	26	005	Allegan County, MI	2017	NA	61124	58838	2286	3.7
CN2600700000000	26	007	Alpena County, MI	2017	NA	13591	12819	772	5.7
CN2600900000000	26	009	Antrim County, MI	2017	NA	10057	9401	656	6.5
CN2601100000000	26	011	Arenac County, MI	2017	NA	6013	5531	482	8
CN2601300000000	26	013	Baraga County, MI	2017	NA	3173	2929	244	7.7
CN2601500000000	26	015	Barry County, MI	2017	NA	31233	30014	1219	3.9
CN2601700000000	26	017	Bay County, MI	2017	NA	50845	48066	2779	5.5
CN2601900000000	26	019	Benzie County, MI	2017	NA	8829	8259	570	6.5
CN2602100000000	26	021	Berrien County, MI	2017	NA	73938	70391	3547	4.8
CN2602300000000	26	023	Branch County, MI	2017	NA	19208	18333	875	4.6
CN2602500000000	26	025	Calhoun County, MI	2017	NA	63848	60757	3091	4.8
CN2602700000000	26	027	Cass County, MI	2017	NA	24252	23150	1102	4.5
CN2602900000000	26	029	Charlevoix County, MI	2017	NA	13051	12329	722	5.5
CN2603100000000	26	031	Cheboygan County, MI	2017	NA	10789	9718	1071	9.9
CN2603300000000	26	033	Chippewa County, MI	2017	NA	16325	15084	1241	7.6
CN2603500000000	26	035	Clare County, MI	2017	NA	11938	11113	825	6.9
CN2603700000000	26	037	Clinton County, MI	2017	NA	40900	39428	1472	3.6
CN2603900000000	26	039	Crawford County, MI	2017	NA	5407	5035	372	6.9
CN2604100000000	26	041	Delta County, MI	2017	NA	17020	15960	1060	6.2
CN2604300000000	26	043	Dickinson County, MI	2017	NA	12527	11941	586	4.7
CN2604500000000	26	045	Eaton County, MI	2017	NA	57162	54842	2320	4.1
CN2604700000000	26	047	Emmet County, MI	2017	NA	17617	16479	1138	6.5
CN2604900000000	26	049	Genesee County, MI	2017	NA	182159	171986	10173	5.6
CN2605100000000	26	051	Gladwin County, MI	2017	NA	9872	9234	638	6.5
CN2605300000000	26	053	Gogebic County, MI	2017	NA	6304	5931	373	5.9
CN2605500000000	26	055	Grand Traverse County, MI	2017	NA	49242	47194	2048	4.2
CN2605700000000	26	057	Gratiot County, MI	2017	NA	17818	16859	959	5.4
CN2605900000000	26	059	Hillsdale County, MI	2017	NA	20887	19872	1015	4.9
CN2606100000000	26	061	Houghton County, MI	2017	NA	16437	15470	967	5.9
CN2606300000000	26	063	Huron County, MI	2017	NA	15581	14784	797	5.1
CN2606500000000	26	065	Ingham County, MI	2017	NA	150953	144547	6406	4.2
CN2606700000000	26	067	Ionia County, MI	2017	NA	29780	28615	1165	3.9
CN2606900000000	26	069	Iosco County, MI	2017	NA	10114	9376	738	7.3
CN2607100000000	26	071	Iron County, MI	2017	NA	5155	4828	327	6.3
CN2607300000000	26	073	Isabella County, MI	2017	NA	35109	33550	1559	4.4
CN2607500000000	26	075	Jackson County, MI	2017	NA	74225	70836	3389	4.6
CN2607700000000	26	077	Kalamazoo County, MI	2017	NA	132575	127306	5269	4
CN2607900000000	26	079	Kalkaska County, MI	2017	NA	7869	7329	540	6.9
CN2608100000000	26	081	Kent County, MI	2017	NA	355010	342863	12147	3.4
CN2608300000000	26	083	Keweenaw County, MI	2017	NA	899	821	78	8.7
CN2608500000000	26	085	Lake County, MI	2017	NA	3720	3419	301	8.1
CN2608700000000	26	087	Lapeer County, MI	2017	NA	40961	38687	2274	5.6
CN2608900000000	26	089	Leelanau County, MI	2017	NA	10483	9984	499	4.8
CN2609100000000	26	091	Lenawee County, MI	2017	NA	47053	44858	2195	4.7
CN2609300000000	26	093	Livingston County, MI	2017	NA	101753	98273	3480	3.4
CN2609500000000	26	095	Luce County, MI	2017	NA	2409	2246	163	6.8
CN2609700000000	26	097	Mackinac County, MI	2017	NA	5188	4667	521	10
CN2609900000000	26	099	Macomb County, MI	2017	NA	442784	423189	19595	4.4
CN2610100000000	26	101	Manistee County, MI	2017	NA	10403	9732	671	6.5
CN2610300000000	26	103	Marquette County, MI	2017	NA	32847	31032	1815	5.5
CN2610500000000	26	105	Mason County, MI	2017	NA	14008	13211	797	5.7
CN2610700000000	26	107	Mecosta County, MI	2017	NA	18766	17703	1063	5.7
CN2610900000000	26	109	Menominee County, MI	2017	NA	10982	10454	528	4.8
CN2611100000000	26	111	Midland County, MI	2017	NA	40475	38616	1859	4.6
CN2611300000000	26	113	Missaukee County, MI	2017	NA	6908	6507	401	5.8
CN2611500000000	26	115	Monroe County, MI	2017	NA	75940	72370	3570	4.7
CN2611700000000	26	117	Montcalm County, MI	2017	NA	28112	26722	1390	4.9
CN2611900000000	26	119	Montmorency County, MI	2017	NA	3053	2737	316	10.4
CN2612100000000	26	121	Muskegon County, MI	2017	NA	77760	73660	4100	5.3
CN2612300000000	26	123	Newaygo County, MI	2017	NA	23250	22113	1137	4.9
CN2612500000000	26	125	Oakland County, MI	2017	NA	665406	641783	23623	3.6
CN2612700000000	26	127	Oceana County, MI	2017	NA	12199	11342	857	7
CN2612900000000	26	129	Ogemaw County, MI	2017	NA	8164	7543	621	7.6
CN2613100000000	26	131	Ontonagon County, MI	2017	NA	2163	1974	189	8.7
CN2613300000000	26	133	Osceola County, MI	2017	NA	10611	9983	628	5.9
CN2613500000000	26	135	Oscoda County, MI	2017	NA	2908	2696	212	7.3
CN2613700000000	26	137	Otsego County, MI	2017	NA	11639	10947	692	5.9
CN2613900000000	26	139	Ottawa County, MI	2017	NA	157861	152735	5126	3.2
CN2614100000000	26	141	Presque Isle County, MI	2017	NA	5163	4688	475	9.2
CN2614300000000	26	143	Roscommon County, MI	2017	NA	7825	7140	685	8.8
CN2614500000000	26	145	Saginaw County, MI	2017	NA	87634	82954	4680	5.3
CN2614700000000	26	147	St. Clair County, MI	2017	NA	75211	71343	3868	5.1
CN2614900000000	26	149	St. Joseph County, MI	2017	NA	28680	27484	1196	4.2
CN2615100000000	26	151	Sanilac County, MI	2017	NA	19272	18149	1123	5.8
CN2615300000000	26	153	Schoolcraft County, MI	2017	NA	3355	3078	277	8.3
CN2615500000000	26	155	Shiawassee County, MI	2017	NA	33371	31670	1701	5.1
CN2615700000000	26	157	Tuscola County, MI	2017	NA	23925	22452	1473	6.2
CN2615900000000	26	159	Van Buren County, MI	2017	NA	35236	33249	1987	5.6
CN2616100000000	26	161	Washtenaw County, MI	2017	NA	193957	187194	6763	3.5
CN2616300000000	26	163	Wayne County, MI	2017	NA	791967	747804	44163	5.6
CN2616500000000	26	165	Wexford County, MI	2017	NA	14752	13936	816	5.5
CN2700100000000	27	001	Aitkin County, MN	2017	NA	7174	6734	440	6.1
CN2700300000000	27	003	Anoka County, MN	2017	NA	195325	188903	6422	3.3
CN2700500000000	27	005	Becker County, MN	2017	NA	18564	17802	762	4.1
CN2700700000000	27	007	Beltrami County, MN	2017	NA	23654	22518	1136	4.8
CN2700900000000	27	009	Benton County, MN	2017	NA	21736	20869	867	4
CN2701100000000	27	011	Big Stone County, MN	2017	NA	2571	2459	112	4.4
CN2701300000000	27	013	Blue Earth County, MN	2017	NA	40034	38886	1148	2.9
CN2701500000000	27	015	Brown County, MN	2017	NA	14382	13856	526	3.7
CN2701700000000	27	017	Carlton County, MN	2017	NA	17692	16866	826	4.7
CN2701900000000	27	019	Carver County, MN	2017	NA	57430	55780	1650	2.9
CN2702100000000	27	021	Cass County, MN	2017	NA	14343	13503	840	5.9
CN2702300000000	27	023	Chippewa County, MN	2017	NA	6925	6655	270	3.9
CN2702500000000	27	025	Chisago County, MN	2017	NA	29483	28331	1152	3.9
CN2702700000000	27	027	Clay County, MN	2017	NA	35669	34540	1129	3.2
CN2702900000000	27	029	Clearwater County, MN	2017	NA	4599	4201	398	8.7
CN2703100000000	27	031	Cook County, MN	2017	NA	3108	2991	117	3.8
CN2703300000000	27	033	Cottonwood County, MN	2017	NA	5716	5423	293	5.1
CN2703500000000	27	035	Crow Wing County, MN	2017	NA	32209	30796	1413	4.4
CN2703700000000	27	037	Dakota County, MN	2017	NA	238085	230989	7096	3
CN2703900000000	27	039	Dodge County, MN	2017	NA	11702	11313	389	3.3
CN2704100000000	27	041	Douglas County, MN	2017	NA	20534	19891	643	3.1
CN2704300000000	27	043	Faribault County, MN	2017	NA	7139	6846	293	4.1
CN2704500000000	27	045	Fillmore County, MN	2017	NA	11415	11020	395	3.5
CN2704700000000	27	047	Freeborn County, MN	2017	NA	16147	15567	580	3.6
CN2704900000000	27	049	Goodhue County, MN	2017	NA	26854	26001	853	3.2
CN2705100000000	27	051	Grant County, MN	2017	NA	3282	3149	133	4.1
CN2705300000000	27	053	Hennepin County, MN	2017	NA	698627	677806	20821	3
CN2705500000000	27	055	Houston County, MN	2017	NA	10458	10104	354	3.4
CN2705700000000	27	057	Hubbard County, MN	2017	NA	9820	9276	544	5.5
CN2705900000000	27	059	Isanti County, MN	2017	NA	20998	20108	890	4.2
CN2706100000000	27	061	Itasca County, MN	2017	NA	21732	20241	1491	6.9
CN2706300000000	27	063	Jackson County, MN	2017	NA	5757	5551	206	3.6
CN2706500000000	27	065	Kanabec County, MN	2017	NA	9031	8489	542	6
CN2706700000000	27	067	Kandiyohi County, MN	2017	NA	24838	24041	797	3.2
CN2706900000000	27	069	Kittson County, MN	2017	NA	2367	2280	87	3.7
CN2707100000000	27	071	Koochiching County, MN	2017	NA	5970	5553	417	7
CN2707300000000	27	073	Lac qui Parle County, MN	2017	NA	3524	3404	120	3.4
CN2707500000000	27	075	Lake County, MN	2017	NA	5506	5297	209	3.8
CN2707700000000	27	077	Lake of the Woods County, MN	2017	NA	2384	2274	110	4.6
CN2707900000000	27	079	Le Sueur County, MN	2017	NA	15854	15125	729	4.6
CN2708100000000	27	081	Lincoln County, MN	2017	NA	3358	3252	106	3.2
CN2708300000000	27	083	Lyon County, MN	2017	NA	14969	14498	471	3.1
CN2708500000000	27	085	McLeod County, MN	2017	NA	19508	18778	730	3.7
CN2708700000000	27	087	Mahnomen County, MN	2017	NA	2361	2244	117	5
CN2708900000000	27	089	Marshall County, MN	2017	NA	5474	5100	374	6.8
CN2709100000000	27	091	Martin County, MN	2017	NA	10411	10058	353	3.4
CN2709300000000	27	093	Meeker County, MN	2017	NA	13243	12715	528	4
CN2709500000000	27	095	Mille Lacs County, MN	2017	NA	12724	12028	696	5.5
CN2709700000000	27	097	Morrison County, MN	2017	NA	17663	16736	927	5.2
CN2709900000000	27	099	Mower County, MN	2017	NA	20566	19995	571	2.8
CN2710100000000	27	101	Murray County, MN	2017	NA	4885	4673	212	4.3
CN2710300000000	27	103	Nicollet County, MN	2017	NA	20620	20106	514	2.5
CN2710500000000	27	105	Nobles County, MN	2017	NA	11343	10988	355	3.1
CN2710700000000	27	107	Norman County, MN	2017	NA	3396	3239	157	4.6
CN2710900000000	27	109	Olmsted County, MN	2017	NA	86732	84431	2301	2.7
CN2711100000000	27	111	Otter Tail County, MN	2017	NA	31540	30306	1234	3.9
CN2711300000000	27	113	Pennington County, MN	2017	NA	8795	8304	491	5.6
CN2711500000000	27	115	Pine County, MN	2017	NA	14983	14141	842	5.6
CN2711700000000	27	117	Pipestone County, MN	2017	NA	4859	4699	160	3.3
CN2711900000000	27	119	Polk County, MN	2017	NA	16994	16291	703	4.1
CN2712100000000	27	121	Pope County, MN	2017	NA	6360	6168	192	3
CN2712300000000	27	123	Ramsey County, MN	2017	NA	286896	277771	9125	3.2
CN2712500000000	27	125	Red Lake County, MN	2017	NA	2251	2104	147	6.5
CN2712700000000	27	127	Redwood County, MN	2017	NA	7676	7368	308	4
CN2712900000000	27	129	Renville County, MN	2017	NA	8880	8493	387	4.4
CN2713100000000	27	131	Rice County, MN	2017	NA	36535	35393	1142	3.1
CN2713300000000	27	133	Rock County, MN	2017	NA	5875	5754	121	2.1
CN2713500000000	27	135	Roseau County, MN	2017	NA	8141	7749	392	4.8
CN2713700000000	27	137	St. Louis County, MN	2017	NA	102524	97860	4664	4.5
CN2713900000000	27	139	Scott County, MN	2017	NA	82152	79809	2343	2.9
CN2714100000000	27	141	Sherburne County, MN	2017	NA	51370	49480	1890	3.7
CN2714300000000	27	143	Sibley County, MN	2017	NA	8413	8116	297	3.5
CN2714500000000	27	145	Stearns County, MN	2017	NA	90072	87070	3002	3.3
CN2714700000000	27	147	Steele County, MN	2017	NA	20536	19855	681	3.3
CN2714900000000	27	149	Stevens County, MN	2017	NA	5508	5364	144	2.6
CN2715100000000	27	151	Swift County, MN	2017	NA	5049	4845	204	4
CN2715300000000	27	153	Todd County, MN	2017	NA	13500	12976	524	3.9
CN2715500000000	27	155	Traverse County, MN	2017	NA	1772	1710	62	3.5
CN2715700000000	27	157	Wabasha County, MN	2017	NA	12164	11764	400	3.3
CN2715900000000	27	159	Wadena County, MN	2017	NA	5831	5511	320	5.5
CN2716100000000	27	161	Waseca County, MN	2017	NA	9296	8940	356	3.8
CN2716300000000	27	163	Washington County, MN	2017	NA	140943	136786	4157	2.9
CN2716500000000	27	165	Watonwan County, MN	2017	NA	6499	6223	276	4.2
CN2716700000000	27	167	Wilkin County, MN	2017	NA	3553	3444	109	3.1
CN2716900000000	27	169	Winona County, MN	2017	NA	28973	28089	884	3.1
CN2717100000000	27	171	Wright County, MN	2017	NA	74182	71611	2571	3.5
CN2717300000000	27	173	Yellow Medicine County, MN	2017	NA	5353	5170	183	3.4
CN2800100000000	28	001	Adams County, MS	2017	NA	11244	10424	820	7.3
CN2800300000000	28	003	Alcorn County, MS	2017	NA	16063	15353	710	4.4
CN2800500000000	28	005	Amite County, MS	2017	NA	4469	4166	303	6.8
CN2800700000000	28	007	Attala County, MS	2017	NA	6970	6549	421	6
CN2800900000000	28	009	Benton County, MS	2017	NA	3040	2870	170	5.6
CN2801100000000	28	011	Bolivar County, MS	2017	NA	12916	12087	829	6.4
CN2801300000000	28	013	Calhoun County, MS	2017	NA	5640	5376	264	4.7
CN2801500000000	28	015	Carroll County, MS	2017	NA	3540	3333	207	5.8
CN2801700000000	28	017	Chickasaw County, MS	2017	NA	7079	6709	370	5.2
CN2801900000000	28	019	Choctaw County, MS	2017	NA	3623	3443	180	5
CN2802100000000	28	021	Claiborne County, MS	2017	NA	3029	2733	296	9.8
CN2802300000000	28	023	Clarke County, MS	2017	NA	6167	5796	371	6
CN2802500000000	28	025	Clay County, MS	2017	NA	7749	7223	526	6.8
CN2802700000000	28	027	Coahoma County, MS	2017	NA	8632	7989	643	7.4
CN2802900000000	28	029	Copiah County, MS	2017	NA	11268	10626	642	5.7
CN2803100000000	28	031	Covington County, MS	2017	NA	8116	7723	393	4.8
CN2803300000000	28	033	DeSoto County, MS	2017	NA	88831	85421	3410	3.8
CN2803500000000	28	035	Forrest County, MS	2017	NA	33524	31900	1624	4.8
CN2803700000000	28	037	Franklin County, MS	2017	NA	2866	2671	195	6.8
CN2803900000000	28	039	George County, MS	2017	NA	8849	8215	634	7.2
CN2804100000000	28	041	Greene County, MS	2017	NA	4382	4054	328	7.5
CN2804300000000	28	043	Grenada County, MS	2017	NA	9664	9221	443	4.6
CN2804500000000	28	045	Hancock County, MS	2017	NA	18757	17714	1043	5.6
CN2804700000000	28	047	Harrison County, MS	2017	NA	86244	82053	4191	4.9
CN2804900000000	28	049	Hinds County, MS	2017	NA	109419	104106	5313	4.9
CN2805100000000	28	051	Holmes County, MS	2017	NA	5826	5278	548	9.4
CN2805300000000	28	053	Humphreys County, MS	2017	NA	2207	1998	209	9.5
CN2805500000000	28	055	Issaquena County, MS	2017	NA	392	345	47	12
CN2805700000000	28	057	Itawamba County, MS	2017	NA	10534	10092	442	4.2
CN2805900000000	28	059	Jackson County, MS	2017	NA	58609	55136	3473	5.9
CN2806100000000	28	061	Jasper County, MS	2017	NA	6094	5695	399	6.5
CN2806300000000	28	063	Jefferson County, MS	2017	NA	2122	1812	310	14.6
CN2806500000000	28	065	Jefferson Davis County, MS	2017	NA	4243	3954	289	6.8
CN2806700000000	28	067	Jones County, MS	2017	NA	25449	24132	1317	5.2
CN2806900000000	28	069	Kemper County, MS	2017	NA	3600	3320	280	7.8
CN2807100000000	28	071	Lafayette County, MS	2017	NA	27579	26435	1144	4.1
CN2807300000000	28	073	Lamar County, MS	2017	NA	30223	29067	1156	3.8
CN2807500000000	28	075	Lauderdale County, MS	2017	NA	31844	30149	1695	5.3
CN2807700000000	28	077	Lawrence County, MS	2017	NA	4694	4388	306	6.5
CN2807900000000	28	079	Leake County, MS	2017	NA	7604	7168	436	5.7
CN2808100000000	28	081	Lee County, MS	2017	NA	41205	39555	1650	4
CN2808300000000	28	083	Leflore County, MS	2017	NA	10148	9392	756	7.4
CN2808500000000	28	085	Lincoln County, MS	2017	NA	14570	13813	757	5.2
CN2808700000000	28	087	Lowndes County, MS	2017	NA	25338	23979	1359	5.4
CN2808900000000	28	089	Madison County, MS	2017	NA	53314	51244	2070	3.9
CN2809100000000	28	091	Marion County, MS	2017	NA	10217	9655	562	5.5
CN2809300000000	28	093	Marshall County, MS	2017	NA	14405	13661	744	5.2
CN2809500000000	28	095	Monroe County, MS	2017	NA	15603	14799	804	5.2
CN2809700000000	28	097	Montgomery County, MS	2017	NA	4169	3957	212	5.1
CN2809900000000	28	099	Neshoba County, MS	2017	NA	10403	9865	538	5.2
CN2810100000000	28	101	Newton County, MS	2017	NA	8935	8481	454	5.1
CN2810300000000	28	103	Noxubee County, MS	2017	NA	3907	3621	286	7.3
CN2810500000000	28	105	Oktibbeha County, MS	2017	NA	22268	21160	1108	5
CN2810700000000	28	107	Panola County, MS	2017	NA	13080	12200	880	6.7
CN2810900000000	28	109	Pearl River County, MS	2017	NA	23492	22256	1236	5.3
CN2811100000000	28	111	Perry County, MS	2017	NA	4328	4054	274	6.3
CN2811300000000	28	113	Pike County, MS	2017	NA	14492	13611	881	6.1
CN2811500000000	28	115	Pontotoc County, MS	2017	NA	14681	14115	566	3.9
CN2811700000000	28	117	Prentiss County, MS	2017	NA	11224	10713	511	4.6
CN2811900000000	28	119	Quitman County, MS	2017	NA	2433	2216	217	8.9
CN2812100000000	28	121	Rankin County, MS	2017	NA	76182	73456	2726	3.6
CN2812300000000	28	123	Scott County, MS	2017	NA	13051	12512	539	4.1
CN2812500000000	28	125	Sharkey County, MS	2017	NA	1616	1487	129	8
CN2812700000000	28	127	Simpson County, MS	2017	NA	10958	10423	535	4.9
CN2812900000000	28	129	Smith County, MS	2017	NA	6767	6447	320	4.7
CN2813100000000	28	131	Stone County, MS	2017	NA	6583	6180	403	6.1
CN2813300000000	28	133	Sunflower County, MS	2017	NA	7969	7306	663	8.3
CN2813500000000	28	135	Tallahatchie County, MS	2017	NA	5483	5189	294	5.4
CN2813700000000	28	137	Tate County, MS	2017	NA	12117	11502	615	5.1
CN2813900000000	28	139	Tippah County, MS	2017	NA	9479	9056	423	4.5
CN2814100000000	28	141	Tishomingo County, MS	2017	NA	8368	7954	414	4.9
CN2814300000000	28	143	Tunica County, MS	2017	NA	4460	4195	265	5.9
CN2814500000000	28	145	Union County, MS	2017	NA	14006	13501	505	3.6
CN2814700000000	28	147	Walthall County, MS	2017	NA	5069	4727	342	6.7
CN2814900000000	28	149	Warren County, MS	2017	NA	20881	19704	1177	5.6
CN2815100000000	28	151	Washington County, MS	2017	NA	17781	16509	1272	7.2
CN2815300000000	28	153	Wayne County, MS	2017	NA	7400	6930	470	6.4
CN2815500000000	28	155	Webster County, MS	2017	NA	3881	3677	204	5.3
CN2815700000000	28	157	Wilkinson County, MS	2017	NA	2835	2585	250	8.8
CN2815900000000	28	159	Winston County, MS	2017	NA	7228	6792	436	6
CN2816100000000	28	161	Yalobusha County, MS	2017	NA	5084	4808	276	5.4
CN2816300000000	28	163	Yazoo County, MS	2017	NA	9102	8547	555	6.1
CN2900100000000	29	001	Adair County, MO	2017	NA	10495	10049	446	4.2
CN2900300000000	29	003	Andrew County, MO	2017	NA	9814	9502	312	3.2
CN2900500000000	29	005	Atchison County, MO	2017	NA	2857	2758	99	3.5
CN2900700000000	29	007	Audrain County, MO	2017	NA	11100	10716	384	3.5
CN2900900000000	29	009	Barry County, MO	2017	NA	15511	14995	516	3.3
CN2901100000000	29	011	Barton County, MO	2017	NA	5213	4997	216	4.1
CN2901300000000	29	013	Bates County, MO	2017	NA	7988	7634	354	4.4
CN2901500000000	29	015	Benton County, MO	2017	NA	7297	6928	369	5.1
CN2901700000000	29	017	Bollinger County, MO	2017	NA	5507	5266	241	4.4
CN2901900000000	29	019	Boone County, MO	2017	NA	97546	94997	2549	2.6
CN2902100000000	29	021	Buchanan County, MO	2017	NA	45168	43570	1598	3.5
CN2902300000000	29	023	Butler County, MO	2017	NA	18547	17713	834	4.5
CN2902500000000	29	025	Caldwell County, MO	2017	NA	4435	4256	179	4
CN2902700000000	29	027	Callaway County, MO	2017	NA	21476	20731	745	3.5
CN2902900000000	29	029	Camden County, MO	2017	NA	18919	18019	900	4.8
CN2903100000000	29	031	Cape Girardeau County, MO	2017	NA	39910	38531	1379	3.5
CN2903300000000	29	033	Carroll County, MO	2017	NA	4794	4601	193	4
CN2903500000000	29	035	Carter County, MO	2017	NA	2536	2388	148	5.8
CN2903700000000	29	037	Cass County, MO	2017	NA	54292	52392	1900	3.5
CN2903900000000	29	039	Cedar County, MO	2017	NA	5765	5532	233	4
CN2904100000000	29	041	Chariton County, MO	2017	NA	3858	3725	133	3.4
CN2904300000000	29	043	Christian County, MO	2017	NA	43259	41924	1335	3.1
CN2904500000000	29	045	Clark County, MO	2017	NA	3211	3032	179	5.6
CN2904700000000	29	047	Clay County, MO	2017	NA	134965	130101	4864	3.6
CN2904900000000	29	049	Clinton County, MO	2017	NA	10891	10460	431	4
CN2905100000000	29	051	Cole County, MO	2017	NA	38867	37730	1137	2.9
CN2905300000000	29	053	Cooper County, MO	2017	NA	7472	7202	270	3.6
CN2905500000000	29	055	Crawford County, MO	2017	NA	10826	10330	496	4.6
CN2905700000000	29	057	Dade County, MO	2017	NA	3581	3460	121	3.4
CN2905900000000	29	059	Dallas County, MO	2017	NA	6954	6628	326	4.7
CN2906100000000	29	061	Daviess County, MO	2017	NA	4082	3947	135	3.3
CN2906300000000	29	063	DeKalb County, MO	2017	NA	4914	4724	190	3.9
CN2906500000000	29	065	Dent County, MO	2017	NA	6188	5930	258	4.2
CN2906700000000	29	067	Douglas County, MO	2017	NA	5079	4846	233	4.6
CN2906900000000	29	069	Dunklin County, MO	2017	NA	12454	11650	804	6.5
CN2907100000000	29	071	Franklin County, MO	2017	NA	52531	50641	1890	3.6
CN2907300000000	29	073	Gasconade County, MO	2017	NA	7801	7503	298	3.8
CN2907500000000	29	075	Gentry County, MO	2017	NA	3628	3526	102	2.8
CN2907700000000	29	077	Greene County, MO	2017	NA	147265	142759	4506	3.1
CN2907900000000	29	079	Grundy County, MO	2017	NA	4810	4639	171	3.6
CN2908100000000	29	081	Harrison County, MO	2017	NA	3926	3789	137	3.5
CN2908300000000	29	083	Henry County, MO	2017	NA	9911	9506	405	4.1
CN2908500000000	29	085	Hickory County, MO	2017	NA	3768	3601	167	4.4
CN2908700000000	29	087	Holt County, MO	2017	NA	2698	2621	77	2.9
CN2908900000000	29	089	Howard County, MO	2017	NA	5090	4897	193	3.8
CN2909100000000	29	091	Howell County, MO	2017	NA	15936	15183	753	4.7
CN2909300000000	29	093	Iron County, MO	2017	NA	3590	3360	230	6.4
CN2909500000000	29	095	Jackson County, MO	2017	NA	363006	347100	15906	4.4
CN2909700000000	29	097	Jasper County, MO	2017	NA	56919	55007	1912	3.4
CN2909900000000	29	099	Jefferson County, MO	2017	NA	116554	112409	4145	3.6
CN2910100000000	29	101	Johnson County, MO	2017	NA	23329	22310	1019	4.4
CN2910300000000	29	103	Knox County, MO	2017	NA	1996	1932	64	3.2
CN2910500000000	29	105	Laclede County, MO	2017	NA	16639	15854	785	4.7
CN2910700000000	29	107	Lafayette County, MO	2017	NA	17014	16375	639	3.8
CN2910900000000	29	109	Lawrence County, MO	2017	NA	17897	17267	630	3.5
CN2911100000000	29	111	Lewis County, MO	2017	NA	5122	4947	175	3.4
CN2911300000000	29	113	Lincoln County, MO	2017	NA	27431	26453	978	3.6
CN2911500000000	29	115	Linn County, MO	2017	NA	5272	4967	305	5.8
CN2911700000000	29	117	Livingston County, MO	2017	NA	7478	7259	219	2.9
CN2911900000000	29	119	McDonald County, MO	2017	NA	10414	10036	378	3.6
CN2912100000000	29	121	Macon County, MO	2017	NA	7594	7322	272	3.6
CN2912300000000	29	123	Madison County, MO	2017	NA	5504	5258	246	4.5
CN2912500000000	29	125	Maries County, MO	2017	NA	3926	3758	168	4.3
CN2912700000000	29	127	Marion County, MO	2017	NA	14574	14055	519	3.6
CN2912900000000	29	129	Mercer County, MO	2017	NA	1949	1877	72	3.7
CN2913100000000	29	131	Miller County, MO	2017	NA	12044	11512	532	4.4
CN2913300000000	29	133	Mississippi County, MO	2017	NA	6064	5762	302	5
CN2913500000000	29	135	Moniteau County, MO	2017	NA	7377	7111	266	3.6
CN2913700000000	29	137	Monroe County, MO	2017	NA	4078	3904	174	4.3
CN2913900000000	29	139	Montgomery County, MO	2017	NA	5666	5481	185	3.3
CN2914100000000	29	141	Morgan County, MO	2017	NA	7958	7570	388	4.9
CN2914300000000	29	143	New Madrid County, MO	2017	NA	8019	7494	525	6.5
CN2914500000000	29	145	Newton County, MO	2017	NA	27399	26407	992	3.6
CN2914700000000	29	147	Nodaway County, MO	2017	NA	10668	10288	380	3.6
CN2914900000000	29	149	Oregon County, MO	2017	NA	4025	3841	184	4.6
CN2915100000000	29	151	Osage County, MO	2017	NA	7132	6920	212	3
CN2915300000000	29	153	Ozark County, MO	2017	NA	3576	3369	207	5.8
CN2915500000000	29	155	Pemiscot County, MO	2017	NA	6572	6085	487	7.4
CN2915700000000	29	157	Perry County, MO	2017	NA	10134	9866	268	2.6
CN2915900000000	29	159	Pettis County, MO	2017	NA	20917	20052	865	4.1
CN2916100000000	29	161	Phelps County, MO	2017	NA	19741	19009	732	3.7
CN2916300000000	29	163	Pike County, MO	2017	NA	7950	7678	272	3.4
CN2916500000000	29	165	Platte County, MO	2017	NA	57782	55951	1831	3.2
CN2916700000000	29	167	Polk County, MO	2017	NA	14224	13660	564	4
CN2916900000000	29	169	Pulaski County, MO	2017	NA	14743	14116	627	4.3
CN2917100000000	29	171	Putnam County, MO	2017	NA	2452	2359	93	3.8
CN2917300000000	29	173	Ralls County, MO	2017	NA	5660	5485	175	3.1
CN2917500000000	29	175	Randolph County, MO	2017	NA	10297	9834	463	4.5
CN2917700000000	29	177	Ray County, MO	2017	NA	11120	10587	533	4.8
CN2917900000000	29	179	Reynolds County, MO	2017	NA	3136	3015	121	3.9
CN2918100000000	29	181	Ripley County, MO	2017	NA	5261	4971	290	5.5
CN2918300000000	29	183	St. Charles County, MO	2017	NA	222425	216099	6326	2.8
CN2918500000000	29	185	St. Clair County, MO	2017	NA	3890	3693	197	5.1
CN2918600000000	29	186	Ste. Genevieve County, MO	2017	NA	9113	8788	325	3.6
CN2918700000000	29	187	St. Francois County, MO	2017	NA	26794	25629	1165	4.3
CN2918900000000	29	189	St. Louis County, MO	2017	NA	526669	508640	18029	3.4
CN2919500000000	29	195	Saline County, MO	2017	NA	10701	10323	378	3.5
CN2919700000000	29	197	Schuyler County, MO	2017	NA	1962	1867	95	4.8
CN2919900000000	29	199	Scotland County, MO	2017	NA	2459	2382	77	3.1
CN2920100000000	29	201	Scott County, MO	2017	NA	20167	19277	890	4.4
CN2920300000000	29	203	Shannon County, MO	2017	NA	3290	3092	198	6
CN2920500000000	29	205	Shelby County, MO	2017	NA	3101	2996	105	3.4
CN2920700000000	29	207	Stoddard County, MO	2017	NA	13264	12599	665	5
CN2920900000000	29	209	Stone County, MO	2017	NA	13857	13096	761	5.5
CN2921100000000	29	211	Sullivan County, MO	2017	NA	2760	2649	111	4
CN2921300000000	29	213	Taney County, MO	2017	NA	27006	25390	1616	6
CN2921500000000	29	215	Texas County, MO	2017	NA	9394	8932	462	4.9
CN2921700000000	29	217	Vernon County, MO	2017	NA	9673	9308	365	3.8
CN2921900000000	29	219	Warren County, MO	2017	NA	17618	17058	560	3.2
CN2922100000000	29	221	Washington County, MO	2017	NA	10329	9775	554	5.4
CN2922300000000	29	223	Wayne County, MO	2017	NA	5552	5272	280	5
CN2922500000000	29	225	Webster County, MO	2017	NA	16866	16216	650	3.9
CN2922700000000	29	227	Worth County, MO	2017	NA	1194	1164	30	2.5
CN2922900000000	29	229	Wright County, MO	2017	NA	7633	7258	375	4.9
CN2951000000000	29	510	St. Louis city, MO	2017	NA	154436	147604	6832	4.4
CN3000100000000	30	001	Beaverhead County, MT	2017	NA	5054	4900	154	3
CN3000300000000	30	003	Big Horn County, MT	2017	NA	5519	4792	727	13.2
CN3000500000000	30	005	Blaine County, MT	2017	NA	2355	2261	94	4
CN3000700000000	30	007	Broadwater County, MT	2017	NA	2587	2467	120	4.6
CN3000900000000	30	009	Carbon County, MT	2017	NA	5506	5310	196	3.6
CN3001100000000	30	011	Carter County, MT	2017	NA	696	679	17	2.4
CN3001300000000	30	013	Cascade County, MT	2017	NA	37801	36409	1392	3.7
CN3001500000000	30	015	Chouteau County, MT	2017	NA	2495	2414	81	3.2
CN3001700000000	30	017	Custer County, MT	2017	NA	6166	5976	190	3.1
CN3001900000000	30	019	Daniels County, MT	2017	NA	908	888	20	2.2
CN3002100000000	30	021	Dawson County, MT	2017	NA	4683	4542	141	3
CN3002300000000	30	023	Deer Lodge County, MT	2017	NA	5140	4961	179	3.5
CN3002500000000	30	025	Fallon County, MT	2017	NA	1738	1693	45	2.6
CN3002700000000	30	027	Fergus County, MT	2017	NA	5767	5540	227	3.9
CN3002900000000	30	029	Flathead County, MT	2017	NA	46813	44406	2407	5.1
CN3003100000000	30	031	Gallatin County, MT	2017	NA	64606	62858	1748	2.7
CN3003300000000	30	033	Garfield County, MT	2017	NA	761	740	21	2.8
CN3003500000000	30	035	Glacier County, MT	2017	NA	5726	5280	446	7.8
CN3003700000000	30	037	Golden Valley County, MT	2017	NA	373	355	18	4.8
CN3003900000000	30	039	Granite County, MT	2017	NA	1619	1526	93	5.7
CN3004100000000	30	041	Hill County, MT	2017	NA	7800	7511	289	3.7
CN3004300000000	30	043	Jefferson County, MT	2017	NA	5631	5394	237	4.2
CN3004500000000	30	045	Judith Basin County, MT	2017	NA	924	891	33	3.6
CN3004700000000	30	047	Lake County, MT	2017	NA	13149	12573	576	4.4
CN3004900000000	30	049	Lewis and Clark County, MT	2017	NA	35293	34099	1194	3.4
CN3005100000000	30	051	Liberty County, MT	2017	NA	980	951	29	3
CN3005300000000	30	053	Lincoln County, MT	2017	NA	7898	7243	655	8.3
CN3005500000000	30	055	McCone County, MT	2017	NA	1023	1002	21	2.1
CN3005700000000	30	057	Madison County, MT	2017	NA	4397	4229	168	3.8
CN3005900000000	30	059	Meagher County, MT	2017	NA	931	891	40	4.3
CN3006100000000	30	061	Mineral County, MT	2017	NA	1687	1563	124	7.4
CN3006300000000	30	063	Missoula County, MT	2017	NA	62402	60192	2210	3.5
CN3006500000000	30	065	Musselshell County, MT	2017	NA	2291	2191	100	4.4
CN3006700000000	30	067	Park County, MT	2017	NA	8632	8301	331	3.8
CN3006900000000	30	069	Petroleum County, MT	2017	NA	292	280	12	4.1
CN3007100000000	30	071	Phillips County, MT	2017	NA	1893	1809	84	4.4
CN3007300000000	30	073	Pondera County, MT	2017	NA	2743	2640	103	3.8
CN3007500000000	30	075	Powder River County, MT	2017	NA	1007	982	25	2.5
CN3007700000000	30	077	Powell County, MT	2017	NA	2891	2768	123	4.3
CN3007900000000	30	079	Prairie County, MT	2017	NA	487	469	18	3.7
CN3008100000000	30	081	Ravalli County, MT	2017	NA	19788	18881	907	4.6
CN3008300000000	30	083	Richland County, MT	2017	NA	5978	5758	220	3.7
CN3008500000000	30	085	Roosevelt County, MT	2017	NA	4572	4364	208	4.5
CN3008700000000	30	087	Rosebud County, MT	2017	NA	4024	3821	203	5
CN3008900000000	30	089	Sanders County, MT	2017	NA	4783	4456	327	6.8
CN3009100000000	30	091	Sheridan County, MT	2017	NA	1865	1816	49	2.6
CN3009300000000	30	093	Silver Bow County, MT	2017	NA	17157	16452	705	4.1
CN3009500000000	30	095	Stillwater County, MT	2017	NA	4847	4664	183	3.8
CN3009700000000	30	097	Sweet Grass County, MT	2017	NA	1798	1743	55	3.1
CN3009900000000	30	099	Teton County, MT	2017	NA	2783	2676	107	3.8
CN3010100000000	30	101	Toole County, MT	2017	NA	2152	2088	64	3
CN3010300000000	30	103	Treasure County, MT	2017	NA	341	328	13	3.8
CN3010500000000	30	105	Valley County, MT	2017	NA	4163	4030	133	3.2
CN3010700000000	30	107	Wheatland County, MT	2017	NA	785	751	34	4.3
CN3010900000000	30	109	Wibaux County, MT	2017	NA	483	468	15	3.1
CN3011100000000	30	111	Yellowstone County, MT	2017	NA	81390	78600	2790	3.4
CN3100100000000	31	001	Adams County, NE	2017	NA	16592	16081	511	3.1
CN3100300000000	31	003	Antelope County, NE	2017	NA	3557	3469	88	2.5
CN3100500000000	31	005	Arthur County, NE	2017	NA	219	207	12	5.5
CN3100700000000	31	007	Banner County, NE	2017	NA	389	375	14	3.6
CN3100900000000	31	009	Blaine County, NE	2017	NA	261	250	11	4.2
CN3101100000000	31	011	Boone County, NE	2017	NA	2924	2853	71	2.4
CN3101300000000	31	013	Box Butte County, NE	2017	NA	5417	5240	177	3.3
CN3101500000000	31	015	Boyd County, NE	2017	NA	1078	1042	36	3.3
CN3101700000000	31	017	Brown County, NE	2017	NA	1399	1354	45	3.2
CN3101900000000	31	019	Buffalo County, NE	2017	NA	27227	26571	656	2.4
CN3102100000000	31	021	Burt County, NE	2017	NA	3499	3371	128	3.7
CN3102300000000	31	023	Butler County, NE	2017	NA	4556	4430	126	2.8
CN3102500000000	31	025	Cass County, NE	2017	NA	13144	12731	413	3.1
CN3102700000000	31	027	Cedar County, NE	2017	NA	4463	4364	99	2.2
CN3102900000000	31	029	Chase County, NE	2017	NA	2301	2258	43	1.9
CN3103100000000	31	031	Cherry County, NE	2017	NA	3387	3309	78	2.3
CN3103300000000	31	033	Cheyenne County, NE	2017	NA	5090	4945	145	2.8
CN3103500000000	31	035	Clay County, NE	2017	NA	3271	3170	101	3.1
CN3103700000000	31	037	Colfax County, NE	2017	NA	5589	5455	134	2.4
CN3103900000000	31	039	Cuming County, NE	2017	NA	4722	4595	127	2.7
CN3104100000000	31	041	Custer County, NE	2017	NA	6374	6238	136	2.1
CN3104300000000	31	043	Dakota County, NE	2017	NA	10613	10185	428	4
CN3104500000000	31	045	Dawes County, NE	2017	NA	5153	5013	140	2.7
CN3104700000000	31	047	Dawson County, NE	2017	NA	12917	12549	368	2.8
CN3104900000000	31	049	Deuel County, NE	2017	NA	1034	1008	26	2.5
CN3105100000000	31	051	Dixon County, NE	2017	NA	3010	2917	93	3.1
CN3105300000000	31	053	Dodge County, NE	2017	NA	19323	18784	539	2.8
CN3105500000000	31	055	Douglas County, NE	2017	NA	290548	281350	9198	3.2
CN3105700000000	31	057	Dundy County, NE	2017	NA	1179	1151	28	2.4
CN3105900000000	31	059	Fillmore County, NE	2017	NA	3100	3023	77	2.5
CN3106100000000	31	061	Franklin County, NE	2017	NA	1474	1430	44	3
CN3106300000000	31	063	Frontier County, NE	2017	NA	1558	1519	39	2.5
CN3106500000000	31	065	Furnas County, NE	2017	NA	2674	2609	65	2.4
CN3106700000000	31	067	Gage County, NE	2017	NA	10940	10561	379	3.5
CN3106900000000	31	069	Garden County, NE	2017	NA	1187	1154	33	2.8
CN3107100000000	31	071	Garfield County, NE	2017	NA	1155	1125	30	2.6
CN3107300000000	31	073	Gosper County, NE	2017	NA	1043	1015	28	2.7
CN3107500000000	31	075	Grant County, NE	2017	NA	438	428	10	2.3
CN3107700000000	31	077	Greeley County, NE	2017	NA	1219	1182	37	3
CN3107900000000	31	079	Hall County, NE	2017	NA	31536	30461	1075	3.4
CN3108100000000	31	081	Hamilton County, NE	2017	NA	4673	4557	116	2.5
CN3108300000000	31	083	Harlan County, NE	2017	NA	1770	1725	45	2.5
CN3108500000000	31	085	Hayes County, NE	2017	NA	571	557	14	2.5
CN3108700000000	31	087	Hitchcock County, NE	2017	NA	1261	1218	43	3.4
CN3108900000000	31	089	Holt County, NE	2017	NA	5742	5603	139	2.4
CN3109100000000	31	091	Hooker County, NE	2017	NA	395	380	15	3.8
CN3109300000000	31	093	Howard County, NE	2017	NA	3312	3212	100	3
CN3109500000000	31	095	Jefferson County, NE	2017	NA	4190	4089	101	2.4
CN3109700000000	31	097	Johnson County, NE	2017	NA	2072	2002	70	3.4
CN3109900000000	31	099	Kearney County, NE	2017	NA	3749	3667	82	2.2
CN3110100000000	31	101	Keith County, NE	2017	NA	4582	4444	138	3
CN3110300000000	31	103	Keya Paha County, NE	2017	NA	605	590	15	2.5
CN3110500000000	31	105	Kimball County, NE	2017	NA	1970	1914	56	2.8
CN3110700000000	31	107	Knox County, NE	2017	NA	4682	4522	160	3.4
CN3110900000000	31	109	Lancaster County, NE	2017	NA	170251	165762	4489	2.6
CN3111100000000	31	111	Lincoln County, NE	2017	NA	18420	17863	557	3
CN3111300000000	31	113	Logan County, NE	2017	NA	470	457	13	2.8
CN3111500000000	31	115	Loup County, NE	2017	NA	398	386	12	3
CN3111700000000	31	117	McPherson County, NE	2017	NA	452	442	10	2.2
CN3111900000000	31	119	Madison County, NE	2017	NA	19222	18721	501	2.6
CN3112100000000	31	121	Merrick County, NE	2017	NA	4047	3935	112	2.8
CN3112300000000	31	123	Morrill County, NE	2017	NA	2602	2525	77	3
CN3112500000000	31	125	Nance County, NE	2017	NA	2015	1965	50	2.5
CN3112700000000	31	127	Nemaha County, NE	2017	NA	3597	3458	139	3.9
CN3112900000000	31	129	Nuckolls County, NE	2017	NA	2357	2295	62	2.6
CN3113100000000	31	131	Otoe County, NE	2017	NA	8142	7872	270	3.3
CN3113300000000	31	133	Pawnee County, NE	2017	NA	1501	1456	45	3
CN3113500000000	31	135	Perkins County, NE	2017	NA	1803	1769	34	1.9
CN3113700000000	31	137	Phelps County, NE	2017	NA	4896	4784	112	2.3
CN3113900000000	31	139	Pierce County, NE	2017	NA	4109	3999	110	2.7
CN3114100000000	31	141	Platte County, NE	2017	NA	17216	16725	491	2.9
CN3114300000000	31	143	Polk County, NE	2017	NA	2888	2820	68	2.4
CN3114500000000	31	145	Red Willow County, NE	2017	NA	5830	5683	147	2.5
CN3114700000000	31	147	Richardson County, NE	2017	NA	4205	4069	136	3.2
CN3114900000000	31	149	Rock County, NE	2017	NA	902	879	23	2.5
CN3115100000000	31	151	Saline County, NE	2017	NA	7382	7156	226	3.1
CN3115300000000	31	153	Sarpy County, NE	2017	NA	93021	90440	2581	2.8
CN3115500000000	31	155	Saunders County, NE	2017	NA	10818	10517	301	2.8
CN3115700000000	31	157	Scotts Bluff County, NE	2017	NA	18352	17727	625	3.4
CN3115900000000	31	159	Seward County, NE	2017	NA	8600	8370	230	2.7
CN3116100000000	31	161	Sheridan County, NE	2017	NA	2710	2639	71	2.6
CN3116300000000	31	163	Sherman County, NE	2017	NA	1690	1642	48	2.8
CN3116500000000	31	165	Sioux County, NE	2017	NA	754	732	22	2.9
CN3116700000000	31	167	Stanton County, NE	2017	NA	3470	3373	97	2.8
CN3116900000000	31	169	Thayer County, NE	2017	NA	2857	2793	64	2.2
CN3117100000000	31	171	Thomas County, NE	2017	NA	435	421	14	3.2
CN3117300000000	31	173	Thurston County, NE	2017	NA	3007	2859	148	4.9
CN3117500000000	31	175	Valley County, NE	2017	NA	2107	2052	55	2.6
CN3117700000000	31	177	Washington County, NE	2017	NA	11124	10781	343	3.1
CN3117900000000	31	179	Wayne County, NE	2017	NA	5644	5510	134	2.4
CN3118100000000	31	181	Webster County, NE	2017	NA	1659	1611	48	2.9
CN3118300000000	31	183	Wheeler County, NE	2017	NA	582	569	13	2.2
CN3118500000000	31	185	York County, NE	2017	NA	7316	7130	186	2.5
CN3200100000000	32	001	Churchill County, NV	2017	NA	10560	10091	469	4.4
CN3200300000000	32	003	Clark County, NV	2017	NA	1072743	1016808	55935	5.2
CN3200500000000	32	005	Douglas County, NV	2017	NA	22453	21371	1082	4.8
CN3200700000000	32	007	Elko County, NV	2017	NA	26869	25879	990	3.7
CN3200900000000	32	009	Esmeralda County, NV	2017	NA	486	466	20	4.1
CN3201100000000	32	011	Eureka County, NV	2017	NA	1048	1016	32	3.1
CN3201300000000	32	013	Humboldt County, NV	2017	NA	8076	7735	341	4.2
CN3201500000000	32	015	Lander County, NV	2017	NA	3119	2978	141	4.5
CN3201700000000	32	017	Lincoln County, NV	2017	NA	2019	1923	96	4.8
CN3201900000000	32	019	Lyon County, NV	2017	NA	21723	20420	1303	6
CN3202100000000	32	021	Mineral County, NV	2017	NA	1985	1877	108	5.4
CN3202300000000	32	023	Nye County, NV	2017	NA	16170	15132	1038	6.4
CN3202700000000	32	027	Pershing County, NV	2017	NA	2547	2431	116	4.6
CN3202900000000	32	029	Storey County, NV	2017	NA	1920	1824	96	5
CN3203100000000	32	031	Washoe County, NV	2017	NA	239139	229233	9906	4.1
CN3203300000000	32	033	White Pine County, NV	2017	NA	4472	4292	180	4
CN3251000000000	32	510	Carson City, NV	2017	NA	25427	24153	1274	5
CN3300100000000	33	001	Belknap County, NH	2017	NA	31126	30295	831	2.7
CN3300300000000	33	003	Carroll County, NH	2017	NA	23569	22935	634	2.7
CN3300500000000	33	005	Cheshire County, NH	2017	NA	40986	39915	1071	2.6
CN3300700000000	33	007	Coos County, NH	2017	NA	14470	13967	503	3.5
CN3300900000000	33	009	Grafton County, NH	2017	NA	49321	48232	1089	2.2
CN3301100000000	33	011	Hillsborough County, NH	2017	NA	234126	227400	6726	2.9
CN3301300000000	33	013	Merrimack County, NH	2017	NA	82089	80129	1960	2.4
CN3301500000000	33	015	Rockingham County, NH	2017	NA	183194	177806	5388	2.9
CN3301700000000	33	017	Strafford County, NH	2017	NA	72549	70794	1755	2.4
CN3301900000000	33	019	Sullivan County, NH	2017	NA	23253	22733	520	2.2
CN3400100000000	34	001	Atlantic County, NJ	2017	NA	118514	109953	8561	7.2
CN3400300000000	34	003	Bergen County, NJ	2017	NA	475764	457269	18495	3.9
CN3400500000000	34	005	Burlington County, NJ	2017	NA	229971	220557	9414	4.1
CN3400700000000	34	007	Camden County, NJ	2017	NA	252989	240117	12872	5.1
CN3400900000000	34	009	Cape May County, NJ	2017	NA	46047	41812	4235	9.2
CN3401100000000	34	011	Cumberland County, NJ	2017	NA	65243	60702	4541	7
CN3401300000000	34	013	Essex County, NJ	2017	NA	367815	347042	20773	5.6
CN3401500000000	34	015	Gloucester County, NJ	2017	NA	149033	141994	7039	4.7
CN3401700000000	34	017	Hudson County, NJ	2017	NA	360525	344859	15666	4.3
CN3401900000000	34	019	Hunterdon County, NJ	2017	NA	63549	61304	2245	3.5
CN3402100000000	34	021	Mercer County, NJ	2017	NA	197039	188988	8051	4.1
CN3402300000000	34	023	Middlesex County, NJ	2017	NA	436049	418216	17833	4.1
CN3402500000000	34	025	Monmouth County, NJ	2017	NA	324012	310646	13366	4.1
CN3402700000000	34	027	Morris County, NJ	2017	NA	255094	245814	9280	3.6
CN3402900000000	34	029	Ocean County, NJ	2017	NA	267817	254946	12871	4.8
CN3403100000000	34	031	Passaic County, NJ	2017	NA	241533	227728	13805	5.7
CN3403300000000	34	033	Salem County, NJ	2017	NA	29163	27367	1796	6.2
CN3403500000000	34	035	Somerset County, NJ	2017	NA	170551	164062	6489	3.8
CN3403700000000	34	037	Sussex County, NJ	2017	NA	73275	70045	3230	4.4
CN3403900000000	34	039	Union County, NJ	2017	NA	275131	262077	13054	4.7
CN3404100000000	34	041	Warren County, NJ	2017	NA	55567	53243	2324	4.2
CN3500100000000	35	001	Bernalillo County, NM	2017	NA	327461	310374	17087	5.2
CN3500300000000	35	003	Catron County, NM	2017	NA	1159	1082	77	6.6
CN3500500000000	35	005	Chaves County, NM	2017	NA	27369	25691	1678	6.1
CN3500600000000	35	006	Cibola County, NM	2017	NA	9071	8400	671	7.4
CN3500700000000	35	007	Colfax County, NM	2017	NA	5671	5347	324	5.7
CN3500900000000	35	009	Curry County, NM	2017	NA	22218	21203	1015	4.6
CN3501100000000	35	011	De Baca County, NM	2017	NA	846	809	37	4.4
CN3501300000000	35	013	Dona Ana County, NM	2017	NA	95419	89235	6184	6.5
CN3501500000000	35	015	Eddy County, NM	2017	NA	29070	27623	1447	5
CN3501700000000	35	017	Grant County, NM	2017	NA	12204	11497	707	5.8
CN3501900000000	35	019	Guadalupe County, NM	2017	NA	1638	1536	102	6.2
CN3502100000000	35	021	Harding County, NM	2017	NA	281	264	17	6
CN3502300000000	35	023	Hidalgo County, NM	2017	NA	2124	2021	103	4.8
CN3502500000000	35	025	Lea County, NM	2017	NA	27733	26002	1731	6.2
CN3502700000000	35	027	Lincoln County, NM	2017	NA	8685	8228	457	5.3
CN3502800000000	35	028	Los Alamos County, NM	2017	NA	9100	8766	334	3.7
CN3502900000000	35	029	Luna County, NM	2017	NA	10474	9069	1405	13.4
CN3503100000000	35	031	McKinley County, NM	2017	NA	24191	22202	1989	8.2
CN3503300000000	35	033	Mora County, NM	2017	NA	2200	2033	167	7.6
CN3503500000000	35	035	Otero County, NM	2017	NA	24863	23415	1448	5.8
CN3503700000000	35	037	Quay County, NM	2017	NA	3242	3052	190	5.9
CN3503900000000	35	039	Rio Arriba County, NM	2017	NA	16734	15714	1020	6.1
CN3504100000000	35	041	Roosevelt County, NM	2017	NA	7971	7576	395	5
CN3504300000000	35	043	Sandoval County, NM	2017	NA	64348	60568	3780	5.9
CN3504500000000	35	045	San Juan County, NM	2017	NA	53757	49896	3861	7.2
CN3504700000000	35	047	San Miguel County, NM	2017	NA	10930	10157	773	7.1
CN3504900000000	35	049	Santa Fe County, NM	2017	NA	73231	69681	3550	4.8
CN3505100000000	35	051	Sierra County, NM	2017	NA	4153	3844	309	7.4
CN3505300000000	35	053	Socorro County, NM	2017	NA	6575	6174	401	6.1
CN3505500000000	35	055	Taos County, NM	2017	NA	15024	13891	1133	7.5
CN3505700000000	35	057	Torrance County, NM	2017	NA	5561	5106	455	8.2
CN3505900000000	35	059	Union County, NM	2017	NA	1907	1839	68	3.6
CN3506100000000	35	061	Valencia County, NM	2017	NA	30053	28149	1904	6.3
CN3600100000000	36	001	Albany County, NY	2017	NA	158138	151479	6659	4.2
CN3600300000000	36	003	Allegany County, NY	2017	NA	19695	18395	1300	6.6
CN3600500000000	36	005	Bronx County, NY	2017	NA	605491	567233	38258	6.3
CN3600700000000	36	007	Broome County, NY	2017	NA	84531	79840	4691	5.5
CN3600900000000	36	009	Cattaraugus County, NY	2017	NA	34282	32162	2120	6.2
CN3601100000000	36	011	Cayuga County, NY	2017	NA	35875	34077	1798	5
CN3601300000000	36	013	Chautauqua County, NY	2017	NA	55433	52119	3314	6
CN3601500000000	36	015	Chemung County, NY	2017	NA	35667	33705	1962	5.5
CN3601700000000	36	017	Chenango County, NY	2017	NA	22331	21141	1190	5.3
CN3601900000000	36	019	Clinton County, NY	2017	NA	36139	34239	1900	5.3
CN3602100000000	36	021	Columbia County, NY	2017	NA	31107	29931	1176	3.8
CN3602300000000	36	023	Cortland County, NY	2017	NA	22952	21630	1322	5.8
CN3602500000000	36	025	Delaware County, NY	2017	NA	18962	17917	1045	5.5
CN3602700000000	36	027	Dutchess County, NY	2017	NA	143315	137197	6118	4.3
CN3602900000000	36	029	Erie County, NY	2017	NA	444145	421301	22844	5.1
CN3603100000000	36	031	Essex County, NY	2017	NA	17163	16226	937	5.5
CN3603300000000	36	033	Franklin County, NY	2017	NA	19747	18554	1193	6
CN3603500000000	36	035	Fulton County, NY	2017	NA	23158	21826	1332	5.8
CN3603700000000	36	037	Genesee County, NY	2017	NA	29531	28123	1408	4.8
CN3603900000000	36	039	Greene County, NY	2017	NA	20509	19443	1066	5.2
CN3604100000000	36	041	Hamilton County, NY	2017	NA	2316	2145	171	7.4
CN3604300000000	36	043	Herkimer County, NY	2017	NA	28021	26428	1593	5.7
CN3604500000000	36	045	Jefferson County, NY	2017	NA	44993	42071	2922	6.5
CN3604700000000	36	047	Kings County, NY	2017	NA	1209284	1152039	57245	4.7
CN3604900000000	36	049	Lewis County, NY	2017	NA	11599	10831	768	6.6
CN3605100000000	36	051	Livingston County, NY	2017	NA	30639	29101	1538	5
CN3605300000000	36	053	Madison County, NY	2017	NA	32385	30604	1781	5.5
CN3605500000000	36	055	Monroe County, NY	2017	NA	361957	344172	17785	4.9
CN3605700000000	36	057	Montgomery County, NY	2017	NA	22523	21240	1283	5.7
CN3605900000000	36	059	Nassau County, NY	2017	NA	706396	677660	28736	4.1
CN3606100000000	36	061	New York County, NY	2017	NA	916625	878936	37689	4.1
CN3606300000000	36	063	Niagara County, NY	2017	NA	99442	93300	6142	6.2
CN3606500000000	36	065	Oneida County, NY	2017	NA	101766	96696	5070	5
CN3606700000000	36	067	Onondaga County, NY	2017	NA	219720	209472	10248	4.7
CN3606900000000	36	069	Ontario County, NY	2017	NA	54838	52384	2454	4.5
CN3607100000000	36	071	Orange County, NY	2017	NA	180708	172521	8187	4.5
CN3607300000000	36	073	Orleans County, NY	2017	NA	17522	16491	1031	5.9
CN3607500000000	36	075	Oswego County, NY	2017	NA	52710	49308	3402	6.5
CN3607700000000	36	077	Otsego County, NY	2017	NA	28022	26621	1401	5
CN3607900000000	36	079	Putnam County, NY	2017	NA	50861	48730	2131	4.2
CN3608100000000	36	081	Queens County, NY	2017	NA	1159130	1112183	46947	4.1
CN3608300000000	36	083	Rensselaer County, NY	2017	NA	80979	77395	3584	4.4
CN3608500000000	36	085	Richmond County, NY	2017	NA	220272	209939	10333	4.7
CN3608700000000	36	087	Rockland County, NY	2017	NA	153519	146878	6641	4.3
CN3608900000000	36	089	St. Lawrence County, NY	2017	NA	43315	40431	2884	6.7
CN3609100000000	36	091	Saratoga County, NY	2017	NA	118282	113595	4687	4
CN3609300000000	36	093	Schenectady County, NY	2017	NA	75900	72511	3389	4.5
CN3609500000000	36	095	Schoharie County, NY	2017	NA	14664	13864	800	5.5
CN3609700000000	36	097	Schuyler County, NY	2017	NA	8211	7736	475	5.8
CN3609900000000	36	099	Seneca County, NY	2017	NA	16073	15343	730	4.5
CN3610100000000	36	101	Steuben County, NY	2017	NA	42668	40231	2437	5.7
CN3610300000000	36	103	Suffolk County, NY	2017	NA	776679	741944	34735	4.5
CN3610500000000	36	105	Sullivan County, NY	2017	NA	34296	32621	1675	4.9
CN3610700000000	36	107	Tioga County, NY	2017	NA	22745	21580	1165	5.1
CN3610900000000	36	109	Tompkins County, NY	2017	NA	49912	47752	2160	4.3
CN3611100000000	36	111	Ulster County, NY	2017	NA	88041	84047	3994	4.5
CN3611300000000	36	113	Warren County, NY	2017	NA	31841	30168	1673	5.3
CN3611500000000	36	115	Washington County, NY	2017	NA	28128	26823	1305	4.6
CN3611700000000	36	117	Wayne County, NY	2017	NA	43657	41495	2162	5
CN3611900000000	36	119	Westchester County, NY	2017	NA	480739	459137	21602	4.5
CN3612100000000	36	121	Wyoming County, NY	2017	NA	17907	16903	1004	5.6
CN3612300000000	36	123	Yates County, NY	2017	NA	11622	11114	508	4.4
CN3700100000000	37	001	Alamance County, NC	2017	NA	79952	76587	3365	4.2
CN3700300000000	37	003	Alexander County, NC	2017	NA	17977	17329	648	3.6
CN3700500000000	37	005	Alleghany County, NC	2017	NA	4363	4144	219	5
CN3700700000000	37	007	Anson County, NC	2017	NA	10526	9988	538	5.1
CN3700900000000	37	009	Ashe County, NC	2017	NA	12664	12149	515	4.1
CN3701100000000	37	011	Avery County, NC	2017	NA	7639	7315	324	4.2
CN3701300000000	37	013	Beaufort County, NC	2017	NA	19992	18992	1000	5
CN3701500000000	37	015	Bertie County, NC	2017	NA	8080	7607	473	5.9
CN3701700000000	37	017	Bladen County, NC	2017	NA	14422	13589	833	5.8
CN3701900000000	37	019	Brunswick County, NC	2017	NA	51337	48457	2880	5.6
CN3702100000000	37	021	Buncombe County, NC	2017	NA	136616	131958	4658	3.4
CN3702300000000	37	023	Burke County, NC	2017	NA	40502	38822	1680	4.1
CN3702500000000	37	025	Cabarrus County, NC	2017	NA	104706	100409	4297	4.1
CN3702700000000	37	027	Caldwell County, NC	2017	NA	36518	34907	1611	4.4
CN3702900000000	37	029	Camden County, NC	2017	NA	4728	4524	204	4.3
CN3703100000000	37	031	Carteret County, NC	2017	NA	31934	30530	1404	4.4
CN3703300000000	37	033	Caswell County, NC	2017	NA	9769	9312	457	4.7
CN3703500000000	37	035	Catawba County, NC	2017	NA	78657	75428	3229	4.1
CN3703700000000	37	037	Chatham County, NC	2017	NA	34170	32858	1312	3.8
CN3703900000000	37	039	Cherokee County, NC	2017	NA	11175	10624	551	4.9
CN3704100000000	37	041	Chowan County, NC	2017	NA	5599	5306	293	5.2
CN3704300000000	37	043	Clay County, NC	2017	NA	3952	3757	195	4.9
CN3704500000000	37	045	Cleveland County, NC	2017	NA	47491	45316	2175	4.6
CN3704700000000	37	047	Columbus County, NC	2017	NA	22289	21083	1206	5.4
CN3704900000000	37	049	Craven County, NC	2017	NA	41759	39840	1919	4.6
CN3705100000000	37	051	Cumberland County, NC	2017	NA	127703	120440	7263	5.7
CN3705300000000	37	053	Currituck County, NC	2017	NA	13582	12997	585	4.3
CN3705500000000	37	055	Dare County, NC	2017	NA	20112	18936	1176	5.8
CN3705700000000	37	057	Davidson County, NC	2017	NA	79639	76250	3389	4.3
CN3705900000000	37	059	Davie County, NC	2017	NA	20348	19545	803	3.9
CN3706100000000	37	061	Duplin County, NC	2017	NA	25456	24231	1225	4.8
CN3706300000000	37	063	Durham County, NC	2017	NA	165274	158652	6622	4
CN3706500000000	37	065	Edgecombe County, NC	2017	NA	21939	20266	1673	7.6
CN3706700000000	37	067	Forsyth County, NC	2017	NA	184810	176817	7993	4.3
CN3706900000000	37	069	Franklin County, NC	2017	NA	30111	28720	1391	4.6
CN3707100000000	37	071	Gaston County, NC	2017	NA	107808	102873	4935	4.6
CN3707300000000	37	073	Gates County, NC	2017	NA	5280	5049	231	4.4
CN3707500000000	37	075	Graham County, NC	2017	NA	3129	2917	212	6.8
CN3707700000000	37	077	Granville County, NC	2017	NA	30027	28893	1134	3.8
CN3707900000000	37	079	Greene County, NC	2017	NA	9551	9132	419	4.4
CN3708100000000	37	081	Guilford County, NC	2017	NA	260811	248524	12287	4.7
CN3708300000000	37	083	Halifax County, NC	2017	NA	20564	19081	1483	7.2
CN3708500000000	37	085	Harnett County, NC	2017	NA	52576	49918	2658	5.1
CN3708700000000	37	087	Haywood County, NC	2017	NA	28952	27799	1153	4
CN3708900000000	37	089	Henderson County, NC	2017	NA	53508	51491	2017	3.8
CN3709100000000	37	091	Hertford County, NC	2017	NA	9186	8663	523	5.7
CN3709300000000	37	093	Hoke County, NC	2017	NA	19916	18779	1137	5.7
CN3709500000000	37	095	Hyde County, NC	2017	NA	2099	1924	175	8.3
CN3709700000000	37	097	Iredell County, NC	2017	NA	86508	82869	3639	4.2
CN3709900000000	37	099	Jackson County, NC	2017	NA	19067	18165	902	4.7
CN3710100000000	37	101	Johnston County, NC	2017	NA	94409	90532	3877	4.1
CN3710300000000	37	103	Jones County, NC	2017	NA	4408	4215	193	4.4
CN3710500000000	37	105	Lee County, NC	2017	NA	26576	25230	1346	5.1
CN3710700000000	37	107	Lenoir County, NC	2017	NA	28015	26780	1235	4.4
CN3710900000000	37	109	Lincoln County, NC	2017	NA	41918	40245	1673	4
CN3711100000000	37	111	McDowell County, NC	2017	NA	20976	20134	842	4
CN3711300000000	37	113	Macon County, NC	2017	NA	15230	14531	699	4.6
CN3711500000000	37	115	Madison County, NC	2017	NA	9969	9549	420	4.2
CN3711700000000	37	117	Martin County, NC	2017	NA	9589	9056	533	5.6
CN3711900000000	37	119	Mecklenburg County, NC	2017	NA	600609	575010	25599	4.3
CN3712100000000	37	121	Mitchell County, NC	2017	NA	6097	5783	314	5.2
CN3712300000000	37	123	Montgomery County, NC	2017	NA	11752	11223	529	4.5
CN3712500000000	37	125	Moore County, NC	2017	NA	39874	38107	1767	4.4
CN3712700000000	37	127	Nash County, NC	2017	NA	43662	41059	2603	6
CN3712900000000	37	129	New Hanover County, NC	2017	NA	119415	114537	4878	4.1
CN3713100000000	37	131	Northampton County, NC	2017	NA	7743	7265	478	6.2
CN3713300000000	37	133	Onslow County, NC	2017	NA	64554	61201	3353	5.2
CN3713500000000	37	135	Orange County, NC	2017	NA	76671	73804	2867	3.7
CN3713700000000	37	137	Pamlico County, NC	2017	NA	5388	5142	246	4.6
CN3713900000000	37	139	Pasquotank County, NC	2017	NA	17355	16404	951	5.5
CN3714100000000	37	141	Pender County, NC	2017	NA	27971	26691	1280	4.6
CN3714300000000	37	143	Perquimans County, NC	2017	NA	5138	4851	287	5.6
CN3714500000000	37	145	Person County, NC	2017	NA	18027	17194	833	4.6
CN3714700000000	37	147	Pitt County, NC	2017	NA	89301	84997	4304	4.8
CN3714900000000	37	149	Polk County, NC	2017	NA	8918	8551	367	4.1
CN3715100000000	37	151	Randolph County, NC	2017	NA	66629	63744	2885	4.3
CN3715300000000	37	153	Richmond County, NC	2017	NA	16711	15716	995	6
CN3715500000000	37	155	Robeson County, NC	2017	NA	50181	46945	3236	6.4
CN3715700000000	37	157	Rockingham County, NC	2017	NA	40564	38481	2083	5.1
CN3715900000000	37	159	Rowan County, NC	2017	NA	64752	61737	3015	4.7
CN3716100000000	37	161	Rutherford County, NC	2017	NA	24589	23112	1477	6
CN3716300000000	37	163	Sampson County, NC	2017	NA	29405	28020	1385	4.7
CN3716500000000	37	165	Scotland County, NC	2017	NA	11500	10626	874	7.6
CN3716700000000	37	167	Stanly County, NC	2017	NA	29771	28556	1215	4.1
CN3716900000000	37	169	Stokes County, NC	2017	NA	21640	20732	908	4.2
CN3717100000000	37	171	Surry County, NC	2017	NA	33611	32222	1389	4.1
CN3717300000000	37	173	Swain County, NC	2017	NA	6844	6501	343	5
CN3717500000000	37	175	Transylvania County, NC	2017	NA	14217	13610	607	4.3
CN3717700000000	37	177	Tyrrell County, NC	2017	NA	1495	1381	114	7.6
CN3717900000000	37	179	Union County, NC	2017	NA	119127	114401	4726	4
CN3718100000000	37	181	Vance County, NC	2017	NA	17890	16790	1100	6.1
CN3718300000000	37	183	Wake County, NC	2017	NA	573417	551245	22172	3.9
CN3718500000000	37	185	Warren County, NC	2017	NA	6824	6362	462	6.8
CN3718700000000	37	187	Washington County, NC	2017	NA	4770	4458	312	6.5
CN3718900000000	37	189	Watauga County, NC	2017	NA	28571	27422	1149	4
CN3719100000000	37	191	Wayne County, NC	2017	NA	53403	50743	2660	5
CN3719300000000	37	193	Wilkes County, NC	2017	NA	30918	29615	1303	4.2
CN3719500000000	37	195	Wilson County, NC	2017	NA	35958	33386	2572	7.2
CN3719700000000	37	197	Yadkin County, NC	2017	NA	17696	17006	690	3.9
CN3719900000000	37	199	Yancey County, NC	2017	NA	7427	7091	336	4.5
CN3800100000000	38	001	Adams County, ND	2017	NA	1113	1085	28	2.5
CN3800300000000	38	003	Barnes County, ND	2017	NA	5410	5258	152	2.8
CN3800500000000	38	005	Benson County, ND	2017	NA	2385	2298	87	3.6
CN3800700000000	38	007	Billings County, ND	2017	NA	439	425	14	3.2
CN3800900000000	38	009	Bottineau County, ND	2017	NA	3104	3000	104	3.4
CN3801100000000	38	011	Bowman County, ND	2017	NA	1751	1720	31	1.8
CN3801300000000	38	013	Burke County, ND	2017	NA	1089	1055	34	3.1
CN3801500000000	38	015	Burleigh County, ND	2017	NA	50370	49125	1245	2.5
CN3801700000000	38	017	Cass County, ND	2017	NA	101672	99495	2177	2.1
CN3801900000000	38	019	Cavalier County, ND	2017	NA	2052	1997	55	2.7
CN3802100000000	38	021	Dickey County, ND	2017	NA	2502	2458	44	1.8
CN3802300000000	38	023	Divide County, ND	2017	NA	1580	1554	26	1.6
CN3802500000000	38	025	Dunn County, ND	2017	NA	3157	3089	68	2.2
CN3802700000000	38	027	Eddy County, ND	2017	NA	1268	1208	60	4.7
CN3802900000000	38	029	Emmons County, ND	2017	NA	1546	1484	62	4
CN3803100000000	38	031	Foster County, ND	2017	NA	1653	1612	41	2.5
CN3803300000000	38	033	Golden Valley County, ND	2017	NA	931	912	19	2
CN3803500000000	38	035	Grand Forks County, ND	2017	NA	38883	38015	868	2.2
CN3803700000000	38	037	Grant County, ND	2017	NA	1276	1238	38	3
CN3803900000000	38	039	Griggs County, ND	2017	NA	1121	1088	33	2.9
CN3804100000000	38	041	Hettinger County, ND	2017	NA	1471	1443	28	1.9
CN3804300000000	38	043	Kidder County, ND	2017	NA	1360	1311	49	3.6
CN3804500000000	38	045	LaMoure County, ND	2017	NA	2263	2220	43	1.9
CN3804700000000	38	047	Logan County, ND	2017	NA	943	919	24	2.5
CN3804900000000	38	049	McHenry County, ND	2017	NA	3285	3143	142	4.3
CN3805100000000	38	051	McIntosh County, ND	2017	NA	1222	1190	32	2.6
CN3805300000000	38	053	McKenzie County, ND	2017	NA	8136	7931	205	2.5
CN3805500000000	38	055	McLean County, ND	2017	NA	5000	4840	160	3.2
CN3805700000000	38	057	Mercer County, ND	2017	NA	4434	4254	180	4.1
CN3805900000000	38	059	Morton County, ND	2017	NA	16594	16076	518	3.1
CN3806100000000	38	061	Mountrail County, ND	2017	NA	6991	6846	145	2.1
CN3806300000000	38	063	Nelson County, ND	2017	NA	1485	1439	46	3.1
CN3806500000000	38	065	Oliver County, ND	2017	NA	910	872	38	4.2
CN3806700000000	38	067	Pembina County, ND	2017	NA	3511	3363	148	4.2
CN3806900000000	38	069	Pierce County, ND	2017	NA	1877	1817	60	3.2
CN3807100000000	38	071	Ramsey County, ND	2017	NA	5849	5690	159	2.7
CN3807300000000	38	073	Ransom County, ND	2017	NA	2808	2753	55	2
CN3807500000000	38	075	Renville County, ND	2017	NA	1267	1234	33	2.6
CN3807700000000	38	077	Richland County, ND	2017	NA	8791	8579	212	2.4
CN3807900000000	38	079	Rolette County, ND	2017	NA	4818	4314	504	10.5
CN3808100000000	38	081	Sargent County, ND	2017	NA	2377	2328	49	2.1
CN3808300000000	38	083	Sheridan County, ND	2017	NA	731	698	33	4.5
CN3808500000000	38	085	Sioux County, ND	2017	NA	1290	1241	49	3.8
CN3808700000000	38	087	Slope County, ND	2017	NA	426	417	9	2.1
CN3808900000000	38	089	Stark County, ND	2017	NA	17944	17453	491	2.7
CN3809100000000	38	091	Steele County, ND	2017	NA	1054	1036	18	1.7
CN3809300000000	38	093	Stutsman County, ND	2017	NA	10930	10670	260	2.4
CN3809500000000	38	095	Towner County, ND	2017	NA	1242	1210	32	2.6
CN3809700000000	38	097	Traill County, ND	2017	NA	4577	4464	113	2.5
CN3809900000000	38	099	Walsh County, ND	2017	NA	5570	5381	189	3.4
CN3810100000000	38	101	Ward County, ND	2017	NA	32466	31396	1070	3.3
CN3810300000000	38	103	Wells County, ND	2017	NA	2137	2067	70	3.3
CN3810500000000	38	105	Williams County, ND	2017	NA	22689	22112	577	2.5
CN3900100000000	39	001	Adams County, OH	2017	NA	10891	10106	785	7.2
CN3900300000000	39	003	Allen County, OH	2017	NA	48564	46130	2434	5
CN3900500000000	39	005	Ashland County, OH	2017	NA	26220	24924	1296	4.9
CN3900700000000	39	007	Ashtabula County, OH	2017	NA	44120	41506	2614	5.9
CN3900900000000	39	009	Athens County, OH	2017	NA	28319	26596	1723	6.1
CN3901100000000	39	011	Auglaize County, OH	2017	NA	24673	23757	916	3.7
CN3901300000000	39	013	Belmont County, OH	2017	NA	30336	28407	1929	6.4
CN3901500000000	39	015	Brown County, OH	2017	NA	19483	18363	1120	5.7
CN3901700000000	39	017	Butler County, OH	2017	NA	192286	183718	8568	4.5
CN3901900000000	39	019	Carroll County, OH	2017	NA	13239	12461	778	5.9
CN3902100000000	39	021	Champaign County, OH	2017	NA	19895	19071	824	4.1
CN3902300000000	39	023	Clark County, OH	2017	NA	63629	60528	3101	4.9
CN3902500000000	39	025	Clermont County, OH	2017	NA	105184	100545	4639	4.4
CN3902700000000	39	027	Clinton County, OH	2017	NA	17412	16454	958	5.5
CN3902900000000	39	029	Columbiana County, OH	2017	NA	47647	44797	2850	6
CN3903100000000	39	031	Coshocton County, OH	2017	NA	14668	13665	1003	6.8
CN3903300000000	39	033	Crawford County, OH	2017	NA	18804	17719	1085	5.8
CN3903500000000	39	035	Cuyahoga County, OH	2017	NA	617638	583182	34456	5.6
CN3903700000000	39	037	Darke County, OH	2017	NA	26270	25162	1108	4.2
CN3903900000000	39	039	Defiance County, OH	2017	NA	18385	17489	896	4.9
CN3904100000000	39	041	Delaware County, OH	2017	NA	107047	103221	3826	3.6
CN3904300000000	39	043	Erie County, OH	2017	NA	38106	35764	2342	6.1
CN3904500000000	39	045	Fairfield County, OH	2017	NA	77039	73727	3312	4.3
CN3904700000000	39	047	Fayette County, OH	2017	NA	14372	13761	611	4.3
CN3904900000000	39	049	Franklin County, OH	2017	NA	682117	654273	27844	4.1
CN3905100000000	39	051	Fulton County, OH	2017	NA	22446	21340	1106	4.9
CN3905300000000	39	053	Gallia County, OH	2017	NA	12272	11457	815	6.6
CN3905500000000	39	055	Geauga County, OH	2017	NA	49327	47081	2246	4.6
CN3905700000000	39	057	Greene County, OH	2017	NA	82408	78882	3526	4.3
CN3905900000000	39	059	Guernsey County, OH	2017	NA	18930	17786	1144	6
CN3906100000000	39	061	Hamilton County, OH	2017	NA	410169	392106	18063	4.4
CN3906300000000	39	063	Hancock County, OH	2017	NA	41560	40050	1510	3.6
CN3906500000000	39	065	Hardin County, OH	2017	NA	14337	13625	712	5
CN3906700000000	39	067	Harrison County, OH	2017	NA	7127	6700	427	6
CN3906900000000	39	069	Henry County, OH	2017	NA	13509	12807	702	5.2
CN3907100000000	39	071	Highland County, OH	2017	NA	17124	16101	1023	6
CN3907300000000	39	073	Hocking County, OH	2017	NA	13064	12352	712	5.5
CN3907500000000	39	075	Holmes County, OH	2017	NA	20778	20039	739	3.6
CN3907700000000	39	077	Huron County, OH	2017	NA	28129	26320	1809	6.4
CN3907900000000	39	079	Jackson County, OH	2017	NA	12881	11959	922	7.2
CN3908100000000	39	081	Jefferson County, OH	2017	NA	27799	25748	2051	7.4
CN3908300000000	39	083	Knox County, OH	2017	NA	31287	29874	1413	4.5
CN3908500000000	39	085	Lake County, OH	2017	NA	126504	120301	6203	4.9
CN3908700000000	39	087	Lawrence County, OH	2017	NA	24015	22582	1433	6
CN3908900000000	39	089	Licking County, OH	2017	NA	88767	84997	3770	4.2
CN3909100000000	39	091	Logan County, OH	2017	NA	23502	22539	963	4.1
CN3909300000000	39	093	Lorain County, OH	2017	NA	154163	145104	9059	5.9
CN3909500000000	39	095	Lucas County, OH	2017	NA	210232	197796	12436	5.9
CN3909700000000	39	097	Madison County, OH	2017	NA	20583	19779	804	3.9
CN3909900000000	39	099	Mahoning County, OH	2017	NA	105080	97823	7257	6.9
CN3910100000000	39	101	Marion County, OH	2017	NA	28052	26630	1422	5.1
CN3910300000000	39	103	Medina County, OH	2017	NA	97412	93026	4386	4.5
CN3910500000000	39	105	Meigs County, OH	2017	NA	8960	8227	733	8.2
CN3910700000000	39	107	Mercer County, OH	2017	NA	23480	22757	723	3.1
CN3910900000000	39	109	Miami County, OH	2017	NA	53449	51170	2279	4.3
CN3911100000000	39	111	Monroe County, OH	2017	NA	5154	4720	434	8.4
CN3911300000000	39	113	Montgomery County, OH	2017	NA	251542	239204	12338	4.9
CN3911500000000	39	115	Morgan County, OH	2017	NA	6692	6238	454	6.8
CN3911700000000	39	117	Morrow County, OH	2017	NA	16724	15893	831	5
CN3911900000000	39	119	Muskingum County, OH	2017	NA	39756	37495	2261	5.7
CN3912100000000	39	121	Noble County, OH	2017	NA	4763	4419	344	7.2
CN3912300000000	39	123	Ottawa County, OH	2017	NA	21190	19763	1427	6.7
CN3912500000000	39	125	Paulding County, OH	2017	NA	8879	8485	394	4.4
CN3912700000000	39	127	Perry County, OH	2017	NA	15881	14917	964	6.1
CN3912900000000	39	129	Pickaway County, OH	2017	NA	26266	25038	1228	4.7
CN3913100000000	39	131	Pike County, OH	2017	NA	10850	10091	759	7
CN3913300000000	39	133	Portage County, OH	2017	NA	87395	82978	4417	5.1
CN3913500000000	39	135	Preble County, OH	2017	NA	21169	20221	948	4.5
CN3913700000000	39	137	Putnam County, OH	2017	NA	18868	18196	672	3.6
CN3913900000000	39	139	Richland County, OH	2017	NA	53171	50259	2912	5.5
CN3914100000000	39	141	Ross County, OH	2017	NA	34187	32430	1757	5.1
CN3914300000000	39	143	Sandusky County, OH	2017	NA	31296	29809	1487	4.8
CN3914500000000	39	145	Scioto County, OH	2017	NA	29580	27483	2097	7.1
CN3914700000000	39	147	Seneca County, OH	2017	NA	27367	26067	1300	4.8
CN3914900000000	39	149	Shelby County, OH	2017	NA	24008	23011	997	4.2
CN3915100000000	39	151	Stark County, OH	2017	NA	187039	177263	9776	5.2
CN3915300000000	39	153	Summit County, OH	2017	NA	273123	259223	13900	5.1
CN3915500000000	39	155	Trumbull County, OH	2017	NA	89065	82628	6437	7.2
CN3915700000000	39	157	Tuscarawas County, OH	2017	NA	45364	43080	2284	5
CN3915900000000	39	159	Union County, OH	2017	NA	28360	27296	1064	3.8
CN3916100000000	39	161	Van Wert County, OH	2017	NA	14489	13919	570	3.9
CN3916300000000	39	163	Vinton County, OH	2017	NA	5456	5080	376	6.9
CN3916500000000	39	165	Warren County, OH	2017	NA	116304	111495	4809	4.1
CN3916700000000	39	167	Washington County, OH	2017	NA	27280	25569	1711	6.3
CN3916900000000	39	169	Wayne County, OH	2017	NA	61613	59198	2415	3.9
CN3917100000000	39	171	Williams County, OH	2017	NA	18984	18150	834	4.4
CN3917300000000	39	173	Wood County, OH	2017	NA	70593	67475	3118	4.4
CN3917500000000	39	175	Wyandot County, OH	2017	NA	12637	12168	469	3.7
CN4000100000000	40	001	Adair County, OK	2017	NA	8239	7833	406	4.9
CN4000300000000	40	003	Alfalfa County, OK	2017	NA	2960	2882	78	2.6
CN4000500000000	40	005	Atoka County, OK	2017	NA	5195	4922	273	5.3
CN4000700000000	40	007	Beaver County, OK	2017	NA	3039	2961	78	2.6
CN4000900000000	40	009	Beckham County, OK	2017	NA	11310	10876	434	3.8
CN4001100000000	40	011	Blaine County, OK	2017	NA	4626	4498	128	2.8
CN4001300000000	40	013	Bryan County, OK	2017	NA	20412	19633	779	3.8
CN4001500000000	40	015	Caddo County, OK	2017	NA	12391	11849	542	4.4
CN4001700000000	40	017	Canadian County, OK	2017	NA	71166	68680	2486	3.5
CN4001900000000	40	019	Carter County, OK	2017	NA	22491	21479	1012	4.5
CN4002100000000	40	021	Cherokee County, OK	2017	NA	19192	18165	1027	5.4
CN4002300000000	40	023	Choctaw County, OK	2017	NA	5730	5381	349	6.1
CN4002500000000	40	025	Cimarron County, OK	2017	NA	1419	1386	33	2.3
CN4002700000000	40	027	Cleveland County, OK	2017	NA	139944	135066	4878	3.5
CN4002900000000	40	029	Coal County, OK	2017	NA	2276	2155	121	5.3
CN4003100000000	40	031	Comanche County, OK	2017	NA	48989	46848	2141	4.4
CN4003300000000	40	033	Cotton County, OK	2017	NA	2802	2690	112	4
CN4003500000000	40	035	Craig County, OK	2017	NA	6101	5837	264	4.3
CN4003700000000	40	037	Creek County, OK	2017	NA	31539	29977	1562	5
CN4003900000000	40	039	Custer County, OK	2017	NA	15438	14943	495	3.2
CN4004100000000	40	041	Delaware County, OK	2017	NA	18600	17790	810	4.4
CN4004300000000	40	043	Dewey County, OK	2017	NA	2526	2454	72	2.9
CN4004500000000	40	045	Ellis County, OK	2017	NA	2227	2157	70	3.1
CN4004700000000	40	047	Garfield County, OK	2017	NA	27841	26774	1067	3.8
CN4004900000000	40	049	Garvin County, OK	2017	NA	12649	12126	523	4.1
CN4005100000000	40	051	Grady County, OK	2017	NA	26099	25051	1048	4
CN4005300000000	40	053	Grant County, OK	2017	NA	2892	2818	74	2.6
CN4005500000000	40	055	Greer County, OK	2017	NA	2062	1955	107	5.2
CN4005700000000	40	057	Harmon County, OK	2017	NA	1274	1226	48	3.8
CN4005900000000	40	059	Harper County, OK	2017	NA	1877	1820	57	3
CN4006100000000	40	061	Haskell County, OK	2017	NA	4372	4086	286	6.5
CN4006300000000	40	063	Hughes County, OK	2017	NA	5413	5114	299	5.5
CN4006500000000	40	065	Jackson County, OK	2017	NA	10858	10451	407	3.7
CN4006700000000	40	067	Jefferson County, OK	2017	NA	2498	2361	137	5.5
CN4006900000000	40	069	Johnston County, OK	2017	NA	5046	4847	199	3.9
CN4007100000000	40	071	Kay County, OK	2017	NA	19240	18208	1032	5.4
CN4007300000000	40	073	Kingfisher County, OK	2017	NA	8723	8483	240	2.8
CN4007500000000	40	075	Kiowa County, OK	2017	NA	3933	3727	206	5.2
CN4007700000000	40	077	Latimer County, OK	2017	NA	3398	3146	252	7.4
CN4007900000000	40	079	Le Flore County, OK	2017	NA	19373	18261	1112	5.7
CN4008100000000	40	081	Lincoln County, OK	2017	NA	15794	15111	683	4.3
CN4008300000000	40	083	Logan County, OK	2017	NA	21694	20901	793	3.7
CN4008500000000	40	085	Love County, OK	2017	NA	6590	6396	194	2.9
CN4008700000000	40	087	McClain County, OK	2017	NA	19252	18578	674	3.5
CN4008900000000	40	089	McCurtain County, OK	2017	NA	14773	13851	922	6.2
CN4009100000000	40	091	McIntosh County, OK	2017	NA	6951	6420	531	7.6
CN4009300000000	40	093	Major County, OK	2017	NA	4024	3898	126	3.1
CN4009500000000	40	095	Marshall County, OK	2017	NA	6582	6277	305	4.6
CN4009700000000	40	097	Mayes County, OK	2017	NA	19263	18357	906	4.7
CN4009900000000	40	099	Murray County, OK	2017	NA	6407	6171	236	3.7
CN4010100000000	40	101	Muskogee County, OK	2017	NA	29587	28092	1495	5.1
CN4010300000000	40	103	Noble County, OK	2017	NA	5765	5577	188	3.3
CN4010500000000	40	105	Nowata County, OK	2017	NA	4620	4372	248	5.4
CN4010700000000	40	107	Okfuskee County, OK	2017	NA	4466	4199	267	6
CN4010900000000	40	109	Oklahoma County, OK	2017	NA	378349	363326	15023	4
CN4011100000000	40	111	Okmulgee County, OK	2017	NA	15957	14960	997	6.2
CN4011300000000	40	113	Osage County, OK	2017	NA	20786	19720	1066	5.1
CN4011500000000	40	115	Ottawa County, OK	2017	NA	14503	13878	625	4.3
CN4011700000000	40	117	Pawnee County, OK	2017	NA	7411	7019	392	5.3
CN4011900000000	40	119	Payne County, OK	2017	NA	38933	37556	1377	3.5
CN4012100000000	40	121	Pittsburg County, OK	2017	NA	17785	16856	929	5.2
CN4012300000000	40	123	Pontotoc County, OK	2017	NA	18607	17912	695	3.7
CN4012500000000	40	125	Pottawatomie County, OK	2017	NA	33072	31718	1354	4.1
CN4012700000000	40	127	Pushmataha County, OK	2017	NA	4738	4447	291	6.1
CN4012900000000	40	129	Roger Mills County, OK	2017	NA	1885	1824	61	3.2
CN4013100000000	40	131	Rogers County, OK	2017	NA	44666	42713	1953	4.4
CN4013300000000	40	133	Seminole County, OK	2017	NA	9458	8924	534	5.6
CN4013500000000	40	135	Sequoyah County, OK	2017	NA	16602	15701	901	5.4
CN4013700000000	40	137	Stephens County, OK	2017	NA	18219	17102	1117	6.1
CN4013900000000	40	139	Texas County, OK	2017	NA	9378	9088	290	3.1
CN4014100000000	40	141	Tillman County, OK	2017	NA	3273	3136	137	4.2
CN4014300000000	40	143	Tulsa County, OK	2017	NA	320058	306501	13557	4.2
CN4014500000000	40	145	Wagoner County, OK	2017	NA	37101	35489	1612	4.3
CN4014700000000	40	147	Washington County, OK	2017	NA	23262	22221	1041	4.5
CN4014900000000	40	149	Washita County, OK	2017	NA	5377	5142	235	4.4
CN4015100000000	40	151	Woods County, OK	2017	NA	4929	4802	127	2.6
CN4015300000000	40	153	Woodward County, OK	2017	NA	9453	9065	388	4.1
CN4100100000000	41	001	Baker County, OR	2017	NA	7007	6624	383	5.5
CN4100300000000	41	003	Benton County, OR	2017	NA	48283	46719	1564	3.2
CN4100500000000	41	005	Clackamas County, OR	2017	NA	217437	209351	8086	3.7
CN4100700000000	41	007	Clatsop County, OR	2017	NA	19218	18429	789	4.1
CN4100900000000	41	009	Columbia County, OR	2017	NA	24250	23006	1244	5.1
CN4101100000000	41	011	Coos County, OR	2017	NA	26459	25007	1452	5.5
CN4101300000000	41	013	Crook County, OR	2017	NA	9418	8821	597	6.3
CN4101500000000	41	015	Curry County, OR	2017	NA	8966	8422	544	6.1
CN4101700000000	41	017	Deschutes County, OR	2017	NA	93241	89287	3954	4.2
CN4101900000000	41	019	Douglas County, OR	2017	NA	46214	43747	2467	5.3
CN4102100000000	41	021	Gilliam County, OR	2017	NA	855	819	36	4.2
CN4102300000000	41	023	Grant County, OR	2017	NA	3133	2916	217	6.9
CN4102500000000	41	025	Harney County, OR	2017	NA	3410	3196	214	6.3
CN4102700000000	41	027	Hood River County, OR	2017	NA	14345	13831	514	3.6
CN4102900000000	41	029	Jackson County, OR	2017	NA	103238	98355	4883	4.7
CN4103100000000	41	031	Jefferson County, OR	2017	NA	9974	9415	559	5.6
CN4103300000000	41	033	Josephine County, OR	2017	NA	35171	33288	1883	5.4
CN4103500000000	41	035	Klamath County, OR	2017	NA	29548	27801	1747	5.9
CN4103700000000	41	037	Lake County, OR	2017	NA	3509	3309	200	5.7
CN4103900000000	41	039	Lane County, OR	2017	NA	181468	173411	8057	4.4
CN4104100000000	41	041	Lincoln County, OR	2017	NA	21095	20088	1007	4.8
CN4104300000000	41	043	Linn County, OR	2017	NA	57804	55063	2741	4.7
CN4104500000000	41	045	Malheur County, OR	2017	NA	12544	11963	581	4.6
CN4104700000000	41	047	Marion County, OR	2017	NA	160106	153168	6938	4.3
CN4104900000000	41	049	Morrow County, OR	2017	NA	5754	5501	253	4.4
CN4105100000000	41	051	Multnomah County, OR	2017	NA	453416	436974	16442	3.6
CN4105300000000	41	053	Polk County, OR	2017	NA	39312	37609	1703	4.3
CN4105500000000	41	055	Sherman County, OR	2017	NA	898	856	42	4.7
CN4105700000000	41	057	Tillamook County, OR	2017	NA	11748	11249	499	4.2
CN4105900000000	41	059	Umatilla County, OR	2017	NA	36702	34932	1770	4.8
CN4106100000000	41	061	Union County, OR	2017	NA	11973	11342	631	5.3
CN4106300000000	41	063	Wallowa County, OR	2017	NA	3318	3130	188	5.7
CN4106500000000	41	065	Wasco County, OR	2017	NA	13801	13228	573	4.2
CN4106700000000	41	067	Washington County, OR	2017	NA	320427	309262	11165	3.5
CN4106900000000	41	069	Wheeler County, OR	2017	NA	733	704	29	4
CN4107100000000	41	071	Yamhill County, OR	2017	NA	54006	51981	2025	3.7
CN4200100000000	42	001	Adams County, PA	2017	NA	55407	53389	2018	3.6
CN4200300000000	42	003	Allegheny County, PA	2017	NA	646086	615683	30403	4.7
CN4200500000000	42	005	Armstrong County, PA	2017	NA	32337	30356	1981	6.1
CN4200700000000	42	007	Beaver County, PA	2017	NA	84454	79801	4653	5.5
CN4200900000000	42	009	Bedford County, PA	2017	NA	23761	22540	1221	5.1
CN4201100000000	42	011	Berks County, PA	2017	NA	212468	202750	9718	4.6
CN4201300000000	42	013	Blair County, PA	2017	NA	60139	57259	2880	4.8
CN4201500000000	42	015	Bradford County, PA	2017	NA	29301	27806	1495	5.1
CN4201700000000	42	017	Bucks County, PA	2017	NA	340370	326004	14366	4.2
CN4201900000000	42	019	Butler County, PA	2017	NA	98657	94181	4476	4.5
CN4202100000000	42	021	Cambria County, PA	2017	NA	59648	56073	3575	6
CN4202300000000	42	023	Cameron County, PA	2017	NA	2194	2045	149	6.8
CN4202500000000	42	025	Carbon County, PA	2017	NA	31490	29750	1740	5.5
CN4202700000000	42	027	Centre County, PA	2017	NA	79092	76192	2900	3.7
CN4202900000000	42	029	Chester County, PA	2017	NA	281044	271014	10030	3.6
CN4203100000000	42	031	Clarion County, PA	2017	NA	17723	16731	992	5.6
CN4203300000000	42	033	Clearfield County, PA	2017	NA	35859	33750	2109	5.9
CN4203500000000	42	035	Clinton County, PA	2017	NA	18350	17233	1117	6.1
CN4203700000000	42	037	Columbia County, PA	2017	NA	33713	31977	1736	5.1
CN4203900000000	42	039	Crawford County, PA	2017	NA	39437	37286	2151	5.5
CN4204100000000	42	041	Cumberland County, PA	2017	NA	130224	125303	4921	3.8
CN4204300000000	42	043	Dauphin County, PA	2017	NA	142381	136008	6373	4.5
CN4204500000000	42	045	Delaware County, PA	2017	NA	295041	281811	13230	4.5
CN4204700000000	42	047	Elk County, PA	2017	NA	16015	15246	769	4.8
CN4204900000000	42	049	Erie County, PA	2017	NA	130712	123236	7476	5.7
CN4205100000000	42	051	Fayette County, PA	2017	NA	57402	53449	3953	6.9
CN4205300000000	42	053	Forest County, PA	2017	NA	1833	1712	121	6.6
CN4205500000000	42	055	Franklin County, PA	2017	NA	76606	73214	3392	4.4
CN4205700000000	42	057	Fulton County, PA	2017	NA	7249	6883	366	5
CN4205900000000	42	059	Greene County, PA	2017	NA	16794	15810	984	5.9
CN4206100000000	42	061	Huntingdon County, PA	2017	NA	19796	18619	1177	5.9
CN4206300000000	42	063	Indiana County, PA	2017	NA	39238	36966	2272	5.8
CN4206500000000	42	065	Jefferson County, PA	2017	NA	20567	19429	1138	5.5
CN4206700000000	42	067	Juniata County, PA	2017	NA	12379	11813	566	4.6
CN4206900000000	42	069	Lackawanna County, PA	2017	NA	105921	100517	5404	5.1
CN4207100000000	42	071	Lancaster County, PA	2017	NA	279028	268376	10652	3.8
CN4207300000000	42	073	Lawrence County, PA	2017	NA	40631	38186	2445	6
CN4207500000000	42	075	Lebanon County, PA	2017	NA	70748	67844	2904	4.1
CN4207700000000	42	077	Lehigh County, PA	2017	NA	189669	180225	9444	5
CN4207900000000	42	079	Luzerne County, PA	2017	NA	158530	149262	9268	5.8
CN4208100000000	42	081	Lycoming County, PA	2017	NA	57842	54631	3211	5.6
CN4208300000000	42	083	McKean County, PA	2017	NA	18164	17063	1101	6.1
CN4208500000000	42	085	Mercer County, PA	2017	NA	50685	47936	2749	5.4
CN4208700000000	42	087	Mifflin County, PA	2017	NA	20675	19583	1092	5.3
CN4208900000000	42	089	Monroe County, PA	2017	NA	82215	77428	4787	5.8
CN4209100000000	42	091	Montgomery County, PA	2017	NA	448234	431055	17179	3.8
CN4209300000000	42	093	Montour County, PA	2017	NA	9105	8757	348	3.8
CN4209500000000	42	095	Northampton County, PA	2017	NA	158626	150897	7729	4.9
CN4209700000000	42	097	Northumberland County, PA	2017	NA	43661	41205	2456	5.6
CN4209900000000	42	099	Perry County, PA	2017	NA	24294	23260	1034	4.3
CN4210100000000	42	101	Philadelphia County/city, PA	2017	NA	704948	661229	43719	6.2
CN4210300000000	42	103	Pike County, PA	2017	NA	24752	23294	1458	5.9
CN4210500000000	42	105	Potter County, PA	2017	NA	7267	6797	470	6.5
CN4210700000000	42	107	Schuylkill County, PA	2017	NA	66264	62420	3844	5.8
CN4210900000000	42	109	Snyder County, PA	2017	NA	20717	19810	907	4.4
CN4211100000000	42	111	Somerset County, PA	2017	NA	33634	31613	2021	6
CN4211300000000	42	113	Sullivan County, PA	2017	NA	2689	2530	159	5.9
CN4211500000000	42	115	Susquehanna County, PA	2017	NA	20597	19628	969	4.7
CN4211700000000	42	117	Tioga County, PA	2017	NA	19113	17981	1132	5.9
CN4211900000000	42	119	Union County, PA	2017	NA	19675	18822	853	4.3
CN4212100000000	42	121	Venango County, PA	2017	NA	22955	21564	1391	6.1
CN4212300000000	42	123	Warren County, PA	2017	NA	19301	18289	1012	5.2
CN4212500000000	42	125	Washington County, PA	2017	NA	106359	100831	5528	5.2
CN4212700000000	42	127	Wayne County, PA	2017	NA	22413	21276	1137	5.1
CN4212900000000	42	129	Westmoreland County, PA	2017	NA	180797	171495	9302	5.1
CN4213100000000	42	131	Wyoming County, PA	2017	NA	13846	13119	727	5.3
CN4213300000000	42	133	York County, PA	2017	NA	234928	224744	10184	4.3
CN4400100000000	44	001	Bristol County, RI	2017	NA	25955	24970	985	3.8
CN4400300000000	44	003	Kent County, RI	2017	NA	90048	86403	3645	4
CN4400500000000	44	005	Newport County, RI	2017	NA	44424	42713	1711	3.9
CN4400700000000	44	007	Providence County, RI	2017	NA	323972	308660	15312	4.7
CN4400900000000	44	009	Washington County, RI	2017	NA	68725	66001	2724	4
CN4500100000000	45	001	Abbeville County, SC	2017	NA	9973	9514	459	4.6
CN4500300000000	45	003	Aiken County, SC	2017	NA	74086	71044	3042	4.1
CN4500500000000	45	005	Allendale County, SC	2017	NA	2706	2519	187	6.9
CN4500700000000	45	007	Anderson County, SC	2017	NA	89513	85993	3520	3.9
CN4500900000000	45	009	Bamberg County, SC	2017	NA	5145	4760	385	7.5
CN4501100000000	45	011	Barnwell County, SC	2017	NA	8019	7535	484	6
CN4501300000000	45	013	Beaufort County, SC	2017	NA	74382	71349	3033	4.1
CN4501500000000	45	015	Berkeley County, SC	2017	NA	99953	96123	3830	3.8
CN4501700000000	45	017	Calhoun County, SC	2017	NA	6745	6393	352	5.2
CN4501900000000	45	019	Charleston County, SC	2017	NA	203901	196750	7151	3.5
CN4502100000000	45	021	Cherokee County, SC	2017	NA	23843	22659	1184	5
CN4502300000000	45	023	Chester County, SC	2017	NA	13320	12505	815	6.1
CN4502500000000	45	025	Chesterfield County, SC	2017	NA	21511	20579	932	4.3
CN4502700000000	45	027	Clarendon County, SC	2017	NA	12392	11652	740	6
CN4502900000000	45	029	Colleton County, SC	2017	NA	16618	15820	798	4.8
CN4503100000000	45	031	Darlington County, SC	2017	NA	29926	28348	1578	5.3
CN4503300000000	45	033	Dillon County, SC	2017	NA	12464	11751	713	5.7
CN4503500000000	45	035	Dorchester County, SC	2017	NA	74246	71377	2869	3.9
CN4503700000000	45	037	Edgefield County, SC	2017	NA	10592	10108	484	4.6
CN4503900000000	45	039	Fairfield County, SC	2017	NA	9933	9201	732	7.4
CN4504100000000	45	041	Florence County, SC	2017	NA	65462	62493	2969	4.5
CN4504300000000	45	043	Georgetown County, SC	2017	NA	24905	23512	1393	5.6
CN4504500000000	45	045	Greenville County, SC	2017	NA	248650	239569	9081	3.7
CN4504700000000	45	047	Greenwood County, SC	2017	NA	30761	29369	1392	4.5
CN4504900000000	45	049	Hampton County, SC	2017	NA	8120	7759	361	4.4
CN4505100000000	45	051	Horry County, SC	2017	NA	143776	136558	7218	5
CN4505300000000	45	053	Jasper County, SC	2017	NA	12032	11587	445	3.7
CN4505500000000	45	055	Kershaw County, SC	2017	NA	29275	27958	1317	4.5
CN4505700000000	45	057	Lancaster County, SC	2017	NA	39423	37583	1840	4.7
CN4505900000000	45	059	Laurens County, SC	2017	NA	29876	28564	1312	4.4
CN4506100000000	45	061	Lee County, SC	2017	NA	6403	6020	383	6
CN4506300000000	45	063	Lexington County, SC	2017	NA	148762	143404	5358	3.6
CN4506500000000	45	065	McCormick County, SC	2017	NA	3372	3219	153	4.5
CN4506700000000	45	067	Marion County, SC	2017	NA	12473	11552	921	7.4
CN4506900000000	45	069	Marlboro County, SC	2017	NA	9155	8555	600	6.6
CN4507100000000	45	071	Newberry County, SC	2017	NA	18421	17649	772	4.2
CN4507300000000	45	073	Oconee County, SC	2017	NA	34113	32618	1495	4.4
CN4507500000000	45	075	Orangeburg County, SC	2017	NA	34657	32170	2487	7.2
CN4507700000000	45	077	Pickens County, SC	2017	NA	56283	53956	2327	4.1
CN4507900000000	45	079	Richland County, SC	2017	NA	199166	190672	8494	4.3
CN4508100000000	45	081	Saluda County, SC	2017	NA	8883	8534	349	3.9
CN4508300000000	45	083	Spartanburg County, SC	2017	NA	146695	140787	5908	4
CN4508500000000	45	085	Sumter County, SC	2017	NA	44030	41734	2296	5.2
CN4508700000000	45	087	Union County, SC	2017	NA	11533	10909	624	5.4
CN4508900000000	45	089	Williamsburg County, SC	2017	NA	12159	11385	774	6.4
CN4509100000000	45	091	York County, SC	2017	NA	134117	128751	5366	4
CN4600300000000	46	003	Aurora County, SD	2017	NA	1523	1481	42	2.8
CN4600500000000	46	005	Beadle County, SD	2017	NA	9391	9132	259	2.8
CN4600700000000	46	007	Bennett County, SD	2017	NA	1114	1066	48	4.3
CN4600900000000	46	009	Bon Homme County, SD	2017	NA	2915	2832	83	2.8
CN4601100000000	46	011	Brookings County, SD	2017	NA	18826	18252	574	3
CN4601300000000	46	013	Brown County, SD	2017	NA	20948	20340	608	2.9
CN4601500000000	46	015	Brule County, SD	2017	NA	2481	2408	73	2.9
CN4601700000000	46	017	Buffalo County, SD	2017	NA	708	657	51	7.2
CN4601900000000	46	019	Butte County, SD	2017	NA	5026	4853	173	3.4
CN4602100000000	46	021	Campbell County, SD	2017	NA	833	805	28	3.4
CN4602300000000	46	023	Charles Mix County, SD	2017	NA	3887	3749	138	3.6
CN4602500000000	46	025	Clark County, SD	2017	NA	1885	1801	84	4.5
CN4602700000000	46	027	Clay County, SD	2017	NA	7127	6900	227	3.2
CN4602900000000	46	029	Codington County, SD	2017	NA	15223	14729	494	3.2
CN4603100000000	46	031	Corson County, SD	2017	NA	1423	1365	58	4.1
CN4603300000000	46	033	Custer County, SD	2017	NA	4036	3868	168	4.2
CN4603500000000	46	035	Davison County, SD	2017	NA	11033	10722	311	2.8
CN4603700000000	46	037	Day County, SD	2017	NA	2827	2716	111	3.9
CN4603900000000	46	039	Deuel County, SD	2017	NA	2197	2093	104	4.7
CN4604100000000	46	041	Dewey County, SD	2017	NA	2248	2027	221	9.8
CN4604300000000	46	043	Douglas County, SD	2017	NA	1596	1550	46	2.9
CN4604500000000	46	045	Edmunds County, SD	2017	NA	2115	2057	58	2.7
CN4604700000000	46	047	Fall River County, SD	2017	NA	2981	2864	117	3.9
CN4604900000000	46	049	Faulk County, SD	2017	NA	1101	1068	33	3
CN4605100000000	46	051	Grant County, SD	2017	NA	4455	4303	152	3.4
CN4605300000000	46	053	Gregory County, SD	2017	NA	2054	1984	70	3.4
CN4605500000000	46	055	Haakon County, SD	2017	NA	1103	1073	30	2.7
CN4605700000000	46	057	Hamlin County, SD	2017	NA	3151	3040	111	3.5
CN4605900000000	46	059	Hand County, SD	2017	NA	1824	1781	43	2.4
CN4606100000000	46	061	Hanson County, SD	2017	NA	1772	1702	70	4
CN4606300000000	46	063	Harding County, SD	2017	NA	727	706	21	2.9
CN4606500000000	46	065	Hughes County, SD	2017	NA	10021	9753	268	2.7
CN4606700000000	46	067	Hutchinson County, SD	2017	NA	3611	3504	107	3
CN4606900000000	46	069	Hyde County, SD	2017	NA	685	664	21	3.1
CN4607100000000	46	071	Jackson County, SD	2017	NA	1324	1251	73	5.5
CN4607300000000	46	073	Jerauld County, SD	2017	NA	1140	1113	27	2.4
CN4607500000000	46	075	Jones County, SD	2017	NA	561	545	16	2.9
CN4607700000000	46	077	Kingsbury County, SD	2017	NA	2678	2596	82	3.1
CN4607900000000	46	079	Lake County, SD	2017	NA	6505	6262	243	3.7
CN4608100000000	46	081	Lawrence County, SD	2017	NA	13052	12636	416	3.2
CN4608300000000	46	083	Lincoln County, SD	2017	NA	32965	32172	793	2.4
CN4608500000000	46	085	Lyman County, SD	2017	NA	1747	1662	85	4.9
CN4608700000000	46	087	McCook County, SD	2017	NA	3060	2977	83	2.7
CN4608900000000	46	089	McPherson County, SD	2017	NA	1050	1015	35	3.3
CN4609100000000	46	091	Marshall County, SD	2017	NA	2400	2295	105	4.4
CN4609300000000	46	093	Meade County, SD	2017	NA	13965	13501	464	3.3
CN4609500000000	46	095	Mellette County, SD	2017	NA	764	728	36	4.7
CN4609700000000	46	097	Miner County, SD	2017	NA	1195	1161	34	2.8
CN4609900000000	46	099	Minnehaha County, SD	2017	NA	109321	106305	3016	2.8
CN4610100000000	46	101	Moody County, SD	2017	NA	3984	3841	143	3.6
CN4610200000000	46	102	Oglala Lakota County, SD	2017	NA	3624	3216	408	11.3
CN4610300000000	46	103	Pennington County, SD	2017	NA	55732	53902	1830	3.3
CN4610500000000	46	105	Perkins County, SD	2017	NA	1592	1548	44	2.8
CN4610700000000	46	107	Potter County, SD	2017	NA	1123	1086	37	3.3
CN4610900000000	46	109	Roberts County, SD	2017	NA	4822	4597	225	4.7
CN4611100000000	46	111	Sanborn County, SD	2017	NA	1176	1135	41	3.5
CN4611500000000	46	115	Spink County, SD	2017	NA	3232	3125	107	3.3
CN4611700000000	46	117	Stanley County, SD	2017	NA	1866	1806	60	3.2
CN4611900000000	46	119	Sully County, SD	2017	NA	835	809	26	3.1
CN4612100000000	46	121	Todd County, SD	2017	NA	3138	2935	203	6.5
CN4612300000000	46	123	Tripp County, SD	2017	NA	3038	2954	84	2.8
CN4612500000000	46	125	Turner County, SD	2017	NA	4674	4527	147	3.1
CN4612700000000	46	127	Union County, SD	2017	NA	8045	7761	284	3.5
CN4612900000000	46	129	Walworth County, SD	2017	NA	2237	2127	110	4.9
CN4613500000000	46	135	Yankton County, SD	2017	NA	11611	11282	329	2.8
CN4613700000000	46	137	Ziebach County, SD	2017	NA	939	890	49	5.2
CN4700100000000	47	001	Anderson County, TN	2017	NA	33790	32451	1339	4
CN4700300000000	47	003	Bedford County, TN	2017	NA	20479	19665	814	4
CN4700500000000	47	005	Benton County, TN	2017	NA	6703	6338	365	5.4
CN4700700000000	47	007	Bledsoe County, TN	2017	NA	4286	4032	254	5.9
CN4700900000000	47	009	Blount County, TN	2017	NA	61461	59282	2179	3.5
CN4701100000000	47	011	Bradley County, TN	2017	NA	50727	48868	1859	3.7
CN4701300000000	47	013	Campbell County, TN	2017	NA	14581	13817	764	5.2
CN4701500000000	47	015	Cannon County, TN	2017	NA	6183	5962	221	3.6
CN4701700000000	47	017	Carroll County, TN	2017	NA	11904	11287	617	5.2
CN4701900000000	47	019	Carter County, TN	2017	NA	23814	22723	1091	4.6
CN4702100000000	47	021	Cheatham County, TN	2017	NA	20791	20149	642	3.1
CN4702300000000	47	023	Chester County, TN	2017	NA	8312	7979	333	4
CN4702500000000	47	025	Claiborne County, TN	2017	NA	12675	12072	603	4.8
CN4702700000000	47	027	Clay County, TN	2017	NA	3025	2869	156	5.2
CN4702900000000	47	029	Cocke County, TN	2017	NA	14564	13795	769	5.3
CN4703100000000	47	031	Coffee County, TN	2017	NA	24881	23963	918	3.7
CN4703300000000	47	033	Crockett County, TN	2017	NA	6941	6651	290	4.2
CN4703500000000	47	035	Cumberland County, TN	2017	NA	23327	22235	1092	4.7
CN4703700000000	47	037	Davidson County, TN	2017	NA	383649	372829	10820	2.8
CN4703900000000	47	039	Decatur County, TN	2017	NA	4658	4414	244	5.2
CN4704100000000	47	041	DeKalb County, TN	2017	NA	7643	7273	370	4.8
CN4704300000000	47	043	Dickson County, TN	2017	NA	25459	24599	860	3.4
CN4704500000000	47	045	Dyer County, TN	2017	NA	16048	15264	784	4.9
CN4704700000000	47	047	Fayette County, TN	2017	NA	18538	17790	748	4
CN4704900000000	47	049	Fentress County, TN	2017	NA	7070	6747	323	4.6
CN4705100000000	47	051	Franklin County, TN	2017	NA	19785	19030	755	3.8
CN4705300000000	47	053	Gibson County, TN	2017	NA	21219	20240	979	4.6
CN4705500000000	47	055	Giles County, TN	2017	NA	15499	14966	533	3.4
CN4705700000000	47	057	Grainger County, TN	2017	NA	9295	8897	398	4.3
CN4705900000000	47	059	Greene County, TN	2017	NA	30267	28873	1394	4.6
CN4706100000000	47	061	Grundy County, TN	2017	NA	4816	4573	243	5
CN4706300000000	47	063	Hamblen County, TN	2017	NA	27222	26111	1111	4.1
CN4706500000000	47	065	Hamilton County, TN	2017	NA	176088	169603	6485	3.7
CN4706700000000	47	067	Hancock County, TN	2017	NA	2039	1920	119	5.8
CN4706900000000	47	069	Hardeman County, TN	2017	NA	9189	8707	482	5.2
CN4707100000000	47	071	Hardin County, TN	2017	NA	10368	9874	494	4.8
CN4707300000000	47	073	Hawkins County, TN	2017	NA	23603	22588	1015	4.3
CN4707500000000	47	075	Haywood County, TN	2017	NA	7776	7367	409	5.3
CN4707700000000	47	077	Henderson County, TN	2017	NA	11858	11243	615	5.2
CN4707900000000	47	079	Henry County, TN	2017	NA	13937	13299	638	4.6
CN4708100000000	47	081	Hickman County, TN	2017	NA	10809	10434	375	3.5
CN4708300000000	47	083	Houston County, TN	2017	NA	3193	3005	188	5.9
CN4708500000000	47	085	Humphreys County, TN	2017	NA	8767	8384	383	4.4
CN4708700000000	47	087	Jackson County, TN	2017	NA	4584	4337	247	5.4
CN4708900000000	47	089	Jefferson County, TN	2017	NA	23835	22863	972	4.1
CN4709100000000	47	091	Johnson County, TN	2017	NA	7573	7274	299	3.9
CN4709300000000	47	093	Knox County, TN	2017	NA	236767	229187	7580	3.2
CN4709500000000	47	095	Lake County, TN	2017	NA	1835	1732	103	5.6
CN4709700000000	47	097	Lauderdale County, TN	2017	NA	9376	8830	546	5.8
CN4709900000000	47	099	Lawrence County, TN	2017	NA	17737	16951	786	4.4
CN4710100000000	47	101	Lewis County, TN	2017	NA	4932	4705	227	4.6
CN4710300000000	47	103	Lincoln County, TN	2017	NA	16243	15708	535	3.3
CN4710500000000	47	105	Loudon County, TN	2017	NA	22580	21741	839	3.7
CN4710700000000	47	107	McMinn County, TN	2017	NA	22606	21608	998	4.4
CN4710900000000	47	109	McNairy County, TN	2017	NA	8519	8035	484	5.7
CN4711100000000	47	111	Macon County, TN	2017	NA	10680	10310	370	3.5
CN4711300000000	47	113	Madison County, TN	2017	NA	47954	46050	1904	4
CN4711500000000	47	115	Marion County, TN	2017	NA	12009	11420	589	4.9
CN4711700000000	47	117	Marshall County, TN	2017	NA	15051	14520	531	3.5
CN4711900000000	47	119	Maury County, TN	2017	NA	45890	44388	1502	3.3
CN4712100000000	47	121	Meigs County, TN	2017	NA	4985	4722	263	5.3
CN4712300000000	47	123	Monroe County, TN	2017	NA	19596	18802	794	4.1
CN4712500000000	47	125	Montgomery County, TN	2017	NA	81765	78386	3379	4.1
CN4712700000000	47	127	Moore County, TN	2017	NA	3471	3361	110	3.2
CN4712900000000	47	129	Morgan County, TN	2017	NA	7780	7397	383	4.9
CN4713100000000	47	131	Obion County, TN	2017	NA	12185	11510	675	5.5
CN4713300000000	47	133	Overton County, TN	2017	NA	9500	9104	396	4.2
CN4713500000000	47	135	Perry County, TN	2017	NA	3229	3072	157	4.9
CN4713700000000	47	137	Pickett County, TN	2017	NA	2442	2333	109	4.5
CN4713900000000	47	139	Polk County, TN	2017	NA	7372	7033	339	4.6
CN4714100000000	47	141	Putnam County, TN	2017	NA	33897	32595	1302	3.8
CN4714300000000	47	143	Rhea County, TN	2017	NA	13198	12335	863	6.5
CN4714500000000	47	145	Roane County, TN	2017	NA	22869	21852	1017	4.4
CN4714700000000	47	147	Robertson County, TN	2017	NA	35874	34637	1237	3.4
CN4714900000000	47	149	Rutherford County, TN	2017	NA	171109	166081	5028	2.9
CN4715100000000	47	151	Scott County, TN	2017	NA	8146	7728	418	5.1
CN4715300000000	47	153	Sequatchie County, TN	2017	NA	5947	5644	303	5.1
CN4715500000000	47	155	Sevier County, TN	2017	NA	52007	49906	2101	4
CN4715700000000	47	157	Shelby County, TN	2017	NA	436135	417021	19114	4.4
CN4715900000000	47	159	Smith County, TN	2017	NA	8892	8570	322	3.6
CN4716100000000	47	161	Stewart County, TN	2017	NA	5171	4891	280	5.4
CN4716300000000	47	163	Sullivan County, TN	2017	NA	69799	66959	2840	4.1
CN4716500000000	47	165	Sumner County, TN	2017	NA	95538	92656	2882	3
CN4716700000000	47	167	Tipton County, TN	2017	NA	27526	26297	1229	4.5
CN4716900000000	47	169	Trousdale County, TN	2017	NA	4736	4571	165	3.5
CN4717100000000	47	171	Unicoi County, TN	2017	NA	7033	6652	381	5.4
CN4717300000000	47	173	Union County, TN	2017	NA	7359	7033	326	4.4
CN4717500000000	47	175	Van Buren County, TN	2017	NA	2083	1994	89	4.3
CN4717700000000	47	177	Warren County, TN	2017	NA	17111	16429	682	4
CN4717900000000	47	179	Washington County, TN	2017	NA	59352	57093	2259	3.8
CN4718100000000	47	181	Wayne County, TN	2017	NA	6108	5784	324	5.3
CN4718300000000	47	183	Weakley County, TN	2017	NA	15725	14954	771	4.9
CN4718500000000	47	185	White County, TN	2017	NA	11872	11395	477	4
CN4718700000000	47	187	Williamson County, TN	2017	NA	119252	116005	3247	2.7
CN4718900000000	47	189	Wilson County, TN	2017	NA	70776	68655	2121	3
CN4800100000000	48	001	Anderson County, TX	2017	NA	23259	22413	846	3.6
CN4800300000000	48	003	Andrews County, TX	2017	NA	9002	8724	278	3.1
CN4800500000000	48	005	Angelina County, TX	2017	NA	36648	34786	1862	5.1
CN4800700000000	48	007	Aransas County, TX	2017	NA	10332	9628	704	6.8
CN4800900000000	48	009	Archer County, TX	2017	NA	4142	4003	139	3.4
CN4801100000000	48	011	Armstrong County, TX	2017	NA	918	894	24	2.6
CN4801300000000	48	013	Atascosa County, TX	2017	NA	20943	20052	891	4.3
CN4801500000000	48	015	Austin County, TX	2017	NA	13805	13197	608	4.4
CN4801700000000	48	017	Bailey County, TX	2017	NA	2661	2547	114	4.3
CN4801900000000	48	019	Bandera County, TX	2017	NA	9741	9389	352	3.6
CN4802100000000	48	021	Bastrop County, TX	2017	NA	40197	38756	1441	3.6
CN4802300000000	48	023	Baylor County, TX	2017	NA	1589	1535	54	3.4
CN4802500000000	48	025	Bee County, TX	2017	NA	9970	9325	645	6.5
CN4802700000000	48	027	Bell County, TX	2017	NA	142118	136070	6048	4.3
CN4802900000000	48	029	Bexar County, TX	2017	NA	924257	891563	32694	3.5
CN4803100000000	48	031	Blanco County, TX	2017	NA	6228	6057	171	2.7
CN4803300000000	48	033	Borden County, TX	2017	NA	322	311	11	3.4
CN4803500000000	48	035	Bosque County, TX	2017	NA	8197	7870	327	4
CN4803700000000	48	037	Bowie County, TX	2017	NA	39276	37479	1797	4.6
CN4803900000000	48	039	Brazoria County, TX	2017	NA	173279	164089	9190	5.3
CN4804100000000	48	041	Brazos County, TX	2017	NA	113040	109558	3482	3.1
CN4804300000000	48	043	Brewster County, TX	2017	NA	3968	3829	139	3.5
CN4804500000000	48	045	Briscoe County, TX	2017	NA	554	530	24	4.3
CN4804700000000	48	047	Brooks County, TX	2017	NA	2433	2232	201	8.3
CN4804900000000	48	049	Brown County, TX	2017	NA	16091	15468	623	3.9
CN4805100000000	48	051	Burleson County, TX	2017	NA	7992	7657	335	4.2
CN4805300000000	48	053	Burnet County, TX	2017	NA	22274	21567	707	3.2
CN4805500000000	48	055	Caldwell County, TX	2017	NA	18510	17785	725	3.9
CN4805700000000	48	057	Calhoun County, TX	2017	NA	10497	9891	606	5.8
CN4805900000000	48	059	Callahan County, TX	2017	NA	5912	5697	215	3.6
CN4806100000000	48	061	Cameron County, TX	2017	NA	166244	154709	11535	6.9
CN4806300000000	48	063	Camp County, TX	2017	NA	5027	4743	284	5.6
CN4806500000000	48	065	Carson County, TX	2017	NA	3030	2932	98	3.2
CN4806700000000	48	067	Cass County, TX	2017	NA	12192	11467	725	5.9
CN4806900000000	48	069	Castro County, TX	2017	NA	3394	3282	112	3.3
CN4807100000000	48	071	Chambers County, TX	2017	NA	18922	17693	1229	6.5
CN4807300000000	48	073	Cherokee County, TX	2017	NA	20779	19837	942	4.5
CN4807500000000	48	075	Childress County, TX	2017	NA	2910	2824	86	3
CN4807700000000	48	077	Clay County, TX	2017	NA	4903	4731	172	3.5
CN4807900000000	48	079	Cochran County, TX	2017	NA	1133	1081	52	4.6
CN4808100000000	48	081	Coke County, TX	2017	NA	1400	1348	52	3.7
CN4808300000000	48	083	Coleman County, TX	2017	NA	3068	2931	137	4.5
CN4808500000000	48	085	Collin County, TX	2017	NA	532152	513771	18381	3.5
CN4808700000000	48	087	Collingsworth County, TX	2017	NA	1166	1125	41	3.5
CN4808900000000	48	089	Colorado County, TX	2017	NA	9748	9359	389	4
CN4809100000000	48	091	Comal County, TX	2017	NA	68795	66483	2312	3.4
CN4809300000000	48	093	Comanche County, TX	2017	NA	5304	5109	195	3.7
CN4809500000000	48	095	Concho County, TX	2017	NA	1213	1162	51	4.2
CN4809700000000	48	097	Cooke County, TX	2017	NA	18854	18175	679	3.6
CN4809900000000	48	099	Coryell County, TX	2017	NA	24400	23332	1068	4.4
CN4810100000000	48	101	Cottle County, TX	2017	NA	520	498	22	4.2
CN4810300000000	48	103	Crane County, TX	2017	NA	1594	1510	84	5.3
CN4810500000000	48	105	Crockett County, TX	2017	NA	1679	1611	68	4.1
CN4810700000000	48	107	Crosby County, TX	2017	NA	2547	2440	107	4.2
CN4810900000000	48	109	Culberson County, TX	2017	NA	923	889	34	3.7
CN4811100000000	48	111	Dallam County, TX	2017	NA	4060	3973	87	2.1
CN4811300000000	48	113	Dallas County, TX	2017	NA	1326972	1274970	52002	3.9
CN4811500000000	48	115	Dawson County, TX	2017	NA	4631	4407	224	4.8
CN4811700000000	48	117	Deaf Smith County, TX	2017	NA	8349	8095	254	3
CN4811900000000	48	119	Delta County, TX	2017	NA	2548	2462	86	3.4
CN4812100000000	48	121	Denton County, TX	2017	NA	471180	455462	15718	3.3
CN4812300000000	48	123	DeWitt County, TX	2017	NA	9582	9163	419	4.4
CN4812500000000	48	125	Dickens County, TX	2017	NA	680	647	33	4.9
CN4812700000000	48	127	Dimmit County, TX	2017	NA	6489	6161	328	5.1
CN4812900000000	48	129	Donley County, TX	2017	NA	1503	1449	54	3.6
CN4813100000000	48	131	Duval County, TX	2017	NA	4801	4433	368	7.7
CN4813300000000	48	133	Eastland County, TX	2017	NA	7941	7602	339	4.3
CN4813500000000	48	135	Ector County, TX	2017	NA	78564	75345	3219	4.1
CN4813700000000	48	137	Edwards County, TX	2017	NA	906	877	29	3.2
CN4813900000000	48	139	Ellis County, TX	2017	NA	87802	84756	3046	3.5
CN4814100000000	48	141	El Paso County, TX	2017	NA	354160	337807	16353	4.6
CN4814300000000	48	143	Erath County, TX	2017	NA	20687	19981	706	3.4
CN4814500000000	48	145	Falls County, TX	2017	NA	6648	6367	281	4.2
CN4814700000000	48	147	Fannin County, TX	2017	NA	15952	15420	532	3.3
CN4814900000000	48	149	Fayette County, TX	2017	NA	12577	12176	401	3.2
CN4815100000000	48	151	Fisher County, TX	2017	NA	1704	1643	61	3.6
CN4815300000000	48	153	Floyd County, TX	2017	NA	2701	2554	147	5.4
CN4815500000000	48	155	Foard County, TX	2017	NA	595	574	21	3.5
CN4815700000000	48	157	Fort Bend County, TX	2017	NA	375627	358184	17443	4.6
CN4815900000000	48	159	Franklin County, TX	2017	NA	4544	4333	211	4.6
CN4816100000000	48	161	Freestone County, TX	2017	NA	6755	6325	430	6.4
CN4816300000000	48	163	Frio County, TX	2017	NA	9364	8996	368	3.9
CN4816500000000	48	165	Gaines County, TX	2017	NA	9248	8968	280	3
CN4816700000000	48	167	Galveston County, TX	2017	NA	161977	153462	8515	5.3
CN4816900000000	48	169	Garza County, TX	2017	NA	2121	2051	70	3.3
CN4817100000000	48	171	Gillespie County, TX	2017	NA	13136	12795	341	2.6
CN4817300000000	48	173	Glasscock County, TX	2017	NA	709	690	19	2.7
CN4817500000000	48	175	Goliad County, TX	2017	NA	3276	3115	161	4.9
CN4817700000000	48	177	Gonzales County, TX	2017	NA	9372	9046	326	3.5
CN4817900000000	48	179	Gray County, TX	2017	NA	8234	7802	432	5.2
CN4818100000000	48	181	Grayson County, TX	2017	NA	61945	59749	2196	3.5
CN4818300000000	48	183	Gregg County, TX	2017	NA	57403	54442	2961	5.2
CN4818500000000	48	185	Grimes County, TX	2017	NA	10884	10302	582	5.3
CN4818700000000	48	187	Guadalupe County, TX	2017	NA	78444	75830	2614	3.3
CN4818900000000	48	189	Hale County, TX	2017	NA	12514	11874	640	5.1
CN4819100000000	48	191	Hall County, TX	2017	NA	1129	1060	69	6.1
CN4819300000000	48	193	Hamilton County, TX	2017	NA	3621	3479	142	3.9
CN4819500000000	48	195	Hansford County, TX	2017	NA	2862	2789	73	2.6
CN4819700000000	48	197	Hardeman County, TX	2017	NA	1659	1593	66	4
CN4819900000000	48	199	Hardin County, TX	2017	NA	25303	23752	1551	6.1
CN4820100000000	48	201	Harris County, TX	2017	NA	2265691	2150927	114764	5.1
CN4820300000000	48	203	Harrison County, TX	2017	NA	29464	27926	1538	5.2
CN4820500000000	48	205	Hartley County, TX	2017	NA	2940	2883	57	1.9
CN4820700000000	48	207	Haskell County, TX	2017	NA	2438	2321	117	4.8
CN4820900000000	48	209	Hays County, TX	2017	NA	110721	107235	3486	3.1
CN4821100000000	48	211	Hemphill County, TX	2017	NA	2315	2257	58	2.5
CN4821300000000	48	213	Henderson County, TX	2017	NA	35640	34153	1487	4.2
CN4821500000000	48	215	Hidalgo County, TX	2017	NA	342969	317398	25571	7.5
CN4821700000000	48	217	Hill County, TX	2017	NA	16170	15534	636	3.9
CN4821900000000	48	219	Hockley County, TX	2017	NA	11262	10844	418	3.7
CN4822100000000	48	221	Hood County, TX	2017	NA	25925	24835	1090	4.2
CN4822300000000	48	223	Hopkins County, TX	2017	NA	17169	16552	617	3.6
CN4822500000000	48	225	Houston County, TX	2017	NA	10387	9937	450	4.3
CN4822700000000	48	227	Howard County, TX	2017	NA	13220	12657	563	4.3
CN4822900000000	48	229	Hudspeth County, TX	2017	NA	1664	1568	96	5.8
CN4823100000000	48	231	Hunt County, TX	2017	NA	41383	39733	1650	4
CN4823300000000	48	233	Hutchinson County, TX	2017	NA	9400	8832	568	6
CN4823500000000	48	235	Irion County, TX	2017	NA	756	733	23	3
CN4823700000000	48	237	Jack County, TX	2017	NA	3953	3806	147	3.7
CN4823900000000	48	239	Jackson County, TX	2017	NA	7374	7080	294	4
CN4824100000000	48	241	Jasper County, TX	2017	NA	13448	12446	1002	7.5
CN4824300000000	48	243	Jeff Davis County, TX	2017	NA	1067	1033	34	3.2
CN4824500000000	48	245	Jefferson County, TX	2017	NA	107606	99675	7931	7.4
CN4824700000000	48	247	Jim Hogg County, TX	2017	NA	1906	1767	139	7.3
CN4824900000000	48	249	Jim Wells County, TX	2017	NA	16653	15391	1262	7.6
CN4825100000000	48	251	Johnson County, TX	2017	NA	78088	75128	2960	3.8
CN4825300000000	48	253	Jones County, TX	2017	NA	5650	5349	301	5.3
CN4825500000000	48	255	Karnes County, TX	2017	NA	6448	6223	225	3.5
CN4825700000000	48	257	Kaufman County, TX	2017	NA	60334	58196	2138	3.5
CN4825900000000	48	259	Kendall County, TX	2017	NA	21094	20446	648	3.1
CN4826100000000	48	261	Kenedy County, TX	2017	NA	242	234	8	3.3
CN4826300000000	48	263	Kent County, TX	2017	NA	454	442	12	2.6
CN4826500000000	48	265	Kerr County, TX	2017	NA	21336	20609	727	3.4
CN4826700000000	48	267	Kimble County, TX	2017	NA	1891	1824	67	3.5
CN4826900000000	48	269	King County, TX	2017	NA	165	159	6	3.6
CN4827100000000	48	271	Kinney County, TX	2017	NA	1166	1101	65	5.6
CN4827300000000	48	273	Kleberg County, TX	2017	NA	13396	12604	792	5.9
CN4827500000000	48	275	Knox County, TX	2017	NA	1484	1425	59	4
CN4827700000000	48	277	Lamar County, TX	2017	NA	23756	22760	996	4.2
CN4827900000000	48	279	Lamb County, TX	2017	NA	5191	4923	268	5.2
CN4828100000000	48	281	Lampasas County, TX	2017	NA	9213	8869	344	3.7
CN4828300000000	48	283	La Salle County, TX	2017	NA	4206	4052	154	3.7
CN4828500000000	48	285	Lavaca County, TX	2017	NA	8735	8420	315	3.6
CN4828700000000	48	287	Lee County, TX	2017	NA	9540	9225	315	3.3
CN4828900000000	48	289	Leon County, TX	2017	NA	6188	5797	391	6.3
CN4829100000000	48	291	Liberty County, TX	2017	NA	31979	29702	2277	7.1
CN4829300000000	48	293	Limestone County, TX	2017	NA	8316	7853	463	5.6
CN4829500000000	48	295	Lipscomb County, TX	2017	NA	1625	1573	52	3.2
CN4829700000000	48	297	Live Oak County, TX	2017	NA	5418	5165	253	4.7
CN4829900000000	48	299	Llano County, TX	2017	NA	8366	8048	318	3.8
CN4830100000000	48	301	Loving County, TX	2017	NA	100	95	5	5
CN4830300000000	48	303	Lubbock County, TX	2017	NA	155992	151032	4960	3.2
CN4830500000000	48	305	Lynn County, TX	2017	NA	2773	2669	104	3.8
CN4830700000000	48	307	McCulloch County, TX	2017	NA	3685	3555	130	3.5
CN4830900000000	48	309	McLennan County, TX	2017	NA	118071	113493	4578	3.9
CN4831100000000	48	311	McMullen County, TX	2017	NA	749	735	14	1.9
CN4831300000000	48	313	Madison County, TX	2017	NA	4686	4465	221	4.7
CN4831500000000	48	315	Marion County, TX	2017	NA	4336	4090	246	5.7
CN4831700000000	48	317	Martin County, TX	2017	NA	2525	2444	81	3.2
CN4831900000000	48	319	Mason County, TX	2017	NA	1814	1753	61	3.4
CN4832100000000	48	321	Matagorda County, TX	2017	NA	16903	15671	1232	7.3
CN4832300000000	48	323	Maverick County, TX	2017	NA	23924	21690	2234	9.3
CN4832500000000	48	325	Medina County, TX	2017	NA	21282	20457	825	3.9
CN4832700000000	48	327	Menard County, TX	2017	NA	806	767	39	4.8
CN4832900000000	48	329	Midland County, TX	2017	NA	90759	88048	2711	3
CN4833100000000	48	331	Milam County, TX	2017	NA	10094	9586	508	5
CN4833300000000	48	333	Mills County, TX	2017	NA	1912	1844	68	3.6
CN4833500000000	48	335	Mitchell County, TX	2017	NA	2498	2362	136	5.4
CN4833700000000	48	337	Montague County, TX	2017	NA	9088	8725	363	4
CN4833900000000	48	339	Montgomery County, TX	2017	NA	270212	258443	11769	4.4
CN4834100000000	48	341	Moore County, TX	2017	NA	11070	10752	318	2.9
CN4834300000000	48	343	Morris County, TX	2017	NA	4678	4276	402	8.6
CN4834500000000	48	345	Motley County, TX	2017	NA	495	477	18	3.6
CN4834700000000	48	347	Nacogdoches County, TX	2017	NA	28559	27346	1213	4.2
CN4834900000000	48	349	Navarro County, TX	2017	NA	22820	21921	899	3.9
CN4835100000000	48	351	Newton County, TX	2017	NA	5277	4856	421	8
CN4835300000000	48	353	Nolan County, TX	2017	NA	6779	6506	273	4
CN4835500000000	48	355	Nueces County, TX	2017	NA	167983	158897	9086	5.4
CN4835700000000	48	357	Ochiltree County, TX	2017	NA	4523	4359	164	3.6
CN4835900000000	48	359	Oldham County, TX	2017	NA	902	879	23	2.5
CN4836100000000	48	361	Orange County, TX	2017	NA	37146	34577	2569	6.9
CN4836300000000	48	363	Palo Pinto County, TX	2017	NA	13401	12852	549	4.1
CN4836500000000	48	365	Panola County, TX	2017	NA	10407	9843	564	5.4
CN4836700000000	48	367	Parker County, TX	2017	NA	63232	61045	2187	3.5
CN4836900000000	48	369	Parmer County, TX	2017	NA	4920	4799	121	2.5
CN4837100000000	48	371	Pecos County, TX	2017	NA	6270	5978	292	4.7
CN4837300000000	48	373	Polk County, TX	2017	NA	17526	16459	1067	6.1
CN4837500000000	48	375	Potter County, TX	2017	NA	55437	53656	1781	3.2
CN4837700000000	48	377	Presidio County, TX	2017	NA	3041	2755	286	9.4
CN4837900000000	48	379	Rains County, TX	2017	NA	5702	5497	205	3.6
CN4838100000000	48	381	Randall County, TX	2017	NA	70916	68918	1998	2.8
CN4838300000000	48	383	Reagan County, TX	2017	NA	1794	1725	69	3.8
CN4838500000000	48	385	Real County, TX	2017	NA	1054	994	60	5.7
CN4838700000000	48	387	Red River County, TX	2017	NA	5199	4927	272	5.2
CN4838900000000	48	389	Reeves County, TX	2017	NA	6995	6745	250	3.6
CN4839100000000	48	391	Refugio County, TX	2017	NA	3242	3061	181	5.6
CN4839300000000	48	393	Roberts County, TX	2017	NA	441	424	17	3.9
CN4839500000000	48	395	Robertson County, TX	2017	NA	7448	7096	352	4.7
CN4839700000000	48	397	Rockwall County, TX	2017	NA	48975	47330	1645	3.4
CN4839900000000	48	399	Runnels County, TX	2017	NA	4580	4411	169	3.7
CN4840100000000	48	401	Rusk County, TX	2017	NA	22125	21002	1123	5.1
CN4840300000000	48	403	Sabine County, TX	2017	NA	3574	3267	307	8.6
CN4840500000000	48	405	San Augustine County, TX	2017	NA	2869	2654	215	7.5
CN4840700000000	48	407	San Jacinto County, TX	2017	NA	11460	10807	653	5.7
CN4840900000000	48	409	San Patricio County, TX	2017	NA	30563	28218	2345	7.7
CN4841100000000	48	411	San Saba County, TX	2017	NA	2418	2340	78	3.2
CN4841300000000	48	413	Schleicher County, TX	2017	NA	1334	1284	50	3.7
CN4841500000000	48	415	Scurry County, TX	2017	NA	6987	6685	302	4.3
CN4841700000000	48	417	Shackelford County, TX	2017	NA	1889	1833	56	3
CN4841900000000	48	419	Shelby County, TX	2017	NA	10779	10223	556	5.2
CN4842100000000	48	421	Sherman County, TX	2017	NA	1290	1250	40	3.1
CN4842300000000	48	423	Smith County, TX	2017	NA	106035	101697	4338	4.1
CN4842500000000	48	425	Somervell County, TX	2017	NA	4188	3997	191	4.6
CN4842700000000	48	427	Starr County, TX	2017	NA	26103	23034	3069	11.8
CN4842900000000	48	429	Stephens County, TX	2017	NA	4005	3823	182	4.5
CN4843100000000	48	431	Sterling County, TX	2017	NA	594	572	22	3.7
CN4843300000000	48	433	Stonewall County, TX	2017	NA	614	593	21	3.4
CN4843500000000	48	435	Sutton County, TX	2017	NA	1507	1430	77	5.1
CN4843700000000	48	437	Swisher County, TX	2017	NA	2691	2581	110	4.1
CN4843900000000	48	439	Tarrant County, TX	2017	NA	1036343	997799	38544	3.7
CN4844100000000	48	441	Taylor County, TX	2017	NA	64214	61947	2267	3.5
CN4844300000000	48	443	Terrell County, TX	2017	NA	393	375	18	4.6
CN4844500000000	48	445	Terry County, TX	2017	NA	5245	4981	264	5
CN4844700000000	48	447	Throckmorton County, TX	2017	NA	691	661	30	4.3
CN4844900000000	48	449	Titus County, TX	2017	NA	12950	12252	698	5.4
CN4845100000000	48	451	Tom Green County, TX	2017	NA	54164	52178	1986	3.7
CN4845300000000	48	453	Travis County, TX	2017	NA	698699	677404	21295	3
CN4845500000000	48	455	Trinity County, TX	2017	NA	5376	5079	297	5.5
CN4845700000000	48	457	Tyler County, TX	2017	NA	7072	6553	519	7.3
CN4845900000000	48	459	Upshur County, TX	2017	NA	17719	16791	928	5.2
CN4846100000000	48	461	Upton County, TX	2017	NA	1548	1490	58	3.7
CN4846300000000	48	463	Uvalde County, TX	2017	NA	11703	11156	547	4.7
CN4846500000000	48	465	Val Verde County, TX	2017	NA	20092	19071	1021	5.1
CN4846700000000	48	467	Van Zandt County, TX	2017	NA	25386	24433	953	3.8
CN4846900000000	48	469	Victoria County, TX	2017	NA	42948	40874	2074	4.8
CN4847100000000	48	471	Walker County, TX	2017	NA	23686	22591	1095	4.6
CN4847300000000	48	473	Waller County, TX	2017	NA	22384	21289	1095	4.9
CN4847500000000	48	475	Ward County, TX	2017	NA	5587	5361	226	4
CN4847700000000	48	477	Washington County, TX	2017	NA	14872	14246	626	4.2
CN4847900000000	48	479	Webb County, TX	2017	NA	115116	110273	4843	4.2
CN4848100000000	48	481	Wharton County, TX	2017	NA	21099	20153	946	4.5
CN4848300000000	48	483	Wheeler County, TX	2017	NA	2353	2260	93	4
CN4848500000000	48	485	Wichita County, TX	2017	NA	56078	54010	2068	3.7
CN4848700000000	48	487	Wilbarger County, TX	2017	NA	4962	4730	232	4.7
CN4848900000000	48	489	Willacy County, TX	2017	NA	6323	5626	697	11
CN4849100000000	48	491	Williamson County, TX	2017	NA	290795	281296	9499	3.3
CN4849300000000	48	493	Wilson County, TX	2017	NA	24184	23340	844	3.5
CN4849500000000	48	495	Winkler County, TX	2017	NA	3259	3092	167	5.1
CN4849700000000	48	497	Wise County, TX	2017	NA	30173	28965	1208	4
CN4849900000000	48	499	Wood County, TX	2017	NA	17343	16529	814	4.7
CN4850100000000	48	501	Yoakum County, TX	2017	NA	3823	3688	135	3.5
CN4850300000000	48	503	Young County, TX	2017	NA	8076	7772	304	3.8
CN4850500000000	48	505	Zapata County, TX	2017	NA	5389	4988	401	7.4
CN4850700000000	48	507	Zavala County, TX	2017	NA	3732	3315	417	11.2
CN4900100000000	49	001	Beaver County, UT	2017	NA	3040	2916	124	4.1
CN4900300000000	49	003	Box Elder County, UT	2017	NA	25317	24486	831	3.3
CN4900500000000	49	005	Cache County, UT	2017	NA	62596	60855	1741	2.8
CN4900700000000	49	007	Carbon County, UT	2017	NA	8278	7858	420	5.1
CN4900900000000	49	009	Daggett County, UT	2017	NA	429	408	21	4.9
CN4901100000000	49	011	Davis County, UT	2017	NA	168545	163348	5197	3.1
CN4901300000000	49	013	Duchesne County, UT	2017	NA	7977	7519	458	5.7
CN4901500000000	49	015	Emery County, UT	2017	NA	4189	3973	216	5.2
CN4901700000000	49	017	Garfield County, UT	2017	NA	2900	2681	219	7.6
CN4901900000000	49	019	Grand County, UT	2017	NA	5932	5616	316	5.3
CN4902100000000	49	021	Iron County, UT	2017	NA	22241	21309	932	4.2
CN4902300000000	49	023	Juab County, UT	2017	NA	5420	5237	183	3.4
CN4902500000000	49	025	Kane County, UT	2017	NA	3743	3614	129	3.4
CN4902700000000	49	027	Millard County, UT	2017	NA	6431	6220	211	3.3
CN4902900000000	49	029	Morgan County, UT	2017	NA	5387	5233	154	2.9
CN4903100000000	49	031	Piute County, UT	2017	NA	483	459	24	5
CN4903300000000	49	033	Rich County, UT	2017	NA	1140	1103	37	3.2
CN4903500000000	49	035	Salt Lake County, UT	2017	NA	614498	595348	19150	3.1
CN4903700000000	49	037	San Juan County, UT	2017	NA	5696	5295	401	7
CN4903900000000	49	039	Sanpete County, UT	2017	NA	12011	11536	475	4
CN4904100000000	49	041	Sevier County, UT	2017	NA	9785	9406	379	3.9
CN4904300000000	49	043	Summit County, UT	2017	NA	24325	23567	758	3.1
CN4904500000000	49	045	Tooele County, UT	2017	NA	32306	31139	1167	3.6
CN4904700000000	49	047	Uintah County, UT	2017	NA	13680	12850	830	6.1
CN4904900000000	49	049	Utah County, UT	2017	NA	290640	282093	8547	2.9
CN4905100000000	49	051	Wasatch County, UT	2017	NA	14603	14116	487	3.3
CN4905300000000	49	053	Washington County, UT	2017	NA	70715	68238	2477	3.5
CN4905500000000	49	055	Wayne County, UT	2017	NA	1461	1353	108	7.4
CN4905700000000	49	057	Weber County, UT	2017	NA	123223	118690	4533	3.7
CN5000100000000	50	001	Addison County, VT	2017	NA	20770	20197	573	2.8
CN5000300000000	50	003	Bennington County, VT	2017	NA	18266	17616	650	3.6
CN5000500000000	50	005	Caledonia County, VT	2017	NA	14698	14165	533	3.6
CN5000700000000	50	007	Chittenden County, VT	2017	NA	96775	94635	2140	2.2
CN5000900000000	50	009	Essex County, VT	2017	NA	2694	2572	122	4.5
CN5001100000000	50	011	Franklin County, VT	2017	NA	27632	26810	822	3
CN5001300000000	50	013	Grand Isle County, VT	2017	NA	4060	3922	138	3.4
CN5001500000000	50	015	Lamoille County, VT	2017	NA	14076	13526	550	3.9
CN5001700000000	50	017	Orange County, VT	2017	NA	15933	15454	479	3
CN5001900000000	50	019	Orleans County, VT	2017	NA	13601	12920	681	5
CN5002100000000	50	021	Rutland County, VT	2017	NA	31096	30030	1066	3.4
CN5002300000000	50	023	Washington County, VT	2017	NA	34260	33273	987	2.9
CN5002500000000	50	025	Windham County, VT	2017	NA	22823	22132	691	3
CN5002700000000	50	027	Windsor County, VT	2017	NA	29048	28318	730	2.5
CN5100100000000	51	001	Accomack County, VA	2017	NA	16628	15876	752	4.5
CN5100300000000	51	003	Albemarle County, VA	2017	NA	55339	53519	1820	3.3
CN5100500000000	51	005	Alleghany County, VA	2017	NA	7004	6683	321	4.6
CN5100700000000	51	007	Amelia County, VA	2017	NA	6208	5961	247	4
CN5100900000000	51	009	Amherst County, VA	2017	NA	15002	14389	613	4.1
CN5101100000000	51	011	Appomattox County, VA	2017	NA	7083	6774	309	4.4
CN5101300000000	51	013	Arlington County, VA	2017	NA	149893	146174	3719	2.5
CN5101500000000	51	015	Augusta County, VA	2017	NA	36715	35468	1247	3.4
CN5101700000000	51	017	Bath County, VA	2017	NA	2561	2484	77	3
CN5101900000000	51	019	Bedford County, VA	2017	NA	38089	36619	1470	3.9
CN5102100000000	51	021	Bland County, VA	2017	NA	2868	2750	118	4.1
CN5102300000000	51	023	Botetourt County, VA	2017	NA	17267	16661	606	3.5
CN5102500000000	51	025	Brunswick County, VA	2017	NA	6118	5794	324	5.3
CN5102700000000	51	027	Buchanan County, VA	2017	NA	6989	6496	493	7.1
CN5102900000000	51	029	Buckingham County, VA	2017	NA	6316	5977	339	5.4
CN5103100000000	51	031	Campbell County, VA	2017	NA	26051	24974	1077	4.1
CN5103300000000	51	033	Caroline County, VA	2017	NA	15020	14375	645	4.3
CN5103500000000	51	035	Carroll County, VA	2017	NA	13507	12911	596	4.4
CN5103600000000	51	036	Charles City County, VA	2017	NA	3683	3507	176	4.8
CN5103700000000	51	037	Charlotte County, VA	2017	NA	5320	5078	242	4.5
CN5104100000000	51	041	Chesterfield County, VA	2017	NA	183611	177006	6605	3.6
CN5104300000000	51	043	Clarke County, VA	2017	NA	7448	7194	254	3.4
CN5104500000000	51	045	Craig County, VA	2017	NA	2287	2188	99	4.3
CN5104700000000	51	047	Culpeper County, VA	2017	NA	23900	23037	863	3.6
CN5104900000000	51	049	Cumberland County, VA	2017	NA	4685	4491	194	4.1
CN5105100000000	51	051	Dickenson County, VA	2017	NA	4631	4318	313	6.8
CN5105300000000	51	053	Dinwiddie County, VA	2017	NA	13422	12822	600	4.5
CN5105700000000	51	057	Essex County, VA	2017	NA	5588	5320	268	4.8
CN5105900000000	51	059	Fairfax County, VA	2017	NA	622985	604061	18924	3
CN5106100000000	51	061	Fauquier County, VA	2017	NA	35918	34743	1175	3.3
CN5106300000000	51	063	Floyd County, VA	2017	NA	8075	7780	295	3.7
CN5106500000000	51	065	Fluvanna County, VA	2017	NA	13408	13000	408	3
CN5106700000000	51	067	Franklin County, VA	2017	NA	26307	25282	1025	3.9
CN5106900000000	51	069	Frederick County, VA	2017	NA	46372	44897	1475	3.2
CN5107100000000	51	071	Giles County, VA	2017	NA	7866	7499	367	4.7
CN5107300000000	51	073	Gloucester County, VA	2017	NA	19350	18712	638	3.3
CN5107500000000	51	075	Goochland County, VA	2017	NA	10821	10443	378	3.5
CN5107700000000	51	077	Grayson County, VA	2017	NA	7670	7367	303	4
CN5107900000000	51	079	Greene County, VA	2017	NA	10142	9834	308	3
CN5108100000000	51	081	Greensville County, VA	2017	NA	4424	4232	192	4.3
CN5108300000000	51	083	Halifax County, VA	2017	NA	15544	14785	759	4.9
CN5108500000000	51	085	Hanover County, VA	2017	NA	58112	56188	1924	3.3
CN5108700000000	51	087	Henrico County, VA	2017	NA	180160	173585	6575	3.6
CN5108900000000	51	089	Henry County, VA	2017	NA	23750	22650	1100	4.6
CN5109100000000	51	091	Highland County, VA	2017	NA	1292	1250	42	3.3
CN5109300000000	51	093	Isle of Wight County, VA	2017	NA	19083	18352	731	3.8
CN5109500000000	51	095	James City County, VA	2017	NA	35889	34630	1259	3.5
CN5109700000000	51	097	King and Queen County, VA	2017	NA	3798	3666	132	3.5
CN5109900000000	51	099	King George County, VA	2017	NA	12933	12450	483	3.7
CN5110100000000	51	101	King William County, VA	2017	NA	8927	8621	306	3.4
CN5110300000000	51	103	Lancaster County, VA	2017	NA	5332	5055	277	5.2
CN5110500000000	51	105	Lee County, VA	2017	NA	8546	8105	441	5.2
CN5110700000000	51	107	Loudoun County, VA	2017	NA	214084	207604	6480	3
CN5110900000000	51	109	Louisa County, VA	2017	NA	19574	18908	666	3.4
CN5111100000000	51	111	Lunenburg County, VA	2017	NA	5352	5131	221	4.1
CN5111300000000	51	113	Madison County, VA	2017	NA	7261	7049	212	2.9
CN5111500000000	51	115	Mathews County, VA	2017	NA	4093	3941	152	3.7
CN5111700000000	51	117	Mecklenburg County, VA	2017	NA	12736	12115	621	4.9
CN5111900000000	51	119	Middlesex County, VA	2017	NA	5314	5142	172	3.2
CN5112100000000	51	121	Montgomery County, VA	2017	NA	49663	47802	1861	3.7
CN5112500000000	51	125	Nelson County, VA	2017	NA	7283	7029	254	3.5
CN5112700000000	51	127	New Kent County, VA	2017	NA	11978	11598	380	3.2
CN5113100000000	51	131	Northampton County, VA	2017	NA	5514	5206	308	5.6
CN5113300000000	51	133	Northumberland County, VA	2017	NA	5558	5269	289	5.2
CN5113500000000	51	135	Nottoway County, VA	2017	NA	7123	6852	271	3.8
CN5113700000000	51	137	Orange County, VA	2017	NA	16852	16218	634	3.8
CN5113900000000	51	139	Page County, VA	2017	NA	11868	11260	608	5.1
CN5114100000000	51	141	Patrick County, VA	2017	NA	7688	7363	325	4.2
CN5114300000000	51	143	Pittsylvania County, VA	2017	NA	30652	29339	1313	4.3
CN5114500000000	51	145	Powhatan County, VA	2017	NA	13729	13275	454	3.3
CN5114700000000	51	147	Prince Edward County, VA	2017	NA	10237	9744	493	4.8
CN5114900000000	51	149	Prince George County, VA	2017	NA	14919	14255	664	4.5
CN5115300000000	51	153	Prince William County, VA	2017	NA	239266	231140	8126	3.4
CN5115500000000	51	155	Pulaski County, VA	2017	NA	16197	15338	859	5.3
CN5115700000000	51	157	Rappahannock County, VA	2017	NA	3645	3518	127	3.5
CN5115900000000	51	159	Richmond County, VA	2017	NA	4043	3897	146	3.6
CN5116100000000	51	161	Roanoke County, VA	2017	NA	48893	47231	1662	3.4
CN5116300000000	51	163	Rockbridge County, VA	2017	NA	10570	10134	436	4.1
CN5116500000000	51	165	Rockingham County, VA	2017	NA	40587	39271	1316	3.2
CN5116700000000	51	167	Russell County, VA	2017	NA	11433	10839	594	5.2
CN5116900000000	51	169	Scott County, VA	2017	NA	9302	8926	376	4
CN5117100000000	51	171	Shenandoah County, VA	2017	NA	21621	20891	730	3.4
CN5117300000000	51	173	Smyth County, VA	2017	NA	13876	13186	690	5
CN5117500000000	51	175	Southampton County, VA	2017	NA	9032	8708	324	3.6
CN5117700000000	51	177	Spotsylvania County, VA	2017	NA	65375	62938	2437	3.7
CN5117900000000	51	179	Stafford County, VA	2017	NA	69424	66922	2502	3.6
CN5118100000000	51	181	Surry County, VA	2017	NA	3738	3573	165	4.4
CN5118300000000	51	183	Sussex County, VA	2017	NA	3819	3592	227	5.9
CN5118500000000	51	185	Tazewell County, VA	2017	NA	16148	15239	909	5.6
CN5118700000000	51	187	Warren County, VA	2017	NA	19859	19124	735	3.7
CN5119100000000	51	191	Washington County, VA	2017	NA	26823	25723	1100	4.1
CN5119300000000	51	193	Westmoreland County, VA	2017	NA	9353	8937	416	4.4
CN5119500000000	51	195	Wise County, VA	2017	NA	13538	12678	860	6.4
CN5119700000000	51	197	Wythe County, VA	2017	NA	14026	13324	702	5
CN5119900000000	51	199	York County, VA	2017	NA	32501	31362	1139	3.5
CN5151000000000	51	510	Alexandria city, VA	2017	NA	99307	96481	2826	2.8
CN5152000000000	51	520	Bristol city, VA	2017	NA	7343	7013	330	4.5
CN5153000000000	51	530	Buena Vista city, VA	2017	NA	3354	3213	141	4.2
CN5154000000000	51	540	Charlottesville city, VA	2017	NA	25767	24974	793	3.1
CN5155000000000	51	550	Chesapeake city, VA	2017	NA	120860	116298	4562	3.8
CN5157000000000	51	570	Colonial Heights city, VA	2017	NA	8746	8393	353	4
CN5158000000000	51	580	Covington city, VA	2017	NA	2446	2299	147	6
CN5159000000000	51	590	Danville city, VA	2017	NA	19928	18803	1125	5.6
CN5159500000000	51	595	Emporia city, VA	2017	NA	2361	2237	124	5.3
CN5160000000000	51	600	Fairfax city, VA	2017	NA	12956	12584	372	2.9
CN5161000000000	51	610	Falls Church city, VA	2017	NA	8326	8107	219	2.6
CN5162000000000	51	620	Franklin city, VA	2017	NA	3569	3381	188	5.3
CN5163000000000	51	630	Fredericksburg city, VA	2017	NA	13591	12998	593	4.4
CN5164000000000	51	640	Galax city, VA	2017	NA	3005	2880	125	4.2
CN5165000000000	51	650	Hampton city, VA	2017	NA	64427	61183	3244	5
CN5166000000000	51	660	Harrisonburg city, VA	2017	NA	24767	23679	1088	4.4
CN5167000000000	51	670	Hopewell city, VA	2017	NA	9740	9144	596	6.1
CN5167800000000	51	678	Lexington city, VA	2017	NA	2122	1994	128	6
CN5168000000000	51	680	Lynchburg city, VA	2017	NA	36030	34263	1767	4.9
CN5168300000000	51	683	Manassas city, VA	2017	NA	21633	20905	728	3.4
CN5168500000000	51	685	Manassas Park city, VA	2017	NA	8840	8544	296	3.3
CN5169000000000	51	690	Martinsville city, VA	2017	NA	5508	5163	345	6.3
CN5170000000000	51	700	Newport News city, VA	2017	NA	88940	84851	4089	4.6
CN5171000000000	51	710	Norfolk city, VA	2017	NA	111593	106473	5120	4.6
CN5172000000000	51	720	Norton city, VA	2017	NA	1700	1611	89	5.2
CN5173000000000	51	730	Petersburg city, VA	2017	NA	13145	12186	959	7.3
CN5173500000000	51	735	Poquoson city, VA	2017	NA	6265	6052	213	3.4
CN5174000000000	51	740	Portsmouth city, VA	2017	NA	44257	41889	2368	5.4
CN5175000000000	51	750	Radford city, VA	2017	NA	8337	7927	410	4.9
CN5176000000000	51	760	Richmond city, VA	2017	NA	116822	111802	5020	4.3
CN5177000000000	51	770	Roanoke city, VA	2017	NA	48956	46927	2029	4.1
CN5177500000000	51	775	Salem city, VA	2017	NA	13034	12549	485	3.7
CN5179000000000	51	790	Staunton city, VA	2017	NA	11861	11437	424	3.6
CN5180000000000	51	800	Suffolk city, VA	2017	NA	43983	42193	1790	4.1
CN5181000000000	51	810	Virginia Beach city, VA	2017	NA	231550	223354	8196	3.5
CN5182000000000	51	820	Waynesboro city, VA	2017	NA	10418	10003	415	4
CN5183000000000	51	830	Williamsburg city, VA	2017	NA	6739	6390	349	5.2
CN5184000000000	51	840	Winchester city, VA	2017	NA	14469	13943	526	3.6
CN5300100000000	53	001	Adams County, WA	2017	NA	8885	8369	516	5.8
CN5300300000000	53	003	Asotin County, WA	2017	NA	10233	9799	434	4.2
CN5300500000000	53	005	Benton County, WA	2017	NA	96881	91463	5418	5.6
CN5300700000000	53	007	Chelan County, WA	2017	NA	44246	42072	2174	4.9
CN5300900000000	53	009	Clallam County, WA	2017	NA	27749	25834	1915	6.9
CN5301100000000	53	011	Clark County, WA	2017	NA	227605	215883	11722	5.2
CN5301300000000	53	013	Columbia County, WA	2017	NA	1773	1672	101	5.7
CN5301500000000	53	015	Cowlitz County, WA	2017	NA	45695	42881	2814	6.2
CN5301700000000	53	017	Douglas County, WA	2017	NA	21094	19882	1212	5.7
CN5301900000000	53	019	Ferry County, WA	2017	NA	2514	2233	281	11.2
CN5302100000000	53	021	Franklin County, WA	2017	NA	40682	38067	2615	6.4
CN5302300000000	53	023	Garfield County, WA	2017	NA	904	855	49	5.4
CN5302500000000	53	025	Grant County, WA	2017	NA	45099	42238	2861	6.3
CN5302700000000	53	027	Grays Harbor County, WA	2017	NA	27827	25833	1994	7.2
CN5302900000000	53	029	Island County, WA	2017	NA	33917	32133	1784	5.3
CN5303100000000	53	031	Jefferson County, WA	2017	NA	11907	11170	737	6.2
CN5303300000000	53	033	King County, WA	2017	NA	1238090	1194955	43135	3.5
CN5303500000000	53	035	Kitsap County, WA	2017	NA	120251	114308	5943	4.9
CN5303700000000	53	037	Kittitas County, WA	2017	NA	22242	21043	1199	5.4
CN5303900000000	53	039	Klickitat County, WA	2017	NA	9881	9285	596	6
CN5304100000000	53	041	Lewis County, WA	2017	NA	33087	30869	2218	6.7
CN5304300000000	53	043	Lincoln County, WA	2017	NA	4945	4697	248	5
CN5304500000000	53	045	Mason County, WA	2017	NA	23775	22189	1586	6.7
CN5304700000000	53	047	Okanogan County, WA	2017	NA	20919	19475	1444	6.9
CN5304900000000	53	049	Pacific County, WA	2017	NA	8335	7738	597	7.2
CN5305100000000	53	051	Pend Oreille County, WA	2017	NA	4729	4374	355	7.5
CN5305300000000	53	053	Pierce County, WA	2017	NA	415689	393077	22612	5.4
CN5305500000000	53	055	San Juan County, WA	2017	NA	8184	7855	329	4
CN5305700000000	53	057	Skagit County, WA	2017	NA	59305	56012	3293	5.6
CN5305900000000	53	059	Skamania County, WA	2017	NA	5286	4959	327	6.2
CN5306100000000	53	061	Snohomish County, WA	2017	NA	423819	407363	16456	3.9
CN5306300000000	53	063	Spokane County, WA	2017	NA	239480	226384	13096	5.5
CN5306500000000	53	065	Stevens County, WA	2017	NA	18083	16750	1333	7.4
CN5306700000000	53	067	Thurston County, WA	2017	NA	134189	127424	6765	5
CN5306900000000	53	069	Wahkiakum County, WA	2017	NA	1305	1209	96	7.4
CN5307100000000	53	071	Walla Walla County, WA	2017	NA	28831	27383	1448	5
CN5307300000000	53	073	Whatcom County, WA	2017	NA	109892	104326	5566	5.1
CN5307500000000	53	075	Whitman County, WA	2017	NA	23290	22255	1035	4.4
CN5307700000000	53	077	Yakima County, WA	2017	NA	125504	116825	8679	6.9
CN5400100000000	54	001	Barbour County, WV	2017	NA	6804	6408	396	5.8
CN5400300000000	54	003	Berkeley County, WV	2017	NA	56125	54081	2044	3.6
CN5400500000000	54	005	Boone County, WV	2017	NA	7544	7061	483	6.4
CN5400700000000	54	007	Braxton County, WV	2017	NA	5244	4851	393	7.5
CN5400900000000	54	009	Brooke County, WV	2017	NA	9763	9170	593	6.1
CN5401100000000	54	011	Cabell County, WV	2017	NA	41466	39584	1882	4.5
CN5401300000000	54	013	Calhoun County, WV	2017	NA	2403	2144	259	10.8
CN5401500000000	54	015	Clay County, WV	2017	NA	3146	2875	271	8.6
CN5401700000000	54	017	Doddridge County, WV	2017	NA	3882	3717	165	4.3
CN5401900000000	54	019	Fayette County, WV	2017	NA	15715	14712	1003	6.4
CN5402100000000	54	021	Gilmer County, WV	2017	NA	2401	2229	172	7.2
CN5402300000000	54	023	Grant County, WV	2017	NA	5891	5562	329	5.6
CN5402500000000	54	025	Greenbrier County, WV	2017	NA	15711	14949	762	4.9
CN5402700000000	54	027	Hampshire County, WV	2017	NA	10319	9915	404	3.9
CN5402900000000	54	029	Hancock County, WV	2017	NA	12801	12028	773	6
CN5403100000000	54	031	Hardy County, WV	2017	NA	5897	5609	288	4.9
CN5403300000000	54	033	Harrison County, WV	2017	NA	33125	31532	1593	4.8
CN5403500000000	54	035	Jackson County, WV	2017	NA	11998	11316	682	5.7
CN5403700000000	54	037	Jefferson County, WV	2017	NA	29257	28352	905	3.1
CN5403900000000	54	039	Kanawha County, WV	2017	NA	82962	78764	4198	5.1
CN5404100000000	54	041	Lewis County, WV	2017	NA	6515	6085	430	6.6
CN5404300000000	54	043	Lincoln County, WV	2017	NA	7152	6663	489	6.8
CN5404500000000	54	045	Logan County, WV	2017	NA	10764	9963	801	7.4
CN5404700000000	54	047	McDowell County, WV	2017	NA	4667	4250	417	8.9
CN5404900000000	54	049	Marion County, WV	2017	NA	25316	23981	1335	5.3
CN5405100000000	54	051	Marshall County, WV	2017	NA	13955	13126	829	5.9
CN5405300000000	54	053	Mason County, WV	2017	NA	9987	9317	670	6.7
CN5405500000000	54	055	Mercer County, WV	2017	NA	21296	20056	1240	5.8
CN5405700000000	54	057	Mineral County, WV	2017	NA	12193	11552	641	5.3
CN5405900000000	54	059	Mingo County, WV	2017	NA	6748	6167	581	8.6
CN5406100000000	54	061	Monongalia County, WV	2017	NA	52782	50824	1958	3.7
CN5406300000000	54	063	Monroe County, WV	2017	NA	5888	5629	259	4.4
CN5406500000000	54	065	Morgan County, WV	2017	NA	7807	7499	308	3.9
CN5406700000000	54	067	Nicholas County, WV	2017	NA	9244	8584	660	7.1
CN5406900000000	54	069	Ohio County, WV	2017	NA	20892	19911	981	4.7
CN5407100000000	54	071	Pendleton County, WV	2017	NA	3556	3423	133	3.7
CN5407300000000	54	073	Pleasants County, WV	2017	NA	2814	2616	198	7
CN5407500000000	54	075	Pocahontas County, WV	2017	NA	3741	3520	221	5.9
CN5407700000000	54	077	Preston County, WV	2017	NA	15194	14445	749	4.9
CN5407900000000	54	079	Putnam County, WV	2017	NA	26201	24973	1228	4.7
CN5408100000000	54	081	Raleigh County, WV	2017	NA	29362	27791	1571	5.4
CN5408300000000	54	083	Randolph County, WV	2017	NA	12127	11474	653	5.4
CN5408500000000	54	085	Ritchie County, WV	2017	NA	4398	4157	241	5.5
CN5408700000000	54	087	Roane County, WV	2017	NA	5018	4582	436	8.7
CN5408900000000	54	089	Summers County, WV	2017	NA	4374	4116	258	5.9
CN5409100000000	54	091	Taylor County, WV	2017	NA	7797	7416	381	4.9
CN5409300000000	54	093	Tucker County, WV	2017	NA	3398	3222	176	5.2
CN5409500000000	54	095	Tyler County, WV	2017	NA	3211	2965	246	7.7
CN5409700000000	54	097	Upshur County, WV	2017	NA	9397	8821	576	6.1
CN5409900000000	54	099	Wayne County, WV	2017	NA	15566	14663	903	5.8
CN5410100000000	54	101	Webster County, WV	2017	NA	3294	3086	208	6.3
CN5410300000000	54	103	Wetzel County, WV	2017	NA	6730	6223	507	7.5
CN5410500000000	54	105	Wirt County, WV	2017	NA	2195	2022	173	7.9
CN5410700000000	54	107	Wood County, WV	2017	NA	36094	34118	1976	5.5
CN5410900000000	54	109	Wyoming County, WV	2017	NA	6857	6373	484	7.1
CN5500100000000	55	001	Adams County, WI	2017	NA	8239	7820	419	5.1
CN5500300000000	55	003	Ashland County, WI	2017	NA	7897	7537	360	4.6
CN5500500000000	55	005	Barron County, WI	2017	NA	24717	23848	869	3.5
CN5500700000000	55	007	Bayfield County, WI	2017	NA	7585	7190	395	5.2
CN5500900000000	55	009	Brown County, WI	2017	NA	142790	138594	4196	2.9
CN5501100000000	55	011	Buffalo County, WI	2017	NA	6584	6337	247	3.8
CN5501300000000	55	013	Burnett County, WI	2017	NA	7351	6995	356	4.8
CN5501500000000	55	015	Calumet County, WI	2017	NA	27917	27139	778	2.8
CN5501700000000	55	017	Chippewa County, WI	2017	NA	33466	32289	1177	3.5
CN5501900000000	55	019	Clark County, WI	2017	NA	17977	17427	550	3.1
CN5502100000000	55	021	Columbia County, WI	2017	NA	31733	30795	938	3
CN5502300000000	55	023	Crawford County, WI	2017	NA	7886	7557	329	4.2
CN5502500000000	55	025	Dane County, WI	2017	NA	320586	312894	7692	2.4
CN5502700000000	55	027	Dodge County, WI	2017	NA	48430	47025	1405	2.9
CN5502900000000	55	029	Door County, WI	2017	NA	15578	14979	599	3.8
CN5503100000000	55	031	Douglas County, WI	2017	NA	23559	22510	1049	4.5
CN5503300000000	55	033	Dunn County, WI	2017	NA	24463	23661	802	3.3
CN5503500000000	55	035	Eau Claire County, WI	2017	NA	59322	57600	1722	2.9
CN5503700000000	55	037	Florence County, WI	2017	NA	2289	2182	107	4.7
CN5503900000000	55	039	Fond du Lac County, WI	2017	NA	57067	55452	1615	2.8
CN5504100000000	55	041	Forest County, WI	2017	NA	4028	3825	203	5
CN5504300000000	55	043	Grant County, WI	2017	NA	28207	27319	888	3.1
CN5504500000000	55	045	Green County, WI	2017	NA	21138	20556	582	2.8
CN5504700000000	55	047	Green Lake County, WI	2017	NA	9716	9351	365	3.8
CN5504900000000	55	049	Iowa County, WI	2017	NA	13809	13401	408	3
CN5505100000000	55	051	Iron County, WI	2017	NA	2610	2448	162	6.2
CN5505300000000	55	053	Jackson County, WI	2017	NA	10431	10080	351	3.4
CN5505500000000	55	055	Jefferson County, WI	2017	NA	45636	44181	1455	3.2
CN5505700000000	55	057	Juneau County, WI	2017	NA	13597	13143	454	3.3
CN5505900000000	55	059	Kenosha County, WI	2017	NA	89439	85988	3451	3.9
CN5506100000000	55	061	Kewaunee County, WI	2017	NA	11192	10847	345	3.1
CN5506300000000	55	063	La Crosse County, WI	2017	NA	67684	65712	1972	2.9
CN5506500000000	55	065	Lafayette County, WI	2017	NA	10158	9901	257	2.5
CN5506700000000	55	067	Langlade County, WI	2017	NA	9646	9240	406	4.2
CN5506900000000	55	069	Lincoln County, WI	2017	NA	15505	14953	552	3.6
CN5507100000000	55	071	Manitowoc County, WI	2017	NA	41725	40254	1471	3.5
CN5507300000000	55	073	Marathon County, WI	2017	NA	73896	71730	2166	2.9
CN5507500000000	55	075	Marinette County, WI	2017	NA	19767	18892	875	4.4
CN5507700000000	55	077	Marquette County, WI	2017	NA	7610	7317	293	3.9
CN5507800000000	55	078	Menominee County, WI	2017	NA	1608	1513	95	5.9
CN5507900000000	55	079	Milwaukee County, WI	2017	NA	475142	456025	19117	4
CN5508100000000	55	081	Monroe County, WI	2017	NA	23529	22838	691	2.9
CN5508300000000	55	083	Oconto County, WI	2017	NA	20655	19923	732	3.5
CN5508500000000	55	085	Oneida County, WI	2017	NA	18372	17665	707	3.8
CN5508700000000	55	087	Outagamie County, WI	2017	NA	104011	100888	3123	3
CN5508900000000	55	089	Ozaukee County, WI	2017	NA	49172	47823	1349	2.7
CN5509100000000	55	091	Pepin County, WI	2017	NA	4218	4069	149	3.5
CN5509300000000	55	093	Pierce County, WI	2017	NA	25177	24328	849	3.4
CN5509500000000	55	095	Polk County, WI	2017	NA	24858	23916	942	3.8
CN5509700000000	55	097	Portage County, WI	2017	NA	39636	38417	1219	3.1
CN5509900000000	55	099	Price County, WI	2017	NA	6796	6542	254	3.7
CN5510100000000	55	101	Racine County, WI	2017	NA	99694	95664	4030	4
CN5510300000000	55	103	Richland County, WI	2017	NA	9290	9012	278	3
CN5510500000000	55	105	Rock County, WI	2017	NA	85290	82139	3151	3.7
CN5510700000000	55	107	Rusk County, WI	2017	NA	6992	6681	311	4.4
CN5510900000000	55	109	St. Croix County, WI	2017	NA	50180	48615	1565	3.1
CN5511100000000	55	111	Sauk County, WI	2017	NA	35550	34516	1034	2.9
CN5511300000000	55	113	Sawyer County, WI	2017	NA	8001	7627	374	4.7
CN5511500000000	55	115	Shawano County, WI	2017	NA	21454	20764	690	3.2
CN5511700000000	55	117	Sheboygan County, WI	2017	NA	62584	60854	1730	2.8
CN5511900000000	55	119	Taylor County, WI	2017	NA	11118	10728	390	3.5
CN5512100000000	55	121	Trempealeau County, WI	2017	NA	16477	15972	505	3.1
CN5512300000000	55	123	Vernon County, WI	2017	NA	15738	15251	487	3.1
CN5512500000000	55	125	Vilas County, WI	2017	NA	10168	9725	443	4.4
CN5512700000000	55	127	Walworth County, WI	2017	NA	57960	56062	1898	3.3
CN5512900000000	55	129	Washburn County, WI	2017	NA	7919	7607	312	3.9
CN5513100000000	55	131	Washington County, WI	2017	NA	77751	75596	2155	2.8
CN5513300000000	55	133	Waukesha County, WI	2017	NA	226155	219636	6519	2.9
CN5513500000000	55	135	Waupaca County, WI	2017	NA	26605	25759	846	3.2
CN5513700000000	55	137	Waushara County, WI	2017	NA	11417	10963	454	4
CN5513900000000	55	139	Winnebago County, WI	2017	NA	93634	90853	2781	3
CN5514100000000	55	141	Wood County, WI	2017	NA	35031	33720	1311	3.7
CN5600100000000	56	001	Albany County, WY	2017	NA	20477	19893	584	2.9
CN5600300000000	56	003	Big Horn County, WY	2017	NA	5362	5135	227	4.2
CN5600500000000	56	005	Campbell County, WY	2017	NA	23028	21912	1116	4.8
CN5600700000000	56	007	Carbon County, WY	2017	NA	7903	7589	314	4
CN5600900000000	56	009	Converse County, WY	2017	NA	7483	7151	332	4.4
CN5601100000000	56	011	Crook County, WY	2017	NA	3687	3557	130	3.5
CN5601300000000	56	013	Fremont County, WY	2017	NA	19356	18288	1068	5.5
CN5601500000000	56	015	Goshen County, WY	2017	NA	6925	6727	198	2.9
CN5601700000000	56	017	Hot Springs County, WY	2017	NA	2333	2242	91	3.9
CN5601900000000	56	019	Johnson County, WY	2017	NA	4198	4023	175	4.2
CN5602100000000	56	021	Laramie County, WY	2017	NA	48230	46472	1758	3.6
CN5602300000000	56	023	Lincoln County, WY	2017	NA	8752	8432	320	3.7
CN5602500000000	56	025	Natrona County, WY	2017	NA	39535	37472	2063	5.2
CN5602700000000	56	027	Niobrara County, WY	2017	NA	1302	1266	36	2.8
CN5602900000000	56	029	Park County, WY	2017	NA	15696	15031	665	4.2
CN5603100000000	56	031	Platte County, WY	2017	NA	4777	4601	176	3.7
CN5603300000000	56	033	Sheridan County, WY	2017	NA	15803	15190	613	3.9
CN5603500000000	56	035	Sublette County, WY	2017	NA	4258	4068	190	4.5
CN5603700000000	56	037	Sweetwater County, WY	2017	NA	21565	20591	974	4.5
CN5603900000000	56	039	Teton County, WY	2017	NA	15428	14994	434	2.8
CN5604100000000	56	041	Uinta County, WY	2017	NA	9108	8695	413	4.5
CN5604300000000	56	043	Washakie County, WY	2017	NA	4114	3950	164	4
CN5604500000000	56	045	Weston County, WY	2017	NA	3756	3608	148	3.9
CN7200100000000	72	001	Adjuntas Municipio, PR	2017	NA	4368	3710	658	15.1
CN7200300000000	72	003	Aguada Municipio, PR	2017	NA	11868	10334	1534	12.9
CN7200500000000	72	005	Aguadilla Municipio, PR	2017	NA	14891	12732	2159	14.5
CN7200700000000	72	007	Aguas Buenas Municipio, PR	2017	NA	6616	5789	827	12.5
CN7200900000000	72	009	Aibonito Municipio, PR	2017	NA	6575	5643	932	14.2
CN7201100000000	72	011	Anasco Municipio, PR	2017	NA	8952	7831	1121	12.5
CN7201300000000	72	013	Arecibo Municipio, PR	2017	NA	23532	20772	2760	11.7
CN7201500000000	72	015	Arroyo Municipio, PR	2017	NA	5000	4113	887	17.7
CN7201700000000	72	017	Barceloneta Municipio, PR	2017	NA	5884	5060	824	14
CN7201900000000	72	019	Barranquitas Municipio, PR	2017	NA	7372	6535	837	11.4
CN7202100000000	72	021	Bayamon Municipio, PR	2017	NA	64846	59877	4969	7.7
CN7202300000000	72	023	Cabo Rojo Municipio, PR	2017	NA	13946	12047	1899	13.6
CN7202500000000	72	025	Caguas Municipio, PR	2017	NA	47504	43195	4309	9.1
CN7202700000000	72	027	Camuy Municipio, PR	2017	NA	9387	8297	1090	11.6
CN7202900000000	72	029	Canovanas Municipio, PR	2017	NA	16013	14452	1561	9.7
CN7203100000000	72	031	Carolina Municipio, PR	2017	NA	61105	56351	4754	7.8
CN7203300000000	72	033	Catano Municipio, PR	2017	NA	7782	7076	706	9.1
CN7203500000000	72	035	Cayey Municipio, PR	2017	NA	16107	14479	1628	10.1
CN7203700000000	72	037	Ceiba Municipio, PR	2017	NA	3774	3265	509	13.5
CN7203900000000	72	039	Ciales Municipio, PR	2017	NA	3834	3215	619	16.1
CN7204100000000	72	041	Cidra Municipio, PR	2017	NA	15246	13964	1282	8.4
CN7204300000000	72	043	Coamo Municipio, PR	2017	NA	10349	8669	1680	16.2
CN7204500000000	72	045	Comerio Municipio, PR	2017	NA	4948	4366	582	11.8
CN7204700000000	72	047	Corozal Municipio, PR	2017	NA	9013	7994	1019	11.3
CN7204900000000	72	049	Culebra Municipio, PR	2017	NA	912	872	40	4.4
CN7205100000000	72	051	Dorado Municipio, PR	2017	NA	12819	11936	883	6.9
CN7205300000000	72	053	Fajardo Municipio, PR	2017	NA	11112	9630	1482	13.3
CN7205400000000	72	054	Florida Municipio, PR	2017	NA	3359	2879	480	14.3
CN7205500000000	72	055	Guanica Municipio, PR	2017	NA	4053	3312	741	18.3
CN7205700000000	72	057	Guayama Municipio, PR	2017	NA	11746	9908	1838	15.6
CN7205900000000	72	059	Guayanilla Municipio, PR	2017	NA	5085	4251	834	16.4
CN7206100000000	72	061	Guaynabo Municipio, PR	2017	NA	36752	34813	1939	5.3
CN7206300000000	72	063	Gurabo Municipio, PR	2017	NA	17559	16277	1282	7.3
CN7206500000000	72	065	Hatillo Municipio, PR	2017	NA	13086	11258	1828	14
CN7206700000000	72	067	Hormigueros Municipio, PR	2017	NA	5538	4833	705	12.7
CN7206900000000	72	069	Humacao Municipio, PR	2017	NA	17374	14948	2426	14
CN7207100000000	72	071	Isabela Municipio, PR	2017	NA	12599	10912	1687	13.4
CN7207300000000	72	073	Jayuya Municipio, PR	2017	NA	4249	3697	552	13
CN7207500000000	72	075	Juana Diaz Municipio, PR	2017	NA	15029	13090	1939	12.9
CN7207700000000	72	077	Juncos Municipio, PR	2017	NA	12321	10898	1423	11.5
CN7207900000000	72	079	Lajas Municipio, PR	2017	NA	5473	4409	1064	19.4
CN7208100000000	72	081	Lares Municipio, PR	2017	NA	7235	5888	1347	18.6
CN7208300000000	72	083	Las Marias Municipio, PR	2017	NA	2802	2224	578	20.6
CN7208500000000	72	085	Las Piedras Municipio, PR	2017	NA	11244	9897	1347	12
CN7208700000000	72	087	Loiza Municipio, PR	2017	NA	8428	7619	809	9.6
CN7208900000000	72	089	Luquillo Municipio, PR	2017	NA	6223	5424	799	12.8
CN7209100000000	72	091	Manati Municipio, PR	2017	NA	11505	10282	1223	10.6
CN7209300000000	72	093	Maricao Municipio, PR	2017	NA	2024	1618	406	20.1
CN7209500000000	72	095	Maunabo Municipio, PR	2017	NA	2949	2439	510	17.3
CN7209700000000	72	097	Mayaguez Municipio, PR	2017	NA	22579	19422	3157	14
CN7209900000000	72	099	Moca Municipio, PR	2017	NA	10707	9133	1574	14.7
CN7210100000000	72	101	Morovis Municipio, PR	2017	NA	8028	7032	996	12.4
CN7210300000000	72	103	Naguabo Municipio, PR	2017	NA	8013	7120	893	11.1
CN7210500000000	72	105	Naranjito Municipio, PR	2017	NA	7155	6308	847	11.8
CN7210700000000	72	107	Orocovis Municipio, PR	2017	NA	5096	4369	727	14.3
CN7210900000000	72	109	Patillas Municipio, PR	2017	NA	4643	3728	915	19.7
CN7211100000000	72	111	Penuelas Municipio, PR	2017	NA	5994	4946	1048	17.5
CN7211300000000	72	113	Ponce Municipio, PR	2017	NA	45598	40291	5307	11.6
CN7211500000000	72	115	Quebradillas Municipio, PR	2017	NA	6062	5105	957	15.8
CN7211700000000	72	117	Rincon Municipio, PR	2017	NA	4664	3951	713	15.3
CN7211900000000	72	119	Rio Grande Municipio, PR	2017	NA	16953	15308	1645	9.7
CN7212100000000	72	121	Sabana Grande Municipio, PR	2017	NA	6369	5296	1073	16.8
CN7212300000000	72	123	Salinas Municipio, PR	2017	NA	7481	6080	1401	18.7
CN7212500000000	72	125	San German Municipio, PR	2017	NA	10017	8447	1570	15.7
CN7212700000000	72	127	San Juan Municipio, PR	2017	NA	132504	123201	9303	7
CN7212900000000	72	129	San Lorenzo Municipio, PR	2017	NA	11908	10381	1527	12.8
CN7213100000000	72	131	San Sebastian Municipio, PR	2017	NA	10576	8709	1867	17.7
CN7213300000000	72	133	Santa Isabel Municipio, PR	2017	NA	9738	8420	1318	13.5
CN7213500000000	72	135	Toa Alta Municipio, PR	2017	NA	26566	24512	2054	7.7
CN7213700000000	72	137	Toa Baja Municipio, PR	2017	NA	29185	26823	2362	8.1
CN7213900000000	72	139	Trujillo Alto Municipio, PR	2017	NA	26623	25045	1578	5.9
CN7214100000000	72	141	Utuado Municipio, PR	2017	NA	6756	5813	943	14
CN7214300000000	72	143	Vega Alta Municipio, PR	2017	NA	9785	8738	1047	10.7
CN7214500000000	72	145	Vega Baja Municipio, PR	2017	NA	13414	11746	1668	12.4
CN7214700000000	72	147	Vieques Municipio, PR	2017	NA	3027	2589	438	14.5
CN7214900000000	72	149	Villalba Municipio, PR	2017	NA	7557	6090	1467	19.4
CN7215100000000	72	151	Yabucoa Municipio, PR	2017	NA	9000	7512	1488	16.5
CN7215300000000	72	153	Yauco Municipio, PR	2017	NA	10160	8409	1751	17.2
NA	NA	NA	NA	NA	NA	NA	NA	NA	NA
SOURCE:  BLS, LAUS	NA	NA	NA	NA	NA	NA	NA	NA	NA
April 17, 2020	NA	NA	NA	NA	NA	NA	NA	NA	NA
