LAUS_CODE	STATE_FIPS	COUNTY_FIPS	COUNTY	YEAR	ESTIMATED	LABOR_FORCE	EMPLOYED	UNEMPLOYED_LEVEL	UNEMPLOYED_RATE
CN0100100000000	01	001	Autauga County, AL	1999	NA	22433	21577	856	3.8
CN0100300000000	01	003	Baldwin County, AL	1999	NA	70912	68556	2356	3.3
CN0100500000000	01	005	Barbour County, AL	1999	NA	13364	12720	644	4.8
CN0100700000000	01	007	Bibb County, AL	1999	NA	7186	6695	491	6.8
CN0100900000000	01	009	Blount County, AL	1999	NA	23968	23297	671	2.8
CN0101100000000	01	011	Bullock County, AL	1999	NA	4455	4009	446	10
CN0101300000000	01	013	Butler County, AL	1999	NA	9873	8520	1353	13.7
CN0101500000000	01	015	Calhoun County, AL	1999	NA	54364	51588	2776	5.1
CN0101700000000	01	017	Chambers County, AL	1999	NA	16448	15674	774	4.7
CN0101900000000	01	019	Cherokee County, AL	1999	NA	10177	9675	502	4.9
CN0102100000000	01	021	Chilton County, AL	1999	NA	18606	17896	710	3.8
CN0102300000000	01	023	Choctaw County, AL	1999	NA	5802	5270	532	9.2
CN0102500000000	01	025	Clarke County, AL	1999	NA	13577	12411	1166	8.6
CN0102700000000	01	027	Clay County, AL	1999	NA	6624	6264	360	5.4
CN0102900000000	01	029	Cleburne County, AL	1999	NA	7229	6918	311	4.3
CN0103100000000	01	031	Coffee County, AL	1999	NA	21888	20853	1035	4.7
CN0103300000000	01	033	Colbert County, AL	1999	NA	25356	23538	1818	7.2
CN0103500000000	01	035	Conecuh County, AL	1999	NA	5902	5351	551	9.3
CN0103700000000	01	037	Coosa County, AL	1999	NA	5270	4977	293	5.6
CN0103900000000	01	039	Covington County, AL	1999	NA	17066	15667	1399	8.2
CN0104100000000	01	041	Crenshaw County, AL	1999	NA	5388	4790	598	11.1
CN0104300000000	01	043	Cullman County, AL	1999	NA	39497	37945	1552	3.9
CN0104500000000	01	045	Dale County, AL	1999	NA	21267	20236	1031	4.8
CN0104700000000	01	047	Dallas County, AL	1999	NA	19615	17464	2151	11
CN0104900000000	01	049	DeKalb County, AL	1999	NA	32473	31206	1267	3.9
CN0105100000000	01	051	Elmore County, AL	1999	NA	30513	29493	1020	3.3
CN0105300000000	01	053	Escambia County, AL	1999	NA	16464	15416	1048	6.4
CN0105500000000	01	055	Etowah County, AL	1999	NA	49440	46003	3437	7
CN0105700000000	01	057	Fayette County, AL	1999	NA	7853	7088	765	9.7
CN0105900000000	01	059	Franklin County, AL	1999	NA	16828	15592	1236	7.3
CN0106100000000	01	061	Geneva County, AL	1999	NA	10675	9874	801	7.5
CN0106300000000	01	063	Greene County, AL	1999	NA	3094	2711	383	12.4
CN0106500000000	01	065	Hale County, AL	1999	NA	7016	6488	528	7.5
CN0106700000000	01	067	Henry County, AL	1999	NA	6428	6093	335	5.2
CN0106900000000	01	069	Houston County, AL	1999	NA	45134	43448	1686	3.7
CN0107100000000	01	071	Jackson County, AL	1999	NA	25698	23999	1699	6.6
CN0107300000000	01	073	Jefferson County, AL	1999	NA	332540	321121	11419	3.4
CN0107500000000	01	075	Lamar County, AL	1999	NA	7188	6510	678	9.4
CN0107700000000	01	077	Lauderdale County, AL	1999	NA	41083	38490	2593	6.3
CN0107900000000	01	079	Lawrence County, AL	1999	NA	16579	15593	986	5.9
CN0108100000000	01	081	Lee County, AL	1999	NA	48770	47052	1718	3.5
CN0108300000000	01	083	Limestone County, AL	1999	NA	29003	27944	1059	3.7
CN0108500000000	01	085	Lowndes County, AL	1999	NA	4155	3633	522	12.6
CN0108700000000	01	087	Macon County, AL	1999	NA	7666	7019	647	8.4
CN0108900000000	01	089	Madison County, AL	1999	NA	142993	138333	4660	3.3
CN0109100000000	01	091	Marengo County, AL	1999	NA	11063	10481	582	5.3
CN0109300000000	01	093	Marion County, AL	1999	NA	16089	14799	1290	8
CN0109500000000	01	095	Marshall County, AL	1999	NA	40030	37552	2478	6.2
CN0109700000000	01	097	Mobile County, AL	1999	NA	198920	188796	10124	5.1
CN0109900000000	01	099	Monroe County, AL	1999	NA	9644	8490	1154	12
CN0110100000000	01	101	Montgomery County, AL	1999	NA	110193	106029	4164	3.8
CN0110300000000	01	103	Morgan County, AL	1999	NA	56569	54149	2420	4.3
CN0110500000000	01	105	Perry County, AL	1999	NA	4577	4154	423	9.2
CN0110700000000	01	107	Pickens County, AL	1999	NA	8577	7683	894	10.4
CN0110900000000	01	109	Pike County, AL	1999	NA	13667	12922	745	5.5
CN0111100000000	01	111	Randolph County, AL	1999	NA	9286	8730	556	6
CN0111300000000	01	113	Russell County, AL	1999	NA	25607	24363	1244	4.9
CN0111500000000	01	115	St. Clair County, AL	1999	NA	31476	30387	1089	3.5
CN0111700000000	01	117	Shelby County, AL	1999	NA	82638	81267	1371	1.7
CN0111900000000	01	119	Sumter County, AL	1999	NA	5501	4905	596	10.8
CN0112100000000	01	121	Talladega County, AL	1999	NA	34284	32215	2069	6
CN0112300000000	01	123	Tallapoosa County, AL	1999	NA	19868	18832	1036	5.2
CN0112500000000	01	125	Tuscaloosa County, AL	1999	NA	83605	81135	2470	3
CN0112700000000	01	127	Walker County, AL	1999	NA	28653	26864	1789	6.2
CN0112900000000	01	129	Washington County, AL	1999	NA	5983	5257	726	12.1
CN0113100000000	01	131	Wilcox County, AL	1999	NA	3810	3268	542	14.2
CN0113300000000	01	133	Winston County, AL	1999	NA	12410	11623	787	6.3
CN0201300000000	02	013	Aleutians East Borough, AK	1999	NA	1558	1501	57	3.7
CN0201600000000	02	016	Aleutians West Census Area, AK	1999	NA	2033	1895	138	6.8
CN0202000000000	02	020	Anchorage Borough/municipality, AK	1999	NA	142144	135610	6534	4.6
CN0205000000000	02	050	Bethel Census Area, AK	1999	NA	6330	5786	544	8.6
CN0206000000000	02	060	Bristol Bay Borough, AK	1999	NA	503	456	47	9.3
CN0206800000000	02	068	Denali Borough, AK	1999	NA	1148	1049	99	8.6
CN0207000000000	02	070	Dillingham Census Area, AK	1999	NA	1811	1677	134	7.4
CN0209000000000	02	090	Fairbanks North Star Borough, AK	1999	NA	43557	40924	2633	6
CN0210000000000	02	100	Haines Borough, AK	1999	NA	1246	1110	136	10.9
CN0211000000000	02	110	Juneau Borough/city, AK	1999	NA	17150	16283	867	5.1
CN0212200000000	02	122	Kenai Peninsula Borough, AK	1999	NA	21981	19543	2438	11.1
CN0213000000000	02	130	Ketchikan Gateway Borough, AK	1999	NA	7599	7051	548	7.2
CN0215000000000	02	150	Kodiak Island Borough, AK	1999	NA	6828	6327	501	7.3
CN0215800000000	02	158	Kusilvak Census Area, AK	1999	NA	2199	1876	323	14.7
CN0216400000000	02	164	Lake and Peninsula Borough, AK	1999	NA	611	565	46	7.5
CN0217000000000	02	170	Matanuska-Susitna Borough, AK	1999	NA	29721	27255	2466	8.3
CN0218000000000	02	180	Nome Census Area, AK	1999	NA	3147	2779	368	11.7
CN0218500000000	02	185	North Slope Borough, AK	1999	NA	3113	2863	250	8
CN0218800000000	02	188	Northwest Arctic Borough, AK	1999	NA	2055	1770	285	13.9
CN0220100000000	02	201	Prince of Wales-Outer Ketchikan Census Area, AK	1999	NA	3212	2780	432	13.4
CN0222000000000	02	220	Sitka Borough/city, AK	1999	NA	4322	4093	229	5.3
CN0223200000000	02	232	Skagway-Hoonah-Angoon Census Area, AK	1999	NA	2075	1922	153	7.4
CN0224000000000	02	240	Southeast Fairbanks Census Area, AK	1999	NA	2573	2311	262	10.2
CN0226100000000	02	261	Valdez-Cordova Census Area, AK	1999	NA	5079	4618	461	9.1
CN0228000000000	02	280	Wrangell-Petersburg Census Area, AK	1999	NA	3541	3226	315	8.9
CN0228200000000	02	282	Yakutat Borough/city, AK	1999	NA	302	276	26	8.6
CN0229000000000	02	290	Yukon-Koyukuk Census Area, AK	1999	NA	2105	1808	297	14.1
CN0400100000000	04	001	Apache County, AZ	1999	NA	22687	19461	3226	14.2
CN0400300000000	04	003	Cochise County, AZ	1999	NA	41615	39191	2424	5.8
CN0400500000000	04	005	Coconino County, AZ	1999	NA	62604	58326	4278	6.8
CN0400700000000	04	007	Gila County, AZ	1999	NA	18836	17465	1371	7.3
CN0400900000000	04	009	Graham County, AZ	1999	NA	11203	10239	964	8.6
CN0401100000000	04	011	Greenlee County, AZ	1999	NA	4391	4003	388	8.8
CN0401200000000	04	012	La Paz County, AZ	1999	NA	7234	6643	591	8.2
CN0401300000000	04	013	Maricopa County, AZ	1999	NA	1583933	1536576	47357	3
CN0401500000000	04	015	Mohave County, AZ	1999	NA	65598	62490	3108	4.7
CN0401700000000	04	017	Navajo County, AZ	1999	NA	33736	29228	4508	13.4
CN0401900000000	04	019	Pima County, AZ	1999	NA	403212	390493	12719	3.2
CN0402100000000	04	021	Pinal County, AZ	1999	NA	63257	59775	3482	5.5
CN0402300000000	04	023	Santa Cruz County, AZ	1999	NA	14202	11813	2389	16.8
CN0402500000000	04	025	Yavapai County, AZ	1999	NA	70754	68321	2433	3.4
CN0402700000000	04	027	Yuma County, AZ	1999	NA	69754	49062	20692	29.7
CN0500100000000	05	001	Arkansas County, AR	1999	NA	10836	10290	546	5
CN0500300000000	05	003	Ashley County, AR	1999	NA	11037	10125	912	8.3
CN0500500000000	05	005	Baxter County, AR	1999	NA	14489	13921	568	3.9
CN0500700000000	05	007	Benton County, AR	1999	NA	68697	67142	1555	2.3
CN0500900000000	05	009	Boone County, AR	1999	NA	14876	14044	832	5.6
CN0501100000000	05	011	Bradley County, AR	1999	NA	4483	4074	409	9.1
CN0501300000000	05	013	Calhoun County, AR	1999	NA	2294	2080	214	9.3
CN0501500000000	05	015	Carroll County, AR	1999	NA	11861	11325	536	4.5
CN0501700000000	05	017	Chicot County, AR	1999	NA	6382	5787	595	9.3
CN0501900000000	05	019	Clark County, AR	1999	NA	11926	11572	354	3
CN0502100000000	05	021	Clay County, AR	1999	NA	8168	7634	534	6.5
CN0502300000000	05	023	Cleburne County, AR	1999	NA	9715	9332	383	3.9
CN0502500000000	05	025	Cleveland County, AR	1999	NA	3806	3589	217	5.7
CN0502700000000	05	027	Columbia County, AR	1999	NA	11577	10856	721	6.2
CN0502900000000	05	029	Conway County, AR	1999	NA	9322	8669	653	7
CN0503100000000	05	031	Craighead County, AR	1999	NA	43275	41838	1437	3.3
CN0503300000000	05	033	Crawford County, AR	1999	NA	25072	24173	899	3.6
CN0503500000000	05	035	Crittenden County, AR	1999	NA	22952	21935	1017	4.4
CN0503700000000	05	037	Cross County, AR	1999	NA	8193	7650	543	6.6
CN0503900000000	05	039	Dallas County, AR	1999	NA	3607	3320	287	8
CN0504100000000	05	041	Desha County, AR	1999	NA	7166	6487	679	9.5
CN0504300000000	05	043	Drew County, AR	1999	NA	10016	9334	682	6.8
CN0504500000000	05	045	Faulkner County, AR	1999	NA	43257	41887	1370	3.2
CN0504700000000	05	047	Franklin County, AR	1999	NA	7713	7442	271	3.5
CN0504900000000	05	049	Fulton County, AR	1999	NA	4192	4023	169	4
CN0505100000000	05	051	Garland County, AR	1999	NA	36444	34777	1667	4.6
CN0505300000000	05	053	Grant County, AR	1999	NA	7455	7119	336	4.5
CN0505500000000	05	055	Greene County, AR	1999	NA	18771	17849	922	4.9
CN0505700000000	05	057	Hempstead County, AR	1999	NA	11555	10894	661	5.7
CN0505900000000	05	059	Hot Spring County, AR	1999	NA	12304	11757	547	4.4
CN0506100000000	05	061	Howard County, AR	1999	NA	6963	6587	376	5.4
CN0506300000000	05	063	Independence County, AR	1999	NA	17265	16439	826	4.8
CN0506500000000	05	065	Izard County, AR	1999	NA	4372	4189	183	4.2
CN0506700000000	05	067	Jackson County, AR	1999	NA	8022	7235	787	9.8
CN0506900000000	05	069	Jefferson County, AR	1999	NA	36987	34145	2842	7.7
CN0507100000000	05	071	Johnson County, AR	1999	NA	10756	10356	400	3.7
CN0507300000000	05	073	Lafayette County, AR	1999	NA	3479	3214	265	7.6
CN0507500000000	05	075	Lawrence County, AR	1999	NA	7428	6936	492	6.6
CN0507700000000	05	077	Lee County, AR	1999	NA	4606	4257	349	7.6
CN0507900000000	05	079	Lincoln County, AR	1999	NA	5374	5089	285	5.3
CN0508100000000	05	081	Little River County, AR	1999	NA	5600	5260	340	6.1
CN0508300000000	05	083	Logan County, AR	1999	NA	9709	9195	514	5.3
CN0508500000000	05	085	Lonoke County, AR	1999	NA	26397	25729	668	2.5
CN0508700000000	05	087	Madison County, AR	1999	NA	6750	6510	240	3.6
CN0508900000000	05	089	Marion County, AR	1999	NA	6240	6040	200	3.2
CN0509100000000	05	091	Miller County, AR	1999	NA	17602	16616	986	5.6
CN0509300000000	05	093	Mississippi County, AR	1999	NA	27068	24080	2988	11
CN0509500000000	05	095	Monroe County, AR	1999	NA	4085	3798	287	7
CN0509700000000	05	097	Montgomery County, AR	1999	NA	4034	3886	148	3.7
CN0509900000000	05	099	Nevada County, AR	1999	NA	5004	4702	302	6
CN0510100000000	05	101	Newton County, AR	1999	NA	2983	2804	179	6
CN0510300000000	05	103	Ouachita County, AR	1999	NA	11511	10475	1036	9
CN0510500000000	05	105	Perry County, AR	1999	NA	3640	3413	227	6.2
CN0510700000000	05	107	Phillips County, AR	1999	NA	9630	8876	754	7.8
CN0510900000000	05	109	Pike County, AR	1999	NA	4944	4707	237	4.8
CN0511100000000	05	111	Poinsett County, AR	1999	NA	10663	10009	654	6.1
CN0511300000000	05	113	Polk County, AR	1999	NA	9400	9032	368	3.9
CN0511500000000	05	115	Pope County, AR	1999	NA	27485	26267	1218	4.4
CN0511700000000	05	117	Prairie County, AR	1999	NA	3998	3770	228	5.7
CN0511900000000	05	119	Pulaski County, AR	1999	NA	194703	187912	6791	3.5
CN0512100000000	05	121	Randolph County, AR	1999	NA	7960	7411	549	6.9
CN0512300000000	05	123	St. Francis County, AR	1999	NA	12461	11317	1144	9.2
CN0512500000000	05	125	Saline County, AR	1999	NA	42321	41211	1110	2.6
CN0512700000000	05	127	Scott County, AR	1999	NA	4985	4850	135	2.7
CN0512900000000	05	129	Searcy County, AR	1999	NA	2997	2773	224	7.5
CN0513100000000	05	131	Sebastian County, AR	1999	NA	56409	54455	1954	3.5
CN0513300000000	05	133	Sevier County, AR	1999	NA	6942	6623	319	4.6
CN0513500000000	05	135	Sharp County, AR	1999	NA	6302	5978	324	5.1
CN0513700000000	05	137	Stone County, AR	1999	NA	5230	4974	256	4.9
CN0513900000000	05	139	Union County, AR	1999	NA	21108	19818	1290	6.1
CN0514100000000	05	141	Van Buren County, AR	1999	NA	6209	5848	361	5.8
CN0514300000000	05	143	Washington County, AR	1999	NA	78589	76553	2036	2.6
CN0514500000000	05	145	White County, AR	1999	NA	32011	30475	1536	4.8
CN0514700000000	05	147	Woodruff County, AR	1999	NA	3946	3534	412	10.4
CN0514900000000	05	149	Yell County, AR	1999	NA	9433	9051	382	4
CN0600100000000	06	001	Alameda County, CA	1999	NA	714059	689186	24873	3.5
CN0600300000000	06	003	Alpine County, CA	1999	NA	492	447	45	9.1
CN0600500000000	06	005	Amador County, CA	1999	NA	13519	12891	628	4.6
CN0600700000000	06	007	Butte County, CA	1999	NA	85499	79671	5828	6.8
CN0600900000000	06	009	Calaveras County, CA	1999	NA	14462	13450	1012	7
CN0601100000000	06	011	Colusa County, CA	1999	NA	8715	7324	1391	16
CN0601300000000	06	013	Contra Costa County, CA	1999	NA	486202	471358	14844	3.1
CN0601500000000	06	015	Del Norte County, CA	1999	NA	9867	9074	793	8
CN0601700000000	06	017	El Dorado County, CA	1999	NA	79215	76117	3098	3.9
CN0601900000000	06	019	Fresno County, CA	1999	NA	377383	326276	51107	13.5
CN0602100000000	06	021	Glenn County, CA	1999	NA	10384	9214	1170	11.3
CN0602300000000	06	023	Humboldt County, CA	1999	NA	59772	55904	3868	6.5
CN0602500000000	06	025	Imperial County, CA	1999	NA	55154	42127	13027	23.6
CN0602700000000	06	027	Inyo County, CA	1999	NA	7131	6723	408	5.7
CN0602900000000	06	029	Kern County, CA	1999	NA	278596	246709	31887	11.4
CN0603100000000	06	031	Kings County, CA	1999	NA	42836	37193	5643	13.2
CN0603300000000	06	033	Lake County, CA	1999	NA	23534	21696	1838	7.8
CN0603500000000	06	035	Lassen County, CA	1999	NA	11055	10275	780	7.1
CN0603700000000	06	037	Los Angeles County, CA	1999	NA	4576413	4307045	269368	5.9
CN0603900000000	06	039	Madera County, CA	1999	NA	52774	46635	6139	11.6
CN0604100000000	06	041	Marin County, CA	1999	NA	134113	131495	2618	2
CN0604300000000	06	043	Mariposa County, CA	1999	NA	6641	6147	494	7.4
CN0604500000000	06	045	Mendocino County, CA	1999	NA	41530	38710	2820	6.8
CN0604700000000	06	047	Merced County, CA	1999	NA	83648	72425	11223	13.4
CN0604900000000	06	049	Modoc County, CA	1999	NA	3989	3647	342	8.6
CN0605100000000	06	051	Mono County, CA	1999	NA	6134	5721	413	6.7
CN0605300000000	06	053	Monterey County, CA	1999	NA	187423	169338	18085	9.6
CN0605500000000	06	055	Napa County, CA	1999	NA	62158	60102	2056	3.3
CN0605700000000	06	057	Nevada County, CA	1999	NA	43505	41726	1779	4.1
CN0605900000000	06	059	Orange County, CA	1999	NA	1459901	1420878	39023	2.7
CN0606100000000	06	061	Placer County, CA	1999	NA	119867	115981	3886	3.2
CN0606300000000	06	063	Plumas County, CA	1999	NA	9426	8573	853	9
CN0606500000000	06	065	Riverside County, CA	1999	NA	690877	653014	37863	5.5
CN0606700000000	06	067	Sacramento County, CA	1999	NA	581617	556937	24680	4.2
CN0606900000000	06	069	San Benito County, CA	1999	NA	26220	24100	2120	8.1
CN0607100000000	06	071	San Bernardino County, CA	1999	NA	748372	712037	36335	4.9
CN0607300000000	06	073	San Diego County, CA	1999	NA	1350741	1308725	42016	3.1
CN0607500000000	06	075	San Francisco County/city, CA	1999	NA	417554	404744	12810	3.1
CN0607700000000	06	077	San Joaquin County, CA	1999	NA	250051	227938	22113	8.8
CN0607900000000	06	079	San Luis Obispo County, CA	1999	NA	111163	107542	3621	3.3
CN0608100000000	06	081	San Mateo County, CA	1999	NA	395072	387248	7824	2
CN0608300000000	06	083	Santa Barbara County, CA	1999	NA	197532	189812	7720	3.9
CN0608500000000	06	085	Santa Clara County, CA	1999	NA	957792	928555	29237	3.1
CN0608700000000	06	087	Santa Cruz County, CA	1999	NA	138703	129873	8830	6.4
CN0608900000000	06	089	Shasta County, CA	1999	NA	72119	67012	5107	7.1
CN0609100000000	06	091	Sierra County, CA	1999	NA	1621	1472	149	9.2
CN0609300000000	06	093	Siskiyou County, CA	1999	NA	17575	15750	1825	10.4
CN0609500000000	06	095	Solano County, CA	1999	NA	188845	180117	8728	4.6
CN0609700000000	06	097	Sonoma County, CA	1999	NA	248820	242079	6741	2.7
CN0609900000000	06	099	Stanislaus County, CA	1999	NA	201992	180565	21427	10.6
CN0610100000000	06	101	Sutter County, CA	1999	NA	35570	30915	4655	13.1
CN0610300000000	06	103	Tehama County, CA	1999	NA	24146	22514	1632	6.8
CN0610500000000	06	105	Trinity County, CA	1999	NA	4849	4287	562	11.6
CN0610700000000	06	107	Tulare County, CA	1999	NA	164680	137363	27317	16.6
CN0610900000000	06	109	Tuolumne County, CA	1999	NA	19813	18509	1304	6.6
CN0611100000000	06	111	Ventura County, CA	1999	NA	394297	375297	19000	4.8
CN0611300000000	06	113	Yolo County, CA	1999	NA	90710	86740	3970	4.4
CN0611500000000	06	115	Yuba County, CA	1999	NA	20474	18076	2398	11.7
CN0800100000000	08	001	Adams County, CO	1999	NA	183841	178606	5235	2.8
CN0800300000000	08	003	Alamosa County, CO	1999	NA	8345	7895	450	5.4
CN0800500000000	08	005	Arapahoe County, CO	1999	NA	294004	287376	6628	2.3
CN0800700000000	08	007	Archuleta County, CO	1999	NA	4765	4569	196	4.1
CN0800900000000	08	009	Baca County, CO	1999	NA	2388	2327	61	2.6
CN0801100000000	08	011	Bent County, CO	1999	NA	2253	2174	79	3.5
CN0801300000000	08	013	Boulder County, CO	1999	NA	170041	165215	4826	2.8
CN0801400000000	08	014	Broomfield County/city, CO	1999	NA	19259	18866	393	2
CN0801500000000	08	015	Chaffee County, CO	1999	NA	7931	7666	265	3.3
CN0801700000000	08	017	Cheyenne County, CO	1999	NA	1294	1245	49	3.8
CN0801900000000	08	019	Clear Creek County, CO	1999	NA	5378	5217	161	3
CN0802100000000	08	021	Conejos County, CO	1999	NA	3786	3502	284	7.5
CN0802300000000	08	023	Costilla County, CO	1999	NA	1403	1236	167	11.9
CN0802500000000	08	025	Crowley County, CO	1999	NA	1385	1323	62	4.5
CN0802700000000	08	027	Custer County, CO	1999	NA	1824	1778	46	2.5
CN0802900000000	08	029	Delta County, CO	1999	NA	11233	10691	542	4.8
CN0803100000000	08	031	Denver County/city, CO	1999	NA	285676	276241	9435	3.3
CN0803300000000	08	033	Dolores County, CO	1999	NA	725	662	63	8.7
CN0803500000000	08	035	Douglas County, CO	1999	NA	96048	94672	1376	1.4
CN0803700000000	08	037	Eagle County, CO	1999	NA	21519	20950	569	2.6
CN0803900000000	08	039	Elbert County, CO	1999	NA	12475	12111	364	2.9
CN0804100000000	08	041	El Paso County, CO	1999	NA	268032	258648	9384	3.5
CN0804300000000	08	043	Fremont County, CO	1999	NA	17970	17229	741	4.1
CN0804500000000	08	045	Garfield County, CO	1999	NA	23719	23019	700	3
CN0804700000000	08	047	Gilpin County, CO	1999	NA	3374	3296	78	2.3
CN0804900000000	08	049	Grand County, CO	1999	NA	6196	6048	148	2.4
CN0805100000000	08	051	Gunnison County, CO	1999	NA	8310	7894	416	5
CN0805300000000	08	053	Hinsdale County, CO	1999	NA	640	624	16	2.5
CN0805500000000	08	055	Huerfano County, CO	1999	NA	3785	3569	216	5.7
CN0805700000000	08	057	Jackson County, CO	1999	NA	923	877	46	5
CN0805900000000	08	059	Jefferson County, CO	1999	NA	315872	308617	7255	2.3
CN0806100000000	08	061	Kiowa County, CO	1999	NA	859	822	37	4.3
CN0806300000000	08	063	Kit Carson County, CO	1999	NA	3786	3698	88	2.3
CN0806500000000	08	065	Lake County, CO	1999	NA	3265	3094	171	5.2
CN0806700000000	08	067	La Plata County, CO	1999	NA	25083	24069	1014	4
CN0806900000000	08	069	Larimer County, CO	1999	NA	145724	140987	4737	3.3
CN0807100000000	08	071	Las Animas County, CO	1999	NA	6899	6522	377	5.5
CN0807300000000	08	073	Lincoln County, CO	1999	NA	2714	2671	43	1.6
CN0807500000000	08	075	Logan County, CO	1999	NA	10222	9868	354	3.5
CN0807700000000	08	077	Mesa County, CO	1999	NA	60750	58335	2415	4
CN0807900000000	08	079	Mineral County, CO	1999	NA	436	423	13	3
CN0808100000000	08	081	Moffat County, CO	1999	NA	6465	6090	375	5.8
CN0808300000000	08	083	Montezuma County, CO	1999	NA	12125	11488	637	5.3
CN0808500000000	08	085	Montrose County, CO	1999	NA	15980	15083	897	5.6
CN0808700000000	08	087	Morgan County, CO	1999	NA	13157	12728	429	3.3
CN0808900000000	08	089	Otero County, CO	1999	NA	9091	8639	452	5
CN0809100000000	08	091	Ouray County, CO	1999	NA	1874	1802	72	3.8
CN0809300000000	08	093	Park County, CO	1999	NA	8303	8041	262	3.2
CN0809500000000	08	095	Phillips County, CO	1999	NA	2105	2069	36	1.7
CN0809700000000	08	097	Pitkin County, CO	1999	NA	9271	8951	320	3.5
CN0809900000000	08	099	Prowers County, CO	1999	NA	7266	7041	225	3.1
CN0810100000000	08	101	Pueblo County, CO	1999	NA	62350	59183	3167	5.1
CN0810300000000	08	103	Rio Blanco County, CO	1999	NA	3170	3037	133	4.2
CN0810500000000	08	105	Rio Grande County, CO	1999	NA	5171	4789	382	7.4
CN0810700000000	08	107	Routt County, CO	1999	NA	11611	11279	332	2.9
CN0810900000000	08	109	Saguache County, CO	1999	NA	2867	2615	252	8.8
CN0811100000000	08	111	San Juan County, CO	1999	NA	298	262	36	12.1
CN0811300000000	08	113	San Miguel County, CO	1999	NA	4771	4561	210	4.4
CN0811500000000	08	115	Sedgwick County, CO	1999	NA	1233	1201	32	2.6
CN0811700000000	08	117	Summit County, CO	1999	NA	13233	12927	306	2.3
CN0811900000000	08	119	Teller County, CO	1999	NA	13931	13436	495	3.6
CN0812100000000	08	121	Washington County, CO	1999	NA	2451	2388	63	2.6
CN0812300000000	08	123	Weld County, CO	1999	NA	88839	85480	3359	3.8
CN0812500000000	08	125	Yuma County, CO	1999	NA	4592	4476	116	2.5
CN0900100000000	09	001	Fairfield County, CT	1999	NA	456719	444811	11908	2.6
CN0900300000000	09	003	Hartford County, CT	1999	NA	426197	412736	13461	3.2
CN0900500000000	09	005	Litchfield County, CT	1999	NA	102615	100148	2467	2.4
CN0900700000000	09	007	Middlesex County, CT	1999	NA	84357	82258	2099	2.5
CN0900900000000	09	009	New Haven County, CT	1999	NA	421329	408348	12981	3.1
CN0901100000000	09	011	New London County, CT	1999	NA	134612	130573	4039	3
CN0901300000000	09	013	Tolland County, CT	1999	NA	71638	70085	1553	2.2
CN0901500000000	09	015	Windham County, CT	1999	NA	57099	55180	1919	3.4
CN1000100000000	10	001	Kent County, DE	1999	NA	69925	67338	2587	3.7
CN1000300000000	10	003	New Castle County, DE	1999	NA	257207	249205	8002	3.1
CN1000500000000	10	005	Sussex County, DE	1999	NA	71650	68647	3003	4.2
CN1100100000000	11	001	District of Columbia	1999	NA	306131	286650	19481	6.4
CN1200100000000	12	001	Alachua County, FL	1999	NA	109256	106801	2455	2.2
CN1200300000000	12	003	Baker County, FL	1999	NA	9064	8748	316	3.5
CN1200500000000	12	005	Bay County, FL	1999	NA	68609	64225	4384	6.4
CN1200700000000	12	007	Bradford County, FL	1999	NA	10057	9706	351	3.5
CN1200900000000	12	009	Brevard County, FL	1999	NA	214156	205403	8753	4.1
CN1201100000000	12	011	Broward County, FL	1999	NA	797693	763685	34008	4.3
CN1201300000000	12	013	Calhoun County, FL	1999	NA	4996	4651	345	6.9
CN1201500000000	12	015	Charlotte County, FL	1999	NA	49986	48333	1653	3.3
CN1201700000000	12	017	Citrus County, FL	1999	NA	37682	35857	1825	4.8
CN1201900000000	12	019	Clay County, FL	1999	NA	74054	72060	1994	2.7
CN1202100000000	12	021	Collier County, FL	1999	NA	99022	95142	3880	3.9
CN1202300000000	12	023	Columbia County, FL	1999	NA	25235	24079	1156	4.6
CN1202700000000	12	027	DeSoto County, FL	1999	NA	9182	8561	621	6.8
CN1202900000000	12	029	Dixie County, FL	1999	NA	3838	3629	209	5.4
CN1203100000000	12	031	Duval County, FL	1999	NA	396524	383585	12939	3.3
CN1203300000000	12	033	Escambia County, FL	1999	NA	124696	120038	4658	3.7
CN1203500000000	12	035	Flagler County, FL	1999	NA	18248	17635	613	3.4
CN1203700000000	12	037	Franklin County, FL	1999	NA	4733	4505	228	4.8
CN1203900000000	12	039	Gadsden County, FL	1999	NA	20524	19755	769	3.7
CN1204100000000	12	041	Gilchrist County, FL	1999	NA	4650	4460	190	4.1
CN1204300000000	12	043	Glades County, FL	1999	NA	3952	3650	302	7.6
CN1204500000000	12	045	Gulf County, FL	1999	NA	5516	4732	784	14.2
CN1204700000000	12	047	Hamilton County, FL	1999	NA	3547	3306	241	6.8
CN1204900000000	12	049	Hardee County, FL	1999	NA	9798	8759	1039	10.6
CN1205100000000	12	051	Hendry County, FL	1999	NA	16248	14158	2090	12.9
CN1205300000000	12	053	Hernando County, FL	1999	NA	49621	47891	1730	3.5
CN1205500000000	12	055	Highlands County, FL	1999	NA	26906	24985	1921	7.1
CN1205700000000	12	057	Hillsborough County, FL	1999	NA	570838	555196	15642	2.7
CN1205900000000	12	059	Holmes County, FL	1999	NA	6798	6408	390	5.7
CN1206100000000	12	061	Indian River County, FL	1999	NA	47140	43428	3712	7.9
CN1206300000000	12	063	Jackson County, FL	1999	NA	18562	17318	1244	6.7
CN1206500000000	12	065	Jefferson County, FL	1999	NA	5034	4811	223	4.4
CN1206700000000	12	067	Lafayette County, FL	1999	NA	3050	2978	72	2.4
CN1206900000000	12	069	Lake County, FL	1999	NA	95616	93064	2552	2.7
CN1207100000000	12	071	Lee County, FL	1999	NA	186043	181024	5019	2.7
CN1207300000000	12	073	Leon County, FL	1999	NA	134906	131423	3483	2.6
CN1207500000000	12	075	Levy County, FL	1999	NA	13404	12960	444	3.3
CN1207700000000	12	077	Liberty County, FL	1999	NA	2389	2271	118	4.9
CN1207900000000	12	079	Madison County, FL	1999	NA	7672	7379	293	3.8
CN1208100000000	12	081	Manatee County, FL	1999	NA	125056	122143	2913	2.3
CN1208300000000	12	083	Marion County, FL	1999	NA	102068	98176	3892	3.8
CN1208500000000	12	085	Martin County, FL	1999	NA	50204	47599	2605	5.2
CN1208600000000	12	086	Miami-Dade County, FL	1999	NA	1086593	1033333	53260	4.9
CN1208700000000	12	087	Monroe County, FL	1999	NA	47660	46543	1117	2.3
CN1208900000000	12	089	Nassau County, FL	1999	NA	29984	28943	1041	3.5
CN1209100000000	12	091	Okaloosa County, FL	1999	NA	83745	80872	2873	3.4
CN1209300000000	12	093	Okeechobee County, FL	1999	NA	16411	15113	1298	7.9
CN1209500000000	12	095	Orange County, FL	1999	NA	507335	492721	14614	2.9
CN1209700000000	12	097	Osceola County, FL	1999	NA	87824	85348	2476	2.8
CN1209900000000	12	099	Palm Beach County, FL	1999	NA	526787	498879	27908	5.3
CN1210100000000	12	101	Pasco County, FL	1999	NA	141898	137259	4639	3.3
CN1210300000000	12	103	Pinellas County, FL	1999	NA	484824	470970	13854	2.9
CN1210500000000	12	105	Polk County, FL	1999	NA	208685	198023	10662	5.1
CN1210700000000	12	107	Putnam County, FL	1999	NA	28916	27392	1524	5.3
CN1210900000000	12	109	St. Johns County, FL	1999	NA	63910	62300	1610	2.5
CN1211100000000	12	111	St. Lucie County, FL	1999	NA	80876	73189	7687	9.5
CN1211300000000	12	113	Santa Rosa County, FL	1999	NA	55472	53217	2255	4.1
CN1211500000000	12	115	Sarasota County, FL	1999	NA	156357	152817	3540	2.3
CN1211700000000	12	117	Seminole County, FL	1999	NA	225332	219006	6326	2.8
CN1211900000000	12	119	Sumter County, FL	1999	NA	14724	14297	427	2.9
CN1212100000000	12	121	Suwannee County, FL	1999	NA	13795	13231	564	4.1
CN1212300000000	12	123	Taylor County, FL	1999	NA	7590	7016	574	7.6
CN1212500000000	12	125	Union County, FL	1999	NA	3578	3480	98	2.7
CN1212700000000	12	127	Volusia County, FL	1999	NA	180429	174554	5875	3.3
CN1212900000000	12	129	Wakulla County, FL	1999	NA	11387	11025	362	3.2
CN1213100000000	12	131	Walton County, FL	1999	NA	16483	15849	634	3.8
CN1213300000000	12	133	Washington County, FL	1999	NA	9996	9568	428	4.3
CN1300100000000	13	001	Appling County, GA	1999	NA	8300	7486	814	9.8
CN1300300000000	13	003	Atkinson County, GA	1999	NA	3392	3185	207	6.1
CN1300500000000	13	005	Bacon County, GA	1999	NA	4340	4032	308	7.1
CN1300700000000	13	007	Baker County, GA	1999	NA	1644	1530	114	6.9
CN1300900000000	13	009	Baldwin County, GA	1999	NA	17831	16766	1065	6
CN1301100000000	13	011	Banks County, GA	1999	NA	6442	6203	239	3.7
CN1301300000000	13	013	Barrow County, GA	1999	NA	21518	20884	634	2.9
CN1301500000000	13	015	Bartow County, GA	1999	NA	40594	39009	1585	3.9
CN1301700000000	13	017	Ben Hill County, GA	1999	NA	9687	9079	608	6.3
CN1301900000000	13	019	Berrien County, GA	1999	NA	6880	6424	456	6.6
CN1302100000000	13	021	Bibb County, GA	1999	NA	71063	67378	3685	5.2
CN1302300000000	13	023	Bleckley County, GA	1999	NA	5812	5558	254	4.4
CN1302500000000	13	025	Brantley County, GA	1999	NA	5995	5586	409	6.8
CN1302700000000	13	027	Brooks County, GA	1999	NA	7779	7433	346	4.4
CN1302900000000	13	029	Bryan County, GA	1999	NA	11377	11009	368	3.2
CN1303100000000	13	031	Bulloch County, GA	1999	NA	26885	26203	682	2.5
CN1303300000000	13	033	Burke County, GA	1999	NA	8825	7983	842	9.5
CN1303500000000	13	035	Butts County, GA	1999	NA	8633	8270	363	4.2
CN1303700000000	13	037	Calhoun County, GA	1999	NA	2443	2225	218	8.9
CN1303900000000	13	039	Camden County, GA	1999	NA	17108	16483	625	3.7
CN1304300000000	13	043	Candler County, GA	1999	NA	4126	3901	225	5.5
CN1304500000000	13	045	Carroll County, GA	1999	NA	45351	43330	2021	4.5
CN1304700000000	13	047	Catoosa County, GA	1999	NA	27451	26592	859	3.1
CN1304900000000	13	049	Charlton County, GA	1999	NA	3876	3700	176	4.5
CN1305100000000	13	051	Chatham County, GA	1999	NA	108268	103553	4715	4.4
CN1305300000000	13	053	Chattahoochee County, GA	1999	NA	2471	2304	167	6.8
CN1305500000000	13	055	Chattooga County, GA	1999	NA	12184	11702	482	4
CN1305700000000	13	057	Cherokee County, GA	1999	NA	82552	80910	1642	2
CN1305900000000	13	059	Clarke County, GA	1999	NA	47095	45786	1309	2.8
CN1306100000000	13	061	Clay County, GA	1999	NA	1571	1469	102	6.5
CN1306300000000	13	063	Clayton County, GA	1999	NA	125858	121492	4366	3.5
CN1306500000000	13	065	Clinch County, GA	1999	NA	3516	3391	125	3.6
CN1306700000000	13	067	Cobb County, GA	1999	NA	361419	352249	9170	2.5
CN1306900000000	13	069	Coffee County, GA	1999	NA	21131	20116	1015	4.8
CN1307100000000	13	071	Colquitt County, GA	1999	NA	19623	18408	1215	6.2
CN1307300000000	13	073	Columbia County, GA	1999	NA	45963	44553	1410	3.1
CN1307500000000	13	075	Cook County, GA	1999	NA	7968	7582	386	4.8
CN1307700000000	13	077	Coweta County, GA	1999	NA	46728	45441	1287	2.8
CN1307900000000	13	079	Crawford County, GA	1999	NA	5710	5463	247	4.3
CN1308100000000	13	081	Crisp County, GA	1999	NA	10036	9450	586	5.8
CN1308300000000	13	083	Dade County, GA	1999	NA	7628	7347	281	3.7
CN1308500000000	13	085	Dawson County, GA	1999	NA	10469	10193	276	2.6
CN1308700000000	13	087	Decatur County, GA	1999	NA	12099	11432	667	5.5
CN1308900000000	13	089	DeKalb County, GA	1999	NA	364047	349921	14126	3.9
CN1309100000000	13	091	Dodge County, GA	1999	NA	9916	9412	504	5.1
CN1309300000000	13	093	Dooly County, GA	1999	NA	4753	4445	308	6.5
CN1309500000000	13	095	Dougherty County, GA	1999	NA	45820	42055	3765	8.2
CN1309700000000	13	097	Douglas County, GA	1999	NA	52751	51244	1507	2.9
CN1309900000000	13	099	Early County, GA	1999	NA	4752	4335	417	8.8
CN1310100000000	13	101	Echols County, GA	1999	NA	1282	1225	57	4.4
CN1310300000000	13	103	Effingham County, GA	1999	NA	18780	18177	603	3.2
CN1310500000000	13	105	Elbert County, GA	1999	NA	8894	8239	655	7.4
CN1310700000000	13	107	Emanuel County, GA	1999	NA	8767	7851	916	10.4
CN1310900000000	13	109	Evans County, GA	1999	NA	4873	4683	190	3.9
CN1311100000000	13	111	Fannin County, GA	1999	NA	8998	8600	398	4.4
CN1311300000000	13	113	Fayette County, GA	1999	NA	51257	50330	927	1.8
CN1311500000000	13	115	Floyd County, GA	1999	NA	45708	43530	2178	4.8
CN1311700000000	13	117	Forsyth County, GA	1999	NA	55366	54493	873	1.6
CN1311900000000	13	119	Franklin County, GA	1999	NA	10337	9994	343	3.3
CN1312100000000	13	121	Fulton County, GA	1999	NA	408023	392495	15528	3.8
CN1312300000000	13	123	Gilmer County, GA	1999	NA	8472	8160	312	3.7
CN1312500000000	13	125	Glascock County, GA	1999	NA	998	928	70	7
CN1312700000000	13	127	Glynn County, GA	1999	NA	36144	34970	1174	3.2
CN1312900000000	13	129	Gordon County, GA	1999	NA	22644	21505	1139	5
CN1313100000000	13	131	Grady County, GA	1999	NA	9389	8545	844	9
CN1313300000000	13	133	Greene County, GA	1999	NA	5962	5609	353	5.9
CN1313500000000	13	135	Gwinnett County, GA	1999	NA	343799	335801	7998	2.3
CN1313700000000	13	137	Habersham County, GA	1999	NA	16047	15478	569	3.5
CN1313900000000	13	139	Hall County, GA	1999	NA	72722	70861	1861	2.6
CN1314100000000	13	141	Hancock County, GA	1999	NA	4030	3524	506	12.6
CN1314300000000	13	143	Haralson County, GA	1999	NA	9677	9206	471	4.9
CN1314500000000	13	145	Harris County, GA	1999	NA	12356	12020	336	2.7
CN1314700000000	13	147	Hart County, GA	1999	NA	9762	9367	395	4
CN1314900000000	13	149	Heard County, GA	1999	NA	4873	4556	317	6.5
CN1315100000000	13	151	Henry County, GA	1999	NA	63475	62227	1248	2
CN1315300000000	13	153	Houston County, GA	1999	NA	50694	48711	1983	3.9
CN1315500000000	13	155	Irwin County, GA	1999	NA	5082	4850	232	4.6
CN1315700000000	13	157	Jackson County, GA	1999	NA	22678	21868	810	3.6
CN1315900000000	13	159	Jasper County, GA	1999	NA	4841	4653	188	3.9
CN1316100000000	13	161	Jeff Davis County, GA	1999	NA	5394	5016	378	7
CN1316300000000	13	163	Jefferson County, GA	1999	NA	7587	6584	1003	13.2
CN1316500000000	13	165	Jenkins County, GA	1999	NA	4530	4320	210	4.6
CN1316700000000	13	167	Johnson County, GA	1999	NA	3582	3273	309	8.6
CN1316900000000	13	169	Jones County, GA	1999	NA	11774	11277	497	4.2
CN1317100000000	13	171	Lamar County, GA	1999	NA	6960	6552	408	5.9
CN1317300000000	13	173	Lanier County, GA	1999	NA	3604	3458	146	4.1
CN1317500000000	13	175	Laurens County, GA	1999	NA	23102	21306	1796	7.8
CN1317700000000	13	177	Lee County, GA	1999	NA	12244	11693	551	4.5
CN1317900000000	13	179	Liberty County, GA	1999	NA	17301	16228	1073	6.2
CN1318100000000	13	181	Lincoln County, GA	1999	NA	3492	3114	378	10.8
CN1318300000000	13	183	Long County, GA	1999	NA	3689	3580	109	3
CN1318500000000	13	185	Lowndes County, GA	1999	NA	43717	41805	1912	4.4
CN1318700000000	13	187	Lumpkin County, GA	1999	NA	10937	10701	236	2.2
CN1318900000000	13	189	McDuffie County, GA	1999	NA	9952	9292	660	6.6
CN1319100000000	13	191	McIntosh County, GA	1999	NA	4633	4438	195	4.2
CN1319300000000	13	193	Macon County, GA	1999	NA	5412	4933	479	8.9
CN1319500000000	13	195	Madison County, GA	1999	NA	13892	13469	423	3
CN1319700000000	13	197	Marion County, GA	1999	NA	3463	3287	176	5.1
CN1319900000000	13	199	Meriwether County, GA	1999	NA	9249	8726	523	5.7
CN1320100000000	13	201	Miller County, GA	1999	NA	3214	3060	154	4.8
CN1320500000000	13	205	Mitchell County, GA	1999	NA	12040	11106	934	7.8
CN1320700000000	13	207	Monroe County, GA	1999	NA	7777	7350	427	5.5
CN1320900000000	13	209	Montgomery County, GA	1999	NA	3905	3519	386	9.9
CN1321100000000	13	211	Morgan County, GA	1999	NA	7257	6979	278	3.8
CN1321300000000	13	213	Murray County, GA	1999	NA	19547	18930	617	3.2
CN1321500000000	13	215	Muscogee County, GA	1999	NA	88389	83604	4785	5.4
CN1321700000000	13	217	Newton County, GA	1999	NA	30686	29658	1028	3.4
CN1321900000000	13	219	Oconee County, GA	1999	NA	13745	13543	202	1.5
CN1322100000000	13	221	Oglethorpe County, GA	1999	NA	6100	5908	192	3.1
CN1322300000000	13	223	Paulding County, GA	1999	NA	43224	42345	879	2
CN1322500000000	13	225	Peach County, GA	1999	NA	10997	10357	640	5.8
CN1322700000000	13	227	Pickens County, GA	1999	NA	11179	10894	285	2.5
CN1322900000000	13	229	Pierce County, GA	1999	NA	7474	7084	390	5.2
CN1323100000000	13	231	Pike County, GA	1999	NA	6491	6227	264	4.1
CN1323300000000	13	233	Polk County, GA	1999	NA	16421	15469	952	5.8
CN1323500000000	13	235	Pulaski County, GA	1999	NA	4664	4437	227	4.9
CN1323700000000	13	237	Putnam County, GA	1999	NA	9679	9350	329	3.4
CN1323900000000	13	239	Quitman County, GA	1999	NA	1283	1235	48	3.7
CN1324100000000	13	241	Rabun County, GA	1999	NA	7404	7196	208	2.8
CN1324300000000	13	243	Randolph County, GA	1999	NA	3243	2954	289	8.9
CN1324500000000	13	245	Richmond County, GA	1999	NA	82070	76944	5126	6.2
CN1324700000000	13	247	Rockdale County, GA	1999	NA	39711	38722	989	2.5
CN1324900000000	13	249	Schley County, GA	1999	NA	1840	1756	84	4.6
CN1325100000000	13	251	Screven County, GA	1999	NA	5974	5540	434	7.3
CN1325300000000	13	253	Seminole County, GA	1999	NA	4516	4303	213	4.7
CN1325500000000	13	255	Spalding County, GA	1999	NA	29581	28365	1216	4.1
CN1325700000000	13	257	Stephens County, GA	1999	NA	12143	11550	593	4.9
CN1325900000000	13	259	Stewart County, GA	1999	NA	2367	2226	141	6
CN1326100000000	13	261	Sumter County, GA	1999	NA	15638	14679	959	6.1
CN1326300000000	13	263	Talbot County, GA	1999	NA	2885	2701	184	6.4
CN1326500000000	13	265	Taliaferro County, GA	1999	NA	769	726	43	5.6
CN1326700000000	13	267	Tattnall County, GA	1999	NA	7428	6999	429	5.8
CN1326900000000	13	269	Taylor County, GA	1999	NA	3938	3695	243	6.2
CN1327100000000	13	271	Telfair County, GA	1999	NA	5003	4404	599	12
CN1327300000000	13	273	Terrell County, GA	1999	NA	4003	3607	396	9.9
CN1327500000000	13	275	Thomas County, GA	1999	NA	22226	21077	1149	5.2
CN1327700000000	13	277	Tift County, GA	1999	NA	20988	19959	1029	4.9
CN1327900000000	13	279	Toombs County, GA	1999	NA	12835	11561	1274	9.9
CN1328100000000	13	281	Towns County, GA	1999	NA	4036	3873	163	4
CN1328300000000	13	283	Treutlen County, GA	1999	NA	2972	2596	376	12.7
CN1328500000000	13	285	Troup County, GA	1999	NA	31111	29634	1477	4.7
CN1328700000000	13	287	Turner County, GA	1999	NA	4357	3917	440	10.1
CN1328900000000	13	289	Twiggs County, GA	1999	NA	4160	3878	282	6.8
CN1329100000000	13	291	Union County, GA	1999	NA	7774	7514	260	3.3
CN1329300000000	13	293	Upson County, GA	1999	NA	13158	12196	962	7.3
CN1329500000000	13	295	Walker County, GA	1999	NA	32117	30851	1266	3.9
CN1329700000000	13	297	Walton County, GA	1999	NA	30278	29296	982	3.2
CN1329900000000	13	299	Ware County, GA	1999	NA	15641	14823	818	5.2
CN1330100000000	13	301	Warren County, GA	1999	NA	2697	2416	281	10.4
CN1330300000000	13	303	Washington County, GA	1999	NA	9882	9152	730	7.4
CN1330500000000	13	305	Wayne County, GA	1999	NA	11926	11168	758	6.4
CN1330700000000	13	307	Webster County, GA	1999	NA	1172	1111	61	5.2
CN1330900000000	13	309	Wheeler County, GA	1999	NA	2079	1841	238	11.4
CN1331100000000	13	311	White County, GA	1999	NA	9393	8969	424	4.5
CN1331300000000	13	313	Whitfield County, GA	1999	NA	46644	45428	1216	2.6
CN1331500000000	13	315	Wilcox County, GA	1999	NA	3471	3281	190	5.5
CN1331700000000	13	317	Wilkes County, GA	1999	NA	5694	5366	328	5.8
CN1331900000000	13	319	Wilkinson County, GA	1999	NA	4725	4296	429	9.1
CN1332100000000	13	321	Worth County, GA	1999	NA	9475	8768	707	7.5
CN1500100000000	15	001	Hawaii County, HI	1999	NA	70485	64568	5917	8.4
CN1500300000000	15	003	Honolulu County/city, HI	1999	NA	430460	410022	20438	4.7
CN1500700000000	15	007	Kauai County, HI	1999	NA	29362	27188	2174	7.4
CN1500900000000	15	009	Maui County, HI	1999	NA	72599	68616	3983	5.5
CN1600100000000	16	001	Ada County, ID	1999	NA	166095	160959	5136	3.1
CN1600300000000	16	003	Adams County, ID	1999	NA	1607	1378	229	14.3
CN1600500000000	16	005	Bannock County, ID	1999	NA	39197	37236	1961	5
CN1600700000000	16	007	Bear Lake County, ID	1999	NA	2947	2818	129	4.4
CN1600900000000	16	009	Benewah County, ID	1999	NA	4411	3882	529	12
CN1601100000000	16	011	Bingham County, ID	1999	NA	21887	20833	1054	4.8
CN1601300000000	16	013	Blaine County, ID	1999	NA	11089	10695	394	3.6
CN1601500000000	16	015	Boise County, ID	1999	NA	2462	2285	177	7.2
CN1601700000000	16	017	Bonner County, ID	1999	NA	17373	15800	1573	9.1
CN1601900000000	16	019	Bonneville County, ID	1999	NA	46383	44784	1599	3.4
CN1602100000000	16	021	Boundary County, ID	1999	NA	4459	4070	389	8.7
CN1602300000000	16	023	Butte County, ID	1999	NA	1592	1532	60	3.8
CN1602500000000	16	025	Camas County, ID	1999	NA	411	394	17	4.1
CN1602700000000	16	027	Canyon County, ID	1999	NA	63472	60581	2891	4.6
CN1602900000000	16	029	Caribou County, ID	1999	NA	3097	2919	178	5.7
CN1603100000000	16	031	Cassia County, ID	1999	NA	9648	9028	620	6.4
CN1603300000000	16	033	Clark County, ID	1999	NA	553	535	18	3.3
CN1603500000000	16	035	Clearwater County, ID	1999	NA	4060	3540	520	12.8
CN1603700000000	16	037	Custer County, ID	1999	NA	1998	1845	153	7.7
CN1603900000000	16	039	Elmore County, ID	1999	NA	9213	8642	571	6.2
CN1604100000000	16	041	Franklin County, ID	1999	NA	4633	4478	155	3.3
CN1604300000000	16	043	Fremont County, ID	1999	NA	4805	4492	313	6.5
CN1604500000000	16	045	Gem County, ID	1999	NA	6245	5836	409	6.5
CN1604700000000	16	047	Gooding County, ID	1999	NA	6604	6379	225	3.4
CN1604900000000	16	049	Idaho County, ID	1999	NA	6244	5608	636	10.2
CN1605100000000	16	051	Jefferson County, ID	1999	NA	10274	9843	431	4.2
CN1605300000000	16	053	Jerome County, ID	1999	NA	8932	8549	383	4.3
CN1605500000000	16	055	Kootenai County, ID	1999	NA	55675	51460	4215	7.6
CN1605700000000	16	057	Latah County, ID	1999	NA	14847	14386	461	3.1
CN1605900000000	16	059	Lemhi County, ID	1999	NA	3843	3550	293	7.6
CN1606100000000	16	061	Lewis County, ID	1999	NA	1536	1437	99	6.4
CN1606300000000	16	063	Lincoln County, ID	1999	NA	1866	1770	96	5.1
CN1606500000000	16	065	Madison County, ID	1999	NA	10424	10170	254	2.4
CN1606700000000	16	067	Minidoka County, ID	1999	NA	9798	9095	703	7.2
CN1606900000000	16	069	Nez Perce County, ID	1999	NA	23331	22459	872	3.7
CN1607100000000	16	071	Oneida County, ID	1999	NA	1732	1667	65	3.8
CN1607300000000	16	073	Owyhee County, ID	1999	NA	4394	4212	182	4.1
CN1607500000000	16	075	Payette County, ID	1999	NA	10157	9440	717	7.1
CN1607700000000	16	077	Power County, ID	1999	NA	3457	3219	238	6.9
CN1607900000000	16	079	Shoshone County, ID	1999	NA	6531	5810	721	11
CN1608100000000	16	081	Teton County, ID	1999	NA	3087	2983	104	3.4
CN1608300000000	16	083	Twin Falls County, ID	1999	NA	32193	30714	1479	4.6
CN1608500000000	16	085	Valley County, ID	1999	NA	4036	3680	356	8.8
CN1608700000000	16	087	Washington County, ID	1999	NA	4615	4247	368	8
CN1700100000000	17	001	Adams County, IL	1999	NA	37500	36310	1190	3.2
CN1700300000000	17	003	Alexander County, IL	1999	NA	4259	3986	273	6.4
CN1700500000000	17	005	Bond County, IL	1999	NA	8333	8025	308	3.7
CN1700700000000	17	007	Boone County, IL	1999	NA	22298	21418	880	3.9
CN1700900000000	17	009	Brown County, IL	1999	NA	3131	3039	92	2.9
CN1701100000000	17	011	Bureau County, IL	1999	NA	19306	18493	813	4.2
CN1701300000000	17	013	Calhoun County, IL	1999	NA	3387	3244	143	4.2
CN1701500000000	17	015	Carroll County, IL	1999	NA	9149	8672	477	5.2
CN1701700000000	17	017	Cass County, IL	1999	NA	7447	7092	355	4.8
CN1701900000000	17	019	Champaign County, IL	1999	NA	98260	96044	2216	2.3
CN1702100000000	17	021	Christian County, IL	1999	NA	19378	18426	952	4.9
CN1702300000000	17	023	Clark County, IL	1999	NA	10539	10181	358	3.4
CN1702500000000	17	025	Clay County, IL	1999	NA	7398	6874	524	7.1
CN1702700000000	17	027	Clinton County, IL	1999	NA	17552	16943	609	3.5
CN1702900000000	17	029	Coles County, IL	1999	NA	28352	27508	844	3
CN1703100000000	17	031	Cook County, IL	1999	NA	2723536	2586017	137519	5
CN1703300000000	17	033	Crawford County, IL	1999	NA	9998	9427	571	5.7
CN1703500000000	17	035	Cumberland County, IL	1999	NA	5742	5535	207	3.6
CN1703700000000	17	037	DeKalb County, IL	1999	NA	49619	47924	1695	3.4
CN1703900000000	17	039	De Witt County, IL	1999	NA	8439	7987	452	5.4
CN1704100000000	17	041	Douglas County, IL	1999	NA	12825	12442	383	3
CN1704300000000	17	043	DuPage County, IL	1999	NA	536116	520202	15914	3
CN1704500000000	17	045	Edgar County, IL	1999	NA	10642	10258	384	3.6
CN1704700000000	17	047	Edwards County, IL	1999	NA	3803	3580	223	5.9
CN1704900000000	17	049	Effingham County, IL	1999	NA	18917	18189	728	3.8
CN1705100000000	17	051	Fayette County, IL	1999	NA	10881	10244	637	5.9
CN1705300000000	17	053	Ford County, IL	1999	NA	6773	6535	238	3.5
CN1705500000000	17	055	Franklin County, IL	1999	NA	17091	15891	1200	7
CN1705700000000	17	057	Fulton County, IL	1999	NA	14507	13583	924	6.4
CN1705900000000	17	059	Gallatin County, IL	1999	NA	2853	2681	172	6
CN1706100000000	17	061	Greene County, IL	1999	NA	7628	7311	317	4.2
CN1706300000000	17	063	Grundy County, IL	1999	NA	19680	18311	1369	7
CN1706500000000	17	065	Hamilton County, IL	1999	NA	3754	3511	243	6.5
CN1706700000000	17	067	Hancock County, IL	1999	NA	12928	12513	415	3.2
CN1706900000000	17	069	Hardin County, IL	1999	NA	1889	1773	116	6.1
CN1707100000000	17	071	Henderson County, IL	1999	NA	5161	4991	170	3.3
CN1707300000000	17	073	Henry County, IL	1999	NA	27619	26346	1273	4.6
CN1707500000000	17	075	Iroquois County, IL	1999	NA	16402	15678	724	4.4
CN1707700000000	17	077	Jackson County, IL	1999	NA	30673	29595	1078	3.5
CN1707900000000	17	079	Jasper County, IL	1999	NA	4046	3767	279	6.9
CN1708100000000	17	081	Jefferson County, IL	1999	NA	18938	17932	1006	5.3
CN1708300000000	17	083	Jersey County, IL	1999	NA	10776	10297	479	4.4
CN1708500000000	17	085	Jo Daviess County, IL	1999	NA	13342	12837	505	3.8
CN1708700000000	17	087	Johnson County, IL	1999	NA	5115	4839	276	5.4
CN1708900000000	17	089	Kane County, IL	1999	NA	227055	218418	8637	3.8
CN1709100000000	17	091	Kankakee County, IL	1999	NA	52658	50099	2559	4.9
CN1709300000000	17	093	Kendall County, IL	1999	NA	30683	29745	938	3.1
CN1709500000000	17	095	Knox County, IL	1999	NA	29902	28855	1047	3.5
CN1709700000000	17	097	Lake County, IL	1999	NA	333093	323136	9957	3
CN1709900000000	17	099	LaSalle County, IL	1999	NA	57829	54546	3283	5.7
CN1710100000000	17	101	Lawrence County, IL	1999	NA	6805	6358	447	6.6
CN1710300000000	17	103	Lee County, IL	1999	NA	18431	17763	668	3.6
CN1710500000000	17	105	Livingston County, IL	1999	NA	20840	20237	603	2.9
CN1710700000000	17	107	Logan County, IL	1999	NA	14486	14019	467	3.2
CN1710900000000	17	109	McDonough County, IL	1999	NA	17017	16632	385	2.3
CN1711100000000	17	111	McHenry County, IL	1999	NA	140756	135762	4994	3.5
CN1711300000000	17	113	McLean County, IL	1999	NA	92222	90398	1824	2
CN1711500000000	17	115	Macon County, IL	1999	NA	61212	58567	2645	4.3
CN1711700000000	17	117	Macoupin County, IL	1999	NA	23416	22340	1076	4.6
CN1711900000000	17	119	Madison County, IL	1999	NA	131523	126275	5248	4
CN1712100000000	17	121	Marion County, IL	1999	NA	21139	19936	1203	5.7
CN1712300000000	17	123	Marshall County, IL	1999	NA	6709	6452	257	3.8
CN1712500000000	17	125	Mason County, IL	1999	NA	8482	7987	495	5.8
CN1712700000000	17	127	Massac County, IL	1999	NA	8142	7807	335	4.1
CN1712900000000	17	129	Menard County, IL	1999	NA	6316	6111	205	3.2
CN1713100000000	17	131	Mercer County, IL	1999	NA	9432	8868	564	6
CN1713300000000	17	133	Monroe County, IL	1999	NA	14567	14189	378	2.6
CN1713500000000	17	135	Montgomery County, IL	1999	NA	15814	14892	922	5.8
CN1713700000000	17	137	Morgan County, IL	1999	NA	19264	18612	652	3.4
CN1713900000000	17	139	Moultrie County, IL	1999	NA	8179	7960	219	2.7
CN1714100000000	17	141	Ogle County, IL	1999	NA	28405	27354	1051	3.7
CN1714300000000	17	143	Peoria County, IL	1999	NA	95969	92294	3675	3.8
CN1714500000000	17	145	Perry County, IL	1999	NA	9044	8357	687	7.6
CN1714700000000	17	147	Piatt County, IL	1999	NA	8436	8172	264	3.1
CN1714900000000	17	149	Pike County, IL	1999	NA	9262	8836	426	4.6
CN1715100000000	17	151	Pope County, IL	1999	NA	1810	1685	125	6.9
CN1715300000000	17	153	Pulaski County, IL	1999	NA	3193	2952	241	7.5
CN1715500000000	17	155	Putnam County, IL	1999	NA	3259	3114	145	4.4
CN1715700000000	17	157	Randolph County, IL	1999	NA	14337	13685	652	4.5
CN1715900000000	17	159	Richland County, IL	1999	NA	9183	8616	567	6.2
CN1716100000000	17	161	Rock Island County, IL	1999	NA	77408	73464	3944	5.1
CN1716300000000	17	163	St. Clair County, IL	1999	NA	117912	112019	5893	5
CN1716500000000	17	165	Saline County, IL	1999	NA	10656	9937	719	6.7
CN1716700000000	17	167	Sangamon County, IL	1999	NA	101530	98219	3311	3.3
CN1716900000000	17	169	Schuyler County, IL	1999	NA	4444	4252	192	4.3
CN1717100000000	17	171	Scott County, IL	1999	NA	2978	2841	137	4.6
CN1717300000000	17	173	Shelby County, IL	1999	NA	11769	11205	564	4.8
CN1717500000000	17	175	Stark County, IL	1999	NA	2996	2856	140	4.7
CN1717700000000	17	177	Stephenson County, IL	1999	NA	25771	24473	1298	5
CN1717900000000	17	179	Tazewell County, IL	1999	NA	71826	69235	2591	3.6
CN1718100000000	17	181	Union County, IL	1999	NA	8570	8015	555	6.5
CN1718300000000	17	183	Vermilion County, IL	1999	NA	39334	37252	2082	5.3
CN1718500000000	17	185	Wabash County, IL	1999	NA	4999	4580	419	8.4
CN1718700000000	17	187	Warren County, IL	1999	NA	10281	9961	320	3.1
CN1718900000000	17	189	Washington County, IL	1999	NA	9389	9089	300	3.2
CN1719100000000	17	191	Wayne County, IL	1999	NA	8418	7881	537	6.4
CN1719300000000	17	193	White County, IL	1999	NA	7426	6989	437	5.9
CN1719500000000	17	195	Whiteside County, IL	1999	NA	32489	31244	1245	3.8
CN1719700000000	17	197	Will County, IL	1999	NA	255041	243944	11097	4.4
CN1719900000000	17	199	Williamson County, IL	1999	NA	29091	27548	1543	5.3
CN1720100000000	17	201	Winnebago County, IL	1999	NA	151295	145059	6236	4.1
CN1720300000000	17	203	Woodford County, IL	1999	NA	19526	19011	515	2.6
CN1800100000000	18	001	Adams County, IN	1999	NA	16492	16124	368	2.2
CN1800300000000	18	003	Allen County, IN	1999	NA	176753	171515	5238	3
CN1800500000000	18	005	Bartholomew County, IN	1999	NA	39671	38832	839	2.1
CN1800700000000	18	007	Benton County, IN	1999	NA	5466	5295	171	3.1
CN1800900000000	18	009	Blackford County, IN	1999	NA	6494	6205	289	4.5
CN1801100000000	18	011	Boone County, IN	1999	NA	24983	24556	427	1.7
CN1801300000000	18	013	Brown County, IN	1999	NA	8878	8670	208	2.3
CN1801500000000	18	015	Carroll County, IN	1999	NA	12505	12234	271	2.2
CN1801700000000	18	017	Cass County, IN	1999	NA	20163	19517	646	3.2
CN1801900000000	18	019	Clark County, IN	1999	NA	53451	51978	1473	2.8
CN1802100000000	18	021	Clay County, IN	1999	NA	12549	12031	518	4.1
CN1802300000000	18	023	Clinton County, IN	1999	NA	16009	15607	402	2.5
CN1802500000000	18	025	Crawford County, IN	1999	NA	5384	5076	308	5.7
CN1802700000000	18	027	Daviess County, IN	1999	NA	13891	13434	457	3.3
CN1802900000000	18	029	Dearborn County, IN	1999	NA	23970	23195	775	3.2
CN1803100000000	18	031	Decatur County, IN	1999	NA	17104	16777	327	1.9
CN1803300000000	18	033	DeKalb County, IN	1999	NA	22037	21343	694	3.1
CN1803500000000	18	035	Delaware County, IN	1999	NA	61373	59298	2075	3.4
CN1803700000000	18	037	Dubois County, IN	1999	NA	23371	22881	490	2.1
CN1803900000000	18	039	Elkhart County, IN	1999	NA	98089	95947	2142	2.2
CN1804100000000	18	041	Fayette County, IN	1999	NA	11076	10508	568	5.1
CN1804300000000	18	043	Floyd County, IN	1999	NA	39337	38413	924	2.3
CN1804500000000	18	045	Fountain County, IN	1999	NA	8757	8411	346	4
CN1804700000000	18	047	Franklin County, IN	1999	NA	11091	10716	375	3.4
CN1804900000000	18	049	Fulton County, IN	1999	NA	10076	9677	399	4
CN1805100000000	18	051	Gibson County, IN	1999	NA	16925	16169	756	4.5
CN1805300000000	18	053	Grant County, IN	1999	NA	33297	31962	1335	4
CN1805500000000	18	055	Greene County, IN	1999	NA	14542	13649	893	6.1
CN1805700000000	18	057	Hamilton County, IN	1999	NA	99091	97896	1195	1.2
CN1805900000000	18	059	Hancock County, IN	1999	NA	30777	30173	604	2
CN1806100000000	18	061	Harrison County, IN	1999	NA	19133	18634	499	2.6
CN1806300000000	18	063	Hendricks County, IN	1999	NA	54868	53984	884	1.6
CN1806500000000	18	065	Henry County, IN	1999	NA	24544	23532	1012	4.1
CN1806700000000	18	067	Howard County, IN	1999	NA	42366	41236	1130	2.7
CN1806900000000	18	069	Huntington County, IN	1999	NA	20521	19902	619	3
CN1807100000000	18	071	Jackson County, IN	1999	NA	21805	21282	523	2.4
CN1807300000000	18	073	Jasper County, IN	1999	NA	14529	13938	591	4.1
CN1807500000000	18	075	Jay County, IN	1999	NA	10903	10450	453	4.2
CN1807700000000	18	077	Jefferson County, IN	1999	NA	13703	13213	490	3.6
CN1807900000000	18	079	Jennings County, IN	1999	NA	14743	14410	333	2.3
CN1808100000000	18	081	Johnson County, IN	1999	NA	63468	62306	1162	1.8
CN1808300000000	18	083	Knox County, IN	1999	NA	19296	18646	650	3.4
CN1808500000000	18	085	Kosciusko County, IN	1999	NA	38461	37566	895	2.3
CN1808700000000	18	087	LaGrange County, IN	1999	NA	17615	17159	456	2.6
CN1808900000000	18	089	Lake County, IN	1999	NA	226465	216753	9712	4.3
CN1809100000000	18	091	LaPorte County, IN	1999	NA	53656	51736	1920	3.6
CN1809300000000	18	093	Lawrence County, IN	1999	NA	22964	21777	1187	5.2
CN1809500000000	18	095	Madison County, IN	1999	NA	65388	63257	2131	3.3
CN1809700000000	18	097	Marion County, IN	1999	NA	448732	436093	12639	2.8
CN1809900000000	18	099	Marshall County, IN	1999	NA	25035	24390	645	2.6
CN1810100000000	18	101	Martin County, IN	1999	NA	5165	4960	205	4
CN1810300000000	18	103	Miami County, IN	1999	NA	15704	15113	591	3.8
CN1810500000000	18	105	Monroe County, IN	1999	NA	61817	60380	1437	2.3
CN1810700000000	18	107	Montgomery County, IN	1999	NA	18105	17521	584	3.2
CN1810900000000	18	109	Morgan County, IN	1999	NA	35983	35097	886	2.5
CN1811100000000	18	111	Newton County, IN	1999	NA	6521	6280	241	3.7
CN1811300000000	18	113	Noble County, IN	1999	NA	24611	23744	867	3.5
CN1811500000000	18	115	Ohio County, IN	1999	NA	2691	2603	88	3.3
CN1811700000000	18	117	Orange County, IN	1999	NA	8903	8281	622	7
CN1811900000000	18	119	Owen County, IN	1999	NA	11014	10608	406	3.7
CN1812100000000	18	121	Parke County, IN	1999	NA	7786	7520	266	3.4
CN1812300000000	18	123	Perry County, IN	1999	NA	9148	8613	535	5.8
CN1812500000000	18	125	Pike County, IN	1999	NA	6428	6179	249	3.9
CN1812700000000	18	127	Porter County, IN	1999	NA	76839	74504	2335	3
CN1812900000000	18	129	Posey County, IN	1999	NA	14006	13593	413	2.9
CN1813100000000	18	131	Pulaski County, IN	1999	NA	6243	5808	435	7
CN1813300000000	18	133	Putnam County, IN	1999	NA	16992	16660	332	2
CN1813500000000	18	135	Randolph County, IN	1999	NA	11541	10779	762	6.6
CN1813700000000	18	137	Ripley County, IN	1999	NA	13732	13284	448	3.3
CN1813900000000	18	139	Rush County, IN	1999	NA	10147	9852	295	2.9
CN1814100000000	18	141	St. Joseph County, IN	1999	NA	136517	132256	4261	3.1
CN1814300000000	18	143	Scott County, IN	1999	NA	11250	10909	341	3
CN1814500000000	18	145	Shelby County, IN	1999	NA	23650	22933	717	3
CN1814700000000	18	147	Spencer County, IN	1999	NA	11990	11508	482	4
CN1814900000000	18	149	Starke County, IN	1999	NA	10905	10384	521	4.8
CN1815100000000	18	151	Steuben County, IN	1999	NA	17909	17387	522	2.9
CN1815300000000	18	153	Sullivan County, IN	1999	NA	9622	9098	524	5.4
CN1815500000000	18	155	Switzerland County, IN	1999	NA	3732	3574	158	4.2
CN1815700000000	18	157	Tippecanoe County, IN	1999	NA	75289	73674	1615	2.1
CN1815900000000	18	159	Tipton County, IN	1999	NA	8833	8631	202	2.3
CN1816100000000	18	161	Union County, IN	1999	NA	3947	3825	122	3.1
CN1816300000000	18	163	Vanderburgh County, IN	1999	NA	91813	88912	2901	3.2
CN1816500000000	18	165	Vermillion County, IN	1999	NA	7810	7397	413	5.3
CN1816700000000	18	167	Vigo County, IN	1999	NA	50004	47828	2176	4.4
CN1816900000000	18	169	Wabash County, IN	1999	NA	17640	17086	554	3.1
CN1817100000000	18	171	Warren County, IN	1999	NA	3976	3860	116	2.9
CN1817300000000	18	173	Warrick County, IN	1999	NA	29485	28657	828	2.8
CN1817500000000	18	175	Washington County, IN	1999	NA	11856	11307	549	4.6
CN1817700000000	18	177	Wayne County, IN	1999	NA	38261	36915	1346	3.5
CN1817900000000	18	179	Wells County, IN	1999	NA	14664	14314	350	2.4
CN1818100000000	18	181	White County, IN	1999	NA	13758	13299	459	3.3
CN1818300000000	18	183	Whitley County, IN	1999	NA	16780	16352	428	2.6
CN1900100000000	19	001	Adair County, IA	1999	NA	4472	4364	108	2.4
CN1900300000000	19	003	Adams County, IA	1999	NA	2299	2242	57	2.5
CN1900500000000	19	005	Allamakee County, IA	1999	NA	7548	7256	292	3.9
CN1900700000000	19	007	Appanoose County, IA	1999	NA	6815	6538	277	4.1
CN1900900000000	19	009	Audubon County, IA	1999	NA	3508	3422	86	2.5
CN1901100000000	19	011	Benton County, IA	1999	NA	11712	11392	320	2.7
CN1901300000000	19	013	Black Hawk County, IA	1999	NA	68466	65759	2707	4
CN1901500000000	19	015	Boone County, IA	1999	NA	14320	14026	294	2.1
CN1901700000000	19	017	Bremer County, IA	1999	NA	12619	12258	361	2.9
CN1901900000000	19	019	Buchanan County, IA	1999	NA	11093	10676	417	3.8
CN1902100000000	19	021	Buena Vista County, IA	1999	NA	11101	10866	235	2.1
CN1902300000000	19	023	Butler County, IA	1999	NA	7758	7406	352	4.5
CN1902500000000	19	025	Calhoun County, IA	1999	NA	4909	4769	140	2.9
CN1902700000000	19	027	Carroll County, IA	1999	NA	12698	12414	284	2.2
CN1902900000000	19	029	Cass County, IA	1999	NA	7644	7397	247	3.2
CN1903100000000	19	031	Cedar County, IA	1999	NA	9550	9316	234	2.5
CN1903300000000	19	033	Cerro Gordo County, IA	1999	NA	26203	25514	689	2.6
CN1903500000000	19	035	Cherokee County, IA	1999	NA	6960	6805	155	2.2
CN1903700000000	19	037	Chickasaw County, IA	1999	NA	7738	7478	260	3.4
CN1903900000000	19	039	Clarke County, IA	1999	NA	4589	4429	160	3.5
CN1904100000000	19	041	Clay County, IA	1999	NA	10103	9872	231	2.3
CN1904300000000	19	043	Clayton County, IA	1999	NA	10483	10027	456	4.3
CN1904500000000	19	045	Clinton County, IA	1999	NA	26770	25809	961	3.6
CN1904700000000	19	047	Crawford County, IA	1999	NA	8929	8724	205	2.3
CN1904900000000	19	049	Dallas County, IA	1999	NA	20943	20601	342	1.6
CN1905100000000	19	051	Davis County, IA	1999	NA	4223	4067	156	3.7
CN1905300000000	19	053	Decatur County, IA	1999	NA	3683	3522	161	4.4
CN1905500000000	19	055	Delaware County, IA	1999	NA	9588	9210	378	3.9
CN1905700000000	19	057	Des Moines County, IA	1999	NA	23580	22840	740	3.1
CN1905900000000	19	059	Dickinson County, IA	1999	NA	9799	9558	241	2.5
CN1906100000000	19	061	Dubuque County, IA	1999	NA	49287	47944	1343	2.7
CN1906300000000	19	063	Emmet County, IA	1999	NA	5589	5401	188	3.4
CN1906500000000	19	065	Fayette County, IA	1999	NA	11295	10893	402	3.6
CN1906700000000	19	067	Floyd County, IA	1999	NA	7834	7556	278	3.5
CN1906900000000	19	069	Franklin County, IA	1999	NA	5993	5801	192	3.2
CN1907100000000	19	071	Fremont County, IA	1999	NA	3882	3801	81	2.1
CN1907300000000	19	073	Greene County, IA	1999	NA	5051	4902	149	2.9
CN1907500000000	19	075	Grundy County, IA	1999	NA	6256	6095	161	2.6
CN1907700000000	19	077	Guthrie County, IA	1999	NA	6071	5938	133	2.2
CN1907900000000	19	079	Hamilton County, IA	1999	NA	8762	8579	183	2.1
CN1908100000000	19	081	Hancock County, IA	1999	NA	7163	7036	127	1.8
CN1908300000000	19	083	Hardin County, IA	1999	NA	9469	9189	280	3
CN1908500000000	19	085	Harrison County, IA	1999	NA	7879	7691	188	2.4
CN1908700000000	19	087	Henry County, IA	1999	NA	11074	10764	310	2.8
CN1908900000000	19	089	Howard County, IA	1999	NA	5640	5490	150	2.7
CN1909100000000	19	091	Humboldt County, IA	1999	NA	5587	5479	108	1.9
CN1909300000000	19	093	Ida County, IA	1999	NA	4147	4059	88	2.1
CN1909500000000	19	095	Iowa County, IA	1999	NA	9439	9281	158	1.7
CN1909700000000	19	097	Jackson County, IA	1999	NA	10574	10166	408	3.9
CN1909900000000	19	099	Jasper County, IA	1999	NA	19430	19046	384	2
CN1910100000000	19	101	Jefferson County, IA	1999	NA	9791	9476	315	3.2
CN1910300000000	19	103	Johnson County, IA	1999	NA	68429	67016	1413	2.1
CN1910500000000	19	105	Jones County, IA	1999	NA	9749	9482	267	2.7
CN1910700000000	19	107	Keokuk County, IA	1999	NA	5159	4927	232	4.5
CN1910900000000	19	109	Kossuth County, IA	1999	NA	8792	8532	260	3
CN1911100000000	19	111	Lee County, IA	1999	NA	19282	18523	759	3.9
CN1911300000000	19	113	Linn County, IA	1999	NA	114551	112439	2112	1.8
CN1911500000000	19	115	Louisa County, IA	1999	NA	5538	5353	185	3.3
CN1911700000000	19	117	Lucas County, IA	1999	NA	4102	3966	136	3.3
CN1911900000000	19	119	Lyon County, IA	1999	NA	5600	5499	101	1.8
CN1912100000000	19	121	Madison County, IA	1999	NA	7684	7440	244	3.2
CN1912300000000	19	123	Mahaska County, IA	1999	NA	11746	11478	268	2.3
CN1912500000000	19	125	Marion County, IA	1999	NA	18341	17943	398	2.2
CN1912700000000	19	127	Marshall County, IA	1999	NA	20600	20133	467	2.3
CN1912900000000	19	129	Mills County, IA	1999	NA	6381	6259	122	1.9
CN1913100000000	19	131	Mitchell County, IA	1999	NA	5529	5364	165	3
CN1913300000000	19	133	Monona County, IA	1999	NA	5077	4918	159	3.1
CN1913500000000	19	135	Monroe County, IA	1999	NA	4192	4067	125	3
CN1913700000000	19	137	Montgomery County, IA	1999	NA	5936	5745	191	3.2
CN1913900000000	19	139	Muscatine County, IA	1999	NA	21780	21173	607	2.8
CN1914100000000	19	141	O'Brien County, IA	1999	NA	7910	7737	173	2.2
CN1914300000000	19	143	Osceola County, IA	1999	NA	3967	3874	93	2.3
CN1914500000000	19	145	Page County, IA	1999	NA	9074	8851	223	2.5
CN1914700000000	19	147	Palo Alto County, IA	1999	NA	5462	5327	135	2.5
CN1914900000000	19	149	Plymouth County, IA	1999	NA	13153	12830	323	2.5
CN1915100000000	19	151	Pocahontas County, IA	1999	NA	4146	4005	141	3.4
CN1915300000000	19	153	Polk County, IA	1999	NA	215075	210922	4153	1.9
CN1915500000000	19	155	Pottawattamie County, IA	1999	NA	48697	47719	978	2
CN1915700000000	19	157	Poweshiek County, IA	1999	NA	10350	10059	291	2.8
CN1915900000000	19	159	Ringgold County, IA	1999	NA	2643	2570	73	2.8
CN1916100000000	19	161	Sac County, IA	1999	NA	5973	5818	155	2.6
CN1916300000000	19	163	Scott County, IA	1999	NA	86354	83692	2662	3.1
CN1916500000000	19	165	Shelby County, IA	1999	NA	6968	6804	164	2.4
CN1916700000000	19	167	Sioux County, IA	1999	NA	17819	17380	439	2.5
CN1916900000000	19	169	Story County, IA	1999	NA	46439	45448	991	2.1
CN1917100000000	19	171	Tama County, IA	1999	NA	9182	8911	271	3
CN1917300000000	19	173	Taylor County, IA	1999	NA	3401	3292	109	3.2
CN1917500000000	19	175	Union County, IA	1999	NA	6596	6351	245	3.7
CN1917700000000	19	177	Van Buren County, IA	1999	NA	4176	4052	124	3
CN1917900000000	19	179	Wapello County, IA	1999	NA	17526	16842	684	3.9
CN1918100000000	19	181	Warren County, IA	1999	NA	23425	23009	416	1.8
CN1918300000000	19	183	Washington County, IA	1999	NA	11306	11031	275	2.4
CN1918500000000	19	185	Wayne County, IA	1999	NA	3004	2916	88	2.9
CN1918700000000	19	187	Webster County, IA	1999	NA	20342	19773	569	2.8
CN1918900000000	19	189	Winnebago County, IA	1999	NA	6622	6494	128	1.9
CN1919100000000	19	191	Winneshiek County, IA	1999	NA	12902	12496	406	3.1
CN1919300000000	19	193	Woodbury County, IA	1999	NA	54262	52903	1359	2.5
CN1919500000000	19	195	Worth County, IA	1999	NA	4081	3966	115	2.8
CN1919700000000	19	197	Wright County, IA	1999	NA	6779	6619	160	2.4
CN2000100000000	20	001	Allen County, KS	1999	NA	7311	6945	366	5
CN2000300000000	20	003	Anderson County, KS	1999	NA	4006	3816	190	4.7
CN2000500000000	20	005	Atchison County, KS	1999	NA	8901	8519	382	4.3
CN2000700000000	20	007	Barber County, KS	1999	NA	2457	2397	60	2.4
CN2000900000000	20	009	Barton County, KS	1999	NA	14764	14274	490	3.3
CN2001100000000	20	011	Bourbon County, KS	1999	NA	6905	6595	310	4.5
CN2001300000000	20	013	Brown County, KS	1999	NA	5912	5461	451	7.6
CN2001500000000	20	015	Butler County, KS	1999	NA	32004	31003	1001	3.1
CN2001700000000	20	017	Chase County, KS	1999	NA	1482	1427	55	3.7
CN2001900000000	20	019	Chautauqua County, KS	1999	NA	1711	1622	89	5.2
CN2002100000000	20	021	Cherokee County, KS	1999	NA	10279	9819	460	4.5
CN2002300000000	20	023	Cheyenne County, KS	1999	NA	1575	1548	27	1.7
CN2002500000000	20	025	Clark County, KS	1999	NA	1333	1312	21	1.6
CN2002700000000	20	027	Clay County, KS	1999	NA	4873	4728	145	3
CN2002900000000	20	029	Cloud County, KS	1999	NA	4989	4837	152	3
CN2003100000000	20	031	Coffey County, KS	1999	NA	4172	3976	196	4.7
CN2003300000000	20	033	Comanche County, KS	1999	NA	1025	1011	14	1.4
CN2003500000000	20	035	Cowley County, KS	1999	NA	17697	16974	723	4.1
CN2003700000000	20	037	Crawford County, KS	1999	NA	18544	17882	662	3.6
CN2003900000000	20	039	Decatur County, KS	1999	NA	1658	1624	34	2.1
CN2004100000000	20	041	Dickinson County, KS	1999	NA	10434	10116	318	3
CN2004300000000	20	043	Doniphan County, KS	1999	NA	4270	4033	237	5.6
CN2004500000000	20	045	Douglas County, KS	1999	NA	55660	53693	1967	3.5
CN2004700000000	20	047	Edwards County, KS	1999	NA	1692	1650	42	2.5
CN2004900000000	20	049	Elk County, KS	1999	NA	1341	1284	57	4.3
CN2005100000000	20	051	Ellis County, KS	1999	NA	16963	16551	412	2.4
CN2005300000000	20	053	Ellsworth County, KS	1999	NA	2911	2843	68	2.3
CN2005500000000	20	055	Finney County, KS	1999	NA	19851	19302	549	2.8
CN2005700000000	20	057	Ford County, KS	1999	NA	15747	15419	328	2.1
CN2005900000000	20	059	Franklin County, KS	1999	NA	13198	12730	468	3.5
CN2006100000000	20	061	Geary County, KS	1999	NA	10068	9405	663	6.6
CN2006300000000	20	063	Gove County, KS	1999	NA	1512	1485	27	1.8
CN2006500000000	20	065	Graham County, KS	1999	NA	1561	1524	37	2.4
CN2006700000000	20	067	Grant County, KS	1999	NA	3852	3703	149	3.9
CN2006900000000	20	069	Gray County, KS	1999	NA	3271	3207	64	2
CN2007100000000	20	071	Greeley County, KS	1999	NA	824	800	24	2.9
CN2007300000000	20	073	Greenwood County, KS	1999	NA	3195	3034	161	5
CN2007500000000	20	075	Hamilton County, KS	1999	NA	1249	1232	17	1.4
CN2007700000000	20	077	Harper County, KS	1999	NA	3011	2919	92	3.1
CN2007900000000	20	079	Harvey County, KS	1999	NA	17715	17201	514	2.9
CN2008100000000	20	081	Haskell County, KS	1999	NA	2151	2105	46	2.1
CN2008300000000	20	083	Hodgeman County, KS	1999	NA	1088	1066	22	2
CN2008500000000	20	085	Jackson County, KS	1999	NA	8927	8659	268	3
CN2008700000000	20	087	Jefferson County, KS	1999	NA	9714	9389	325	3.3
CN2008900000000	20	089	Jewell County, KS	1999	NA	2059	2023	36	1.7
CN2009100000000	20	091	Johnson County, KS	1999	NA	270649	265121	5528	2
CN2009300000000	20	093	Kearny County, KS	1999	NA	2097	2043	54	2.6
CN2009500000000	20	095	Kingman County, KS	1999	NA	4264	4127	137	3.2
CN2009700000000	20	097	Kiowa County, KS	1999	NA	1690	1661	29	1.7
CN2009900000000	20	099	Labette County, KS	1999	NA	11688	11184	504	4.3
CN2010100000000	20	101	Lane County, KS	1999	NA	1131	1097	34	3
CN2010300000000	20	103	Leavenworth County, KS	1999	NA	29291	28266	1025	3.5
CN2010500000000	20	105	Lincoln County, KS	1999	NA	1827	1791	36	2
CN2010700000000	20	107	Linn County, KS	1999	NA	3299	3072	227	6.9
CN2010900000000	20	109	Logan County, KS	1999	NA	1629	1598	31	1.9
CN2011100000000	20	111	Lyon County, KS	1999	NA	19959	19275	684	3.4
CN2011300000000	20	113	McPherson County, KS	1999	NA	16205	15844	361	2.2
CN2011500000000	20	115	Marion County, KS	1999	NA	7139	6972	167	2.3
CN2011700000000	20	117	Marshall County, KS	1999	NA	6009	5849	160	2.7
CN2011900000000	20	119	Meade County, KS	1999	NA	2249	2202	47	2.1
CN2012100000000	20	121	Miami County, KS	1999	NA	14392	13963	429	3
CN2012300000000	20	123	Mitchell County, KS	1999	NA	3805	3737	68	1.8
CN2012500000000	20	125	Montgomery County, KS	1999	NA	18830	17927	903	4.8
CN2012700000000	20	127	Morris County, KS	1999	NA	3148	3055	93	3
CN2012900000000	20	129	Morton County, KS	1999	NA	1741	1701	40	2.3
CN2013100000000	20	131	Nemaha County, KS	1999	NA	5649	5503	146	2.6
CN2013300000000	20	133	Neosho County, KS	1999	NA	8882	8489	393	4.4
CN2013500000000	20	135	Ness County, KS	1999	NA	1856	1811	45	2.4
CN2013700000000	20	137	Norton County, KS	1999	NA	3183	3138	45	1.4
CN2013900000000	20	139	Osage County, KS	1999	NA	9952	9516	436	4.4
CN2014100000000	20	141	Osborne County, KS	1999	NA	2298	2253	45	2
CN2014300000000	20	143	Ottawa County, KS	1999	NA	3171	3088	83	2.6
CN2014500000000	20	145	Pawnee County, KS	1999	NA	3818	3741	77	2
CN2014700000000	20	147	Phillips County, KS	1999	NA	3215	3153	62	1.9
CN2014900000000	20	149	Pottawatomie County, KS	1999	NA	11002	10747	255	2.3
CN2015100000000	20	151	Pratt County, KS	1999	NA	4896	4781	115	2.3
CN2015300000000	20	153	Rawlins County, KS	1999	NA	1551	1510	41	2.6
CN2015500000000	20	155	Reno County, KS	1999	NA	33115	32037	1078	3.3
CN2015700000000	20	157	Republic County, KS	1999	NA	3075	3019	56	1.8
CN2015900000000	20	159	Rice County, KS	1999	NA	4734	4561	173	3.7
CN2016100000000	20	161	Riley County, KS	1999	NA	30593	29623	970	3.2
CN2016300000000	20	163	Rooks County, KS	1999	NA	3009	2928	81	2.7
CN2016500000000	20	165	Rush County, KS	1999	NA	1877	1822	55	2.9
CN2016700000000	20	167	Russell County, KS	1999	NA	3531	3416	115	3.3
CN2016900000000	20	169	Saline County, KS	1999	NA	30707	29869	838	2.7
CN2017100000000	20	171	Scott County, KS	1999	NA	2704	2659	45	1.7
CN2017300000000	20	173	Sedgwick County, KS	1999	NA	239138	230262	8876	3.7
CN2017500000000	20	175	Seward County, KS	1999	NA	11005	10673	332	3
CN2017700000000	20	177	Shawnee County, KS	1999	NA	89938	86890	3048	3.4
CN2017900000000	20	179	Sheridan County, KS	1999	NA	1489	1463	26	1.7
CN2018100000000	20	181	Sherman County, KS	1999	NA	4225	4155	70	1.7
CN2018300000000	20	183	Smith County, KS	1999	NA	2434	2398	36	1.5
CN2018500000000	20	185	Stafford County, KS	1999	NA	2424	2365	59	2.4
CN2018700000000	20	187	Stanton County, KS	1999	NA	1110	1086	24	2.2
CN2018900000000	20	189	Stevens County, KS	1999	NA	2798	2735	63	2.3
CN2019100000000	20	191	Sumner County, KS	1999	NA	14036	13531	505	3.6
CN2019300000000	20	193	Thomas County, KS	1999	NA	4720	4636	84	1.8
CN2019500000000	20	195	Trego County, KS	1999	NA	1883	1823	60	3.2
CN2019700000000	20	197	Wabaunsee County, KS	1999	NA	3647	3529	118	3.2
CN2019900000000	20	199	Wallace County, KS	1999	NA	873	858	15	1.7
CN2020100000000	20	201	Washington County, KS	1999	NA	3433	3341	92	2.7
CN2020300000000	20	203	Wichita County, KS	1999	NA	1320	1284	36	2.7
CN2020500000000	20	205	Wilson County, KS	1999	NA	5545	5368	177	3.2
CN2020700000000	20	207	Woodson County, KS	1999	NA	1595	1513	82	5.1
CN2020900000000	20	209	Wyandotte County, KS	1999	NA	76269	71673	4596	6
CN2100100000000	21	001	Adair County, KY	1999	NA	7568	6869	699	9.2
CN2100300000000	21	003	Allen County, KY	1999	NA	8748	8283	465	5.3
CN2100500000000	21	005	Anderson County, KY	1999	NA	10035	9737	298	3
CN2100700000000	21	007	Ballard County, KY	1999	NA	4256	3995	261	6.1
CN2100900000000	21	009	Barren County, KY	1999	NA	18847	17862	985	5.2
CN2101100000000	21	011	Bath County, KY	1999	NA	5870	5504	366	6.2
CN2101300000000	21	013	Bell County, KY	1999	NA	10141	9576	565	5.6
CN2101500000000	21	015	Boone County, KY	1999	NA	46155	44901	1254	2.7
CN2101700000000	21	017	Bourbon County, KY	1999	NA	10068	9822	246	2.4
CN2101900000000	21	019	Boyd County, KY	1999	NA	22534	20990	1544	6.9
CN2102100000000	21	021	Boyle County, KY	1999	NA	14532	14062	470	3.2
CN2102300000000	21	023	Bracken County, KY	1999	NA	3964	3804	160	4
CN2102500000000	21	025	Breathitt County, KY	1999	NA	4248	3886	362	8.5
CN2102700000000	21	027	Breckinridge County, KY	1999	NA	7816	7322	494	6.3
CN2102900000000	21	029	Bullitt County, KY	1999	NA	34236	33152	1084	3.2
CN2103100000000	21	031	Butler County, KY	1999	NA	5931	5596	335	5.6
CN2103300000000	21	033	Caldwell County, KY	1999	NA	6524	6217	307	4.7
CN2103500000000	21	035	Calloway County, KY	1999	NA	17851	17083	768	4.3
CN2103700000000	21	037	Campbell County, KY	1999	NA	45664	44162	1502	3.3
CN2103900000000	21	039	Carlisle County, KY	1999	NA	2792	2615	177	6.3
CN2104100000000	21	041	Carroll County, KY	1999	NA	5069	4854	215	4.2
CN2104300000000	21	043	Carter County, KY	1999	NA	12103	10548	1555	12.8
CN2104500000000	21	045	Casey County, KY	1999	NA	6724	6217	507	7.5
CN2104700000000	21	047	Christian County, KY	1999	NA	27950	26872	1078	3.9
CN2104900000000	21	049	Clark County, KY	1999	NA	16703	16163	540	3.2
CN2105100000000	21	051	Clay County, KY	1999	NA	7356	6844	512	7
CN2105300000000	21	053	Clinton County, KY	1999	NA	5541	5321	220	4
CN2105500000000	21	055	Crittenden County, KY	1999	NA	4019	3791	228	5.7
CN2105700000000	21	057	Cumberland County, KY	1999	NA	2893	2699	194	6.7
CN2105900000000	21	059	Daviess County, KY	1999	NA	50185	47603	2582	5.1
CN2106100000000	21	061	Edmonson County, KY	1999	NA	5073	4784	289	5.7
CN2106300000000	21	063	Elliott County, KY	1999	NA	2795	2402	393	14.1
CN2106500000000	21	065	Estill County, KY	1999	NA	5790	5512	278	4.8
CN2106700000000	21	067	Fayette County, KY	1999	NA	144550	141689	2861	2
CN2106900000000	21	069	Fleming County, KY	1999	NA	6254	5977	277	4.4
CN2107100000000	21	071	Floyd County, KY	1999	NA	13770	12695	1075	7.8
CN2107300000000	21	073	Franklin County, KY	1999	NA	24890	24270	620	2.5
CN2107500000000	21	075	Fulton County, KY	1999	NA	3392	3035	357	10.5
CN2107700000000	21	077	Gallatin County, KY	1999	NA	3727	3596	131	3.5
CN2107900000000	21	079	Garrard County, KY	1999	NA	7524	7322	202	2.7
CN2108100000000	21	081	Grant County, KY	1999	NA	10206	9805	401	3.9
CN2108300000000	21	083	Graves County, KY	1999	NA	17618	16619	999	5.7
CN2108500000000	21	085	Grayson County, KY	1999	NA	12402	11627	775	6.2
CN2108700000000	21	087	Green County, KY	1999	NA	4285	3691	594	13.9
CN2108900000000	21	089	Greenup County, KY	1999	NA	16615	15540	1075	6.5
CN2109100000000	21	091	Hancock County, KY	1999	NA	4175	3747	428	10.3
CN2109300000000	21	093	Hardin County, KY	1999	NA	36999	34897	2102	5.7
CN2109500000000	21	095	Harlan County, KY	1999	NA	9197	8170	1027	11.2
CN2109700000000	21	097	Harrison County, KY	1999	NA	7437	7117	320	4.3
CN2109900000000	21	099	Hart County, KY	1999	NA	7984	7570	414	5.2
CN2110100000000	21	101	Henderson County, KY	1999	NA	24035	22993	1042	4.3
CN2110300000000	21	103	Henry County, KY	1999	NA	7529	7260	269	3.6
CN2110500000000	21	105	Hickman County, KY	1999	NA	2509	2354	155	6.2
CN2110700000000	21	107	Hopkins County, KY	1999	NA	19632	18491	1141	5.8
CN2110900000000	21	109	Jackson County, KY	1999	NA	6883	6550	333	4.8
CN2111100000000	21	111	Jefferson County, KY	1999	NA	378131	363792	14339	3.8
CN2111300000000	21	113	Jessamine County, KY	1999	NA	21082	20763	319	1.5
CN2111500000000	21	115	Johnson County, KY	1999	NA	9276	8597	679	7.3
CN2111700000000	21	117	Kenton County, KY	1999	NA	79849	77292	2557	3.2
CN2111900000000	21	119	Knott County, KY	1999	NA	5889	5393	496	8.4
CN2112100000000	21	121	Knox County, KY	1999	NA	11263	10630	633	5.6
CN2112300000000	21	123	Larue County, KY	1999	NA	6320	6016	304	4.8
CN2112500000000	21	125	Laurel County, KY	1999	NA	23271	22188	1083	4.7
CN2112700000000	21	127	Lawrence County, KY	1999	NA	5603	4996	607	10.8
CN2112900000000	21	129	Lee County, KY	1999	NA	2486	2341	145	5.8
CN2113100000000	21	131	Leslie County, KY	1999	NA	4436	4180	256	5.8
CN2113300000000	21	133	Letcher County, KY	1999	NA	7906	7175	731	9.2
CN2113500000000	21	135	Lewis County, KY	1999	NA	4763	4092	671	14.1
CN2113700000000	21	137	Lincoln County, KY	1999	NA	11060	10614	446	4
CN2113900000000	21	139	Livingston County, KY	1999	NA	4948	4684	264	5.3
CN2114100000000	21	141	Logan County, KY	1999	NA	13203	12745	458	3.5
CN2114300000000	21	143	Lyon County, KY	1999	NA	3367	3201	166	4.9
CN2114500000000	21	145	McCracken County, KY	1999	NA	33769	32493	1276	3.8
CN2114700000000	21	147	McCreary County, KY	1999	NA	6352	5920	432	6.8
CN2114900000000	21	149	McLean County, KY	1999	NA	4539	4221	318	7
CN2115100000000	21	151	Madison County, KY	1999	NA	36588	35622	966	2.6
CN2115300000000	21	153	Magoffin County, KY	1999	NA	5136	4436	700	13.6
CN2115500000000	21	155	Marion County, KY	1999	NA	11034	10425	609	5.5
CN2115700000000	21	157	Marshall County, KY	1999	NA	14754	13917	837	5.7
CN2115900000000	21	159	Martin County, KY	1999	NA	3105	2715	390	12.6
CN2116100000000	21	161	Mason County, KY	1999	NA	8575	8313	262	3.1
CN2116300000000	21	163	Meade County, KY	1999	NA	10952	10467	485	4.4
CN2116500000000	21	165	Menifee County, KY	1999	NA	2929	2731	198	6.8
CN2116700000000	21	167	Mercer County, KY	1999	NA	10975	10627	348	3.2
CN2116900000000	21	169	Metcalfe County, KY	1999	NA	4995	4637	358	7.2
CN2117100000000	21	171	Monroe County, KY	1999	NA	5449	4763	686	12.6
CN2117300000000	21	173	Montgomery County, KY	1999	NA	12815	12159	656	5.1
CN2117500000000	21	175	Morgan County, KY	1999	NA	4971	4579	392	7.9
CN2117700000000	21	177	Muhlenberg County, KY	1999	NA	12667	11597	1070	8.4
CN2117900000000	21	179	Nelson County, KY	1999	NA	18961	17825	1136	6
CN2118100000000	21	181	Nicholas County, KY	1999	NA	3137	3008	129	4.1
CN2118300000000	21	183	Ohio County, KY	1999	NA	10059	9210	849	8.4
CN2118500000000	21	185	Oldham County, KY	1999	NA	25283	24796	487	1.9
CN2118700000000	21	187	Owen County, KY	1999	NA	4331	4198	133	3.1
CN2118900000000	21	189	Owsley County, KY	1999	NA	1746	1653	93	5.3
CN2119100000000	21	191	Pendleton County, KY	1999	NA	6700	6441	259	3.9
CN2119300000000	21	193	Perry County, KY	1999	NA	11707	10782	925	7.9
CN2119500000000	21	195	Pike County, KY	1999	NA	27482	25383	2099	7.6
CN2119700000000	21	197	Powell County, KY	1999	NA	6456	6080	376	5.8
CN2119900000000	21	199	Pulaski County, KY	1999	NA	26151	24899	1252	4.8
CN2120100000000	21	201	Robertson County, KY	1999	NA	1056	1005	51	4.8
CN2120300000000	21	203	Rockcastle County, KY	1999	NA	6253	5913	340	5.4
CN2120500000000	21	205	Rowan County, KY	1999	NA	9454	9094	360	3.8
CN2120700000000	21	207	Russell County, KY	1999	NA	5810	5104	706	12.2
CN2120900000000	21	209	Scott County, KY	1999	NA	18190	17834	356	2
CN2121100000000	21	211	Shelby County, KY	1999	NA	18001	17569	432	2.4
CN2121300000000	21	213	Simpson County, KY	1999	NA	8303	8034	269	3.2
CN2121500000000	21	215	Spencer County, KY	1999	NA	5294	5113	181	3.4
CN2121700000000	21	217	Taylor County, KY	1999	NA	9764	8228	1536	15.7
CN2121900000000	21	219	Todd County, KY	1999	NA	5338	5175	163	3.1
CN2122100000000	21	221	Trigg County, KY	1999	NA	5946	5763	183	3.1
CN2122300000000	21	223	Trimble County, KY	1999	NA	3179	3090	89	2.8
CN2122500000000	21	225	Union County, KY	1999	NA	6221	5833	388	6.2
CN2122700000000	21	227	Warren County, KY	1999	NA	49898	48217	1681	3.4
CN2122900000000	21	229	Washington County, KY	1999	NA	5763	5538	225	3.9
CN2123100000000	21	231	Wayne County, KY	1999	NA	8083	7545	538	6.7
CN2123300000000	21	233	Webster County, KY	1999	NA	5498	5108	390	7.1
CN2123500000000	21	235	Whitley County, KY	1999	NA	14445	13591	854	5.9
CN2123700000000	21	237	Wolfe County, KY	1999	NA	3316	3148	168	5.1
CN2123900000000	21	239	Woodford County, KY	1999	NA	13541	13320	221	1.6
CN2200100000000	22	001	Acadia Parish, LA	1999	NA	23337	21592	1745	7.5
CN2200300000000	22	003	Allen Parish, LA	1999	NA	9746	9126	620	6.4
CN2200500000000	22	005	Ascension Parish, LA	1999	NA	35234	33695	1539	4.4
CN2200700000000	22	007	Assumption Parish, LA	1999	NA	9002	8358	644	7.2
CN2200900000000	22	009	Avoyelles Parish, LA	1999	NA	16054	15130	924	5.8
CN2201100000000	22	011	Beauregard Parish, LA	1999	NA	12449	11617	832	6.7
CN2201300000000	22	013	Bienville Parish, LA	1999	NA	5510	5149	361	6.6
CN2201500000000	22	015	Bossier Parish, LA	1999	NA	45847	43857	1990	4.3
CN2201700000000	22	017	Caddo Parish, LA	1999	NA	115946	110867	5079	4.4
CN2201900000000	22	019	Calcasieu Parish, LA	1999	NA	90087	85495	4592	5.1
CN2202100000000	22	021	Caldwell Parish, LA	1999	NA	4295	3942	353	8.2
CN2202300000000	22	023	Cameron Parish, LA	1999	NA	3831	3642	189	4.9
CN2202500000000	22	025	Catahoula Parish, LA	1999	NA	4862	4392	470	9.7
CN2202700000000	22	027	Claiborne Parish, LA	1999	NA	5693	5262	431	7.6
CN2202900000000	22	029	Concordia Parish, LA	1999	NA	8368	7335	1033	12.3
CN2203100000000	22	031	De Soto Parish, LA	1999	NA	11239	10554	685	6.1
CN2203300000000	22	033	East Baton Rouge Parish, LA	1999	NA	208242	200959	7283	3.5
CN2203500000000	22	035	East Carroll Parish, LA	1999	NA	3041	2655	386	12.7
CN2203700000000	22	037	East Feliciana Parish, LA	1999	NA	7481	7119	362	4.8
CN2203900000000	22	039	Evangeline Parish, LA	1999	NA	12036	11367	669	5.6
CN2204100000000	22	041	Franklin Parish, LA	1999	NA	9825	9059	766	7.8
CN2204300000000	22	043	Grant Parish, LA	1999	NA	6949	6483	466	6.7
CN2204500000000	22	045	Iberia Parish, LA	1999	NA	32399	29912	2487	7.7
CN2204700000000	22	047	Iberville Parish, LA	1999	NA	12886	12068	818	6.3
CN2204900000000	22	049	Jackson Parish, LA	1999	NA	5653	5356	297	5.3
CN2205100000000	22	051	Jefferson Parish, LA	1999	NA	242342	231934	10408	4.3
CN2205300000000	22	053	Jefferson Davis Parish, LA	1999	NA	11439	10654	785	6.9
CN2205500000000	22	055	Lafayette Parish, LA	1999	NA	95768	91786	3982	4.2
CN2205700000000	22	057	Lafourche Parish, LA	1999	NA	41607	40074	1533	3.7
CN2205900000000	22	059	LaSalle Parish, LA	1999	NA	5280	4892	388	7.3
CN2206100000000	22	061	Lincoln Parish, LA	1999	NA	19288	18830	458	2.4
CN2206300000000	22	063	Livingston Parish, LA	1999	NA	43958	41844	2114	4.8
CN2206500000000	22	065	Madison Parish, LA	1999	NA	5435	5009	426	7.8
CN2206700000000	22	067	Morehouse Parish, LA	1999	NA	11952	10746	1206	10.1
CN2206900000000	22	069	Natchitoches Parish, LA	1999	NA	17926	17022	904	5
CN2207100000000	22	071	Orleans Parish, LA	1999	NA	204901	193110	11791	5.8
CN2207300000000	22	073	Ouachita Parish, LA	1999	NA	69770	67183	2587	3.7
CN2207500000000	22	075	Plaquemines Parish, LA	1999	NA	11183	10527	656	5.9
CN2207700000000	22	077	Pointe Coupee Parish, LA	1999	NA	9613	9027	586	6.1
CN2207900000000	22	079	Rapides Parish, LA	1999	NA	60027	57415	2612	4.4
CN2208100000000	22	081	Red River Parish, LA	1999	NA	3309	3050	259	7.8
CN2208300000000	22	083	Richland Parish, LA	1999	NA	8223	7583	640	7.8
CN2208500000000	22	085	Sabine Parish, LA	1999	NA	8524	7991	533	6.3
CN2208700000000	22	087	St. Bernard Parish, LA	1999	NA	32261	30605	1656	5.1
CN2208900000000	22	089	St. Charles Parish, LA	1999	NA	24105	22835	1270	5.3
CN2209100000000	22	091	St. Helena Parish, LA	1999	NA	3891	3698	193	5
CN2209300000000	22	093	St. James Parish, LA	1999	NA	9056	8177	879	9.7
CN2209500000000	22	095	St. John the Baptist Parish, LA	1999	NA	20438	18940	1498	7.3
CN2209700000000	22	097	St. Landry Parish, LA	1999	NA	31590	29293	2297	7.3
CN2209900000000	22	099	St. Martin Parish, LA	1999	NA	21013	19769	1244	5.9
CN2210100000000	22	101	St. Mary Parish, LA	1999	NA	23797	21233	2564	10.8
CN2210300000000	22	103	St. Tammany Parish, LA	1999	NA	95591	92254	3337	3.5
CN2210500000000	22	105	Tangipahoa Parish, LA	1999	NA	43815	41011	2804	6.4
CN2210700000000	22	107	Tensas Parish, LA	1999	NA	3112	2909	203	6.5
CN2210900000000	22	109	Terrebonne Parish, LA	1999	NA	47810	45823	1987	4.2
CN2211100000000	22	111	Union Parish, LA	1999	NA	12527	12025	502	4
CN2211300000000	22	113	Vermilion Parish, LA	1999	NA	21866	20373	1493	6.8
CN2211500000000	22	115	Vernon Parish, LA	1999	NA	17109	16134	975	5.7
CN2211700000000	22	117	Washington Parish, LA	1999	NA	16255	15319	936	5.8
CN2211900000000	22	119	Webster Parish, LA	1999	NA	18893	17713	1180	6.2
CN2212100000000	22	121	West Baton Rouge Parish, LA	1999	NA	9916	9507	409	4.1
CN2212300000000	22	123	West Carroll Parish, LA	1999	NA	5322	4606	716	13.5
CN2212500000000	22	125	West Feliciana Parish, LA	1999	NA	3693	3530	163	4.4
CN2212700000000	22	127	Winn Parish, LA	1999	NA	6427	6034	393	6.1
CN2300100000000	23	001	Androscoggin County, ME	1999	NA	59645	57326	2319	3.9
CN2300300000000	23	003	Aroostook County, ME	1999	NA	37561	35513	2048	5.5
CN2300500000000	23	005	Cumberland County, ME	1999	NA	141602	138420	3182	2.2
CN2300700000000	23	007	Franklin County, ME	1999	NA	14957	13953	1004	6.7
CN2300900000000	23	009	Hancock County, ME	1999	NA	28357	26916	1441	5.1
CN2301100000000	23	011	Kennebec County, ME	1999	NA	59518	56910	2608	4.4
CN2301300000000	23	013	Knox County, ME	1999	NA	19894	19321	573	2.9
CN2301500000000	23	015	Lincoln County, ME	1999	NA	17533	17038	495	2.8
CN2301700000000	23	017	Oxford County, ME	1999	NA	26372	24674	1698	6.4
CN2301900000000	23	019	Penobscot County, ME	1999	NA	77190	74015	3175	4.1
CN2302100000000	23	021	Piscataquis County, ME	1999	NA	8302	7737	565	6.8
CN2302300000000	23	023	Sagadahoc County, ME	1999	NA	16249	15774	475	2.9
CN2302500000000	23	025	Somerset County, ME	1999	NA	25678	23842	1836	7.2
CN2302700000000	23	027	Waldo County, ME	1999	NA	21651	20741	910	4.2
CN2302900000000	23	029	Washington County, ME	1999	NA	16382	14973	1409	8.6
CN2303100000000	23	031	York County, ME	1999	NA	97629	94954	2675	2.7
CN2400100000000	24	001	Allegany County, MD	1999	NA	32159	29834	2325	7.2
CN2400300000000	24	003	Anne Arundel County, MD	1999	NA	256773	249511	7262	2.8
CN2400500000000	24	005	Baltimore County, MD	1999	NA	393674	378792	14882	3.8
CN2400900000000	24	009	Calvert County, MD	1999	NA	37956	36966	990	2.6
CN2401100000000	24	011	Caroline County, MD	1999	NA	15852	15326	526	3.3
CN2401300000000	24	013	Carroll County, MD	1999	NA	82628	80556	2072	2.5
CN2401500000000	24	015	Cecil County, MD	1999	NA	41448	39537	1911	4.6
CN2401700000000	24	017	Charles County, MD	1999	NA	61954	60389	1565	2.5
CN2401900000000	24	019	Dorchester County, MD	1999	NA	15419	14277	1142	7.4
CN2402100000000	24	021	Frederick County, MD	1999	NA	100836	98617	2219	2.2
CN2402300000000	24	023	Garrett County, MD	1999	NA	13472	12320	1152	8.6
CN2402500000000	24	025	Harford County, MD	1999	NA	114305	110610	3695	3.2
CN2402700000000	24	027	Howard County, MD	1999	NA	143613	141035	2578	1.8
CN2402900000000	24	029	Kent County, MD	1999	NA	10010	9625	385	3.8
CN2403100000000	24	031	Montgomery County, MD	1999	NA	475247	466434	8813	1.9
CN2403300000000	24	033	Prince George's County, MD	1999	NA	440861	425229	15632	3.5
CN2403500000000	24	035	Queen Anne's County, MD	1999	NA	21352	20743	609	2.9
CN2403700000000	24	037	St. Mary's County, MD	1999	NA	49547	47985	1562	3.2
CN2403900000000	24	039	Somerset County, MD	1999	NA	11370	10498	872	7.7
CN2404100000000	24	041	Talbot County, MD	1999	NA	18816	18277	539	2.9
CN2404300000000	24	043	Washington County, MD	1999	NA	67895	65559	2336	3.4
CN2404500000000	24	045	Wicomico County, MD	1999	NA	47373	45147	2226	4.7
CN2404700000000	24	047	Worcester County, MD	1999	NA	24834	22605	2229	9
CN2451000000000	24	510	Baltimore city, MD	1999	NA	288725	267470	21255	7.4
CN2500100000000	25	001	Barnstable County, MA	1999	NA	109354	104711	4643	4.2
CN2500300000000	25	003	Berkshire County, MA	1999	NA	66317	63843	2474	3.7
CN2500500000000	25	005	Bristol County, MA	1999	NA	269675	257462	12213	4.5
CN2500700000000	25	007	Dukes County, MA	1999	NA	9531	9170	361	3.8
CN2500900000000	25	009	Essex County, MA	1999	NA	377359	364191	13168	3.5
CN2501100000000	25	011	Franklin County, MA	1999	NA	38796	37659	1137	2.9
CN2501300000000	25	013	Hampden County, MA	1999	NA	213998	205434	8564	4
CN2501500000000	25	015	Hampshire County, MA	1999	NA	83077	81036	2041	2.5
CN2501700000000	25	017	Middlesex County, MA	1999	NA	837580	816828	20752	2.5
CN2501900000000	25	019	Nantucket County/town, MA	1999	NA	6605	6493	112	1.7
CN2502100000000	25	021	Norfolk County, MA	1999	NA	366597	357940	8657	2.4
CN2502300000000	25	023	Plymouth County, MA	1999	NA	252099	243893	8206	3.3
CN2502500000000	25	025	Suffolk County, MA	1999	NA	346429	334575	11854	3.4
CN2502700000000	25	027	Worcester County, MA	1999	NA	376442	363774	12668	3.4
CN2600100000000	26	001	Alcona County, MI	1999	NA	5007	4651	356	7.1
CN2600300000000	26	003	Alger County, MI	1999	NA	4449	4215	234	5.3
CN2600500000000	26	005	Allegan County, MI	1999	NA	57823	56332	1491	2.6
CN2600700000000	26	007	Alpena County, MI	1999	NA	16190	15248	942	5.8
CN2600900000000	26	009	Antrim County, MI	1999	NA	10649	10052	597	5.6
CN2601100000000	26	011	Arenac County, MI	1999	NA	7039	6581	458	6.5
CN2601300000000	26	013	Baraga County, MI	1999	NA	4404	4132	272	6.2
CN2601500000000	26	015	Barry County, MI	1999	NA	33064	32183	881	2.7
CN2601700000000	26	017	Bay County, MI	1999	NA	56078	53672	2406	4.3
CN2601900000000	26	019	Benzie County, MI	1999	NA	7954	7560	394	5
CN2602100000000	26	021	Berrien County, MI	1999	NA	84266	81247	3019	3.6
CN2602300000000	26	023	Branch County, MI	1999	NA	22910	22187	723	3.2
CN2602500000000	26	025	Calhoun County, MI	1999	NA	70283	67655	2628	3.7
CN2602700000000	26	027	Cass County, MI	1999	NA	27097	26286	811	3
CN2602900000000	26	029	Charlevoix County, MI	1999	NA	14416	13750	666	4.6
CN2603100000000	26	031	Cheboygan County, MI	1999	NA	12624	11434	1190	9.4
CN2603300000000	26	033	Chippewa County, MI	1999	NA	17872	16710	1162	6.5
CN2603500000000	26	035	Clare County, MI	1999	NA	10920	10162	758	6.9
CN2603700000000	26	037	Clinton County, MI	1999	NA	34746	34054	692	2
CN2603900000000	26	039	Crawford County, MI	1999	NA	5735	5401	334	5.8
CN2604100000000	26	041	Delta County, MI	1999	NA	19336	18223	1113	5.8
CN2604300000000	26	043	Dickinson County, MI	1999	NA	14342	13662	680	4.7
CN2604500000000	26	045	Eaton County, MI	1999	NA	56617	55431	1186	2.1
CN2604700000000	26	047	Emmet County, MI	1999	NA	18262	17120	1142	6.3
CN2604900000000	26	049	Genesee County, MI	1999	NA	197034	187284	9750	4.9
CN2605100000000	26	051	Gladwin County, MI	1999	NA	9129	8530	599	6.6
CN2605300000000	26	053	Gogebic County, MI	1999	NA	8047	7546	501	6.2
CN2605500000000	26	055	Grand Traverse County, MI	1999	NA	45900	44414	1486	3.2
CN2605700000000	26	057	Gratiot County, MI	1999	NA	19818	19021	797	4
CN2605900000000	26	059	Hillsdale County, MI	1999	NA	24664	23940	724	2.9
CN2606100000000	26	061	Houghton County, MI	1999	NA	17497	16767	730	4.2
CN2606300000000	26	063	Huron County, MI	1999	NA	18053	17258	795	4.4
CN2606500000000	26	065	Ingham County, MI	1999	NA	154279	150508	3771	2.4
CN2606700000000	26	067	Ionia County, MI	1999	NA	27828	26742	1086	3.9
CN2606900000000	26	069	Iosco County, MI	1999	NA	11704	10852	852	7.3
CN2607100000000	26	071	Iron County, MI	1999	NA	5623	5280	343	6.1
CN2607300000000	26	073	Isabella County, MI	1999	NA	33122	32202	920	2.8
CN2607500000000	26	075	Jackson County, MI	1999	NA	78112	75751	2361	3
CN2607700000000	26	077	Kalamazoo County, MI	1999	NA	130114	126745	3369	2.6
CN2607900000000	26	079	Kalkaska County, MI	1999	NA	7771	7342	429	5.5
CN2608100000000	26	081	Kent County, MI	1999	NA	329758	320624	9134	2.8
CN2608300000000	26	083	Keweenaw County, MI	1999	NA	879	811	68	7.7
CN2608500000000	26	085	Lake County, MI	1999	NA	3476	3223	253	7.3
CN2608700000000	26	087	Lapeer County, MI	1999	NA	44859	42862	1997	4.5
CN2608900000000	26	089	Leelanau County, MI	1999	NA	11244	10913	331	2.9
CN2609100000000	26	091	Lenawee County, MI	1999	NA	48650	47096	1554	3.2
CN2609300000000	26	093	Livingston County, MI	1999	NA	81645	79658	1987	2.4
CN2609500000000	26	095	Luce County, MI	1999	NA	2646	2450	196	7.4
CN2609700000000	26	097	Mackinac County, MI	1999	NA	7475	6830	645	8.6
CN2609900000000	26	099	Macomb County, MI	1999	NA	443626	427668	15958	3.6
CN2610100000000	26	101	Manistee County, MI	1999	NA	11020	10427	593	5.4
CN2610300000000	26	103	Marquette County, MI	1999	NA	32839	31188	1651	5
CN2610500000000	26	105	Mason County, MI	1999	NA	14372	13582	790	5.5
CN2610700000000	26	107	Mecosta County, MI	1999	NA	18135	17464	671	3.7
CN2610900000000	26	109	Menominee County, MI	1999	NA	13026	12462	564	4.3
CN2611100000000	26	111	Midland County, MI	1999	NA	43753	42617	1136	2.6
CN2611300000000	26	113	Missaukee County, MI	1999	NA	7017	6654	363	5.2
CN2611500000000	26	115	Monroe County, MI	1999	NA	75607	73492	2115	2.8
CN2611700000000	26	117	Montcalm County, MI	1999	NA	25560	24213	1347	5.3
CN2611900000000	26	119	Montmorency County, MI	1999	NA	3579	3208	371	10.4
CN2612100000000	26	121	Muskegon County, MI	1999	NA	84961	81413	3548	4.2
CN2612300000000	26	123	Newaygo County, MI	1999	NA	20852	19543	1309	6.3
CN2612500000000	26	125	Oakland County, MI	1999	NA	679850	660710	19140	2.8
CN2612700000000	26	127	Oceana County, MI	1999	NA	14357	13413	944	6.6
CN2612900000000	26	129	Ogemaw County, MI	1999	NA	8904	8349	555	6.2
CN2613100000000	26	131	Ontonagon County, MI	1999	NA	3039	2795	244	8
CN2613300000000	26	133	Osceola County, MI	1999	NA	10831	10282	549	5.1
CN2613500000000	26	135	Oscoda County, MI	1999	NA	3675	3414	261	7.1
CN2613700000000	26	137	Otsego County, MI	1999	NA	13482	12917	565	4.2
CN2613900000000	26	139	Ottawa County, MI	1999	NA	142221	138860	3361	2.4
CN2614100000000	26	141	Presque Isle County, MI	1999	NA	6284	5678	606	9.6
CN2614300000000	26	143	Roscommon County, MI	1999	NA	8223	7666	557	6.8
CN2614500000000	26	145	Saginaw County, MI	1999	NA	102292	98233	4059	4
CN2614700000000	26	147	St. Clair County, MI	1999	NA	81576	77645	3931	4.8
CN2614900000000	26	149	St. Joseph County, MI	1999	NA	33179	32229	950	2.9
CN2615100000000	26	151	Sanilac County, MI	1999	NA	21051	19845	1206	5.7
CN2615300000000	26	153	Schoolcraft County, MI	1999	NA	4343	3977	366	8.4
CN2615500000000	26	155	Shiawassee County, MI	1999	NA	36856	35390	1466	4
CN2615700000000	26	157	Tuscola County, MI	1999	NA	28057	26674	1383	4.9
CN2615900000000	26	159	Van Buren County, MI	1999	NA	37539	36097	1442	3.8
CN2616100000000	26	161	Washtenaw County, MI	1999	NA	177007	174146	2861	1.6
CN2616300000000	26	163	Wayne County, MI	1999	NA	961764	916598	45166	4.7
CN2616500000000	26	165	Wexford County, MI	1999	NA	15475	14560	915	5.9
CN2700100000000	27	001	Aitkin County, MN	1999	NA	6085	5632	453	7.4
CN2700300000000	27	003	Anoka County, MN	1999	NA	183240	179233	4007	2.2
CN2700500000000	27	005	Becker County, MN	1999	NA	14234	13449	785	5.5
CN2700700000000	27	007	Beltrami County, MN	1999	NA	20022	19008	1014	5.1
CN2700900000000	27	009	Benton County, MN	1999	NA	21089	20448	641	3
CN2701100000000	27	011	Big Stone County, MN	1999	NA	2741	2638	103	3.8
CN2701300000000	27	013	Blue Earth County, MN	1999	NA	33725	32949	776	2.3
CN2701500000000	27	015	Brown County, MN	1999	NA	15064	14531	533	3.5
CN2701700000000	27	017	Carlton County, MN	1999	NA	16088	15412	676	4.2
CN2701900000000	27	019	Carver County, MN	1999	NA	40897	40043	854	2.1
CN2702100000000	27	021	Cass County, MN	1999	NA	12587	11844	743	5.9
CN2702300000000	27	023	Chippewa County, MN	1999	NA	6984	6643	341	4.9
CN2702500000000	27	025	Chisago County, MN	1999	NA	22003	21306	697	3.2
CN2702700000000	27	027	Clay County, MN	1999	NA	30363	29621	742	2.4
CN2702900000000	27	029	Clearwater County, MN	1999	NA	4165	3695	470	11.3
CN2703100000000	27	031	Cook County, MN	1999	NA	3085	2973	112	3.6
CN2703300000000	27	033	Cottonwood County, MN	1999	NA	5717	5465	252	4.4
CN2703500000000	27	035	Crow Wing County, MN	1999	NA	28091	26856	1235	4.4
CN2703700000000	27	037	Dakota County, MN	1999	NA	217949	213972	3977	1.8
CN2703900000000	27	039	Dodge County, MN	1999	NA	9110	8820	290	3.2
CN2704100000000	27	041	Douglas County, MN	1999	NA	16850	16282	568	3.4
CN2704300000000	27	043	Faribault County, MN	1999	NA	8169	7861	308	3.8
CN2704500000000	27	045	Fillmore County, MN	1999	NA	10043	9715	328	3.3
CN2704700000000	27	047	Freeborn County, MN	1999	NA	16687	16243	444	2.7
CN2704900000000	27	049	Goodhue County, MN	1999	NA	23455	22772	683	2.9
CN2705100000000	27	051	Grant County, MN	1999	NA	2861	2707	154	5.4
CN2705300000000	27	053	Hennepin County, MN	1999	NA	661528	647231	14297	2.2
CN2705500000000	27	055	Houston County, MN	1999	NA	11389	10996	393	3.5
CN2705700000000	27	057	Hubbard County, MN	1999	NA	8415	8006	409	4.9
CN2705900000000	27	059	Isanti County, MN	1999	NA	16254	15692	562	3.5
CN2706100000000	27	061	Itasca County, MN	1999	NA	20126	18689	1437	7.1
CN2706300000000	27	063	Jackson County, MN	1999	NA	6134	5940	194	3.2
CN2706500000000	27	065	Kanabec County, MN	1999	NA	6960	6508	452	6.5
CN2706700000000	27	067	Kandiyohi County, MN	1999	NA	21654	20908	746	3.4
CN2706900000000	27	069	Kittson County, MN	1999	NA	2350	2203	147	6.3
CN2707100000000	27	071	Koochiching County, MN	1999	NA	6538	6104	434	6.6
CN2707300000000	27	073	Lac qui Parle County, MN	1999	NA	3775	3649	126	3.3
CN2707500000000	27	075	Lake County, MN	1999	NA	5683	5474	209	3.7
CN2707700000000	27	077	Lake of the Woods County, MN	1999	NA	2540	2421	119	4.7
CN2707900000000	27	079	Le Sueur County, MN	1999	NA	14789	14297	492	3.3
CN2708100000000	27	081	Lincoln County, MN	1999	NA	3043	2930	113	3.7
CN2708300000000	27	083	Lyon County, MN	1999	NA	15058	14662	396	2.6
CN2708500000000	27	085	McLeod County, MN	1999	NA	21081	20409	672	3.2
CN2708700000000	27	087	Mahnomen County, MN	1999	NA	2237	2072	165	7.4
CN2708900000000	27	089	Marshall County, MN	1999	NA	4620	4169	451	9.8
CN2709100000000	27	091	Martin County, MN	1999	NA	11077	10697	380	3.4
CN2709300000000	27	093	Meeker County, MN	1999	NA	9497	8993	504	5.3
CN2709500000000	27	095	Mille Lacs County, MN	1999	NA	9465	8881	584	6.2
CN2709700000000	27	097	Morrison County, MN	1999	NA	14915	14009	906	6.1
CN2709900000000	27	099	Mower County, MN	1999	NA	19105	18702	403	2.1
CN2710100000000	27	101	Murray County, MN	1999	NA	4372	4194	178	4.1
CN2710300000000	27	103	Nicollet County, MN	1999	NA	18532	18183	349	1.9
CN2710500000000	27	105	Nobles County, MN	1999	NA	9694	9390	304	3.1
CN2710700000000	27	107	Norman County, MN	1999	NA	3383	3210	173	5.1
CN2710900000000	27	109	Olmsted County, MN	1999	NA	74143	72670	1473	2
CN2711100000000	27	111	Otter Tail County, MN	1999	NA	27678	26503	1175	4.2
CN2711300000000	27	113	Pennington County, MN	1999	NA	8123	7652	471	5.8
CN2711500000000	27	115	Pine County, MN	1999	NA	11304	10597	707	6.3
CN2711700000000	27	117	Pipestone County, MN	1999	NA	4976	4835	141	2.8
CN2711900000000	27	119	Polk County, MN	1999	NA	17116	16488	628	3.7
CN2712100000000	27	121	Pope County, MN	1999	NA	5485	5318	167	3
CN2712300000000	27	123	Ramsey County, MN	1999	NA	283934	277426	6508	2.3
CN2712500000000	27	125	Red Lake County, MN	1999	NA	1897	1721	176	9.3
CN2712700000000	27	127	Redwood County, MN	1999	NA	8954	8702	252	2.8
CN2712900000000	27	129	Renville County, MN	1999	NA	8174	7791	383	4.7
CN2713100000000	27	131	Rice County, MN	1999	NA	28512	27686	826	2.9
CN2713300000000	27	133	Rock County, MN	1999	NA	4744	4611	133	2.8
CN2713500000000	27	135	Roseau County, MN	1999	NA	9026	8662	364	4
CN2713700000000	27	137	St. Louis County, MN	1999	NA	103980	99832	4148	4
CN2713900000000	27	139	Scott County, MN	1999	NA	49569	48469	1100	2.2
CN2714100000000	27	141	Sherburne County, MN	1999	NA	34768	33868	900	2.6
CN2714300000000	27	143	Sibley County, MN	1999	NA	6589	6325	264	4
CN2714500000000	27	145	Stearns County, MN	1999	NA	78428	76149	2279	2.9
CN2714700000000	27	147	Steele County, MN	1999	NA	19635	19145	490	2.5
CN2714900000000	27	149	Stevens County, MN	1999	NA	5594	5435	159	2.8
CN2715100000000	27	151	Swift County, MN	1999	NA	5566	5349	217	3.9
CN2715300000000	27	153	Todd County, MN	1999	NA	9332	8851	481	5.2
CN2715500000000	27	155	Traverse County, MN	1999	NA	1754	1656	98	5.6
CN2715700000000	27	157	Wabasha County, MN	1999	NA	12727	12426	301	2.4
CN2715900000000	27	159	Wadena County, MN	1999	NA	7208	6824	384	5.3
CN2716100000000	27	161	Waseca County, MN	1999	NA	9700	9393	307	3.2
CN2716300000000	27	163	Washington County, MN	1999	NA	119117	116975	2142	1.8
CN2716500000000	27	165	Watonwan County, MN	1999	NA	5794	5575	219	3.8
CN2716700000000	27	167	Wilkin County, MN	1999	NA	4048	3958	90	2.2
CN2716900000000	27	169	Winona County, MN	1999	NA	28213	27471	742	2.6
CN2717100000000	27	171	Wright County, MN	1999	NA	49226	47836	1390	2.8
CN2717300000000	27	173	Yellow Medicine County, MN	1999	NA	5328	5100	228	4.3
CN2800100000000	28	001	Adams County, MS	1999	NA	14599	13326	1273	8.7
CN2800300000000	28	003	Alcorn County, MS	1999	NA	15127	14340	787	5.2
CN2800500000000	28	005	Amite County, MS	1999	NA	5746	5463	283	4.9
CN2800700000000	28	007	Attala County, MS	1999	NA	7760	7103	657	8.5
CN2800900000000	28	009	Benton County, MS	1999	NA	3208	3005	203	6.3
CN2801100000000	28	011	Bolivar County, MS	1999	NA	16761	15514	1247	7.4
CN2801300000000	28	013	Calhoun County, MS	1999	NA	6231	5971	260	4.2
CN2801500000000	28	015	Carroll County, MS	1999	NA	4453	4222	231	5.2
CN2801700000000	28	017	Chickasaw County, MS	1999	NA	7703	7218	485	6.3
CN2801900000000	28	019	Choctaw County, MS	1999	NA	3102	2863	239	7.7
CN2802100000000	28	021	Claiborne County, MS	1999	NA	3416	3063	353	10.3
CN2802300000000	28	023	Clarke County, MS	1999	NA	8875	8233	642	7.2
CN2802500000000	28	025	Clay County, MS	1999	NA	8958	8298	660	7.4
CN2802700000000	28	027	Coahoma County, MS	1999	NA	11707	10643	1064	9.1
CN2802900000000	28	029	Copiah County, MS	1999	NA	11132	10159	973	8.7
CN2803100000000	28	031	Covington County, MS	1999	NA	8305	7839	466	5.6
CN2803300000000	28	033	DeSoto County, MS	1999	NA	55007	53639	1368	2.5
CN2803500000000	28	035	Forrest County, MS	1999	NA	33488	32353	1135	3.4
CN2803700000000	28	037	Franklin County, MS	1999	NA	3444	3165	279	8.1
CN2803900000000	28	039	George County, MS	1999	NA	8593	7982	611	7.1
CN2804100000000	28	041	Greene County, MS	1999	NA	5312	4936	376	7.1
CN2804300000000	28	043	Grenada County, MS	1999	NA	10128	9585	543	5.4
CN2804500000000	28	045	Hancock County, MS	1999	NA	18516	17783	733	4
CN2804700000000	28	047	Harrison County, MS	1999	NA	86229	83240	2989	3.5
CN2804900000000	28	049	Hinds County, MS	1999	NA	126563	121311	5252	4.1
CN2805100000000	28	051	Holmes County, MS	1999	NA	7020	5805	1215	17.3
CN2805300000000	28	053	Humphreys County, MS	1999	NA	4825	4346	479	9.9
CN2805500000000	28	055	Issaquena County, MS	1999	NA	648	551	97	15
CN2805700000000	28	057	Itawamba County, MS	1999	NA	11331	10841	490	4.3
CN2805900000000	28	059	Jackson County, MS	1999	NA	70521	67821	2700	3.8
CN2806100000000	28	061	Jasper County, MS	1999	NA	8236	7836	400	4.9
CN2806300000000	28	063	Jefferson County, MS	1999	NA	2680	2202	478	17.8
CN2806500000000	28	065	Jefferson Davis County, MS	1999	NA	4800	4006	794	16.5
CN2806700000000	28	067	Jones County, MS	1999	NA	31307	30251	1056	3.4
CN2806900000000	28	069	Kemper County, MS	1999	NA	4510	3959	551	12.2
CN2807100000000	28	071	Lafayette County, MS	1999	NA	17693	17375	318	1.8
CN2807300000000	28	073	Lamar County, MS	1999	NA	17760	17239	521	2.9
CN2807500000000	28	075	Lauderdale County, MS	1999	NA	34790	32809	1981	5.7
CN2807700000000	28	077	Lawrence County, MS	1999	NA	5282	4889	393	7.4
CN2807900000000	28	079	Leake County, MS	1999	NA	9465	8889	576	6.1
CN2808100000000	28	081	Lee County, MS	1999	NA	40660	39112	1548	3.8
CN2808300000000	28	083	Leflore County, MS	1999	NA	15547	14245	1302	8.4
CN2808500000000	28	085	Lincoln County, MS	1999	NA	14026	13352	674	4.8
CN2808700000000	28	087	Lowndes County, MS	1999	NA	26971	25399	1572	5.8
CN2808900000000	28	089	Madison County, MS	1999	NA	37346	36192	1154	3.1
CN2809100000000	28	091	Marion County, MS	1999	NA	10690	9997	693	6.5
CN2809300000000	28	093	Marshall County, MS	1999	NA	13759	12918	841	6.1
CN2809500000000	28	095	Monroe County, MS	1999	NA	15256	14143	1113	7.3
CN2809700000000	28	097	Montgomery County, MS	1999	NA	5471	5141	330	6
CN2809900000000	28	099	Neshoba County, MS	1999	NA	15876	15126	750	4.7
CN2810100000000	28	101	Newton County, MS	1999	NA	8513	7952	561	6.6
CN2810300000000	28	103	Noxubee County, MS	1999	NA	4591	4070	521	11.3
CN2810500000000	28	105	Oktibbeha County, MS	1999	NA	21283	20815	468	2.2
CN2810700000000	28	107	Panola County, MS	1999	NA	12552	11532	1020	8.1
CN2810900000000	28	109	Pearl River County, MS	1999	NA	20060	19239	821	4.1
CN2811100000000	28	111	Perry County, MS	1999	NA	4125	3822	303	7.3
CN2811300000000	28	113	Pike County, MS	1999	NA	16693	15833	860	5.2
CN2811500000000	28	115	Pontotoc County, MS	1999	NA	13654	13194	460	3.4
CN2811700000000	28	117	Prentiss County, MS	1999	NA	12506	11730	776	6.2
CN2811900000000	28	119	Quitman County, MS	1999	NA	3311	3020	291	8.8
CN2812100000000	28	121	Rankin County, MS	1999	NA	60821	59513	1308	2.2
CN2812300000000	28	123	Scott County, MS	1999	NA	12324	11909	415	3.4
CN2812500000000	28	125	Sharkey County, MS	1999	NA	2536	2077	459	18.1
CN2812700000000	28	127	Simpson County, MS	1999	NA	9874	9247	627	6.4
CN2812900000000	28	129	Smith County, MS	1999	NA	5802	5579	223	3.8
CN2813100000000	28	131	Stone County, MS	1999	NA	5091	4828	263	5.2
CN2813300000000	28	133	Sunflower County, MS	1999	NA	10999	9905	1094	9.9
CN2813500000000	28	135	Tallahatchie County, MS	1999	NA	5360	4843	517	9.6
CN2813700000000	28	137	Tate County, MS	1999	NA	10457	9857	600	5.7
CN2813900000000	28	139	Tippah County, MS	1999	NA	9968	9482	486	4.9
CN2814100000000	28	141	Tishomingo County, MS	1999	NA	9459	8701	758	8
CN2814300000000	28	143	Tunica County, MS	1999	NA	5726	5355	371	6.5
CN2814500000000	28	145	Union County, MS	1999	NA	12626	12147	479	3.8
CN2814700000000	28	147	Walthall County, MS	1999	NA	5944	5603	341	5.7
CN2814900000000	28	149	Warren County, MS	1999	NA	26583	25380	1203	4.5
CN2815100000000	28	151	Washington County, MS	1999	NA	27062	24499	2563	9.5
CN2815300000000	28	153	Wayne County, MS	1999	NA	8500	7959	541	6.4
CN2815500000000	28	155	Webster County, MS	1999	NA	4407	4176	231	5.2
CN2815700000000	28	157	Wilkinson County, MS	1999	NA	3010	2549	461	15.3
CN2815900000000	28	159	Winston County, MS	1999	NA	7731	7236	495	6.4
CN2816100000000	28	161	Yalobusha County, MS	1999	NA	4695	4313	382	8.1
CN2816300000000	28	163	Yazoo County, MS	1999	NA	9407	8640	767	8.2
CN2900100000000	29	001	Adair County, MO	1999	NA	13995	13746	249	1.8
CN2900300000000	29	003	Andrew County, MO	1999	NA	8393	8157	236	2.8
CN2900500000000	29	005	Atchison County, MO	1999	NA	3147	3083	64	2
CN2900700000000	29	007	Audrain County, MO	1999	NA	13127	12787	340	2.6
CN2900900000000	29	009	Barry County, MO	1999	NA	15480	14933	547	3.5
CN2901100000000	29	011	Barton County, MO	1999	NA	7346	7164	182	2.5
CN2901300000000	29	013	Bates County, MO	1999	NA	7502	7190	312	4.2
CN2901500000000	29	015	Benton County, MO	1999	NA	6090	5751	339	5.6
CN2901700000000	29	017	Bollinger County, MO	1999	NA	5467	5254	213	3.9
CN2901900000000	29	019	Boone County, MO	1999	NA	84006	83003	1003	1.2
CN2902100000000	29	021	Buchanan County, MO	1999	NA	42225	40710	1515	3.6
CN2902300000000	29	023	Butler County, MO	1999	NA	19794	19009	785	4
CN2902500000000	29	025	Caldwell County, MO	1999	NA	3183	3035	148	4.6
CN2902700000000	29	027	Callaway County, MO	1999	NA	21713	21187	526	2.4
CN2902900000000	29	029	Camden County, MO	1999	NA	17487	16699	788	4.5
CN2903100000000	29	031	Cape Girardeau County, MO	1999	NA	38096	37094	1002	2.6
CN2903300000000	29	033	Carroll County, MO	1999	NA	4908	4719	189	3.9
CN2903500000000	29	035	Carter County, MO	1999	NA	2784	2611	173	6.2
CN2903700000000	29	037	Cass County, MO	1999	NA	45506	44435	1071	2.4
CN2903900000000	29	039	Cedar County, MO	1999	NA	5167	4987	180	3.5
CN2904100000000	29	041	Chariton County, MO	1999	NA	4184	4019	165	3.9
CN2904300000000	29	043	Christian County, MO	1999	NA	28465	27789	676	2.4
CN2904500000000	29	045	Clark County, MO	1999	NA	3720	3547	173	4.7
CN2904700000000	29	047	Clay County, MO	1999	NA	107242	104736	2506	2.3
CN2904900000000	29	049	Clinton County, MO	1999	NA	9868	9577	291	2.9
CN2905100000000	29	051	Cole County, MO	1999	NA	40415	39651	764	1.9
CN2905300000000	29	053	Cooper County, MO	1999	NA	8482	8240	242	2.9
CN2905500000000	29	055	Crawford County, MO	1999	NA	9816	9324	492	5
CN2905700000000	29	057	Dade County, MO	1999	NA	3418	3289	129	3.8
CN2905900000000	29	059	Dallas County, MO	1999	NA	6587	6322	265	4
CN2906100000000	29	061	Daviess County, MO	1999	NA	3553	3438	115	3.2
CN2906300000000	29	063	DeKalb County, MO	1999	NA	4817	4686	131	2.7
CN2906500000000	29	065	Dent County, MO	1999	NA	6493	6097	396	6.1
CN2906700000000	29	067	Douglas County, MO	1999	NA	5608	5313	295	5.3
CN2906900000000	29	069	Dunklin County, MO	1999	NA	14293	13586	707	4.9
CN2907100000000	29	071	Franklin County, MO	1999	NA	47642	46013	1629	3.4
CN2907300000000	29	073	Gasconade County, MO	1999	NA	7923	7696	227	2.9
CN2907500000000	29	075	Gentry County, MO	1999	NA	3652	3561	91	2.5
CN2907700000000	29	077	Greene County, MO	1999	NA	126325	123486	2839	2.2
CN2907900000000	29	079	Grundy County, MO	1999	NA	4975	4823	152	3.1
CN2908100000000	29	081	Harrison County, MO	1999	NA	4406	4305	101	2.3
CN2908300000000	29	083	Henry County, MO	1999	NA	10706	10314	392	3.7
CN2908500000000	29	085	Hickory County, MO	1999	NA	2869	2719	150	5.2
CN2908700000000	29	087	Holt County, MO	1999	NA	2751	2660	91	3.3
CN2908900000000	29	089	Howard County, MO	1999	NA	4701	4542	159	3.4
CN2909100000000	29	091	Howell County, MO	1999	NA	17743	17057	686	3.9
CN2909300000000	29	093	Iron County, MO	1999	NA	4190	3891	299	7.1
CN2909500000000	29	095	Jackson County, MO	1999	NA	362708	350108	12600	3.5
CN2909700000000	29	097	Jasper County, MO	1999	NA	55644	54060	1584	2.8
CN2909900000000	29	099	Jefferson County, MO	1999	NA	104191	100915	3276	3.1
CN2910100000000	29	101	Johnson County, MO	1999	NA	23241	22743	498	2.1
CN2910300000000	29	103	Knox County, MO	1999	NA	2014	1962	52	2.6
CN2910500000000	29	105	Laclede County, MO	1999	NA	16198	15512	686	4.2
CN2910700000000	29	107	Lafayette County, MO	1999	NA	16588	16012	576	3.5
CN2910900000000	29	109	Lawrence County, MO	1999	NA	16066	15520	546	3.4
CN2911100000000	29	111	Lewis County, MO	1999	NA	5664	5489	175	3.1
CN2911300000000	29	113	Lincoln County, MO	1999	NA	18682	18098	584	3.1
CN2911500000000	29	115	Linn County, MO	1999	NA	6525	6152	373	5.7
CN2911700000000	29	117	Livingston County, MO	1999	NA	7355	7173	182	2.5
CN2911900000000	29	119	McDonald County, MO	1999	NA	8538	8219	319	3.7
CN2912100000000	29	121	Macon County, MO	1999	NA	7626	7324	302	4
CN2912300000000	29	123	Madison County, MO	1999	NA	4393	4143	250	5.7
CN2912500000000	29	125	Maries County, MO	1999	NA	4495	4359	136	3
CN2912700000000	29	127	Marion County, MO	1999	NA	15808	15241	567	3.6
CN2912900000000	29	129	Mercer County, MO	1999	NA	1637	1589	48	2.9
CN2913100000000	29	131	Miller County, MO	1999	NA	11698	11147	551	4.7
CN2913300000000	29	133	Mississippi County, MO	1999	NA	6010	5698	312	5.2
CN2913500000000	29	135	Moniteau County, MO	1999	NA	7437	7247	190	2.6
CN2913700000000	29	137	Monroe County, MO	1999	NA	4555	4361	194	4.3
CN2913900000000	29	139	Montgomery County, MO	1999	NA	5750	5503	247	4.3
CN2914100000000	29	141	Morgan County, MO	1999	NA	8540	8196	344	4
CN2914300000000	29	143	New Madrid County, MO	1999	NA	8676	8221	455	5.2
CN2914500000000	29	145	Newton County, MO	1999	NA	28061	27074	987	3.5
CN2914700000000	29	147	Nodaway County, MO	1999	NA	12974	12816	158	1.2
CN2914900000000	29	149	Oregon County, MO	1999	NA	4476	4294	182	4.1
CN2915100000000	29	151	Osage County, MO	1999	NA	7554	7226	328	4.3
CN2915300000000	29	153	Ozark County, MO	1999	NA	4112	3926	186	4.5
CN2915500000000	29	155	Pemiscot County, MO	1999	NA	8447	7878	569	6.7
CN2915700000000	29	157	Perry County, MO	1999	NA	11052	10816	236	2.1
CN2915900000000	29	159	Pettis County, MO	1999	NA	21924	21080	844	3.8
CN2916100000000	29	161	Phelps County, MO	1999	NA	20255	19741	514	2.5
CN2916300000000	29	163	Pike County, MO	1999	NA	8159	7847	312	3.8
CN2916500000000	29	165	Platte County, MO	1999	NA	44294	43446	848	1.9
CN2916700000000	29	167	Polk County, MO	1999	NA	12459	12072	387	3.1
CN2916900000000	29	169	Pulaski County, MO	1999	NA	12375	11620	755	6.1
CN2917100000000	29	171	Putnam County, MO	1999	NA	1981	1916	65	3.3
CN2917300000000	29	173	Ralls County, MO	1999	NA	5534	5333	201	3.6
CN2917500000000	29	175	Randolph County, MO	1999	NA	11108	10675	433	3.9
CN2917700000000	29	177	Ray County, MO	1999	NA	11515	11056	459	4
CN2917900000000	29	179	Reynolds County, MO	1999	NA	3230	3087	143	4.4
CN2918100000000	29	181	Ripley County, MO	1999	NA	5464	5228	236	4.3
CN2918300000000	29	183	St. Charles County, MO	1999	NA	160352	157056	3296	2.1
CN2918500000000	29	185	St. Clair County, MO	1999	NA	3900	3740	160	4.1
CN2918600000000	29	186	Ste. Genevieve County, MO	1999	NA	8950	8654	296	3.3
CN2918700000000	29	187	St. Francois County, MO	1999	NA	24857	23433	1424	5.7
CN2918900000000	29	189	St. Louis County, MO	1999	NA	554505	539455	15050	2.7
CN2919500000000	29	195	Saline County, MO	1999	NA	12096	11784	312	2.6
CN2919700000000	29	197	Schuyler County, MO	1999	NA	2420	2339	81	3.3
CN2919900000000	29	199	Scotland County, MO	1999	NA	2222	2159	63	2.8
CN2920100000000	29	201	Scott County, MO	1999	NA	20628	19798	830	4
CN2920300000000	29	203	Shannon County, MO	1999	NA	4042	3835	207	5.1
CN2920500000000	29	205	Shelby County, MO	1999	NA	3493	3298	195	5.6
CN2920700000000	29	207	Stoddard County, MO	1999	NA	13365	12734	631	4.7
CN2920900000000	29	209	Stone County, MO	1999	NA	13923	12844	1079	7.7
CN2921100000000	29	211	Sullivan County, MO	1999	NA	4053	3974	79	1.9
CN2921300000000	29	213	Taney County, MO	1999	NA	29970	28134	1836	6.1
CN2921500000000	29	215	Texas County, MO	1999	NA	9139	8362	777	8.5
CN2921700000000	29	217	Vernon County, MO	1999	NA	9101	8844	257	2.8
CN2921900000000	29	219	Warren County, MO	1999	NA	12796	12373	423	3.3
CN2922100000000	29	221	Washington County, MO	1999	NA	9707	9018	689	7.1
CN2922300000000	29	223	Wayne County, MO	1999	NA	3482	3217	265	7.6
CN2922500000000	29	225	Webster County, MO	1999	NA	14521	14116	405	2.8
CN2922700000000	29	227	Worth County, MO	1999	NA	854	823	31	3.6
CN2922900000000	29	229	Wright County, MO	1999	NA	7278	6905	373	5.1
CN2951000000000	29	510	St. Louis city, MO	1999	NA	154052	144072	9980	6.5
CN3000100000000	30	001	Beaverhead County, MT	1999	NA	5078	4833	245	4.8
CN3000300000000	30	003	Big Horn County, MT	1999	NA	5343	4822	521	9.8
CN3000500000000	30	005	Blaine County, MT	1999	NA	2934	2687	247	8.4
CN3000700000000	30	007	Broadwater County, MT	1999	NA	2106	1983	123	5.8
CN3000900000000	30	009	Carbon County, MT	1999	NA	4787	4527	260	5.4
CN3001100000000	30	011	Carter County, MT	1999	NA	1064	1038	26	2.4
CN3001300000000	30	013	Cascade County, MT	1999	NA	36785	34786	1999	5.4
CN3001500000000	30	015	Chouteau County, MT	1999	NA	2889	2798	91	3.1
CN3001700000000	30	017	Custer County, MT	1999	NA	5986	5719	267	4.5
CN3001900000000	30	019	Daniels County, MT	1999	NA	1297	1256	41	3.2
CN3002100000000	30	021	Dawson County, MT	1999	NA	4991	4787	204	4.1
CN3002300000000	30	023	Deer Lodge County, MT	1999	NA	3879	3570	309	8
CN3002500000000	30	025	Fallon County, MT	1999	NA	1705	1610	95	5.6
CN3002700000000	30	027	Fergus County, MT	1999	NA	6318	5982	336	5.3
CN3002900000000	30	029	Flathead County, MT	1999	NA	37340	34690	2650	7.1
CN3003100000000	30	031	Gallatin County, MT	1999	NA	41816	40626	1190	2.8
CN3003300000000	30	033	Garfield County, MT	1999	NA	1055	1022	33	3.1
CN3003500000000	30	035	Glacier County, MT	1999	NA	5409	4628	781	14.4
CN3003700000000	30	037	Golden Valley County, MT	1999	NA	570	538	32	5.6
CN3003900000000	30	039	Granite County, MT	1999	NA	1214	1122	92	7.6
CN3004100000000	30	041	Hill County, MT	1999	NA	8866	8344	522	5.9
CN3004300000000	30	043	Jefferson County, MT	1999	NA	5044	4816	228	4.5
CN3004500000000	30	045	Judith Basin County, MT	1999	NA	1212	1158	54	4.5
CN3004700000000	30	047	Lake County, MT	1999	NA	12207	11435	772	6.3
CN3004900000000	30	049	Lewis and Clark County, MT	1999	NA	27548	26289	1259	4.6
CN3005100000000	30	051	Liberty County, MT	1999	NA	1211	1158	53	4.4
CN3005300000000	30	053	Lincoln County, MT	1999	NA	6971	6101	870	12.5
CN3005500000000	30	055	McCone County, MT	1999	NA	1288	1240	48	3.7
CN3005700000000	30	057	Madison County, MT	1999	NA	3938	3758	180	4.6
CN3005900000000	30	059	Meagher County, MT	1999	NA	1062	995	67	6.3
CN3006100000000	30	061	Mineral County, MT	1999	NA	1648	1489	159	9.6
CN3006300000000	30	063	Missoula County, MT	1999	NA	52781	50851	1930	3.7
CN3006500000000	30	065	Musselshell County, MT	1999	NA	1815	1664	151	8.3
CN3006700000000	30	067	Park County, MT	1999	NA	10199	9629	570	5.6
CN3006900000000	30	069	Petroleum County, MT	1999	NA	366	344	22	6
CN3007100000000	30	071	Phillips County, MT	1999	NA	2403	2212	191	7.9
CN3007300000000	30	073	Pondera County, MT	1999	NA	3403	3240	163	4.8
CN3007500000000	30	075	Powder River County, MT	1999	NA	1290	1242	48	3.7
CN3007700000000	30	077	Powell County, MT	1999	NA	2505	2378	127	5.1
CN3007900000000	30	079	Prairie County, MT	1999	NA	676	648	28	4.1
CN3008100000000	30	081	Ravalli County, MT	1999	NA	17370	16311	1059	6.1
CN3008300000000	30	083	Richland County, MT	1999	NA	5637	5243	394	7
CN3008500000000	30	085	Roosevelt County, MT	1999	NA	4291	3865	426	9.9
CN3008700000000	30	087	Rosebud County, MT	1999	NA	4506	4160	346	7.7
CN3008900000000	30	089	Sanders County, MT	1999	NA	4237	3843	394	9.3
CN3009100000000	30	091	Sheridan County, MT	1999	NA	2152	2031	121	5.6
CN3009300000000	30	093	Silver Bow County, MT	1999	NA	17318	16345	973	5.6
CN3009500000000	30	095	Stillwater County, MT	1999	NA	4668	4473	195	4.2
CN3009700000000	30	097	Sweet Grass County, MT	1999	NA	1785	1724	61	3.4
CN3009900000000	30	099	Teton County, MT	1999	NA	3445	3321	124	3.6
CN3010100000000	30	101	Toole County, MT	1999	NA	2940	2827	113	3.8
CN3010300000000	30	103	Treasure County, MT	1999	NA	501	480	21	4.2
CN3010500000000	30	105	Valley County, MT	1999	NA	4278	4078	200	4.7
CN3010700000000	30	107	Wheatland County, MT	1999	NA	1258	1182	76	6
CN3010900000000	30	109	Wibaux County, MT	1999	NA	584	560	24	4.1
CN3011100000000	30	111	Yellowstone County, MT	1999	NA	70405	67538	2867	4.1
CN3100100000000	31	001	Adams County, NE	1999	NA	16078	15728	350	2.2
CN3100300000000	31	003	Antelope County, NE	1999	NA	3165	3054	111	3.5
CN3100500000000	31	005	Arthur County, NE	1999	NA	201	197	4	2
CN3100700000000	31	007	Banner County, NE	1999	NA	432	421	11	2.5
CN3100900000000	31	009	Blaine County, NE	1999	NA	392	383	9	2.3
CN3101100000000	31	011	Boone County, NE	1999	NA	3006	2926	80	2.7
CN3101300000000	31	013	Box Butte County, NE	1999	NA	6621	6306	315	4.8
CN3101500000000	31	015	Boyd County, NE	1999	NA	1152	1112	40	3.5
CN3101700000000	31	017	Brown County, NE	1999	NA	1807	1735	72	4
CN3101900000000	31	019	Buffalo County, NE	1999	NA	25257	24466	791	3.1
CN3102100000000	31	021	Burt County, NE	1999	NA	3566	3408	158	4.4
CN3102300000000	31	023	Butler County, NE	1999	NA	4324	4200	124	2.9
CN3102500000000	31	025	Cass County, NE	1999	NA	13211	12892	319	2.4
CN3102700000000	31	027	Cedar County, NE	1999	NA	4737	4609	128	2.7
CN3102900000000	31	029	Chase County, NE	1999	NA	1982	1941	41	2.1
CN3103100000000	31	031	Cherry County, NE	1999	NA	3485	3408	77	2.2
CN3103300000000	31	033	Cheyenne County, NE	1999	NA	5462	5324	138	2.5
CN3103500000000	31	035	Clay County, NE	1999	NA	3556	3472	84	2.4
CN3103700000000	31	037	Colfax County, NE	1999	NA	4954	4834	120	2.4
CN3103900000000	31	039	Cuming County, NE	1999	NA	5447	5333	114	2.1
CN3104100000000	31	041	Custer County, NE	1999	NA	5588	5463	125	2.2
CN3104300000000	31	043	Dakota County, NE	1999	NA	10483	10186	297	2.8
CN3104500000000	31	045	Dawes County, NE	1999	NA	4740	4549	191	4
CN3104700000000	31	047	Dawson County, NE	1999	NA	13419	13023	396	3
CN3104900000000	31	049	Deuel County, NE	1999	NA	906	874	32	3.5
CN3105100000000	31	051	Dixon County, NE	1999	NA	2513	2443	70	2.8
CN3105300000000	31	053	Dodge County, NE	1999	NA	19712	19145	567	2.9
CN3105500000000	31	055	Douglas County, NE	1999	NA	261663	254438	7225	2.8
CN3105700000000	31	057	Dundy County, NE	1999	NA	1103	1081	22	2
CN3105900000000	31	059	Fillmore County, NE	1999	NA	3217	3140	77	2.4
CN3106100000000	31	061	Franklin County, NE	1999	NA	1652	1609	43	2.6
CN3106300000000	31	063	Frontier County, NE	1999	NA	1549	1506	43	2.8
CN3106500000000	31	065	Furnas County, NE	1999	NA	2546	2477	69	2.7
CN3106700000000	31	067	Gage County, NE	1999	NA	12581	12214	367	2.9
CN3106900000000	31	069	Garden County, NE	1999	NA	1122	1095	27	2.4
CN3107100000000	31	071	Garfield County, NE	1999	NA	1013	992	21	2.1
CN3107300000000	31	073	Gosper County, NE	1999	NA	1341	1318	23	1.7
CN3107500000000	31	075	Grant County, NE	1999	NA	359	351	8	2.2
CN3107700000000	31	077	Greeley County, NE	1999	NA	1426	1374	52	3.6
CN3107900000000	31	079	Hall County, NE	1999	NA	31605	30565	1040	3.3
CN3108100000000	31	081	Hamilton County, NE	1999	NA	5539	5422	117	2.1
CN3108300000000	31	083	Harlan County, NE	1999	NA	1767	1715	52	2.9
CN3108500000000	31	085	Hayes County, NE	1999	NA	480	462	18	3.8
CN3108700000000	31	087	Hitchcock County, NE	1999	NA	1612	1574	38	2.4
CN3108900000000	31	089	Holt County, NE	1999	NA	6829	6631	198	2.9
CN3109100000000	31	091	Hooker County, NE	1999	NA	436	425	11	2.5
CN3109300000000	31	093	Howard County, NE	1999	NA	3586	3469	117	3.3
CN3109500000000	31	095	Jefferson County, NE	1999	NA	4119	3997	122	3
CN3109700000000	31	097	Johnson County, NE	1999	NA	2237	2148	89	4
CN3109900000000	31	099	Kearney County, NE	1999	NA	3828	3743	85	2.2
CN3110100000000	31	101	Keith County, NE	1999	NA	4666	4533	133	2.9
CN3110300000000	31	103	Keya Paha County, NE	1999	NA	483	470	13	2.7
CN3110500000000	31	105	Kimball County, NE	1999	NA	1983	1946	37	1.9
CN3110700000000	31	107	Knox County, NE	1999	NA	4876	4707	169	3.5
CN3110900000000	31	109	Lancaster County, NE	1999	NA	146554	143138	3416	2.3
CN3111100000000	31	111	Lincoln County, NE	1999	NA	17675	17102	573	3.2
CN3111300000000	31	113	Logan County, NE	1999	NA	448	439	9	2
CN3111500000000	31	115	Loup County, NE	1999	NA	408	399	9	2.2
CN3111700000000	31	117	McPherson County, NE	1999	NA	302	299	3	1
CN3111900000000	31	119	Madison County, NE	1999	NA	20208	19359	849	4.2
CN3112100000000	31	121	Merrick County, NE	1999	NA	4645	4537	108	2.3
CN3112300000000	31	123	Morrill County, NE	1999	NA	2783	2674	109	3.9
CN3112500000000	31	125	Nance County, NE	1999	NA	1729	1673	56	3.2
CN3112700000000	31	127	Nemaha County, NE	1999	NA	4004	3828	176	4.4
CN3112900000000	31	129	Nuckolls County, NE	1999	NA	2304	2255	49	2.1
CN3113100000000	31	131	Otoe County, NE	1999	NA	7824	7586	238	3
CN3113300000000	31	133	Pawnee County, NE	1999	NA	1648	1600	48	2.9
CN3113500000000	31	135	Perkins County, NE	1999	NA	1538	1498	40	2.6
CN3113700000000	31	137	Phelps County, NE	1999	NA	5084	4976	108	2.1
CN3113900000000	31	139	Pierce County, NE	1999	NA	4100	3978	122	3
CN3114100000000	31	141	Platte County, NE	1999	NA	17534	16938	596	3.4
CN3114300000000	31	143	Polk County, NE	1999	NA	2394	2346	48	2
CN3114500000000	31	145	Red Willow County, NE	1999	NA	6120	5955	165	2.7
CN3114700000000	31	147	Richardson County, NE	1999	NA	4455	4205	250	5.6
CN3114900000000	31	149	Rock County, NE	1999	NA	897	860	37	4.1
CN3115100000000	31	151	Saline County, NE	1999	NA	7184	7044	140	1.9
CN3115300000000	31	153	Sarpy County, NE	1999	NA	62659	61363	1296	2.1
CN3115500000000	31	155	Saunders County, NE	1999	NA	10282	9995	287	2.8
CN3115700000000	31	157	Scotts Bluff County, NE	1999	NA	18689	17905	784	4.2
CN3115900000000	31	159	Seward County, NE	1999	NA	9371	9124	247	2.6
CN3116100000000	31	161	Sheridan County, NE	1999	NA	2935	2847	88	3
CN3116300000000	31	163	Sherman County, NE	1999	NA	1487	1443	44	3
CN3116500000000	31	165	Sioux County, NE	1999	NA	774	759	15	1.9
CN3116700000000	31	167	Stanton County, NE	1999	NA	3333	3230	103	3.1
CN3116900000000	31	169	Thayer County, NE	1999	NA	3355	3284	71	2.1
CN3117100000000	31	171	Thomas County, NE	1999	NA	485	458	27	5.6
CN3117300000000	31	173	Thurston County, NE	1999	NA	2898	2582	316	10.9
CN3117500000000	31	175	Valley County, NE	1999	NA	2530	2467	63	2.5
CN3117700000000	31	177	Washington County, NE	1999	NA	11115	10884	231	2.1
CN3117900000000	31	179	Wayne County, NE	1999	NA	6483	6257	226	3.5
CN3118100000000	31	181	Webster County, NE	1999	NA	1806	1765	41	2.3
CN3118300000000	31	183	Wheeler County, NE	1999	NA	416	402	14	3.4
CN3118500000000	31	185	York County, NE	1999	NA	9295	9158	137	1.5
CN3200100000000	32	001	Churchill County, NV	1999	NA	9998	9216	782	7.8
CN3200300000000	32	003	Clark County, NV	1999	NA	704213	676433	27780	3.9
CN3200500000000	32	005	Douglas County, NV	1999	NA	19233	18400	833	4.3
CN3200700000000	32	007	Elko County, NV	1999	NA	21756	20723	1033	4.7
CN3200900000000	32	009	Esmeralda County, NV	1999	NA	656	591	65	9.9
CN3201100000000	32	011	Eureka County, NV	1999	NA	926	890	36	3.9
CN3201300000000	32	013	Humboldt County, NV	1999	NA	8399	7907	492	5.9
CN3201500000000	32	015	Lander County, NV	1999	NA	2733	2501	232	8.5
CN3201700000000	32	017	Lincoln County, NV	1999	NA	1109	1048	61	5.5
CN3201900000000	32	019	Lyon County, NV	1999	NA	14216	13173	1043	7.3
CN3202100000000	32	021	Mineral County, NV	1999	NA	2134	1972	162	7.6
CN3202300000000	32	023	Nye County, NV	1999	NA	16059	15336	723	4.5
CN3202700000000	32	027	Pershing County, NV	1999	NA	2361	2280	81	3.4
CN3202900000000	32	029	Storey County, NV	1999	NA	1656	1598	58	3.5
CN3203100000000	32	031	Washoe County, NV	1999	NA	187139	180870	6269	3.3
CN3203300000000	32	033	White Pine County, NV	1999	NA	3451	3333	118	3.4
CN3251000000000	32	510	Carson City, NV	1999	NA	24261	23377	884	3.6
CN3300100000000	33	001	Belknap County, NH	1999	NA	30010	29292	718	2.4
CN3300300000000	33	003	Carroll County, NH	1999	NA	21369	20830	539	2.5
CN3300500000000	33	005	Cheshire County, NH	1999	NA	38750	37703	1047	2.7
CN3300700000000	33	007	Coos County, NH	1999	NA	16702	16016	686	4.1
CN3300900000000	33	009	Grafton County, NH	1999	NA	43981	43154	827	1.9
CN3301100000000	33	011	Hillsborough County, NH	1999	NA	206157	200553	5604	2.7
CN3301300000000	33	013	Merrimack County, NH	1999	NA	74827	73250	1577	2.1
CN3301500000000	33	015	Rockingham County, NH	1999	NA	164247	159002	5245	3.2
CN3301700000000	33	017	Strafford County, NH	1999	NA	57718	56326	1392	2.4
CN3301900000000	33	019	Sullivan County, NH	1999	NA	21423	20836	587	2.7
CN3400100000000	34	001	Atlantic County, NJ	1999	NA	130365	121146	9219	7.1
CN3400300000000	34	003	Bergen County, NJ	1999	NA	449535	433162	16373	3.6
CN3400500000000	34	005	Burlington County, NJ	1999	NA	229243	221719	7524	3.3
CN3400700000000	34	007	Camden County, NJ	1999	NA	261478	249481	11997	4.6
CN3400900000000	34	009	Cape May County, NJ	1999	NA	46441	41845	4596	9.9
CN3401100000000	34	011	Cumberland County, NJ	1999	NA	66273	60764	5509	8.3
CN3401300000000	34	013	Essex County, NJ	1999	NA	375247	354206	21041	5.6
CN3401500000000	34	015	Gloucester County, NJ	1999	NA	133815	127931	5884	4.4
CN3401700000000	34	017	Hudson County, NJ	1999	NA	287896	267345	20551	7.1
CN3401900000000	34	019	Hunterdon County, NJ	1999	NA	71693	70236	1457	2
CN3402100000000	34	021	Mercer County, NJ	1999	NA	175052	168345	6707	3.8
CN3402300000000	34	023	Middlesex County, NJ	1999	NA	415823	400604	15219	3.7
CN3402500000000	34	025	Monmouth County, NJ	1999	NA	314500	302209	12291	3.9
CN3402700000000	34	027	Morris County, NJ	1999	NA	268534	261196	7338	2.7
CN3402900000000	34	029	Ocean County, NJ	1999	NA	216762	207014	9748	4.5
CN3403100000000	34	031	Passaic County, NJ	1999	NA	236746	222090	14656	6.2
CN3403300000000	34	033	Salem County, NJ	1999	NA	32225	30723	1502	4.7
CN3403500000000	34	035	Somerset County, NJ	1999	NA	174651	170525	4126	2.4
CN3403700000000	34	037	Sussex County, NJ	1999	NA	78177	75539	2638	3.4
CN3403900000000	34	039	Union County, NJ	1999	NA	270481	257674	12807	4.7
CN3404100000000	34	041	Warren County, NJ	1999	NA	52950	50807	2143	4
CN3500100000000	35	001	Bernalillo County, NM	1999	NA	290762	279703	11059	3.8
CN3500300000000	35	003	Catron County, NM	1999	NA	1148	1037	111	9.7
CN3500500000000	35	005	Chaves County, NM	1999	NA	25793	23672	2121	8.2
CN3500600000000	35	006	Cibola County, NM	1999	NA	11138	10264	874	7.8
CN3500700000000	35	007	Colfax County, NM	1999	NA	6790	6420	370	5.4
CN3500900000000	35	009	Curry County, NM	1999	NA	19743	18931	812	4.1
CN3501100000000	35	011	De Baca County, NM	1999	NA	1025	982	43	4.2
CN3501300000000	35	013	Dona Ana County, NM	1999	NA	70860	65269	5591	7.9
CN3501500000000	35	015	Eddy County, NM	1999	NA	23988	22069	1919	8
CN3501700000000	35	017	Grant County, NM	1999	NA	12830	11740	1090	8.5
CN3501900000000	35	019	Guadalupe County, NM	1999	NA	1882	1730	152	8.1
CN3502100000000	35	021	Harding County, NM	1999	NA	427	413	14	3.3
CN3502300000000	35	023	Hidalgo County, NM	1999	NA	2501	2262	239	9.6
CN3502500000000	35	025	Lea County, NM	1999	NA	24462	22200	2262	9.2
CN3502700000000	35	027	Lincoln County, NM	1999	NA	7566	7256	310	4.1
CN3502800000000	35	028	Los Alamos County, NM	1999	NA	10385	10224	161	1.6
CN3502900000000	35	029	Luna County, NM	1999	NA	11307	8651	2656	23.5
CN3503100000000	35	031	McKinley County, NM	1999	NA	25295	23514	1781	7
CN3503300000000	35	033	Mora County, NM	1999	NA	1744	1452	292	16.7
CN3503500000000	35	035	Otero County, NM	1999	NA	20824	19813	1011	4.9
CN3503700000000	35	037	Quay County, NM	1999	NA	4594	4420	174	3.8
CN3503900000000	35	039	Rio Arriba County, NM	1999	NA	19776	18348	1428	7.2
CN3504100000000	35	041	Roosevelt County, NM	1999	NA	7614	7357	257	3.4
CN3504300000000	35	043	Sandoval County, NM	1999	NA	44415	42643	1772	4
CN3504500000000	35	045	San Juan County, NM	1999	NA	50052	46290	3762	7.5
CN3504700000000	35	047	San Miguel County, NM	1999	NA	12068	11234	834	6.9
CN3504900000000	35	049	Santa Fe County, NM	1999	NA	65115	63282	1833	2.8
CN3505100000000	35	051	Sierra County, NM	1999	NA	4144	4013	131	3.2
CN3505300000000	35	053	Socorro County, NM	1999	NA	6473	6135	338	5.2
CN3505500000000	35	055	Taos County, NM	1999	NA	13063	11563	1500	11.5
CN3505700000000	35	057	Torrance County, NM	1999	NA	6531	6218	313	4.8
CN3505900000000	35	059	Union County, NM	1999	NA	2033	1980	53	2.6
CN3506100000000	35	061	Valencia County, NM	1999	NA	29894	28596	1298	4.3
CN3600100000000	36	001	Albany County, NY	1999	NA	158761	154244	4517	2.8
CN3600300000000	36	003	Allegany County, NY	1999	NA	23485	21709	1776	7.6
CN3600500000000	36	005	Bronx County, NY	1999	NA	484477	444968	39509	8.2
CN3600700000000	36	007	Broome County, NY	1999	NA	99076	95018	4058	4.1
CN3600900000000	36	009	Cattaraugus County, NY	1999	NA	41635	38686	2949	7.1
CN3601100000000	36	011	Cayuga County, NY	1999	NA	38473	36510	1963	5.1
CN3601300000000	36	013	Chautauqua County, NY	1999	NA	67222	63808	3414	5.1
CN3601500000000	36	015	Chemung County, NY	1999	NA	45044	42895	2149	4.8
CN3601700000000	36	017	Chenango County, NY	1999	NA	24418	23002	1416	5.8
CN3601900000000	36	019	Clinton County, NY	1999	NA	40232	37634	2598	6.5
CN3602100000000	36	021	Columbia County, NY	1999	NA	34075	33031	1044	3.1
CN3602300000000	36	023	Cortland County, NY	1999	NA	22983	21414	1569	6.8
CN3602500000000	36	025	Delaware County, NY	1999	NA	21078	19990	1088	5.2
CN3602700000000	36	027	Dutchess County, NY	1999	NA	121547	117411	4136	3.4
CN3602900000000	36	029	Erie County, NY	1999	NA	467824	443807	24017	5.1
CN3603100000000	36	031	Essex County, NY	1999	NA	18480	16925	1555	8.4
CN3603300000000	36	033	Franklin County, NY	1999	NA	22293	20567	1726	7.7
CN3603500000000	36	035	Fulton County, NY	1999	NA	27047	25426	1621	6
CN3603700000000	36	037	Genesee County, NY	1999	NA	32305	30628	1677	5.2
CN3603900000000	36	039	Greene County, NY	1999	NA	21904	20731	1173	5.4
CN3604100000000	36	041	Hamilton County, NY	1999	NA	2608	2337	271	10.4
CN3604300000000	36	043	Herkimer County, NY	1999	NA	31408	29772	1636	5.2
CN3604500000000	36	045	Jefferson County, NY	1999	NA	44665	40586	4079	9.1
CN3604700000000	36	047	Kings County, NY	1999	NA	1009644	929991	79653	7.9
CN3604900000000	36	049	Lewis County, NY	1999	NA	12346	11255	1091	8.8
CN3605100000000	36	051	Livingston County, NY	1999	NA	35021	33298	1723	4.9
CN3605300000000	36	053	Madison County, NY	1999	NA	36095	34434	1661	4.6
CN3605500000000	36	055	Monroe County, NY	1999	NA	386820	371950	14870	3.8
CN3605700000000	36	057	Montgomery County, NY	1999	NA	23749	22251	1498	6.3
CN3605900000000	36	059	Nassau County, NY	1999	NA	700038	679355	20683	3
CN3606100000000	36	061	New York County, NY	1999	NA	865844	815414	50430	5.8
CN3606300000000	36	063	Niagara County, NY	1999	NA	110102	103393	6709	6.1
CN3606500000000	36	065	Oneida County, NY	1999	NA	113691	109134	4557	4
CN3606700000000	36	067	Onondaga County, NY	1999	NA	236047	227817	8230	3.5
CN3606900000000	36	069	Ontario County, NY	1999	NA	54476	52193	2283	4.2
CN3607100000000	36	071	Orange County, NY	1999	NA	160987	155110	5877	3.7
CN3607300000000	36	073	Orleans County, NY	1999	NA	21371	20250	1121	5.2
CN3607500000000	36	075	Oswego County, NY	1999	NA	57794	54161	3633	6.3
CN3607700000000	36	077	Otsego County, NY	1999	NA	32092	30432	1660	5.2
CN3607900000000	36	079	Putnam County, NY	1999	NA	55339	53758	1581	2.9
CN3608100000000	36	081	Queens County, NY	1999	NA	1039869	977017	62852	6
CN3608300000000	36	083	Rensselaer County, NY	1999	NA	80379	77241	3138	3.9
CN3608500000000	36	085	Richmond County, NY	1999	NA	208191	196207	11984	5.8
CN3608700000000	36	087	Rockland County, NY	1999	NA	148554	143483	5071	3.4
CN3608900000000	36	089	St. Lawrence County, NY	1999	NA	52070	47776	4294	8.2
CN3609100000000	36	091	Saratoga County, NY	1999	NA	106561	103063	3498	3.3
CN3609300000000	36	093	Schenectady County, NY	1999	NA	72855	70300	2555	3.5
CN3609500000000	36	095	Schoharie County, NY	1999	NA	15326	14524	802	5.2
CN3609700000000	36	097	Schuyler County, NY	1999	NA	9130	8606	524	5.7
CN3609900000000	36	099	Seneca County, NY	1999	NA	15952	15084	868	5.4
CN3610100000000	36	101	Steuben County, NY	1999	NA	48257	45527	2730	5.7
CN3610300000000	36	103	Suffolk County, NY	1999	NA	731693	705583	26110	3.6
CN3610500000000	36	105	Sullivan County, NY	1999	NA	31607	29766	1841	5.8
CN3610700000000	36	107	Tioga County, NY	1999	NA	26689	25690	999	3.7
CN3610900000000	36	109	Tompkins County, NY	1999	NA	52129	50685	1444	2.8
CN3611100000000	36	111	Ulster County, NY	1999	NA	83583	80624	2959	3.5
CN3611300000000	36	113	Warren County, NY	1999	NA	32103	30224	1879	5.9
CN3611500000000	36	115	Washington County, NY	1999	NA	28795	27486	1309	4.5
CN3611700000000	36	117	Wayne County, NY	1999	NA	50688	48177	2511	5
CN3611900000000	36	119	Westchester County, NY	1999	NA	455085	439711	15374	3.4
CN3612100000000	36	121	Wyoming County, NY	1999	NA	20880	19392	1488	7.1
CN3612300000000	36	123	Yates County, NY	1999	NA	13683	13128	555	4.1
CN3700100000000	37	001	Alamance County, NC	1999	NA	68353	66689	1664	2.4
CN3700300000000	37	003	Alexander County, NC	1999	NA	17796	17410	386	2.2
CN3700500000000	37	005	Alleghany County, NC	1999	NA	5952	5762	190	3.2
CN3700700000000	37	007	Anson County, NC	1999	NA	10738	9985	753	7
CN3700900000000	37	009	Ashe County, NC	1999	NA	11797	11027	770	6.5
CN3701100000000	37	011	Avery County, NC	1999	NA	8148	7876	272	3.3
CN3701300000000	37	013	Beaufort County, NC	1999	NA	20672	19108	1564	7.6
CN3701500000000	37	015	Bertie County, NC	1999	NA	8878	8379	499	5.6
CN3701700000000	37	017	Bladen County, NC	1999	NA	20481	19450	1031	5
CN3701900000000	37	019	Brunswick County, NC	1999	NA	35001	33547	1454	4.2
CN3702100000000	37	021	Buncombe County, NC	1999	NA	105178	102809	2369	2.3
CN3702300000000	37	023	Burke County, NC	1999	NA	44007	42904	1103	2.5
CN3702500000000	37	025	Cabarrus County, NC	1999	NA	69469	68083	1386	2
CN3702700000000	37	027	Caldwell County, NC	1999	NA	41378	40616	762	1.8
CN3702900000000	37	029	Camden County, NC	1999	NA	3310	3226	84	2.5
CN3703100000000	37	031	Carteret County, NC	1999	NA	30203	29006	1197	4
CN3703300000000	37	033	Caswell County, NC	1999	NA	13457	13166	291	2.2
CN3703500000000	37	035	Catawba County, NC	1999	NA	76787	75278	1509	2
CN3703700000000	37	037	Chatham County, NC	1999	NA	27412	26938	474	1.7
CN3703900000000	37	039	Cherokee County, NC	1999	NA	11984	11154	830	6.9
CN3704100000000	37	041	Chowan County, NC	1999	NA	6746	6540	206	3.1
CN3704300000000	37	043	Clay County, NC	1999	NA	4331	4200	131	3
CN3704500000000	37	045	Cleveland County, NC	1999	NA	45281	42952	2329	5.1
CN3704700000000	37	047	Columbus County, NC	1999	NA	23237	21160	2077	8.9
CN3704900000000	37	049	Craven County, NC	1999	NA	38121	36526	1595	4.2
CN3705100000000	37	051	Cumberland County, NC	1999	NA	123115	118412	4703	3.8
CN3705300000000	37	053	Currituck County, NC	1999	NA	9340	9124	216	2.3
CN3705500000000	37	055	Dare County, NC	1999	NA	18585	17699	886	4.8
CN3705700000000	37	057	Davidson County, NC	1999	NA	81754	79857	1897	2.3
CN3705900000000	37	059	Davie County, NC	1999	NA	18247	17780	467	2.6
CN3706100000000	37	061	Duplin County, NC	1999	NA	22981	21551	1430	6.2
CN3706300000000	37	063	Durham County, NC	1999	NA	119112	116660	2452	2.1
CN3706500000000	37	065	Edgecombe County, NC	1999	NA	25226	23129	2097	8.3
CN3706700000000	37	067	Forsyth County, NC	1999	NA	157066	153412	3654	2.3
CN3706900000000	37	069	Franklin County, NC	1999	NA	24195	23576	619	2.6
CN3707100000000	37	071	Gaston County, NC	1999	NA	102039	98329	3710	3.6
CN3707300000000	37	073	Gates County, NC	1999	NA	4818	4685	133	2.8
CN3707500000000	37	075	Graham County, NC	1999	NA	3878	3553	325	8.4
CN3707700000000	37	077	Granville County, NC	1999	NA	23566	22843	723	3.1
CN3707900000000	37	079	Greene County, NC	1999	NA	9418	8976	442	4.7
CN3708100000000	37	081	Guilford County, NC	1999	NA	225431	219949	5482	2.4
CN3708300000000	37	083	Halifax County, NC	1999	NA	23114	21443	1671	7.2
CN3708500000000	37	085	Harnett County, NC	1999	NA	36945	35689	1256	3.4
CN3708700000000	37	087	Haywood County, NC	1999	NA	24807	23818	989	4
CN3708900000000	37	089	Henderson County, NC	1999	NA	39096	38180	916	2.3
CN3709100000000	37	091	Hertford County, NC	1999	NA	10763	10339	424	3.9
CN3709300000000	37	093	Hoke County, NC	1999	NA	12322	11473	849	6.9
CN3709500000000	37	095	Hyde County, NC	1999	NA	3199	2997	202	6.3
CN3709700000000	37	097	Iredell County, NC	1999	NA	65230	63714	1516	2.3
CN3709900000000	37	099	Jackson County, NC	1999	NA	16610	15973	637	3.8
CN3710100000000	37	101	Johnston County, NC	1999	NA	62204	61005	1199	1.9
CN3710300000000	37	103	Jones County, NC	1999	NA	4588	4334	254	5.5
CN3710500000000	37	105	Lee County, NC	1999	NA	27152	26260	892	3.3
CN3710700000000	37	107	Lenoir County, NC	1999	NA	30679	28714	1965	6.4
CN3710900000000	37	109	Lincoln County, NC	1999	NA	32812	31871	941	2.9
CN3711100000000	37	111	McDowell County, NC	1999	NA	20726	19880	846	4.1
CN3711300000000	37	113	Macon County, NC	1999	NA	14305	13781	524	3.7
CN3711500000000	37	115	Madison County, NC	1999	NA	9304	9046	258	2.8
CN3711700000000	37	117	Martin County, NC	1999	NA	11644	10667	977	8.4
CN3711900000000	37	119	Mecklenburg County, NC	1999	NA	378981	371241	7740	2
CN3712100000000	37	121	Mitchell County, NC	1999	NA	7365	6887	478	6.5
CN3712300000000	37	123	Montgomery County, NC	1999	NA	12303	11790	513	4.2
CN3712500000000	37	125	Moore County, NC	1999	NA	30948	29879	1069	3.5
CN3712700000000	37	127	Nash County, NC	1999	NA	44669	42344	2325	5.2
CN3712900000000	37	129	New Hanover County, NC	1999	NA	83834	81273	2561	3.1
CN3713100000000	37	131	Northampton County, NC	1999	NA	8561	8001	560	6.5
CN3713300000000	37	133	Onslow County, NC	1999	NA	50276	48512	1764	3.5
CN3713500000000	37	135	Orange County, NC	1999	NA	65505	64759	746	1.1
CN3713700000000	37	137	Pamlico County, NC	1999	NA	5659	5444	215	3.8
CN3713900000000	37	139	Pasquotank County, NC	1999	NA	15632	15073	559	3.6
CN3714100000000	37	141	Pender County, NC	1999	NA	17418	16591	827	4.7
CN3714300000000	37	143	Perquimans County, NC	1999	NA	4908	4766	142	2.9
CN3714500000000	37	145	Person County, NC	1999	NA	17723	16972	751	4.2
CN3714700000000	37	147	Pitt County, NC	1999	NA	70161	67061	3100	4.4
CN3714900000000	37	149	Polk County, NC	1999	NA	8288	8030	258	3.1
CN3715100000000	37	151	Randolph County, NC	1999	NA	73324	71364	1960	2.7
CN3715300000000	37	153	Richmond County, NC	1999	NA	19663	18402	1261	6.4
CN3715500000000	37	155	Robeson County, NC	1999	NA	55452	50972	4480	8.1
CN3715700000000	37	157	Rockingham County, NC	1999	NA	46348	44107	2241	4.8
CN3715900000000	37	159	Rowan County, NC	1999	NA	67260	65231	2029	3
CN3716100000000	37	161	Rutherford County, NC	1999	NA	29837	27703	2134	7.2
CN3716300000000	37	163	Sampson County, NC	1999	NA	24246	23116	1130	4.7
CN3716500000000	37	165	Scotland County, NC	1999	NA	17970	16835	1135	6.3
CN3716700000000	37	167	Stanly County, NC	1999	NA	27971	26974	997	3.6
CN3716900000000	37	169	Stokes County, NC	1999	NA	23840	23295	545	2.3
CN3717100000000	37	171	Surry County, NC	1999	NA	35568	34266	1302	3.7
CN3717300000000	37	173	Swain County, NC	1999	NA	6180	5503	677	11
CN3717500000000	37	175	Transylvania County, NC	1999	NA	11633	11420	213	1.8
CN3717700000000	37	177	Tyrrell County, NC	1999	NA	1901	1743	158	8.3
CN3717900000000	37	179	Union County, NC	1999	NA	63467	62206	1261	2
CN3718100000000	37	181	Vance County, NC	1999	NA	20146	18733	1413	7
CN3718300000000	37	183	Wake County, NC	1999	NA	361379	356380	4999	1.4
CN3718500000000	37	185	Warren County, NC	1999	NA	7430	6969	461	6.2
CN3718700000000	37	187	Washington County, NC	1999	NA	6346	5966	380	6
CN3718900000000	37	189	Watauga County, NC	1999	NA	23982	23643	339	1.4
CN3719100000000	37	191	Wayne County, NC	1999	NA	50504	48436	2068	4.1
CN3719300000000	37	193	Wilkes County, NC	1999	NA	33831	32956	875	2.6
CN3719500000000	37	195	Wilson County, NC	1999	NA	37901	35043	2858	7.5
CN3719700000000	37	197	Yadkin County, NC	1999	NA	18820	18327	493	2.6
CN3719900000000	37	199	Yancey County, NC	1999	NA	6795	6461	334	4.9
CN3800100000000	38	001	Adams County, ND	1999	NA	1392	1354	38	2.7
CN3800300000000	38	003	Barnes County, ND	1999	NA	5718	5545	173	3
CN3800500000000	38	005	Benson County, ND	1999	NA	2804	2586	218	7.8
CN3800700000000	38	007	Billings County, ND	1999	NA	522	497	25	4.8
CN3800900000000	38	009	Bottineau County, ND	1999	NA	3364	3210	154	4.6
CN3801100000000	38	011	Bowman County, ND	1999	NA	1822	1780	42	2.3
CN3801300000000	38	013	Burke County, ND	1999	NA	1015	979	36	3.5
CN3801500000000	38	015	Burleigh County, ND	1999	NA	40236	39197	1039	2.6
CN3801700000000	38	017	Cass County, ND	1999	NA	73099	71853	1246	1.7
CN3801900000000	38	019	Cavalier County, ND	1999	NA	2510	2434	76	3
CN3802100000000	38	021	Dickey County, ND	1999	NA	2921	2874	47	1.6
CN3802300000000	38	023	Divide County, ND	1999	NA	1123	1093	30	2.7
CN3802500000000	38	025	Dunn County, ND	1999	NA	1955	1869	86	4.4
CN3802700000000	38	027	Eddy County, ND	1999	NA	1313	1241	72	5.5
CN3802900000000	38	029	Emmons County, ND	1999	NA	2048	1967	81	4
CN3803100000000	38	031	Foster County, ND	1999	NA	2325	2269	56	2.4
CN3803300000000	38	033	Golden Valley County, ND	1999	NA	922	886	36	3.9
CN3803500000000	38	035	Grand Forks County, ND	1999	NA	35788	34893	895	2.5
CN3803700000000	38	037	Grant County, ND	1999	NA	1554	1497	57	3.7
CN3803900000000	38	039	Griggs County, ND	1999	NA	1584	1550	34	2.1
CN3804100000000	38	041	Hettinger County, ND	1999	NA	1345	1296	49	3.6
CN3804300000000	38	043	Kidder County, ND	1999	NA	1463	1395	68	4.6
CN3804500000000	38	045	LaMoure County, ND	1999	NA	2279	2219	60	2.6
CN3804700000000	38	047	Logan County, ND	1999	NA	1137	1116	21	1.8
CN3804900000000	38	049	McHenry County, ND	1999	NA	2787	2645	142	5.1
CN3805100000000	38	051	McIntosh County, ND	1999	NA	1726	1687	39	2.3
CN3805300000000	38	053	McKenzie County, ND	1999	NA	3206	3074	132	4.1
CN3805500000000	38	055	McLean County, ND	1999	NA	4559	4254	305	6.7
CN3805700000000	38	057	Mercer County, ND	1999	NA	4659	4342	317	6.8
CN3805900000000	38	059	Morton County, ND	1999	NA	13723	13205	518	3.8
CN3806100000000	38	061	Mountrail County, ND	1999	NA	3090	2876	214	6.9
CN3806300000000	38	063	Nelson County, ND	1999	NA	1590	1519	71	4.5
CN3806500000000	38	065	Oliver County, ND	1999	NA	1052	997	55	5.2
CN3806700000000	38	067	Pembina County, ND	1999	NA	4978	4677	301	6
CN3806900000000	38	069	Pierce County, ND	1999	NA	2583	2501	82	3.2
CN3807100000000	38	071	Ramsey County, ND	1999	NA	6409	6200	209	3.3
CN3807300000000	38	073	Ransom County, ND	1999	NA	2753	2686	67	2.4
CN3807500000000	38	075	Renville County, ND	1999	NA	1368	1331	37	2.7
CN3807700000000	38	077	Richland County, ND	1999	NA	9517	9253	264	2.8
CN3807900000000	38	079	Rolette County, ND	1999	NA	5770	4997	773	13.4
CN3808100000000	38	081	Sargent County, ND	1999	NA	2568	2519	49	1.9
CN3808300000000	38	083	Sheridan County, ND	1999	NA	714	667	47	6.6
CN3808500000000	38	085	Sioux County, ND	1999	NA	1681	1562	119	7.1
CN3808700000000	38	087	Slope County, ND	1999	NA	414	391	23	5.6
CN3808900000000	38	089	Stark County, ND	1999	NA	12576	12057	519	4.1
CN3809100000000	38	091	Steele County, ND	1999	NA	1098	1085	13	1.2
CN3809300000000	38	093	Stutsman County, ND	1999	NA	11781	11472	309	2.6
CN3809500000000	38	095	Towner County, ND	1999	NA	1359	1325	34	2.5
CN3809700000000	38	097	Traill County, ND	1999	NA	3821	3699	122	3.2
CN3809900000000	38	099	Walsh County, ND	1999	NA	6360	6101	259	4.1
CN3810100000000	38	101	Ward County, ND	1999	NA	28980	28028	952	3.3
CN3810300000000	38	103	Wells County, ND	1999	NA	2586	2482	104	4
CN3810500000000	38	105	Williams County, ND	1999	NA	9506	8945	561	5.9
CN3900100000000	39	001	Adams County, OH	1999	NA	11741	10529	1212	10.3
CN3900300000000	39	003	Allen County, OH	1999	NA	51343	48690	2653	5.2
CN3900500000000	39	005	Ashland County, OH	1999	NA	25994	24820	1174	4.5
CN3900700000000	39	007	Ashtabula County, OH	1999	NA	47250	44258	2992	6.3
CN3900900000000	39	009	Athens County, OH	1999	NA	26649	25235	1414	5.3
CN3901100000000	39	011	Auglaize County, OH	1999	NA	24762	23704	1058	4.3
CN3901300000000	39	013	Belmont County, OH	1999	NA	32322	30378	1944	6
CN3901500000000	39	015	Brown County, OH	1999	NA	19967	18798	1169	5.9
CN3901700000000	39	017	Butler County, OH	1999	NA	185460	178974	6486	3.5
CN3901900000000	39	019	Carroll County, OH	1999	NA	13630	12836	794	5.8
CN3902100000000	39	021	Champaign County, OH	1999	NA	18755	17980	775	4.1
CN3902300000000	39	023	Clark County, OH	1999	NA	68195	64900	3295	4.8
CN3902500000000	39	025	Clermont County, OH	1999	NA	95145	91315	3830	4
CN3902700000000	39	027	Clinton County, OH	1999	NA	25200	24280	920	3.7
CN3902900000000	39	029	Columbiana County, OH	1999	NA	52660	49322	3338	6.3
CN3903100000000	39	031	Coshocton County, OH	1999	NA	17677	16516	1161	6.6
CN3903300000000	39	033	Crawford County, OH	1999	NA	21649	20316	1333	6.2
CN3903500000000	39	035	Cuyahoga County, OH	1999	NA	685224	664781	20443	3
CN3903700000000	39	037	Darke County, OH	1999	NA	29474	27890	1584	5.4
CN3903900000000	39	039	Defiance County, OH	1999	NA	21161	20188	973	4.6
CN3904100000000	39	041	Delaware County, OH	1999	NA	58033	56875	1158	2
CN3904300000000	39	043	Erie County, OH	1999	NA	41946	39961	1985	4.7
CN3904500000000	39	045	Fairfield County, OH	1999	NA	66579	64522	2057	3.1
CN3904700000000	39	047	Fayette County, OH	1999	NA	15654	15012	642	4.1
CN3904900000000	39	049	Franklin County, OH	1999	NA	591149	574854	16295	2.8
CN3905100000000	39	051	Fulton County, OH	1999	NA	23403	22378	1025	4.4
CN3905300000000	39	053	Gallia County, OH	1999	NA	15059	13726	1333	8.9
CN3905500000000	39	055	Geauga County, OH	1999	NA	48797	47803	994	2
CN3905700000000	39	057	Greene County, OH	1999	NA	72207	69592	2615	3.6
CN3905900000000	39	059	Guernsey County, OH	1999	NA	19044	17238	1806	9.5
CN3906100000000	39	061	Hamilton County, OH	1999	NA	431922	415010	16912	3.9
CN3906300000000	39	063	Hancock County, OH	1999	NA	41954	40672	1282	3.1
CN3906500000000	39	065	Hardin County, OH	1999	NA	15492	14896	596	3.8
CN3906700000000	39	067	Harrison County, OH	1999	NA	6807	6323	484	7.1
CN3906900000000	39	069	Henry County, OH	1999	NA	15884	14919	965	6.1
CN3907100000000	39	071	Highland County, OH	1999	NA	19232	18212	1020	5.3
CN3907300000000	39	073	Hocking County, OH	1999	NA	11974	11033	941	7.9
CN3907500000000	39	075	Holmes County, OH	1999	NA	18748	18137	611	3.3
CN3907700000000	39	077	Huron County, OH	1999	NA	30180	27762	2418	8
CN3907900000000	39	079	Jackson County, OH	1999	NA	14481	13366	1115	7.7
CN3908100000000	39	081	Jefferson County, OH	1999	NA	29821	27593	2228	7.5
CN3908300000000	39	083	Knox County, OH	1999	NA	26226	24823	1403	5.3
CN3908500000000	39	085	Lake County, OH	1999	NA	128489	125225	3264	2.5
CN3908700000000	39	087	Lawrence County, OH	1999	NA	26968	24868	2100	7.8
CN3908900000000	39	089	Licking County, OH	1999	NA	71666	68772	2894	4
CN3909100000000	39	091	Logan County, OH	1999	NA	28316	27436	880	3.1
CN3909300000000	39	093	Lorain County, OH	1999	NA	142834	138377	4457	3.1
CN3909500000000	39	095	Lucas County, OH	1999	NA	230043	216939	13104	5.7
CN3909700000000	39	097	Madison County, OH	1999	NA	20531	19959	572	2.8
CN3909900000000	39	099	Mahoning County, OH	1999	NA	116836	109763	7073	6.1
CN3910100000000	39	101	Marion County, OH	1999	NA	31381	30072	1309	4.2
CN3910300000000	39	103	Medina County, OH	1999	NA	80984	79093	1891	2.3
CN3910500000000	39	105	Meigs County, OH	1999	NA	8509	7453	1056	12.4
CN3910700000000	39	107	Mercer County, OH	1999	NA	19920	18203	1717	8.6
CN3910900000000	39	109	Miami County, OH	1999	NA	50534	48403	2131	4.2
CN3911100000000	39	111	Monroe County, OH	1999	NA	5901	5290	611	10.4
CN3911300000000	39	113	Montgomery County, OH	1999	NA	277890	266310	11580	4.2
CN3911500000000	39	115	Morgan County, OH	1999	NA	4752	4019	733	15.4
CN3911700000000	39	117	Morrow County, OH	1999	NA	14199	13391	808	5.7
CN3911900000000	39	119	Muskingum County, OH	1999	NA	43197	40066	3131	7.2
CN3912100000000	39	121	Noble County, OH	1999	NA	5598	5100	498	8.9
CN3912300000000	39	123	Ottawa County, OH	1999	NA	20912	19456	1456	7
CN3912500000000	39	125	Paulding County, OH	1999	NA	9926	9438	488	4.9
CN3912700000000	39	127	Perry County, OH	1999	NA	14495	13214	1281	8.8
CN3912900000000	39	129	Pickaway County, OH	1999	NA	24607	23732	875	3.6
CN3913100000000	39	131	Pike County, OH	1999	NA	11670	10592	1078	9.2
CN3913300000000	39	133	Portage County, OH	1999	NA	83001	79409	3592	4.3
CN3913500000000	39	135	Preble County, OH	1999	NA	21180	20239	941	4.4
CN3913700000000	39	137	Putnam County, OH	1999	NA	20573	19741	832	4
CN3913900000000	39	139	Richland County, OH	1999	NA	61832	57494	4338	7
CN3914100000000	39	141	Ross County, OH	1999	NA	34525	32603	1922	5.6
CN3914300000000	39	143	Sandusky County, OH	1999	NA	32031	30170	1861	5.8
CN3914500000000	39	145	Scioto County, OH	1999	NA	32992	29938	3054	9.3
CN3914700000000	39	147	Seneca County, OH	1999	NA	28468	26821	1647	5.8
CN3914900000000	39	149	Shelby County, OH	1999	NA	28130	26882	1248	4.4
CN3915100000000	39	151	Stark County, OH	1999	NA	187383	178233	9150	4.9
CN3915300000000	39	153	Summit County, OH	1999	NA	280593	267650	12943	4.6
CN3915500000000	39	155	Trumbull County, OH	1999	NA	112098	105665	6433	5.7
CN3915700000000	39	157	Tuscarawas County, OH	1999	NA	44228	41748	2480	5.6
CN3915900000000	39	159	Union County, OH	1999	NA	17878	17324	554	3.1
CN3916100000000	39	161	Van Wert County, OH	1999	NA	16648	15995	653	3.9
CN3916300000000	39	163	Vinton County, OH	1999	NA	3768	3292	476	12.6
CN3916500000000	39	165	Warren County, OH	1999	NA	80358	77827	2531	3.1
CN3916700000000	39	167	Washington County, OH	1999	NA	32339	30257	2082	6.4
CN3916900000000	39	169	Wayne County, OH	1999	NA	57204	54997	2207	3.9
CN3917100000000	39	171	Williams County, OH	1999	NA	21040	20004	1036	4.9
CN3917300000000	39	173	Wood County, OH	1999	NA	67416	64879	2537	3.8
CN3917500000000	39	175	Wyandot County, OH	1999	NA	12297	11685	612	5
CN4000100000000	40	001	Adair County, OK	1999	NA	8984	8488	496	5.5
CN4000300000000	40	003	Alfalfa County, OK	1999	NA	2533	2489	44	1.7
CN4000500000000	40	005	Atoka County, OK	1999	NA	4945	4770	175	3.5
CN4000700000000	40	007	Beaver County, OK	1999	NA	2668	2569	99	3.7
CN4000900000000	40	009	Beckham County, OK	1999	NA	9864	9393	471	4.8
CN4001100000000	40	011	Blaine County, OK	1999	NA	4598	4433	165	3.6
CN4001300000000	40	013	Bryan County, OK	1999	NA	16813	16396	417	2.5
CN4001500000000	40	015	Caddo County, OK	1999	NA	13054	12528	526	4
CN4001700000000	40	017	Canadian County, OK	1999	NA	46777	45859	918	2
CN4001900000000	40	019	Carter County, OK	1999	NA	20312	19279	1033	5.1
CN4002100000000	40	021	Cherokee County, OK	1999	NA	18510	17880	630	3.4
CN4002300000000	40	023	Choctaw County, OK	1999	NA	5527	5159	368	6.7
CN4002500000000	40	025	Cimarron County, OK	1999	NA	1757	1716	41	2.3
CN4002700000000	40	027	Cleveland County, OK	1999	NA	113365	110964	2401	2.1
CN4002900000000	40	029	Coal County, OK	1999	NA	2520	2357	163	6.5
CN4003100000000	40	031	Comanche County, OK	1999	NA	41590	40054	1536	3.7
CN4003300000000	40	033	Cotton County, OK	1999	NA	2194	2071	123	5.6
CN4003500000000	40	035	Craig County, OK	1999	NA	6709	6531	178	2.7
CN4003700000000	40	037	Creek County, OK	1999	NA	33698	32483	1215	3.6
CN4003900000000	40	039	Custer County, OK	1999	NA	12029	11626	403	3.4
CN4004100000000	40	041	Delaware County, OK	1999	NA	17615	16976	639	3.6
CN4004300000000	40	043	Dewey County, OK	1999	NA	1991	1912	79	4
CN4004500000000	40	045	Ellis County, OK	1999	NA	1650	1578	72	4.4
CN4004700000000	40	047	Garfield County, OK	1999	NA	27537	26688	849	3.1
CN4004900000000	40	049	Garvin County, OK	1999	NA	10976	10315	661	6
CN4005100000000	40	051	Grady County, OK	1999	NA	19427	18567	860	4.4
CN4005300000000	40	053	Grant County, OK	1999	NA	2240	2181	59	2.6
CN4005500000000	40	055	Greer County, OK	1999	NA	2498	2421	77	3.1
CN4005700000000	40	057	Harmon County, OK	1999	NA	1263	1220	43	3.4
CN4005900000000	40	059	Harper County, OK	1999	NA	1749	1693	56	3.2
CN4006100000000	40	061	Haskell County, OK	1999	NA	4916	4573	343	7
CN4006300000000	40	063	Hughes County, OK	1999	NA	5439	5015	424	7.8
CN4006500000000	40	065	Jackson County, OK	1999	NA	12846	12415	431	3.4
CN4006700000000	40	067	Jefferson County, OK	1999	NA	3145	3030	115	3.7
CN4006900000000	40	069	Johnston County, OK	1999	NA	4929	4728	201	4.1
CN4007100000000	40	071	Kay County, OK	1999	NA	22069	20602	1467	6.6
CN4007300000000	40	073	Kingfisher County, OK	1999	NA	6745	6562	183	2.7
CN4007500000000	40	075	Kiowa County, OK	1999	NA	4757	4593	164	3.4
CN4007700000000	40	077	Latimer County, OK	1999	NA	4638	4255	383	8.3
CN4007900000000	40	079	Le Flore County, OK	1999	NA	20078	18971	1107	5.5
CN4008100000000	40	081	Lincoln County, OK	1999	NA	14286	13688	598	4.2
CN4008300000000	40	083	Logan County, OK	1999	NA	14572	14206	366	2.5
CN4008500000000	40	085	Love County, OK	1999	NA	3800	3649	151	4
CN4008700000000	40	087	McClain County, OK	1999	NA	13389	13069	320	2.4
CN4008900000000	40	089	McCurtain County, OK	1999	NA	15523	14491	1032	6.6
CN4009100000000	40	091	McIntosh County, OK	1999	NA	8055	7548	507	6.3
CN4009300000000	40	093	Major County, OK	1999	NA	3933	3811	122	3.1
CN4009500000000	40	095	Marshall County, OK	1999	NA	5419	5193	226	4.2
CN4009700000000	40	097	Mayes County, OK	1999	NA	16072	15417	655	4.1
CN4009900000000	40	099	Murray County, OK	1999	NA	5441	5090	351	6.5
CN4010100000000	40	101	Muskogee County, OK	1999	NA	31951	30546	1405	4.4
CN4010300000000	40	103	Noble County, OK	1999	NA	5734	5592	142	2.5
CN4010500000000	40	105	Nowata County, OK	1999	NA	3754	3569	185	4.9
CN4010700000000	40	107	Okfuskee County, OK	1999	NA	3719	3502	217	5.8
CN4010900000000	40	109	Oklahoma County, OK	1999	NA	333712	324395	9317	2.8
CN4011100000000	40	111	Okmulgee County, OK	1999	NA	14374	13315	1059	7.4
CN4011300000000	40	113	Osage County, OK	1999	NA	20359	19609	750	3.7
CN4011500000000	40	115	Ottawa County, OK	1999	NA	13393	12728	665	5
CN4011700000000	40	117	Pawnee County, OK	1999	NA	6443	6105	338	5.2
CN4011900000000	40	119	Payne County, OK	1999	NA	37676	37195	481	1.3
CN4012100000000	40	121	Pittsburg County, OK	1999	NA	18066	16924	1142	6.3
CN4012300000000	40	123	Pontotoc County, OK	1999	NA	17254	16674	580	3.4
CN4012500000000	40	125	Pottawatomie County, OK	1999	NA	29012	27928	1084	3.7
CN4012700000000	40	127	Pushmataha County, OK	1999	NA	5005	4739	266	5.3
CN4012900000000	40	129	Roger Mills County, OK	1999	NA	1980	1912	68	3.4
CN4013100000000	40	131	Rogers County, OK	1999	NA	36860	35731	1129	3.1
CN4013300000000	40	133	Seminole County, OK	1999	NA	10063	9347	716	7.1
CN4013500000000	40	135	Sequoyah County, OK	1999	NA	17411	16525	886	5.1
CN4013700000000	40	137	Stephens County, OK	1999	NA	17976	16839	1137	6.3
CN4013900000000	40	139	Texas County, OK	1999	NA	14236	13925	311	2.2
CN4014100000000	40	141	Tillman County, OK	1999	NA	3539	3391	148	4.2
CN4014300000000	40	143	Tulsa County, OK	1999	NA	301682	291713	9969	3.3
CN4014500000000	40	145	Wagoner County, OK	1999	NA	29065	28269	796	2.7
CN4014700000000	40	147	Washington County, OK	1999	NA	19238	18457	781	4.1
CN4014900000000	40	149	Washita County, OK	1999	NA	4941	4753	188	3.8
CN4015100000000	40	151	Woods County, OK	1999	NA	4421	4336	85	1.9
CN4015300000000	40	153	Woodward County, OK	1999	NA	8897	8374	523	5.9
CN4100100000000	41	001	Baker County, OR	1999	NA	7431	6809	622	8.4
CN4100300000000	41	003	Benton County, OR	1999	NA	40192	39014	1178	2.9
CN4100500000000	41	005	Clackamas County, OR	1999	NA	197578	189846	7732	3.9
CN4100700000000	41	007	Clatsop County, OR	1999	NA	17634	16663	971	5.5
CN4100900000000	41	009	Columbia County, OR	1999	NA	23315	21947	1368	5.9
CN4101100000000	41	011	Coos County, OR	1999	NA	27497	25124	2373	8.6
CN4101300000000	41	013	Crook County, OR	1999	NA	7878	7203	675	8.6
CN4101500000000	41	015	Curry County, OR	1999	NA	8591	7976	615	7.2
CN4101700000000	41	017	Deschutes County, OR	1999	NA	59013	55362	3651	6.2
CN4101900000000	41	019	Douglas County, OR	1999	NA	45973	41985	3988	8.7
CN4102100000000	41	021	Gilliam County, OR	1999	NA	1210	1144	66	5.5
CN4102300000000	41	023	Grant County, OR	1999	NA	4056	3576	480	11.8
CN4102500000000	41	025	Harney County, OR	1999	NA	4106	3797	309	7.5
CN4102700000000	41	027	Hood River County, OR	1999	NA	11123	10175	948	8.5
CN4102900000000	41	029	Jackson County, OR	1999	NA	90628	84766	5862	6.5
CN4103100000000	41	031	Jefferson County, OR	1999	NA	8752	8202	550	6.3
CN4103300000000	41	033	Josephine County, OR	1999	NA	29613	27152	2461	8.3
CN4103500000000	41	035	Klamath County, OR	1999	NA	28988	26513	2475	8.5
CN4103700000000	41	037	Lake County, OR	1999	NA	3404	3064	340	10
CN4103900000000	41	039	Lane County, OR	1999	NA	166351	157496	8855	5.3
CN4104100000000	41	041	Lincoln County, OR	1999	NA	21429	19808	1621	7.6
CN4104300000000	41	043	Linn County, OR	1999	NA	53356	49162	4194	7.9
CN4104500000000	41	045	Malheur County, OR	1999	NA	14740	13377	1363	9.2
CN4104700000000	41	047	Marion County, OR	1999	NA	142922	134324	8598	6
CN4104900000000	41	049	Morrow County, OR	1999	NA	4154	3710	444	10.7
CN4105100000000	41	051	Multnomah County, OR	1999	NA	370965	352268	18697	5
CN4105300000000	41	053	Polk County, OR	1999	NA	31371	29767	1604	5.1
CN4105500000000	41	055	Sherman County, OR	1999	NA	1056	1000	56	5.3
CN4105700000000	41	057	Tillamook County, OR	1999	NA	11470	10881	589	5.1
CN4105900000000	41	059	Umatilla County, OR	1999	NA	37106	34707	2399	6.5
CN4106100000000	41	061	Union County, OR	1999	NA	12443	11721	722	5.8
CN4106300000000	41	063	Wallowa County, OR	1999	NA	3549	3242	307	8.7
CN4106500000000	41	065	Wasco County, OR	1999	NA	12401	11476	925	7.5
CN4106700000000	41	067	Washington County, OR	1999	NA	249884	240145	9739	3.9
CN4106900000000	41	069	Wheeler County, OR	1999	NA	600	543	57	9.5
CN4107100000000	41	071	Yamhill County, OR	1999	NA	42920	40934	1986	4.6
CN4200100000000	42	001	Adams County, PA	1999	NA	42798	41242	1556	3.6
CN4200300000000	42	003	Allegheny County, PA	1999	NA	658119	632694	25425	3.9
CN4200500000000	42	005	Armstrong County, PA	1999	NA	31805	29796	2009	6.3
CN4200700000000	42	007	Beaver County, PA	1999	NA	87042	82871	4171	4.8
CN4200900000000	42	009	Bedford County, PA	1999	NA	26421	24847	1574	6
CN4201100000000	42	011	Berks County, PA	1999	NA	186266	178705	7561	4.1
CN4201300000000	42	013	Blair County, PA	1999	NA	64333	61408	2925	4.5
CN4201500000000	42	015	Bradford County, PA	1999	NA	28071	26907	1164	4.1
CN4201700000000	42	017	Bucks County, PA	1999	NA	333410	322019	11391	3.4
CN4201900000000	42	019	Butler County, PA	1999	NA	90554	86813	3741	4.1
CN4202100000000	42	021	Cambria County, PA	1999	NA	66515	62652	3863	5.8
CN4202300000000	42	023	Cameron County, PA	1999	NA	2847	2617	230	8.1
CN4202500000000	42	025	Carbon County, PA	1999	NA	27676	25829	1847	6.7
CN4202700000000	42	027	Centre County, PA	1999	NA	66191	64406	1785	2.7
CN4202900000000	42	029	Chester County, PA	1999	NA	240698	234473	6225	2.6
CN4203100000000	42	031	Clarion County, PA	1999	NA	19391	18438	953	4.9
CN4203300000000	42	033	Clearfield County, PA	1999	NA	38057	35138	2919	7.7
CN4203500000000	42	035	Clinton County, PA	1999	NA	18104	17082	1022	5.6
CN4203700000000	42	037	Columbia County, PA	1999	NA	33396	31655	1741	5.2
CN4203900000000	42	039	Crawford County, PA	1999	NA	42508	40196	2312	5.4
CN4204100000000	42	041	Cumberland County, PA	1999	NA	123175	119788	3387	2.7
CN4204300000000	42	043	Dauphin County, PA	1999	NA	140878	135575	5303	3.8
CN4204500000000	42	045	Delaware County, PA	1999	NA	282431	271913	10518	3.7
CN4204700000000	42	047	Elk County, PA	1999	NA	18137	17043	1094	6
CN4204900000000	42	049	Erie County, PA	1999	NA	142894	135750	7144	5
CN4205100000000	42	051	Fayette County, PA	1999	NA	58124	54149	3975	6.8
CN4205300000000	42	053	Forest County, PA	1999	NA	1846	1707	139	7.5
CN4205500000000	42	055	Franklin County, PA	1999	NA	65849	62829	3020	4.6
CN4205700000000	42	057	Fulton County, PA	1999	NA	6699	6419	280	4.2
CN4205900000000	42	059	Greene County, PA	1999	NA	16339	15142	1197	7.3
CN4206100000000	42	061	Huntingdon County, PA	1999	NA	19135	17526	1609	8.4
CN4206300000000	42	063	Indiana County, PA	1999	NA	36877	34364	2513	6.8
CN4206500000000	42	065	Jefferson County, PA	1999	NA	21750	20235	1515	7
CN4206700000000	42	067	Juniata County, PA	1999	NA	10483	9862	621	5.9
CN4206900000000	42	069	Lackawanna County, PA	1999	NA	105352	99883	5469	5.2
CN4207100000000	42	071	Lancaster County, PA	1999	NA	247934	241220	6714	2.7
CN4207300000000	42	073	Lawrence County, PA	1999	NA	40999	38669	2330	5.7
CN4207500000000	42	075	Lebanon County, PA	1999	NA	66200	64162	2038	3.1
CN4207700000000	42	077	Lehigh County, PA	1999	NA	159421	153188	6233	3.9
CN4207900000000	42	079	Luzerne County, PA	1999	NA	157163	147957	9206	5.9
CN4208100000000	42	081	Lycoming County, PA	1999	NA	57472	54583	2889	5
CN4208300000000	42	083	McKean County, PA	1999	NA	21493	20349	1144	5.3
CN4208500000000	42	085	Mercer County, PA	1999	NA	58831	55884	2947	5
CN4208700000000	42	087	Mifflin County, PA	1999	NA	22161	20673	1488	6.7
CN4208900000000	42	089	Monroe County, PA	1999	NA	53294	50037	3257	6.1
CN4209100000000	42	091	Montgomery County, PA	1999	NA	407804	395670	12134	3
CN4209300000000	42	093	Montour County, PA	1999	NA	8788	8563	225	2.6
CN4209500000000	42	095	Northampton County, PA	1999	NA	133121	127844	5277	4
CN4209700000000	42	097	Northumberland County, PA	1999	NA	44171	41950	2221	5
CN4209900000000	42	099	Perry County, PA	1999	NA	24504	23575	929	3.8
CN4210100000000	42	101	Philadelphia County/city, PA	1999	NA	641087	602132	38955	6.1
CN4210300000000	42	103	Pike County, PA	1999	NA	19079	18419	660	3.5
CN4210500000000	42	105	Potter County, PA	1999	NA	9323	8834	489	5.2
CN4210700000000	42	107	Schuylkill County, PA	1999	NA	68516	63844	4672	6.8
CN4210900000000	42	109	Snyder County, PA	1999	NA	19305	18505	800	4.1
CN4211100000000	42	111	Somerset County, PA	1999	NA	37735	35573	2162	5.7
CN4211300000000	42	113	Sullivan County, PA	1999	NA	2565	2406	159	6.2
CN4211500000000	42	115	Susquehanna County, PA	1999	NA	19122	18184	938	4.9
CN4211700000000	42	117	Tioga County, PA	1999	NA	19755	18834	921	4.7
CN4211900000000	42	119	Union County, PA	1999	NA	18925	18357	568	3
CN4212100000000	42	121	Venango County, PA	1999	NA	26619	25068	1551	5.8
CN4212300000000	42	123	Warren County, PA	1999	NA	20537	19718	819	4
CN4212500000000	42	125	Washington County, PA	1999	NA	97871	93200	4671	4.8
CN4212700000000	42	127	Wayne County, PA	1999	NA	19863	18665	1198	6
CN4212900000000	42	129	Westmoreland County, PA	1999	NA	185454	176520	8934	4.8
CN4213100000000	42	131	Wyoming County, PA	1999	NA	15304	14450	854	5.6
CN4213300000000	42	133	York County, PA	1999	NA	198199	191159	7040	3.6
CN4400100000000	44	001	Bristol County, RI	1999	NA	27061	26215	846	3.1
CN4400300000000	44	003	Kent County, RI	1999	NA	92398	88768	3630	3.9
CN4400500000000	44	005	Newport County, RI	1999	NA	43136	41547	1589	3.7
CN4400700000000	44	007	Providence County, RI	1999	NA	306002	291948	14054	4.6
CN4400900000000	44	009	Washington County, RI	1999	NA	69499	67283	2216	3.2
CN4500100000000	45	001	Abbeville County, SC	1999	NA	12418	11715	703	5.7
CN4500300000000	45	003	Aiken County, SC	1999	NA	64348	61349	2999	4.7
CN4500500000000	45	005	Allendale County, SC	1999	NA	4896	4533	363	7.4
CN4500700000000	45	007	Anderson County, SC	1999	NA	85476	82919	2557	3
CN4500900000000	45	009	Bamberg County, SC	1999	NA	7854	7208	646	8.2
CN4501100000000	45	011	Barnwell County, SC	1999	NA	11608	10757	851	7.3
CN4501300000000	45	013	Beaufort County, SC	1999	NA	51925	50781	1144	2.2
CN4501500000000	45	015	Berkeley County, SC	1999	NA	65485	63183	2302	3.5
CN4501700000000	45	017	Calhoun County, SC	1999	NA	6964	6478	486	7
CN4501900000000	45	019	Charleston County, SC	1999	NA	162444	157299	5145	3.2
CN4502100000000	45	021	Cherokee County, SC	1999	NA	26095	24990	1105	4.2
CN4502300000000	45	023	Chester County, SC	1999	NA	16113	14716	1397	8.7
CN4502500000000	45	025	Chesterfield County, SC	1999	NA	20489	19057	1432	7
CN4502700000000	45	027	Clarendon County, SC	1999	NA	13136	12182	954	7.3
CN4502900000000	45	029	Colleton County, SC	1999	NA	15442	14618	824	5.3
CN4503100000000	45	031	Darlington County, SC	1999	NA	31354	29108	2246	7.2
CN4503300000000	45	033	Dillon County, SC	1999	NA	14445	13083	1362	9.4
CN4503500000000	45	035	Dorchester County, SC	1999	NA	44663	43205	1458	3.3
CN4503700000000	45	037	Edgefield County, SC	1999	NA	9493	8989	504	5.3
CN4503900000000	45	039	Fairfield County, SC	1999	NA	10928	9945	983	9
CN4504100000000	45	041	Florence County, SC	1999	NA	63905	60571	3334	5.2
CN4504300000000	45	043	Georgetown County, SC	1999	NA	25093	23007	2086	8.3
CN4504500000000	45	045	Greenville County, SC	1999	NA	195407	190830	4577	2.3
CN4504700000000	45	047	Greenwood County, SC	1999	NA	33655	31452	2203	6.5
CN4504900000000	45	049	Hampton County, SC	1999	NA	8767	8277	490	5.6
CN4505100000000	45	051	Horry County, SC	1999	NA	105223	101307	3916	3.7
CN4505300000000	45	053	Jasper County, SC	1999	NA	8153	7872	281	3.4
CN4505500000000	45	055	Kershaw County, SC	1999	NA	23292	22138	1154	5
CN4505700000000	45	057	Lancaster County, SC	1999	NA	29702	28506	1196	4
CN4505900000000	45	059	Laurens County, SC	1999	NA	28026	26988	1038	3.7
CN4506100000000	45	061	Lee County, SC	1999	NA	8369	7709	660	7.9
CN4506300000000	45	063	Lexington County, SC	1999	NA	122509	120156	2353	1.9
CN4506500000000	45	065	McCormick County, SC	1999	NA	4188	3706	482	11.5
CN4506700000000	45	067	Marion County, SC	1999	NA	16867	14759	2108	12.5
CN4506900000000	45	069	Marlboro County, SC	1999	NA	11874	10453	1421	12
CN4507100000000	45	071	Newberry County, SC	1999	NA	18245	17402	843	4.6
CN4507300000000	45	073	Oconee County, SC	1999	NA	29067	27936	1131	3.9
CN4507500000000	45	075	Orangeburg County, SC	1999	NA	42418	37735	4683	11
CN4507700000000	45	077	Pickens County, SC	1999	NA	57030	55188	1842	3.2
CN4507900000000	45	079	Richland County, SC	1999	NA	162645	158353	4292	2.6
CN4508100000000	45	081	Saluda County, SC	1999	NA	9094	8640	454	5
CN4508300000000	45	083	Spartanburg County, SC	1999	NA	134321	128777	5544	4.1
CN4508500000000	45	085	Sumter County, SC	1999	NA	47561	45073	2488	5.2
CN4508700000000	45	087	Union County, SC	1999	NA	15384	14308	1076	7
CN4508900000000	45	089	Williamsburg County, SC	1999	NA	14978	13141	1837	12.3
CN4509100000000	45	091	York County, SC	1999	NA	90198	86657	3541	3.9
CN4600300000000	46	003	Aurora County, SD	1999	NA	1405	1375	30	2.1
CN4600500000000	46	005	Beadle County, SD	1999	NA	8792	8545	247	2.8
CN4600700000000	46	007	Bennett County, SD	1999	NA	1079	1026	53	4.9
CN4600900000000	46	009	Bon Homme County, SD	1999	NA	3170	3108	62	2
CN4601100000000	46	011	Brookings County, SD	1999	NA	17096	16848	248	1.5
CN4601300000000	46	013	Brown County, SD	1999	NA	21054	20571	483	2.3
CN4601500000000	46	015	Brule County, SD	1999	NA	2648	2552	96	3.6
CN4601700000000	46	017	Buffalo County, SD	1999	NA	845	759	86	10.2
CN4601900000000	46	019	Butte County, SD	1999	NA	3826	3676	150	3.9
CN4602100000000	46	021	Campbell County, SD	1999	NA	895	868	27	3
CN4602300000000	46	023	Charles Mix County, SD	1999	NA	4523	4379	144	3.2
CN4602500000000	46	025	Clark County, SD	1999	NA	2010	1922	88	4.4
CN4602700000000	46	027	Clay County, SD	1999	NA	7911	7854	57	0.7
CN4602900000000	46	029	Codington County, SD	1999	NA	14731	14219	512	3.5
CN4603100000000	46	031	Corson County, SD	1999	NA	1626	1505	121	7.4
CN4603300000000	46	033	Custer County, SD	1999	NA	3550	3403	147	4.1
CN4603500000000	46	035	Davison County, SD	1999	NA	10322	10095	227	2.2
CN4603700000000	46	037	Day County, SD	1999	NA	3035	2829	206	6.8
CN4603900000000	46	039	Deuel County, SD	1999	NA	2519	2425	94	3.7
CN4604100000000	46	041	Dewey County, SD	1999	NA	2437	2131	306	12.6
CN4604300000000	46	043	Douglas County, SD	1999	NA	1654	1618	36	2.2
CN4604500000000	46	045	Edmunds County, SD	1999	NA	2230	2188	42	1.9
CN4604700000000	46	047	Fall River County, SD	1999	NA	3383	3257	126	3.7
CN4604900000000	46	049	Faulk County, SD	1999	NA	1216	1189	27	2.2
CN4605100000000	46	051	Grant County, SD	1999	NA	4271	4112	159	3.7
CN4605300000000	46	053	Gregory County, SD	1999	NA	2616	2509	107	4.1
CN4605500000000	46	055	Haakon County, SD	1999	NA	1130	1095	35	3.1
CN4605700000000	46	057	Hamlin County, SD	1999	NA	2595	2514	81	3.1
CN4605900000000	46	059	Hand County, SD	1999	NA	2075	2033	42	2
CN4606100000000	46	061	Hanson County, SD	1999	NA	1768	1728	40	2.3
CN4606300000000	46	063	Harding County, SD	1999	NA	773	744	29	3.8
CN4606500000000	46	065	Hughes County, SD	1999	NA	10114	9907	207	2
CN4606700000000	46	067	Hutchinson County, SD	1999	NA	3884	3787	97	2.5
CN4606900000000	46	069	Hyde County, SD	1999	NA	917	895	22	2.4
CN4607100000000	46	071	Jackson County, SD	1999	NA	1136	1069	67	5.9
CN4607300000000	46	073	Jerauld County, SD	1999	NA	1324	1294	30	2.3
CN4607500000000	46	075	Jones County, SD	1999	NA	833	811	22	2.6
CN4607700000000	46	077	Kingsbury County, SD	1999	NA	2627	2511	116	4.4
CN4607900000000	46	079	Lake County, SD	1999	NA	6202	6050	152	2.5
CN4608100000000	46	081	Lawrence County, SD	1999	NA	10551	10167	384	3.6
CN4608300000000	46	083	Lincoln County, SD	1999	NA	13038	12847	191	1.5
CN4608500000000	46	085	Lyman County, SD	1999	NA	2481	2368	113	4.6
CN4608700000000	46	087	McCook County, SD	1999	NA	2513	2454	59	2.3
CN4608900000000	46	089	McPherson County, SD	1999	NA	1303	1272	31	2.4
CN4609100000000	46	091	Marshall County, SD	1999	NA	2310	2177	133	5.8
CN4609300000000	46	093	Meade County, SD	1999	NA	13644	13277	367	2.7
CN4609500000000	46	095	Mellette County, SD	1999	NA	756	706	50	6.6
CN4609700000000	46	097	Miner County, SD	1999	NA	1414	1365	49	3.5
CN4609900000000	46	099	Minnehaha County, SD	1999	NA	90018	88504	1514	1.7
CN4610100000000	46	101	Moody County, SD	1999	NA	3680	3492	188	5.1
CN4610200000000	46	102	Oglala Lakota County, SD	1999	NA	3270	2858	412	12.6
CN4610300000000	46	103	Pennington County, SD	1999	NA	47408	46277	1131	2.4
CN4610500000000	46	105	Perkins County, SD	1999	NA	2016	1955	61	3
CN4610700000000	46	107	Potter County, SD	1999	NA	1467	1415	52	3.5
CN4610900000000	46	109	Roberts County, SD	1999	NA	4845	4592	253	5.2
CN4611100000000	46	111	Sanborn County, SD	1999	NA	1510	1469	41	2.7
CN4611500000000	46	115	Spink County, SD	1999	NA	3592	3474	118	3.3
CN4611700000000	46	117	Stanley County, SD	1999	NA	1900	1859	41	2.2
CN4611900000000	46	119	Sully County, SD	1999	NA	879	855	24	2.7
CN4612100000000	46	121	Todd County, SD	1999	NA	2953	2745	208	7
CN4612300000000	46	123	Tripp County, SD	1999	NA	3571	3468	103	2.9
CN4612500000000	46	125	Turner County, SD	1999	NA	4238	4152	86	2
CN4612700000000	46	127	Union County, SD	1999	NA	7267	7074	193	2.7
CN4612900000000	46	129	Walworth County, SD	1999	NA	3150	3051	99	3.1
CN4613500000000	46	135	Yankton County, SD	1999	NA	11415	11173	242	2.1
CN4613700000000	46	137	Ziebach County, SD	1999	NA	703	607	96	13.7
CN4700100000000	47	001	Anderson County, TN	1999	NA	35966	34678	1288	3.6
CN4700300000000	47	003	Bedford County, TN	1999	NA	18088	17184	904	5
CN4700500000000	47	005	Benton County, TN	1999	NA	7621	7005	616	8.1
CN4700700000000	47	007	Bledsoe County, TN	1999	NA	3970	3833	137	3.5
CN4700900000000	47	009	Blount County, TN	1999	NA	52243	50325	1918	3.7
CN4701100000000	47	011	Bradley County, TN	1999	NA	43712	42179	1533	3.5
CN4701300000000	47	013	Campbell County, TN	1999	NA	17251	15940	1311	7.6
CN4701500000000	47	015	Cannon County, TN	1999	NA	5087	4866	221	4.3
CN4701700000000	47	017	Carroll County, TN	1999	NA	12767	11586	1181	9.3
CN4701900000000	47	019	Carter County, TN	1999	NA	25989	24702	1287	5
CN4702100000000	47	021	Cheatham County, TN	1999	NA	20025	19590	435	2.2
CN4702300000000	47	023	Chester County, TN	1999	NA	8488	8162	326	3.8
CN4702500000000	47	025	Claiborne County, TN	1999	NA	13421	12854	567	4.2
CN4702700000000	47	027	Clay County, TN	1999	NA	2751	2429	322	11.7
CN4702900000000	47	029	Cocke County, TN	1999	NA	16843	15706	1137	6.8
CN4703100000000	47	031	Coffee County, TN	1999	NA	22966	21992	974	4.2
CN4703300000000	47	033	Crockett County, TN	1999	NA	7451	7053	398	5.3
CN4703500000000	47	035	Cumberland County, TN	1999	NA	21412	20400	1012	4.7
CN4703700000000	47	037	Davidson County, TN	1999	NA	309337	300542	8795	2.8
CN4703900000000	47	039	Decatur County, TN	1999	NA	5572	5177	395	7.1
CN4704100000000	47	041	DeKalb County, TN	1999	NA	8182	7687	495	6
CN4704300000000	47	043	Dickson County, TN	1999	NA	22245	21547	698	3.1
CN4704500000000	47	045	Dyer County, TN	1999	NA	18771	17887	884	4.7
CN4704700000000	47	047	Fayette County, TN	1999	NA	14718	14186	532	3.6
CN4704900000000	47	049	Fentress County, TN	1999	NA	6704	5997	707	10.5
CN4705100000000	47	051	Franklin County, TN	1999	NA	18536	17718	818	4.4
CN4705300000000	47	053	Gibson County, TN	1999	NA	21591	20236	1355	6.3
CN4705500000000	47	055	Giles County, TN	1999	NA	16526	15888	638	3.9
CN4705700000000	47	057	Grainger County, TN	1999	NA	10391	9957	434	4.2
CN4705900000000	47	059	Greene County, TN	1999	NA	36348	34330	2018	5.6
CN4706100000000	47	061	Grundy County, TN	1999	NA	5562	5240	322	5.8
CN4706300000000	47	063	Hamblen County, TN	1999	NA	30670	29363	1307	4.3
CN4706500000000	47	065	Hamilton County, TN	1999	NA	152627	147700	4927	3.2
CN4706700000000	47	067	Hancock County, TN	1999	NA	2799	2622	177	6.3
CN4706900000000	47	069	Hardeman County, TN	1999	NA	9585	8703	882	9.2
CN4707100000000	47	071	Hardin County, TN	1999	NA	12435	11582	853	6.9
CN4707300000000	47	073	Hawkins County, TN	1999	NA	24295	23044	1251	5.1
CN4707500000000	47	075	Haywood County, TN	1999	NA	8520	7766	754	8.8
CN4707700000000	47	077	Henderson County, TN	1999	NA	14648	13775	873	6
CN4707900000000	47	079	Henry County, TN	1999	NA	14685	13734	951	6.5
CN4708100000000	47	081	Hickman County, TN	1999	NA	7993	7532	461	5.8
CN4708300000000	47	083	Houston County, TN	1999	NA	2763	2508	255	9.2
CN4708500000000	47	085	Humphreys County, TN	1999	NA	8092	7541	551	6.8
CN4708700000000	47	087	Jackson County, TN	1999	NA	4697	4297	400	8.5
CN4708900000000	47	089	Jefferson County, TN	1999	NA	24600	23591	1009	4.1
CN4709100000000	47	091	Johnson County, TN	1999	NA	7424	6722	702	9.5
CN4709300000000	47	093	Knox County, TN	1999	NA	203690	198555	5135	2.5
CN4709500000000	47	095	Lake County, TN	1999	NA	2589	2429	160	6.2
CN4709700000000	47	097	Lauderdale County, TN	1999	NA	10177	9335	842	8.3
CN4709900000000	47	099	Lawrence County, TN	1999	NA	21041	18751	2290	10.9
CN4710100000000	47	101	Lewis County, TN	1999	NA	4227	3829	398	9.4
CN4710300000000	47	103	Lincoln County, TN	1999	NA	14452	13865	587	4.1
CN4710500000000	47	105	Loudon County, TN	1999	NA	21020	20401	619	2.9
CN4710700000000	47	107	McMinn County, TN	1999	NA	22017	20756	1261	5.7
CN4710900000000	47	109	McNairy County, TN	1999	NA	11861	11275	586	4.9
CN4711100000000	47	111	Macon County, TN	1999	NA	8407	8053	354	4.2
CN4711300000000	47	113	Madison County, TN	1999	NA	51269	49578	1691	3.3
CN4711500000000	47	115	Marion County, TN	1999	NA	12826	12215	611	4.8
CN4711700000000	47	117	Marshall County, TN	1999	NA	12431	11982	449	3.6
CN4711900000000	47	119	Maury County, TN	1999	NA	37961	36644	1317	3.5
CN4712100000000	47	121	Meigs County, TN	1999	NA	4738	4372	366	7.7
CN4712300000000	47	123	Monroe County, TN	1999	NA	19128	18139	989	5.2
CN4712500000000	47	125	Montgomery County, TN	1999	NA	59412	57607	1805	3
CN4712700000000	47	127	Moore County, TN	1999	NA	2909	2846	63	2.2
CN4712900000000	47	129	Morgan County, TN	1999	NA	6973	6468	505	7.2
CN4713100000000	47	131	Obion County, TN	1999	NA	15675	14739	936	6
CN4713300000000	47	133	Overton County, TN	1999	NA	9880	9323	557	5.6
CN4713500000000	47	135	Perry County, TN	1999	NA	3867	3579	288	7.4
CN4713700000000	47	137	Pickett County, TN	1999	NA	2229	2089	140	6.3
CN4713900000000	47	139	Polk County, TN	1999	NA	6936	6588	348	5
CN4714100000000	47	141	Putnam County, TN	1999	NA	31746	30320	1426	4.5
CN4714300000000	47	143	Rhea County, TN	1999	NA	12375	11668	707	5.7
CN4714500000000	47	145	Roane County, TN	1999	NA	25076	23942	1134	4.5
CN4714700000000	47	147	Robertson County, TN	1999	NA	29789	28829	960	3.2
CN4714900000000	47	149	Rutherford County, TN	1999	NA	99024	96468	2556	2.6
CN4715100000000	47	151	Scott County, TN	1999	NA	8977	8224	753	8.4
CN4715300000000	47	153	Sequatchie County, TN	1999	NA	4960	4764	196	4
CN4715500000000	47	155	Sevier County, TN	1999	NA	36308	33952	2356	6.5
CN4715700000000	47	157	Shelby County, TN	1999	NA	451185	434479	16706	3.7
CN4715900000000	47	159	Smith County, TN	1999	NA	9849	9479	370	3.8
CN4716100000000	47	161	Stewart County, TN	1999	NA	3482	3204	278	8
CN4716300000000	47	163	Sullivan County, TN	1999	NA	75670	72631	3039	4
CN4716500000000	47	165	Sumner County, TN	1999	NA	70570	68697	1873	2.7
CN4716700000000	47	167	Tipton County, TN	1999	NA	22905	22153	752	3.3
CN4716900000000	47	169	Trousdale County, TN	1999	NA	2120	2007	113	5.3
CN4717100000000	47	171	Unicoi County, TN	1999	NA	8061	7602	459	5.7
CN4717300000000	47	173	Union County, TN	1999	NA	7978	7701	277	3.5
CN4717500000000	47	175	Van Buren County, TN	1999	NA	2419	2269	150	6.2
CN4717700000000	47	177	Warren County, TN	1999	NA	19655	18777	878	4.5
CN4717900000000	47	179	Washington County, TN	1999	NA	52805	50913	1892	3.6
CN4718100000000	47	181	Wayne County, TN	1999	NA	7638	6731	907	11.9
CN4718300000000	47	183	Weakley County, TN	1999	NA	17130	16096	1034	6
CN4718500000000	47	185	White County, TN	1999	NA	11499	10977	522	4.5
CN4718700000000	47	187	Williamson County, TN	1999	NA	70195	68893	1302	1.9
CN4718900000000	47	189	Wilson County, TN	1999	NA	48950	47638	1312	2.7
CN4800100000000	48	001	Anderson County, TX	1999	NA	20467	19198	1269	6.2
CN4800300000000	48	003	Andrews County, TX	1999	NA	5300	4692	608	11.5
CN4800500000000	48	005	Angelina County, TX	1999	NA	35789	33637	2152	6
CN4800700000000	48	007	Aransas County, TX	1999	NA	9711	9144	567	5.8
CN4800900000000	48	009	Archer County, TX	1999	NA	4068	3937	131	3.2
CN4801100000000	48	011	Armstrong County, TX	1999	NA	1032	1015	17	1.6
CN4801300000000	48	013	Atascosa County, TX	1999	NA	17901	17155	746	4.2
CN4801500000000	48	015	Austin County, TX	1999	NA	13469	12951	518	3.8
CN4801700000000	48	017	Bailey County, TX	1999	NA	3475	3299	176	5.1
CN4801900000000	48	019	Bandera County, TX	1999	NA	6893	6707	186	2.7
CN4802100000000	48	021	Bastrop County, TX	1999	NA	28232	27519	713	2.5
CN4802300000000	48	023	Baylor County, TX	1999	NA	1738	1664	74	4.3
CN4802500000000	48	025	Bee County, TX	1999	NA	10902	10235	667	6.1
CN4802700000000	48	027	Bell County, TX	1999	NA	94235	91011	3224	3.4
CN4802900000000	48	029	Bexar County, TX	1999	NA	670474	648566	21908	3.3
CN4803100000000	48	031	Blanco County, TX	1999	NA	3927	3843	84	2.1
CN4803300000000	48	033	Borden County, TX	1999	NA	393	384	9	2.3
CN4803500000000	48	035	Bosque County, TX	1999	NA	7251	6991	260	3.6
CN4803700000000	48	037	Bowie County, TX	1999	NA	39144	36917	2227	5.7
CN4803900000000	48	039	Brazoria County, TX	1999	NA	104631	97483	7148	6.8
CN4804100000000	48	041	Brazos County, TX	1999	NA	75666	74330	1336	1.8
CN4804300000000	48	043	Brewster County, TX	1999	NA	5238	5108	130	2.5
CN4804500000000	48	045	Briscoe County, TX	1999	NA	912	878	34	3.7
CN4804700000000	48	047	Brooks County, TX	1999	NA	3137	2828	309	9.9
CN4804900000000	48	049	Brown County, TX	1999	NA	17160	16496	664	3.9
CN4805100000000	48	051	Burleson County, TX	1999	NA	6819	6506	313	4.6
CN4805300000000	48	053	Burnet County, TX	1999	NA	14035	13651	384	2.7
CN4805500000000	48	055	Caldwell County, TX	1999	NA	16247	15683	564	3.5
CN4805700000000	48	057	Calhoun County, TX	1999	NA	9644	9074	570	5.9
CN4805900000000	48	059	Callahan County, TX	1999	NA	6145	5876	269	4.4
CN4806100000000	48	061	Cameron County, TX	1999	NA	127149	114536	12613	9.9
CN4806300000000	48	063	Camp County, TX	1999	NA	5390	5032	358	6.6
CN4806500000000	48	065	Carson County, TX	1999	NA	3176	3046	130	4.1
CN4806700000000	48	067	Cass County, TX	1999	NA	15447	14289	1158	7.5
CN4806900000000	48	069	Castro County, TX	1999	NA	3726	3560	166	4.5
CN4807100000000	48	071	Chambers County, TX	1999	NA	11785	11268	517	4.4
CN4807300000000	48	073	Cherokee County, TX	1999	NA	20800	19924	876	4.2
CN4807500000000	48	075	Childress County, TX	1999	NA	3018	2918	100	3.3
CN4807700000000	48	077	Clay County, TX	1999	NA	5568	5408	160	2.9
CN4807900000000	48	079	Cochran County, TX	1999	NA	1329	1255	74	5.6
CN4808100000000	48	081	Coke County, TX	1999	NA	1577	1533	44	2.8
CN4808300000000	48	083	Coleman County, TX	1999	NA	3325	3108	217	6.5
CN4808500000000	48	085	Collin County, TX	1999	NA	280505	274713	5792	2.1
CN4808700000000	48	087	Collingsworth County, TX	1999	NA	1488	1472	16	1.1
CN4808900000000	48	089	Colorado County, TX	1999	NA	8338	8020	318	3.8
CN4809100000000	48	091	Comal County, TX	1999	NA	39693	38701	992	2.5
CN4809300000000	48	093	Comanche County, TX	1999	NA	6638	6412	226	3.4
CN4809500000000	48	095	Concho County, TX	1999	NA	1561	1522	39	2.5
CN4809700000000	48	097	Cooke County, TX	1999	NA	17119	16591	528	3.1
CN4809900000000	48	099	Coryell County, TX	1999	NA	21479	20663	816	3.8
CN4810100000000	48	101	Cottle County, TX	1999	NA	837	794	43	5.1
CN4810300000000	48	103	Crane County, TX	1999	NA	2018	1839	179	8.9
CN4810500000000	48	105	Crockett County, TX	1999	NA	2044	1877	167	8.2
CN4810700000000	48	107	Crosby County, TX	1999	NA	2722	2544	178	6.5
CN4810900000000	48	109	Culberson County, TX	1999	NA	1239	1139	100	8.1
CN4811100000000	48	111	Dallam County, TX	1999	NA	3659	3561	98	2.7
CN4811300000000	48	113	Dallas County, TX	1999	NA	1208890	1165810	43080	3.6
CN4811500000000	48	115	Dawson County, TX	1999	NA	6102	5693	409	6.7
CN4811700000000	48	117	Deaf Smith County, TX	1999	NA	7879	7419	460	5.8
CN4811900000000	48	119	Delta County, TX	1999	NA	3394	3277	117	3.4
CN4812100000000	48	121	Denton County, TX	1999	NA	251449	246613	4836	1.9
CN4812300000000	48	123	DeWitt County, TX	1999	NA	8432	8048	384	4.6
CN4812500000000	48	125	Dickens County, TX	1999	NA	872	824	48	5.5
CN4812700000000	48	127	Dimmit County, TX	1999	NA	3669	3089	580	15.8
CN4812900000000	48	129	Donley County, TX	1999	NA	1544	1489	55	3.6
CN4813100000000	48	131	Duval County, TX	1999	NA	5042	4280	762	15.1
CN4813300000000	48	133	Eastland County, TX	1999	NA	9015	8586	429	4.8
CN4813500000000	48	135	Ector County, TX	1999	NA	61122	54709	6413	10.5
CN4813700000000	48	137	Edwards County, TX	1999	NA	793	745	48	6.1
CN4813900000000	48	139	Ellis County, TX	1999	NA	55881	54140	1741	3.1
CN4814100000000	48	141	El Paso County, TX	1999	NA	288679	261255	27424	9.5
CN4814300000000	48	143	Erath County, TX	1999	NA	16524	16111	413	2.5
CN4814500000000	48	145	Falls County, TX	1999	NA	7435	7157	278	3.7
CN4814700000000	48	147	Fannin County, TX	1999	NA	12937	12222	715	5.5
CN4814900000000	48	149	Fayette County, TX	1999	NA	10829	10499	330	3
CN4815100000000	48	151	Fisher County, TX	1999	NA	1650	1584	66	4
CN4815300000000	48	153	Floyd County, TX	1999	NA	3203	2998	205	6.4
CN4815500000000	48	155	Foard County, TX	1999	NA	853	834	19	2.2
CN4815700000000	48	157	Fort Bend County, TX	1999	NA	188554	182509	6045	3.2
CN4815900000000	48	159	Franklin County, TX	1999	NA	4545	4369	176	3.9
CN4816100000000	48	161	Freestone County, TX	1999	NA	7469	7132	337	4.5
CN4816300000000	48	163	Frio County, TX	1999	NA	6139	5682	457	7.4
CN4816500000000	48	165	Gaines County, TX	1999	NA	6729	6363	366	5.4
CN4816700000000	48	167	Galveston County, TX	1999	NA	122493	114420	8073	6.6
CN4816900000000	48	169	Garza County, TX	1999	NA	1989	1872	117	5.9
CN4817100000000	48	171	Gillespie County, TX	1999	NA	10285	10058	227	2.2
CN4817300000000	48	173	Glasscock County, TX	1999	NA	698	680	18	2.6
CN4817500000000	48	175	Goliad County, TX	1999	NA	2690	2572	118	4.4
CN4817700000000	48	177	Gonzales County, TX	1999	NA	7506	7264	242	3.2
CN4817900000000	48	179	Gray County, TX	1999	NA	9698	9015	683	7
CN4818100000000	48	181	Grayson County, TX	1999	NA	50674	48389	2285	4.5
CN4818300000000	48	183	Gregg County, TX	1999	NA	59185	54717	4468	7.5
CN4818500000000	48	185	Grimes County, TX	1999	NA	8966	8332	634	7.1
CN4818700000000	48	187	Guadalupe County, TX	1999	NA	43183	42116	1067	2.5
CN4818900000000	48	189	Hale County, TX	1999	NA	16956	16108	848	5
CN4819100000000	48	191	Hall County, TX	1999	NA	1607	1522	85	5.3
CN4819300000000	48	193	Hamilton County, TX	1999	NA	4008	3849	159	4
CN4819500000000	48	195	Hansford County, TX	1999	NA	2462	2375	87	3.5
CN4819700000000	48	197	Hardeman County, TX	1999	NA	1916	1824	92	4.8
CN4819900000000	48	199	Hardin County, TX	1999	NA	23699	21847	1852	7.8
CN4820100000000	48	201	Harris County, TX	1999	NA	1768585	1684805	83780	4.7
CN4820300000000	48	203	Harrison County, TX	1999	NA	27675	25733	1942	7
CN4820500000000	48	205	Hartley County, TX	1999	NA	3008	2969	39	1.3
CN4820700000000	48	207	Haskell County, TX	1999	NA	2720	2609	111	4.1
CN4820900000000	48	209	Hays County, TX	1999	NA	53037	51597	1440	2.7
CN4821100000000	48	211	Hemphill County, TX	1999	NA	1877	1821	56	3
CN4821300000000	48	213	Henderson County, TX	1999	NA	30405	29333	1072	3.5
CN4821500000000	48	215	Hidalgo County, TX	1999	NA	195207	166747	28460	14.6
CN4821700000000	48	217	Hill County, TX	1999	NA	16278	15698	580	3.6
CN4821900000000	48	219	Hockley County, TX	1999	NA	10877	10144	733	6.7
CN4822100000000	48	221	Hood County, TX	1999	NA	17368	16728	640	3.7
CN4822300000000	48	223	Hopkins County, TX	1999	NA	15772	15084	688	4.4
CN4822500000000	48	225	Houston County, TX	1999	NA	9162	8763	399	4.4
CN4822700000000	48	227	Howard County, TX	1999	NA	13695	12873	822	6
CN4822900000000	48	229	Hudspeth County, TX	1999	NA	1455	1404	51	3.5
CN4823100000000	48	231	Hunt County, TX	1999	NA	36411	35000	1411	3.9
CN4823300000000	48	233	Hutchinson County, TX	1999	NA	9327	8609	718	7.7
CN4823500000000	48	235	Irion County, TX	1999	NA	701	671	30	4.3
CN4823700000000	48	237	Jack County, TX	1999	NA	3501	3351	150	4.3
CN4823900000000	48	239	Jackson County, TX	1999	NA	8505	8221	284	3.3
CN4824100000000	48	241	Jasper County, TX	1999	NA	14669	12903	1766	12
CN4824300000000	48	243	Jeff Davis County, TX	1999	NA	1858	1819	39	2.1
CN4824500000000	48	245	Jefferson County, TX	1999	NA	116941	107297	9644	8.2
CN4824700000000	48	247	Jim Hogg County, TX	1999	NA	2270	1998	272	12
CN4824900000000	48	249	Jim Wells County, TX	1999	NA	17130	15231	1899	11.1
CN4825100000000	48	251	Johnson County, TX	1999	NA	62249	60151	2098	3.4
CN4825300000000	48	253	Jones County, TX	1999	NA	9858	9513	345	3.5
CN4825500000000	48	255	Karnes County, TX	1999	NA	5763	5531	232	4
CN4825700000000	48	257	Kaufman County, TX	1999	NA	33494	32163	1331	4
CN4825900000000	48	259	Kendall County, TX	1999	NA	13606	13303	303	2.2
CN4826100000000	48	261	Kenedy County, TX	1999	NA	227	220	7	3.1
CN4826300000000	48	263	Kent County, TX	1999	NA	442	430	12	2.7
CN4826500000000	48	265	Kerr County, TX	1999	NA	17566	17187	379	2.2
CN4826700000000	48	267	Kimble County, TX	1999	NA	2384	2318	66	2.8
CN4826900000000	48	269	King County, TX	1999	NA	124	119	5	4
CN4827100000000	48	271	Kinney County, TX	1999	NA	1123	1034	89	7.9
CN4827300000000	48	273	Kleberg County, TX	1999	NA	12891	12037	854	6.6
CN4827500000000	48	275	Knox County, TX	1999	NA	1951	1844	107	5.5
CN4827700000000	48	277	Lamar County, TX	1999	NA	22273	20934	1339	6
CN4827900000000	48	279	Lamb County, TX	1999	NA	6466	6001	465	7.2
CN4828100000000	48	281	Lampasas County, TX	1999	NA	8044	7786	258	3.2
CN4828300000000	48	283	La Salle County, TX	1999	NA	2886	2636	250	8.7
CN4828500000000	48	285	Lavaca County, TX	1999	NA	9504	9311	193	2
CN4828700000000	48	287	Lee County, TX	1999	NA	7198	6941	257	3.6
CN4828900000000	48	289	Leon County, TX	1999	NA	6340	5929	411	6.5
CN4829100000000	48	291	Liberty County, TX	1999	NA	29540	27346	2194	7.4
CN4829300000000	48	293	Limestone County, TX	1999	NA	9186	8789	397	4.3
CN4829500000000	48	295	Lipscomb County, TX	1999	NA	1514	1463	51	3.4
CN4829700000000	48	297	Live Oak County, TX	1999	NA	4399	4211	188	4.3
CN4829900000000	48	299	Llano County, TX	1999	NA	5609	5464	145	2.6
CN4830100000000	48	301	Loving County, TX	1999	NA	76	67	9	11.8
CN4830300000000	48	303	Lubbock County, TX	1999	NA	123770	120171	3599	2.9
CN4830500000000	48	305	Lynn County, TX	1999	NA	2882	2751	131	4.5
CN4830700000000	48	307	McCulloch County, TX	1999	NA	3712	3515	197	5.3
CN4830900000000	48	309	McLennan County, TX	1999	NA	101970	98561	3409	3.3
CN4831100000000	48	311	McMullen County, TX	1999	NA	282	268	14	5
CN4831300000000	48	313	Madison County, TX	1999	NA	4270	4118	152	3.6
CN4831500000000	48	315	Marion County, TX	1999	NA	3883	3532	351	9
CN4831700000000	48	317	Martin County, TX	1999	NA	1779	1679	100	5.6
CN4831900000000	48	319	Mason County, TX	1999	NA	1557	1517	40	2.6
CN4832100000000	48	321	Matagorda County, TX	1999	NA	16332	14636	1696	10.4
CN4832300000000	48	323	Maverick County, TX	1999	NA	18248	14306	3942	21.6
CN4832500000000	48	325	Medina County, TX	1999	NA	15930	15382	548	3.4
CN4832700000000	48	327	Menard County, TX	1999	NA	1042	1010	32	3.1
CN4832900000000	48	329	Midland County, TX	1999	NA	61269	56994	4275	7
CN4833100000000	48	331	Milam County, TX	1999	NA	9482	9093	389	4.1
CN4833300000000	48	333	Mills County, TX	1999	NA	2344	2296	48	2
CN4833500000000	48	335	Mitchell County, TX	1999	NA	3362	3143	219	6.5
CN4833700000000	48	337	Montague County, TX	1999	NA	7360	7022	338	4.6
CN4833900000000	48	339	Montgomery County, TX	1999	NA	144083	139252	4831	3.4
CN4834100000000	48	341	Moore County, TX	1999	NA	9279	8993	286	3.1
CN4834300000000	48	343	Morris County, TX	1999	NA	6333	5634	699	11
CN4834500000000	48	345	Motley County, TX	1999	NA	590	581	9	1.5
CN4834700000000	48	347	Nacogdoches County, TX	1999	NA	25385	24396	989	3.9
CN4834900000000	48	349	Navarro County, TX	1999	NA	21649	20679	970	4.5
CN4835100000000	48	351	Newton County, TX	1999	NA	5826	5022	804	13.8
CN4835300000000	48	353	Nolan County, TX	1999	NA	7114	6693	421	5.9
CN4835500000000	48	355	Nueces County, TX	1999	NA	146488	136770	9718	6.6
CN4835700000000	48	357	Ochiltree County, TX	1999	NA	5270	5053	217	4.1
CN4835900000000	48	359	Oldham County, TX	1999	NA	1231	1205	26	2.1
CN4836100000000	48	361	Orange County, TX	1999	NA	41793	37485	4308	10.3
CN4836300000000	48	363	Palo Pinto County, TX	1999	NA	12360	11833	527	4.3
CN4836500000000	48	365	Panola County, TX	1999	NA	8073	7272	801	9.9
CN4836700000000	48	367	Parker County, TX	1999	NA	42773	41599	1174	2.7
CN4836900000000	48	369	Parmer County, TX	1999	NA	4457	4342	115	2.6
CN4837100000000	48	371	Pecos County, TX	1999	NA	6721	6156	565	8.4
CN4837300000000	48	373	Polk County, TX	1999	NA	15055	14196	859	5.7
CN4837500000000	48	375	Potter County, TX	1999	NA	55586	52322	3264	5.9
CN4837700000000	48	377	Presidio County, TX	1999	NA	3493	2433	1060	30.3
CN4837900000000	48	379	Rains County, TX	1999	NA	3713	3569	144	3.9
CN4838100000000	48	381	Randall County, TX	1999	NA	57929	57087	842	1.5
CN4838300000000	48	383	Reagan County, TX	1999	NA	1888	1722	166	8.8
CN4838500000000	48	385	Real County, TX	1999	NA	1339	1294	45	3.4
CN4838700000000	48	387	Red River County, TX	1999	NA	5974	5678	296	5
CN4838900000000	48	389	Reeves County, TX	1999	NA	7293	6466	827	11.3
CN4839100000000	48	391	Refugio County, TX	1999	NA	2894	2734	160	5.5
CN4839300000000	48	393	Roberts County, TX	1999	NA	434	422	12	2.8
CN4839500000000	48	395	Robertson County, TX	1999	NA	6316	6019	297	4.7
CN4839700000000	48	397	Rockwall County, TX	1999	NA	22699	22228	471	2.1
CN4839900000000	48	399	Runnels County, TX	1999	NA	5184	4939	245	4.7
CN4840100000000	48	401	Rusk County, TX	1999	NA	21036	19805	1231	5.9
CN4840300000000	48	403	Sabine County, TX	1999	NA	4069	3671	398	9.8
CN4840500000000	48	405	San Augustine County, TX	1999	NA	3157	2950	207	6.6
CN4840700000000	48	407	San Jacinto County, TX	1999	NA	8606	8262	344	4
CN4840900000000	48	409	San Patricio County, TX	1999	NA	30157	28220	1937	6.4
CN4841100000000	48	411	San Saba County, TX	1999	NA	2575	2451	124	4.8
CN4841300000000	48	413	Schleicher County, TX	1999	NA	1497	1411	86	5.7
CN4841500000000	48	415	Scurry County, TX	1999	NA	7409	6813	596	8
CN4841700000000	48	417	Shackelford County, TX	1999	NA	1336	1266	70	5.2
CN4841900000000	48	419	Shelby County, TX	1999	NA	9362	8715	647	6.9
CN4842100000000	48	421	Sherman County, TX	1999	NA	1511	1491	20	1.3
CN4842300000000	48	423	Smith County, TX	1999	NA	90059	86177	3882	4.3
CN4842500000000	48	425	Somervell County, TX	1999	NA	2054	1943	111	5.4
CN4842700000000	48	427	Starr County, TX	1999	NA	21360	16078	5282	24.7
CN4842900000000	48	429	Stephens County, TX	1999	NA	4148	3962	186	4.5
CN4843100000000	48	431	Sterling County, TX	1999	NA	671	643	28	4.2
CN4843300000000	48	433	Stonewall County, TX	1999	NA	695	656	39	5.6
CN4843500000000	48	435	Sutton County, TX	1999	NA	2047	1898	149	7.3
CN4843700000000	48	437	Swisher County, TX	1999	NA	3600	3458	142	3.9
CN4843900000000	48	439	Tarrant County, TX	1999	NA	777430	753001	24429	3.1
CN4844100000000	48	441	Taylor County, TX	1999	NA	59807	57563	2244	3.8
CN4844300000000	48	443	Terrell County, TX	1999	NA	705	675	30	4.3
CN4844500000000	48	445	Terry County, TX	1999	NA	5634	5233	401	7.1
CN4844700000000	48	447	Throckmorton County, TX	1999	NA	742	720	22	3
CN4844900000000	48	449	Titus County, TX	1999	NA	12650	11924	726	5.7
CN4845100000000	48	451	Tom Green County, TX	1999	NA	50321	48138	2183	4.3
CN4845300000000	48	453	Travis County, TX	1999	NA	464021	453127	10894	2.3
CN4845500000000	48	455	Trinity County, TX	1999	NA	5801	5495	306	5.3
CN4845700000000	48	457	Tyler County, TX	1999	NA	6440	5862	578	9
CN4845900000000	48	459	Upshur County, TX	1999	NA	17040	15982	1058	6.2
CN4846100000000	48	461	Upton County, TX	1999	NA	1574	1453	121	7.7
CN4846300000000	48	463	Uvalde County, TX	1999	NA	11016	10126	890	8.1
CN4846500000000	48	465	Val Verde County, TX	1999	NA	18129	16596	1533	8.5
CN4846700000000	48	467	Van Zandt County, TX	1999	NA	20470	19785	685	3.3
CN4846900000000	48	469	Victoria County, TX	1999	NA	43261	41438	1823	4.2
CN4847100000000	48	471	Walker County, TX	1999	NA	23469	22958	511	2.2
CN4847300000000	48	473	Waller County, TX	1999	NA	12906	12225	681	5.3
CN4847500000000	48	475	Ward County, TX	1999	NA	4357	3843	514	11.8
CN4847700000000	48	477	Washington County, TX	1999	NA	14916	14509	407	2.7
CN4847900000000	48	479	Webb County, TX	1999	NA	72932	66647	6285	8.6
CN4848100000000	48	481	Wharton County, TX	1999	NA	19379	18323	1056	5.4
CN4848300000000	48	483	Wheeler County, TX	1999	NA	2753	2633	120	4.4
CN4848500000000	48	485	Wichita County, TX	1999	NA	60137	57249	2888	4.8
CN4848700000000	48	487	Wilbarger County, TX	1999	NA	7427	7240	187	2.5
CN4848900000000	48	489	Willacy County, TX	1999	NA	6913	5757	1156	16.7
CN4849100000000	48	491	Williamson County, TX	1999	NA	148450	146034	2416	1.6
CN4849300000000	48	493	Wilson County, TX	1999	NA	15678	15269	409	2.6
CN4849500000000	48	495	Winkler County, TX	1999	NA	3052	2634	418	13.7
CN4849700000000	48	497	Wise County, TX	1999	NA	23426	22745	681	2.9
CN4849900000000	48	499	Wood County, TX	1999	NA	13960	13267	693	5
CN4850100000000	48	501	Yoakum County, TX	1999	NA	3567	3217	350	9.8
CN4850300000000	48	503	Young County, TX	1999	NA	8243	7800	443	5.4
CN4850500000000	48	505	Zapata County, TX	1999	NA	4560	3951	609	13.4
CN4850700000000	48	507	Zavala County, TX	1999	NA	4203	3470	733	17.4
CN4900100000000	49	001	Beaver County, UT	1999	NA	2461	2371	90	3.7
CN4900300000000	49	003	Box Elder County, UT	1999	NA	18327	17500	827	4.5
CN4900500000000	49	005	Cache County, UT	1999	NA	45162	43988	1174	2.6
CN4900700000000	49	007	Carbon County, UT	1999	NA	9886	9222	664	6.7
CN4900900000000	49	009	Daggett County, UT	1999	NA	447	432	15	3.4
CN4901100000000	49	011	Davis County, UT	1999	NA	124606	120604	4002	3.2
CN4901300000000	49	013	Duchesne County, UT	1999	NA	5950	5411	539	9.1
CN4901500000000	49	015	Emery County, UT	1999	NA	4024	3741	283	7
CN4901700000000	49	017	Garfield County, UT	1999	NA	2878	2657	221	7.7
CN4901900000000	49	019	Grand County, UT	1999	NA	5568	5217	351	6.3
CN4902100000000	49	021	Iron County, UT	1999	NA	15116	14583	533	3.5
CN4902300000000	49	023	Juab County, UT	1999	NA	3611	3439	172	4.8
CN4902500000000	49	025	Kane County, UT	1999	NA	2800	2696	104	3.7
CN4902700000000	49	027	Millard County, UT	1999	NA	4643	4447	196	4.2
CN4902900000000	49	029	Morgan County, UT	1999	NA	3563	3424	139	3.9
CN4903100000000	49	031	Piute County, UT	1999	NA	539	507	32	5.9
CN4903300000000	49	033	Rich County, UT	1999	NA	992	957	35	3.5
CN4903500000000	49	035	Salt Lake County, UT	1999	NA	490026	474240	15786	3.2
CN4903700000000	49	037	San Juan County, UT	1999	NA	5032	4652	380	7.6
CN4903900000000	49	039	Sanpete County, UT	1999	NA	8957	8486	471	5.3
CN4904100000000	49	041	Sevier County, UT	1999	NA	8436	8092	344	4.1
CN4904300000000	49	043	Summit County, UT	1999	NA	14700	14021	679	4.6
CN4904500000000	49	045	Tooele County, UT	1999	NA	12264	11619	645	5.3
CN4904700000000	49	047	Uintah County, UT	1999	NA	11175	10420	755	6.8
CN4904900000000	49	049	Utah County, UT	1999	NA	170285	165233	5052	3
CN4905100000000	49	051	Wasatch County, UT	1999	NA	6436	6128	308	4.8
CN4905300000000	49	053	Washington County, UT	1999	NA	38714	37380	1334	3.4
CN4905500000000	49	055	Wayne County, UT	1999	NA	1485	1403	82	5.5
CN4905700000000	49	057	Weber County, UT	1999	NA	102837	98407	4430	4.3
CN5000100000000	50	001	Addison County, VT	1999	NA	20243	19620	623	3.1
CN5000300000000	50	003	Bennington County, VT	1999	NA	20480	19752	728	3.6
CN5000500000000	50	005	Caledonia County, VT	1999	NA	15261	14654	607	4
CN5000700000000	50	007	Chittenden County, VT	1999	NA	90556	88876	1680	1.9
CN5000900000000	50	009	Essex County, VT	1999	NA	2911	2745	166	5.7
CN5001100000000	50	011	Franklin County, VT	1999	NA	23879	23175	704	2.9
CN5001300000000	50	013	Grand Isle County, VT	1999	NA	3502	3337	165	4.7
CN5001500000000	50	015	Lamoille County, VT	1999	NA	11993	11521	472	3.9
CN5001700000000	50	017	Orange County, VT	1999	NA	15923	15557	366	2.3
CN5001900000000	50	019	Orleans County, VT	1999	NA	12536	11786	750	6
CN5002100000000	50	021	Rutland County, VT	1999	NA	32059	30861	1198	3.7
CN5002300000000	50	023	Washington County, VT	1999	NA	31919	30878	1041	3.3
CN5002500000000	50	025	Windham County, VT	1999	NA	23678	23021	657	2.8
CN5002700000000	50	027	Windsor County, VT	1999	NA	31986	31196	790	2.5
CN5100100000000	51	001	Accomack County, VA	1999	NA	14764	13823	941	6.4
CN5100300000000	51	003	Albemarle County, VA	1999	NA	39966	39520	446	1.1
CN5100500000000	51	005	Alleghany County, VA	1999	NA	8202	7737	465	5.7
CN5100700000000	51	007	Amelia County, VA	1999	NA	5140	5013	127	2.5
CN5100900000000	51	009	Amherst County, VA	1999	NA	14688	14431	257	1.7
CN5101100000000	51	011	Appomattox County, VA	1999	NA	5421	5207	214	3.9
CN5101300000000	51	013	Arlington County, VA	1999	NA	106826	105149	1677	1.6
CN5101500000000	51	015	Augusta County, VA	1999	NA	31895	31150	745	2.3
CN5101700000000	51	017	Bath County, VA	1999	NA	2392	2280	112	4.7
CN5101900000000	51	019	Bedford County, VA	1999	NA	33508	32840	668	2
CN5102100000000	51	021	Bland County, VA	1999	NA	3479	3325	154	4.4
CN5102300000000	51	023	Botetourt County, VA	1999	NA	16673	16376	297	1.8
CN5102500000000	51	025	Brunswick County, VA	1999	NA	7673	7364	309	4
CN5102700000000	51	027	Buchanan County, VA	1999	NA	8373	7218	1155	13.8
CN5102900000000	51	029	Buckingham County, VA	1999	NA	6004	5757	247	4.1
CN5103100000000	51	031	Campbell County, VA	1999	NA	26510	25931	579	2.2
CN5103300000000	51	033	Caroline County, VA	1999	NA	10572	10226	346	3.3
CN5103500000000	51	035	Carroll County, VA	1999	NA	13957	13018	939	6.7
CN5103600000000	51	036	Charles City County, VA	1999	NA	3759	3656	103	2.7
CN5103700000000	51	037	Charlotte County, VA	1999	NA	6072	5883	189	3.1
CN5104100000000	51	041	Chesterfield County, VA	1999	NA	141187	138501	2686	1.9
CN5104300000000	51	043	Clarke County, VA	1999	NA	6495	6399	96	1.5
CN5104500000000	51	045	Craig County, VA	1999	NA	2080	1992	88	4.2
CN5104700000000	51	047	Culpeper County, VA	1999	NA	16259	15936	323	2
CN5104900000000	51	049	Cumberland County, VA	1999	NA	3794	3720	74	2
CN5105100000000	51	051	Dickenson County, VA	1999	NA	5392	4725	667	12.4
CN5105300000000	51	053	Dinwiddie County, VA	1999	NA	12144	11839	305	2.5
CN5105700000000	51	057	Essex County, VA	1999	NA	4372	4174	198	4.5
CN5105900000000	51	059	Fairfax County, VA	1999	NA	537477	529145	8332	1.6
CN5106100000000	51	061	Fauquier County, VA	1999	NA	28561	28148	413	1.4
CN5106300000000	51	063	Floyd County, VA	1999	NA	6791	6493	298	4.4
CN5106500000000	51	065	Fluvanna County, VA	1999	NA	9641	9532	109	1.1
CN5106700000000	51	067	Franklin County, VA	1999	NA	25148	24132	1016	4
CN5106900000000	51	069	Frederick County, VA	1999	NA	32645	31971	674	2.1
CN5107100000000	51	071	Giles County, VA	1999	NA	8437	7923	514	6.1
CN5107300000000	51	073	Gloucester County, VA	1999	NA	18054	17636	418	2.3
CN5107500000000	51	075	Goochland County, VA	1999	NA	9097	8946	151	1.7
CN5107700000000	51	077	Grayson County, VA	1999	NA	8273	7802	471	5.7
CN5107900000000	51	079	Greene County, VA	1999	NA	7715	7607	108	1.4
CN5108100000000	51	081	Greensville County, VA	1999	NA	5416	5254	162	3
CN5108300000000	51	083	Halifax County, VA	1999	NA	18403	17242	1161	6.3
CN5108500000000	51	085	Hanover County, VA	1999	NA	47513	46814	699	1.5
CN5108700000000	51	087	Henrico County, VA	1999	NA	138799	136128	2671	1.9
CN5108900000000	51	089	Henry County, VA	1999	NA	27586	25835	1751	6.3
CN5109100000000	51	091	Highland County, VA	1999	NA	1263	1230	33	2.6
CN5109300000000	51	093	Isle of Wight County, VA	1999	NA	15146	14746	400	2.6
CN5109500000000	51	095	James City County, VA	1999	NA	25120	24632	488	1.9
CN5109700000000	51	097	King and Queen County, VA	1999	NA	2913	2822	91	3.1
CN5109900000000	51	099	King George County, VA	1999	NA	8653	8488	165	1.9
CN5110100000000	51	101	King William County, VA	1999	NA	6275	6125	150	2.4
CN5110300000000	51	103	Lancaster County, VA	1999	NA	5159	4662	497	9.6
CN5110500000000	51	105	Lee County, VA	1999	NA	9557	8711	846	8.9
CN5110700000000	51	107	Loudoun County, VA	1999	NA	90500	89503	997	1.1
CN5110900000000	51	109	Louisa County, VA	1999	NA	9651	9315	336	3.5
CN5111100000000	51	111	Lunenburg County, VA	1999	NA	4779	4550	229	4.8
CN5111300000000	51	113	Madison County, VA	1999	NA	8747	8595	152	1.7
CN5111500000000	51	115	Mathews County, VA	1999	NA	4647	4545	102	2.2
CN5111700000000	51	117	Mecklenburg County, VA	1999	NA	15040	14238	802	5.3
CN5111900000000	51	119	Middlesex County, VA	1999	NA	5098	4990	108	2.1
CN5112100000000	51	121	Montgomery County, VA	1999	NA	37763	37075	688	1.8
CN5112500000000	51	125	Nelson County, VA	1999	NA	7233	7077	156	2.2
CN5112700000000	51	127	New Kent County, VA	1999	NA	6938	6805	133	1.9
CN5113100000000	51	131	Northampton County, VA	1999	NA	5276	5041	235	4.5
CN5113300000000	51	133	Northumberland County, VA	1999	NA	5315	4908	407	7.7
CN5113500000000	51	135	Nottoway County, VA	1999	NA	6743	6560	183	2.7
CN5113700000000	51	137	Orange County, VA	1999	NA	11028	10753	275	2.5
CN5113900000000	51	139	Page County, VA	1999	NA	11966	11492	474	4
CN5114100000000	51	141	Patrick County, VA	1999	NA	8983	8494	489	5.4
CN5114300000000	51	143	Pittsylvania County, VA	1999	NA	31410	29596	1814	5.8
CN5114500000000	51	145	Powhatan County, VA	1999	NA	11141	10965	176	1.6
CN5114700000000	51	147	Prince Edward County, VA	1999	NA	8167	7881	286	3.5
CN5114900000000	51	149	Prince George County, VA	1999	NA	12099	11755	344	2.8
CN5115300000000	51	153	Prince William County, VA	1999	NA	142289	139606	2683	1.9
CN5115500000000	51	155	Pulaski County, VA	1999	NA	16978	16233	745	4.4
CN5115700000000	51	157	Rappahannock County, VA	1999	NA	3991	3912	79	2
CN5115900000000	51	159	Richmond County, VA	1999	NA	4036	3854	182	4.5
CN5116100000000	51	161	Roanoke County, VA	1999	NA	47875	47244	631	1.3
CN5116300000000	51	163	Rockbridge County, VA	1999	NA	10241	10029	212	2.1
CN5116500000000	51	165	Rockingham County, VA	1999	NA	37456	36985	471	1.3
CN5116700000000	51	167	Russell County, VA	1999	NA	14109	12951	1158	8.2
CN5116900000000	51	169	Scott County, VA	1999	NA	9261	8656	605	6.5
CN5117100000000	51	171	Shenandoah County, VA	1999	NA	17574	17081	493	2.8
CN5117300000000	51	173	Smyth County, VA	1999	NA	16558	15558	1000	6
CN5117500000000	51	175	Southampton County, VA	1999	NA	8536	8260	276	3.2
CN5117700000000	51	177	Spotsylvania County, VA	1999	NA	44530	43834	696	1.6
CN5117900000000	51	179	Stafford County, VA	1999	NA	46699	46004	695	1.5
CN5118100000000	51	181	Surry County, VA	1999	NA	2405	2221	184	7.7
CN5118300000000	51	183	Sussex County, VA	1999	NA	6277	6094	183	2.9
CN5118500000000	51	185	Tazewell County, VA	1999	NA	19524	18153	1371	7
CN5118700000000	51	187	Warren County, VA	1999	NA	15065	14668	397	2.6
CN5119100000000	51	191	Washington County, VA	1999	NA	24868	23743	1125	4.5
CN5119300000000	51	193	Westmoreland County, VA	1999	NA	7343	6967	376	5.1
CN5119500000000	51	195	Wise County, VA	1999	NA	14812	13478	1334	9
CN5119700000000	51	197	Wythe County, VA	1999	NA	14276	13695	581	4.1
CN5119900000000	51	199	York County, VA	1999	NA	28782	28206	576	2
CN5151000000000	51	510	Alexandria city, VA	1999	NA	74455	72803	1652	2.2
CN5152000000000	51	520	Bristol city, VA	1999	NA	7665	7390	275	3.6
CN5153000000000	51	530	Buena Vista city, VA	1999	NA	3380	3291	89	2.6
CN5154000000000	51	540	Charlottesville city, VA	1999	NA	18182	17864	318	1.7
CN5155000000000	51	550	Chesapeake city, VA	1999	NA	106288	103558	2730	2.6
CN5157000000000	51	570	Colonial Heights city, VA	1999	NA	8409	8201	208	2.5
CN5158000000000	51	580	Covington city, VA	1999	NA	3315	3068	247	7.5
CN5159000000000	51	590	Danville city, VA	1999	NA	25213	23571	1642	6.5
CN5159500000000	51	595	Emporia city, VA	1999	NA	2500	2384	116	4.6
CN5160000000000	51	600	Fairfax city, VA	1999	NA	12315	12206	109	0.9
CN5161000000000	51	610	Falls Church city, VA	1999	NA	5826	5751	75	1.3
CN5162000000000	51	620	Franklin city, VA	1999	NA	3969	3795	174	4.4
CN5163000000000	51	630	Fredericksburg city, VA	1999	NA	9543	9264	279	2.9
CN5164000000000	51	640	Galax city, VA	1999	NA	3236	3093	143	4.4
CN5165000000000	51	650	Hampton city, VA	1999	NA	66364	63731	2633	4
CN5166000000000	51	660	Harrisonburg city, VA	1999	NA	18640	18402	238	1.3
CN5167000000000	51	670	Hopewell city, VA	1999	NA	10669	10233	436	4.1
CN5167800000000	51	678	Lexington city, VA	1999	NA	3013	2969	44	1.5
CN5168000000000	51	680	Lynchburg city, VA	1999	NA	29665	29036	629	2.1
CN5168300000000	51	683	Manassas city, VA	1999	NA	18816	18512	304	1.6
CN5168500000000	51	685	Manassas Park city, VA	1999	NA	4263	4209	54	1.3
CN5169000000000	51	690	Martinsville city, VA	1999	NA	6830	6151	679	9.9
CN5170000000000	51	700	Newport News city, VA	1999	NA	84368	81028	3340	4
CN5171000000000	51	710	Norfolk city, VA	1999	NA	83551	79262	4289	5.1
CN5172000000000	51	720	Norton city, VA	1999	NA	1448	1339	109	7.5
CN5173000000000	51	730	Petersburg city, VA	1999	NA	15618	14805	813	5.2
CN5173500000000	51	735	Poquoson city, VA	1999	NA	6117	5983	134	2.2
CN5174000000000	51	740	Portsmouth city, VA	1999	NA	44225	42031	2194	5
CN5175000000000	51	750	Radford city, VA	1999	NA	6634	6451	183	2.8
CN5176000000000	51	760	Richmond city, VA	1999	NA	93603	90403	3200	3.4
CN5177000000000	51	770	Roanoke city, VA	1999	NA	48810	47564	1246	2.6
CN5177500000000	51	775	Salem city, VA	1999	NA	13422	13208	214	1.6
CN5179000000000	51	790	Staunton city, VA	1999	NA	11494	11235	259	2.3
CN5180000000000	51	800	Suffolk city, VA	1999	NA	30736	29686	1050	3.4
CN5181000000000	51	810	Virginia Beach city, VA	1999	NA	211899	206331	5568	2.6
CN5182000000000	51	820	Waynesboro city, VA	1999	NA	9257	8997	260	2.8
CN5183000000000	51	830	Williamsburg city, VA	1999	NA	6130	5782	348	5.7
CN5184000000000	51	840	Winchester city, VA	1999	NA	12977	12654	323	2.5
CN5300100000000	53	001	Adams County, WA	1999	NA	8915	7962	953	10.7
CN5300300000000	53	003	Asotin County, WA	1999	NA	12820	12381	439	3.4
CN5300500000000	53	005	Benton County, WA	1999	NA	75019	70789	4230	5.6
CN5300700000000	53	007	Chelan County, WA	1999	NA	36065	32905	3160	8.8
CN5300900000000	53	009	Clallam County, WA	1999	NA	26584	24643	1941	7.3
CN5301100000000	53	011	Clark County, WA	1999	NA	188637	181075	7562	4
CN5301300000000	53	013	Columbia County, WA	1999	NA	1572	1388	184	11.7
CN5301500000000	53	015	Cowlitz County, WA	1999	NA	43823	40694	3129	7.1
CN5301700000000	53	017	Douglas County, WA	1999	NA	20089	18697	1392	6.9
CN5301900000000	53	019	Ferry County, WA	1999	NA	2730	2425	305	11.2
CN5302100000000	53	021	Franklin County, WA	1999	NA	23876	21587	2289	9.6
CN5302300000000	53	023	Garfield County, WA	1999	NA	1129	1086	43	3.8
CN5302500000000	53	025	Grant County, WA	1999	NA	39500	35749	3751	9.5
CN5302700000000	53	027	Grays Harbor County, WA	1999	NA	27359	25050	2309	8.4
CN5302900000000	53	029	Island County, WA	1999	NA	31034	29843	1191	3.8
CN5303100000000	53	031	Jefferson County, WA	1999	NA	11431	10759	672	5.9
CN5303300000000	53	033	King County, WA	1999	NA	979108	946876	32232	3.3
CN5303500000000	53	035	Kitsap County, WA	1999	NA	99009	94047	4962	5
CN5303700000000	53	037	Kittitas County, WA	1999	NA	15543	14665	878	5.6
CN5303900000000	53	039	Klickitat County, WA	1999	NA	9087	8212	875	9.6
CN5304100000000	53	041	Lewis County, WA	1999	NA	31387	28696	2691	8.6
CN5304300000000	53	043	Lincoln County, WA	1999	NA	4913	4662	251	5.1
CN5304500000000	53	045	Mason County, WA	1999	NA	20337	19030	1307	6.4
CN5304700000000	53	047	Okanogan County, WA	1999	NA	22446	20231	2215	9.9
CN5304900000000	53	049	Pacific County, WA	1999	NA	8142	7433	709	8.7
CN5305100000000	53	051	Pend Oreille County, WA	1999	NA	4417	3966	451	10.2
CN5305300000000	53	053	Pierce County, WA	1999	NA	349193	333096	16097	4.6
CN5305500000000	53	055	San Juan County, WA	1999	NA	6808	6555	253	3.7
CN5305700000000	53	057	Skagit County, WA	1999	NA	52771	49404	3367	6.4
CN5305900000000	53	059	Skamania County, WA	1999	NA	4260	3895	365	8.6
CN5306100000000	53	061	Snohomish County, WA	1999	NA	329780	316441	13339	4
CN5306300000000	53	063	Spokane County, WA	1999	NA	221051	209374	11677	5.3
CN5306500000000	53	065	Stevens County, WA	1999	NA	17707	16157	1550	8.8
CN5306700000000	53	067	Thurston County, WA	1999	NA	106852	101933	4919	4.6
CN5306900000000	53	069	Wahkiakum County, WA	1999	NA	1997	1865	132	6.6
CN5307100000000	53	071	Walla Walla County, WA	1999	NA	27689	25815	1874	6.8
CN5307300000000	53	073	Whatcom County, WA	1999	NA	86046	81556	4490	5.2
CN5307500000000	53	075	Whitman County, WA	1999	NA	19806	19441	365	1.8
CN5307700000000	53	077	Yakima County, WA	1999	NA	116615	104823	11792	10.1
CN5400100000000	54	001	Barbour County, WV	1999	NA	6109	5452	657	10.8
CN5400300000000	54	003	Berkeley County, WV	1999	NA	35201	33939	1262	3.6
CN5400500000000	54	005	Boone County, WV	1999	NA	8034	7157	877	10.9
CN5400700000000	54	007	Braxton County, WV	1999	NA	5274	4716	558	10.6
CN5400900000000	54	009	Brooke County, WV	1999	NA	11386	10692	694	6.1
CN5401100000000	54	011	Cabell County, WV	1999	NA	42798	40636	2162	5.1
CN5401300000000	54	013	Calhoun County, WV	1999	NA	2637	2178	459	17.4
CN5401500000000	54	015	Clay County, WV	1999	NA	4233	3777	456	10.8
CN5401700000000	54	017	Doddridge County, WV	1999	NA	3286	3093	193	5.9
CN5401900000000	54	019	Fayette County, WV	1999	NA	17412	15662	1750	10.1
CN5402100000000	54	021	Gilmer County, WV	1999	NA	2653	2403	250	9.4
CN5402300000000	54	023	Grant County, WV	1999	NA	4433	4061	372	8.4
CN5402500000000	54	025	Greenbrier County, WV	1999	NA	15515	14267	1248	8
CN5402700000000	54	027	Hampshire County, WV	1999	NA	8724	8310	414	4.7
CN5402900000000	54	029	Hancock County, WV	1999	NA	15115	14181	934	6.2
CN5403100000000	54	031	Hardy County, WV	1999	NA	7293	7011	282	3.9
CN5403300000000	54	033	Harrison County, WV	1999	NA	34433	32086	2347	6.8
CN5403500000000	54	035	Jackson County, WV	1999	NA	12723	11786	937	7.4
CN5403700000000	54	037	Jefferson County, WV	1999	NA	21467	20864	603	2.8
CN5403900000000	54	039	Kanawha County, WV	1999	NA	105902	101002	4900	4.6
CN5404100000000	54	041	Lewis County, WV	1999	NA	7116	6543	573	8.1
CN5404300000000	54	043	Lincoln County, WV	1999	NA	6982	6171	811	11.6
CN5404500000000	54	045	Logan County, WV	1999	NA	13181	11600	1581	12
CN5404700000000	54	047	McDowell County, WV	1999	NA	7469	6410	1059	14.2
CN5404900000000	54	049	Marion County, WV	1999	NA	24033	22156	1877	7.8
CN5405100000000	54	051	Marshall County, WV	1999	NA	16124	15116	1008	6.3
CN5405300000000	54	053	Mason County, WV	1999	NA	9026	7854	1172	13
CN5405500000000	54	055	Mercer County, WV	1999	NA	28232	26888	1344	4.8
CN5405700000000	54	057	Mineral County, WV	1999	NA	12444	11579	865	7
CN5405900000000	54	059	Mingo County, WV	1999	NA	8503	7255	1248	14.7
CN5406100000000	54	061	Monongalia County, WV	1999	NA	38622	37342	1280	3.3
CN5406300000000	54	063	Monroe County, WV	1999	NA	5329	5104	225	4.2
CN5406500000000	54	065	Morgan County, WV	1999	NA	6153	5998	155	2.5
CN5406700000000	54	067	Nicholas County, WV	1999	NA	10909	9870	1039	9.5
CN5406900000000	54	069	Ohio County, WV	1999	NA	24397	23419	978	4
CN5407100000000	54	071	Pendleton County, WV	1999	NA	3971	3791	180	4.5
CN5407300000000	54	073	Pleasants County, WV	1999	NA	2827	2584	243	8.6
CN5407500000000	54	075	Pocahontas County, WV	1999	NA	4278	3914	364	8.5
CN5407700000000	54	077	Preston County, WV	1999	NA	12762	11982	780	6.1
CN5407900000000	54	079	Putnam County, WV	1999	NA	27397	26147	1250	4.6
CN5408100000000	54	081	Raleigh County, WV	1999	NA	34799	32295	2504	7.2
CN5408300000000	54	083	Randolph County, WV	1999	NA	13590	12589	1001	7.4
CN5408500000000	54	085	Ritchie County, WV	1999	NA	4305	3893	412	9.6
CN5408700000000	54	087	Roane County, WV	1999	NA	6188	5438	750	12.1
CN5408900000000	54	089	Summers County, WV	1999	NA	4337	3947	390	9
CN5409100000000	54	091	Taylor County, WV	1999	NA	7037	6494	543	7.7
CN5409300000000	54	093	Tucker County, WV	1999	NA	3443	3132	311	9
CN5409500000000	54	095	Tyler County, WV	1999	NA	4244	3934	310	7.3
CN5409700000000	54	097	Upshur County, WV	1999	NA	10383	9612	771	7.4
CN5409900000000	54	099	Wayne County, WV	1999	NA	16930	15896	1034	6.1
CN5410100000000	54	101	Webster County, WV	1999	NA	3061	2770	291	9.5
CN5410300000000	54	103	Wetzel County, WV	1999	NA	7772	6950	822	10.6
CN5410500000000	54	105	Wirt County, WV	1999	NA	1965	1679	286	14.6
CN5410700000000	54	107	Wood County, WV	1999	NA	43721	41420	2301	5.3
CN5410900000000	54	109	Wyoming County, WV	1999	NA	8193	7338	855	10.4
CN5500100000000	55	001	Adams County, WI	1999	NA	7976	7670	306	3.8
CN5500300000000	55	003	Ashland County, WI	1999	NA	7821	7225	596	7.6
CN5500500000000	55	005	Barron County, WI	1999	NA	23733	22786	947	4
CN5500700000000	55	007	Bayfield County, WI	1999	NA	7343	6914	429	5.8
CN5500900000000	55	009	Brown County, WI	1999	NA	135432	132228	3204	2.4
CN5501100000000	55	011	Buffalo County, WI	1999	NA	7888	7652	236	3
CN5501300000000	55	013	Burnett County, WI	1999	NA	7088	6758	330	4.7
CN5501500000000	55	015	Calumet County, WI	1999	NA	25168	24584	584	2.3
CN5501700000000	55	017	Chippewa County, WI	1999	NA	30797	29643	1154	3.7
CN5501900000000	55	019	Clark County, WI	1999	NA	15819	15022	797	5
CN5502100000000	55	021	Columbia County, WI	1999	NA	26770	25737	1033	3.9
CN5502300000000	55	023	Crawford County, WI	1999	NA	9977	9603	374	3.7
CN5502500000000	55	025	Dane County, WI	1999	NA	263633	259933	3700	1.4
CN5502700000000	55	027	Dodge County, WI	1999	NA	48037	46806	1231	2.6
CN5502900000000	55	029	Door County, WI	1999	NA	15529	14838	691	4.4
CN5503100000000	55	031	Douglas County, WI	1999	NA	22650	21692	958	4.2
CN5503300000000	55	033	Dunn County, WI	1999	NA	21990	21306	684	3.1
CN5503500000000	55	035	Eau Claire County, WI	1999	NA	52295	50878	1417	2.7
CN5503700000000	55	037	Florence County, WI	1999	NA	1746	1629	117	6.7
CN5503900000000	55	039	Fond du Lac County, WI	1999	NA	54172	52638	1534	2.8
CN5504100000000	55	041	Forest County, WI	1999	NA	4473	4234	239	5.3
CN5504300000000	55	043	Grant County, WI	1999	NA	24085	23226	859	3.6
CN5504500000000	55	045	Green County, WI	1999	NA	18322	17722	600	3.3
CN5504700000000	55	047	Green Lake County, WI	1999	NA	10495	10065	430	4.1
CN5504900000000	55	049	Iowa County, WI	1999	NA	13665	13251	414	3
CN5505100000000	55	051	Iron County, WI	1999	NA	3267	3072	195	6
CN5505300000000	55	053	Jackson County, WI	1999	NA	12511	12100	411	3.3
CN5505500000000	55	055	Jefferson County, WI	1999	NA	42156	41113	1043	2.5
CN5505700000000	55	057	Juneau County, WI	1999	NA	10615	9897	718	6.8
CN5505900000000	55	059	Kenosha County, WI	1999	NA	82020	79303	2717	3.3
CN5506100000000	55	061	Kewaunee County, WI	1999	NA	10598	10296	302	2.8
CN5506300000000	55	063	La Crosse County, WI	1999	NA	60376	58572	1804	3
CN5506500000000	55	065	Lafayette County, WI	1999	NA	7573	7297	276	3.6
CN5506700000000	55	067	Langlade County, WI	1999	NA	9305	8815	490	5.3
CN5506900000000	55	069	Lincoln County, WI	1999	NA	14602	13921	681	4.7
CN5507100000000	55	071	Manitowoc County, WI	1999	NA	44588	42966	1622	3.6
CN5507300000000	55	073	Marathon County, WI	1999	NA	73316	71109	2207	3
CN5507500000000	55	075	Marinette County, WI	1999	NA	21198	20192	1006	4.7
CN5507700000000	55	077	Marquette County, WI	1999	NA	7008	6634	374	5.3
CN5507800000000	55	078	Menominee County, WI	1999	NA	2547	2348	199	7.8
CN5507900000000	55	079	Milwaukee County, WI	1999	NA	478839	460114	18725	3.9
CN5508100000000	55	081	Monroe County, WI	1999	NA	19652	18871	781	4
CN5508300000000	55	083	Oconto County, WI	1999	NA	15804	15091	713	4.5
CN5508500000000	55	085	Oneida County, WI	1999	NA	20435	19524	911	4.5
CN5508700000000	55	087	Outagamie County, WI	1999	NA	101750	99146	2604	2.6
CN5508900000000	55	089	Ozaukee County, WI	1999	NA	48958	48014	944	1.9
CN5509100000000	55	091	Pepin County, WI	1999	NA	3237	3105	132	4.1
CN5509300000000	55	093	Pierce County, WI	1999	NA	20680	20152	528	2.6
CN5509500000000	55	095	Polk County, WI	1999	NA	22050	21229	821	3.7
CN5509700000000	55	097	Portage County, WI	1999	NA	36952	35712	1240	3.4
CN5509900000000	55	099	Price County, WI	1999	NA	7119	6623	496	7
CN5510100000000	55	101	Racine County, WI	1999	NA	92773	88596	4177	4.5
CN5510300000000	55	103	Richland County, WI	1999	NA	8363	8067	296	3.5
CN5510500000000	55	105	Rock County, WI	1999	NA	79257	76014	3243	4.1
CN5510700000000	55	107	Rusk County, WI	1999	NA	7146	6804	342	4.8
CN5510900000000	55	109	St. Croix County, WI	1999	NA	33639	32839	800	2.4
CN5511100000000	55	111	Sauk County, WI	1999	NA	34318	33360	958	2.8
CN5511300000000	55	113	Sawyer County, WI	1999	NA	9326	8833	493	5.3
CN5511500000000	55	115	Shawano County, WI	1999	NA	20276	19546	730	3.6
CN5511700000000	55	117	Sheboygan County, WI	1999	NA	62034	60766	1268	2
CN5511900000000	55	119	Taylor County, WI	1999	NA	10320	9909	411	4
CN5512100000000	55	121	Trempealeau County, WI	1999	NA	14149	13607	542	3.8
CN5512300000000	55	123	Vernon County, WI	1999	NA	13684	13131	553	4
CN5512500000000	55	125	Vilas County, WI	1999	NA	11233	10740	493	4.4
CN5512700000000	55	127	Walworth County, WI	1999	NA	52978	51679	1299	2.5
CN5512900000000	55	129	Washburn County, WI	1999	NA	7835	7383	452	5.8
CN5513100000000	55	131	Washington County, WI	1999	NA	68411	66845	1566	2.3
CN5513300000000	55	133	Waukesha County, WI	1999	NA	215611	211022	4589	2.1
CN5513500000000	55	135	Waupaca County, WI	1999	NA	26100	25223	877	3.4
CN5513700000000	55	137	Waushara County, WI	1999	NA	10366	9889	477	4.6
CN5513900000000	55	139	Winnebago County, WI	1999	NA	95565	93371	2194	2.3
CN5514100000000	55	141	Wood County, WI	1999	NA	39807	38333	1474	3.7
CN5600100000000	56	001	Albany County, WY	1999	NA	18323	18002	321	1.8
CN5600300000000	56	003	Big Horn County, WY	1999	NA	5793	5431	362	6.2
CN5600500000000	56	005	Campbell County, WY	1999	NA	19684	18714	970	4.9
CN5600700000000	56	007	Carbon County, WY	1999	NA	8407	7985	422	5
CN5600900000000	56	009	Converse County, WY	1999	NA	6669	6340	329	4.9
CN5601100000000	56	011	Crook County, WY	1999	NA	3069	2922	147	4.8
CN5601300000000	56	013	Fremont County, WY	1999	NA	18020	16706	1314	7.3
CN5601500000000	56	015	Goshen County, WY	1999	NA	6536	6303	233	3.6
CN5601700000000	56	017	Hot Springs County, WY	1999	NA	2438	2318	120	4.9
CN5601900000000	56	019	Johnson County, WY	1999	NA	3918	3788	130	3.3
CN5602100000000	56	021	Laramie County, WY	1999	NA	40063	38724	1339	3.3
CN5602300000000	56	023	Lincoln County, WY	1999	NA	6627	6240	387	5.8
CN5602500000000	56	025	Natrona County, WY	1999	NA	33822	32066	1756	5.2
CN5602700000000	56	027	Niobrara County, WY	1999	NA	1330	1294	36	2.7
CN5602900000000	56	029	Park County, WY	1999	NA	15401	14725	676	4.4
CN5603100000000	56	031	Platte County, WY	1999	NA	4660	4462	198	4.2
CN5603300000000	56	033	Sheridan County, WY	1999	NA	13724	13084	640	4.7
CN5603500000000	56	035	Sublette County, WY	1999	NA	3149	3037	112	3.6
CN5603700000000	56	037	Sweetwater County, WY	1999	NA	20664	19433	1231	6
CN5603900000000	56	039	Teton County, WY	1999	NA	11675	11424	251	2.1
CN5604100000000	56	041	Uinta County, WY	1999	NA	10528	9828	700	6.6
CN5604300000000	56	043	Washakie County, WY	1999	NA	4891	4588	303	6.2
CN5604500000000	56	045	Weston County, WY	1999	NA	3367	3190	177	5.3
CN7200100000000	72	001	Adjuntas Municipio, PR	1999	NA	5396	4510	886	16.4
CN7200300000000	72	003	Aguada Municipio, PR	1999	NA	13954	11517	2437	17.5
CN7200500000000	72	005	Aguadilla Municipio, PR	1999	NA	20088	16759	3329	16.6
CN7200700000000	72	007	Aguas Buenas Municipio, PR	1999	NA	9301	8340	961	10.3
CN7200900000000	72	009	Aibonito Municipio, PR	1999	NA	10018	9062	956	9.5
CN7201100000000	72	011	Anasco Municipio, PR	1999	NA	10735	8830	1905	17.7
CN7201300000000	72	013	Arecibo Municipio, PR	1999	NA	29934	25675	4259	14.2
CN7201500000000	72	015	Arroyo Municipio, PR	1999	NA	5173	4316	857	16.6
CN7201700000000	72	017	Barceloneta Municipio, PR	1999	NA	8354	7064	1290	15.4
CN7201900000000	72	019	Barranquitas Municipio, PR	1999	NA	6118	5249	869	14.2
CN7202100000000	72	021	Bayamon Municipio, PR	1999	NA	88228	81917	6311	7.2
CN7202300000000	72	023	Cabo Rojo Municipio, PR	1999	NA	16619	14447	2172	13.1
CN7202500000000	72	025	Caguas Municipio, PR	1999	NA	60234	54206	6028	10
CN7202700000000	72	027	Camuy Municipio, PR	1999	NA	9652	8341	1311	13.6
CN7202900000000	72	029	Canovanas Municipio, PR	1999	NA	17284	15287	1997	11.6
CN7203100000000	72	031	Carolina Municipio, PR	1999	NA	80984	74136	6848	8.5
CN7203300000000	72	033	Catano Municipio, PR	1999	NA	9891	9065	826	8.4
CN7203500000000	72	035	Cayey Municipio, PR	1999	NA	17301	15066	2235	12.9
CN7203700000000	72	037	Ceiba Municipio, PR	1999	NA	5732	5102	630	11
CN7203900000000	72	039	Ciales Municipio, PR	1999	NA	4412	3611	801	18.2
CN7204100000000	72	041	Cidra Municipio, PR	1999	NA	16699	15106	1593	9.5
CN7204300000000	72	043	Coamo Municipio, PR	1999	NA	9023	7647	1376	15.2
CN7204500000000	72	045	Comerio Municipio, PR	1999	NA	5430	4844	586	10.8
CN7204700000000	72	047	Corozal Municipio, PR	1999	NA	9935	9056	879	8.8
CN7204900000000	72	049	Culebra Municipio, PR	1999	NA	784	747	37	4.7
CN7205100000000	72	051	Dorado Municipio, PR	1999	NA	11264	10293	971	8.6
CN7205300000000	72	053	Fajardo Municipio, PR	1999	NA	13538	11512	2026	15
CN7205400000000	72	054	Florida Municipio, PR	1999	NA	2928	2308	620	21.2
CN7205500000000	72	055	Guanica Municipio, PR	1999	NA	6207	4981	1226	19.8
CN7205700000000	72	057	Guayama Municipio, PR	1999	NA	11098	9213	1885	17
CN7205900000000	72	059	Guayanilla Municipio, PR	1999	NA	7957	6719	1238	15.6
CN7206100000000	72	061	Guaynabo Municipio, PR	1999	NA	41849	39790	2059	4.9
CN7206300000000	72	063	Gurabo Municipio, PR	1999	NA	12131	10803	1328	10.9
CN7206500000000	72	065	Hatillo Municipio, PR	1999	NA	11318	9849	1469	13
CN7206700000000	72	067	Hormigueros Municipio, PR	1999	NA	6922	5988	934	13.5
CN7206900000000	72	069	Humacao Municipio, PR	1999	NA	20613	17615	2998	14.5
CN7207100000000	72	071	Isabela Municipio, PR	1999	NA	12694	10271	2423	19.1
CN7207300000000	72	073	Jayuya Municipio, PR	1999	NA	4268	3758	510	11.9
CN7207500000000	72	075	Juana Diaz Municipio, PR	1999	NA	14069	11851	2218	15.8
CN7207700000000	72	077	Juncos Municipio, PR	1999	NA	12917	11467	1450	11.2
CN7207900000000	72	079	Lajas Municipio, PR	1999	NA	8897	7578	1319	14.8
CN7208100000000	72	081	Lares Municipio, PR	1999	NA	9106	7777	1329	14.6
CN7208300000000	72	083	Las Marias Municipio, PR	1999	NA	3080	2020	1060	34.4
CN7208500000000	72	085	Las Piedras Municipio, PR	1999	NA	10624	9091	1533	14.4
CN7208700000000	72	087	Loiza Municipio, PR	1999	NA	8380	7341	1039	12.4
CN7208900000000	72	089	Luquillo Municipio, PR	1999	NA	6495	5420	1075	16.6
CN7209100000000	72	091	Manati Municipio, PR	1999	NA	14005	11657	2348	16.8
CN7209300000000	72	093	Maricao Municipio, PR	1999	NA	2070	1759	311	15
CN7209500000000	72	095	Maunabo Municipio, PR	1999	NA	2692	2004	688	25.6
CN7209700000000	72	097	Mayaguez Municipio, PR	1999	NA	35167	29670	5497	15.6
CN7209900000000	72	099	Moca Municipio, PR	1999	NA	12156	9927	2229	18.3
CN7210100000000	72	101	Morovis Municipio, PR	1999	NA	9944	8700	1244	12.5
CN7210300000000	72	103	Naguabo Municipio, PR	1999	NA	7118	6135	983	13.8
CN7210500000000	72	105	Naranjito Municipio, PR	1999	NA	7038	6301	737	10.5
CN7210700000000	72	107	Orocovis Municipio, PR	1999	NA	5366	4626	740	13.8
CN7210900000000	72	109	Patillas Municipio, PR	1999	NA	5743	4718	1025	17.8
CN7211100000000	72	111	Penuelas Municipio, PR	1999	NA	8034	6341	1693	21.1
CN7211300000000	72	113	Ponce Municipio, PR	1999	NA	59070	51391	7679	13
CN7211500000000	72	115	Quebradillas Municipio, PR	1999	NA	7783	6735	1048	13.5
CN7211700000000	72	117	Rincon Municipio, PR	1999	NA	5641	4731	910	16.1
CN7211900000000	72	119	Rio Grande Municipio, PR	1999	NA	17681	15437	2244	12.7
CN7212100000000	72	121	Sabana Grande Municipio, PR	1999	NA	8387	7247	1140	13.6
CN7212300000000	72	123	Salinas Municipio, PR	1999	NA	7939	6551	1388	17.5
CN7212500000000	72	125	San German Municipio, PR	1999	NA	13442	11343	2099	15.6
CN7212700000000	72	127	San Juan Municipio, PR	1999	NA	164351	151566	12785	7.8
CN7212900000000	72	129	San Lorenzo Municipio, PR	1999	NA	13110	11127	1983	15.1
CN7213100000000	72	131	San Sebastian Municipio, PR	1999	NA	12475	9726	2749	22
CN7213300000000	72	133	Santa Isabel Municipio, PR	1999	NA	5652	4469	1183	20.9
CN7213500000000	72	135	Toa Alta Municipio, PR	1999	NA	20898	19449	1449	6.9
CN7213700000000	72	137	Toa Baja Municipio, PR	1999	NA	35474	32884	2590	7.3
CN7213900000000	72	139	Trujillo Alto Municipio, PR	1999	NA	30862	28785	2077	6.7
CN7214100000000	72	141	Utuado Municipio, PR	1999	NA	8418	7152	1266	15
CN7214300000000	72	143	Vega Alta Municipio, PR	1999	NA	11539	10554	985	8.5
CN7214500000000	72	145	Vega Baja Municipio, PR	1999	NA	19705	17046	2659	13.5
CN7214700000000	72	147	Vieques Municipio, PR	1999	NA	2662	2310	352	13.2
CN7214900000000	72	149	Villalba Municipio, PR	1999	NA	6143	5018	1125	18.3
CN7215100000000	72	151	Yabucoa Municipio, PR	1999	NA	12428	10158	2270	18.3
CN7215300000000	72	153	Yauco Municipio, PR	1999	NA	13706	11408	2298	16.8
NA	NA	NA	NA	NA	NA	NA	NA	NA	NA
SOURCE:  BLS, LAUS	NA	NA	NA	NA	NA	NA	NA	NA	NA
November 2, 2016	NA	NA	NA	NA	NA	NA	NA	NA	NA
