LAUS_CODE	STATE_FIPS	COUNTY_FIPS	COUNTY	YEAR	ESTIMATED	LABOR_FORCE	EMPLOYED	UNEMPLOYED_LEVEL	UNEMPLOYED_RATE
CN0100100000000	01	001	Autauga County, AL	1991	NA	16928	15777	1151	6.8
CN0100300000000	01	003	Baldwin County, AL	1991	NA	49426	46695	2731	5.5
CN0100500000000	01	005	Barbour County, AL	1991	NA	11628	10608	1020	8.8
CN0100700000000	01	007	Bibb County, AL	1991	NA	7520	6627	893	11.9
CN0100900000000	01	009	Blount County, AL	1991	NA	19132	18021	1111	5.8
CN0101100000000	01	011	Bullock County, AL	1991	NA	4544	3688	856	18.8
CN0101300000000	01	013	Butler County, AL	1991	NA	8709	7648	1061	12.2
CN0101500000000	01	015	Calhoun County, AL	1991	NA	52124	48128	3996	7.7
CN0101700000000	01	017	Chambers County, AL	1991	NA	17542	15787	1755	10
CN0101900000000	01	019	Cherokee County, AL	1991	NA	9610	8786	824	8.6
CN0102100000000	01	021	Chilton County, AL	1991	NA	15218	13702	1516	10
CN0102300000000	01	023	Choctaw County, AL	1991	NA	6704	5997	707	10.5
CN0102500000000	01	025	Clarke County, AL	1991	NA	12077	10930	1147	9.5
CN0102700000000	01	027	Clay County, AL	1991	NA	6495	5860	635	9.8
CN0102900000000	01	029	Cleburne County, AL	1991	NA	6701	6212	489	7.3
CN0103100000000	01	031	Coffee County, AL	1991	NA	19075	17832	1243	6.5
CN0103300000000	01	033	Colbert County, AL	1991	NA	24904	22667	2237	9
CN0103500000000	01	035	Conecuh County, AL	1991	NA	5823	5188	635	10.9
CN0103700000000	01	037	Coosa County, AL	1991	NA	5004	4666	338	6.8
CN0103900000000	01	039	Covington County, AL	1991	NA	16775	15162	1613	9.6
CN0104100000000	01	041	Crenshaw County, AL	1991	NA	6107	5586	521	8.5
CN0104300000000	01	043	Cullman County, AL	1991	NA	33052	30561	2491	7.5
CN0104500000000	01	045	Dale County, AL	1991	NA	20620	19286	1334	6.5
CN0104700000000	01	047	Dallas County, AL	1991	NA	19666	17113	2553	13
CN0104900000000	01	049	DeKalb County, AL	1991	NA	27540	25369	2171	7.9
CN0105100000000	01	051	Elmore County, AL	1991	NA	22721	21201	1520	6.7
CN0105300000000	01	053	Escambia County, AL	1991	NA	15218	13823	1395	9.2
CN0105500000000	01	055	Etowah County, AL	1991	NA	46379	41484	4895	10.6
CN0105700000000	01	057	Fayette County, AL	1991	NA	8474	7573	901	10.6
CN0105900000000	01	059	Franklin County, AL	1991	NA	14201	12855	1346	9.5
CN0106100000000	01	061	Geneva County, AL	1991	NA	11385	10803	582	5.1
CN0106300000000	01	063	Greene County, AL	1991	NA	3789	3355	434	11.5
CN0106500000000	01	065	Hale County, AL	1991	NA	6111	5547	564	9.2
CN0106700000000	01	067	Henry County, AL	1991	NA	6648	6106	542	8.2
CN0106900000000	01	069	Houston County, AL	1991	NA	41159	39022	2137	5.2
CN0107100000000	01	071	Jackson County, AL	1991	NA	24289	21692	2597	10.7
CN0107300000000	01	073	Jefferson County, AL	1991	NA	311177	293991	17186	5.5
CN0107500000000	01	075	Lamar County, AL	1991	NA	7822	7037	785	10
CN0107700000000	01	077	Lauderdale County, AL	1991	NA	38609	35698	2911	7.5
CN0107900000000	01	079	Lawrence County, AL	1991	NA	15365	13858	1507	9.8
CN0108100000000	01	081	Lee County, AL	1991	NA	42976	40416	2560	6
CN0108300000000	01	083	Limestone County, AL	1991	NA	26932	24702	2230	8.3
CN0108500000000	01	085	Lowndes County, AL	1991	NA	4461	3724	737	16.5
CN0108700000000	01	087	Macon County, AL	1991	NA	8911	8082	829	9.3
CN0108900000000	01	089	Madison County, AL	1991	NA	128614	121251	7363	5.7
CN0109100000000	01	091	Marengo County, AL	1991	NA	10165	9378	787	7.7
CN0109300000000	01	093	Marion County, AL	1991	NA	13882	12346	1536	11.1
CN0109500000000	01	095	Marshall County, AL	1991	NA	34989	31555	3434	9.8
CN0109700000000	01	097	Mobile County, AL	1991	NA	176318	163858	12460	7.1
CN0109900000000	01	099	Monroe County, AL	1991	NA	10807	9684	1123	10.4
CN0110100000000	01	101	Montgomery County, AL	1991	NA	99765	93702	6063	6.1
CN0110300000000	01	103	Morgan County, AL	1991	NA	50777	47113	3664	7.2
CN0110500000000	01	105	Perry County, AL	1991	NA	4654	4028	626	13.5
CN0110700000000	01	107	Pickens County, AL	1991	NA	8775	7906	869	9.9
CN0110900000000	01	109	Pike County, AL	1991	NA	12308	11329	979	8
CN0111100000000	01	111	Randolph County, AL	1991	NA	9329	8411	918	9.8
CN0111300000000	01	113	Russell County, AL	1991	NA	21871	20005	1866	8.5
CN0111500000000	01	115	St. Clair County, AL	1991	NA	23970	22496	1474	6.1
CN0111700000000	01	117	Shelby County, AL	1991	NA	54777	52612	2165	4
CN0111900000000	01	119	Sumter County, AL	1991	NA	5913	5267	646	10.9
CN0112100000000	01	121	Talladega County, AL	1991	NA	33671	30515	3156	9.4
CN0112300000000	01	123	Tallapoosa County, AL	1991	NA	19230	18033	1197	6.2
CN0112500000000	01	125	Tuscaloosa County, AL	1991	NA	70361	66651	3710	5.3
CN0112700000000	01	127	Walker County, AL	1991	NA	30059	26513	3546	11.8
CN0112900000000	01	129	Washington County, AL	1991	NA	6362	5505	857	13.5
CN0113100000000	01	131	Wilcox County, AL	1991	NA	3981	3357	624	15.7
CN0113300000000	01	133	Winston County, AL	1991	NA	10435	9113	1322	12.7
CN0201300000000	02	013	Aleutians East Borough, AK	1991	NA	1434	1417	17	1.2
CN0201600000000	02	016	Aleutians West Census Area, AK	1991	NA	3760	3724	36	1
CN0202000000000	02	020	Anchorage Borough/municipality, AK	1991	NA	123222	115028	8194	6.6
CN0205000000000	02	050	Bethel Census Area, AK	1991	NA	4619	4226	393	8.5
CN0206000000000	02	060	Bristol Bay Borough, AK	1991	NA	533	505	28	5.3
CN0206800000000	02	068	Denali Borough, AK	1991	NA	1012	887	125	12.4
CN0207000000000	02	070	Dillingham Census Area, AK	1991	NA	1374	1279	95	6.9
CN0209000000000	02	090	Fairbanks North Star Borough, AK	1991	NA	36770	33154	3616	9.8
CN0210000000000	02	100	Haines Borough, AK	1991	NA	1163	991	172	14.8
CN0211000000000	02	110	Juneau Borough/city, AK	1991	NA	15401	14438	963	6.3
CN0212200000000	02	122	Kenai Peninsula Borough, AK	1991	NA	19685	17075	2610	13.3
CN0213000000000	02	130	Ketchikan Gateway Borough, AK	1991	NA	7473	6777	696	9.3
CN0215000000000	02	150	Kodiak Island Borough, AK	1991	NA	6722	6184	538	8
CN0215800000000	02	158	Kusilvak Census Area, AK	1991	NA	1557	1361	196	12.6
CN0216400000000	02	164	Lake and Peninsula Borough, AK	1991	NA	498	462	36	7.2
CN0217000000000	02	170	Matanuska-Susitna Borough, AK	1991	NA	19977	17557	2420	12.1
CN0218000000000	02	180	Nome Census Area, AK	1991	NA	3274	2912	362	11.1
CN0218500000000	02	185	North Slope Borough, AK	1991	NA	2924	2794	130	4.4
CN0218800000000	02	188	Northwest Arctic Borough, AK	1991	NA	2174	1827	347	16
CN0220100000000	02	201	Prince of Wales-Outer Ketchikan Census Area, AK	1991	NA	2973	2567	406	13.7
CN0222000000000	02	220	Sitka Borough/city, AK	1991	NA	4475	4214	261	5.8
CN0223200000000	02	232	Skagway-Hoonah-Angoon Census Area, AK	1991	NA	2442	2190	252	10.3
CN0224000000000	02	240	Southeast Fairbanks Census Area, AK	1991	NA	2158	1864	294	13.6
CN0226100000000	02	261	Valdez-Cordova Census Area, AK	1991	NA	5096	4611	485	9.5
CN0228000000000	02	280	Wrangell-Petersburg Census Area, AK	1991	NA	3568	3210	358	10
CN0229000000000	02	290	Yukon-Koyukuk Census Area, AK	1991	NA	1992	1666	326	16.4
CN0400100000000	04	001	Apache County, AZ	1991	NA	17565	15207	2358	13.4
CN0400300000000	04	003	Cochise County, AZ	1991	NA	36973	34155	2818	7.6
CN0400500000000	04	005	Coconino County, AZ	1991	NA	49310	45601	3709	7.5
CN0400700000000	04	007	Gila County, AZ	1991	NA	16478	15171	1307	7.9
CN0400900000000	04	009	Graham County, AZ	1991	NA	9311	8647	664	7.1
CN0401100000000	04	011	Greenlee County, AZ	1991	NA	3922	3667	255	6.5
CN0401200000000	04	012	La Paz County, AZ	1991	NA	5311	4839	472	8.9
CN0401300000000	04	013	Maricopa County, AZ	1991	NA	1116919	1059433	57486	5.1
CN0401500000000	04	015	Mohave County, AZ	1991	NA	45872	42800	3072	6.7
CN0401700000000	04	017	Navajo County, AZ	1991	NA	26219	23109	3110	11.9
CN0401900000000	04	019	Pima County, AZ	1991	NA	321664	307634	14030	4.4
CN0402100000000	04	021	Pinal County, AZ	1991	NA	45300	42157	3143	6.9
CN0402300000000	04	023	Santa Cruz County, AZ	1991	NA	13029	11195	1834	14.1
CN0402500000000	04	025	Yavapai County, AZ	1991	NA	47338	44833	2505	5.3
CN0402700000000	04	027	Yuma County, AZ	1991	NA	49802	39227	10575	21.2
CN0500100000000	05	001	Arkansas County, AR	1991	NA	10158	9541	617	6.1
CN0500300000000	05	003	Ashley County, AR	1991	NA	10989	10184	805	7.3
CN0500500000000	05	005	Baxter County, AR	1991	NA	11888	11193	695	5.8
CN0500700000000	05	007	Benton County, AR	1991	NA	49988	48250	1738	3.5
CN0500900000000	05	009	Boone County, AR	1991	NA	13630	12795	835	6.1
CN0501100000000	05	011	Bradley County, AR	1991	NA	5083	4461	622	12.2
CN0501300000000	05	013	Calhoun County, AR	1991	NA	2461	2200	261	10.6
CN0501500000000	05	015	Carroll County, AR	1991	NA	10373	9759	614	5.9
CN0501700000000	05	017	Chicot County, AR	1991	NA	6003	5370	633	10.5
CN0501900000000	05	019	Clark County, AR	1991	NA	10232	9575	657	6.4
CN0502100000000	05	021	Clay County, AR	1991	NA	8166	7448	718	8.8
CN0502300000000	05	023	Cleburne County, AR	1991	NA	8738	8023	715	8.2
CN0502500000000	05	025	Cleveland County, AR	1991	NA	3644	3354	290	8
CN0502700000000	05	027	Columbia County, AR	1991	NA	11693	10822	871	7.4
CN0502900000000	05	029	Conway County, AR	1991	NA	9110	8509	601	6.6
CN0503100000000	05	031	Craighead County, AR	1991	NA	36841	34143	2698	7.3
CN0503300000000	05	033	Crawford County, AR	1991	NA	21120	19192	1928	9.1
CN0503500000000	05	035	Crittenden County, AR	1991	NA	22242	20196	2046	9.2
CN0503700000000	05	037	Cross County, AR	1991	NA	8543	7852	691	8.1
CN0503900000000	05	039	Dallas County, AR	1991	NA	4064	3675	389	9.6
CN0504100000000	05	041	Desha County, AR	1991	NA	6947	6226	721	10.4
CN0504300000000	05	043	Drew County, AR	1991	NA	8621	7803	818	9.5
CN0504500000000	05	045	Faulkner County, AR	1991	NA	32300	30008	2292	7.1
CN0504700000000	05	047	Franklin County, AR	1991	NA	7202	6650	552	7.7
CN0504900000000	05	049	Fulton County, AR	1991	NA	4096	3854	242	5.9
CN0505100000000	05	051	Garland County, AR	1991	NA	32163	29633	2530	7.9
CN0505300000000	05	053	Grant County, AR	1991	NA	6964	6475	489	7
CN0505500000000	05	055	Greene County, AR	1991	NA	15620	14526	1094	7
CN0505700000000	05	057	Hempstead County, AR	1991	NA	10185	9278	907	8.9
CN0505900000000	05	059	Hot Spring County, AR	1991	NA	11349	10175	1174	10.3
CN0506100000000	05	061	Howard County, AR	1991	NA	6500	6046	454	7
CN0506300000000	05	063	Independence County, AR	1991	NA	15837	14596	1241	7.8
CN0506500000000	05	065	Izard County, AR	1991	NA	4529	4272	257	5.7
CN0506700000000	05	067	Jackson County, AR	1991	NA	8223	7167	1056	12.8
CN0506900000000	05	069	Jefferson County, AR	1991	NA	37785	33504	4281	11.3
CN0507100000000	05	071	Johnson County, AR	1991	NA	8254	7573	681	8.3
CN0507300000000	05	073	Lafayette County, AR	1991	NA	3624	3269	355	9.8
CN0507500000000	05	075	Lawrence County, AR	1991	NA	7517	6786	731	9.7
CN0507700000000	05	077	Lee County, AR	1991	NA	4660	4027	633	13.6
CN0507900000000	05	079	Lincoln County, AR	1991	NA	4832	4400	432	8.9
CN0508100000000	05	081	Little River County, AR	1991	NA	6645	6026	619	9.3
CN0508300000000	05	083	Logan County, AR	1991	NA	9513	8700	813	8.5
CN0508500000000	05	085	Lonoke County, AR	1991	NA	19598	18451	1147	5.9
CN0508700000000	05	087	Madison County, AR	1991	NA	6719	6393	326	4.9
CN0508900000000	05	089	Marion County, AR	1991	NA	4876	4564	312	6.4
CN0509100000000	05	091	Miller County, AR	1991	NA	16922	15520	1402	8.3
CN0509300000000	05	093	Mississippi County, AR	1991	NA	25799	23200	2599	10.1
CN0509500000000	05	095	Monroe County, AR	1991	NA	4404	3955	449	10.2
CN0509700000000	05	097	Montgomery County, AR	1991	NA	3542	3358	184	5.2
CN0509900000000	05	099	Nevada County, AR	1991	NA	4493	4074	419	9.3
CN0510100000000	05	101	Newton County, AR	1991	NA	2932	2670	262	8.9
CN0510300000000	05	103	Ouachita County, AR	1991	NA	13443	11744	1699	12.6
CN0510500000000	05	105	Perry County, AR	1991	NA	3662	3334	328	9
CN0510700000000	05	107	Phillips County, AR	1991	NA	10624	9519	1105	10.4
CN0510900000000	05	109	Pike County, AR	1991	NA	4521	4118	403	8.9
CN0511100000000	05	111	Poinsett County, AR	1991	NA	10796	9794	1002	9.3
CN0511300000000	05	113	Polk County, AR	1991	NA	7639	7165	474	6.2
CN0511500000000	05	115	Pope County, AR	1991	NA	24178	22679	1499	6.2
CN0511700000000	05	117	Prairie County, AR	1991	NA	4350	3938	412	9.5
CN0511900000000	05	119	Pulaski County, AR	1991	NA	185764	174765	10999	5.9
CN0512100000000	05	121	Randolph County, AR	1991	NA	7224	6436	788	10.9
CN0512300000000	05	123	St. Francis County, AR	1991	NA	11440	10022	1418	12.4
CN0512500000000	05	125	Saline County, AR	1991	NA	34082	31940	2142	6.3
CN0512700000000	05	127	Scott County, AR	1991	NA	4780	4535	245	5.1
CN0512900000000	05	129	Searcy County, AR	1991	NA	2996	2753	243	8.1
CN0513100000000	05	131	Sebastian County, AR	1991	NA	52134	48211	3923	7.5
CN0513300000000	05	133	Sevier County, AR	1991	NA	6786	6379	407	6
CN0513500000000	05	135	Sharp County, AR	1991	NA	5132	4725	407	7.9
CN0513700000000	05	137	Stone County, AR	1991	NA	4444	4150	294	6.6
CN0513900000000	05	139	Union County, AR	1991	NA	20591	18989	1602	7.8
CN0514100000000	05	141	Van Buren County, AR	1991	NA	5606	5038	568	10.1
CN0514300000000	05	143	Washington County, AR	1991	NA	62260	59795	2465	4
CN0514500000000	05	145	White County, AR	1991	NA	26733	24136	2597	9.7
CN0514700000000	05	147	Woodruff County, AR	1991	NA	4027	3412	615	15.3
CN0514900000000	05	149	Yell County, AR	1991	NA	8687	8229	458	5.3
CN0600100000000	06	001	Alameda County, CA	1991	NA	671839	635540	36299	5.4
CN0600300000000	06	003	Alpine County, CA	1991	NA	356	309	47	13.2
CN0600500000000	06	005	Amador County, CA	1991	NA	11984	11153	831	6.9
CN0600700000000	06	007	Butte County, CA	1991	NA	79279	71560	7719	9.7
CN0600900000000	06	009	Calaveras County, CA	1991	NA	13962	12670	1292	9.3
CN0601100000000	06	011	Colusa County, CA	1991	NA	8089	6638	1451	17.9
CN0601300000000	06	013	Contra Costa County, CA	1991	NA	434514	410896	23618	5.4
CN0601500000000	06	015	Del Norte County, CA	1991	NA	9767	8580	1187	12.2
CN0601700000000	06	017	El Dorado County, CA	1991	NA	65535	61183	4352	6.6
CN0601900000000	06	019	Fresno County, CA	1991	NA	336788	291777	45011	13.4
CN0602100000000	06	021	Glenn County, CA	1991	NA	11076	9341	1735	15.7
CN0602300000000	06	023	Humboldt County, CA	1991	NA	56681	51733	4948	8.7
CN0602500000000	06	025	Imperial County, CA	1991	NA	48827	36175	12652	25.9
CN0602700000000	06	027	Inyo County, CA	1991	NA	7167	6472	695	9.7
CN0602900000000	06	029	Kern County, CA	1991	NA	264585	232453	32132	12.1
CN0603100000000	06	031	Kings County, CA	1991	NA	38615	33732	4883	12.6
CN0603300000000	06	033	Lake County, CA	1991	NA	20905	18693	2212	10.6
CN0603500000000	06	035	Lassen County, CA	1991	NA	10240	9177	1063	10.4
CN0603700000000	06	037	Los Angeles County, CA	1991	NA	4471689	4114757	356932	8
CN0603900000000	06	039	Madera County, CA	1991	NA	44212	37617	6595	14.9
CN0604100000000	06	041	Marin County, CA	1991	NA	130625	125664	4961	3.8
CN0604300000000	06	043	Mariposa County, CA	1991	NA	6949	6453	496	7.1
CN0604500000000	06	045	Mendocino County, CA	1991	NA	38776	34676	4100	10.6
CN0604700000000	06	047	Merced County, CA	1991	NA	77227	65218	12009	15.6
CN0604900000000	06	049	Modoc County, CA	1991	NA	3882	3400	482	12.4
CN0605100000000	06	051	Mono County, CA	1991	NA	5454	4801	653	12
CN0605300000000	06	053	Monterey County, CA	1991	NA	171305	151950	19355	11.3
CN0605500000000	06	055	Napa County, CA	1991	NA	55209	52030	3179	5.8
CN0605700000000	06	057	Nevada County, CA	1991	NA	38380	35900	2480	6.5
CN0605900000000	06	059	Orange County, CA	1991	NA	1318918	1249776	69142	5.2
CN0606100000000	06	061	Placer County, CA	1991	NA	91093	85224	5869	6.4
CN0606300000000	06	063	Plumas County, CA	1991	NA	9657	8594	1063	11
CN0606500000000	06	065	Riverside County, CA	1991	NA	549767	494559	55208	10
CN0606700000000	06	067	Sacramento County, CA	1991	NA	527293	492452	34841	6.6
CN0606900000000	06	069	San Benito County, CA	1991	NA	21221	17821	3400	16
CN0607100000000	06	071	San Bernardino County, CA	1991	NA	644321	591358	52963	8.2
CN0607300000000	06	073	San Diego County, CA	1991	NA	1207018	1131580	75438	6.2
CN0607500000000	06	075	San Francisco County/city, CA	1991	NA	405045	383499	21546	5.3
CN0607700000000	06	077	San Joaquin County, CA	1991	NA	231287	203608	27679	12
CN0607900000000	06	079	San Luis Obispo County, CA	1991	NA	96171	90389	5782	6
CN0608100000000	06	081	San Mateo County, CA	1991	NA	366679	352198	14481	3.9
CN0608300000000	06	083	Santa Barbara County, CA	1991	NA	194875	183348	11527	5.9
CN0608500000000	06	085	Santa Clara County, CA	1991	NA	841771	793935	47836	5.7
CN0608700000000	06	087	Santa Cruz County, CA	1991	NA	137204	125073	12131	8.8
CN0608900000000	06	089	Shasta County, CA	1991	NA	68194	60781	7413	10.9
CN0609100000000	06	091	Sierra County, CA	1991	NA	1648	1470	178	10.8
CN0609300000000	06	093	Siskiyou County, CA	1991	NA	19117	16608	2509	13.1
CN0609500000000	06	095	Solano County, CA	1991	NA	166468	156090	10378	6.2
CN0609700000000	06	097	Sonoma County, CA	1991	NA	211891	200154	11737	5.5
CN0609900000000	06	099	Stanislaus County, CA	1991	NA	183210	156290	26920	14.7
CN0610100000000	06	101	Sutter County, CA	1991	NA	34522	28680	5842	16.9
CN0610300000000	06	103	Tehama County, CA	1991	NA	21173	18744	2429	11.5
CN0610500000000	06	105	Trinity County, CA	1991	NA	5127	4386	741	14.5
CN0610700000000	06	107	Tulare County, CA	1991	NA	152736	125114	27622	18.1
CN0610900000000	06	109	Tuolumne County, CA	1991	NA	20008	18281	1727	8.6
CN0611100000000	06	111	Ventura County, CA	1991	NA	366484	338934	27550	7.5
CN0611300000000	06	113	Yolo County, CA	1991	NA	77051	71016	6035	7.8
CN0611500000000	06	115	Yuba County, CA	1991	NA	22624	19498	3126	13.8
CN0800100000000	08	001	Adams County, CO	1991	NA	142002	134516	7486	5.3
CN0800300000000	08	003	Alamosa County, CO	1991	NA	6791	6311	480	7.1
CN0800500000000	08	005	Arapahoe County, CO	1991	NA	230581	221522	9059	3.9
CN0800700000000	08	007	Archuleta County, CO	1991	NA	2736	2529	207	7.6
CN0800900000000	08	009	Baca County, CO	1991	NA	2018	1951	67	3.3
CN0801100000000	08	011	Bent County, CO	1991	NA	2045	1953	92	4.5
CN0801300000000	08	013	Boulder County, CO	1991	NA	128009	122095	5914	4.6
CN0801400000000	08	014	Broomfield County/city, CO	1991	NA	14577	14074	503	3.5
CN0801500000000	08	015	Chaffee County, CO	1991	NA	6068	5711	357	5.9
CN0801700000000	08	017	Cheyenne County, CO	1991	NA	1209	1184	25	2.1
CN0801900000000	08	019	Clear Creek County, CO	1991	NA	4517	4326	191	4.2
CN0802100000000	08	021	Conejos County, CO	1991	NA	3063	2745	318	10.4
CN0802300000000	08	023	Costilla County, CO	1991	NA	1610	1401	209	13
CN0802500000000	08	025	Crowley County, CO	1991	NA	1167	1106	61	5.2
CN0802700000000	08	027	Custer County, CO	1991	NA	998	949	49	4.9
CN0802900000000	08	029	Delta County, CO	1991	NA	8601	7730	871	10.1
CN0803100000000	08	031	Denver County/city, CO	1991	NA	252944	238602	14342	5.7
CN0803300000000	08	033	Dolores County, CO	1991	NA	715	629	86	12
CN0803500000000	08	035	Douglas County, CO	1991	NA	38000	36848	1152	3
CN0803700000000	08	037	Eagle County, CO	1991	NA	13281	12640	641	4.8
CN0803900000000	08	039	Elbert County, CO	1991	NA	5825	5537	288	4.9
CN0804100000000	08	041	El Paso County, CO	1991	NA	192725	179421	13304	6.9
CN0804300000000	08	043	Fremont County, CO	1991	NA	13029	12128	901	6.9
CN0804500000000	08	045	Garfield County, CO	1991	NA	17147	15939	1208	7
CN0804700000000	08	047	Gilpin County, CO	1991	NA	2753	2666	87	3.2
CN0804900000000	08	049	Grand County, CO	1991	NA	4488	4317	171	3.8
CN0805100000000	08	051	Gunnison County, CO	1991	NA	5932	5484	448	7.6
CN0805300000000	08	053	Hinsdale County, CO	1991	NA	422	413	9	2.1
CN0805500000000	08	055	Huerfano County, CO	1991	NA	2520	2322	198	7.9
CN0805700000000	08	057	Jackson County, CO	1991	NA	903	853	50	5.5
CN0805900000000	08	059	Jefferson County, CO	1991	NA	257348	247267	10081	3.9
CN0806100000000	08	061	Kiowa County, CO	1991	NA	793	760	33	4.2
CN0806300000000	08	063	Kit Carson County, CO	1991	NA	3227	3156	71	2.2
CN0806500000000	08	065	Lake County, CO	1991	NA	2876	2673	203	7.1
CN0806700000000	08	067	La Plata County, CO	1991	NA	18294	17156	1138	6.2
CN0806900000000	08	069	Larimer County, CO	1991	NA	106820	101691	5129	4.8
CN0807100000000	08	071	Las Animas County, CO	1991	NA	5443	5059	384	7.1
CN0807300000000	08	073	Lincoln County, CO	1991	NA	2445	2367	78	3.2
CN0807500000000	08	075	Logan County, CO	1991	NA	8454	7998	456	5.4
CN0807700000000	08	077	Mesa County, CO	1991	NA	46428	43273	3155	6.8
CN0807900000000	08	079	Mineral County, CO	1991	NA	316	303	13	4.1
CN0808100000000	08	081	Moffat County, CO	1991	NA	5983	5569	414	6.9
CN0808300000000	08	083	Montezuma County, CO	1991	NA	9387	8603	784	8.4
CN0808500000000	08	085	Montrose County, CO	1991	NA	11992	11064	928	7.7
CN0808700000000	08	087	Morgan County, CO	1991	NA	10929	10431	498	4.6
CN0808900000000	08	089	Otero County, CO	1991	NA	8473	7899	574	6.8
CN0809100000000	08	091	Ouray County, CO	1991	NA	1252	1160	92	7.3
CN0809300000000	08	093	Park County, CO	1991	NA	4705	4503	202	4.3
CN0809500000000	08	095	Phillips County, CO	1991	NA	1726	1690	36	2.1
CN0809700000000	08	097	Pitkin County, CO	1991	NA	7653	7094	559	7.3
CN0809900000000	08	099	Prowers County, CO	1991	NA	5917	5566	351	5.9
CN0810100000000	08	101	Pueblo County, CO	1991	NA	52364	48257	4107	7.8
CN0810300000000	08	103	Rio Blanco County, CO	1991	NA	3298	3131	167	5.1
CN0810500000000	08	105	Rio Grande County, CO	1991	NA	5052	4538	514	10.2
CN0810700000000	08	107	Routt County, CO	1991	NA	8540	8111	429	5
CN0810900000000	08	109	Saguache County, CO	1991	NA	2286	2044	242	10.6
CN0811100000000	08	111	San Juan County, CO	1991	NA	436	340	96	22
CN0811300000000	08	113	San Miguel County, CO	1991	NA	2745	2565	180	6.6
CN0811500000000	08	115	Sedgwick County, CO	1991	NA	1236	1195	41	3.3
CN0811700000000	08	117	Summit County, CO	1991	NA	8496	8122	374	4.4
CN0811900000000	08	119	Teller County, CO	1991	NA	8369	7974	395	4.7
CN0812100000000	08	121	Washington County, CO	1991	NA	2126	2064	62	2.9
CN0812300000000	08	123	Weld County, CO	1991	NA	68230	64680	3550	5.2
CN0812500000000	08	125	Yuma County, CO	1991	NA	3974	3869	105	2.6
CN0900100000000	09	001	Fairfield County, CT	1991	NA	466192	439189	27003	5.8
CN0900300000000	09	003	Hartford County, CT	1991	NA	475212	442277	32935	6.9
CN0900500000000	09	005	Litchfield County, CT	1991	NA	104998	98329	6669	6.4
CN0900700000000	09	007	Middlesex County, CT	1991	NA	84996	80157	4839	5.7
CN0900900000000	09	009	New Haven County, CT	1991	NA	445234	414253	30981	7
CN0901100000000	09	011	New London County, CT	1991	NA	132222	123468	8754	6.6
CN0901300000000	09	013	Tolland County, CT	1991	NA	75592	71284	4308	5.7
CN0901500000000	09	015	Windham County, CT	1991	NA	56656	51699	4957	8.7
CN1000100000000	10	001	Kent County, DE	1991	NA	61764	57878	3886	6.3
CN1000300000000	10	003	New Castle County, DE	1991	NA	237540	222061	15479	6.5
CN1000500000000	10	005	Sussex County, DE	1991	NA	62410	59364	3046	4.9
CN1100100000000	11	001	District of Columbia	1991	NA	321433	296477	24956	7.8
CN1200100000000	12	001	Alachua County, FL	1991	NA	95686	91406	4280	4.5
CN1200300000000	12	003	Baker County, FL	1991	NA	8475	7628	847	10
CN1200500000000	12	005	Bay County, FL	1991	NA	62067	56955	5112	8.2
CN1200700000000	12	007	Bradford County, FL	1991	NA	9675	9136	539	5.6
CN1200900000000	12	009	Brevard County, FL	1991	NA	209660	194390	15270	7.3
CN1201100000000	12	011	Broward County, FL	1991	NA	678695	624471	54224	8
CN1201300000000	12	013	Calhoun County, FL	1991	NA	4686	4286	400	8.5
CN1201500000000	12	015	Charlotte County, FL	1991	NA	43089	40170	2919	6.8
CN1201700000000	12	017	Citrus County, FL	1991	NA	33817	30492	3325	9.8
CN1201900000000	12	019	Clay County, FL	1991	NA	55268	52412	2856	5.2
CN1202100000000	12	021	Collier County, FL	1991	NA	75699	69600	6099	8.1
CN1202300000000	12	023	Columbia County, FL	1991	NA	20867	18793	2074	9.9
CN1202700000000	12	027	DeSoto County, FL	1991	NA	10199	9436	763	7.5
CN1202900000000	12	029	Dixie County, FL	1991	NA	3892	3447	445	11.4
CN1203100000000	12	031	Duval County, FL	1991	NA	356943	333767	23176	6.5
CN1203300000000	12	033	Escambia County, FL	1991	NA	122678	115367	7311	6
CN1203500000000	12	035	Flagler County, FL	1991	NA	12584	11496	1088	8.6
CN1203700000000	12	037	Franklin County, FL	1991	NA	4190	3968	222	5.3
CN1203900000000	12	039	Gadsden County, FL	1991	NA	18598	17351	1247	6.7
CN1204100000000	12	041	Gilchrist County, FL	1991	NA	4072	3751	321	7.9
CN1204300000000	12	043	Glades County, FL	1991	NA	3298	2979	319	9.7
CN1204500000000	12	045	Gulf County, FL	1991	NA	5359	5003	356	6.6
CN1204700000000	12	047	Hamilton County, FL	1991	NA	4143	3769	374	9
CN1204900000000	12	049	Hardee County, FL	1991	NA	9673	8593	1080	11.2
CN1205100000000	12	051	Hendry County, FL	1991	NA	14206	12317	1889	13.3
CN1205300000000	12	053	Hernando County, FL	1991	NA	37497	34108	3389	9
CN1205500000000	12	055	Highlands County, FL	1991	NA	26715	24333	2382	8.9
CN1205700000000	12	057	Hillsborough County, FL	1991	NA	456479	427333	29146	6.4
CN1205900000000	12	059	Holmes County, FL	1991	NA	6511	6077	434	6.7
CN1206100000000	12	061	Indian River County, FL	1991	NA	40568	35435	5133	12.7
CN1206300000000	12	063	Jackson County, FL	1991	NA	19534	18204	1330	6.8
CN1206500000000	12	065	Jefferson County, FL	1991	NA	5555	5265	290	5.2
CN1206700000000	12	067	Lafayette County, FL	1991	NA	2288	2131	157	6.9
CN1206900000000	12	069	Lake County, FL	1991	NA	66651	61069	5582	8.4
CN1207100000000	12	071	Lee County, FL	1991	NA	158371	148493	9878	6.2
CN1207300000000	12	073	Leon County, FL	1991	NA	115895	111549	4346	3.7
CN1207500000000	12	075	Levy County, FL	1991	NA	10803	10066	737	6.8
CN1207700000000	12	077	Liberty County, FL	1991	NA	2298	2167	131	5.7
CN1207900000000	12	079	Madison County, FL	1991	NA	7034	6442	592	8.4
CN1208100000000	12	081	Manatee County, FL	1991	NA	99037	93733	5304	5.4
CN1208300000000	12	083	Marion County, FL	1991	NA	85934	78776	7158	8.3
CN1208500000000	12	085	Martin County, FL	1991	NA	45582	40929	4653	10.2
CN1208600000000	12	086	Miami-Dade County, FL	1991	NA	978740	891995	86745	8.9
CN1208700000000	12	087	Monroe County, FL	1991	NA	41363	39722	1641	4
CN1208900000000	12	089	Nassau County, FL	1991	NA	23228	21647	1581	6.8
CN1209100000000	12	091	Okaloosa County, FL	1991	NA	67013	62795	4218	6.3
CN1209300000000	12	093	Okeechobee County, FL	1991	NA	14471	13093	1378	9.5
CN1209500000000	12	095	Orange County, FL	1991	NA	395349	367598	27751	7
CN1209700000000	12	097	Osceola County, FL	1991	NA	61148	57236	3912	6.4
CN1209900000000	12	099	Palm Beach County, FL	1991	NA	441647	400981	40666	9.2
CN1210100000000	12	101	Pasco County, FL	1991	NA	110009	101337	8672	7.9
CN1210300000000	12	103	Pinellas County, FL	1991	NA	422510	395970	26540	6.3
CN1210500000000	12	105	Polk County, FL	1991	NA	199890	179833	20057	10
CN1210700000000	12	107	Putnam County, FL	1991	NA	27799	25737	2062	7.4
CN1210900000000	12	109	St. Johns County, FL	1991	NA	45374	42655	2719	6
CN1211100000000	12	111	St. Lucie County, FL	1991	NA	71831	61801	10030	14
CN1211300000000	12	113	Santa Rosa County, FL	1991	NA	40476	38252	2224	5.5
CN1211500000000	12	115	Sarasota County, FL	1991	NA	128302	122027	6275	4.9
CN1211700000000	12	117	Seminole County, FL	1991	NA	172402	160954	11448	6.6
CN1211900000000	12	119	Sumter County, FL	1991	NA	12291	11206	1085	8.8
CN1212100000000	12	121	Suwannee County, FL	1991	NA	12109	10993	1116	9.2
CN1212300000000	12	123	Taylor County, FL	1991	NA	8169	6896	1273	15.6
CN1212500000000	12	125	Union County, FL	1991	NA	3828	3618	210	5.5
CN1212700000000	12	127	Volusia County, FL	1991	NA	170829	159237	11592	6.8
CN1212900000000	12	129	Wakulla County, FL	1991	NA	8291	7892	399	4.8
CN1213100000000	12	131	Walton County, FL	1991	NA	13378	12446	932	7
CN1213300000000	12	133	Washington County, FL	1991	NA	7722	7211	511	6.6
CN1300100000000	13	001	Appling County, GA	1991	NA	7564	6937	627	8.3
CN1300300000000	13	003	Atkinson County, GA	1991	NA	2497	2342	155	6.2
CN1300500000000	13	005	Bacon County, GA	1991	NA	4381	4101	280	6.4
CN1300700000000	13	007	Baker County, GA	1991	NA	1632	1531	101	6.2
CN1300900000000	13	009	Baldwin County, GA	1991	NA	16632	15988	644	3.9
CN1301100000000	13	011	Banks County, GA	1991	NA	5847	5545	302	5.2
CN1301300000000	13	013	Barrow County, GA	1991	NA	15089	14159	930	6.2
CN1301500000000	13	015	Bartow County, GA	1991	NA	29755	27733	2022	6.8
CN1301700000000	13	017	Ben Hill County, GA	1991	NA	7095	6693	402	5.7
CN1301900000000	13	019	Berrien County, GA	1991	NA	6592	6226	366	5.6
CN1302100000000	13	021	Bibb County, GA	1991	NA	68111	64994	3117	4.6
CN1302300000000	13	023	Bleckley County, GA	1991	NA	4794	4579	215	4.5
CN1302500000000	13	025	Brantley County, GA	1991	NA	4619	4275	344	7.4
CN1302700000000	13	027	Brooks County, GA	1991	NA	6384	6167	217	3.4
CN1302900000000	13	029	Bryan County, GA	1991	NA	7322	6987	335	4.6
CN1303100000000	13	031	Bulloch County, GA	1991	NA	20003	19145	858	4.3
CN1303300000000	13	033	Burke County, GA	1991	NA	8471	7490	981	11.6
CN1303500000000	13	035	Butts County, GA	1991	NA	6780	6289	491	7.2
CN1303700000000	13	037	Calhoun County, GA	1991	NA	2089	1948	141	6.7
CN1303900000000	13	039	Camden County, GA	1991	NA	13611	13093	518	3.8
CN1304300000000	13	043	Candler County, GA	1991	NA	3484	3335	149	4.3
CN1304500000000	13	045	Carroll County, GA	1991	NA	36171	34088	2083	5.8
CN1304700000000	13	047	Catoosa County, GA	1991	NA	21630	20608	1022	4.7
CN1304900000000	13	049	Charlton County, GA	1991	NA	3840	3678	162	4.2
CN1305100000000	13	051	Chatham County, GA	1991	NA	99590	95148	4442	4.5
CN1305300000000	13	053	Chattahoochee County, GA	1991	NA	1980	1827	153	7.7
CN1305500000000	13	055	Chattooga County, GA	1991	NA	10563	9785	778	7.4
CN1305700000000	13	057	Cherokee County, GA	1991	NA	52535	50533	2002	3.8
CN1305900000000	13	059	Clarke County, GA	1991	NA	42387	40707	1680	4
CN1306100000000	13	061	Clay County, GA	1991	NA	1385	1330	55	4
CN1306300000000	13	063	Clayton County, GA	1991	NA	102028	96053	5975	5.9
CN1306500000000	13	065	Clinch County, GA	1991	NA	2831	2704	127	4.5
CN1306700000000	13	067	Cobb County, GA	1991	NA	266809	255556	11253	4.2
CN1306900000000	13	069	Coffee County, GA	1991	NA	14520	13752	768	5.3
CN1307100000000	13	071	Colquitt County, GA	1991	NA	16233	15385	848	5.2
CN1307300000000	13	073	Columbia County, GA	1991	NA	35217	33969	1248	3.5
CN1307500000000	13	075	Cook County, GA	1991	NA	6092	5651	441	7.2
CN1307700000000	13	077	Coweta County, GA	1991	NA	28140	26559	1581	5.6
CN1307900000000	13	079	Crawford County, GA	1991	NA	4015	3723	292	7.3
CN1308100000000	13	081	Crisp County, GA	1991	NA	8660	8097	563	6.5
CN1308300000000	13	083	Dade County, GA	1991	NA	6266	5920	346	5.5
CN1308500000000	13	085	Dawson County, GA	1991	NA	5903	5628	275	4.7
CN1308700000000	13	087	Decatur County, GA	1991	NA	11033	10289	744	6.7
CN1308900000000	13	089	DeKalb County, GA	1991	NA	312445	297564	14881	4.8
CN1309100000000	13	091	Dodge County, GA	1991	NA	8106	7655	451	5.6
CN1309300000000	13	093	Dooly County, GA	1991	NA	3944	3659	285	7.2
CN1309500000000	13	095	Dougherty County, GA	1991	NA	42091	39229	2862	6.8
CN1309700000000	13	097	Douglas County, GA	1991	NA	39570	37676	1894	4.8
CN1309900000000	13	099	Early County, GA	1991	NA	5253	4887	366	7
CN1310100000000	13	101	Echols County, GA	1991	NA	1001	965	36	3.6
CN1310300000000	13	103	Effingham County, GA	1991	NA	12538	11895	643	5.1
CN1310500000000	13	105	Elbert County, GA	1991	NA	8740	8127	613	7
CN1310700000000	13	107	Emanuel County, GA	1991	NA	8799	7945	854	9.7
CN1310900000000	13	109	Evans County, GA	1991	NA	3930	3743	187	4.8
CN1311100000000	13	111	Fannin County, GA	1991	NA	7165	6645	520	7.3
CN1311300000000	13	113	Fayette County, GA	1991	NA	34304	32986	1318	3.8
CN1311500000000	13	115	Floyd County, GA	1991	NA	42111	39641	2470	5.9
CN1311700000000	13	117	Forsyth County, GA	1991	NA	25355	24206	1149	4.5
CN1311900000000	13	119	Franklin County, GA	1991	NA	8078	7553	525	6.5
CN1312100000000	13	121	Fulton County, GA	1991	NA	333851	315693	18158	5.4
CN1312300000000	13	123	Gilmer County, GA	1991	NA	6515	6041	474	7.3
CN1312500000000	13	125	Glascock County, GA	1991	NA	1206	1136	70	5.8
CN1312700000000	13	127	Glynn County, GA	1991	NA	30619	29354	1265	4.1
CN1312900000000	13	129	Gordon County, GA	1991	NA	18367	17042	1325	7.2
CN1313100000000	13	131	Grady County, GA	1991	NA	9223	8722	501	5.4
CN1313300000000	13	133	Greene County, GA	1991	NA	5192	4787	405	7.8
CN1313500000000	13	135	Gwinnett County, GA	1991	NA	217988	209447	8541	3.9
CN1313700000000	13	137	Habersham County, GA	1991	NA	14030	13333	697	5
CN1313900000000	13	139	Hall County, GA	1991	NA	52955	50332	2623	5
CN1314100000000	13	141	Hancock County, GA	1991	NA	3647	3296	351	9.6
CN1314300000000	13	143	Haralson County, GA	1991	NA	9748	8788	960	9.8
CN1314500000000	13	145	Harris County, GA	1991	NA	8640	8219	421	4.9
CN1314700000000	13	147	Hart County, GA	1991	NA	9389	8847	542	5.8
CN1314900000000	13	149	Heard County, GA	1991	NA	3983	3689	294	7.4
CN1315100000000	13	151	Henry County, GA	1991	NA	33454	31863	1591	4.8
CN1315300000000	13	153	Houston County, GA	1991	NA	42535	40880	1655	3.9
CN1315500000000	13	155	Irwin County, GA	1991	NA	3725	3545	180	4.8
CN1315700000000	13	157	Jackson County, GA	1991	NA	15227	14285	942	6.2
CN1315900000000	13	159	Jasper County, GA	1991	NA	3824	3509	315	8.2
CN1316100000000	13	161	Jeff Davis County, GA	1991	NA	5783	5366	417	7.2
CN1316300000000	13	163	Jefferson County, GA	1991	NA	7568	7049	519	6.9
CN1316500000000	13	165	Jenkins County, GA	1991	NA	3634	3437	197	5.4
CN1316700000000	13	167	Johnson County, GA	1991	NA	3673	3474	199	5.4
CN1316900000000	13	169	Jones County, GA	1991	NA	10462	10017	445	4.3
CN1317100000000	13	171	Lamar County, GA	1991	NA	5977	5639	338	5.7
CN1317300000000	13	173	Lanier County, GA	1991	NA	2543	2437	106	4.2
CN1317500000000	13	175	Laurens County, GA	1991	NA	18652	17754	898	4.8
CN1317700000000	13	177	Lee County, GA	1991	NA	7977	7606	371	4.7
CN1317900000000	13	179	Liberty County, GA	1991	NA	13997	13320	677	4.8
CN1318100000000	13	181	Lincoln County, GA	1991	NA	3579	3417	162	4.5
CN1318300000000	13	183	Long County, GA	1991	NA	2391	2313	78	3.3
CN1318500000000	13	185	Lowndes County, GA	1991	NA	33956	32593	1363	4
CN1318700000000	13	187	Lumpkin County, GA	1991	NA	7411	7032	379	5.1
CN1318900000000	13	189	McDuffie County, GA	1991	NA	9421	8829	592	6.3
CN1319100000000	13	191	McIntosh County, GA	1991	NA	3505	3290	215	6.1
CN1319300000000	13	193	Macon County, GA	1991	NA	5511	4962	549	10
CN1319500000000	13	195	Madison County, GA	1991	NA	11181	10591	590	5.3
CN1319700000000	13	197	Marion County, GA	1991	NA	2109	1961	148	7
CN1319900000000	13	199	Meriwether County, GA	1991	NA	9377	8726	651	6.9
CN1320100000000	13	201	Miller County, GA	1991	NA	2734	2565	169	6.2
CN1320500000000	13	205	Mitchell County, GA	1991	NA	8897	8178	719	8.1
CN1320700000000	13	207	Monroe County, GA	1991	NA	7703	7201	502	6.5
CN1320900000000	13	209	Montgomery County, GA	1991	NA	3338	3132	206	6.2
CN1321100000000	13	211	Morgan County, GA	1991	NA	5931	5548	383	6.5
CN1321300000000	13	213	Murray County, GA	1991	NA	14660	13558	1102	7.5
CN1321500000000	13	215	Muscogee County, GA	1991	NA	75546	71741	3805	5
CN1321700000000	13	217	Newton County, GA	1991	NA	20694	19500	1194	5.8
CN1321900000000	13	219	Oconee County, GA	1991	NA	9576	9260	316	3.3
CN1322100000000	13	221	Oglethorpe County, GA	1991	NA	5137	4849	288	5.6
CN1322300000000	13	223	Paulding County, GA	1991	NA	22914	21720	1194	5.2
CN1322500000000	13	225	Peach County, GA	1991	NA	9320	8760	560	6
CN1322700000000	13	227	Pickens County, GA	1991	NA	7503	6996	507	6.8
CN1322900000000	13	229	Pierce County, GA	1991	NA	6368	5986	382	6
CN1323100000000	13	231	Pike County, GA	1991	NA	5182	4924	258	5
CN1323300000000	13	233	Polk County, GA	1991	NA	15914	14401	1513	9.5
CN1323500000000	13	235	Pulaski County, GA	1991	NA	3688	3536	152	4.1
CN1323700000000	13	237	Putnam County, GA	1991	NA	6927	6595	332	4.8
CN1323900000000	13	239	Quitman County, GA	1991	NA	893	843	50	5.6
CN1324100000000	13	241	Rabun County, GA	1991	NA	5675	5299	376	6.6
CN1324300000000	13	243	Randolph County, GA	1991	NA	2947	2731	216	7.3
CN1324500000000	13	245	Richmond County, GA	1991	NA	84686	79879	4807	5.7
CN1324700000000	13	247	Rockdale County, GA	1991	NA	30474	29201	1273	4.2
CN1324900000000	13	249	Schley County, GA	1991	NA	1354	1250	104	7.7
CN1325100000000	13	251	Screven County, GA	1991	NA	6320	5759	561	8.9
CN1325300000000	13	253	Seminole County, GA	1991	NA	4088	3822	266	6.5
CN1325500000000	13	255	Spalding County, GA	1991	NA	26520	24876	1644	6.2
CN1325700000000	13	257	Stephens County, GA	1991	NA	11718	11070	648	5.5
CN1325900000000	13	259	Stewart County, GA	1991	NA	2095	1923	172	8.2
CN1326100000000	13	261	Sumter County, GA	1991	NA	13429	12507	922	6.9
CN1326300000000	13	263	Talbot County, GA	1991	NA	2699	2540	159	5.9
CN1326500000000	13	265	Taliaferro County, GA	1991	NA	780	740	40	5.1
CN1326700000000	13	267	Tattnall County, GA	1991	NA	6845	6577	268	3.9
CN1326900000000	13	269	Taylor County, GA	1991	NA	3134	2894	240	7.7
CN1327100000000	13	271	Telfair County, GA	1991	NA	4522	4269	253	5.6
CN1327300000000	13	273	Terrell County, GA	1991	NA	4581	4289	292	6.4
CN1327500000000	13	275	Thomas County, GA	1991	NA	17907	17086	821	4.6
CN1327700000000	13	277	Tift County, GA	1991	NA	17514	16518	996	5.7
CN1327900000000	13	279	Toombs County, GA	1991	NA	10807	10110	697	6.4
CN1328100000000	13	281	Towns County, GA	1991	NA	2601	2463	138	5.3
CN1328300000000	13	283	Treutlen County, GA	1991	NA	2648	2463	185	7
CN1328500000000	13	285	Troup County, GA	1991	NA	25314	23311	2003	7.9
CN1328700000000	13	287	Turner County, GA	1991	NA	3573	3379	194	5.4
CN1328900000000	13	289	Twiggs County, GA	1991	NA	3890	3675	215	5.5
CN1329100000000	13	291	Union County, GA	1991	NA	5503	5258	245	4.5
CN1329300000000	13	293	Upson County, GA	1991	NA	12282	11630	652	5.3
CN1329500000000	13	295	Walker County, GA	1991	NA	28693	26863	1830	6.4
CN1329700000000	13	297	Walton County, GA	1991	NA	19266	18244	1022	5.3
CN1329900000000	13	299	Ware County, GA	1991	NA	14625	13778	847	5.8
CN1330100000000	13	301	Warren County, GA	1991	NA	2437	2165	272	11.2
CN1330300000000	13	303	Washington County, GA	1991	NA	8328	7896	432	5.2
CN1330500000000	13	305	Wayne County, GA	1991	NA	10825	10140	685	6.3
CN1330700000000	13	307	Webster County, GA	1991	NA	1025	954	71	6.9
CN1330900000000	13	309	Wheeler County, GA	1991	NA	1972	1860	112	5.7
CN1331100000000	13	311	White County, GA	1991	NA	7078	6704	374	5.3
CN1331300000000	13	313	Whitfield County, GA	1991	NA	39328	37032	2296	5.8
CN1331500000000	13	315	Wilcox County, GA	1991	NA	2830	2687	143	5.1
CN1331700000000	13	317	Wilkes County, GA	1991	NA	4811	4566	245	5.1
CN1331900000000	13	319	Wilkinson County, GA	1991	NA	4547	4353	194	4.3
CN1332100000000	13	321	Worth County, GA	1991	NA	8997	8576	421	4.7
CN1500100000000	15	001	Hawaii County, HI	1991	NA	63577	60621	2956	4.6
CN1500300000000	15	003	Honolulu County/city, HI	1991	NA	418193	409367	8826	2.1
CN1500700000000	15	007	Kauai County, HI	1991	NA	28489	27278	1211	4.3
CN1500900000000	15	009	Maui County, HI	1991	NA	61330	57922	3408	5.6
CN1600100000000	16	001	Ada County, ID	1991	NA	115245	110414	4831	4.2
CN1600300000000	16	003	Adams County, ID	1991	NA	1586	1358	228	14.4
CN1600500000000	16	005	Bannock County, ID	1991	NA	31711	29527	2184	6.9
CN1600700000000	16	007	Bear Lake County, ID	1991	NA	2410	2289	121	5
CN1600900000000	16	009	Benewah County, ID	1991	NA	3600	3156	444	12.3
CN1601100000000	16	011	Bingham County, ID	1991	NA	19042	17992	1050	5.5
CN1601300000000	16	013	Blaine County, ID	1991	NA	8323	7819	504	6.1
CN1601500000000	16	015	Boise County, ID	1991	NA	1814	1683	131	7.2
CN1601700000000	16	017	Bonner County, ID	1991	NA	12581	11254	1327	10.5
CN1601900000000	16	019	Bonneville County, ID	1991	NA	40658	39000	1658	4.1
CN1602100000000	16	021	Boundary County, ID	1991	NA	3499	3145	354	10.1
CN1602300000000	16	023	Butte County, ID	1991	NA	1466	1379	87	5.9
CN1602500000000	16	025	Camas County, ID	1991	NA	436	414	22	5
CN1602700000000	16	027	Canyon County, ID	1991	NA	44216	41086	3130	7.1
CN1602900000000	16	029	Caribou County, ID	1991	NA	3042	2862	180	5.9
CN1603100000000	16	031	Cassia County, ID	1991	NA	8629	8081	548	6.4
CN1603300000000	16	033	Clark County, ID	1991	NA	591	575	16	2.7
CN1603500000000	16	035	Clearwater County, ID	1991	NA	4042	3414	628	15.5
CN1603700000000	16	037	Custer County, ID	1991	NA	1976	1847	129	6.5
CN1603900000000	16	039	Elmore County, ID	1991	NA	7843	7409	434	5.5
CN1604100000000	16	041	Franklin County, ID	1991	NA	3837	3706	131	3.4
CN1604300000000	16	043	Fremont County, ID	1991	NA	5039	4618	421	8.4
CN1604500000000	16	045	Gem County, ID	1991	NA	5202	4756	446	8.6
CN1604700000000	16	047	Gooding County, ID	1991	NA	5320	5086	234	4.4
CN1604900000000	16	049	Idaho County, ID	1991	NA	6236	5512	724	11.6
CN1605100000000	16	051	Jefferson County, ID	1991	NA	8390	7932	458	5.5
CN1605300000000	16	053	Jerome County, ID	1991	NA	7144	6744	400	5.6
CN1605500000000	16	055	Kootenai County, ID	1991	NA	36203	33336	2867	7.9
CN1605700000000	16	057	Latah County, ID	1991	NA	13721	13125	596	4.3
CN1605900000000	16	059	Lemhi County, ID	1991	NA	3234	2873	361	11.2
CN1606100000000	16	061	Lewis County, ID	1991	NA	1492	1386	106	7.1
CN1606300000000	16	063	Lincoln County, ID	1991	NA	1968	1853	115	5.8
CN1606500000000	16	065	Madison County, ID	1991	NA	8663	8284	379	4.4
CN1606700000000	16	067	Minidoka County, ID	1991	NA	9252	8647	605	6.5
CN1606900000000	16	069	Nez Perce County, ID	1991	NA	19794	18855	939	4.7
CN1607100000000	16	071	Oneida County, ID	1991	NA	1426	1375	51	3.6
CN1607300000000	16	073	Owyhee County, ID	1991	NA	3999	3770	229	5.7
CN1607500000000	16	075	Payette County, ID	1991	NA	8681	8035	646	7.4
CN1607700000000	16	077	Power County, ID	1991	NA	3334	3102	232	7
CN1607900000000	16	079	Shoshone County, ID	1991	NA	6643	5506	1137	17.1
CN1608100000000	16	081	Teton County, ID	1991	NA	1921	1851	70	3.6
CN1608300000000	16	083	Twin Falls County, ID	1991	NA	26223	24722	1501	5.7
CN1608500000000	16	085	Valley County, ID	1991	NA	3325	2978	347	10.4
CN1608700000000	16	087	Washington County, ID	1991	NA	4330	3751	579	13.4
CN1700100000000	17	001	Adams County, IL	1991	NA	33791	31913	1878	5.6
CN1700300000000	17	003	Alexander County, IL	1991	NA	4325	3780	545	12.6
CN1700500000000	17	005	Bond County, IL	1991	NA	7588	6959	629	8.3
CN1700700000000	17	007	Boone County, IL	1991	NA	18151	16370	1781	9.8
CN1700900000000	17	009	Brown County, IL	1991	NA	2428	2290	138	5.7
CN1701100000000	17	011	Bureau County, IL	1991	NA	18225	16999	1226	6.7
CN1701300000000	17	013	Calhoun County, IL	1991	NA	2713	2458	255	9.4
CN1701500000000	17	015	Carroll County, IL	1991	NA	8371	7797	574	6.9
CN1701700000000	17	017	Cass County, IL	1991	NA	6934	6393	541	7.8
CN1701900000000	17	019	Champaign County, IL	1991	NA	95230	91869	3361	3.5
CN1702100000000	17	021	Christian County, IL	1991	NA	17622	16415	1207	6.8
CN1702300000000	17	023	Clark County, IL	1991	NA	8906	8276	630	7.1
CN1702500000000	17	025	Clay County, IL	1991	NA	6948	6355	593	8.5
CN1702700000000	17	027	Clinton County, IL	1991	NA	16706	15528	1178	7.1
CN1702900000000	17	029	Coles County, IL	1991	NA	26395	24970	1425	5.4
CN1703100000000	17	031	Cook County, IL	1991	NA	2592809	2379989	212820	8.2
CN1703300000000	17	033	Crawford County, IL	1991	NA	8968	8120	848	9.5
CN1703500000000	17	035	Cumberland County, IL	1991	NA	5340	4890	450	8.4
CN1703700000000	17	037	DeKalb County, IL	1991	NA	42863	40070	2793	6.5
CN1703900000000	17	039	De Witt County, IL	1991	NA	8810	8194	616	7
CN1704100000000	17	041	Douglas County, IL	1991	NA	10819	10245	574	5.3
CN1704300000000	17	043	DuPage County, IL	1991	NA	459527	435787	23740	5.2
CN1704500000000	17	045	Edgar County, IL	1991	NA	9670	8930	740	7.7
CN1704700000000	17	047	Edwards County, IL	1991	NA	3722	3378	344	9.2
CN1704900000000	17	049	Effingham County, IL	1991	NA	16942	15646	1296	7.6
CN1705100000000	17	051	Fayette County, IL	1991	NA	9917	9080	837	8.4
CN1705300000000	17	053	Ford County, IL	1991	NA	6918	6514	404	5.8
CN1705500000000	17	055	Franklin County, IL	1991	NA	16925	14816	2109	12.5
CN1705700000000	17	057	Fulton County, IL	1991	NA	14799	13370	1429	9.7
CN1705900000000	17	059	Gallatin County, IL	1991	NA	3016	2750	266	8.8
CN1706100000000	17	061	Greene County, IL	1991	NA	7230	6751	479	6.6
CN1706300000000	17	063	Grundy County, IL	1991	NA	17128	15311	1817	10.6
CN1706500000000	17	065	Hamilton County, IL	1991	NA	3651	3234	417	11.4
CN1706700000000	17	067	Hancock County, IL	1991	NA	11355	10737	618	5.4
CN1706900000000	17	069	Hardin County, IL	1991	NA	1975	1839	136	6.9
CN1707100000000	17	071	Henderson County, IL	1991	NA	4614	4320	294	6.4
CN1707300000000	17	073	Henry County, IL	1991	NA	26554	24699	1855	7
CN1707500000000	17	075	Iroquois County, IL	1991	NA	16645	15821	824	5
CN1707700000000	17	077	Jackson County, IL	1991	NA	29685	27739	1946	6.6
CN1707900000000	17	079	Jasper County, IL	1991	NA	4883	4547	336	6.9
CN1708100000000	17	081	Jefferson County, IL	1991	NA	17827	15842	1985	11.1
CN1708300000000	17	083	Jersey County, IL	1991	NA	10216	9510	706	6.9
CN1708500000000	17	085	Jo Daviess County, IL	1991	NA	11136	10513	623	5.6
CN1708700000000	17	087	Johnson County, IL	1991	NA	4297	3810	487	11.3
CN1708900000000	17	089	Kane County, IL	1991	NA	176389	162727	13662	7.7
CN1709100000000	17	091	Kankakee County, IL	1991	NA	50202	46456	3746	7.5
CN1709300000000	17	093	Kendall County, IL	1991	NA	22274	20942	1332	6
CN1709500000000	17	095	Knox County, IL	1991	NA	29199	27246	1953	6.7
CN1709700000000	17	097	Lake County, IL	1991	NA	288382	274628	13754	4.8
CN1709900000000	17	099	LaSalle County, IL	1991	NA	52989	48434	4555	8.6
CN1710100000000	17	101	Lawrence County, IL	1991	NA	7497	6798	699	9.3
CN1710300000000	17	103	Lee County, IL	1991	NA	16825	15723	1102	6.5
CN1710500000000	17	105	Livingston County, IL	1991	NA	19810	18966	844	4.3
CN1710700000000	17	107	Logan County, IL	1991	NA	14139	13298	841	5.9
CN1710900000000	17	109	McDonough County, IL	1991	NA	18096	17418	678	3.7
CN1711100000000	17	111	McHenry County, IL	1991	NA	106223	98966	7257	6.8
CN1711300000000	17	113	McLean County, IL	1991	NA	75827	73023	2804	3.7
CN1711500000000	17	115	Macon County, IL	1991	NA	61257	56263	4994	8.2
CN1711700000000	17	117	Macoupin County, IL	1991	NA	22953	21223	1730	7.5
CN1711900000000	17	119	Madison County, IL	1991	NA	126714	117653	9061	7.2
CN1712100000000	17	121	Marion County, IL	1991	NA	19973	17817	2156	10.8
CN1712300000000	17	123	Marshall County, IL	1991	NA	6592	6211	381	5.8
CN1712500000000	17	125	Mason County, IL	1991	NA	8032	7243	789	9.8
CN1712700000000	17	127	Massac County, IL	1991	NA	6751	6274	477	7.1
CN1712900000000	17	129	Menard County, IL	1991	NA	6210	5923	287	4.6
CN1713100000000	17	131	Mercer County, IL	1991	NA	8697	8076	621	7.1
CN1713300000000	17	133	Monroe County, IL	1991	NA	12163	11483	680	5.6
CN1713500000000	17	135	Montgomery County, IL	1991	NA	14177	13070	1107	7.8
CN1713700000000	17	137	Morgan County, IL	1991	NA	19262	18363	899	4.7
CN1713900000000	17	139	Moultrie County, IL	1991	NA	7203	6738	465	6.5
CN1714100000000	17	141	Ogle County, IL	1991	NA	25689	24036	1653	6.4
CN1714300000000	17	143	Peoria County, IL	1991	NA	92461	86767	5694	6.2
CN1714500000000	17	145	Perry County, IL	1991	NA	8950	7608	1342	15
CN1714700000000	17	147	Piatt County, IL	1991	NA	8353	7882	471	5.6
CN1714900000000	17	149	Pike County, IL	1991	NA	8524	7952	572	6.7
CN1715100000000	17	151	Pope County, IL	1991	NA	1713	1529	184	10.7
CN1715300000000	17	153	Pulaski County, IL	1991	NA	3009	2671	338	11.2
CN1715500000000	17	155	Putnam County, IL	1991	NA	3016	2784	232	7.7
CN1715700000000	17	157	Randolph County, IL	1991	NA	15935	14738	1197	7.5
CN1715900000000	17	159	Richland County, IL	1991	NA	8557	8007	550	6.4
CN1716100000000	17	161	Rock Island County, IL	1991	NA	75424	70726	4698	6.2
CN1716300000000	17	163	St. Clair County, IL	1991	NA	117636	108540	9096	7.7
CN1716500000000	17	165	Saline County, IL	1991	NA	11075	9984	1091	9.9
CN1716700000000	17	167	Sangamon County, IL	1991	NA	105411	101177	4234	4
CN1716900000000	17	169	Schuyler County, IL	1991	NA	3686	3423	263	7.1
CN1717100000000	17	171	Scott County, IL	1991	NA	2883	2690	193	6.7
CN1717300000000	17	173	Shelby County, IL	1991	NA	10998	10123	875	8
CN1717500000000	17	175	Stark County, IL	1991	NA	2701	2479	222	8.2
CN1717700000000	17	177	Stephenson County, IL	1991	NA	25547	23892	1655	6.5
CN1717900000000	17	179	Tazewell County, IL	1991	NA	65526	61561	3965	6.1
CN1718100000000	17	181	Union County, IL	1991	NA	8237	7352	885	10.7
CN1718300000000	17	183	Vermilion County, IL	1991	NA	41713	38003	3710	8.9
CN1718500000000	17	185	Wabash County, IL	1991	NA	6118	5283	835	13.6
CN1718700000000	17	187	Warren County, IL	1991	NA	9943	9376	567	5.7
CN1718900000000	17	189	Washington County, IL	1991	NA	7691	7085	606	7.9
CN1719100000000	17	191	Wayne County, IL	1991	NA	8336	7596	740	8.9
CN1719300000000	17	193	White County, IL	1991	NA	7500	6845	655	8.7
CN1719500000000	17	195	Whiteside County, IL	1991	NA	31471	29309	2162	6.9
CN1719700000000	17	197	Will County, IL	1991	NA	189245	174825	14420	7.6
CN1719900000000	17	199	Williamson County, IL	1991	NA	26763	24251	2512	9.4
CN1720100000000	17	201	Winnebago County, IL	1991	NA	142637	132515	10122	7.1
CN1720300000000	17	203	Woodford County, IL	1991	NA	17140	16535	605	3.5
CN1800100000000	18	001	Adams County, IN	1991	NA	15125	14018	1107	7.3
CN1800300000000	18	003	Allen County, IN	1991	NA	160641	151062	9579	6
CN1800500000000	18	005	Bartholomew County, IN	1991	NA	33440	31469	1971	5.9
CN1800700000000	18	007	Benton County, IN	1991	NA	4637	4457	180	3.9
CN1800900000000	18	009	Blackford County, IN	1991	NA	6466	5668	798	12.3
CN1801100000000	18	011	Boone County, IN	1991	NA	20371	19730	641	3.1
CN1801300000000	18	013	Brown County, IN	1991	NA	7142	6815	327	4.6
CN1801500000000	18	015	Carroll County, IN	1991	NA	9939	9505	434	4.4
CN1801700000000	18	017	Cass County, IN	1991	NA	18659	17377	1282	6.9
CN1801900000000	18	019	Clark County, IN	1991	NA	45173	42608	2565	5.7
CN1802100000000	18	021	Clay County, IN	1991	NA	11480	10695	785	6.8
CN1802300000000	18	023	Clinton County, IN	1991	NA	14517	13824	693	4.8
CN1802500000000	18	025	Crawford County, IN	1991	NA	4407	3943	464	10.5
CN1802700000000	18	027	Daviess County, IN	1991	NA	12359	11772	587	4.7
CN1802900000000	18	029	Dearborn County, IN	1991	NA	19498	17836	1662	8.5
CN1803100000000	18	031	Decatur County, IN	1991	NA	11945	11433	512	4.3
CN1803300000000	18	033	DeKalb County, IN	1991	NA	19157	17780	1377	7.2
CN1803500000000	18	035	Delaware County, IN	1991	NA	58592	54714	3878	6.6
CN1803700000000	18	037	Dubois County, IN	1991	NA	20278	19557	721	3.6
CN1803900000000	18	039	Elkhart County, IN	1991	NA	82245	76544	5701	6.9
CN1804100000000	18	041	Fayette County, IN	1991	NA	12538	10925	1613	12.9
CN1804300000000	18	043	Floyd County, IN	1991	NA	32513	31016	1497	4.6
CN1804500000000	18	045	Fountain County, IN	1991	NA	8296	7624	672	8.1
CN1804700000000	18	047	Franklin County, IN	1991	NA	9680	8870	810	8.4
CN1804900000000	18	049	Fulton County, IN	1991	NA	9310	8723	587	6.3
CN1805100000000	18	051	Gibson County, IN	1991	NA	15675	14697	978	6.2
CN1805300000000	18	053	Grant County, IN	1991	NA	35608	32442	3166	8.9
CN1805500000000	18	055	Greene County, IN	1991	NA	14069	12886	1183	8.4
CN1805700000000	18	057	Hamilton County, IN	1991	NA	62723	61167	1556	2.5
CN1805900000000	18	059	Hancock County, IN	1991	NA	24426	23393	1033	4.2
CN1806100000000	18	061	Harrison County, IN	1991	NA	14902	14124	778	5.2
CN1806300000000	18	063	Hendricks County, IN	1991	NA	40508	39333	1175	2.9
CN1806500000000	18	065	Henry County, IN	1991	NA	23039	21058	1981	8.6
CN1806700000000	18	067	Howard County, IN	1991	NA	39877	36585	3292	8.3
CN1806900000000	18	069	Huntington County, IN	1991	NA	19036	17523	1513	7.9
CN1807100000000	18	071	Jackson County, IN	1991	NA	18985	17520	1465	7.7
CN1807300000000	18	073	Jasper County, IN	1991	NA	11844	11038	806	6.8
CN1807500000000	18	075	Jay County, IN	1991	NA	10585	9601	984	9.3
CN1807700000000	18	077	Jefferson County, IN	1991	NA	14481	13253	1228	8.5
CN1807900000000	18	079	Jennings County, IN	1991	NA	11552	10719	833	7.2
CN1808100000000	18	081	Johnson County, IN	1991	NA	48883	47137	1746	3.6
CN1808300000000	18	083	Knox County, IN	1991	NA	18459	17113	1346	7.3
CN1808500000000	18	085	Kosciusko County, IN	1991	NA	34061	32350	1711	5
CN1808700000000	18	087	LaGrange County, IN	1991	NA	13940	12898	1042	7.5
CN1808900000000	18	089	Lake County, IN	1991	NA	221896	206205	15691	7.1
CN1809100000000	18	091	LaPorte County, IN	1991	NA	51511	48586	2925	5.7
CN1809300000000	18	093	Lawrence County, IN	1991	NA	21084	19190	1894	9
CN1809500000000	18	095	Madison County, IN	1991	NA	63284	58969	4315	6.8
CN1809700000000	18	097	Marion County, IN	1991	NA	421789	402517	19272	4.6
CN1809900000000	18	099	Marshall County, IN	1991	NA	22220	20928	1292	5.8
CN1810100000000	18	101	Martin County, IN	1991	NA	4919	4554	365	7.4
CN1810300000000	18	103	Miami County, IN	1991	NA	15809	14464	1345	8.5
CN1810500000000	18	105	Monroe County, IN	1991	NA	53991	52150	1841	3.4
CN1810700000000	18	107	Montgomery County, IN	1991	NA	17436	16739	697	4
CN1810900000000	18	109	Morgan County, IN	1991	NA	29337	27808	1529	5.2
CN1811100000000	18	111	Newton County, IN	1991	NA	6371	6062	309	4.9
CN1811300000000	18	113	Noble County, IN	1991	NA	19463	17659	1804	9.3
CN1811500000000	18	115	Ohio County, IN	1991	NA	2541	2356	185	7.3
CN1811700000000	18	117	Orange County, IN	1991	NA	8309	7381	928	11.2
CN1811900000000	18	119	Owen County, IN	1991	NA	8163	7688	475	5.8
CN1812100000000	18	121	Parke County, IN	1991	NA	7043	6622	421	6
CN1812300000000	18	123	Perry County, IN	1991	NA	8446	7630	816	9.7
CN1812500000000	18	125	Pike County, IN	1991	NA	5764	5399	365	6.3
CN1812700000000	18	127	Porter County, IN	1991	NA	66597	63651	2946	4.4
CN1812900000000	18	129	Posey County, IN	1991	NA	12687	12040	647	5.1
CN1813100000000	18	131	Pulaski County, IN	1991	NA	5838	5457	381	6.5
CN1813300000000	18	133	Putnam County, IN	1991	NA	14189	13412	777	5.5
CN1813500000000	18	135	Randolph County, IN	1991	NA	12099	10682	1417	11.7
CN1813700000000	18	137	Ripley County, IN	1991	NA	12173	11190	983	8.1
CN1813900000000	18	139	Rush County, IN	1991	NA	8778	8168	610	6.9
CN1814100000000	18	141	St. Joseph County, IN	1991	NA	123587	115925	7662	6.2
CN1814300000000	18	143	Scott County, IN	1991	NA	9502	8743	759	8
CN1814500000000	18	145	Shelby County, IN	1991	NA	21216	19920	1296	6.1
CN1814700000000	18	147	Spencer County, IN	1991	NA	9414	8735	679	7.2
CN1814900000000	18	149	Starke County, IN	1991	NA	10047	9282	765	7.6
CN1815100000000	18	151	Steuben County, IN	1991	NA	14752	13724	1028	7
CN1815300000000	18	153	Sullivan County, IN	1991	NA	8727	7972	755	8.7
CN1815500000000	18	155	Switzerland County, IN	1991	NA	3944	3621	323	8.2
CN1815700000000	18	157	Tippecanoe County, IN	1991	NA	64977	63214	1763	2.7
CN1815900000000	18	159	Tipton County, IN	1991	NA	8144	7599	545	6.7
CN1816100000000	18	161	Union County, IN	1991	NA	3402	3085	317	9.3
CN1816300000000	18	163	Vanderburgh County, IN	1991	NA	83757	78822	4935	5.9
CN1816500000000	18	165	Vermillion County, IN	1991	NA	7532	6997	535	7.1
CN1816700000000	18	167	Vigo County, IN	1991	NA	49735	47017	2718	5.5
CN1816900000000	18	169	Wabash County, IN	1991	NA	18114	16503	1611	8.9
CN1817100000000	18	171	Warren County, IN	1991	NA	3740	3516	224	6
CN1817300000000	18	173	Warrick County, IN	1991	NA	23545	22436	1109	4.7
CN1817500000000	18	175	Washington County, IN	1991	NA	10688	9788	900	8.4
CN1817700000000	18	177	Wayne County, IN	1991	NA	35083	31225	3858	11
CN1817900000000	18	179	Wells County, IN	1991	NA	13475	12766	709	5.3
CN1818100000000	18	181	White County, IN	1991	NA	11991	11264	727	6.1
CN1818300000000	18	183	Whitley County, IN	1991	NA	14674	13696	978	6.7
CN1900100000000	19	001	Adair County, IA	1991	NA	4023	3899	124	3.1
CN1900300000000	19	003	Adams County, IA	1991	NA	2421	2308	113	4.7
CN1900500000000	19	005	Allamakee County, IA	1991	NA	7269	6873	396	5.4
CN1900700000000	19	007	Appanoose County, IA	1991	NA	6624	6193	431	6.5
CN1900900000000	19	009	Audubon County, IA	1991	NA	3747	3638	109	2.9
CN1901100000000	19	011	Benton County, IA	1991	NA	11109	10533	576	5.2
CN1901300000000	19	013	Black Hawk County, IA	1991	NA	64163	60184	3979	6.2
CN1901500000000	19	015	Boone County, IA	1991	NA	12866	12235	631	4.9
CN1901700000000	19	017	Bremer County, IA	1991	NA	11901	11337	564	4.7
CN1901900000000	19	019	Buchanan County, IA	1991	NA	9869	9285	584	5.9
CN1902100000000	19	021	Buena Vista County, IA	1991	NA	10529	10272	257	2.4
CN1902300000000	19	023	Butler County, IA	1991	NA	7584	7107	477	6.3
CN1902500000000	19	025	Calhoun County, IA	1991	NA	5056	4897	159	3.1
CN1902700000000	19	027	Carroll County, IA	1991	NA	11015	10602	413	3.7
CN1902900000000	19	029	Cass County, IA	1991	NA	7532	7123	409	5.4
CN1903100000000	19	031	Cedar County, IA	1991	NA	9242	8965	277	3
CN1903300000000	19	033	Cerro Gordo County, IA	1991	NA	25889	24452	1437	5.6
CN1903500000000	19	035	Cherokee County, IA	1991	NA	6898	6698	200	2.9
CN1903700000000	19	037	Chickasaw County, IA	1991	NA	7125	6641	484	6.8
CN1903900000000	19	039	Clarke County, IA	1991	NA	4369	4076	293	6.7
CN1904100000000	19	041	Clay County, IA	1991	NA	8876	8576	300	3.4
CN1904300000000	19	043	Clayton County, IA	1991	NA	9222	8673	549	6
CN1904500000000	19	045	Clinton County, IA	1991	NA	26229	24632	1597	6.1
CN1904700000000	19	047	Crawford County, IA	1991	NA	8454	8075	379	4.5
CN1904900000000	19	049	Dallas County, IA	1991	NA	16456	15898	558	3.4
CN1905100000000	19	051	Davis County, IA	1991	NA	4022	3777	245	6.1
CN1905300000000	19	053	Decatur County, IA	1991	NA	3860	3609	251	6.5
CN1905500000000	19	055	Delaware County, IA	1991	NA	8994	8512	482	5.4
CN1905700000000	19	057	Des Moines County, IA	1991	NA	22512	21179	1333	5.9
CN1905900000000	19	059	Dickinson County, IA	1991	NA	8302	8005	297	3.6
CN1906100000000	19	061	Dubuque County, IA	1991	NA	47413	44520	2893	6.1
CN1906300000000	19	063	Emmet County, IA	1991	NA	5705	5370	335	5.9
CN1906500000000	19	065	Fayette County, IA	1991	NA	10429	9880	549	5.3
CN1906700000000	19	067	Floyd County, IA	1991	NA	8647	8070	577	6.7
CN1906900000000	19	069	Franklin County, IA	1991	NA	5704	5463	241	4.2
CN1907100000000	19	071	Fremont County, IA	1991	NA	3725	3542	183	4.9
CN1907300000000	19	073	Greene County, IA	1991	NA	5002	4760	242	4.8
CN1907500000000	19	075	Grundy County, IA	1991	NA	5839	5640	199	3.4
CN1907700000000	19	077	Guthrie County, IA	1991	NA	5669	5420	249	4.4
CN1907900000000	19	079	Hamilton County, IA	1991	NA	8505	8149	356	4.2
CN1908100000000	19	081	Hancock County, IA	1991	NA	6008	5665	343	5.7
CN1908300000000	19	083	Hardin County, IA	1991	NA	9462	8929	533	5.6
CN1908500000000	19	085	Harrison County, IA	1991	NA	7244	6862	382	5.3
CN1908700000000	19	087	Henry County, IA	1991	NA	10196	9749	447	4.4
CN1908900000000	19	089	Howard County, IA	1991	NA	4702	4515	187	4
CN1909100000000	19	091	Humboldt County, IA	1991	NA	5012	4813	199	4
CN1909300000000	19	093	Ida County, IA	1991	NA	3776	3639	137	3.6
CN1909500000000	19	095	Iowa County, IA	1991	NA	8410	8200	210	2.5
CN1909700000000	19	097	Jackson County, IA	1991	NA	10304	9622	682	6.6
CN1909900000000	19	099	Jasper County, IA	1991	NA	18005	17202	803	4.5
CN1910100000000	19	101	Jefferson County, IA	1991	NA	8613	8216	397	4.6
CN1910300000000	19	103	Johnson County, IA	1991	NA	58595	56839	1756	3
CN1910500000000	19	105	Jones County, IA	1991	NA	9355	8877	478	5.1
CN1910700000000	19	107	Keokuk County, IA	1991	NA	5269	4999	270	5.1
CN1910900000000	19	109	Kossuth County, IA	1991	NA	8930	8440	490	5.5
CN1911100000000	19	111	Lee County, IA	1991	NA	19537	18059	1478	7.6
CN1911300000000	19	113	Linn County, IA	1991	NA	97040	92264	4776	4.9
CN1911500000000	19	115	Louisa County, IA	1991	NA	6109	5793	316	5.2
CN1911700000000	19	117	Lucas County, IA	1991	NA	4300	4061	239	5.6
CN1911900000000	19	119	Lyon County, IA	1991	NA	5667	5535	132	2.3
CN1912100000000	19	121	Madison County, IA	1991	NA	6394	6036	358	5.6
CN1912300000000	19	123	Mahaska County, IA	1991	NA	10614	10128	486	4.6
CN1912500000000	19	125	Marion County, IA	1991	NA	15939	15317	622	3.9
CN1912700000000	19	127	Marshall County, IA	1991	NA	20209	19471	738	3.7
CN1912900000000	19	129	Mills County, IA	1991	NA	6573	6343	230	3.5
CN1913100000000	19	131	Mitchell County, IA	1991	NA	5184	4958	226	4.4
CN1913300000000	19	133	Monona County, IA	1991	NA	4457	4265	192	4.3
CN1913500000000	19	135	Monroe County, IA	1991	NA	3919	3688	231	5.9
CN1913700000000	19	137	Montgomery County, IA	1991	NA	6006	5754	252	4.2
CN1913900000000	19	139	Muscatine County, IA	1991	NA	20968	19790	1178	5.6
CN1914100000000	19	141	O'Brien County, IA	1991	NA	7444	7264	180	2.4
CN1914300000000	19	143	Osceola County, IA	1991	NA	3592	3476	116	3.2
CN1914500000000	19	145	Page County, IA	1991	NA	8188	7704	484	5.9
CN1914700000000	19	147	Palo Alto County, IA	1991	NA	4926	4738	188	3.8
CN1914900000000	19	149	Plymouth County, IA	1991	NA	12382	11977	405	3.3
CN1915100000000	19	151	Pocahontas County, IA	1991	NA	4320	4189	131	3
CN1915300000000	19	153	Polk County, IA	1991	NA	193821	186896	6925	3.6
CN1915500000000	19	155	Pottawattamie County, IA	1991	NA	43988	42013	1975	4.5
CN1915700000000	19	157	Poweshiek County, IA	1991	NA	9822	9379	443	4.5
CN1915900000000	19	159	Ringgold County, IA	1991	NA	2615	2508	107	4.1
CN1916100000000	19	161	Sac County, IA	1991	NA	5919	5694	225	3.8
CN1916300000000	19	163	Scott County, IA	1991	NA	80831	76848	3983	4.9
CN1916500000000	19	165	Shelby County, IA	1991	NA	6676	6322	354	5.3
CN1916700000000	19	167	Sioux County, IA	1991	NA	15494	15056	438	2.8
CN1916900000000	19	169	Story County, IA	1991	NA	42040	40390	1650	3.9
CN1917100000000	19	171	Tama County, IA	1991	NA	8184	7761	423	5.2
CN1917300000000	19	173	Taylor County, IA	1991	NA	3288	3144	144	4.4
CN1917500000000	19	175	Union County, IA	1991	NA	6067	5703	364	6
CN1917700000000	19	177	Van Buren County, IA	1991	NA	3731	3532	199	5.3
CN1917900000000	19	179	Wapello County, IA	1991	NA	17450	16151	1299	7.4
CN1918100000000	19	181	Warren County, IA	1991	NA	20807	20158	649	3.1
CN1918300000000	19	183	Washington County, IA	1991	NA	10713	10352	361	3.4
CN1918500000000	19	185	Wayne County, IA	1991	NA	3146	3030	116	3.7
CN1918700000000	19	187	Webster County, IA	1991	NA	19584	18577	1007	5.1
CN1918900000000	19	189	Winnebago County, IA	1991	NA	5990	5630	360	6
CN1919100000000	19	191	Winneshiek County, IA	1991	NA	11462	10851	611	5.3
CN1919300000000	19	193	Woodbury County, IA	1991	NA	51504	49025	2479	4.8
CN1919500000000	19	195	Worth County, IA	1991	NA	4023	3796	227	5.6
CN1919700000000	19	197	Wright County, IA	1991	NA	7199	6908	291	4
CN2000100000000	20	001	Allen County, KS	1991	NA	6628	6239	389	5.9
CN2000300000000	20	003	Anderson County, KS	1991	NA	3889	3623	266	6.8
CN2000500000000	20	005	Atchison County, KS	1991	NA	8255	7728	527	6.4
CN2000700000000	20	007	Barber County, KS	1991	NA	2788	2709	79	2.8
CN2000900000000	20	009	Barton County, KS	1991	NA	15245	14694	551	3.6
CN2001100000000	20	011	Bourbon County, KS	1991	NA	6623	6236	387	5.8
CN2001300000000	20	013	Brown County, KS	1991	NA	4911	4660	251	5.1
CN2001500000000	20	015	Butler County, KS	1991	NA	26519	25592	927	3.5
CN2001700000000	20	017	Chase County, KS	1991	NA	1423	1333	90	6.3
CN2001900000000	20	019	Chautauqua County, KS	1991	NA	1783	1697	86	4.8
CN2002100000000	20	021	Cherokee County, KS	1991	NA	9631	8930	701	7.3
CN2002300000000	20	023	Cheyenne County, KS	1991	NA	1517	1499	18	1.2
CN2002500000000	20	025	Clark County, KS	1991	NA	1265	1241	24	1.9
CN2002700000000	20	027	Clay County, KS	1991	NA	4391	4228	163	3.7
CN2002900000000	20	029	Cloud County, KS	1991	NA	5258	5107	151	2.9
CN2003100000000	20	031	Coffey County, KS	1991	NA	4098	3883	215	5.2
CN2003300000000	20	033	Comanche County, KS	1991	NA	1083	1071	12	1.1
CN2003500000000	20	035	Cowley County, KS	1991	NA	17894	17012	882	4.9
CN2003700000000	20	037	Crawford County, KS	1991	NA	15930	15049	881	5.5
CN2003900000000	20	039	Decatur County, KS	1991	NA	1949	1917	32	1.6
CN2004100000000	20	041	Dickinson County, KS	1991	NA	9570	9196	374	3.9
CN2004300000000	20	043	Doniphan County, KS	1991	NA	3689	3395	294	8
CN2004500000000	20	045	Douglas County, KS	1991	NA	45734	43679	2055	4.5
CN2004700000000	20	047	Edwards County, KS	1991	NA	1832	1781	51	2.8
CN2004900000000	20	049	Elk County, KS	1991	NA	1423	1356	67	4.7
CN2005100000000	20	051	Ellis County, KS	1991	NA	14644	14162	482	3.3
CN2005300000000	20	053	Ellsworth County, KS	1991	NA	2888	2810	78	2.7
CN2005500000000	20	055	Finney County, KS	1991	NA	18031	17520	511	2.8
CN2005700000000	20	057	Ford County, KS	1991	NA	14297	13904	393	2.7
CN2005900000000	20	059	Franklin County, KS	1991	NA	11315	10670	645	5.7
CN2006100000000	20	061	Geary County, KS	1991	NA	10775	9832	943	8.8
CN2006300000000	20	063	Gove County, KS	1991	NA	1468	1448	20	1.4
CN2006500000000	20	065	Graham County, KS	1991	NA	1725	1689	36	2.1
CN2006700000000	20	067	Grant County, KS	1991	NA	3698	3595	103	2.8
CN2006900000000	20	069	Gray County, KS	1991	NA	2647	2588	59	2.2
CN2007100000000	20	071	Greeley County, KS	1991	NA	880	866	14	1.6
CN2007300000000	20	073	Greenwood County, KS	1991	NA	3482	3325	157	4.5
CN2007500000000	20	075	Hamilton County, KS	1991	NA	1234	1217	17	1.4
CN2007700000000	20	077	Harper County, KS	1991	NA	3202	3120	82	2.6
CN2007900000000	20	079	Harvey County, KS	1991	NA	16137	15598	539	3.3
CN2008100000000	20	081	Haskell County, KS	1991	NA	1995	1956	39	2
CN2008300000000	20	083	Hodgeman County, KS	1991	NA	951	939	12	1.3
CN2008500000000	20	085	Jackson County, KS	1991	NA	5623	5273	350	6.2
CN2008700000000	20	087	Jefferson County, KS	1991	NA	8532	8083	449	5.3
CN2008900000000	20	089	Jewell County, KS	1991	NA	2036	1997	39	1.9
CN2009100000000	20	091	Johnson County, KS	1991	NA	213378	206355	7023	3.3
CN2009300000000	20	093	Kearny County, KS	1991	NA	2027	1988	39	1.9
CN2009500000000	20	095	Kingman County, KS	1991	NA	3970	3805	165	4.2
CN2009700000000	20	097	Kiowa County, KS	1991	NA	1738	1702	36	2.1
CN2009900000000	20	099	Labette County, KS	1991	NA	11712	11009	703	6
CN2010100000000	20	101	Lane County, KS	1991	NA	1106	1091	15	1.4
CN2010300000000	20	103	Leavenworth County, KS	1991	NA	25816	24494	1322	5.1
CN2010500000000	20	105	Lincoln County, KS	1991	NA	1803	1742	61	3.4
CN2010700000000	20	107	Linn County, KS	1991	NA	3305	2989	316	9.6
CN2010900000000	20	109	Logan County, KS	1991	NA	1567	1521	46	2.9
CN2011100000000	20	111	Lyon County, KS	1991	NA	18769	17954	815	4.3
CN2011300000000	20	113	McPherson County, KS	1991	NA	14378	13902	476	3.3
CN2011500000000	20	115	Marion County, KS	1991	NA	6570	6394	176	2.7
CN2011700000000	20	117	Marshall County, KS	1991	NA	5287	5116	171	3.2
CN2011900000000	20	119	Meade County, KS	1991	NA	2117	2070	47	2.2
CN2012100000000	20	121	Miami County, KS	1991	NA	12217	11517	700	5.7
CN2012300000000	20	123	Mitchell County, KS	1991	NA	3511	3394	117	3.3
CN2012500000000	20	125	Montgomery County, KS	1991	NA	17763	16626	1137	6.4
CN2012700000000	20	127	Morris County, KS	1991	NA	2923	2800	123	4.2
CN2012900000000	20	129	Morton County, KS	1991	NA	1657	1622	35	2.1
CN2013100000000	20	131	Nemaha County, KS	1991	NA	5229	5128	101	1.9
CN2013300000000	20	133	Neosho County, KS	1991	NA	8638	8215	423	4.9
CN2013500000000	20	135	Ness County, KS	1991	NA	1951	1926	25	1.3
CN2013700000000	20	137	Norton County, KS	1991	NA	2854	2798	56	2
CN2013900000000	20	139	Osage County, KS	1991	NA	7487	6970	517	6.9
CN2014100000000	20	141	Osborne County, KS	1991	NA	2510	2455	55	2.2
CN2014300000000	20	143	Ottawa County, KS	1991	NA	2771	2684	87	3.1
CN2014500000000	20	145	Pawnee County, KS	1991	NA	3675	3583	92	2.5
CN2014700000000	20	147	Phillips County, KS	1991	NA	3073	3000	73	2.4
CN2014900000000	20	149	Pottawatomie County, KS	1991	NA	8699	8244	455	5.2
CN2015100000000	20	151	Pratt County, KS	1991	NA	4848	4715	133	2.7
CN2015300000000	20	153	Rawlins County, KS	1991	NA	1592	1547	45	2.8
CN2015500000000	20	155	Reno County, KS	1991	NA	31385	29805	1580	5
CN2015700000000	20	157	Republic County, KS	1991	NA	3239	3191	48	1.5
CN2015900000000	20	159	Rice County, KS	1991	NA	4993	4819	174	3.5
CN2016100000000	20	161	Riley County, KS	1991	NA	28154	26726	1428	5.1
CN2016300000000	20	163	Rooks County, KS	1991	NA	2794	2737	57	2
CN2016500000000	20	165	Rush County, KS	1991	NA	1841	1789	52	2.8
CN2016700000000	20	167	Russell County, KS	1991	NA	3753	3639	114	3
CN2016900000000	20	169	Saline County, KS	1991	NA	27837	26787	1050	3.8
CN2017100000000	20	171	Scott County, KS	1991	NA	2717	2661	56	2.1
CN2017300000000	20	173	Sedgwick County, KS	1991	NA	217966	208904	9062	4.2
CN2017500000000	20	175	Seward County, KS	1991	NA	9905	9555	350	3.5
CN2017700000000	20	177	Shawnee County, KS	1991	NA	86650	82441	4209	4.9
CN2017900000000	20	179	Sheridan County, KS	1991	NA	1501	1477	24	1.6
CN2018100000000	20	181	Sherman County, KS	1991	NA	3566	3478	88	2.5
CN2018300000000	20	183	Smith County, KS	1991	NA	2393	2347	46	1.9
CN2018500000000	20	185	Stafford County, KS	1991	NA	2435	2372	63	2.6
CN2018700000000	20	187	Stanton County, KS	1991	NA	1130	1101	29	2.6
CN2018900000000	20	189	Stevens County, KS	1991	NA	2495	2443	52	2.1
CN2019100000000	20	191	Sumner County, KS	1991	NA	12391	11792	599	4.8
CN2019300000000	20	193	Thomas County, KS	1991	NA	4238	4144	94	2.2
CN2019500000000	20	195	Trego County, KS	1991	NA	1804	1772	32	1.8
CN2019700000000	20	197	Wabaunsee County, KS	1991	NA	3302	3148	154	4.7
CN2019900000000	20	199	Wallace County, KS	1991	NA	846	822	24	2.8
CN2020100000000	20	201	Washington County, KS	1991	NA	3532	3419	113	3.2
CN2020300000000	20	203	Wichita County, KS	1991	NA	1270	1247	23	1.8
CN2020500000000	20	205	Wilson County, KS	1991	NA	4554	4247	307	6.7
CN2020700000000	20	207	Woodson County, KS	1991	NA	1739	1669	70	4
CN2020900000000	20	209	Wyandotte County, KS	1991	NA	77702	71101	6601	8.5
CN2100100000000	21	001	Adair County, KY	1991	NA	7610	6924	686	9
CN2100300000000	21	003	Allen County, KY	1991	NA	7116	6483	633	8.9
CN2100500000000	21	005	Anderson County, KY	1991	NA	8365	7934	431	5.2
CN2100700000000	21	007	Ballard County, KY	1991	NA	3775	3442	333	8.8
CN2100900000000	21	009	Barren County, KY	1991	NA	17011	15523	1488	8.7
CN2101100000000	21	011	Bath County, KY	1991	NA	4616	3929	687	14.9
CN2101300000000	21	013	Bell County, KY	1991	NA	10670	9290	1380	12.9
CN2101500000000	21	015	Boone County, KY	1991	NA	32859	31202	1657	5
CN2101700000000	21	017	Bourbon County, KY	1991	NA	9431	8988	443	4.7
CN2101900000000	21	019	Boyd County, KY	1991	NA	22888	20739	2149	9.4
CN2102100000000	21	021	Boyle County, KY	1991	NA	12507	11588	919	7.3
CN2102300000000	21	023	Bracken County, KY	1991	NA	3557	3224	333	9.4
CN2102500000000	21	025	Breathitt County, KY	1991	NA	5191	4188	1003	19.3
CN2102700000000	21	027	Breckinridge County, KY	1991	NA	7075	6465	610	8.6
CN2102900000000	21	029	Bullitt County, KY	1991	NA	25735	24405	1330	5.2
CN2103100000000	21	031	Butler County, KY	1991	NA	5424	4873	551	10.2
CN2103300000000	21	033	Caldwell County, KY	1991	NA	6115	5575	540	8.8
CN2103500000000	21	035	Calloway County, KY	1991	NA	15499	14654	845	5.5
CN2103700000000	21	037	Campbell County, KY	1991	NA	43048	40802	2246	5.2
CN2103900000000	21	039	Carlisle County, KY	1991	NA	2615	2355	260	9.9
CN2104100000000	21	041	Carroll County, KY	1991	NA	4087	3831	256	6.3
CN2104300000000	21	043	Carter County, KY	1991	NA	10779	9063	1716	15.9
CN2104500000000	21	045	Casey County, KY	1991	NA	6670	6094	576	8.6
CN2104700000000	21	047	Christian County, KY	1991	NA	23391	21496	1895	8.1
CN2104900000000	21	049	Clark County, KY	1991	NA	14619	13587	1032	7.1
CN2105100000000	21	051	Clay County, KY	1991	NA	6667	6026	641	9.6
CN2105300000000	21	053	Clinton County, KY	1991	NA	4448	4111	337	7.6
CN2105500000000	21	055	Crittenden County, KY	1991	NA	3795	3358	437	11.5
CN2105700000000	21	057	Cumberland County, KY	1991	NA	3020	2808	212	7
CN2105900000000	21	059	Daviess County, KY	1991	NA	44628	41464	3164	7.1
CN2106100000000	21	061	Edmonson County, KY	1991	NA	4443	3964	479	10.8
CN2106300000000	21	063	Elliott County, KY	1991	NA	2450	2037	413	16.9
CN2106500000000	21	065	Estill County, KY	1991	NA	5668	4992	676	11.9
CN2106700000000	21	067	Fayette County, KY	1991	NA	126559	121876	4683	3.7
CN2106900000000	21	069	Fleming County, KY	1991	NA	6194	5759	435	7
CN2107100000000	21	071	Floyd County, KY	1991	NA	14943	13254	1689	11.3
CN2107300000000	21	073	Franklin County, KY	1991	NA	24406	23373	1033	4.2
CN2107500000000	21	075	Fulton County, KY	1991	NA	3615	3243	372	10.3
CN2107700000000	21	077	Gallatin County, KY	1991	NA	2754	2544	210	7.6
CN2107900000000	21	079	Garrard County, KY	1991	NA	5713	5307	406	7.1
CN2108100000000	21	081	Grant County, KY	1991	NA	7889	7347	542	6.9
CN2108300000000	21	083	Graves County, KY	1991	NA	15969	14306	1663	10.4
CN2108500000000	21	085	Grayson County, KY	1991	NA	9870	9018	852	8.6
CN2108700000000	21	087	Green County, KY	1991	NA	5221	4829	392	7.5
CN2108900000000	21	089	Greenup County, KY	1991	NA	16074	14600	1474	9.2
CN2109100000000	21	091	Hancock County, KY	1991	NA	3630	3223	407	11.2
CN2109300000000	21	093	Hardin County, KY	1991	NA	34479	32095	2384	6.9
CN2109500000000	21	095	Harlan County, KY	1991	NA	11266	9497	1769	15.7
CN2109700000000	21	097	Harrison County, KY	1991	NA	7626	7134	492	6.5
CN2109900000000	21	099	Hart County, KY	1991	NA	7124	6463	661	9.3
CN2110100000000	21	101	Henderson County, KY	1991	NA	22388	20803	1585	7.1
CN2110300000000	21	103	Henry County, KY	1991	NA	7091	6766	325	4.6
CN2110500000000	21	105	Hickman County, KY	1991	NA	2592	2364	228	8.8
CN2110700000000	21	107	Hopkins County, KY	1991	NA	20917	19189	1728	8.3
CN2110900000000	21	109	Jackson County, KY	1991	NA	4484	4022	462	10.3
CN2111100000000	21	111	Jefferson County, KY	1991	NA	349737	328679	21058	6
CN2111300000000	21	113	Jessamine County, KY	1991	NA	16738	16032	706	4.2
CN2111500000000	21	115	Johnson County, KY	1991	NA	9289	8331	958	10.3
CN2111700000000	21	117	Kenton County, KY	1991	NA	75468	71737	3731	4.9
CN2111900000000	21	119	Knott County, KY	1991	NA	5500	4804	696	12.7
CN2112100000000	21	121	Knox County, KY	1991	NA	10062	9166	896	8.9
CN2112300000000	21	123	Larue County, KY	1991	NA	5623	5275	348	6.2
CN2112500000000	21	125	Laurel County, KY	1991	NA	18807	17330	1477	7.9
CN2112700000000	21	127	Lawrence County, KY	1991	NA	4692	4014	678	14.5
CN2112900000000	21	129	Lee County, KY	1991	NA	2470	2217	253	10.2
CN2113100000000	21	131	Leslie County, KY	1991	NA	4330	3717	613	14.2
CN2113300000000	21	133	Letcher County, KY	1991	NA	9054	7546	1508	16.7
CN2113500000000	21	135	Lewis County, KY	1991	NA	6052	5203	849	14
CN2113700000000	21	137	Lincoln County, KY	1991	NA	9081	8362	719	7.9
CN2113900000000	21	139	Livingston County, KY	1991	NA	4624	4158	466	10.1
CN2114100000000	21	141	Logan County, KY	1991	NA	11797	10914	883	7.5
CN2114300000000	21	143	Lyon County, KY	1991	NA	2774	2509	265	9.6
CN2114500000000	21	145	McCracken County, KY	1991	NA	31408	29489	1919	6.1
CN2114700000000	21	147	McCreary County, KY	1991	NA	5430	4672	758	14
CN2114900000000	21	149	McLean County, KY	1991	NA	4382	3849	533	12.2
CN2115100000000	21	151	Madison County, KY	1991	NA	29849	28244	1605	5.4
CN2115300000000	21	153	Magoffin County, KY	1991	NA	4459	3658	801	18
CN2115500000000	21	155	Marion County, KY	1991	NA	8031	7421	610	7.6
CN2115700000000	21	157	Marshall County, KY	1991	NA	12926	11754	1172	9.1
CN2115900000000	21	159	Martin County, KY	1991	NA	3555	3197	358	10.1
CN2116100000000	21	161	Mason County, KY	1991	NA	8068	7529	539	6.7
CN2116300000000	21	163	Meade County, KY	1991	NA	9002	8337	665	7.4
CN2116500000000	21	165	Menifee County, KY	1991	NA	2250	1873	377	16.8
CN2116700000000	21	167	Mercer County, KY	1991	NA	9624	9025	599	6.2
CN2116900000000	21	169	Metcalfe County, KY	1991	NA	4454	4109	345	7.7
CN2117100000000	21	171	Monroe County, KY	1991	NA	5114	4714	400	7.8
CN2117300000000	21	173	Montgomery County, KY	1991	NA	10063	8641	1422	14.1
CN2117500000000	21	175	Morgan County, KY	1991	NA	4287	3692	595	13.9
CN2117700000000	21	177	Muhlenberg County, KY	1991	NA	12454	10927	1527	12.3
CN2117900000000	21	179	Nelson County, KY	1991	NA	15570	14488	1082	6.9
CN2118100000000	21	181	Nicholas County, KY	1991	NA	3519	3299	220	6.3
CN2118300000000	21	183	Ohio County, KY	1991	NA	8945	7900	1045	11.7
CN2118500000000	21	185	Oldham County, KY	1991	NA	17950	17324	626	3.5
CN2118700000000	21	187	Owen County, KY	1991	NA	4214	4026	188	4.5
CN2118900000000	21	189	Owsley County, KY	1991	NA	1437	1320	117	8.1
CN2119100000000	21	191	Pendleton County, KY	1991	NA	5891	5469	422	7.2
CN2119300000000	21	193	Perry County, KY	1991	NA	10927	9509	1418	13
CN2119500000000	21	195	Pike County, KY	1991	NA	26699	23881	2818	10.6
CN2119700000000	21	197	Powell County, KY	1991	NA	5415	4736	679	12.5
CN2119900000000	21	199	Pulaski County, KY	1991	NA	23262	21126	2136	9.2
CN2120100000000	21	201	Robertson County, KY	1991	NA	928	860	68	7.3
CN2120300000000	21	203	Rockcastle County, KY	1991	NA	6425	5774	651	10.1
CN2120500000000	21	205	Rowan County, KY	1991	NA	9298	8499	799	8.6
CN2120700000000	21	207	Russell County, KY	1991	NA	6939	5755	1184	17.1
CN2120900000000	21	209	Scott County, KY	1991	NA	12996	12387	609	4.7
CN2121100000000	21	211	Shelby County, KY	1991	NA	13656	13109	547	4
CN2121300000000	21	213	Simpson County, KY	1991	NA	7730	7164	566	7.3
CN2121500000000	21	215	Spencer County, KY	1991	NA	3740	3579	161	4.3
CN2121700000000	21	217	Taylor County, KY	1991	NA	10910	10273	637	5.8
CN2121900000000	21	219	Todd County, KY	1991	NA	4827	4438	389	8.1
CN2122100000000	21	221	Trigg County, KY	1991	NA	5326	4985	341	6.4
CN2122300000000	21	223	Trimble County, KY	1991	NA	2819	2655	164	5.8
CN2122500000000	21	225	Union County, KY	1991	NA	7318	6669	649	8.9
CN2122700000000	21	227	Warren County, KY	1991	NA	43037	40062	2975	6.9
CN2122900000000	21	229	Washington County, KY	1991	NA	4920	4591	329	6.7
CN2123100000000	21	231	Wayne County, KY	1991	NA	7173	6461	712	9.9
CN2123300000000	21	233	Webster County, KY	1991	NA	5968	5434	534	8.9
CN2123500000000	21	235	Whitley County, KY	1991	NA	12691	11537	1154	9.1
CN2123700000000	21	237	Wolfe County, KY	1991	NA	2808	2453	355	12.6
CN2123900000000	21	239	Woodford County, KY	1991	NA	11373	10940	433	3.8
CN2200100000000	22	001	Acadia Parish, LA	1991	NA	22233	20650	1583	7.1
CN2200300000000	22	003	Allen Parish, LA	1991	NA	7926	6932	994	12.5
CN2200500000000	22	005	Ascension Parish, LA	1991	NA	27730	25785	1945	7
CN2200700000000	22	007	Assumption Parish, LA	1991	NA	9516	8791	725	7.6
CN2200900000000	22	009	Avoyelles Parish, LA	1991	NA	14374	12511	1863	13
CN2201100000000	22	011	Beauregard Parish, LA	1991	NA	11388	10551	837	7.3
CN2201300000000	22	013	Bienville Parish, LA	1991	NA	6176	5625	551	8.9
CN2201500000000	22	015	Bossier Parish, LA	1991	NA	40437	37829	2608	6.4
CN2201700000000	22	017	Caddo Parish, LA	1991	NA	113618	105693	7925	7
CN2201900000000	22	019	Calcasieu Parish, LA	1991	NA	82148	76093	6055	7.4
CN2202100000000	22	021	Caldwell Parish, LA	1991	NA	4006	3557	449	11.2
CN2202300000000	22	023	Cameron Parish, LA	1991	NA	3950	3744	206	5.2
CN2202500000000	22	025	Catahoula Parish, LA	1991	NA	4549	4056	493	10.8
CN2202700000000	22	027	Claiborne Parish, LA	1991	NA	6109	5644	465	7.6
CN2202900000000	22	029	Concordia Parish, LA	1991	NA	8626	7288	1338	15.5
CN2203100000000	22	031	De Soto Parish, LA	1991	NA	9880	8726	1154	11.7
CN2203300000000	22	033	East Baton Rouge Parish, LA	1991	NA	198594	187943	10651	5.4
CN2203500000000	22	035	East Carroll Parish, LA	1991	NA	3431	2837	594	17.3
CN2203700000000	22	037	East Feliciana Parish, LA	1991	NA	7521	7005	516	6.9
CN2203900000000	22	039	Evangeline Parish, LA	1991	NA	12422	11354	1068	8.6
CN2204100000000	22	041	Franklin Parish, LA	1991	NA	9628	8568	1060	11
CN2204300000000	22	043	Grant Parish, LA	1991	NA	6861	6255	606	8.8
CN2204500000000	22	045	Iberia Parish, LA	1991	NA	29980	28210	1770	5.9
CN2204700000000	22	047	Iberville Parish, LA	1991	NA	13188	11919	1269	9.6
CN2204900000000	22	049	Jackson Parish, LA	1991	NA	6525	6177	348	5.3
CN2205100000000	22	051	Jefferson Parish, LA	1991	NA	233679	218011	15668	6.7
CN2205300000000	22	053	Jefferson Davis Parish, LA	1991	NA	12701	11617	1084	8.5
CN2205500000000	22	055	Lafayette Parish, LA	1991	NA	85506	81414	4092	4.8
CN2205700000000	22	057	Lafourche Parish, LA	1991	NA	37142	35391	1751	4.7
CN2205900000000	22	059	LaSalle Parish, LA	1991	NA	5892	5423	469	8
CN2206100000000	22	061	Lincoln Parish, LA	1991	NA	18342	17459	883	4.8
CN2206300000000	22	063	Livingston Parish, LA	1991	NA	34471	31562	2909	8.4
CN2206500000000	22	065	Madison Parish, LA	1991	NA	4727	4075	652	13.8
CN2206700000000	22	067	Morehouse Parish, LA	1991	NA	12789	11545	1244	9.7
CN2206900000000	22	069	Natchitoches Parish, LA	1991	NA	15458	14120	1338	8.7
CN2207100000000	22	071	Orleans Parish, LA	1991	NA	208066	191406	16660	8
CN2207300000000	22	073	Ouachita Parish, LA	1991	NA	66889	62859	4030	6
CN2207500000000	22	075	Plaquemines Parish, LA	1991	NA	10299	9573	726	7
CN2207700000000	22	077	Pointe Coupee Parish, LA	1991	NA	9182	8145	1037	11.3
CN2207900000000	22	079	Rapides Parish, LA	1991	NA	56286	52497	3789	6.7
CN2208100000000	22	081	Red River Parish, LA	1991	NA	3789	3307	482	12.7
CN2208300000000	22	083	Richland Parish, LA	1991	NA	8475	7514	961	11.3
CN2208500000000	22	085	Sabine Parish, LA	1991	NA	8747	8151	596	6.8
CN2208700000000	22	087	St. Bernard Parish, LA	1991	NA	31586	28951	2635	8.3
CN2208900000000	22	089	St. Charles Parish, LA	1991	NA	20435	18935	1500	7.3
CN2209100000000	22	091	St. Helena Parish, LA	1991	NA	3722	3451	271	7.3
CN2209300000000	22	093	St. James Parish, LA	1991	NA	8815	8050	765	8.7
CN2209500000000	22	095	St. John the Baptist Parish, LA	1991	NA	18762	16822	1940	10.3
CN2209700000000	22	097	St. Landry Parish, LA	1991	NA	30579	27651	2928	9.6
CN2209900000000	22	099	St. Martin Parish, LA	1991	NA	19421	18099	1322	6.8
CN2210100000000	22	101	St. Mary Parish, LA	1991	NA	25431	23451	1980	7.8
CN2210300000000	22	103	St. Tammany Parish, LA	1991	NA	71740	66745	4995	7
CN2210500000000	22	105	Tangipahoa Parish, LA	1991	NA	36197	32519	3678	10.2
CN2210700000000	22	107	Tensas Parish, LA	1991	NA	2748	2503	245	8.9
CN2210900000000	22	109	Terrebonne Parish, LA	1991	NA	41532	39282	2250	5.4
CN2211100000000	22	111	Union Parish, LA	1991	NA	8714	8047	667	7.7
CN2211300000000	22	113	Vermilion Parish, LA	1991	NA	19951	18405	1546	7.7
CN2211500000000	22	115	Vernon Parish, LA	1991	NA	16069	14983	1086	6.8
CN2211700000000	22	117	Washington Parish, LA	1991	NA	16015	14315	1700	10.6
CN2211900000000	22	119	Webster Parish, LA	1991	NA	17765	16101	1664	9.4
CN2212100000000	22	121	West Baton Rouge Parish, LA	1991	NA	9343	8681	662	7.1
CN2212300000000	22	123	West Carroll Parish, LA	1991	NA	5350	4439	911	17
CN2212500000000	22	125	West Feliciana Parish, LA	1991	NA	4012	3748	264	6.6
CN2212700000000	22	127	Winn Parish, LA	1991	NA	6019	5623	396	6.6
CN2300100000000	23	001	Androscoggin County, ME	1991	NA	57116	51913	5203	9.1
CN2300300000000	23	003	Aroostook County, ME	1991	NA	41211	37317	3894	9.4
CN2300500000000	23	005	Cumberland County, ME	1991	NA	133251	125343	7908	5.9
CN2300700000000	23	007	Franklin County, ME	1991	NA	14989	13705	1284	8.6
CN2300900000000	23	009	Hancock County, ME	1991	NA	25604	23826	1778	6.9
CN2301100000000	23	011	Kennebec County, ME	1991	NA	61513	57246	4267	6.9
CN2301300000000	23	013	Knox County, ME	1991	NA	18680	17454	1226	6.6
CN2301500000000	23	015	Lincoln County, ME	1991	NA	15827	14963	864	5.5
CN2301700000000	23	017	Oxford County, ME	1991	NA	25717	23279	2438	9.5
CN2301900000000	23	019	Penobscot County, ME	1991	NA	75492	69558	5934	7.9
CN2302100000000	23	021	Piscataquis County, ME	1991	NA	8885	8057	828	9.3
CN2302300000000	23	023	Sagadahoc County, ME	1991	NA	16564	15663	901	5.4
CN2302500000000	23	025	Somerset County, ME	1991	NA	25792	23181	2611	10.1
CN2302700000000	23	027	Waldo County, ME	1991	NA	16798	15218	1580	9.4
CN2302900000000	23	029	Washington County, ME	1991	NA	16491	14852	1639	9.9
CN2303100000000	23	031	York County, ME	1991	NA	91168	84897	6271	6.9
CN2400100000000	24	001	Allegany County, MD	1991	NA	32987	28927	4060	12.3
CN2400300000000	24	003	Anne Arundel County, MD	1991	NA	231709	219977	11732	5.1
CN2400500000000	24	005	Baltimore County, MD	1991	NA	381599	357608	23991	6.3
CN2400900000000	24	009	Calvert County, MD	1991	NA	29541	27726	1815	6.1
CN2401100000000	24	011	Caroline County, MD	1991	NA	14103	13078	1025	7.3
CN2401300000000	24	013	Carroll County, MD	1991	NA	69621	65675	3946	5.7
CN2401500000000	24	015	Cecil County, MD	1991	NA	36600	32293	4307	11.8
CN2401700000000	24	017	Charles County, MD	1991	NA	55226	52754	2472	4.5
CN2401900000000	24	019	Dorchester County, MD	1991	NA	15785	14249	1536	9.7
CN2402100000000	24	021	Frederick County, MD	1991	NA	86261	81409	4852	5.6
CN2402300000000	24	023	Garrett County, MD	1991	NA	13524	11829	1695	12.5
CN2402500000000	24	025	Harford County, MD	1991	NA	99833	93704	6129	6.1
CN2402700000000	24	027	Howard County, MD	1991	NA	114636	110325	4311	3.8
CN2402900000000	24	029	Kent County, MD	1991	NA	9498	8816	682	7.2
CN2403100000000	24	031	Montgomery County, MD	1991	NA	442140	427558	14582	3.3
CN2403300000000	24	033	Prince George's County, MD	1991	NA	430972	409530	21442	5
CN2403500000000	24	035	Queen Anne's County, MD	1991	NA	18259	17253	1006	5.5
CN2403700000000	24	037	St. Mary's County, MD	1991	NA	40032	37798	2234	5.6
CN2403900000000	24	039	Somerset County, MD	1991	NA	11072	9631	1441	13
CN2404100000000	24	041	Talbot County, MD	1991	NA	16515	15745	770	4.7
CN2404300000000	24	043	Washington County, MD	1991	NA	62961	57392	5569	8.8
CN2404500000000	24	045	Wicomico County, MD	1991	NA	44624	41186	3438	7.7
CN2404700000000	24	047	Worcester County, MD	1991	NA	22323	20115	2208	9.9
CN2451000000000	24	510	Baltimore city, MD	1991	NA	336739	302249	34490	10.2
CN2500100000000	25	001	Barnstable County, MA	1991	NA	97579	87795	9784	10
CN2500300000000	25	003	Berkshire County, MA	1991	NA	69577	62188	7389	10.6
CN2500500000000	25	005	Bristol County, MA	1991	NA	265039	232606	32433	12.2
CN2500700000000	25	007	Dukes County, MA	1991	NA	7851	7302	549	7
CN2500900000000	25	009	Essex County, MA	1991	NA	348527	317941	30586	8.8
CN2501100000000	25	011	Franklin County, MA	1991	NA	37681	34791	2890	7.7
CN2501300000000	25	013	Hampden County, MA	1991	NA	221488	200456	21032	9.5
CN2501500000000	25	015	Hampshire County, MA	1991	NA	78672	73225	5447	6.9
CN2501700000000	25	017	Middlesex County, MA	1991	NA	789377	734256	55121	7
CN2501900000000	25	019	Nantucket County/town, MA	1991	NA	4857	4595	262	5.4
CN2502100000000	25	021	Norfolk County, MA	1991	NA	341739	317503	24236	7.1
CN2502300000000	25	023	Plymouth County, MA	1991	NA	228779	206335	22444	9.8
CN2502500000000	25	025	Suffolk County, MA	1991	NA	341264	312492	28772	8.4
CN2502700000000	25	027	Worcester County, MA	1991	NA	362529	328024	34505	9.5
CN2600100000000	26	001	Alcona County, MI	1991	NA	3923	3361	562	14.3
CN2600300000000	26	003	Alger County, MI	1991	NA	3888	3477	411	10.6
CN2600500000000	26	005	Allegan County, MI	1991	NA	45258	42106	3152	7
CN2600700000000	26	007	Alpena County, MI	1991	NA	14398	12657	1741	12.1
CN2600900000000	26	009	Antrim County, MI	1991	NA	8854	7755	1099	12.4
CN2601100000000	26	011	Arenac County, MI	1991	NA	6125	5503	622	10.2
CN2601300000000	26	013	Baraga County, MI	1991	NA	3244	2799	445	13.7
CN2601500000000	26	015	Barry County, MI	1991	NA	25397	23440	1957	7.7
CN2601700000000	26	017	Bay County, MI	1991	NA	53250	48647	4603	8.6
CN2601900000000	26	019	Benzie County, MI	1991	NA	6125	5304	821	13.4
CN2602100000000	26	021	Berrien County, MI	1991	NA	79769	72890	6879	8.6
CN2602300000000	26	023	Branch County, MI	1991	NA	19245	17816	1429	7.4
CN2602500000000	26	025	Calhoun County, MI	1991	NA	63788	58994	4794	7.5
CN2602700000000	26	027	Cass County, MI	1991	NA	24084	21894	2190	9.1
CN2602900000000	26	029	Charlevoix County, MI	1991	NA	11627	10435	1192	10.3
CN2603100000000	26	031	Cheboygan County, MI	1991	NA	10403	8870	1533	14.7
CN2603300000000	26	033	Chippewa County, MI	1991	NA	14824	13096	1728	11.7
CN2603500000000	26	035	Clare County, MI	1991	NA	9443	8297	1146	12.1
CN2603700000000	26	037	Clinton County, MI	1991	NA	31363	28996	2367	7.5
CN2603900000000	26	039	Crawford County, MI	1991	NA	5574	5098	476	8.5
CN2604100000000	26	041	Delta County, MI	1991	NA	17307	15252	2055	11.9
CN2604300000000	26	043	Dickinson County, MI	1991	NA	12737	11567	1170	9.2
CN2604500000000	26	045	Eaton County, MI	1991	NA	51227	47602	3625	7.1
CN2604700000000	26	047	Emmet County, MI	1991	NA	14567	12875	1692	11.6
CN2604900000000	26	049	Genesee County, MI	1991	NA	198981	175161	23820	12
CN2605100000000	26	051	Gladwin County, MI	1991	NA	8137	7139	998	12.3
CN2605300000000	26	053	Gogebic County, MI	1991	NA	7436	6797	639	8.6
CN2605500000000	26	055	Grand Traverse County, MI	1991	NA	36351	33475	2876	7.9
CN2605700000000	26	057	Gratiot County, MI	1991	NA	18303	16329	1974	10.8
CN2605900000000	26	059	Hillsdale County, MI	1991	NA	20310	18207	2103	10.4
CN2606100000000	26	061	Houghton County, MI	1991	NA	14592	13360	1232	8.4
CN2606300000000	26	063	Huron County, MI	1991	NA	15805	13861	1944	12.3
CN2606500000000	26	065	Ingham County, MI	1991	NA	147815	137481	10334	7
CN2606700000000	26	067	Ionia County, MI	1991	NA	26663	23717	2946	11
CN2606900000000	26	069	Iosco County, MI	1991	NA	11229	10137	1092	9.7
CN2607100000000	26	071	Iron County, MI	1991	NA	5287	4726	561	10.6
CN2607300000000	26	073	Isabella County, MI	1991	NA	25444	23600	1844	7.2
CN2607500000000	26	075	Jackson County, MI	1991	NA	69967	63784	6183	8.8
CN2607700000000	26	077	Kalamazoo County, MI	1991	NA	117990	110965	7025	6
CN2607900000000	26	079	Kalkaska County, MI	1991	NA	6329	5578	751	11.9
CN2608100000000	26	081	Kent County, MI	1991	NA	268293	248780	19513	7.3
CN2608300000000	26	083	Keweenaw County, MI	1991	NA	620	508	112	18.1
CN2608500000000	26	085	Lake County, MI	1991	NA	2787	2422	365	13.1
CN2608700000000	26	087	Lapeer County, MI	1991	NA	38406	33439	4967	12.9
CN2608900000000	26	089	Leelanau County, MI	1991	NA	8857	8180	677	7.6
CN2609100000000	26	091	Lenawee County, MI	1991	NA	44243	40077	4166	9.4
CN2609300000000	26	093	Livingston County, MI	1991	NA	63633	59039	4594	7.2
CN2609500000000	26	095	Luce County, MI	1991	NA	2433	2112	321	13.2
CN2609700000000	26	097	Mackinac County, MI	1991	NA	6328	5379	949	15
CN2609900000000	26	099	Macomb County, MI	1991	NA	395267	357475	37792	9.6
CN2610100000000	26	101	Manistee County, MI	1991	NA	9361	8203	1158	12.4
CN2610300000000	26	103	Marquette County, MI	1991	NA	32165	29609	2556	7.9
CN2610500000000	26	105	Mason County, MI	1991	NA	12621	11327	1294	10.3
CN2610700000000	26	107	Mecosta County, MI	1991	NA	16426	14952	1474	9
CN2610900000000	26	109	Menominee County, MI	1991	NA	12042	11036	1006	8.4
CN2611100000000	26	111	Midland County, MI	1991	NA	37755	35405	2350	6.2
CN2611300000000	26	113	Missaukee County, MI	1991	NA	5379	4787	592	11
CN2611500000000	26	115	Monroe County, MI	1991	NA	66759	59995	6764	10.1
CN2611700000000	26	117	Montcalm County, MI	1991	NA	22700	19592	3108	13.7
CN2611900000000	26	119	Montmorency County, MI	1991	NA	3175	2616	559	17.6
CN2612100000000	26	121	Muskegon County, MI	1991	NA	73195	65462	7733	10.6
CN2612300000000	26	123	Newaygo County, MI	1991	NA	17814	15737	2077	11.7
CN2612500000000	26	125	Oakland County, MI	1991	NA	604232	559027	45205	7.5
CN2612700000000	26	127	Oceana County, MI	1991	NA	11132	9786	1346	12.1
CN2612900000000	26	129	Ogemaw County, MI	1991	NA	7180	6385	795	11.1
CN2613100000000	26	131	Ontonagon County, MI	1991	NA	3918	3661	257	6.6
CN2613300000000	26	133	Osceola County, MI	1991	NA	8925	7842	1083	12.1
CN2613500000000	26	135	Oscoda County, MI	1991	NA	2988	2692	296	9.9
CN2613700000000	26	137	Otsego County, MI	1991	NA	9680	8821	859	8.9
CN2613900000000	26	139	Ottawa County, MI	1991	NA	104462	98042	6420	6.1
CN2614100000000	26	141	Presque Isle County, MI	1991	NA	6174	5266	908	14.7
CN2614300000000	26	143	Roscommon County, MI	1991	NA	6961	6239	722	10.4
CN2614500000000	26	145	Saginaw County, MI	1991	NA	96555	88551	8004	8.3
CN2614700000000	26	147	St. Clair County, MI	1991	NA	73248	64718	8530	11.6
CN2614900000000	26	149	St. Joseph County, MI	1991	NA	28703	25712	2991	10.4
CN2615100000000	26	151	Sanilac County, MI	1991	NA	18283	15860	2423	13.3
CN2615300000000	26	153	Schoolcraft County, MI	1991	NA	3748	3231	517	13.8
CN2615500000000	26	155	Shiawassee County, MI	1991	NA	34237	29994	4243	12.4
CN2615700000000	26	157	Tuscola County, MI	1991	NA	25622	22592	3030	11.8
CN2615900000000	26	159	Van Buren County, MI	1991	NA	33719	30381	3338	9.9
CN2616100000000	26	161	Washtenaw County, MI	1991	NA	156657	147723	8934	5.7
CN2616300000000	26	163	Wayne County, MI	1991	NA	939619	836228	103391	11
CN2616500000000	26	165	Wexford County, MI	1991	NA	12306	10741	1565	12.7
CN2700100000000	27	001	Aitkin County, MN	1991	NA	5308	4712	596	11.2
CN2700300000000	27	003	Anoka County, MN	1991	NA	148739	141336	7403	5
CN2700500000000	27	005	Becker County, MN	1991	NA	12758	11782	976	7.7
CN2700700000000	27	007	Beltrami County, MN	1991	NA	16265	14979	1286	7.9
CN2700900000000	27	009	Benton County, MN	1991	NA	17577	16510	1067	6.1
CN2701100000000	27	011	Big Stone County, MN	1991	NA	2869	2724	145	5.1
CN2701300000000	27	013	Blue Earth County, MN	1991	NA	30325	29182	1143	3.8
CN2701500000000	27	015	Brown County, MN	1991	NA	14313	13680	633	4.4
CN2701700000000	27	017	Carlton County, MN	1991	NA	13766	12648	1118	8.1
CN2701900000000	27	019	Carver County, MN	1991	NA	29170	28004	1166	4
CN2702100000000	27	021	Cass County, MN	1991	NA	9531	8623	908	9.5
CN2702300000000	27	023	Chippewa County, MN	1991	NA	6335	5977	358	5.7
CN2702500000000	27	025	Chisago County, MN	1991	NA	15949	14807	1142	7.2
CN2702700000000	27	027	Clay County, MN	1991	NA	27386	26107	1279	4.7
CN2702900000000	27	029	Clearwater County, MN	1991	NA	3675	3035	640	17.4
CN2703100000000	27	031	Cook County, MN	1991	NA	2395	2233	162	6.8
CN2703300000000	27	033	Cottonwood County, MN	1991	NA	5802	5445	357	6.2
CN2703500000000	27	035	Crow Wing County, MN	1991	NA	22176	20576	1600	7.2
CN2703700000000	27	037	Dakota County, MN	1991	NA	171206	164034	7172	4.2
CN2703900000000	27	039	Dodge County, MN	1991	NA	8023	7533	490	6.1
CN2704100000000	27	041	Douglas County, MN	1991	NA	14492	13704	788	5.4
CN2704300000000	27	043	Faribault County, MN	1991	NA	8188	7680	508	6.2
CN2704500000000	27	045	Fillmore County, MN	1991	NA	10140	9589	551	5.4
CN2704700000000	27	047	Freeborn County, MN	1991	NA	16956	15966	990	5.8
CN2704900000000	27	049	Goodhue County, MN	1991	NA	21912	21030	882	4
CN2705100000000	27	051	Grant County, MN	1991	NA	2841	2657	184	6.5
CN2705300000000	27	053	Hennepin County, MN	1991	NA	616600	589750	26850	4.4
CN2705500000000	27	055	Houston County, MN	1991	NA	9971	9548	423	4.2
CN2705700000000	27	057	Hubbard County, MN	1991	NA	6888	6268	620	9
CN2705900000000	27	059	Isanti County, MN	1991	NA	13489	12537	952	7.1
CN2706100000000	27	061	Itasca County, MN	1991	NA	18527	16648	1879	10.1
CN2706300000000	27	063	Jackson County, MN	1991	NA	5438	5177	261	4.8
CN2706500000000	27	065	Kanabec County, MN	1991	NA	6710	6025	685	10.2
CN2706700000000	27	067	Kandiyohi County, MN	1991	NA	19448	18478	970	5
CN2706900000000	27	069	Kittson County, MN	1991	NA	2544	2344	200	7.9
CN2707100000000	27	071	Koochiching County, MN	1991	NA	6787	5921	866	12.8
CN2707300000000	27	073	Lac qui Parle County, MN	1991	NA	3944	3804	140	3.5
CN2707500000000	27	075	Lake County, MN	1991	NA	5293	4829	464	8.8
CN2707700000000	27	077	Lake of the Woods County, MN	1991	NA	2159	2082	77	3.6
CN2707900000000	27	079	Le Sueur County, MN	1991	NA	12365	11549	816	6.6
CN2708100000000	27	081	Lincoln County, MN	1991	NA	3156	3029	127	4
CN2708300000000	27	083	Lyon County, MN	1991	NA	13557	13041	516	3.8
CN2708500000000	27	085	McLeod County, MN	1991	NA	18466	17629	837	4.5
CN2708700000000	27	087	Mahnomen County, MN	1991	NA	1897	1679	218	11.5
CN2708900000000	27	089	Marshall County, MN	1991	NA	4833	4172	661	13.7
CN2709100000000	27	091	Martin County, MN	1991	NA	11822	11080	742	6.3
CN2709300000000	27	093	Meeker County, MN	1991	NA	10155	9259	896	8.8
CN2709500000000	27	095	Mille Lacs County, MN	1991	NA	9013	8200	813	9
CN2709700000000	27	097	Morrison County, MN	1991	NA	13963	12572	1391	10
CN2709900000000	27	099	Mower County, MN	1991	NA	18049	17362	687	3.8
CN2710100000000	27	101	Murray County, MN	1991	NA	4408	4201	207	4.7
CN2710300000000	27	103	Nicollet County, MN	1991	NA	16047	15483	564	3.5
CN2710500000000	27	105	Nobles County, MN	1991	NA	9847	9505	342	3.5
CN2710700000000	27	107	Norman County, MN	1991	NA	3524	3279	245	7
CN2710900000000	27	109	Olmsted County, MN	1991	NA	63842	62028	1814	2.8
CN2711100000000	27	111	Otter Tail County, MN	1991	NA	24709	23115	1594	6.5
CN2711300000000	27	113	Pennington County, MN	1991	NA	6936	6201	735	10.6
CN2711500000000	27	115	Pine County, MN	1991	NA	9384	8316	1068	11.4
CN2711700000000	27	117	Pipestone County, MN	1991	NA	4832	4598	234	4.8
CN2711900000000	27	119	Polk County, MN	1991	NA	15561	14615	946	6.1
CN2712100000000	27	121	Pope County, MN	1991	NA	4878	4597	281	5.8
CN2712300000000	27	123	Ramsey County, MN	1991	NA	270739	258819	11920	4.4
CN2712500000000	27	125	Red Lake County, MN	1991	NA	2063	1755	308	14.9
CN2712700000000	27	127	Redwood County, MN	1991	NA	9333	9066	267	2.9
CN2712900000000	27	129	Renville County, MN	1991	NA	8283	7819	464	5.6
CN2713100000000	27	131	Rice County, MN	1991	NA	27884	26411	1473	5.3
CN2713300000000	27	133	Rock County, MN	1991	NA	4737	4609	128	2.7
CN2713500000000	27	135	Roseau County, MN	1991	NA	8343	7760	583	7
CN2713700000000	27	137	St. Louis County, MN	1991	NA	96730	89963	6767	7
CN2713900000000	27	139	Scott County, MN	1991	NA	34579	32831	1748	5.1
CN2714100000000	27	141	Sherburne County, MN	1991	NA	23338	21934	1404	6
CN2714300000000	27	143	Sibley County, MN	1991	NA	6832	6450	382	5.6
CN2714500000000	27	145	Stearns County, MN	1991	NA	67793	63940	3853	5.7
CN2714700000000	27	147	Steele County, MN	1991	NA	16848	16029	819	4.9
CN2714900000000	27	149	Stevens County, MN	1991	NA	5115	4890	225	4.4
CN2715100000000	27	151	Swift County, MN	1991	NA	4682	4413	269	5.7
CN2715300000000	27	153	Todd County, MN	1991	NA	10256	9400	856	8.3
CN2715500000000	27	155	Traverse County, MN	1991	NA	1812	1721	91	5
CN2715700000000	27	157	Wabasha County, MN	1991	NA	10426	9887	539	5.2
CN2715900000000	27	159	Wadena County, MN	1991	NA	5823	5389	434	7.5
CN2716100000000	27	161	Waseca County, MN	1991	NA	9304	8870	434	4.7
CN2716300000000	27	163	Washington County, MN	1991	NA	85782	82127	3655	4.3
CN2716500000000	27	165	Watonwan County, MN	1991	NA	5747	5472	275	4.8
CN2716700000000	27	167	Wilkin County, MN	1991	NA	3570	3389	181	5.1
CN2716900000000	27	169	Winona County, MN	1991	NA	26661	25084	1577	5.9
CN2717100000000	27	171	Wright County, MN	1991	NA	38418	36015	2403	6.3
CN2717300000000	27	173	Yellow Medicine County, MN	1991	NA	5375	5116	259	4.8
CN2800100000000	28	001	Adams County, MS	1991	NA	15065	13487	1578	10.5
CN2800300000000	28	003	Alcorn County, MS	1991	NA	15653	13994	1659	10.6
CN2800500000000	28	005	Amite County, MS	1991	NA	5039	4695	344	6.8
CN2800700000000	28	007	Attala County, MS	1991	NA	8015	7003	1012	12.6
CN2800900000000	28	009	Benton County, MS	1991	NA	3183	2811	372	11.7
CN2801100000000	28	011	Bolivar County, MS	1991	NA	17389	15860	1529	8.8
CN2801300000000	28	013	Calhoun County, MS	1991	NA	7016	6473	543	7.7
CN2801500000000	28	015	Carroll County, MS	1991	NA	4081	3674	407	10
CN2801700000000	28	017	Chickasaw County, MS	1991	NA	9323	8193	1130	12.1
CN2801900000000	28	019	Choctaw County, MS	1991	NA	3577	3157	420	11.7
CN2802100000000	28	021	Claiborne County, MS	1991	NA	3770	3058	712	18.9
CN2802300000000	28	023	Clarke County, MS	1991	NA	8270	7649	621	7.5
CN2802500000000	28	025	Clay County, MS	1991	NA	9815	8788	1027	10.5
CN2802700000000	28	027	Coahoma County, MS	1991	NA	11816	10453	1363	11.5
CN2802900000000	28	029	Copiah County, MS	1991	NA	11302	10009	1293	11.4
CN2803100000000	28	031	Covington County, MS	1991	NA	7551	6729	822	10.9
CN2803300000000	28	033	DeSoto County, MS	1991	NA	38026	35680	2346	6.2
CN2803500000000	28	035	Forrest County, MS	1991	NA	31197	29066	2131	6.8
CN2803700000000	28	037	Franklin County, MS	1991	NA	3182	2821	361	11.3
CN2803900000000	28	039	George County, MS	1991	NA	7284	6379	905	12.4
CN2804100000000	28	041	Greene County, MS	1991	NA	4583	4046	537	11.7
CN2804300000000	28	043	Grenada County, MS	1991	NA	9823	8890	933	9.5
CN2804500000000	28	045	Hancock County, MS	1991	NA	13035	12134	901	6.9
CN2804700000000	28	047	Harrison County, MS	1991	NA	72619	67599	5020	6.9
CN2804900000000	28	049	Hinds County, MS	1991	NA	127246	119298	7948	6.2
CN2805100000000	28	051	Holmes County, MS	1991	NA	6884	5939	945	13.7
CN2805300000000	28	053	Humphreys County, MS	1991	NA	5298	4788	510	9.6
CN2805500000000	28	055	Issaquena County, MS	1991	NA	865	746	119	13.8
CN2805700000000	28	057	Itawamba County, MS	1991	NA	10613	9602	1011	9.5
CN2805900000000	28	059	Jackson County, MS	1991	NA	56166	52304	3862	6.9
CN2806100000000	28	061	Jasper County, MS	1991	NA	7088	6347	741	10.5
CN2806300000000	28	063	Jefferson County, MS	1991	NA	2823	2009	814	28.8
CN2806500000000	28	065	Jefferson Davis County, MS	1991	NA	5493	4587	906	16.5
CN2806700000000	28	067	Jones County, MS	1991	NA	27987	25737	2250	8
CN2806900000000	28	069	Kemper County, MS	1991	NA	4282	3853	429	10
CN2807100000000	28	071	Lafayette County, MS	1991	NA	15319	14560	759	5
CN2807300000000	28	073	Lamar County, MS	1991	NA	14321	13586	735	5.1
CN2807500000000	28	075	Lauderdale County, MS	1991	NA	35125	32346	2779	7.9
CN2807700000000	28	077	Lawrence County, MS	1991	NA	5304	4741	563	10.6
CN2807900000000	28	079	Leake County, MS	1991	NA	8362	7609	753	9
CN2808100000000	28	081	Lee County, MS	1991	NA	35343	32553	2790	7.9
CN2808300000000	28	083	Leflore County, MS	1991	NA	15528	13554	1974	12.7
CN2808500000000	28	085	Lincoln County, MS	1991	NA	13128	11729	1399	10.7
CN2808700000000	28	087	Lowndes County, MS	1991	NA	27731	25369	2362	8.5
CN2808900000000	28	089	Madison County, MS	1991	NA	27522	25735	1787	6.5
CN2809100000000	28	091	Marion County, MS	1991	NA	10094	9037	1057	10.5
CN2809300000000	28	093	Marshall County, MS	1991	NA	13623	11866	1757	12.9
CN2809500000000	28	095	Monroe County, MS	1991	NA	17286	15594	1692	9.8
CN2809700000000	28	097	Montgomery County, MS	1991	NA	5472	4878	594	10.9
CN2809900000000	28	099	Neshoba County, MS	1991	NA	12234	11302	932	7.6
CN2810100000000	28	101	Newton County, MS	1991	NA	9078	8539	539	5.9
CN2810300000000	28	103	Noxubee County, MS	1991	NA	4670	4113	557	11.9
CN2810500000000	28	105	Oktibbeha County, MS	1991	NA	18106	17045	1061	5.9
CN2810700000000	28	107	Panola County, MS	1991	NA	13499	11988	1511	11.2
CN2810900000000	28	109	Pearl River County, MS	1991	NA	16755	15314	1441	8.6
CN2811100000000	28	111	Perry County, MS	1991	NA	4134	3582	552	13.4
CN2811300000000	28	113	Pike County, MS	1991	NA	15293	13776	1517	9.9
CN2811500000000	28	115	Pontotoc County, MS	1991	NA	11648	10824	824	7.1
CN2811700000000	28	117	Prentiss County, MS	1991	NA	11799	10502	1297	11
CN2811900000000	28	119	Quitman County, MS	1991	NA	4085	3557	528	12.9
CN2812100000000	28	121	Rankin County, MS	1991	NA	47161	45070	2091	4.4
CN2812300000000	28	123	Scott County, MS	1991	NA	12326	11544	782	6.3
CN2812500000000	28	125	Sharkey County, MS	1991	NA	3025	2609	416	13.8
CN2812700000000	28	127	Simpson County, MS	1991	NA	10250	9545	705	6.9
CN2812900000000	28	129	Smith County, MS	1991	NA	6364	5913	451	7.1
CN2813100000000	28	131	Stone County, MS	1991	NA	4944	4539	405	8.2
CN2813300000000	28	133	Sunflower County, MS	1991	NA	12278	10900	1378	11.2
CN2813500000000	28	135	Tallahatchie County, MS	1991	NA	6048	5272	776	12.8
CN2813700000000	28	137	Tate County, MS	1991	NA	10379	9350	1029	9.9
CN2813900000000	28	139	Tippah County, MS	1991	NA	9557	8395	1162	12.2
CN2814100000000	28	141	Tishomingo County, MS	1991	NA	9938	8892	1046	10.5
CN2814300000000	28	143	Tunica County, MS	1991	NA	2959	2515	444	15
CN2814500000000	28	145	Union County, MS	1991	NA	11365	10476	889	7.8
CN2814700000000	28	147	Walthall County, MS	1991	NA	5539	5049	490	8.8
CN2814900000000	28	149	Warren County, MS	1991	NA	22586	20737	1849	8.2
CN2815100000000	28	151	Washington County, MS	1991	NA	28652	25376	3276	11.4
CN2815300000000	28	153	Wayne County, MS	1991	NA	8983	7804	1179	13.1
CN2815500000000	28	155	Webster County, MS	1991	NA	4338	3871	467	10.8
CN2815700000000	28	157	Wilkinson County, MS	1991	NA	3516	3020	496	14.1
CN2815900000000	28	159	Winston County, MS	1991	NA	8448	7341	1107	13.1
CN2816100000000	28	161	Yalobusha County, MS	1991	NA	5164	4598	566	11
CN2816300000000	28	163	Yazoo County, MS	1991	NA	9402	8585	817	8.7
CN2900100000000	29	001	Adair County, MO	1991	NA	12981	12429	552	4.3
CN2900300000000	29	003	Andrew County, MO	1991	NA	7637	7132	505	6.6
CN2900500000000	29	005	Atchison County, MO	1991	NA	3272	3162	110	3.4
CN2900700000000	29	007	Audrain County, MO	1991	NA	11479	10826	653	5.7
CN2900900000000	29	009	Barry County, MO	1991	NA	13180	12408	772	5.9
CN2901100000000	29	011	Barton County, MO	1991	NA	5820	5616	204	3.5
CN2901300000000	29	013	Bates County, MO	1991	NA	7045	6544	501	7.1
CN2901500000000	29	015	Benton County, MO	1991	NA	5662	5127	535	9.4
CN2901700000000	29	017	Bollinger County, MO	1991	NA	4778	4251	527	11
CN2901900000000	29	019	Boone County, MO	1991	NA	69389	67309	2080	3
CN2902100000000	29	021	Buchanan County, MO	1991	NA	41579	38083	3496	8.4
CN2902300000000	29	023	Butler County, MO	1991	NA	17422	15861	1561	9
CN2902500000000	29	025	Caldwell County, MO	1991	NA	3594	3308	286	8
CN2902700000000	29	027	Callaway County, MO	1991	NA	17682	16781	901	5.1
CN2902900000000	29	029	Camden County, MO	1991	NA	13313	12041	1272	9.6
CN2903100000000	29	031	Cape Girardeau County, MO	1991	NA	32741	30896	1845	5.6
CN2903300000000	29	033	Carroll County, MO	1991	NA	4989	4619	370	7.4
CN2903500000000	29	035	Carter County, MO	1991	NA	2277	2018	259	11.4
CN2903700000000	29	037	Cass County, MO	1991	NA	35256	33166	2090	5.9
CN2903900000000	29	039	Cedar County, MO	1991	NA	5196	4859	337	6.5
CN2904100000000	29	041	Chariton County, MO	1991	NA	4484	4097	387	8.6
CN2904300000000	29	043	Christian County, MO	1991	NA	18404	17362	1042	5.7
CN2904500000000	29	045	Clark County, MO	1991	NA	3701	3463	238	6.4
CN2904700000000	29	047	Clay County, MO	1991	NA	90380	85633	4747	5.3
CN2904900000000	29	049	Clinton County, MO	1991	NA	8219	7790	429	5.2
CN2905100000000	29	051	Cole County, MO	1991	NA	34690	33304	1386	4
CN2905300000000	29	053	Cooper County, MO	1991	NA	7928	7570	358	4.5
CN2905500000000	29	055	Crawford County, MO	1991	NA	9183	8130	1053	11.5
CN2905700000000	29	057	Dade County, MO	1991	NA	3037	2845	192	6.3
CN2905900000000	29	059	Dallas County, MO	1991	NA	5711	5188	523	9.2
CN2906100000000	29	061	Daviess County, MO	1991	NA	3337	3088	249	7.5
CN2906300000000	29	063	DeKalb County, MO	1991	NA	3730	3469	261	7
CN2906500000000	29	065	Dent County, MO	1991	NA	5730	5208	522	9.1
CN2906700000000	29	067	Douglas County, MO	1991	NA	5269	4865	404	7.7
CN2906900000000	29	069	Dunklin County, MO	1991	NA	12805	11570	1235	9.6
CN2907100000000	29	071	Franklin County, MO	1991	NA	43369	39197	4172	9.6
CN2907300000000	29	073	Gasconade County, MO	1991	NA	7200	6717	483	6.7
CN2907500000000	29	075	Gentry County, MO	1991	NA	3233	3122	111	3.4
CN2907700000000	29	077	Greene County, MO	1991	NA	111982	106404	5578	5
CN2907900000000	29	079	Grundy County, MO	1991	NA	4830	4584	246	5.1
CN2908100000000	29	081	Harrison County, MO	1991	NA	4021	3830	191	4.8
CN2908300000000	29	083	Henry County, MO	1991	NA	9252	8494	758	8.2
CN2908500000000	29	085	Hickory County, MO	1991	NA	2611	2375	236	9
CN2908700000000	29	087	Holt County, MO	1991	NA	2687	2548	139	5.2
CN2908900000000	29	089	Howard County, MO	1991	NA	4645	4435	210	4.5
CN2909100000000	29	091	Howell County, MO	1991	NA	14928	13854	1074	7.2
CN2909300000000	29	093	Iron County, MO	1991	NA	4109	3565	544	13.2
CN2909500000000	29	095	Jackson County, MO	1991	NA	340447	318959	21488	6.3
CN2909700000000	29	097	Jasper County, MO	1991	NA	46115	43563	2552	5.5
CN2909900000000	29	099	Jefferson County, MO	1991	NA	93817	86036	7781	8.3
CN2910100000000	29	101	Johnson County, MO	1991	NA	20973	19828	1145	5.5
CN2910300000000	29	103	Knox County, MO	1991	NA	1919	1825	94	4.9
CN2910500000000	29	105	Laclede County, MO	1991	NA	12858	11330	1528	11.9
CN2910700000000	29	107	Lafayette County, MO	1991	NA	15266	14315	951	6.2
CN2910900000000	29	109	Lawrence County, MO	1991	NA	14726	13895	831	5.6
CN2911100000000	29	111	Lewis County, MO	1991	NA	4887	4509	378	7.7
CN2911300000000	29	113	Lincoln County, MO	1991	NA	14961	13809	1152	7.7
CN2911500000000	29	115	Linn County, MO	1991	NA	6570	6035	535	8.1
CN2911700000000	29	117	Livingston County, MO	1991	NA	6722	6403	319	4.7
CN2911900000000	29	119	McDonald County, MO	1991	NA	6933	6486	447	6.4
CN2912100000000	29	121	Macon County, MO	1991	NA	7258	6740	518	7.1
CN2912300000000	29	123	Madison County, MO	1991	NA	4728	4123	605	12.8
CN2912500000000	29	125	Maries County, MO	1991	NA	4101	3817	284	6.9
CN2912700000000	29	127	Marion County, MO	1991	NA	14111	13186	925	6.6
CN2912900000000	29	129	Mercer County, MO	1991	NA	1519	1446	73	4.8
CN2913100000000	29	131	Miller County, MO	1991	NA	10254	9139	1115	10.9
CN2913300000000	29	133	Mississippi County, MO	1991	NA	6109	5478	631	10.3
CN2913500000000	29	135	Moniteau County, MO	1991	NA	6443	6057	386	6
CN2913700000000	29	137	Monroe County, MO	1991	NA	4152	3880	272	6.6
CN2913900000000	29	139	Montgomery County, MO	1991	NA	5471	5075	396	7.2
CN2914100000000	29	141	Morgan County, MO	1991	NA	7239	6673	566	7.8
CN2914300000000	29	143	New Madrid County, MO	1991	NA	8512	7671	841	9.9
CN2914500000000	29	145	Newton County, MO	1991	NA	23369	21815	1554	6.6
CN2914700000000	29	147	Nodaway County, MO	1991	NA	11991	11599	392	3.3
CN2914900000000	29	149	Oregon County, MO	1991	NA	3894	3628	266	6.8
CN2915100000000	29	151	Osage County, MO	1991	NA	6586	6267	319	4.8
CN2915300000000	29	153	Ozark County, MO	1991	NA	3612	3362	250	6.9
CN2915500000000	29	155	Pemiscot County, MO	1991	NA	8265	7371	894	10.8
CN2915700000000	29	157	Perry County, MO	1991	NA	9283	8758	525	5.7
CN2915900000000	29	159	Pettis County, MO	1991	NA	18210	16847	1363	7.5
CN2916100000000	29	161	Phelps County, MO	1991	NA	17416	16315	1101	6.3
CN2916300000000	29	163	Pike County, MO	1991	NA	7143	6593	550	7.7
CN2916500000000	29	165	Platte County, MO	1991	NA	35605	34028	1577	4.4
CN2916700000000	29	167	Polk County, MO	1991	NA	10162	9460	702	6.9
CN2916900000000	29	169	Pulaski County, MO	1991	NA	12986	11897	1089	8.4
CN2917100000000	29	171	Putnam County, MO	1991	NA	2013	1942	71	3.5
CN2917300000000	29	173	Ralls County, MO	1991	NA	4506	4258	248	5.5
CN2917500000000	29	175	Randolph County, MO	1991	NA	10392	9501	891	8.6
CN2917700000000	29	177	Ray County, MO	1991	NA	10418	9594	824	7.9
CN2917900000000	29	179	Reynolds County, MO	1991	NA	2832	2585	247	8.7
CN2918100000000	29	181	Ripley County, MO	1991	NA	4369	3944	425	9.7
CN2918300000000	29	183	St. Charles County, MO	1991	NA	126027	118525	7502	6
CN2918500000000	29	185	St. Clair County, MO	1991	NA	3569	3311	258	7.2
CN2918600000000	29	186	Ste. Genevieve County, MO	1991	NA	7981	7394	587	7.4
CN2918700000000	29	187	St. Francois County, MO	1991	NA	20740	18391	2349	11.3
CN2918900000000	29	189	St. Louis County, MO	1991	NA	549791	520870	28921	5.3
CN2919500000000	29	195	Saline County, MO	1991	NA	11189	10400	789	7.1
CN2919700000000	29	197	Schuyler County, MO	1991	NA	2117	1999	118	5.6
CN2919900000000	29	199	Scotland County, MO	1991	NA	2217	2146	71	3.2
CN2920100000000	29	201	Scott County, MO	1991	NA	18754	17162	1592	8.5
CN2920300000000	29	203	Shannon County, MO	1991	NA	3571	3212	359	10.1
CN2920500000000	29	205	Shelby County, MO	1991	NA	3169	3016	153	4.8
CN2920700000000	29	207	Stoddard County, MO	1991	NA	13435	12118	1317	9.8
CN2920900000000	29	209	Stone County, MO	1991	NA	9771	8761	1010	10.3
CN2921100000000	29	211	Sullivan County, MO	1991	NA	2830	2729	101	3.6
CN2921300000000	29	213	Taney County, MO	1991	NA	15684	14015	1669	10.6
CN2921500000000	29	215	Texas County, MO	1991	NA	9525	8594	931	9.8
CN2921700000000	29	217	Vernon County, MO	1991	NA	8747	8274	473	5.4
CN2921900000000	29	219	Warren County, MO	1991	NA	10279	9478	801	7.8
CN2922100000000	29	221	Washington County, MO	1991	NA	8288	7026	1262	15.2
CN2922300000000	29	223	Wayne County, MO	1991	NA	4339	3675	664	15.3
CN2922500000000	29	225	Webster County, MO	1991	NA	11275	10458	817	7.2
CN2922700000000	29	227	Worth County, MO	1991	NA	996	934	62	6.2
CN2922900000000	29	229	Wright County, MO	1991	NA	7360	6539	821	11.2
CN2951000000000	29	510	St. Louis city, MO	1991	NA	179532	162891	16641	9.3
CN3000100000000	30	001	Beaverhead County, MT	1991	NA	4393	4114	279	6.4
CN3000300000000	30	003	Big Horn County, MT	1991	NA	4695	4172	523	11.1
CN3000500000000	30	005	Blaine County, MT	1991	NA	2834	2591	243	8.6
CN3000700000000	30	007	Broadwater County, MT	1991	NA	1733	1650	83	4.8
CN3000900000000	30	009	Carbon County, MT	1991	NA	3792	3548	244	6.4
CN3001100000000	30	011	Carter County, MT	1991	NA	879	860	19	2.2
CN3001300000000	30	013	Cascade County, MT	1991	NA	36263	34106	2157	5.9
CN3001500000000	30	015	Chouteau County, MT	1991	NA	2625	2538	87	3.3
CN3001700000000	30	017	Custer County, MT	1991	NA	5846	5536	310	5.3
CN3001900000000	30	019	Daniels County, MT	1991	NA	1098	1068	30	2.7
CN3002100000000	30	021	Dawson County, MT	1991	NA	4764	4573	191	4
CN3002300000000	30	023	Deer Lodge County, MT	1991	NA	4043	3609	434	10.7
CN3002500000000	30	025	Fallon County, MT	1991	NA	1542	1488	54	3.5
CN3002700000000	30	027	Fergus County, MT	1991	NA	5819	5393	426	7.3
CN3002900000000	30	029	Flathead County, MT	1991	NA	30957	28193	2764	8.9
CN3003100000000	30	031	Gallatin County, MT	1991	NA	29979	28397	1582	5.3
CN3003300000000	30	033	Garfield County, MT	1991	NA	890	876	14	1.6
CN3003500000000	30	035	Glacier County, MT	1991	NA	5396	4795	601	11.1
CN3003700000000	30	037	Golden Valley County, MT	1991	NA	461	413	48	10.4
CN3003900000000	30	039	Granite County, MT	1991	NA	1213	1104	109	9
CN3004100000000	30	041	Hill County, MT	1991	NA	8349	7802	547	6.6
CN3004300000000	30	043	Jefferson County, MT	1991	NA	4150	3904	246	5.9
CN3004500000000	30	045	Judith Basin County, MT	1991	NA	1126	1080	46	4.1
CN3004700000000	30	047	Lake County, MT	1991	NA	9632	8771	861	8.9
CN3004900000000	30	049	Lewis and Clark County, MT	1991	NA	25684	24259	1425	5.5
CN3005100000000	30	051	Liberty County, MT	1991	NA	924	906	18	1.9
CN3005300000000	30	053	Lincoln County, MT	1991	NA	8351	7008	1343	16.1
CN3005500000000	30	055	McCone County, MT	1991	NA	1138	1096	42	3.7
CN3005700000000	30	057	Madison County, MT	1991	NA	3327	3175	152	4.6
CN3005900000000	30	059	Meagher County, MT	1991	NA	909	866	43	4.7
CN3006100000000	30	061	Mineral County, MT	1991	NA	1778	1590	188	10.6
CN3006300000000	30	063	Missoula County, MT	1991	NA	43308	40104	3204	7.4
CN3006500000000	30	065	Musselshell County, MT	1991	NA	1777	1641	136	7.7
CN3006700000000	30	067	Park County, MT	1991	NA	8082	7567	515	6.4
CN3006900000000	30	069	Petroleum County, MT	1991	NA	288	273	15	5.2
CN3007100000000	30	071	Phillips County, MT	1991	NA	2468	2352	116	4.7
CN3007300000000	30	073	Pondera County, MT	1991	NA	2906	2798	108	3.7
CN3007500000000	30	075	Powder River County, MT	1991	NA	1187	1154	33	2.8
CN3007700000000	30	077	Powell County, MT	1991	NA	2665	2493	172	6.5
CN3007900000000	30	079	Prairie County, MT	1991	NA	658	633	25	3.8
CN3008100000000	30	081	Ravalli County, MT	1991	NA	12216	10928	1288	10.5
CN3008300000000	30	083	Richland County, MT	1991	NA	5332	4950	382	7.2
CN3008500000000	30	085	Roosevelt County, MT	1991	NA	4444	3963	481	10.8
CN3008700000000	30	087	Rosebud County, MT	1991	NA	5170	4794	376	7.3
CN3008900000000	30	089	Sanders County, MT	1991	NA	3686	3133	553	15
CN3009100000000	30	091	Sheridan County, MT	1991	NA	2010	1961	49	2.4
CN3009300000000	30	093	Silver Bow County, MT	1991	NA	16013	14738	1275	8
CN3009500000000	30	095	Stillwater County, MT	1991	NA	3198	2929	269	8.4
CN3009700000000	30	097	Sweet Grass County, MT	1991	NA	1540	1480	60	3.9
CN3009900000000	30	099	Teton County, MT	1991	NA	2932	2814	118	4
CN3010100000000	30	101	Toole County, MT	1991	NA	2599	2491	108	4.2
CN3010300000000	30	103	Treasure County, MT	1991	NA	486	468	18	3.7
CN3010500000000	30	105	Valley County, MT	1991	NA	4204	3985	219	5.2
CN3010700000000	30	107	Wheatland County, MT	1991	NA	1123	1062	61	5.4
CN3010900000000	30	109	Wibaux County, MT	1991	NA	522	489	33	6.3
CN3011100000000	30	111	Yellowstone County, MT	1991	NA	62438	59124	3314	5.3
CN3100100000000	31	001	Adams County, NE	1991	NA	15155	14844	311	2.1
CN3100300000000	31	003	Antelope County, NE	1991	NA	3377	3306	71	2.1
CN3100500000000	31	005	Arthur County, NE	1991	NA	222	217	5	2.3
CN3100700000000	31	007	Banner County, NE	1991	NA	408	401	7	1.7
CN3100900000000	31	009	Blaine County, NE	1991	NA	383	369	14	3.7
CN3101100000000	31	011	Boone County, NE	1991	NA	3019	2980	39	1.3
CN3101300000000	31	013	Box Butte County, NE	1991	NA	6199	5965	234	3.8
CN3101500000000	31	015	Boyd County, NE	1991	NA	1213	1195	18	1.5
CN3101700000000	31	017	Brown County, NE	1991	NA	1704	1659	45	2.6
CN3101900000000	31	019	Buffalo County, NE	1991	NA	21099	20514	585	2.8
CN3102100000000	31	021	Burt County, NE	1991	NA	3572	3444	128	3.6
CN3102300000000	31	023	Butler County, NE	1991	NA	4038	3916	122	3
CN3102500000000	31	025	Cass County, NE	1991	NA	10674	10307	367	3.4
CN3102700000000	31	027	Cedar County, NE	1991	NA	4928	4833	95	1.9
CN3102900000000	31	029	Chase County, NE	1991	NA	1968	1931	37	1.9
CN3103100000000	31	031	Cherry County, NE	1991	NA	3257	3210	47	1.4
CN3103300000000	31	033	Cheyenne County, NE	1991	NA	5032	4940	92	1.8
CN3103500000000	31	035	Clay County, NE	1991	NA	3289	3228	61	1.9
CN3103700000000	31	037	Colfax County, NE	1991	NA	4528	4441	87	1.9
CN3103900000000	31	039	Cuming County, NE	1991	NA	5112	5037	75	1.5
CN3104100000000	31	041	Custer County, NE	1991	NA	5808	5694	114	2
CN3104300000000	31	043	Dakota County, NE	1991	NA	8897	8572	325	3.7
CN3104500000000	31	045	Dawes County, NE	1991	NA	4171	4025	146	3.5
CN3104700000000	31	047	Dawson County, NE	1991	NA	12182	11850	332	2.7
CN3104900000000	31	049	Deuel County, NE	1991	NA	1055	1033	22	2.1
CN3105100000000	31	051	Dixon County, NE	1991	NA	3116	3044	72	2.3
CN3105300000000	31	053	Dodge County, NE	1991	NA	17832	17258	574	3.2
CN3105500000000	31	055	Douglas County, NE	1991	NA	227837	220929	6908	3
CN3105700000000	31	057	Dundy County, NE	1991	NA	1278	1263	15	1.2
CN3105900000000	31	059	Fillmore County, NE	1991	NA	3380	3317	63	1.9
CN3106100000000	31	061	Franklin County, NE	1991	NA	1716	1690	26	1.5
CN3106300000000	31	063	Frontier County, NE	1991	NA	1497	1473	24	1.6
CN3106500000000	31	065	Furnas County, NE	1991	NA	2507	2472	35	1.4
CN3106700000000	31	067	Gage County, NE	1991	NA	11790	11558	232	2
CN3106900000000	31	069	Garden County, NE	1991	NA	1152	1133	19	1.6
CN3107100000000	31	071	Garfield County, NE	1991	NA	1073	1040	33	3.1
CN3107300000000	31	073	Gosper County, NE	1991	NA	1209	1192	17	1.4
CN3107500000000	31	075	Grant County, NE	1991	NA	391	383	8	2
CN3107700000000	31	077	Greeley County, NE	1991	NA	1523	1488	35	2.3
CN3107900000000	31	079	Hall County, NE	1991	NA	27991	27257	734	2.6
CN3108100000000	31	081	Hamilton County, NE	1991	NA	4820	4736	84	1.7
CN3108300000000	31	083	Harlan County, NE	1991	NA	1765	1739	26	1.5
CN3108500000000	31	085	Hayes County, NE	1991	NA	500	491	9	1.8
CN3108700000000	31	087	Hitchcock County, NE	1991	NA	1644	1608	36	2.2
CN3108900000000	31	089	Holt County, NE	1991	NA	6101	5982	119	2
CN3109100000000	31	091	Hooker County, NE	1991	NA	367	360	7	1.9
CN3109300000000	31	093	Howard County, NE	1991	NA	3108	3031	77	2.5
CN3109500000000	31	095	Jefferson County, NE	1991	NA	4245	4162	83	2
CN3109700000000	31	097	Johnson County, NE	1991	NA	2328	2275	53	2.3
CN3109900000000	31	099	Kearney County, NE	1991	NA	3223	3163	60	1.9
CN3110100000000	31	101	Keith County, NE	1991	NA	4518	4387	131	2.9
CN3110300000000	31	103	Keya Paha County, NE	1991	NA	503	493	10	2
CN3110500000000	31	105	Kimball County, NE	1991	NA	2054	2020	34	1.7
CN3110700000000	31	107	Knox County, NE	1991	NA	4373	4241	132	3
CN3110900000000	31	109	Lancaster County, NE	1991	NA	126041	123033	3008	2.4
CN3111100000000	31	111	Lincoln County, NE	1991	NA	16956	16456	500	2.9
CN3111300000000	31	113	Logan County, NE	1991	NA	431	423	8	1.9
CN3111500000000	31	115	Loup County, NE	1991	NA	463	455	8	1.7
CN3111700000000	31	117	McPherson County, NE	1991	NA	303	298	5	1.7
CN3111900000000	31	119	Madison County, NE	1991	NA	17355	16944	411	2.4
CN3112100000000	31	121	Merrick County, NE	1991	NA	4324	4230	94	2.2
CN3112300000000	31	123	Morrill County, NE	1991	NA	2742	2653	89	3.2
CN3112500000000	31	125	Nance County, NE	1991	NA	2039	1995	44	2.2
CN3112700000000	31	127	Nemaha County, NE	1991	NA	3571	3411	160	4.5
CN3112900000000	31	129	Nuckolls County, NE	1991	NA	2541	2502	39	1.5
CN3113100000000	31	131	Otoe County, NE	1991	NA	7208	6986	222	3.1
CN3113300000000	31	133	Pawnee County, NE	1991	NA	1587	1554	33	2.1
CN3113500000000	31	135	Perkins County, NE	1991	NA	1411	1382	29	2.1
CN3113700000000	31	137	Phelps County, NE	1991	NA	5168	5096	72	1.4
CN3113900000000	31	139	Pierce County, NE	1991	NA	3675	3589	86	2.3
CN3114100000000	31	141	Platte County, NE	1991	NA	15853	15461	392	2.5
CN3114300000000	31	143	Polk County, NE	1991	NA	2638	2590	48	1.8
CN3114500000000	31	145	Red Willow County, NE	1991	NA	5742	5627	115	2
CN3114700000000	31	147	Richardson County, NE	1991	NA	4620	4409	211	4.6
CN3114900000000	31	149	Rock County, NE	1991	NA	990	963	27	2.7
CN3115100000000	31	151	Saline County, NE	1991	NA	6577	6478	99	1.5
CN3115300000000	31	153	Sarpy County, NE	1991	NA	49866	48654	1212	2.4
CN3115500000000	31	155	Saunders County, NE	1991	NA	9688	9422	266	2.7
CN3115700000000	31	157	Scotts Bluff County, NE	1991	NA	18047	17302	745	4.1
CN3115900000000	31	159	Seward County, NE	1991	NA	8823	8613	210	2.4
CN3116100000000	31	161	Sheridan County, NE	1991	NA	3105	3036	69	2.2
CN3116300000000	31	163	Sherman County, NE	1991	NA	1608	1552	56	3.5
CN3116500000000	31	165	Sioux County, NE	1991	NA	791	782	9	1.1
CN3116700000000	31	167	Stanton County, NE	1991	NA	3091	3026	65	2.1
CN3116900000000	31	169	Thayer County, NE	1991	NA	3209	3163	46	1.4
CN3117100000000	31	171	Thomas County, NE	1991	NA	422	404	18	4.3
CN3117300000000	31	173	Thurston County, NE	1991	NA	2559	2343	216	8.4
CN3117500000000	31	175	Valley County, NE	1991	NA	2811	2754	57	2
CN3117700000000	31	177	Washington County, NE	1991	NA	9133	8882	251	2.7
CN3117900000000	31	179	Wayne County, NE	1991	NA	5259	5117	142	2.7
CN3118100000000	31	181	Webster County, NE	1991	NA	1797	1766	31	1.7
CN3118300000000	31	183	Wheeler County, NE	1991	NA	442	435	7	1.6
CN3118500000000	31	185	York County, NE	1991	NA	8288	8150	138	1.7
CN3200100000000	32	001	Churchill County, NV	1991	NA	7869	7343	526	6.7
CN3200300000000	32	003	Clark County, NV	1991	NA	443278	416645	26633	6
CN3200500000000	32	005	Douglas County, NV	1991	NA	15570	14691	879	5.6
CN3200700000000	32	007	Elko County, NV	1991	NA	18319	17437	882	4.8
CN3200900000000	32	009	Esmeralda County, NV	1991	NA	700	671	29	4.1
CN3201100000000	32	011	Eureka County, NV	1991	NA	878	839	39	4.4
CN3201300000000	32	013	Humboldt County, NV	1991	NA	7520	7160	360	4.8
CN3201500000000	32	015	Lander County, NV	1991	NA	3055	2878	177	5.8
CN3201700000000	32	017	Lincoln County, NV	1991	NA	1504	1383	121	8
CN3201900000000	32	019	Lyon County, NV	1991	NA	9719	9010	709	7.3
CN3202100000000	32	021	Mineral County, NV	1991	NA	2985	2822	163	5.5
CN3202300000000	32	023	Nye County, NV	1991	NA	9378	8989	389	4.1
CN3202700000000	32	027	Pershing County, NV	1991	NA	2066	1978	88	4.3
CN3202900000000	32	029	Storey County, NV	1991	NA	1436	1393	43	3
CN3203100000000	32	031	Washoe County, NV	1991	NA	153496	145427	8069	5.3
CN3203300000000	32	033	White Pine County, NV	1991	NA	3855	3502	353	9.2
CN3251000000000	32	510	Carson City, NV	1991	NA	21120	19615	1505	7.1
CN3300100000000	33	001	Belknap County, NH	1991	NA	26519	24363	2156	8.1
CN3300300000000	33	003	Carroll County, NH	1991	NA	18895	17652	1243	6.6
CN3300500000000	33	005	Cheshire County, NH	1991	NA	38302	36026	2276	5.9
CN3300700000000	33	007	Coos County, NH	1991	NA	17550	16073	1477	8.4
CN3300900000000	33	009	Grafton County, NH	1991	NA	40610	37743	2867	7.1
CN3301100000000	33	011	Hillsborough County, NH	1991	NA	189834	176335	13499	7.1
CN3301300000000	33	013	Merrimack County, NH	1991	NA	65570	61147	4423	6.7
CN3301500000000	33	015	Rockingham County, NH	1991	NA	138990	127969	11021	7.9
CN3301700000000	33	017	Strafford County, NH	1991	NA	58081	53770	4311	7.4
CN3301900000000	33	019	Sullivan County, NH	1991	NA	19948	18378	1570	7.9
CN3400100000000	34	001	Atlantic County, NJ	1991	NA	124064	113191	10873	8.8
CN3400300000000	34	003	Bergen County, NJ	1991	NA	442048	418438	23610	5.3
CN3400500000000	34	005	Burlington County, NJ	1991	NA	210552	197511	13041	6.2
CN3400700000000	34	007	Camden County, NJ	1991	NA	260549	240504	20045	7.7
CN3400900000000	34	009	Cape May County, NJ	1991	NA	45124	40512	4612	10.2
CN3401100000000	34	011	Cumberland County, NJ	1991	NA	66827	60121	6706	10
CN3401300000000	34	013	Essex County, NJ	1991	NA	381190	350205	30985	8.1
CN3401500000000	34	015	Gloucester County, NJ	1991	NA	124193	114896	9297	7.5
CN3401700000000	34	017	Hudson County, NJ	1991	NA	287000	262116	24884	8.7
CN3401900000000	34	019	Hunterdon County, NJ	1991	NA	60226	57952	2274	3.8
CN3402100000000	34	021	Mercer County, NJ	1991	NA	173389	163634	9755	5.6
CN3402300000000	34	023	Middlesex County, NJ	1991	NA	377427	355657	21770	5.8
CN3402500000000	34	025	Monmouth County, NJ	1991	NA	290301	273419	16882	5.8
CN3402700000000	34	027	Morris County, NJ	1991	NA	239566	227957	11609	4.8
CN3402900000000	34	029	Ocean County, NJ	1991	NA	193802	180540	13262	6.8
CN3403100000000	34	031	Passaic County, NJ	1991	NA	235187	216030	19157	8.1
CN3403300000000	34	033	Salem County, NJ	1991	NA	32114	29819	2295	7.1
CN3403500000000	34	035	Somerset County, NJ	1991	NA	142395	136790	5605	3.9
CN3403700000000	34	037	Sussex County, NJ	1991	NA	70467	66206	4261	6
CN3403900000000	34	039	Union County, NJ	1991	NA	261631	243455	18176	6.9
CN3404100000000	34	041	Warren County, NJ	1991	NA	47770	44865	2905	6.1
CN3500100000000	35	001	Bernalillo County, NM	1991	NA	254368	239887	14481	5.7
CN3500300000000	35	003	Catron County, NM	1991	NA	1175	1017	158	13.4
CN3500500000000	35	005	Chaves County, NM	1991	NA	25446	22778	2668	10.5
CN3500600000000	35	006	Cibola County, NM	1991	NA	9231	7966	1265	13.7
CN3500700000000	35	007	Colfax County, NM	1991	NA	5984	5419	565	9.4
CN3500900000000	35	009	Curry County, NM	1991	NA	18442	17392	1050	5.7
CN3501100000000	35	011	De Baca County, NM	1991	NA	923	854	69	7.5
CN3501300000000	35	013	Dona Ana County, NM	1991	NA	60078	55179	4899	8.2
CN3501500000000	35	015	Eddy County, NM	1991	NA	22579	21062	1517	6.7
CN3501700000000	35	017	Grant County, NM	1991	NA	11311	10392	919	8.1
CN3501900000000	35	019	Guadalupe County, NM	1991	NA	1792	1596	196	10.9
CN3502100000000	35	021	Harding County, NM	1991	NA	463	435	28	6
CN3502300000000	35	023	Hidalgo County, NM	1991	NA	2681	2548	133	5
CN3502500000000	35	025	Lea County, NM	1991	NA	24147	23041	1106	4.6
CN3502700000000	35	027	Lincoln County, NM	1991	NA	6166	5727	439	7.1
CN3502800000000	35	028	Los Alamos County, NM	1991	NA	10880	10721	159	1.5
CN3502900000000	35	029	Luna County, NM	1991	NA	8087	6884	1203	14.9
CN3503100000000	35	031	McKinley County, NM	1991	NA	22841	20712	2129	9.3
CN3503300000000	35	033	Mora County, NM	1991	NA	1552	1163	389	25.1
CN3503500000000	35	035	Otero County, NM	1991	NA	20015	18319	1696	8.5
CN3503700000000	35	037	Quay County, NM	1991	NA	4920	4597	323	6.6
CN3503900000000	35	039	Rio Arriba County, NM	1991	NA	15818	13510	2308	14.6
CN3504100000000	35	041	Roosevelt County, NM	1991	NA	7312	6892	420	5.7
CN3504300000000	35	043	Sandoval County, NM	1991	NA	30476	28671	1805	5.9
CN3504500000000	35	045	San Juan County, NM	1991	NA	41889	37843	4046	9.7
CN3504700000000	35	047	San Miguel County, NM	1991	NA	10890	9650	1240	11.4
CN3504900000000	35	049	Santa Fe County, NM	1991	NA	57196	55083	2113	3.7
CN3505100000000	35	051	Sierra County, NM	1991	NA	3410	3210	200	5.9
CN3505300000000	35	053	Socorro County, NM	1991	NA	6638	6137	501	7.5
CN3505500000000	35	055	Taos County, NM	1991	NA	11910	9973	1937	16.3
CN3505700000000	35	057	Torrance County, NM	1991	NA	4503	4141	362	8
CN3505900000000	35	059	Union County, NM	1991	NA	1843	1765	78	4.2
CN3506100000000	35	061	Valencia County, NM	1991	NA	20192	18840	1352	6.7
CN3600100000000	36	001	Albany County, NY	1991	NA	158008	150537	7471	4.7
CN3600300000000	36	003	Allegany County, NY	1991	NA	23020	21159	1861	8.1
CN3600500000000	36	005	Bronx County, NY	1991	NA	451489	404393	47096	10.4
CN3600700000000	36	007	Broome County, NY	1991	NA	105057	98910	6147	5.9
CN3600900000000	36	009	Cattaraugus County, NY	1991	NA	39812	36220	3592	9
CN3601100000000	36	011	Cayuga County, NY	1991	NA	39248	35991	3257	8.3
CN3601300000000	36	013	Chautauqua County, NY	1991	NA	69114	63810	5304	7.7
CN3601500000000	36	015	Chemung County, NY	1991	NA	43360	40479	2881	6.6
CN3601700000000	36	017	Chenango County, NY	1991	NA	24886	23181	1705	6.9
CN3601900000000	36	019	Clinton County, NY	1991	NA	40308	37113	3195	7.9
CN3602100000000	36	021	Columbia County, NY	1991	NA	31346	29625	1721	5.5
CN3602300000000	36	023	Cortland County, NY	1991	NA	24910	23051	1859	7.5
CN3602500000000	36	025	Delaware County, NY	1991	NA	21499	20061	1438	6.7
CN3602700000000	36	027	Dutchess County, NY	1991	NA	130602	123842	6760	5.2
CN3602900000000	36	029	Erie County, NY	1991	NA	477777	444628	33149	6.9
CN3603100000000	36	031	Essex County, NY	1991	NA	18300	16253	2047	11.2
CN3603300000000	36	033	Franklin County, NY	1991	NA	21261	18813	2448	11.5
CN3603500000000	36	035	Fulton County, NY	1991	NA	27085	24233	2852	10.5
CN3603700000000	36	037	Genesee County, NY	1991	NA	32274	29730	2544	7.9
CN3603900000000	36	039	Greene County, NY	1991	NA	21424	19769	1655	7.7
CN3604100000000	36	041	Hamilton County, NY	1991	NA	2911	2606	305	10.5
CN3604300000000	36	043	Herkimer County, NY	1991	NA	30375	27714	2661	8.8
CN3604500000000	36	045	Jefferson County, NY	1991	NA	46673	41536	5137	11
CN3604700000000	36	047	Kings County, NY	1991	NA	938381	848635	89746	9.6
CN3604900000000	36	049	Lewis County, NY	1991	NA	13112	11903	1209	9.2
CN3605100000000	36	051	Livingston County, NY	1991	NA	32962	30838	2124	6.4
CN3605300000000	36	053	Madison County, NY	1991	NA	35719	33086	2633	7.4
CN3605500000000	36	055	Monroe County, NY	1991	NA	380578	363858	16720	4.4
CN3605700000000	36	057	Montgomery County, NY	1991	NA	24728	22324	2404	9.7
CN3605900000000	36	059	Nassau County, NY	1991	NA	687751	648623	39128	5.7
CN3606100000000	36	061	New York County, NY	1991	NA	763728	705291	58437	7.7
CN3606300000000	36	063	Niagara County, NY	1991	NA	109470	101141	8329	7.6
CN3606500000000	36	065	Oneida County, NY	1991	NA	114278	106736	7542	6.6
CN3606700000000	36	067	Onondaga County, NY	1991	NA	243836	229392	14444	5.9
CN3606900000000	36	069	Ontario County, NY	1991	NA	51803	48945	2858	5.5
CN3607100000000	36	071	Orange County, NY	1991	NA	153823	144496	9327	6.1
CN3607300000000	36	073	Orleans County, NY	1991	NA	19982	18519	1463	7.3
CN3607500000000	36	075	Oswego County, NY	1991	NA	58325	52473	5852	10
CN3607700000000	36	077	Otsego County, NY	1991	NA	30921	29090	1831	5.9
CN3607900000000	36	079	Putnam County, NY	1991	NA	48573	45998	2575	5.3
CN3608100000000	36	081	Queens County, NY	1991	NA	937529	862172	75357	8
CN3608300000000	36	083	Rensselaer County, NY	1991	NA	82224	77166	5058	6.2
CN3608500000000	36	085	Richmond County, NY	1991	NA	179804	165522	14282	7.9
CN3608700000000	36	087	Rockland County, NY	1991	NA	142651	134621	8030	5.6
CN3608900000000	36	089	St. Lawrence County, NY	1991	NA	51678	46614	5064	9.8
CN3609100000000	36	091	Saratoga County, NY	1991	NA	98030	92680	5350	5.5
CN3609300000000	36	093	Schenectady County, NY	1991	NA	75839	71363	4476	5.9
CN3609500000000	36	095	Schoharie County, NY	1991	NA	15470	14358	1112	7.2
CN3609700000000	36	097	Schuyler County, NY	1991	NA	9203	8495	708	7.7
CN3609900000000	36	099	Seneca County, NY	1991	NA	16525	15510	1015	6.1
CN3610100000000	36	101	Steuben County, NY	1991	NA	48032	44519	3513	7.3
CN3610300000000	36	103	Suffolk County, NY	1991	NA	701133	652613	48520	6.9
CN3610500000000	36	105	Sullivan County, NY	1991	NA	33311	30627	2684	8.1
CN3610700000000	36	107	Tioga County, NY	1991	NA	26471	24914	1557	5.9
CN3610900000000	36	109	Tompkins County, NY	1991	NA	48479	46402	2077	4.3
CN3611100000000	36	111	Ulster County, NY	1991	NA	84970	79924	5046	5.9
CN3611300000000	36	113	Warren County, NY	1991	NA	31655	28903	2752	8.7
CN3611500000000	36	115	Washington County, NY	1991	NA	29037	26887	2150	7.4
CN3611700000000	36	117	Wayne County, NY	1991	NA	47277	44220	3057	6.5
CN3611900000000	36	119	Westchester County, NY	1991	NA	461417	436529	24888	5.4
CN3612100000000	36	121	Wyoming County, NY	1991	NA	20120	18457	1663	8.3
CN3612300000000	36	123	Yates County, NY	1991	NA	11544	10767	777	6.7
CN3700100000000	37	001	Alamance County, NC	1991	NA	62240	58621	3619	5.8
CN3700300000000	37	003	Alexander County, NC	1991	NA	16385	15312	1073	6.5
CN3700500000000	37	005	Alleghany County, NC	1991	NA	4971	4726	245	4.9
CN3700700000000	37	007	Anson County, NC	1991	NA	12146	11110	1036	8.5
CN3700900000000	37	009	Ashe County, NC	1991	NA	11618	10700	918	7.9
CN3701100000000	37	011	Avery County, NC	1991	NA	7324	6692	632	8.6
CN3701300000000	37	013	Beaufort County, NC	1991	NA	20453	18980	1473	7.2
CN3701500000000	37	015	Bertie County, NC	1991	NA	9124	8596	528	5.8
CN3701700000000	37	017	Bladen County, NC	1991	NA	13703	12201	1502	11
CN3701900000000	37	019	Brunswick County, NC	1991	NA	25885	23699	2186	8.4
CN3702100000000	37	021	Buncombe County, NC	1991	NA	94656	90148	4508	4.8
CN3702300000000	37	023	Burke County, NC	1991	NA	42218	39668	2550	6
CN3702500000000	37	025	Cabarrus County, NC	1991	NA	55624	52870	2754	5
CN3702700000000	37	027	Caldwell County, NC	1991	NA	40931	38123	2808	6.9
CN3702900000000	37	029	Camden County, NC	1991	NA	2755	2635	120	4.4
CN3703100000000	37	031	Carteret County, NC	1991	NA	26387	24900	1487	5.6
CN3703300000000	37	033	Caswell County, NC	1991	NA	11075	10438	637	5.8
CN3703500000000	37	035	Catawba County, NC	1991	NA	72615	67729	4886	6.7
CN3703700000000	37	037	Chatham County, NC	1991	NA	22817	21625	1192	5.2
CN3703900000000	37	039	Cherokee County, NC	1991	NA	9257	8286	971	10.5
CN3704100000000	37	041	Chowan County, NC	1991	NA	6255	5907	348	5.6
CN3704300000000	37	043	Clay County, NC	1991	NA	3213	2959	254	7.9
CN3704500000000	37	045	Cleveland County, NC	1991	NA	46487	43128	3359	7.2
CN3704700000000	37	047	Columbus County, NC	1991	NA	23940	22045	1895	7.9
CN3704900000000	37	049	Craven County, NC	1991	NA	34329	32403	1926	5.6
CN3705100000000	37	051	Cumberland County, NC	1991	NA	107305	100978	6327	5.9
CN3705300000000	37	053	Currituck County, NC	1991	NA	7238	6922	316	4.4
CN3705500000000	37	055	Dare County, NC	1991	NA	14610	13671	939	6.4
CN3705700000000	37	057	Davidson County, NC	1991	NA	73846	69565	4281	5.8
CN3705900000000	37	059	Davie County, NC	1991	NA	15667	14880	787	5
CN3706100000000	37	061	Duplin County, NC	1991	NA	20626	18852	1774	8.6
CN3706300000000	37	063	Durham County, NC	1991	NA	103497	99926	3571	3.5
CN3706500000000	37	065	Edgecombe County, NC	1991	NA	28763	26588	2175	7.6
CN3706700000000	37	067	Forsyth County, NC	1991	NA	144690	138247	6443	4.5
CN3706900000000	37	069	Franklin County, NC	1991	NA	19537	18197	1340	6.9
CN3707100000000	37	071	Gaston County, NC	1991	NA	96093	89772	6321	6.6
CN3707300000000	37	073	Gates County, NC	1991	NA	4140	3995	145	3.5
CN3707500000000	37	075	Graham County, NC	1991	NA	3652	2946	706	19.3
CN3707700000000	37	077	Granville County, NC	1991	NA	19540	18418	1122	5.7
CN3707900000000	37	079	Greene County, NC	1991	NA	7697	7286	411	5.3
CN3708100000000	37	081	Guilford County, NC	1991	NA	202997	192533	10464	5.2
CN3708300000000	37	083	Halifax County, NC	1991	NA	24323	22264	2059	8.5
CN3708500000000	37	085	Harnett County, NC	1991	NA	31584	29698	1886	6
CN3708700000000	37	087	Haywood County, NC	1991	NA	23942	22512	1430	6
CN3708900000000	37	089	Henderson County, NC	1991	NA	32777	31355	1422	4.3
CN3709100000000	37	091	Hertford County, NC	1991	NA	10182	9296	886	8.7
CN3709300000000	37	093	Hoke County, NC	1991	NA	9764	9119	645	6.6
CN3709500000000	37	095	Hyde County, NC	1991	NA	2761	2545	216	7.8
CN3709700000000	37	097	Iredell County, NC	1991	NA	53788	50370	3418	6.4
CN3709900000000	37	099	Jackson County, NC	1991	NA	13685	12757	928	6.8
CN3710100000000	37	101	Johnston County, NC	1991	NA	46154	43468	2686	5.8
CN3710300000000	37	103	Jones County, NC	1991	NA	4455	4207	248	5.6
CN3710500000000	37	105	Lee County, NC	1991	NA	22094	20589	1505	6.8
CN3710700000000	37	107	Lenoir County, NC	1991	NA	28799	27007	1792	6.2
CN3710900000000	37	109	Lincoln County, NC	1991	NA	28355	26579	1776	6.3
CN3711100000000	37	111	McDowell County, NC	1991	NA	19267	17706	1561	8.1
CN3711300000000	37	113	Macon County, NC	1991	NA	11596	10968	628	5.4
CN3711500000000	37	115	Madison County, NC	1991	NA	8525	7943	582	6.8
CN3711700000000	37	117	Martin County, NC	1991	NA	13048	12300	748	5.7
CN3711900000000	37	119	Mecklenburg County, NC	1991	NA	301831	288185	13646	4.5
CN3712100000000	37	121	Mitchell County, NC	1991	NA	7380	6673	707	9.6
CN3712300000000	37	123	Montgomery County, NC	1991	NA	12061	10948	1113	9.2
CN3712500000000	37	125	Moore County, NC	1991	NA	28179	26563	1616	5.7
CN3712700000000	37	127	Nash County, NC	1991	NA	43062	40289	2773	6.4
CN3712900000000	37	129	New Hanover County, NC	1991	NA	68617	64493	4124	6
CN3713100000000	37	131	Northampton County, NC	1991	NA	8749	8131	618	7.1
CN3713300000000	37	133	Onslow County, NC	1991	NA	41982	39772	2210	5.3
CN3713500000000	37	135	Orange County, NC	1991	NA	54733	53206	1527	2.8
CN3713700000000	37	137	Pamlico County, NC	1991	NA	5118	4874	244	4.8
CN3713900000000	37	139	Pasquotank County, NC	1991	NA	13198	12473	725	5.5
CN3714100000000	37	141	Pender County, NC	1991	NA	14300	13165	1135	7.9
CN3714300000000	37	143	Perquimans County, NC	1991	NA	4357	4118	239	5.5
CN3714500000000	37	145	Person County, NC	1991	NA	16485	14966	1519	9.2
CN3714700000000	37	147	Pitt County, NC	1991	NA	58249	54779	3470	6
CN3714900000000	37	149	Polk County, NC	1991	NA	7364	7145	219	3
CN3715100000000	37	151	Randolph County, NC	1991	NA	64011	61001	3010	4.7
CN3715300000000	37	153	Richmond County, NC	1991	NA	22230	20168	2062	9.3
CN3715500000000	37	155	Robeson County, NC	1991	NA	51263	46631	4632	9
CN3715700000000	37	157	Rockingham County, NC	1991	NA	46900	43315	3585	7.6
CN3715900000000	37	159	Rowan County, NC	1991	NA	58407	55208	3199	5.5
CN3716100000000	37	161	Rutherford County, NC	1991	NA	30834	28556	2278	7.4
CN3716300000000	37	163	Sampson County, NC	1991	NA	23128	21410	1718	7.4
CN3716500000000	37	165	Scotland County, NC	1991	NA	16903	15106	1797	10.6
CN3716700000000	37	167	Stanly County, NC	1991	NA	28663	26738	1925	6.7
CN3716900000000	37	169	Stokes County, NC	1991	NA	20380	19421	959	4.7
CN3717100000000	37	171	Surry County, NC	1991	NA	34496	32330	2166	6.3
CN3717300000000	37	173	Swain County, NC	1991	NA	6163	5244	919	14.9
CN3717500000000	37	175	Transylvania County, NC	1991	NA	11912	11316	596	5
CN3717700000000	37	177	Tyrrell County, NC	1991	NA	1870	1659	211	11.3
CN3717900000000	37	179	Union County, NC	1991	NA	47154	44790	2364	5
CN3718100000000	37	181	Vance County, NC	1991	NA	20499	18521	1978	9.6
CN3718300000000	37	183	Wake County, NC	1991	NA	261842	253611	8231	3.1
CN3718500000000	37	185	Warren County, NC	1991	NA	7759	6845	914	11.8
CN3718700000000	37	187	Washington County, NC	1991	NA	6514	6110	404	6.2
CN3718900000000	37	189	Watauga County, NC	1991	NA	20119	19242	877	4.4
CN3719100000000	37	191	Wayne County, NC	1991	NA	49383	45892	3491	7.1
CN3719300000000	37	193	Wilkes County, NC	1991	NA	32291	30497	1794	5.6
CN3719500000000	37	195	Wilson County, NC	1991	NA	35279	31562	3717	10.5
CN3719700000000	37	197	Yadkin County, NC	1991	NA	16382	15609	773	4.7
CN3719900000000	37	199	Yancey County, NC	1991	NA	6568	6002	566	8.6
CN3800100000000	38	001	Adams County, ND	1991	NA	1606	1567	39	2.4
CN3800300000000	38	003	Barnes County, ND	1991	NA	5686	5473	213	3.7
CN3800500000000	38	005	Benson County, ND	1991	NA	2674	2458	216	8.1
CN3800700000000	38	007	Billings County, ND	1991	NA	651	622	29	4.5
CN3800900000000	38	009	Bottineau County, ND	1991	NA	3493	3347	146	4.2
CN3801100000000	38	011	Bowman County, ND	1991	NA	1919	1865	54	2.8
CN3801300000000	38	013	Burke County, ND	1991	NA	1221	1172	49	4
CN3801500000000	38	015	Burleigh County, ND	1991	NA	34503	33099	1404	4.1
CN3801700000000	38	017	Cass County, ND	1991	NA	60511	58593	1918	3.2
CN3801900000000	38	019	Cavalier County, ND	1991	NA	2551	2435	116	4.5
CN3802100000000	38	021	Dickey County, ND	1991	NA	2913	2820	93	3.2
CN3802300000000	38	023	Divide County, ND	1991	NA	1177	1154	23	2
CN3802500000000	38	025	Dunn County, ND	1991	NA	1896	1834	62	3.3
CN3802700000000	38	027	Eddy County, ND	1991	NA	1391	1277	114	8.2
CN3802900000000	38	029	Emmons County, ND	1991	NA	1969	1888	81	4.1
CN3803100000000	38	031	Foster County, ND	1991	NA	1919	1839	80	4.2
CN3803300000000	38	033	Golden Valley County, ND	1991	NA	1022	978	44	4.3
CN3803500000000	38	035	Grand Forks County, ND	1991	NA	33842	32565	1277	3.8
CN3803700000000	38	037	Grant County, ND	1991	NA	1567	1523	44	2.8
CN3803900000000	38	039	Griggs County, ND	1991	NA	1505	1466	39	2.6
CN3804100000000	38	041	Hettinger County, ND	1991	NA	1497	1444	53	3.5
CN3804300000000	38	043	Kidder County, ND	1991	NA	1495	1408	87	5.8
CN3804500000000	38	045	LaMoure County, ND	1991	NA	2254	2199	55	2.4
CN3804700000000	38	047	Logan County, ND	1991	NA	1261	1221	40	3.2
CN3804900000000	38	049	McHenry County, ND	1991	NA	2699	2544	155	5.7
CN3805100000000	38	051	McIntosh County, ND	1991	NA	1818	1790	28	1.5
CN3805300000000	38	053	McKenzie County, ND	1991	NA	2879	2769	110	3.8
CN3805500000000	38	055	McLean County, ND	1991	NA	4649	4367	282	6.1
CN3805700000000	38	057	Mercer County, ND	1991	NA	5029	4650	379	7.5
CN3805900000000	38	059	Morton County, ND	1991	NA	12378	11718	660	5.3
CN3806100000000	38	061	Mountrail County, ND	1991	NA	3049	2832	217	7.1
CN3806300000000	38	063	Nelson County, ND	1991	NA	1762	1694	68	3.9
CN3806500000000	38	065	Oliver County, ND	1991	NA	1196	1134	62	5.2
CN3806700000000	38	067	Pembina County, ND	1991	NA	4664	4289	375	8
CN3806900000000	38	069	Pierce County, ND	1991	NA	2273	2198	75	3.3
CN3807100000000	38	071	Ramsey County, ND	1991	NA	6172	5951	221	3.6
CN3807300000000	38	073	Ransom County, ND	1991	NA	2624	2562	62	2.4
CN3807500000000	38	075	Renville County, ND	1991	NA	1338	1298	40	3
CN3807700000000	38	077	Richland County, ND	1991	NA	8339	7949	390	4.7
CN3807900000000	38	079	Rolette County, ND	1991	NA	4451	3784	667	15
CN3808100000000	38	081	Sargent County, ND	1991	NA	2195	2129	66	3
CN3808300000000	38	083	Sheridan County, ND	1991	NA	750	723	27	3.6
CN3808500000000	38	085	Sioux County, ND	1991	NA	1286	1010	276	21.5
CN3808700000000	38	087	Slope County, ND	1991	NA	453	436	17	3.8
CN3808900000000	38	089	Stark County, ND	1991	NA	11876	11297	579	4.9
CN3809100000000	38	091	Steele County, ND	1991	NA	1022	1003	19	1.9
CN3809300000000	38	093	Stutsman County, ND	1991	NA	11104	10684	420	3.8
CN3809500000000	38	095	Towner County, ND	1991	NA	1553	1505	48	3.1
CN3809700000000	38	097	Traill County, ND	1991	NA	3818	3658	160	4.2
CN3809900000000	38	099	Walsh County, ND	1991	NA	6578	6285	293	4.5
CN3810100000000	38	101	Ward County, ND	1991	NA	25862	24724	1138	4.4
CN3810300000000	38	103	Wells County, ND	1991	NA	2555	2384	171	6.7
CN3810500000000	38	105	Williams County, ND	1991	NA	10323	9867	456	4.4
CN3900100000000	39	001	Adams County, OH	1991	NA	10139	8886	1253	12.4
CN3900300000000	39	003	Allen County, OH	1991	NA	52550	48378	4172	7.9
CN3900500000000	39	005	Ashland County, OH	1991	NA	24833	23148	1685	6.8
CN3900700000000	39	007	Ashtabula County, OH	1991	NA	45580	41475	4105	9
CN3900900000000	39	009	Athens County, OH	1991	NA	24606	23086	1520	6.2
CN3901100000000	39	011	Auglaize County, OH	1991	NA	23467	22040	1427	6.1
CN3901300000000	39	013	Belmont County, OH	1991	NA	30272	28187	2085	6.9
CN3901500000000	39	015	Brown County, OH	1991	NA	17090	15741	1349	7.9
CN3901700000000	39	017	Butler County, OH	1991	NA	152135	143207	8928	5.9
CN3901900000000	39	019	Carroll County, OH	1991	NA	12484	11546	938	7.5
CN3902100000000	39	021	Champaign County, OH	1991	NA	19019	17677	1342	7.1
CN3902300000000	39	023	Clark County, OH	1991	NA	70733	66062	4671	6.6
CN3902500000000	39	025	Clermont County, OH	1991	NA	81768	77084	4684	5.7
CN3902700000000	39	027	Clinton County, OH	1991	NA	19260	18081	1179	6.1
CN3902900000000	39	029	Columbiana County, OH	1991	NA	49577	46147	3430	6.9
CN3903100000000	39	031	Coshocton County, OH	1991	NA	16529	15303	1226	7.4
CN3903300000000	39	033	Crawford County, OH	1991	NA	22544	20171	2373	10.5
CN3903500000000	39	035	Cuyahoga County, OH	1991	NA	675737	634222	41515	6.1
CN3903700000000	39	037	Darke County, OH	1991	NA	27488	25681	1807	6.6
CN3903900000000	39	039	Defiance County, OH	1991	NA	20756	18997	1759	8.5
CN3904100000000	39	041	Delaware County, OH	1991	NA	37491	36103	1388	3.7
CN3904300000000	39	043	Erie County, OH	1991	NA	42023	38957	3066	7.3
CN3904500000000	39	045	Fairfield County, OH	1991	NA	54212	51172	3040	5.6
CN3904700000000	39	047	Fayette County, OH	1991	NA	13242	12327	915	6.9
CN3904900000000	39	049	Franklin County, OH	1991	NA	537349	517061	20288	3.8
CN3905100000000	39	051	Fulton County, OH	1991	NA	20817	18931	1886	9.1
CN3905300000000	39	053	Gallia County, OH	1991	NA	13180	12001	1179	8.9
CN3905500000000	39	055	Geauga County, OH	1991	NA	42619	40680	1939	4.5
CN3905700000000	39	057	Greene County, OH	1991	NA	68030	64586	3444	5.1
CN3905900000000	39	059	Guernsey County, OH	1991	NA	18242	16444	1798	9.9
CN3906100000000	39	061	Hamilton County, OH	1991	NA	439913	419304	20609	4.7
CN3906300000000	39	063	Hancock County, OH	1991	NA	36109	34155	1954	5.4
CN3906500000000	39	065	Hardin County, OH	1991	NA	14346	12911	1435	10
CN3906700000000	39	067	Harrison County, OH	1991	NA	6496	5891	605	9.3
CN3906900000000	39	069	Henry County, OH	1991	NA	15993	14845	1148	7.2
CN3907100000000	39	071	Highland County, OH	1991	NA	16202	14649	1553	9.6
CN3907300000000	39	073	Hocking County, OH	1991	NA	11723	10572	1151	9.8
CN3907500000000	39	075	Holmes County, OH	1991	NA	14850	14128	722	4.9
CN3907700000000	39	077	Huron County, OH	1991	NA	29562	26133	3429	11.6
CN3907900000000	39	079	Jackson County, OH	1991	NA	12883	11799	1084	8.4
CN3908100000000	39	081	Jefferson County, OH	1991	NA	32245	29911	2334	7.2
CN3908300000000	39	083	Knox County, OH	1991	NA	24424	22917	1507	6.2
CN3908500000000	39	085	Lake County, OH	1991	NA	118455	111362	7093	6
CN3908700000000	39	087	Lawrence County, OH	1991	NA	25231	23190	2041	8.1
CN3908900000000	39	089	Licking County, OH	1991	NA	65937	62192	3745	5.7
CN3909100000000	39	091	Logan County, OH	1991	NA	21826	20395	1431	6.6
CN3909300000000	39	093	Lorain County, OH	1991	NA	136831	124550	12281	9
CN3909500000000	39	095	Lucas County, OH	1991	NA	226492	205106	21386	9.4
CN3909700000000	39	097	Madison County, OH	1991	NA	18167	17286	881	4.8
CN3909900000000	39	099	Mahoning County, OH	1991	NA	117737	109509	8228	7
CN3910100000000	39	101	Marion County, OH	1991	NA	30525	28050	2475	8.1
CN3910300000000	39	103	Medina County, OH	1991	NA	66224	62420	3804	5.7
CN3910500000000	39	105	Meigs County, OH	1991	NA	8664	7848	816	9.4
CN3910700000000	39	107	Mercer County, OH	1991	NA	20023	18885	1138	5.7
CN3910900000000	39	109	Miami County, OH	1991	NA	49122	46063	3059	6.2
CN3911100000000	39	111	Monroe County, OH	1991	NA	6149	5554	595	9.7
CN3911300000000	39	113	Montgomery County, OH	1991	NA	286866	270466	16400	5.7
CN3911500000000	39	115	Morgan County, OH	1991	NA	5817	5237	580	10
CN3911700000000	39	117	Morrow County, OH	1991	NA	13465	12402	1063	7.9
CN3911900000000	39	119	Muskingum County, OH	1991	NA	39427	35446	3981	10.1
CN3912100000000	39	121	Noble County, OH	1991	NA	5066	4593	473	9.3
CN3912300000000	39	123	Ottawa County, OH	1991	NA	21535	19454	2081	9.7
CN3912500000000	39	125	Paulding County, OH	1991	NA	9858	9014	844	8.6
CN3912700000000	39	127	Perry County, OH	1991	NA	14357	12374	1983	13.8
CN3912900000000	39	129	Pickaway County, OH	1991	NA	21710	20526	1184	5.5
CN3913100000000	39	131	Pike County, OH	1991	NA	9689	8580	1109	11.4
CN3913300000000	39	133	Portage County, OH	1991	NA	76327	71851	4476	5.9
CN3913500000000	39	135	Preble County, OH	1991	NA	19715	18288	1427	7.2
CN3913700000000	39	137	Putnam County, OH	1991	NA	17129	15845	1284	7.5
CN3913900000000	39	139	Richland County, OH	1991	NA	61470	55099	6371	10.4
CN3914100000000	39	141	Ross County, OH	1991	NA	30550	27926	2624	8.6
CN3914300000000	39	143	Sandusky County, OH	1991	NA	32193	29325	2868	8.9
CN3914500000000	39	145	Scioto County, OH	1991	NA	30073	27034	3039	10.1
CN3914700000000	39	147	Seneca County, OH	1991	NA	30381	27645	2736	9
CN3914900000000	39	149	Shelby County, OH	1991	NA	25588	23821	1767	6.9
CN3915100000000	39	151	Stark County, OH	1991	NA	185689	172543	13146	7.1
CN3915300000000	39	153	Summit County, OH	1991	NA	261628	245922	15706	6
CN3915500000000	39	155	Trumbull County, OH	1991	NA	110890	102140	8750	7.9
CN3915700000000	39	157	Tuscarawas County, OH	1991	NA	41183	37879	3304	8
CN3915900000000	39	159	Union County, OH	1991	NA	16055	15249	806	5
CN3916100000000	39	161	Van Wert County, OH	1991	NA	15906	14747	1159	7.3
CN3916300000000	39	163	Vinton County, OH	1991	NA	4203	3719	484	11.5
CN3916500000000	39	165	Warren County, OH	1991	NA	60991	58006	2985	4.9
CN3916700000000	39	167	Washington County, OH	1991	NA	30409	28359	2050	6.7
CN3916900000000	39	169	Wayne County, OH	1991	NA	52161	49153	3008	5.8
CN3917100000000	39	171	Williams County, OH	1991	NA	20261	18463	1798	8.9
CN3917300000000	39	173	Wood County, OH	1991	NA	60048	55939	4109	6.8
CN3917500000000	39	175	Wyandot County, OH	1991	NA	11383	10243	1140	10
CN4000100000000	40	001	Adair County, OK	1991	NA	9181	8600	581	6.3
CN4000300000000	40	003	Alfalfa County, OK	1991	NA	2684	2617	67	2.5
CN4000500000000	40	005	Atoka County, OK	1991	NA	4821	4425	396	8.2
CN4000700000000	40	007	Beaver County, OK	1991	NA	3003	2903	100	3.3
CN4000900000000	40	009	Beckham County, OK	1991	NA	8705	8090	615	7.1
CN4001100000000	40	011	Blaine County, OK	1991	NA	4968	4671	297	6
CN4001300000000	40	013	Bryan County, OK	1991	NA	13297	12311	986	7.4
CN4001500000000	40	015	Caddo County, OK	1991	NA	11986	11025	961	8
CN4001700000000	40	017	Canadian County, OK	1991	NA	39195	37429	1766	4.5
CN4001900000000	40	019	Carter County, OK	1991	NA	19718	18306	1412	7.2
CN4002100000000	40	021	Cherokee County, OK	1991	NA	15798	14450	1348	8.5
CN4002300000000	40	023	Choctaw County, OK	1991	NA	6015	5329	686	11.4
CN4002500000000	40	025	Cimarron County, OK	1991	NA	1795	1752	43	2.4
CN4002700000000	40	027	Cleveland County, OK	1991	NA	93912	90046	3866	4.1
CN4002900000000	40	029	Coal County, OK	1991	NA	2466	2131	335	13.6
CN4003100000000	40	031	Comanche County, OK	1991	NA	41641	38785	2856	6.9
CN4003300000000	40	033	Cotton County, OK	1991	NA	2412	2137	275	11.4
CN4003500000000	40	035	Craig County, OK	1991	NA	6402	6037	365	5.7
CN4003700000000	40	037	Creek County, OK	1991	NA	29604	27616	1988	6.7
CN4003900000000	40	039	Custer County, OK	1991	NA	13435	12533	902	6.7
CN4004100000000	40	041	Delaware County, OK	1991	NA	12708	11836	872	6.9
CN4004300000000	40	043	Dewey County, OK	1991	NA	2410	2312	98	4.1
CN4004500000000	40	045	Ellis County, OK	1991	NA	2016	1912	104	5.2
CN4004700000000	40	047	Garfield County, OK	1991	NA	26591	25447	1144	4.3
CN4004900000000	40	049	Garvin County, OK	1991	NA	11727	10869	858	7.3
CN4005100000000	40	051	Grady County, OK	1991	NA	18535	17153	1382	7.5
CN4005300000000	40	053	Grant County, OK	1991	NA	2538	2460	78	3.1
CN4005500000000	40	055	Greer County, OK	1991	NA	2285	2178	107	4.7
CN4005700000000	40	057	Harmon County, OK	1991	NA	1369	1297	72	5.3
CN4005900000000	40	059	Harper County, OK	1991	NA	2012	1945	67	3.3
CN4006100000000	40	061	Haskell County, OK	1991	NA	4408	3638	770	17.5
CN4006300000000	40	063	Hughes County, OK	1991	NA	5338	4683	655	12.3
CN4006500000000	40	065	Jackson County, OK	1991	NA	10232	9495	737	7.2
CN4006700000000	40	067	Jefferson County, OK	1991	NA	2826	2647	179	6.3
CN4006900000000	40	069	Johnston County, OK	1991	NA	3887	3574	313	8.1
CN4007100000000	40	071	Kay County, OK	1991	NA	23495	22204	1291	5.5
CN4007300000000	40	073	Kingfisher County, OK	1991	NA	6478	6251	227	3.5
CN4007500000000	40	075	Kiowa County, OK	1991	NA	4745	4531	214	4.5
CN4007700000000	40	077	Latimer County, OK	1991	NA	4348	3711	637	14.7
CN4007900000000	40	079	Le Flore County, OK	1991	NA	17763	15299	2464	13.9
CN4008100000000	40	081	Lincoln County, OK	1991	NA	13517	12664	853	6.3
CN4008300000000	40	083	Logan County, OK	1991	NA	13316	12669	647	4.9
CN4008500000000	40	085	Love County, OK	1991	NA	3694	3480	214	5.8
CN4008700000000	40	087	McClain County, OK	1991	NA	11061	10502	559	5.1
CN4008900000000	40	089	McCurtain County, OK	1991	NA	14263	12558	1705	12
CN4009100000000	40	091	McIntosh County, OK	1991	NA	6592	5969	623	9.5
CN4009300000000	40	093	Major County, OK	1991	NA	3686	3565	121	3.3
CN4009500000000	40	095	Marshall County, OK	1991	NA	4494	4236	258	5.7
CN4009700000000	40	097	Mayes County, OK	1991	NA	14710	13270	1440	9.8
CN4009900000000	40	099	Murray County, OK	1991	NA	5608	5068	540	9.6
CN4010100000000	40	101	Muskogee County, OK	1991	NA	29348	26859	2489	8.5
CN4010300000000	40	103	Noble County, OK	1991	NA	5364	5132	232	4.3
CN4010500000000	40	105	Nowata County, OK	1991	NA	4311	3992	319	7.4
CN4010700000000	40	107	Okfuskee County, OK	1991	NA	4319	3938	381	8.8
CN4010900000000	40	109	Oklahoma County, OK	1991	NA	303441	286310	17131	5.6
CN4011100000000	40	111	Okmulgee County, OK	1991	NA	15132	13610	1522	10.1
CN4011300000000	40	113	Osage County, OK	1991	NA	18797	17884	913	4.9
CN4011500000000	40	115	Ottawa County, OK	1991	NA	13061	11870	1191	9.1
CN4011700000000	40	117	Pawnee County, OK	1991	NA	6694	6098	596	8.9
CN4011900000000	40	119	Payne County, OK	1991	NA	30060	28640	1420	4.7
CN4012100000000	40	121	Pittsburg County, OK	1991	NA	18340	16375	1965	10.7
CN4012300000000	40	123	Pontotoc County, OK	1991	NA	15818	14548	1270	8
CN4012500000000	40	125	Pottawatomie County, OK	1991	NA	26270	24389	1881	7.2
CN4012700000000	40	127	Pushmataha County, OK	1991	NA	4311	3848	463	10.7
CN4012900000000	40	129	Roger Mills County, OK	1991	NA	1970	1870	100	5.1
CN4013100000000	40	131	Rogers County, OK	1991	NA	29123	26918	2205	7.6
CN4013300000000	40	133	Seminole County, OK	1991	NA	10421	9323	1098	10.5
CN4013500000000	40	135	Sequoyah County, OK	1991	NA	15501	13960	1541	9.9
CN4013700000000	40	137	Stephens County, OK	1991	NA	19293	17997	1296	6.7
CN4013900000000	40	139	Texas County, OK	1991	NA	8340	8013	327	3.9
CN4014100000000	40	141	Tillman County, OK	1991	NA	4279	3941	338	7.9
CN4014300000000	40	143	Tulsa County, OK	1991	NA	270354	256219	14135	5.2
CN4014500000000	40	145	Wagoner County, OK	1991	NA	24399	23045	1354	5.5
CN4014700000000	40	147	Washington County, OK	1991	NA	22335	21505	830	3.7
CN4014900000000	40	149	Washita County, OK	1991	NA	5158	4866	292	5.7
CN4015100000000	40	151	Woods County, OK	1991	NA	4315	4196	119	2.8
CN4015300000000	40	153	Woodward County, OK	1991	NA	8902	8393	509	5.7
CN4100100000000	41	001	Baker County, OR	1991	NA	7050	6481	569	8.1
CN4100300000000	41	003	Benton County, OR	1991	NA	36193	34638	1555	4.3
CN4100500000000	41	005	Clackamas County, OR	1991	NA	160621	153542	7079	4.4
CN4100700000000	41	007	Clatsop County, OR	1991	NA	16321	15087	1234	7.6
CN4100900000000	41	009	Columbia County, OR	1991	NA	18833	17507	1326	7
CN4101100000000	41	011	Coos County, OR	1991	NA	27028	24504	2524	9.3
CN4101300000000	41	013	Crook County, OR	1991	NA	6953	6371	582	8.4
CN4101500000000	41	015	Curry County, OR	1991	NA	8253	7666	587	7.1
CN4101700000000	41	017	Deschutes County, OR	1991	NA	43107	40157	2950	6.8
CN4101900000000	41	019	Douglas County, OR	1991	NA	43330	38691	4639	10.7
CN4102100000000	41	021	Gilliam County, OR	1991	NA	1084	1048	36	3.3
CN4102300000000	41	023	Grant County, OR	1991	NA	4312	3859	453	10.5
CN4102500000000	41	025	Harney County, OR	1991	NA	3745	3433	312	8.3
CN4102700000000	41	027	Hood River County, OR	1991	NA	9559	8655	904	9.5
CN4102900000000	41	029	Jackson County, OR	1991	NA	74809	68790	6019	8
CN4103100000000	41	031	Jefferson County, OR	1991	NA	6538	6053	485	7.4
CN4103300000000	41	033	Josephine County, OR	1991	NA	26332	24054	2278	8.7
CN4103500000000	41	035	Klamath County, OR	1991	NA	26810	24233	2577	9.6
CN4103700000000	41	037	Lake County, OR	1991	NA	3723	3409	314	8.4
CN4103900000000	41	039	Lane County, OR	1991	NA	146026	135760	10266	7
CN4104100000000	41	041	Lincoln County, OR	1991	NA	19627	18418	1209	6.2
CN4104300000000	41	043	Linn County, OR	1991	NA	44627	40765	3862	8.7
CN4104500000000	41	045	Malheur County, OR	1991	NA	14364	13382	982	6.8
CN4104700000000	41	047	Marion County, OR	1991	NA	118708	111607	7101	6
CN4104900000000	41	049	Morrow County, OR	1991	NA	3513	3163	350	10
CN4105100000000	41	051	Multnomah County, OR	1991	NA	326726	307964	18762	5.7
CN4105300000000	41	053	Polk County, OR	1991	NA	25178	23747	1431	5.7
CN4105500000000	41	055	Sherman County, OR	1991	NA	999	929	70	7
CN4105700000000	41	057	Tillamook County, OR	1991	NA	9842	9213	629	6.4
CN4105900000000	41	059	Umatilla County, OR	1991	NA	30351	27697	2654	8.7
CN4106100000000	41	061	Union County, OR	1991	NA	11753	10885	868	7.4
CN4106300000000	41	063	Wallowa County, OR	1991	NA	3652	3331	321	8.8
CN4106500000000	41	065	Wasco County, OR	1991	NA	11389	10506	883	7.8
CN4106700000000	41	067	Washington County, OR	1991	NA	191801	182813	8988	4.7
CN4106900000000	41	069	Wheeler County, OR	1991	NA	528	457	71	13.4
CN4107100000000	41	071	Yamhill County, OR	1991	NA	33195	31312	1883	5.7
CN4200100000000	42	001	Adams County, PA	1991	NA	41628	39453	2175	5.2
CN4200300000000	42	003	Allegheny County, PA	1991	NA	650951	615916	35035	5.4
CN4200500000000	42	005	Armstrong County, PA	1991	NA	30690	27572	3118	10.2
CN4200700000000	42	007	Beaver County, PA	1991	NA	83902	77823	6079	7.2
CN4200900000000	42	009	Bedford County, PA	1991	NA	22077	19716	2361	10.7
CN4201100000000	42	011	Berks County, PA	1991	NA	175668	164281	11387	6.5
CN4201300000000	42	013	Blair County, PA	1991	NA	61309	55540	5769	9.4
CN4201500000000	42	015	Bradford County, PA	1991	NA	27734	25672	2062	7.4
CN4201700000000	42	017	Bucks County, PA	1991	NA	304267	282670	21597	7.1
CN4201900000000	42	019	Butler County, PA	1991	NA	76578	71387	5191	6.8
CN4202100000000	42	021	Cambria County, PA	1991	NA	68127	61852	6275	9.2
CN4202300000000	42	023	Cameron County, PA	1991	NA	2520	2290	230	9.1
CN4202500000000	42	025	Carbon County, PA	1991	NA	27027	24397	2630	9.7
CN4202700000000	42	027	Centre County, PA	1991	NA	61077	58353	2724	4.5
CN4202900000000	42	029	Chester County, PA	1991	NA	207942	198033	9909	4.8
CN4203100000000	42	031	Clarion County, PA	1991	NA	18194	16541	1653	9.1
CN4203300000000	42	033	Clearfield County, PA	1991	NA	35813	31516	4297	12
CN4203500000000	42	035	Clinton County, PA	1991	NA	17360	15395	1965	11.3
CN4203700000000	42	037	Columbia County, PA	1991	NA	31915	29068	2847	8.9
CN4203900000000	42	039	Crawford County, PA	1991	NA	40414	36602	3812	9.4
CN4204100000000	42	041	Cumberland County, PA	1991	NA	110963	106146	4817	4.3
CN4204300000000	42	043	Dauphin County, PA	1991	NA	131256	124384	6872	5.2
CN4204500000000	42	045	Delaware County, PA	1991	NA	278071	261593	16478	5.9
CN4204700000000	42	047	Elk County, PA	1991	NA	16797	15203	1594	9.5
CN4204900000000	42	049	Erie County, PA	1991	NA	136056	126121	9935	7.3
CN4205100000000	42	051	Fayette County, PA	1991	NA	55989	50355	5634	10.1
CN4205300000000	42	053	Forest County, PA	1991	NA	2035	1796	239	11.7
CN4205500000000	42	055	Franklin County, PA	1991	NA	62305	58398	3907	6.3
CN4205700000000	42	057	Fulton County, PA	1991	NA	6571	6000	571	8.7
CN4205900000000	42	059	Greene County, PA	1991	NA	15630	13922	1708	10.9
CN4206100000000	42	061	Huntingdon County, PA	1991	NA	19662	17187	2475	12.6
CN4206300000000	42	063	Indiana County, PA	1991	NA	38950	35236	3714	9.5
CN4206500000000	42	065	Jefferson County, PA	1991	NA	20784	18822	1962	9.4
CN4206700000000	42	067	Juniata County, PA	1991	NA	10519	9473	1046	9.9
CN4206900000000	42	069	Lackawanna County, PA	1991	NA	106200	97257	8943	8.4
CN4207100000000	42	071	Lancaster County, PA	1991	NA	225402	214848	10554	4.7
CN4207300000000	42	073	Lawrence County, PA	1991	NA	41383	37510	3873	9.4
CN4207500000000	42	075	Lebanon County, PA	1991	NA	62269	58722	3547	5.7
CN4207700000000	42	077	Lehigh County, PA	1991	NA	154585	144600	9985	6.5
CN4207900000000	42	079	Luzerne County, PA	1991	NA	158125	143542	14583	9.2
CN4208100000000	42	081	Lycoming County, PA	1991	NA	57530	52700	4830	8.4
CN4208300000000	42	083	McKean County, PA	1991	NA	20846	19149	1697	8.1
CN4208500000000	42	085	Mercer County, PA	1991	NA	55215	51112	4103	7.4
CN4208700000000	42	087	Mifflin County, PA	1991	NA	22832	20701	2131	9.3
CN4208900000000	42	089	Monroe County, PA	1991	NA	48865	44060	4805	9.8
CN4209100000000	42	091	Montgomery County, PA	1991	NA	376033	355380	20653	5.5
CN4209300000000	42	093	Montour County, PA	1991	NA	8674	8190	484	5.6
CN4209500000000	42	095	Northampton County, PA	1991	NA	126391	118275	8116	6.4
CN4209700000000	42	097	Northumberland County, PA	1991	NA	45387	40794	4593	10.1
CN4209900000000	42	099	Perry County, PA	1991	NA	22367	20932	1435	6.4
CN4210100000000	42	101	Philadelphia County/city, PA	1991	NA	693145	631369	61776	8.9
CN4210300000000	42	103	Pike County, PA	1991	NA	14835	13611	1224	8.3
CN4210500000000	42	105	Potter County, PA	1991	NA	7854	7161	693	8.8
CN4210700000000	42	107	Schuylkill County, PA	1991	NA	69678	62718	6960	10
CN4210900000000	42	109	Snyder County, PA	1991	NA	18366	16981	1385	7.5
CN4211100000000	42	111	Somerset County, PA	1991	NA	35940	32658	3282	9.1
CN4211300000000	42	113	Sullivan County, PA	1991	NA	2603	2270	333	12.8
CN4211500000000	42	115	Susquehanna County, PA	1991	NA	18228	16642	1586	8.7
CN4211700000000	42	117	Tioga County, PA	1991	NA	18805	17248	1557	8.3
CN4211900000000	42	119	Union County, PA	1991	NA	16742	15446	1296	7.7
CN4212100000000	42	121	Venango County, PA	1991	NA	25503	23371	2132	8.4
CN4212300000000	42	123	Warren County, PA	1991	NA	22615	21107	1508	6.7
CN4212500000000	42	125	Washington County, PA	1991	NA	92124	85540	6584	7.1
CN4212700000000	42	127	Wayne County, PA	1991	NA	19567	17579	1988	10.2
CN4212900000000	42	129	Westmoreland County, PA	1991	NA	174461	162185	12276	7
CN4213100000000	42	131	Wyoming County, PA	1991	NA	14027	12821	1206	8.6
CN4213300000000	42	133	York County, PA	1991	NA	187754	177326	10428	5.6
CN4400100000000	44	001	Bristol County, RI	1991	NA	26060	23867	2193	8.4
CN4400300000000	44	003	Kent County, RI	1991	NA	88230	80749	7481	8.5
CN4400500000000	44	005	Newport County, RI	1991	NA	42281	38787	3494	8.3
CN4400700000000	44	007	Providence County, RI	1991	NA	302593	275080	27513	9.1
CN4400900000000	44	009	Washington County, RI	1991	NA	58853	55167	3686	6.3
CN4500100000000	45	001	Abbeville County, SC	1991	NA	11783	10829	954	8.1
CN4500300000000	45	003	Aiken County, SC	1991	NA	62030	58522	3508	5.7
CN4500500000000	45	005	Allendale County, SC	1991	NA	4795	4286	509	10.6
CN4500700000000	45	007	Anderson County, SC	1991	NA	76009	71379	4630	6.1
CN4500900000000	45	009	Bamberg County, SC	1991	NA	7659	6813	846	11
CN4501100000000	45	011	Barnwell County, SC	1991	NA	10043	8658	1385	13.8
CN4501300000000	45	013	Beaufort County, SC	1991	NA	36764	35270	1494	4.1
CN4501500000000	45	015	Berkeley County, SC	1991	NA	57383	55044	2339	4.1
CN4501700000000	45	017	Calhoun County, SC	1991	NA	6124	5690	434	7.1
CN4501900000000	45	019	Charleston County, SC	1991	NA	145054	138891	6163	4.2
CN4502100000000	45	021	Cherokee County, SC	1991	NA	23030	21577	1453	6.3
CN4502300000000	45	023	Chester County, SC	1991	NA	15959	13895	2064	12.9
CN4502500000000	45	025	Chesterfield County, SC	1991	NA	19048	17837	1211	6.4
CN4502700000000	45	027	Clarendon County, SC	1991	NA	11719	10429	1290	11
CN4502900000000	45	029	Colleton County, SC	1991	NA	15410	13845	1565	10.2
CN4503100000000	45	031	Darlington County, SC	1991	NA	30535	28234	2301	7.5
CN4503300000000	45	033	Dillon County, SC	1991	NA	13099	11650	1449	11.1
CN4503500000000	45	035	Dorchester County, SC	1991	NA	40046	38423	1623	4.1
CN4503700000000	45	037	Edgefield County, SC	1991	NA	9015	8555	460	5.1
CN4503900000000	45	039	Fairfield County, SC	1991	NA	10720	9440	1280	11.9
CN4504100000000	45	041	Florence County, SC	1991	NA	57669	54236	3433	6
CN4504300000000	45	043	Georgetown County, SC	1991	NA	21896	19857	2039	9.3
CN4504500000000	45	045	Greenville County, SC	1991	NA	173601	165006	8595	5
CN4504700000000	45	047	Greenwood County, SC	1991	NA	30285	28186	2099	6.9
CN4504900000000	45	049	Hampton County, SC	1991	NA	7609	6977	632	8.3
CN4505100000000	45	051	Horry County, SC	1991	NA	77011	71436	5575	7.2
CN4505300000000	45	053	Jasper County, SC	1991	NA	6607	6308	299	4.5
CN4505500000000	45	055	Kershaw County, SC	1991	NA	23077	21190	1887	8.2
CN4505700000000	45	057	Lancaster County, SC	1991	NA	28938	26558	2380	8.2
CN4505900000000	45	059	Laurens County, SC	1991	NA	29238	27537	1701	5.8
CN4506100000000	45	061	Lee County, SC	1991	NA	7985	7392	593	7.4
CN4506300000000	45	063	Lexington County, SC	1991	NA	97559	93604	3955	4.1
CN4506500000000	45	065	McCormick County, SC	1991	NA	3689	3253	436	11.8
CN4506700000000	45	067	Marion County, SC	1991	NA	16698	14587	2111	12.6
CN4506900000000	45	069	Marlboro County, SC	1991	NA	12853	11437	1416	11
CN4507100000000	45	071	Newberry County, SC	1991	NA	16867	15995	872	5.2
CN4507300000000	45	073	Oconee County, SC	1991	NA	29064	26770	2294	7.9
CN4507500000000	45	075	Orangeburg County, SC	1991	NA	39500	35891	3609	9.1
CN4507700000000	45	077	Pickens County, SC	1991	NA	50122	47385	2737	5.5
CN4507900000000	45	079	Richland County, SC	1991	NA	147988	141317	6671	4.5
CN4508100000000	45	081	Saluda County, SC	1991	NA	8289	7874	415	5
CN4508300000000	45	083	Spartanburg County, SC	1991	NA	120205	113845	6360	5.3
CN4508500000000	45	085	Sumter County, SC	1991	NA	41715	37908	3807	9.1
CN4508700000000	45	087	Union County, SC	1991	NA	15295	13878	1417	9.3
CN4508900000000	45	089	Williamsburg County, SC	1991	NA	15836	14256	1580	10
CN4509100000000	45	091	York County, SC	1991	NA	72959	69038	3921	5.4
CN4600300000000	46	003	Aurora County, SD	1991	NA	1312	1273	39	3
CN4600500000000	46	005	Beadle County, SD	1991	NA	8803	8429	374	4.2
CN4600700000000	46	007	Bennett County, SD	1991	NA	1167	1110	57	4.9
CN4600900000000	46	009	Bon Homme County, SD	1991	NA	3095	3008	87	2.8
CN4601100000000	46	011	Brookings County, SD	1991	NA	14121	13702	419	3
CN4601300000000	46	013	Brown County, SD	1991	NA	19310	18710	600	3.1
CN4601500000000	46	015	Brule County, SD	1991	NA	2692	2612	80	3
CN4601700000000	46	017	Buffalo County, SD	1991	NA	583	530	53	9.1
CN4601900000000	46	019	Butte County, SD	1991	NA	3587	3455	132	3.7
CN4602100000000	46	021	Campbell County, SD	1991	NA	929	887	42	4.5
CN4602300000000	46	023	Charles Mix County, SD	1991	NA	3883	3726	157	4
CN4602500000000	46	025	Clark County, SD	1991	NA	1903	1832	71	3.7
CN4602700000000	46	027	Clay County, SD	1991	NA	6743	6559	184	2.7
CN4602900000000	46	029	Codington County, SD	1991	NA	12034	11558	476	4
CN4603100000000	46	031	Corson County, SD	1991	NA	1519	1195	324	21.3
CN4603300000000	46	033	Custer County, SD	1991	NA	3545	3402	143	4
CN4603500000000	46	035	Davison County, SD	1991	NA	8798	8583	215	2.4
CN4603700000000	46	037	Day County, SD	1991	NA	3006	2849	157	5.2
CN4603900000000	46	039	Deuel County, SD	1991	NA	2110	2037	73	3.5
CN4604100000000	46	041	Dewey County, SD	1991	NA	2087	1813	274	13.1
CN4604300000000	46	043	Douglas County, SD	1991	NA	1550	1510	40	2.6
CN4604500000000	46	045	Edmunds County, SD	1991	NA	2051	2007	44	2.1
CN4604700000000	46	047	Fall River County, SD	1991	NA	3156	3003	153	4.8
CN4604900000000	46	049	Faulk County, SD	1991	NA	1232	1206	26	2.1
CN4605100000000	46	051	Grant County, SD	1991	NA	4169	3971	198	4.7
CN4605300000000	46	053	Gregory County, SD	1991	NA	2417	2361	56	2.3
CN4605500000000	46	055	Haakon County, SD	1991	NA	1154	1114	40	3.5
CN4605700000000	46	057	Hamlin County, SD	1991	NA	2160	2077	83	3.8
CN4605900000000	46	059	Hand County, SD	1991	NA	2031	1969	62	3.1
CN4606100000000	46	061	Hanson County, SD	1991	NA	1506	1473	33	2.2
CN4606300000000	46	063	Harding County, SD	1991	NA	797	775	22	2.8
CN4606500000000	46	065	Hughes County, SD	1991	NA	8480	8243	237	2.8
CN4606700000000	46	067	Hutchinson County, SD	1991	NA	3965	3872	93	2.3
CN4606900000000	46	069	Hyde County, SD	1991	NA	794	775	19	2.4
CN4607100000000	46	071	Jackson County, SD	1991	NA	1190	1142	48	4
CN4607300000000	46	073	Jerauld County, SD	1991	NA	1055	1027	28	2.7
CN4607500000000	46	075	Jones County, SD	1991	NA	754	721	33	4.4
CN4607700000000	46	077	Kingsbury County, SD	1991	NA	2702	2635	67	2.5
CN4607900000000	46	079	Lake County, SD	1991	NA	5523	5340	183	3.3
CN4608100000000	46	081	Lawrence County, SD	1991	NA	12048	11660	388	3.2
CN4608300000000	46	083	Lincoln County, SD	1991	NA	8464	8285	179	2.1
CN4608500000000	46	085	Lyman County, SD	1991	NA	1887	1782	105	5.6
CN4608700000000	46	087	McCook County, SD	1991	NA	2697	2613	84	3.1
CN4608900000000	46	089	McPherson County, SD	1991	NA	1446	1412	34	2.4
CN4609100000000	46	091	Marshall County, SD	1991	NA	2158	2094	64	3
CN4609300000000	46	093	Meade County, SD	1991	NA	10352	9938	414	4
CN4609500000000	46	095	Mellette County, SD	1991	NA	758	715	43	5.7
CN4609700000000	46	097	Miner County, SD	1991	NA	1509	1475	34	2.3
CN4609900000000	46	099	Minnehaha County, SD	1991	NA	72562	70776	1786	2.5
CN4610100000000	46	101	Moody County, SD	1991	NA	3500	3316	184	5.3
CN4610200000000	46	102	Oglala Lakota County, SD	1991	NA	2273	1909	364	16
CN4610300000000	46	103	Pennington County, SD	1991	NA	40603	39117	1486	3.7
CN4610500000000	46	105	Perkins County, SD	1991	NA	2078	2028	50	2.4
CN4610700000000	46	107	Potter County, SD	1991	NA	1482	1440	42	2.8
CN4610900000000	46	109	Roberts County, SD	1991	NA	4542	4281	261	5.7
CN4611100000000	46	111	Sanborn County, SD	1991	NA	1249	1208	41	3.3
CN4611500000000	46	115	Spink County, SD	1991	NA	3510	3402	108	3.1
CN4611700000000	46	117	Stanley County, SD	1991	NA	1419	1368	51	3.6
CN4611900000000	46	119	Sully County, SD	1991	NA	888	863	25	2.8
CN4612100000000	46	121	Todd County, SD	1991	NA	2382	2150	232	9.7
CN4612300000000	46	123	Tripp County, SD	1991	NA	3294	3194	100	3
CN4612500000000	46	125	Turner County, SD	1991	NA	4021	3915	106	2.6
CN4612700000000	46	127	Union County, SD	1991	NA	3476	3234	242	7
CN4612900000000	46	129	Walworth County, SD	1991	NA	2936	2847	89	3
CN4613500000000	46	135	Yankton County, SD	1991	NA	9814	9559	255	2.6
CN4613700000000	46	137	Ziebach County, SD	1991	NA	749	691	58	7.7
CN4700100000000	47	001	Anderson County, TN	1991	NA	33190	31501	1689	5.1
CN4700300000000	47	003	Bedford County, TN	1991	NA	15236	13911	1325	8.7
CN4700500000000	47	005	Benton County, TN	1991	NA	7122	6438	684	9.6
CN4700700000000	47	007	Bledsoe County, TN	1991	NA	3667	3272	395	10.8
CN4700900000000	47	009	Blount County, TN	1991	NA	42919	40299	2620	6.1
CN4701100000000	47	011	Bradley County, TN	1991	NA	38697	35826	2871	7.4
CN4701300000000	47	013	Campbell County, TN	1991	NA	13795	11457	2338	16.9
CN4701500000000	47	015	Cannon County, TN	1991	NA	5571	5221	350	6.3
CN4701700000000	47	017	Carroll County, TN	1991	NA	12923	11848	1075	8.3
CN4701900000000	47	019	Carter County, TN	1991	NA	24406	22785	1621	6.6
CN4702100000000	47	021	Cheatham County, TN	1991	NA	14263	13545	718	5
CN4702300000000	47	023	Chester County, TN	1991	NA	5838	5462	376	6.4
CN4702500000000	47	025	Claiborne County, TN	1991	NA	10342	9397	945	9.1
CN4702700000000	47	027	Clay County, TN	1991	NA	3467	3231	236	6.8
CN4702900000000	47	029	Cocke County, TN	1991	NA	14207	12309	1898	13.4
CN4703100000000	47	031	Coffee County, TN	1991	NA	19166	17786	1380	7.2
CN4703300000000	47	033	Crockett County, TN	1991	NA	6724	6293	431	6.4
CN4703500000000	47	035	Cumberland County, TN	1991	NA	15874	14406	1468	9.2
CN4703700000000	47	037	Davidson County, TN	1991	NA	272808	259701	13107	4.8
CN4703900000000	47	039	Decatur County, TN	1991	NA	4799	4201	598	12.5
CN4704100000000	47	041	DeKalb County, TN	1991	NA	7592	7038	554	7.3
CN4704300000000	47	043	Dickson County, TN	1991	NA	17221	16040	1181	6.9
CN4704500000000	47	045	Dyer County, TN	1991	NA	16653	15280	1373	8.2
CN4704700000000	47	047	Fayette County, TN	1991	NA	11244	10488	756	6.7
CN4704900000000	47	049	Fentress County, TN	1991	NA	6648	6009	639	9.6
CN4705100000000	47	051	Franklin County, TN	1991	NA	16014	15009	1005	6.3
CN4705300000000	47	053	Gibson County, TN	1991	NA	21917	19966	1951	8.9
CN4705500000000	47	055	Giles County, TN	1991	NA	13005	12041	964	7.4
CN4705700000000	47	057	Grainger County, TN	1991	NA	8215	7442	773	9.4
CN4705900000000	47	059	Greene County, TN	1991	NA	27366	24010	3356	12.3
CN4706100000000	47	061	Grundy County, TN	1991	NA	5423	4771	652	12
CN4706300000000	47	063	Hamblen County, TN	1991	NA	26308	23765	2543	9.7
CN4706500000000	47	065	Hamilton County, TN	1991	NA	142013	133499	8514	6
CN4706700000000	47	067	Hancock County, TN	1991	NA	2245	2066	179	8
CN4706900000000	47	069	Hardeman County, TN	1991	NA	9590	8788	802	8.4
CN4707100000000	47	071	Hardin County, TN	1991	NA	10875	9830	1045	9.6
CN4707300000000	47	073	Hawkins County, TN	1991	NA	21021	19758	1263	6
CN4707500000000	47	075	Haywood County, TN	1991	NA	8212	7291	921	11.2
CN4707700000000	47	077	Henderson County, TN	1991	NA	11048	9926	1122	10.2
CN4707900000000	47	079	Henry County, TN	1991	NA	12168	11267	901	7.4
CN4708100000000	47	081	Hickman County, TN	1991	NA	7970	7243	727	9.1
CN4708300000000	47	083	Houston County, TN	1991	NA	3156	2809	347	11
CN4708500000000	47	085	Humphreys County, TN	1991	NA	6849	6042	807	11.8
CN4708700000000	47	087	Jackson County, TN	1991	NA	4077	3729	348	8.5
CN4708900000000	47	089	Jefferson County, TN	1991	NA	16937	15322	1615	9.5
CN4709100000000	47	091	Johnson County, TN	1991	NA	6664	6168	496	7.4
CN4709300000000	47	093	Knox County, TN	1991	NA	175849	167932	7917	4.5
CN4709500000000	47	095	Lake County, TN	1991	NA	2563	2359	204	8
CN4709700000000	47	097	Lauderdale County, TN	1991	NA	9391	8393	998	10.6
CN4709900000000	47	099	Lawrence County, TN	1991	NA	18187	16514	1673	9.2
CN4710100000000	47	101	Lewis County, TN	1991	NA	4317	3934	383	8.9
CN4710300000000	47	103	Lincoln County, TN	1991	NA	14127	12785	1342	9.5
CN4710500000000	47	105	Loudon County, TN	1991	NA	16512	15348	1164	7
CN4710700000000	47	107	McMinn County, TN	1991	NA	20378	18296	2082	10.2
CN4710900000000	47	109	McNairy County, TN	1991	NA	10649	9682	967	9.1
CN4711100000000	47	111	Macon County, TN	1991	NA	8556	7800	756	8.8
CN4711300000000	47	113	Madison County, TN	1991	NA	39540	37222	2318	5.9
CN4711500000000	47	115	Marion County, TN	1991	NA	11596	10575	1021	8.8
CN4711700000000	47	117	Marshall County, TN	1991	NA	10827	9900	927	8.6
CN4711900000000	47	119	Maury County, TN	1991	NA	30800	27793	3007	9.8
CN4712100000000	47	121	Meigs County, TN	1991	NA	3902	3398	504	12.9
CN4712300000000	47	123	Monroe County, TN	1991	NA	13979	12009	1970	14.1
CN4712500000000	47	125	Montgomery County, TN	1991	NA	41239	38460	2779	6.7
CN4712700000000	47	127	Moore County, TN	1991	NA	2596	2438	158	6.1
CN4712900000000	47	129	Morgan County, TN	1991	NA	6958	6347	611	8.8
CN4713100000000	47	131	Obion County, TN	1991	NA	14486	12973	1513	10.4
CN4713300000000	47	133	Overton County, TN	1991	NA	8573	7687	886	10.3
CN4713500000000	47	135	Perry County, TN	1991	NA	2973	2655	318	10.7
CN4713700000000	47	137	Pickett County, TN	1991	NA	1935	1831	104	5.4
CN4713900000000	47	139	Polk County, TN	1991	NA	6444	5729	715	11.1
CN4714100000000	47	141	Putnam County, TN	1991	NA	26171	24003	2168	8.3
CN4714300000000	47	143	Rhea County, TN	1991	NA	11072	9769	1303	11.8
CN4714500000000	47	145	Roane County, TN	1991	NA	20182	18523	1659	8.2
CN4714700000000	47	147	Robertson County, TN	1991	NA	21710	20054	1656	7.6
CN4714900000000	47	149	Rutherford County, TN	1991	NA	65803	62422	3381	5.1
CN4715100000000	47	151	Scott County, TN	1991	NA	7720	6620	1100	14.2
CN4715300000000	47	153	Sequatchie County, TN	1991	NA	4536	4202	334	7.4
CN4715500000000	47	155	Sevier County, TN	1991	NA	28169	25525	2644	9.4
CN4715700000000	47	157	Shelby County, TN	1991	NA	396182	374207	21975	5.5
CN4715900000000	47	159	Smith County, TN	1991	NA	6999	6467	532	7.6
CN4716100000000	47	161	Stewart County, TN	1991	NA	5020	4616	404	8
CN4716300000000	47	163	Sullivan County, TN	1991	NA	69927	66517	3410	4.9
CN4716500000000	47	165	Sumner County, TN	1991	NA	55114	51404	3710	6.7
CN4716700000000	47	167	Tipton County, TN	1991	NA	17075	15877	1198	7
CN4716900000000	47	169	Trousdale County, TN	1991	NA	2834	2520	314	11.1
CN4717100000000	47	171	Unicoi County, TN	1991	NA	7821	6903	918	11.7
CN4717300000000	47	173	Union County, TN	1991	NA	6465	6034	431	6.7
CN4717500000000	47	175	Van Buren County, TN	1991	NA	2231	2010	221	9.9
CN4717700000000	47	177	Warren County, TN	1991	NA	17209	15666	1543	9
CN4717900000000	47	179	Washington County, TN	1991	NA	46756	44160	2596	5.6
CN4718100000000	47	181	Wayne County, TN	1991	NA	6956	6307	649	9.3
CN4718300000000	47	183	Weakley County, TN	1991	NA	16155	15092	1063	6.6
CN4718500000000	47	185	White County, TN	1991	NA	9521	8568	953	10
CN4718700000000	47	187	Williamson County, TN	1991	NA	43853	42328	1525	3.5
CN4718900000000	47	189	Wilson County, TN	1991	NA	36420	34267	2153	5.9
CN4800100000000	48	001	Anderson County, TX	1991	NA	18294	17093	1201	6.6
CN4800300000000	48	003	Andrews County, TX	1991	NA	6351	6067	284	4.5
CN4800500000000	48	005	Angelina County, TX	1991	NA	32586	30201	2385	7.3
CN4800700000000	48	007	Aransas County, TX	1991	NA	7665	7380	285	3.7
CN4800900000000	48	009	Archer County, TX	1991	NA	3750	3603	147	3.9
CN4801100000000	48	011	Armstrong County, TX	1991	NA	1047	1012	35	3.3
CN4801300000000	48	013	Atascosa County, TX	1991	NA	13737	12755	982	7.1
CN4801500000000	48	015	Austin County, TX	1991	NA	9641	9304	337	3.5
CN4801700000000	48	017	Bailey County, TX	1991	NA	3796	3615	181	4.8
CN4801900000000	48	019	Bandera County, TX	1991	NA	6122	5991	131	2.1
CN4802100000000	48	021	Bastrop County, TX	1991	NA	18682	17886	796	4.3
CN4802300000000	48	023	Baylor County, TX	1991	NA	1898	1777	121	6.4
CN4802500000000	48	025	Bee County, TX	1991	NA	9311	8626	685	7.4
CN4802700000000	48	027	Bell County, TX	1991	NA	76152	71011	5141	6.8
CN4802900000000	48	029	Bexar County, TX	1991	NA	567358	528464	38894	6.9
CN4803100000000	48	031	Blanco County, TX	1991	NA	2933	2847	86	2.9
CN4803300000000	48	033	Borden County, TX	1991	NA	395	375	20	5.1
CN4803500000000	48	035	Bosque County, TX	1991	NA	5901	5405	496	8.4
CN4803700000000	48	037	Bowie County, TX	1991	NA	38147	34854	3293	8.6
CN4803900000000	48	039	Brazoria County, TX	1991	NA	102720	97748	4972	4.8
CN4804100000000	48	041	Brazos County, TX	1991	NA	62309	60154	2155	3.5
CN4804300000000	48	043	Brewster County, TX	1991	NA	4074	3941	133	3.3
CN4804500000000	48	045	Briscoe County, TX	1991	NA	925	902	23	2.5
CN4804700000000	48	047	Brooks County, TX	1991	NA	2928	2631	297	10.1
CN4804900000000	48	049	Brown County, TX	1991	NA	15567	14289	1278	8.2
CN4805100000000	48	051	Burleson County, TX	1991	NA	6550	6253	297	4.5
CN4805300000000	48	053	Burnet County, TX	1991	NA	9539	9026	513	5.4
CN4805500000000	48	055	Caldwell County, TX	1991	NA	11837	11214	623	5.3
CN4805700000000	48	057	Calhoun County, TX	1991	NA	8960	8393	567	6.3
CN4805900000000	48	059	Callahan County, TX	1991	NA	5512	5240	272	4.9
CN4806100000000	48	061	Cameron County, TX	1991	NA	109324	92942	16382	15
CN4806300000000	48	063	Camp County, TX	1991	NA	4829	4360	469	9.7
CN4806500000000	48	065	Carson County, TX	1991	NA	3138	3005	133	4.2
CN4806700000000	48	067	Cass County, TX	1991	NA	14633	13081	1552	10.6
CN4806900000000	48	069	Castro County, TX	1991	NA	4181	3967	214	5.1
CN4807100000000	48	071	Chambers County, TX	1991	NA	9902	9443	459	4.6
CN4807300000000	48	073	Cherokee County, TX	1991	NA	18889	17617	1272	6.7
CN4807500000000	48	075	Childress County, TX	1991	NA	2701	2551	150	5.6
CN4807700000000	48	077	Clay County, TX	1991	NA	4721	4525	196	4.2
CN4807900000000	48	079	Cochran County, TX	1991	NA	1987	1897	90	4.5
CN4808100000000	48	081	Coke County, TX	1991	NA	1361	1329	32	2.4
CN4808300000000	48	083	Coleman County, TX	1991	NA	3663	3394	269	7.3
CN4808500000000	48	085	Collin County, TX	1991	NA	166485	158397	8088	4.9
CN4808700000000	48	087	Collingsworth County, TX	1991	NA	1818	1735	83	4.6
CN4808900000000	48	089	Colorado County, TX	1991	NA	8112	7870	242	3
CN4809100000000	48	091	Comal County, TX	1991	NA	26425	24896	1529	5.8
CN4809300000000	48	093	Comanche County, TX	1991	NA	5992	5708	284	4.7
CN4809500000000	48	095	Concho County, TX	1991	NA	1445	1409	36	2.5
CN4809700000000	48	097	Cooke County, TX	1991	NA	15129	14233	896	5.9
CN4809900000000	48	099	Coryell County, TX	1991	NA	17086	15875	1211	7.1
CN4810100000000	48	101	Cottle County, TX	1991	NA	939	896	43	4.6
CN4810300000000	48	103	Crane County, TX	1991	NA	2332	2232	100	4.3
CN4810500000000	48	105	Crockett County, TX	1991	NA	1842	1740	102	5.5
CN4810700000000	48	107	Crosby County, TX	1991	NA	3310	3155	155	4.7
CN4810900000000	48	109	Culberson County, TX	1991	NA	1577	1464	113	7.2
CN4811100000000	48	111	Dallam County, TX	1991	NA	2664	2585	79	3
CN4811300000000	48	113	Dallas County, TX	1991	NA	1080986	1011500	69486	6.4
CN4811500000000	48	115	Dawson County, TX	1991	NA	5799	5415	384	6.6
CN4811700000000	48	117	Deaf Smith County, TX	1991	NA	9013	8397	616	6.8
CN4811900000000	48	119	Delta County, TX	1991	NA	2047	1908	139	6.8
CN4812100000000	48	121	Denton County, TX	1991	NA	172941	164552	8389	4.9
CN4812300000000	48	123	DeWitt County, TX	1991	NA	7718	7386	332	4.3
CN4812500000000	48	125	Dickens County, TX	1991	NA	1051	999	52	4.9
CN4812700000000	48	127	Dimmit County, TX	1991	NA	4174	3585	589	14.1
CN4812900000000	48	129	Donley County, TX	1991	NA	1558	1487	71	4.6
CN4813100000000	48	131	Duval County, TX	1991	NA	4312	3841	471	10.9
CN4813300000000	48	133	Eastland County, TX	1991	NA	7977	7384	593	7.4
CN4813500000000	48	135	Ector County, TX	1991	NA	57900	54296	3604	6.2
CN4813700000000	48	137	Edwards County, TX	1991	NA	955	888	67	7
CN4813900000000	48	139	Ellis County, TX	1991	NA	44231	41266	2965	6.7
CN4814100000000	48	141	El Paso County, TX	1991	NA	263149	231548	31601	12
CN4814300000000	48	143	Erath County, TX	1991	NA	14285	13613	672	4.7
CN4814500000000	48	145	Falls County, TX	1991	NA	7227	6852	375	5.2
CN4814700000000	48	147	Fannin County, TX	1991	NA	11193	10280	913	8.2
CN4814900000000	48	149	Fayette County, TX	1991	NA	10042	9809	233	2.3
CN4815100000000	48	151	Fisher County, TX	1991	NA	1997	1879	118	5.9
CN4815300000000	48	153	Floyd County, TX	1991	NA	3913	3685	228	5.8
CN4815500000000	48	155	Foard County, TX	1991	NA	917	904	13	1.4
CN4815700000000	48	157	Fort Bend County, TX	1991	NA	128335	123576	4759	3.7
CN4815900000000	48	159	Franklin County, TX	1991	NA	3550	3292	258	7.3
CN4816100000000	48	161	Freestone County, TX	1991	NA	7098	6678	420	5.9
CN4816300000000	48	163	Frio County, TX	1991	NA	7240	6630	610	8.4
CN4816500000000	48	165	Gaines County, TX	1991	NA	6796	6563	233	3.4
CN4816700000000	48	167	Galveston County, TX	1991	NA	116006	107404	8602	7.4
CN4816900000000	48	169	Garza County, TX	1991	NA	2271	2178	93	4.1
CN4817100000000	48	171	Gillespie County, TX	1991	NA	8791	8625	166	1.9
CN4817300000000	48	173	Glasscock County, TX	1991	NA	690	677	13	1.9
CN4817500000000	48	175	Goliad County, TX	1991	NA	2669	2537	132	4.9
CN4817700000000	48	177	Gonzales County, TX	1991	NA	7947	7631	316	4
CN4817900000000	48	179	Gray County, TX	1991	NA	11049	10488	561	5.1
CN4818100000000	48	181	Grayson County, TX	1991	NA	46321	42973	3348	7.2
CN4818300000000	48	183	Gregg County, TX	1991	NA	54827	49824	5003	9.1
CN4818500000000	48	185	Grimes County, TX	1991	NA	8082	7711	371	4.6
CN4818700000000	48	187	Guadalupe County, TX	1991	NA	32382	30981	1401	4.3
CN4818900000000	48	189	Hale County, TX	1991	NA	17179	16267	912	5.3
CN4819100000000	48	191	Hall County, TX	1991	NA	1954	1832	122	6.2
CN4819300000000	48	193	Hamilton County, TX	1991	NA	3462	3339	123	3.6
CN4819500000000	48	195	Hansford County, TX	1991	NA	2827	2721	106	3.7
CN4819700000000	48	197	Hardeman County, TX	1991	NA	2110	2020	90	4.3
CN4819900000000	48	199	Hardin County, TX	1991	NA	20451	19100	1351	6.6
CN4820100000000	48	201	Harris County, TX	1991	NA	1581870	1489888	91982	5.8
CN4820300000000	48	203	Harrison County, TX	1991	NA	25943	23701	2242	8.6
CN4820500000000	48	205	Hartley County, TX	1991	NA	1826	1783	43	2.4
CN4820700000000	48	207	Haskell County, TX	1991	NA	2872	2776	96	3.3
CN4820900000000	48	209	Hays County, TX	1991	NA	34464	32939	1525	4.4
CN4821100000000	48	211	Hemphill County, TX	1991	NA	1859	1794	65	3.5
CN4821300000000	48	213	Henderson County, TX	1991	NA	25829	23208	2621	10.1
CN4821500000000	48	215	Hidalgo County, TX	1991	NA	166076	129858	36218	21.8
CN4821700000000	48	217	Hill County, TX	1991	NA	12243	11410	833	6.8
CN4821900000000	48	219	Hockley County, TX	1991	NA	11291	10781	510	4.5
CN4822100000000	48	221	Hood County, TX	1991	NA	13319	12484	835	6.3
CN4822300000000	48	223	Hopkins County, TX	1991	NA	14282	13176	1106	7.7
CN4822500000000	48	225	Houston County, TX	1991	NA	8397	7971	426	5.1
CN4822700000000	48	227	Howard County, TX	1991	NA	13583	12949	634	4.7
CN4822900000000	48	229	Hudspeth County, TX	1991	NA	1134	1106	28	2.5
CN4823100000000	48	231	Hunt County, TX	1991	NA	32028	29596	2432	7.6
CN4823300000000	48	233	Hutchinson County, TX	1991	NA	11263	10618	645	5.7
CN4823500000000	48	235	Irion County, TX	1991	NA	870	837	33	3.8
CN4823700000000	48	237	Jack County, TX	1991	NA	3217	3059	158	4.9
CN4823900000000	48	239	Jackson County, TX	1991	NA	5745	5531	214	3.7
CN4824100000000	48	241	Jasper County, TX	1991	NA	12983	11631	1352	10.4
CN4824300000000	48	243	Jeff Davis County, TX	1991	NA	1029	987	42	4.1
CN4824500000000	48	245	Jefferson County, TX	1991	NA	118301	110178	8123	6.9
CN4824700000000	48	247	Jim Hogg County, TX	1991	NA	2067	1874	193	9.3
CN4824900000000	48	249	Jim Wells County, TX	1991	NA	15358	13834	1524	9.9
CN4825100000000	48	251	Johnson County, TX	1991	NA	49414	46384	3030	6.1
CN4825300000000	48	253	Jones County, TX	1991	NA	8164	7812	352	4.3
CN4825500000000	48	255	Karnes County, TX	1991	NA	5054	4793	261	5.2
CN4825700000000	48	257	Kaufman County, TX	1991	NA	25556	23992	1564	6.1
CN4825900000000	48	259	Kendall County, TX	1991	NA	7862	7655	207	2.6
CN4826100000000	48	261	Kenedy County, TX	1991	NA	211	206	5	2.4
CN4826300000000	48	263	Kent County, TX	1991	NA	486	468	18	3.7
CN4826500000000	48	265	Kerr County, TX	1991	NA	15763	15187	576	3.7
CN4826700000000	48	267	Kimble County, TX	1991	NA	2100	2049	51	2.4
CN4826900000000	48	269	King County, TX	1991	NA	170	164	6	3.5
CN4827100000000	48	271	Kinney County, TX	1991	NA	1122	1047	75	6.7
CN4827300000000	48	273	Kleberg County, TX	1991	NA	12393	11527	866	7
CN4827500000000	48	275	Knox County, TX	1991	NA	2230	2156	74	3.3
CN4827700000000	48	277	Lamar County, TX	1991	NA	20471	18888	1583	7.7
CN4827900000000	48	279	Lamb County, TX	1991	NA	6372	6028	344	5.4
CN4828100000000	48	281	Lampasas County, TX	1991	NA	6189	5788	401	6.5
CN4828300000000	48	283	La Salle County, TX	1991	NA	2377	2186	191	8
CN4828500000000	48	285	Lavaca County, TX	1991	NA	8649	8438	211	2.4
CN4828700000000	48	287	Lee County, TX	1991	NA	6308	6037	271	4.3
CN4828900000000	48	289	Leon County, TX	1991	NA	5006	4646	360	7.2
CN4829100000000	48	291	Liberty County, TX	1991	NA	23737	21641	2096	8.8
CN4829300000000	48	293	Limestone County, TX	1991	NA	9130	8676	454	5
CN4829500000000	48	295	Lipscomb County, TX	1991	NA	1425	1366	59	4.1
CN4829700000000	48	297	Live Oak County, TX	1991	NA	4263	4085	178	4.2
CN4829900000000	48	299	Llano County, TX	1991	NA	4314	4168	146	3.4
CN4830100000000	48	301	Loving County, TX	1991	NA	54	53	1	1.9
CN4830300000000	48	303	Lubbock County, TX	1991	NA	113183	106885	6298	5.6
CN4830500000000	48	305	Lynn County, TX	1991	NA	3014	2910	104	3.5
CN4830700000000	48	307	McCulloch County, TX	1991	NA	3518	3216	302	8.6
CN4830900000000	48	309	McLennan County, TX	1991	NA	93463	86857	6606	7.1
CN4831100000000	48	311	McMullen County, TX	1991	NA	323	316	7	2.2
CN4831300000000	48	313	Madison County, TX	1991	NA	3989	3814	175	4.4
CN4831500000000	48	315	Marion County, TX	1991	NA	3712	3352	360	9.7
CN4831700000000	48	317	Martin County, TX	1991	NA	1888	1849	39	2.1
CN4831900000000	48	319	Mason County, TX	1991	NA	1525	1480	45	3
CN4832100000000	48	321	Matagorda County, TX	1991	NA	17618	15645	1973	11.2
CN4832300000000	48	323	Maverick County, TX	1991	NA	16321	10716	5605	34.3
CN4832500000000	48	325	Medina County, TX	1991	NA	11946	11275	671	5.6
CN4832700000000	48	327	Menard County, TX	1991	NA	954	922	32	3.4
CN4832900000000	48	329	Midland County, TX	1991	NA	56139	53443	2696	4.8
CN4833100000000	48	331	Milam County, TX	1991	NA	9872	9366	506	5.1
CN4833300000000	48	333	Mills County, TX	1991	NA	2053	1990	63	3.1
CN4833500000000	48	335	Mitchell County, TX	1991	NA	3234	2970	264	8.2
CN4833700000000	48	337	Montague County, TX	1991	NA	7742	7291	451	5.8
CN4833900000000	48	339	Montgomery County, TX	1991	NA	97843	92596	5247	5.4
CN4834100000000	48	341	Moore County, TX	1991	NA	8565	8233	332	3.9
CN4834300000000	48	343	Morris County, TX	1991	NA	6060	5304	756	12.5
CN4834500000000	48	345	Motley County, TX	1991	NA	765	741	24	3.1
CN4834700000000	48	347	Nacogdoches County, TX	1991	NA	26331	24735	1596	6.1
CN4834900000000	48	349	Navarro County, TX	1991	NA	18667	17128	1539	8.2
CN4835100000000	48	351	Newton County, TX	1991	NA	5092	4562	530	10.4
CN4835300000000	48	353	Nolan County, TX	1991	NA	7675	7107	568	7.4
CN4835500000000	48	355	Nueces County, TX	1991	NA	138218	126855	11363	8.2
CN4835700000000	48	357	Ochiltree County, TX	1991	NA	4401	4219	182	4.1
CN4835900000000	48	359	Oldham County, TX	1991	NA	1134	1070	64	5.6
CN4836100000000	48	361	Orange County, TX	1991	NA	40577	36877	3700	9.1
CN4836300000000	48	363	Palo Pinto County, TX	1991	NA	11494	10509	985	8.6
CN4836500000000	48	365	Panola County, TX	1991	NA	8133	7331	802	9.9
CN4836700000000	48	367	Parker County, TX	1991	NA	33384	31122	2262	6.8
CN4836900000000	48	369	Parmer County, TX	1991	NA	4249	4097	152	3.6
CN4837100000000	48	371	Pecos County, TX	1991	NA	6554	5996	558	8.5
CN4837300000000	48	373	Polk County, TX	1991	NA	12027	11157	870	7.2
CN4837500000000	48	375	Potter County, TX	1991	NA	47466	44674	2792	5.9
CN4837700000000	48	377	Presidio County, TX	1991	NA	2803	2203	600	21.4
CN4837900000000	48	379	Rains County, TX	1991	NA	3216	3008	208	6.5
CN4838100000000	48	381	Randall County, TX	1991	NA	50682	48823	1859	3.7
CN4838300000000	48	383	Reagan County, TX	1991	NA	1980	1907	73	3.7
CN4838500000000	48	385	Real County, TX	1991	NA	1040	978	62	6
CN4838700000000	48	387	Red River County, TX	1991	NA	5745	5210	535	9.3
CN4838900000000	48	389	Reeves County, TX	1991	NA	6736	6035	701	10.4
CN4839100000000	48	391	Refugio County, TX	1991	NA	3323	3187	136	4.1
CN4839300000000	48	393	Roberts County, TX	1991	NA	540	529	11	2
CN4839500000000	48	395	Robertson County, TX	1991	NA	6324	5854	470	7.4
CN4839700000000	48	397	Rockwall County, TX	1991	NA	15202	14495	707	4.7
CN4839900000000	48	399	Runnels County, TX	1991	NA	5290	5100	190	3.6
CN4840100000000	48	401	Rusk County, TX	1991	NA	21538	19924	1614	7.5
CN4840300000000	48	403	Sabine County, TX	1991	NA	3371	3072	299	8.9
CN4840500000000	48	405	San Augustine County, TX	1991	NA	3277	3072	205	6.3
CN4840700000000	48	407	San Jacinto County, TX	1991	NA	6603	6258	345	5.2
CN4840900000000	48	409	San Patricio County, TX	1991	NA	25627	23176	2451	9.6
CN4841100000000	48	411	San Saba County, TX	1991	NA	2082	1942	140	6.7
CN4841300000000	48	413	Schleicher County, TX	1991	NA	1286	1218	68	5.3
CN4841500000000	48	415	Scurry County, TX	1991	NA	8160	7752	408	5
CN4841700000000	48	417	Shackelford County, TX	1991	NA	1504	1460	44	2.9
CN4841900000000	48	419	Shelby County, TX	1991	NA	9027	8226	801	8.9
CN4842100000000	48	421	Sherman County, TX	1991	NA	1420	1376	44	3.1
CN4842300000000	48	423	Smith County, TX	1991	NA	77197	71965	5232	6.8
CN4842500000000	48	425	Somervell County, TX	1991	NA	3295	3101	194	5.9
CN4842700000000	48	427	Starr County, TX	1991	NA	19500	11836	7664	39.3
CN4842900000000	48	429	Stephens County, TX	1991	NA	3696	3546	150	4.1
CN4843100000000	48	431	Sterling County, TX	1991	NA	672	656	16	2.4
CN4843300000000	48	433	Stonewall County, TX	1991	NA	837	797	40	4.8
CN4843500000000	48	435	Sutton County, TX	1991	NA	2204	2064	140	6.4
CN4843700000000	48	437	Swisher County, TX	1991	NA	3688	3560	128	3.5
CN4843900000000	48	439	Tarrant County, TX	1991	NA	675940	628939	47001	7
CN4844100000000	48	441	Taylor County, TX	1991	NA	55683	52659	3024	5.4
CN4844300000000	48	443	Terrell County, TX	1991	NA	621	602	19	3.1
CN4844500000000	48	445	Terry County, TX	1991	NA	6137	5837	300	4.9
CN4844700000000	48	447	Throckmorton County, TX	1991	NA	926	909	17	1.8
CN4844900000000	48	449	Titus County, TX	1991	NA	11808	10798	1010	8.6
CN4845100000000	48	451	Tom Green County, TX	1991	NA	47023	44679	2344	5
CN4845300000000	48	453	Travis County, TX	1991	NA	343861	327734	16127	4.7
CN4845500000000	48	455	Trinity County, TX	1991	NA	4570	4310	260	5.7
CN4845700000000	48	457	Tyler County, TX	1991	NA	6738	6229	509	7.6
CN4845900000000	48	459	Upshur County, TX	1991	NA	14623	13513	1110	7.6
CN4846100000000	48	461	Upton County, TX	1991	NA	1924	1869	55	2.9
CN4846300000000	48	463	Uvalde County, TX	1991	NA	10590	9380	1210	11.4
CN4846500000000	48	465	Val Verde County, TX	1991	NA	15916	13741	2175	13.7
CN4846700000000	48	467	Van Zandt County, TX	1991	NA	17465	16272	1193	6.8
CN4846900000000	48	469	Victoria County, TX	1991	NA	38691	36951	1740	4.5
CN4847100000000	48	471	Walker County, TX	1991	NA	19861	19170	691	3.5
CN4847300000000	48	473	Waller County, TX	1991	NA	10941	10394	547	5
CN4847500000000	48	475	Ward County, TX	1991	NA	5300	5001	299	5.6
CN4847700000000	48	477	Washington County, TX	1991	NA	13122	12764	358	2.7
CN4847900000000	48	479	Webb County, TX	1991	NA	58345	51817	6528	11.2
CN4848100000000	48	481	Wharton County, TX	1991	NA	18567	17644	923	5
CN4848300000000	48	483	Wheeler County, TX	1991	NA	2673	2556	117	4.4
CN4848500000000	48	485	Wichita County, TX	1991	NA	56579	52586	3993	7.1
CN4848700000000	48	487	Wilbarger County, TX	1991	NA	7190	6775	415	5.8
CN4848900000000	48	489	Willacy County, TX	1991	NA	7096	5813	1283	18.1
CN4849100000000	48	491	Williamson County, TX	1991	NA	81396	78546	2850	3.5
CN4849300000000	48	493	Wilson County, TX	1991	NA	10612	10157	455	4.3
CN4849500000000	48	495	Winkler County, TX	1991	NA	3482	3273	209	6
CN4849700000000	48	497	Wise County, TX	1991	NA	16389	15405	984	6
CN4849900000000	48	499	Wood County, TX	1991	NA	13167	12303	864	6.6
CN4850100000000	48	501	Yoakum County, TX	1991	NA	4134	3985	149	3.6
CN4850300000000	48	503	Young County, TX	1991	NA	8743	8245	498	5.7
CN4850500000000	48	505	Zapata County, TX	1991	NA	3200	2749	451	14.1
CN4850700000000	48	507	Zavala County, TX	1991	NA	4695	3685	1010	21.5
CN4900100000000	49	001	Beaver County, UT	1991	NA	2009	1923	86	4.3
CN4900300000000	49	003	Box Elder County, UT	1991	NA	16225	15579	646	4
CN4900500000000	49	005	Cache County, UT	1991	NA	34535	33350	1185	3.4
CN4900700000000	49	007	Carbon County, UT	1991	NA	8718	8007	711	8.2
CN4900900000000	49	009	Daggett County, UT	1991	NA	393	381	12	3.1
CN4901100000000	49	011	Davis County, UT	1991	NA	90209	86340	3869	4.3
CN4901300000000	49	013	Duchesne County, UT	1991	NA	5187	4787	400	7.7
CN4901500000000	49	015	Emery County, UT	1991	NA	4043	3660	383	9.5
CN4901700000000	49	017	Garfield County, UT	1991	NA	2144	1903	241	11.2
CN4901900000000	49	019	Grand County, UT	1991	NA	3544	3300	244	6.9
CN4902100000000	49	021	Iron County, UT	1991	NA	9568	9076	492	5.1
CN4902300000000	49	023	Juab County, UT	1991	NA	3000	2840	160	5.3
CN4902500000000	49	025	Kane County, UT	1991	NA	2661	2461	200	7.5
CN4902700000000	49	027	Millard County, UT	1991	NA	4699	4457	242	5.2
CN4902900000000	49	029	Morgan County, UT	1991	NA	2595	2461	134	5.2
CN4903100000000	49	031	Piute County, UT	1991	NA	504	454	50	9.9
CN4903300000000	49	033	Rich County, UT	1991	NA	750	730	20	2.7
CN4903500000000	49	035	Salt Lake County, UT	1991	NA	383573	367107	16466	4.3
CN4903700000000	49	037	San Juan County, UT	1991	NA	4160	3717	443	10.6
CN4903900000000	49	039	Sanpete County, UT	1991	NA	6781	6062	719	10.6
CN4904100000000	49	041	Sevier County, UT	1991	NA	6550	6067	483	7.4
CN4904300000000	49	043	Summit County, UT	1991	NA	8513	7916	597	7
CN4904500000000	49	045	Tooele County, UT	1991	NA	12131	11470	661	5.4
CN4904700000000	49	047	Uintah County, UT	1991	NA	9390	8833	557	5.9
CN4904900000000	49	049	Utah County, UT	1991	NA	123864	118402	5462	4.4
CN4905100000000	49	051	Wasatch County, UT	1991	NA	4621	4260	361	7.8
CN4905300000000	49	053	Washington County, UT	1991	NA	21165	20205	960	4.5
CN4905500000000	49	055	Wayne County, UT	1991	NA	966	876	90	9.3
CN4905700000000	49	057	Weber County, UT	1991	NA	79824	75582	4242	5.3
CN5000100000000	50	001	Addison County, VT	1991	NA	18270	17080	1190	6.5
CN5000300000000	50	003	Bennington County, VT	1991	NA	18158	17129	1029	5.7
CN5000500000000	50	005	Caledonia County, VT	1991	NA	14357	13253	1104	7.7
CN5000700000000	50	007	Chittenden County, VT	1991	NA	76546	72781	3765	4.9
CN5000900000000	50	009	Essex County, VT	1991	NA	2771	2501	270	9.7
CN5001100000000	50	011	Franklin County, VT	1991	NA	21101	19502	1599	7.6
CN5001300000000	50	013	Grand Isle County, VT	1991	NA	2874	2634	240	8.4
CN5001500000000	50	015	Lamoille County, VT	1991	NA	10251	9323	928	9.1
CN5001700000000	50	017	Orange County, VT	1991	NA	14166	13239	927	6.5
CN5001900000000	50	019	Orleans County, VT	1991	NA	11972	10679	1293	10.8
CN5002100000000	50	021	Rutland County, VT	1991	NA	31996	29790	2206	6.9
CN5002300000000	50	023	Washington County, VT	1991	NA	29875	27729	2146	7.2
CN5002500000000	50	025	Windham County, VT	1991	NA	22051	20647	1404	6.4
CN5002700000000	50	027	Windsor County, VT	1991	NA	29186	27387	1799	6.2
CN5100100000000	51	001	Accomack County, VA	1991	NA	15489	14387	1102	7.1
CN5100300000000	51	003	Albemarle County, VA	1991	NA	35314	34110	1204	3.4
CN5100500000000	51	005	Alleghany County, VA	1991	NA	8965	8063	902	10.1
CN5100700000000	51	007	Amelia County, VA	1991	NA	4572	4272	300	6.6
CN5100900000000	51	009	Amherst County, VA	1991	NA	14827	13928	899	6.1
CN5101100000000	51	011	Appomattox County, VA	1991	NA	6495	6036	459	7.1
CN5101300000000	51	013	Arlington County, VA	1991	NA	109170	105348	3822	3.5
CN5101500000000	51	015	Augusta County, VA	1991	NA	29864	28127	1737	5.8
CN5101700000000	51	017	Bath County, VA	1991	NA	2759	2434	325	11.8
CN5101900000000	51	019	Bedford County, VA	1991	NA	29349	27751	1598	5.4
CN5102100000000	51	021	Bland County, VA	1991	NA	3616	3381	235	6.5
CN5102300000000	51	023	Botetourt County, VA	1991	NA	14422	13597	825	5.7
CN5102500000000	51	025	Brunswick County, VA	1991	NA	7474	6475	999	13.4
CN5102700000000	51	027	Buchanan County, VA	1991	NA	11887	10089	1798	15.1
CN5102900000000	51	029	Buckingham County, VA	1991	NA	5836	5374	462	7.9
CN5103100000000	51	031	Campbell County, VA	1991	NA	26795	25192	1603	6
CN5103300000000	51	033	Caroline County, VA	1991	NA	10256	9136	1120	10.9
CN5103500000000	51	035	Carroll County, VA	1991	NA	14199	12868	1331	9.4
CN5103600000000	51	036	Charles City County, VA	1991	NA	3503	3196	307	8.8
CN5103700000000	51	037	Charlotte County, VA	1991	NA	5630	5224	406	7.2
CN5104100000000	51	041	Chesterfield County, VA	1991	NA	125829	120241	5588	4.4
CN5104300000000	51	043	Clarke County, VA	1991	NA	6471	6117	354	5.5
CN5104500000000	51	045	Craig County, VA	1991	NA	2397	2213	184	7.7
CN5104700000000	51	047	Culpeper County, VA	1991	NA	14996	13939	1057	7
CN5104900000000	51	049	Cumberland County, VA	1991	NA	4087	3819	268	6.6
CN5105100000000	51	051	Dickenson County, VA	1991	NA	6360	5287	1073	16.9
CN5105300000000	51	053	Dinwiddie County, VA	1991	NA	10807	10031	776	7.2
CN5105700000000	51	057	Essex County, VA	1991	NA	4674	4277	397	8.5
CN5105900000000	51	059	Fairfax County, VA	1991	NA	494334	478675	15659	3.2
CN5106100000000	51	061	Fauquier County, VA	1991	NA	27273	25967	1306	4.8
CN5106300000000	51	063	Floyd County, VA	1991	NA	6439	5752	687	10.7
CN5106500000000	51	065	Fluvanna County, VA	1991	NA	6789	6431	358	5.3
CN5106700000000	51	067	Franklin County, VA	1991	NA	21717	19836	1881	8.7
CN5106900000000	51	069	Frederick County, VA	1991	NA	27345	25262	2083	7.6
CN5107100000000	51	071	Giles County, VA	1991	NA	8588	7686	902	10.5
CN5107300000000	51	073	Gloucester County, VA	1991	NA	15914	15205	709	4.5
CN5107500000000	51	075	Goochland County, VA	1991	NA	7745	7347	398	5.1
CN5107700000000	51	077	Grayson County, VA	1991	NA	8660	7848	812	9.4
CN5107900000000	51	079	Greene County, VA	1991	NA	6118	5643	475	7.8
CN5108100000000	51	081	Greensville County, VA	1991	NA	5225	4792	433	8.3
CN5108300000000	51	083	Halifax County, VA	1991	NA	18678	17043	1635	8.8
CN5108500000000	51	085	Hanover County, VA	1991	NA	37807	36142	1665	4.4
CN5108700000000	51	087	Henrico County, VA	1991	NA	129687	124138	5549	4.3
CN5108900000000	51	089	Henry County, VA	1991	NA	32312	28939	3373	10.4
CN5109100000000	51	091	Highland County, VA	1991	NA	1388	1313	75	5.4
CN5109300000000	51	093	Isle of Wight County, VA	1991	NA	13557	12727	830	6.1
CN5109500000000	51	095	James City County, VA	1991	NA	19999	19322	677	3.4
CN5109700000000	51	097	King and Queen County, VA	1991	NA	3361	3165	196	5.8
CN5109900000000	51	099	King George County, VA	1991	NA	7295	6825	470	6.4
CN5110100000000	51	101	King William County, VA	1991	NA	6432	6110	322	5
CN5110300000000	51	103	Lancaster County, VA	1991	NA	5221	4591	630	12.1
CN5110500000000	51	105	Lee County, VA	1991	NA	9711	8690	1021	10.5
CN5110700000000	51	107	Loudoun County, VA	1991	NA	54617	52728	1889	3.5
CN5110900000000	51	109	Louisa County, VA	1991	NA	10512	9557	955	9.1
CN5111100000000	51	111	Lunenburg County, VA	1991	NA	5528	4477	1051	19
CN5111300000000	51	113	Madison County, VA	1991	NA	6313	6002	311	4.9
CN5111500000000	51	115	Mathews County, VA	1991	NA	4279	4112	167	3.9
CN5111700000000	51	117	Mecklenburg County, VA	1991	NA	14960	13566	1394	9.3
CN5111900000000	51	119	Middlesex County, VA	1991	NA	4208	4043	165	3.9
CN5112100000000	51	121	Montgomery County, VA	1991	NA	37427	34632	2795	7.5
CN5112500000000	51	125	Nelson County, VA	1991	NA	6186	5778	408	6.6
CN5112700000000	51	127	New Kent County, VA	1991	NA	5872	5571	301	5.1
CN5113100000000	51	131	Northampton County, VA	1991	NA	5936	5386	550	9.3
CN5113300000000	51	133	Northumberland County, VA	1991	NA	5174	4618	556	10.7
CN5113500000000	51	135	Nottoway County, VA	1991	NA	6733	6250	483	7.2
CN5113700000000	51	137	Orange County, VA	1991	NA	11083	10141	942	8.5
CN5113900000000	51	139	Page County, VA	1991	NA	11563	10075	1488	12.9
CN5114100000000	51	141	Patrick County, VA	1991	NA	9524	8815	709	7.4
CN5114300000000	51	143	Pittsylvania County, VA	1991	NA	30697	27708	2989	9.7
CN5114500000000	51	145	Powhatan County, VA	1991	NA	8001	7620	381	4.8
CN5114700000000	51	147	Prince Edward County, VA	1991	NA	8303	7424	879	10.6
CN5114900000000	51	149	Prince George County, VA	1991	NA	11453	10883	570	5
CN5115300000000	51	153	Prince William County, VA	1991	NA	121379	116505	4874	4
CN5115500000000	51	155	Pulaski County, VA	1991	NA	18010	15738	2272	12.6
CN5115700000000	51	157	Rappahannock County, VA	1991	NA	4150	3793	357	8.6
CN5115900000000	51	159	Richmond County, VA	1991	NA	3647	3370	277	7.6
CN5116100000000	51	161	Roanoke County, VA	1991	NA	46331	44455	1876	4
CN5116300000000	51	163	Rockbridge County, VA	1991	NA	10205	9373	832	8.2
CN5116500000000	51	165	Rockingham County, VA	1991	NA	33639	31651	1988	5.9
CN5116700000000	51	167	Russell County, VA	1991	NA	12683	11022	1661	13.1
CN5116900000000	51	169	Scott County, VA	1991	NA	9897	9011	886	9
CN5117100000000	51	171	Shenandoah County, VA	1991	NA	17345	16262	1083	6.2
CN5117300000000	51	173	Smyth County, VA	1991	NA	17211	15497	1714	10
CN5117500000000	51	175	Southampton County, VA	1991	NA	7662	7248	414	5.4
CN5117700000000	51	177	Spotsylvania County, VA	1991	NA	32967	31007	1960	5.9
CN5117900000000	51	179	Stafford County, VA	1991	NA	34615	32881	1734	5
CN5118100000000	51	181	Surry County, VA	1991	NA	3250	2950	300	9.2
CN5118300000000	51	183	Sussex County, VA	1991	NA	4916	4405	511	10.4
CN5118500000000	51	185	Tazewell County, VA	1991	NA	19933	17551	2382	12
CN5118700000000	51	187	Warren County, VA	1991	NA	14702	13269	1433	9.7
CN5119100000000	51	191	Washington County, VA	1991	NA	24273	22518	1755	7.2
CN5119300000000	51	193	Westmoreland County, VA	1991	NA	7711	6924	787	10.2
CN5119500000000	51	195	Wise County, VA	1991	NA	16234	14065	2169	13.4
CN5119700000000	51	197	Wythe County, VA	1991	NA	13993	12641	1352	9.7
CN5119900000000	51	199	York County, VA	1991	NA	22100	21256	844	3.8
CN5151000000000	51	510	Alexandria city, VA	1991	NA	75367	71718	3649	4.8
CN5152000000000	51	520	Bristol city, VA	1991	NA	8753	8141	612	7
CN5153000000000	51	530	Buena Vista city, VA	1991	NA	3631	3239	392	10.8
CN5154000000000	51	540	Charlottesville city, VA	1991	NA	20541	19588	953	4.6
CN5155000000000	51	550	Chesapeake city, VA	1991	NA	84966	80324	4642	5.5
CN5157000000000	51	570	Colonial Heights city, VA	1991	NA	8723	8251	472	5.4
CN5158000000000	51	580	Covington city, VA	1991	NA	3432	2991	441	12.8
CN5159000000000	51	590	Danville city, VA	1991	NA	27200	23546	3654	13.4
CN5159500000000	51	595	Emporia city, VA	1991	NA	2673	2389	284	10.6
CN5160000000000	51	600	Fairfax city, VA	1991	NA	12313	12036	277	2.2
CN5161000000000	51	610	Falls Church city, VA	1991	NA	5872	5642	230	3.9
CN5162000000000	51	620	Franklin city, VA	1991	NA	3712	3490	222	6
CN5163000000000	51	630	Fredericksburg city, VA	1991	NA	10798	9923	875	8.1
CN5164000000000	51	640	Galax city, VA	1991	NA	3499	3219	280	8
CN5165000000000	51	650	Hampton city, VA	1991	NA	66963	62923	4040	6
CN5166000000000	51	660	Harrisonburg city, VA	1991	NA	16495	15622	873	5.3
CN5167000000000	51	670	Hopewell city, VA	1991	NA	11581	10539	1042	9
CN5167800000000	51	678	Lexington city, VA	1991	NA	3003	2797	206	6.9
CN5168000000000	51	680	Lynchburg city, VA	1991	NA	32473	30370	2103	6.5
CN5168300000000	51	683	Manassas city, VA	1991	NA	17227	16359	868	5
CN5168500000000	51	685	Manassas Park city, VA	1991	NA	3921	3754	167	4.3
CN5169000000000	51	690	Martinsville city, VA	1991	NA	8384	7253	1131	13.5
CN5170000000000	51	700	Newport News city, VA	1991	NA	82997	78052	4945	6
CN5171000000000	51	710	Norfolk city, VA	1991	NA	96837	90845	5992	6.2
CN5172000000000	51	720	Norton city, VA	1991	NA	1667	1500	167	10
CN5173000000000	51	730	Petersburg city, VA	1991	NA	18417	16521	1896	10.3
CN5173500000000	51	735	Poquoson city, VA	1991	NA	5917	5718	199	3.4
CN5174000000000	51	740	Portsmouth city, VA	1991	NA	47969	44333	3636	7.6
CN5175000000000	51	750	Radford city, VA	1991	NA	7103	6447	656	9.2
CN5176000000000	51	760	Richmond city, VA	1991	NA	104814	96682	8132	7.8
CN5177000000000	51	770	Roanoke city, VA	1991	NA	50452	47094	3358	6.7
CN5177500000000	51	775	Salem city, VA	1991	NA	13304	12582	722	5.4
CN5179000000000	51	790	Staunton city, VA	1991	NA	11691	11093	598	5.1
CN5180000000000	51	800	Suffolk city, VA	1991	NA	25618	24005	1613	6.3
CN5181000000000	51	810	Virginia Beach city, VA	1991	NA	199943	190390	9553	4.8
CN5182000000000	51	820	Waynesboro city, VA	1991	NA	9309	8595	714	7.7
CN5183000000000	51	830	Williamsburg city, VA	1991	NA	5937	5357	580	9.8
CN5184000000000	51	840	Winchester city, VA	1991	NA	12959	11747	1212	9.4
CN5300100000000	53	001	Adams County, WA	1991	NA	8001	6977	1024	12.8
CN5300300000000	53	003	Asotin County, WA	1991	NA	9494	8890	604	6.4
CN5300500000000	53	005	Benton County, WA	1991	NA	62143	57725	4418	7.1
CN5300700000000	53	007	Chelan County, WA	1991	NA	31698	28273	3425	10.8
CN5300900000000	53	009	Clallam County, WA	1991	NA	22949	21112	1837	8
CN5301100000000	53	011	Clark County, WA	1991	NA	128103	119895	8208	6.4
CN5301300000000	53	013	Columbia County, WA	1991	NA	1357	1170	187	13.8
CN5301500000000	53	015	Cowlitz County, WA	1991	NA	38600	35368	3232	8.4
CN5301700000000	53	017	Douglas County, WA	1991	NA	16322	14906	1416	8.7
CN5301900000000	53	019	Ferry County, WA	1991	NA	2755	2401	354	12.8
CN5302100000000	53	021	Franklin County, WA	1991	NA	19844	17431	2413	12.2
CN5302300000000	53	023	Garfield County, WA	1991	NA	1027	1000	27	2.6
CN5302500000000	53	025	Grant County, WA	1991	NA	28647	25663	2984	10.4
CN5302700000000	53	027	Grays Harbor County, WA	1991	NA	27211	23940	3271	12
CN5302900000000	53	029	Island County, WA	1991	NA	22885	21843	1042	4.6
CN5303100000000	53	031	Jefferson County, WA	1991	NA	8211	7654	557	6.8
CN5303300000000	53	033	King County, WA	1991	NA	861929	823004	38925	4.5
CN5303500000000	53	035	Kitsap County, WA	1991	NA	86160	81715	4445	5.2
CN5303700000000	53	037	Kittitas County, WA	1991	NA	12883	11607	1276	9.9
CN5303900000000	53	039	Klickitat County, WA	1991	NA	7834	6791	1043	13.3
CN5304100000000	53	041	Lewis County, WA	1991	NA	26213	23416	2797	10.7
CN5304300000000	53	043	Lincoln County, WA	1991	NA	4102	3916	186	4.5
CN5304500000000	53	045	Mason County, WA	1991	NA	15842	14558	1284	8.1
CN5304700000000	53	047	Okanogan County, WA	1991	NA	20120	17812	2308	11.5
CN5304900000000	53	049	Pacific County, WA	1991	NA	7768	6980	788	10.1
CN5305100000000	53	051	Pend Oreille County, WA	1991	NA	3438	2944	494	14.4
CN5305300000000	53	053	Pierce County, WA	1991	NA	277407	259640	17767	6.4
CN5305500000000	53	055	San Juan County, WA	1991	NA	5322	5128	194	3.6
CN5305700000000	53	057	Skagit County, WA	1991	NA	40636	37126	3510	8.6
CN5305900000000	53	059	Skamania County, WA	1991	NA	4004	3489	515	12.9
CN5306100000000	53	061	Snohomish County, WA	1991	NA	255630	242367	13263	5.2
CN5306300000000	53	063	Spokane County, WA	1991	NA	175989	164831	11158	6.3
CN5306500000000	53	065	Stevens County, WA	1991	NA	13915	12548	1367	9.8
CN5306700000000	53	067	Thurston County, WA	1991	NA	82687	77676	5011	6.1
CN5306900000000	53	069	Wahkiakum County, WA	1991	NA	1513	1424	89	5.9
CN5307100000000	53	071	Walla Walla County, WA	1991	NA	23617	21708	1909	8.1
CN5307300000000	53	073	Whatcom County, WA	1991	NA	69561	64838	4723	6.8
CN5307500000000	53	075	Whitman County, WA	1991	NA	17349	17028	321	1.9
CN5307700000000	53	077	Yakima County, WA	1991	NA	102819	89532	13287	12.9
CN5400100000000	54	001	Barbour County, WV	1991	NA	6263	5149	1114	17.8
CN5400300000000	54	003	Berkeley County, WV	1991	NA	30567	27571	2996	9.8
CN5400500000000	54	005	Boone County, WV	1991	NA	8883	7706	1177	13.3
CN5400700000000	54	007	Braxton County, WV	1991	NA	5126	4027	1099	21.4
CN5400900000000	54	009	Brooke County, WV	1991	NA	11984	10858	1126	9.4
CN5401100000000	54	011	Cabell County, WV	1991	NA	43606	39612	3994	9.2
CN5401300000000	54	013	Calhoun County, WV	1991	NA	3051	2419	632	20.7
CN5401500000000	54	015	Clay County, WV	1991	NA	3066	2474	592	19.3
CN5401700000000	54	017	Doddridge County, WV	1991	NA	2768	2567	201	7.3
CN5401900000000	54	019	Fayette County, WV	1991	NA	17244	14870	2374	13.8
CN5402100000000	54	021	Gilmer County, WV	1991	NA	2837	2492	345	12.2
CN5402300000000	54	023	Grant County, WV	1991	NA	5418	4889	529	9.8
CN5402500000000	54	025	Greenbrier County, WV	1991	NA	15553	13356	2197	14.1
CN5402700000000	54	027	Hampshire County, WV	1991	NA	7691	6731	960	12.5
CN5402900000000	54	029	Hancock County, WV	1991	NA	15903	14513	1390	8.7
CN5403100000000	54	031	Hardy County, WV	1991	NA	5367	4906	461	8.6
CN5403300000000	54	033	Harrison County, WV	1991	NA	30875	27649	3226	10.4
CN5403500000000	54	035	Jackson County, WV	1991	NA	13004	11733	1271	9.8
CN5403700000000	54	037	Jefferson County, WV	1991	NA	19352	17442	1910	9.9
CN5403900000000	54	039	Kanawha County, WV	1991	NA	98410	90755	7655	7.8
CN5404100000000	54	041	Lewis County, WV	1991	NA	7432	6470	962	12.9
CN5404300000000	54	043	Lincoln County, WV	1991	NA	7105	5923	1182	16.6
CN5404500000000	54	045	Logan County, WV	1991	NA	14625	12748	1877	12.8
CN5404700000000	54	047	McDowell County, WV	1991	NA	8982	7358	1624	18.1
CN5404900000000	54	049	Marion County, WV	1991	NA	24038	21447	2591	10.8
CN5405100000000	54	051	Marshall County, WV	1991	NA	16430	14720	1710	10.4
CN5405300000000	54	053	Mason County, WV	1991	NA	10035	8651	1384	13.8
CN5405500000000	54	055	Mercer County, WV	1991	NA	28393	25786	2607	9.2
CN5405700000000	54	057	Mineral County, WV	1991	NA	11790	10788	1002	8.5
CN5405900000000	54	059	Mingo County, WV	1991	NA	10211	8834	1377	13.5
CN5406100000000	54	061	Monongalia County, WV	1991	NA	36973	34338	2635	7.1
CN5406300000000	54	063	Monroe County, WV	1991	NA	5135	4517	618	12
CN5406500000000	54	065	Morgan County, WV	1991	NA	5851	5364	487	8.3
CN5406700000000	54	067	Nicholas County, WV	1991	NA	10593	8938	1655	15.6
CN5406900000000	54	069	Ohio County, WV	1991	NA	24360	22670	1690	6.9
CN5407100000000	54	071	Pendleton County, WV	1991	NA	3654	3404	250	6.8
CN5407300000000	54	073	Pleasants County, WV	1991	NA	3165	2726	439	13.9
CN5407500000000	54	075	Pocahontas County, WV	1991	NA	4160	3466	694	16.7
CN5407700000000	54	077	Preston County, WV	1991	NA	12265	10868	1397	11.4
CN5407900000000	54	079	Putnam County, WV	1991	NA	21095	19258	1837	8.7
CN5408100000000	54	081	Raleigh County, WV	1991	NA	30256	26907	3349	11.1
CN5408300000000	54	083	Randolph County, WV	1991	NA	12544	10711	1833	14.6
CN5408500000000	54	085	Ritchie County, WV	1991	NA	4480	3836	644	14.4
CN5408700000000	54	087	Roane County, WV	1991	NA	5989	4989	1000	16.7
CN5408900000000	54	089	Summers County, WV	1991	NA	4803	4264	539	11.2
CN5409100000000	54	091	Taylor County, WV	1991	NA	6358	5581	777	12.2
CN5409300000000	54	093	Tucker County, WV	1991	NA	3621	3148	473	13.1
CN5409500000000	54	095	Tyler County, WV	1991	NA	4119	3704	415	10.1
CN5409700000000	54	097	Upshur County, WV	1991	NA	10179	8623	1556	15.3
CN5409900000000	54	099	Wayne County, WV	1991	NA	16891	15005	1886	11.2
CN5410100000000	54	101	Webster County, WV	1991	NA	3357	2716	641	19.1
CN5410300000000	54	103	Wetzel County, WV	1991	NA	7848	6831	1017	13
CN5410500000000	54	105	Wirt County, WV	1991	NA	2009	1591	418	20.8
CN5410700000000	54	107	Wood County, WV	1991	NA	42660	38902	3758	8.8
CN5410900000000	54	109	Wyoming County, WV	1991	NA	8377	7306	1071	12.8
CN5500100000000	55	001	Adams County, WI	1991	NA	6393	5986	407	6.4
CN5500300000000	55	003	Ashland County, WI	1991	NA	7538	6833	705	9.4
CN5500500000000	55	005	Barron County, WI	1991	NA	21541	20074	1467	6.8
CN5500700000000	55	007	Bayfield County, WI	1991	NA	6633	6068	565	8.5
CN5500900000000	55	009	Brown County, WI	1991	NA	108655	103420	5235	4.8
CN5501100000000	55	011	Buffalo County, WI	1991	NA	7091	6600	491	6.9
CN5501300000000	55	013	Burnett County, WI	1991	NA	5972	5512	460	7.7
CN5501500000000	55	015	Calumet County, WI	1991	NA	21722	20241	1481	6.8
CN5501700000000	55	017	Chippewa County, WI	1991	NA	26241	24613	1628	6.2
CN5501900000000	55	019	Clark County, WI	1991	NA	15590	14285	1305	8.4
CN5502100000000	55	021	Columbia County, WI	1991	NA	25353	23844	1509	6
CN5502300000000	55	023	Crawford County, WI	1991	NA	8405	7861	544	6.5
CN5502500000000	55	025	Dane County, WI	1991	NA	220082	214754	5328	2.4
CN5502700000000	55	027	Dodge County, WI	1991	NA	39578	37266	2312	5.8
CN5502900000000	55	029	Door County, WI	1991	NA	14561	13424	1137	7.8
CN5503100000000	55	031	Douglas County, WI	1991	NA	20081	18648	1433	7.1
CN5503300000000	55	033	Dunn County, WI	1991	NA	18990	17929	1061	5.6
CN5503500000000	55	035	Eau Claire County, WI	1991	NA	44454	41910	2544	5.7
CN5503700000000	55	037	Florence County, WI	1991	NA	1444	1264	180	12.5
CN5503900000000	55	039	Fond du Lac County, WI	1991	NA	51904	49327	2577	5
CN5504100000000	55	041	Forest County, WI	1991	NA	3647	3307	340	9.3
CN5504300000000	55	043	Grant County, WI	1991	NA	27077	25619	1458	5.4
CN5504500000000	55	045	Green County, WI	1991	NA	17329	16318	1011	5.8
CN5504700000000	55	047	Green Lake County, WI	1991	NA	10153	9461	692	6.8
CN5504900000000	55	049	Iowa County, WI	1991	NA	12649	12063	586	4.6
CN5505100000000	55	051	Iron County, WI	1991	NA	2851	2623	228	8
CN5505300000000	55	053	Jackson County, WI	1991	NA	8384	7676	708	8.4
CN5505500000000	55	055	Jefferson County, WI	1991	NA	37959	35849	2110	5.6
CN5505700000000	55	057	Juneau County, WI	1991	NA	10656	9840	816	7.7
CN5505900000000	55	059	Kenosha County, WI	1991	NA	68538	64343	4195	6.1
CN5506100000000	55	061	Kewaunee County, WI	1991	NA	9867	9207	660	6.7
CN5506300000000	55	063	La Crosse County, WI	1991	NA	53676	51365	2311	4.3
CN5506500000000	55	065	Lafayette County, WI	1991	NA	8279	7868	411	5
CN5506700000000	55	067	Langlade County, WI	1991	NA	8817	8267	550	6.2
CN5506900000000	55	069	Lincoln County, WI	1991	NA	13841	12813	1028	7.4
CN5507100000000	55	071	Manitowoc County, WI	1991	NA	42108	39740	2368	5.6
CN5507300000000	55	073	Marathon County, WI	1991	NA	63481	60039	3442	5.4
CN5507500000000	55	075	Marinette County, WI	1991	NA	19495	17710	1785	9.2
CN5507700000000	55	077	Marquette County, WI	1991	NA	6139	5685	454	7.4
CN5507800000000	55	078	Menominee County, WI	1991	NA	1505	1376	129	8.6
CN5507900000000	55	079	Milwaukee County, WI	1991	NA	469301	443605	25696	5.5
CN5508100000000	55	081	Monroe County, WI	1991	NA	18441	17182	1259	6.8
CN5508300000000	55	083	Oconto County, WI	1991	NA	14379	12864	1515	10.5
CN5508500000000	55	085	Oneida County, WI	1991	NA	16398	15567	831	5.1
CN5508700000000	55	087	Outagamie County, WI	1991	NA	85235	82021	3214	3.8
CN5508900000000	55	089	Ozaukee County, WI	1991	NA	41440	39808	1632	3.9
CN5509100000000	55	091	Pepin County, WI	1991	NA	3403	3145	258	7.6
CN5509300000000	55	093	Pierce County, WI	1991	NA	18255	17277	978	5.4
CN5509500000000	55	095	Polk County, WI	1991	NA	17460	16113	1347	7.7
CN5509700000000	55	097	Portage County, WI	1991	NA	34756	33319	1437	4.1
CN5509900000000	55	099	Price County, WI	1991	NA	7296	6740	556	7.6
CN5510100000000	55	101	Racine County, WI	1991	NA	90065	84052	6013	6.7
CN5510300000000	55	103	Richland County, WI	1991	NA	8237	7670	567	6.9
CN5510500000000	55	105	Rock County, WI	1991	NA	74126	64838	9288	12.5
CN5510700000000	55	107	Rusk County, WI	1991	NA	6706	5988	718	10.7
CN5510900000000	55	109	St. Croix County, WI	1991	NA	27656	26083	1573	5.7
CN5511100000000	55	111	Sauk County, WI	1991	NA	26367	24646	1721	6.5
CN5511300000000	55	113	Sawyer County, WI	1991	NA	6789	6248	541	8
CN5511500000000	55	115	Shawano County, WI	1991	NA	18323	17030	1293	7.1
CN5511700000000	55	117	Sheboygan County, WI	1991	NA	55612	52452	3160	5.7
CN5511900000000	55	119	Taylor County, WI	1991	NA	9964	9098	866	8.7
CN5512100000000	55	121	Trempealeau County, WI	1991	NA	13281	12217	1064	8
CN5512300000000	55	123	Vernon County, WI	1991	NA	12411	11604	807	6.5
CN5512500000000	55	125	Vilas County, WI	1991	NA	8468	7956	512	6
CN5512700000000	55	127	Walworth County, WI	1991	NA	44918	43244	1674	3.7
CN5512900000000	55	129	Washburn County, WI	1991	NA	6730	6202	528	7.8
CN5513100000000	55	131	Washington County, WI	1991	NA	54686	51982	2704	4.9
CN5513300000000	55	133	Waukesha County, WI	1991	NA	175593	168235	7358	4.2
CN5513500000000	55	135	Waupaca County, WI	1991	NA	23546	22273	1273	5.4
CN5513700000000	55	137	Waushara County, WI	1991	NA	9099	8424	675	7.4
CN5513900000000	55	139	Winnebago County, WI	1991	NA	84969	81795	3174	3.7
CN5514100000000	55	141	Wood County, WI	1991	NA	37979	36224	1755	4.6
CN5600100000000	56	001	Albany County, WY	1991	NA	16251	15678	573	3.5
CN5600300000000	56	003	Big Horn County, WY	1991	NA	4749	4454	295	6.2
CN5600500000000	56	005	Campbell County, WY	1991	NA	16641	15818	823	4.9
CN5600700000000	56	007	Carbon County, WY	1991	NA	8660	8159	501	5.8
CN5600900000000	56	009	Converse County, WY	1991	NA	5777	5477	300	5.2
CN5601100000000	56	011	Crook County, WY	1991	NA	2687	2607	80	3
CN5601300000000	56	013	Fremont County, WY	1991	NA	15648	14549	1099	7
CN5601500000000	56	015	Goshen County, WY	1991	NA	5926	5694	232	3.9
CN5601700000000	56	017	Hot Springs County, WY	1991	NA	2432	2320	112	4.6
CN5601900000000	56	019	Johnson County, WY	1991	NA	3359	3182	177	5.3
CN5602100000000	56	021	Laramie County, WY	1991	NA	36176	34668	1508	4.2
CN5602300000000	56	023	Lincoln County, WY	1991	NA	6027	5586	441	7.3
CN5602500000000	56	025	Natrona County, WY	1991	NA	31602	29596	2006	6.3
CN5602700000000	56	027	Niobrara County, WY	1991	NA	1170	1122	48	4.1
CN5602900000000	56	029	Park County, WY	1991	NA	13120	12536	584	4.5
CN5603100000000	56	031	Platte County, WY	1991	NA	3813	3618	195	5.1
CN5603300000000	56	033	Sheridan County, WY	1991	NA	12125	11384	741	6.1
CN5603500000000	56	035	Sublette County, WY	1991	NA	2719	2642	77	2.8
CN5603700000000	56	037	Sweetwater County, WY	1991	NA	20691	19435	1256	6.1
CN5603900000000	56	039	Teton County, WY	1991	NA	8537	8327	210	2.5
CN5604100000000	56	041	Uinta County, WY	1991	NA	10086	9348	738	7.3
CN5604300000000	56	043	Washakie County, WY	1991	NA	4281	4082	199	4.6
CN5604500000000	56	045	Weston County, WY	1991	NA	3194	3045	149	4.7
CN7200100000000	72	001	Adjuntas Municipio, PR	1991	NA	5021	4214	807	16.1
CN7200300000000	72	003	Aguada Municipio, PR	1991	NA	13508	10630	2878	21.3
CN7200500000000	72	005	Aguadilla Municipio, PR	1991	NA	19220	15250	3970	20.7
CN7200700000000	72	007	Aguas Buenas Municipio, PR	1991	NA	7745	6191	1554	20.1
CN7200900000000	72	009	Aibonito Municipio, PR	1991	NA	9308	8206	1102	11.8
CN7201100000000	72	011	Anasco Municipio, PR	1991	NA	9606	7577	2029	21.1
CN7201300000000	72	013	Arecibo Municipio, PR	1991	NA	30014	24616	5398	18
CN7201500000000	72	015	Arroyo Municipio, PR	1991	NA	4961	3769	1192	24
CN7201700000000	72	017	Barceloneta Municipio, PR	1991	NA	6531	4998	1533	23.5
CN7201900000000	72	019	Barranquitas Municipio, PR	1991	NA	6506	5608	898	13.8
CN7202100000000	72	021	Bayamon Municipio, PR	1991	NA	80162	70864	9298	11.6
CN7202300000000	72	023	Cabo Rojo Municipio, PR	1991	NA	13188	10946	2242	17
CN7202500000000	72	025	Caguas Municipio, PR	1991	NA	51778	44004	7774	15
CN7202700000000	72	027	Camuy Municipio, PR	1991	NA	9316	7622	1694	18.2
CN7202900000000	72	029	Canovanas Municipio, PR	1991	NA	12130	10076	2054	16.9
CN7203100000000	72	031	Carolina Municipio, PR	1991	NA	70921	63791	7130	10.1
CN7203300000000	72	033	Catano Municipio, PR	1991	NA	10323	9004	1319	12.8
CN7203500000000	72	035	Cayey Municipio, PR	1991	NA	15027	12119	2908	19.4
CN7203700000000	72	037	Ceiba Municipio, PR	1991	NA	5256	4292	964	18.3
CN7203900000000	72	039	Ciales Municipio, PR	1991	NA	4997	4026	971	19.4
CN7204100000000	72	041	Cidra Municipio, PR	1991	NA	11249	9497	1752	15.6
CN7204300000000	72	043	Coamo Municipio, PR	1991	NA	9286	7444	1842	19.8
CN7204500000000	72	045	Comerio Municipio, PR	1991	NA	5518	4433	1085	19.7
CN7204700000000	72	047	Corozal Municipio, PR	1991	NA	8913	7570	1343	15.1
CN7204900000000	72	049	Culebra Municipio, PR	1991	NA	737	713	24	3.3
CN7205100000000	72	051	Dorado Municipio, PR	1991	NA	9768	8384	1384	14.2
CN7205300000000	72	053	Fajardo Municipio, PR	1991	NA	12695	10224	2471	19.5
CN7205400000000	72	054	Florida Municipio, PR	1991	NA	2717	2048	669	24.6
CN7205500000000	72	055	Guanica Municipio, PR	1991	NA	4923	3745	1178	23.9
CN7205700000000	72	057	Guayama Municipio, PR	1991	NA	10585	8090	2495	23.6
CN7205900000000	72	059	Guayanilla Municipio, PR	1991	NA	6287	4787	1500	23.9
CN7206100000000	72	061	Guaynabo Municipio, PR	1991	NA	35186	32740	2446	7
CN7206300000000	72	063	Gurabo Municipio, PR	1991	NA	9771	8063	1708	17.5
CN7206500000000	72	065	Hatillo Municipio, PR	1991	NA	10035	8271	1764	17.6
CN7206700000000	72	067	Hormigueros Municipio, PR	1991	NA	6262	5182	1080	17.2
CN7206900000000	72	069	Humacao Municipio, PR	1991	NA	18836	15056	3780	20.1
CN7207100000000	72	071	Isabela Municipio, PR	1991	NA	12570	10192	2378	18.9
CN7207300000000	72	073	Jayuya Municipio, PR	1991	NA	3670	3164	506	13.8
CN7207500000000	72	075	Juana Diaz Municipio, PR	1991	NA	12507	9620	2887	23.1
CN7207700000000	72	077	Juncos Municipio, PR	1991	NA	9230	7485	1745	18.9
CN7207900000000	72	079	Lajas Municipio, PR	1991	NA	7632	6180	1452	19
CN7208100000000	72	081	Lares Municipio, PR	1991	NA	7522	5959	1563	20.8
CN7208300000000	72	083	Las Marias Municipio, PR	1991	NA	3529	3022	507	14.4
CN7208500000000	72	085	Las Piedras Municipio, PR	1991	NA	9104	7336	1768	19.4
CN7208700000000	72	087	Loiza Municipio, PR	1991	NA	8204	7125	1079	13.2
CN7208900000000	72	089	Luquillo Municipio, PR	1991	NA	6220	4831	1389	22.3
CN7209100000000	72	091	Manati Municipio, PR	1991	NA	12544	9964	2580	20.6
CN7209300000000	72	093	Maricao Municipio, PR	1991	NA	1963	1707	256	13
CN7209500000000	72	095	Maunabo Municipio, PR	1991	NA	2936	2183	753	25.6
CN7209700000000	72	097	Mayaguez Municipio, PR	1991	NA	34916	28786	6130	17.6
CN7209900000000	72	099	Moca Municipio, PR	1991	NA	11522	8747	2775	24.1
CN7210100000000	72	101	Morovis Municipio, PR	1991	NA	7317	6013	1304	17.8
CN7210300000000	72	103	Naguabo Municipio, PR	1991	NA	6276	5083	1193	19
CN7210500000000	72	105	Naranjito Municipio, PR	1991	NA	6777	5586	1191	17.6
CN7210700000000	72	107	Orocovis Municipio, PR	1991	NA	5407	4512	895	16.6
CN7210900000000	72	109	Patillas Municipio, PR	1991	NA	5367	3935	1432	26.7
CN7211100000000	72	111	Penuelas Municipio, PR	1991	NA	6444	4946	1498	23.2
CN7211300000000	72	113	Ponce Municipio, PR	1991	NA	57786	46950	10836	18.8
CN7211500000000	72	115	Quebradillas Municipio, PR	1991	NA	6914	5658	1256	18.2
CN7211700000000	72	117	Rincon Municipio, PR	1991	NA	5240	4346	894	17.1
CN7211900000000	72	119	Rio Grande Municipio, PR	1991	NA	15272	12777	2495	16.3
CN7212100000000	72	121	Sabana Grande Municipio, PR	1991	NA	7841	6452	1389	17.7
CN7212300000000	72	123	Salinas Municipio, PR	1991	NA	7934	5645	2289	28.9
CN7212500000000	72	125	San German Municipio, PR	1991	NA	12314	9922	2392	19.4
CN7212700000000	72	127	San Juan Municipio, PR	1991	NA	157638	140297	17341	11
CN7212900000000	72	129	San Lorenzo Municipio, PR	1991	NA	11157	8988	2169	19.4
CN7213100000000	72	131	San Sebastian Municipio, PR	1991	NA	12473	8954	3519	28.2
CN7213300000000	72	133	Santa Isabel Municipio, PR	1991	NA	5187	3755	1432	27.6
CN7213500000000	72	135	Toa Alta Municipio, PR	1991	NA	14959	12948	2011	13.4
CN7213700000000	72	137	Toa Baja Municipio, PR	1991	NA	31826	28833	2993	9.4
CN7213900000000	72	139	Trujillo Alto Municipio, PR	1991	NA	22975	20848	2127	9.3
CN7214100000000	72	141	Utuado Municipio, PR	1991	NA	8499	6862	1637	19.3
CN7214300000000	72	143	Vega Alta Municipio, PR	1991	NA	10869	9029	1840	16.9
CN7214500000000	72	145	Vega Baja Municipio, PR	1991	NA	17476	14235	3241	18.5
CN7214700000000	72	147	Vieques Municipio, PR	1991	NA	2588	2183	405	15.6
CN7214900000000	72	149	Villalba Municipio, PR	1991	NA	5986	4507	1479	24.7
CN7215100000000	72	151	Yabucoa Municipio, PR	1991	NA	10995	8252	2743	24.9
CN7215300000000	72	153	Yauco Municipio, PR	1991	NA	12762	9982	2780	21.8
NA	NA	NA	NA	NA	NA	NA	NA	NA	NA
SOURCE:  BLS, LAUS	NA	NA	NA	NA	NA	NA	NA	NA	NA
March 18, 2016	NA	NA	NA	NA	NA	NA	NA	NA	NA
