LAUS_CODE	STATE_FIPS	COUNTY_FIPS	COUNTY	YEAR	ESTIMATED	LABOR_FORCE	EMPLOYED	UNEMPLOYED_LEVEL	UNEMPLOYED_RATE
CN0100100000000	01	001	Autauga County, AL	1993	NA	18234	17139	1095	6
CN0100300000000	01	003	Baldwin County, AL	1993	NA	55079	51755	3324	6
CN0100500000000	01	005	Barbour County, AL	1993	NA	12004	10788	1216	10.1
CN0100700000000	01	007	Bibb County, AL	1993	NA	7734	6833	901	11.6
CN0100900000000	01	009	Blount County, AL	1993	NA	19929	18868	1061	5.3
CN0101100000000	01	011	Bullock County, AL	1993	NA	4175	3555	620	14.9
CN0101300000000	01	013	Butler County, AL	1993	NA	9217	8208	1009	10.9
CN0101500000000	01	015	Calhoun County, AL	1993	NA	52826	48203	4623	8.8
CN0101700000000	01	017	Chambers County, AL	1993	NA	17472	15787	1685	9.6
CN0101900000000	01	019	Cherokee County, AL	1993	NA	9683	9075	608	6.3
CN0102100000000	01	021	Chilton County, AL	1993	NA	16338	14882	1456	8.9
CN0102300000000	01	023	Choctaw County, AL	1993	NA	7254	6217	1037	14.3
CN0102500000000	01	025	Clarke County, AL	1993	NA	13005	11447	1558	12
CN0102700000000	01	027	Clay County, AL	1993	NA	6758	6047	711	10.5
CN0102900000000	01	029	Cleburne County, AL	1993	NA	6993	6523	470	6.7
CN0103100000000	01	031	Coffee County, AL	1993	NA	20868	19593	1275	6.1
CN0103300000000	01	033	Colbert County, AL	1993	NA	25663	23514	2149	8.4
CN0103500000000	01	035	Conecuh County, AL	1993	NA	6316	5667	649	10.3
CN0103700000000	01	037	Coosa County, AL	1993	NA	5140	4822	318	6.2
CN0103900000000	01	039	Covington County, AL	1993	NA	16953	15373	1580	9.3
CN0104100000000	01	041	Crenshaw County, AL	1993	NA	5959	5483	476	8
CN0104300000000	01	043	Cullman County, AL	1993	NA	35320	33020	2300	6.5
CN0104500000000	01	045	Dale County, AL	1993	NA	20959	19070	1889	9
CN0104700000000	01	047	Dallas County, AL	1993	NA	20419	17359	3060	15
CN0104900000000	01	049	DeKalb County, AL	1993	NA	29482	27490	1992	6.8
CN0105100000000	01	051	Elmore County, AL	1993	NA	24742	23223	1519	6.1
CN0105300000000	01	053	Escambia County, AL	1993	NA	16168	14543	1625	10.1
CN0105500000000	01	055	Etowah County, AL	1993	NA	47551	43866	3685	7.7
CN0105700000000	01	057	Fayette County, AL	1993	NA	8756	7941	815	9.3
CN0105900000000	01	059	Franklin County, AL	1993	NA	15296	14145	1151	7.5
CN0106100000000	01	061	Geneva County, AL	1993	NA	12140	11402	738	6.1
CN0106300000000	01	063	Greene County, AL	1993	NA	3731	3174	557	14.9
CN0106500000000	01	065	Hale County, AL	1993	NA	6972	6284	688	9.9
CN0106700000000	01	067	Henry County, AL	1993	NA	6553	5905	648	9.9
CN0106900000000	01	069	Houston County, AL	1993	NA	42408	39455	2953	7
CN0107100000000	01	071	Jackson County, AL	1993	NA	25866	23343	2523	9.8
CN0107300000000	01	073	Jefferson County, AL	1993	NA	318131	300003	18128	5.7
CN0107500000000	01	075	Lamar County, AL	1993	NA	7859	7104	755	9.6
CN0107700000000	01	077	Lauderdale County, AL	1993	NA	40555	37631	2924	7.2
CN0107900000000	01	079	Lawrence County, AL	1993	NA	15400	13883	1517	9.9
CN0108100000000	01	081	Lee County, AL	1993	NA	44427	41792	2635	5.9
CN0108300000000	01	083	Limestone County, AL	1993	NA	27300	25682	1618	5.9
CN0108500000000	01	085	Lowndes County, AL	1993	NA	4283	3469	814	19
CN0108700000000	01	087	Macon County, AL	1993	NA	8626	7771	855	9.9
CN0108900000000	01	089	Madison County, AL	1993	NA	134550	127066	7484	5.6
CN0109100000000	01	091	Marengo County, AL	1993	NA	10764	9586	1178	10.9
CN0109300000000	01	093	Marion County, AL	1993	NA	14458	13118	1340	9.3
CN0109500000000	01	095	Marshall County, AL	1993	NA	37679	34743	2936	7.8
CN0109700000000	01	097	Mobile County, AL	1993	NA	187868	172246	15622	8.3
CN0109900000000	01	099	Monroe County, AL	1993	NA	10211	8721	1490	14.6
CN0110100000000	01	101	Montgomery County, AL	1993	NA	104515	98414	6101	5.8
CN0110300000000	01	103	Morgan County, AL	1993	NA	51774	48064	3710	7.2
CN0110500000000	01	105	Perry County, AL	1993	NA	4847	4123	724	14.9
CN0110700000000	01	107	Pickens County, AL	1993	NA	9171	8110	1061	11.6
CN0110900000000	01	109	Pike County, AL	1993	NA	12976	12077	899	6.9
CN0111100000000	01	111	Randolph County, AL	1993	NA	9715	8804	911	9.4
CN0111300000000	01	113	Russell County, AL	1993	NA	22536	20819	1717	7.6
CN0111500000000	01	115	St. Clair County, AL	1993	NA	25874	24257	1617	6.2
CN0111700000000	01	117	Shelby County, AL	1993	NA	60627	58503	2124	3.5
CN0111900000000	01	119	Sumter County, AL	1993	NA	6170	5385	785	12.7
CN0112100000000	01	121	Talladega County, AL	1993	NA	34492	31496	2996	8.7
CN0112300000000	01	123	Tallapoosa County, AL	1993	NA	19906	18511	1395	7
CN0112500000000	01	125	Tuscaloosa County, AL	1993	NA	72694	68860	3834	5.3
CN0112700000000	01	127	Walker County, AL	1993	NA	29919	26686	3233	10.8
CN0112900000000	01	129	Washington County, AL	1993	NA	6705	5537	1168	17.4
CN0113100000000	01	131	Wilcox County, AL	1993	NA	4030	3315	715	17.7
CN0113300000000	01	133	Winston County, AL	1993	NA	11880	10978	902	7.6
CN0201300000000	02	013	Aleutians East Borough, AK	1993	NA	1490	1460	30	2
CN0201600000000	02	016	Aleutians West Census Area, AK	1993	NA	4007	3958	49	1.2
CN0202000000000	02	020	Anchorage Borough/municipality, AK	1993	NA	132440	124599	7841	5.9
CN0205000000000	02	050	Bethel Census Area, AK	1993	NA	5051	4699	352	7
CN0206000000000	02	060	Bristol Bay Borough, AK	1993	NA	636	598	38	6
CN0206800000000	02	068	Denali Borough, AK	1993	NA	1027	932	95	9.3
CN0207000000000	02	070	Dillingham Census Area, AK	1993	NA	1551	1434	117	7.5
CN0209000000000	02	090	Fairbanks North Star Borough, AK	1993	NA	39730	36413	3317	8.3
CN0210000000000	02	100	Haines Borough, AK	1993	NA	1098	997	101	9.2
CN0211000000000	02	110	Juneau Borough/city, AK	1993	NA	16233	15243	990	6.1
CN0212200000000	02	122	Kenai Peninsula Borough, AK	1993	NA	20536	17898	2638	12.8
CN0213000000000	02	130	Ketchikan Gateway Borough, AK	1993	NA	7681	7015	666	8.7
CN0215000000000	02	150	Kodiak Island Borough, AK	1993	NA	7209	6497	712	9.9
CN0215800000000	02	158	Kusilvak Census Area, AK	1993	NA	1709	1529	180	10.5
CN0216400000000	02	164	Lake and Peninsula Borough, AK	1993	NA	535	495	40	7.5
CN0217000000000	02	170	Matanuska-Susitna Borough, AK	1993	NA	22496	20051	2445	10.9
CN0218000000000	02	180	Nome Census Area, AK	1993	NA	3270	2885	385	11.8
CN0218500000000	02	185	North Slope Borough, AK	1993	NA	2999	2862	137	4.6
CN0218800000000	02	188	Northwest Arctic Borough, AK	1993	NA	2183	1815	368	16.9
CN0220100000000	02	201	Prince of Wales-Outer Ketchikan Census Area, AK	1993	NA	3066	2769	297	9.7
CN0222000000000	02	220	Sitka Borough/city, AK	1993	NA	4739	4451	288	6.1
CN0223200000000	02	232	Skagway-Hoonah-Angoon Census Area, AK	1993	NA	2527	2289	238	9.4
CN0224000000000	02	240	Southeast Fairbanks Census Area, AK	1993	NA	2321	2025	296	12.8
CN0226100000000	02	261	Valdez-Cordova Census Area, AK	1993	NA	5230	4743	487	9.3
CN0228000000000	02	280	Wrangell-Petersburg Census Area, AK	1993	NA	3660	3343	317	8.7
CN0229000000000	02	290	Yukon-Koyukuk Census Area, AK	1993	NA	2012	1710	302	15
CN0400100000000	04	001	Apache County, AZ	1993	NA	18348	15162	3186	17.4
CN0400300000000	04	003	Cochise County, AZ	1993	NA	40875	36921	3954	9.7
CN0400500000000	04	005	Coconino County, AZ	1993	NA	54076	49293	4783	8.8
CN0400700000000	04	007	Gila County, AZ	1993	NA	17784	16093	1691	9.5
CN0400900000000	04	009	Graham County, AZ	1993	NA	10495	9450	1045	10
CN0401100000000	04	011	Greenlee County, AZ	1993	NA	3995	3560	435	10.9
CN0401200000000	04	012	La Paz County, AZ	1993	NA	5390	4537	853	15.8
CN0401300000000	04	013	Maricopa County, AZ	1993	NA	1188830	1128558	60272	5.1
CN0401500000000	04	015	Mohave County, AZ	1993	NA	52538	47504	5034	9.6
CN0401700000000	04	017	Navajo County, AZ	1993	NA	29931	25801	4130	13.8
CN0401900000000	04	019	Pima County, AZ	1993	NA	350101	335703	14398	4.1
CN0402100000000	04	021	Pinal County, AZ	1993	NA	47983	44823	3160	6.6
CN0402300000000	04	023	Santa Cruz County, AZ	1993	NA	14700	12171	2529	17.2
CN0402500000000	04	025	Yavapai County, AZ	1993	NA	56220	53144	3076	5.5
CN0402700000000	04	027	Yuma County, AZ	1993	NA	57760	41530	16230	28.1
CN0500100000000	05	001	Arkansas County, AR	1993	NA	10537	9933	604	5.7
CN0500300000000	05	003	Ashley County, AR	1993	NA	10930	10168	762	7
CN0500500000000	05	005	Baxter County, AR	1993	NA	13193	12556	637	4.8
CN0500700000000	05	007	Benton County, AR	1993	NA	55466	53981	1485	2.7
CN0500900000000	05	009	Boone County, AR	1993	NA	14414	13810	604	4.2
CN0501100000000	05	011	Bradley County, AR	1993	NA	4936	4495	441	8.9
CN0501300000000	05	013	Calhoun County, AR	1993	NA	2405	2177	228	9.5
CN0501500000000	05	015	Carroll County, AR	1993	NA	11892	11283	609	5.1
CN0501700000000	05	017	Chicot County, AR	1993	NA	6306	5734	572	9.1
CN0501900000000	05	019	Clark County, AR	1993	NA	11164	10675	489	4.4
CN0502100000000	05	021	Clay County, AR	1993	NA	8317	7575	742	8.9
CN0502300000000	05	023	Cleburne County, AR	1993	NA	8857	8201	656	7.4
CN0502500000000	05	025	Cleveland County, AR	1993	NA	3776	3542	234	6.2
CN0502700000000	05	027	Columbia County, AR	1993	NA	11806	10905	901	7.6
CN0502900000000	05	029	Conway County, AR	1993	NA	9244	8588	656	7.1
CN0503100000000	05	031	Craighead County, AR	1993	NA	38044	36148	1896	5
CN0503300000000	05	033	Crawford County, AR	1993	NA	22145	20671	1474	6.7
CN0503500000000	05	035	Crittenden County, AR	1993	NA	21921	20384	1537	7
CN0503700000000	05	037	Cross County, AR	1993	NA	8918	8085	833	9.3
CN0503900000000	05	039	Dallas County, AR	1993	NA	3906	3620	286	7.3
CN0504100000000	05	041	Desha County, AR	1993	NA	7129	6519	610	8.6
CN0504300000000	05	043	Drew County, AR	1993	NA	9379	8753	626	6.7
CN0504500000000	05	045	Faulkner County, AR	1993	NA	35162	33167	1995	5.7
CN0504700000000	05	047	Franklin County, AR	1993	NA	7817	7373	444	5.7
CN0504900000000	05	049	Fulton County, AR	1993	NA	4489	4215	274	6.1
CN0505100000000	05	051	Garland County, AR	1993	NA	34629	32043	2586	7.5
CN0505300000000	05	053	Grant County, AR	1993	NA	7081	6710	371	5.2
CN0505500000000	05	055	Greene County, AR	1993	NA	16221	15205	1016	6.3
CN0505700000000	05	057	Hempstead County, AR	1993	NA	10861	10037	824	7.6
CN0505900000000	05	059	Hot Spring County, AR	1993	NA	11853	10916	937	7.9
CN0506100000000	05	061	Howard County, AR	1993	NA	6785	6353	432	6.4
CN0506300000000	05	063	Independence County, AR	1993	NA	16356	15396	960	5.9
CN0506500000000	05	065	Izard County, AR	1993	NA	4175	3807	368	8.8
CN0506700000000	05	067	Jackson County, AR	1993	NA	8369	7412	957	11.4
CN0506900000000	05	069	Jefferson County, AR	1993	NA	37506	33969	3537	9.4
CN0507100000000	05	071	Johnson County, AR	1993	NA	9412	8905	507	5.4
CN0507300000000	05	073	Lafayette County, AR	1993	NA	3621	3335	286	7.9
CN0507500000000	05	075	Lawrence County, AR	1993	NA	7941	7369	572	7.2
CN0507700000000	05	077	Lee County, AR	1993	NA	4695	4176	519	11.1
CN0507900000000	05	079	Lincoln County, AR	1993	NA	5156	4777	379	7.4
CN0508100000000	05	081	Little River County, AR	1993	NA	5704	5247	457	8
CN0508300000000	05	083	Logan County, AR	1993	NA	10075	9583	492	4.9
CN0508500000000	05	085	Lonoke County, AR	1993	NA	21242	20235	1007	4.7
CN0508700000000	05	087	Madison County, AR	1993	NA	6837	6602	235	3.4
CN0508900000000	05	089	Marion County, AR	1993	NA	5330	5146	184	3.5
CN0509100000000	05	091	Miller County, AR	1993	NA	17126	15918	1208	7.1
CN0509300000000	05	093	Mississippi County, AR	1993	NA	27033	24212	2821	10.4
CN0509500000000	05	095	Monroe County, AR	1993	NA	4397	4055	342	7.8
CN0509700000000	05	097	Montgomery County, AR	1993	NA	3804	3647	157	4.1
CN0509900000000	05	099	Nevada County, AR	1993	NA	4586	4309	277	6
CN0510100000000	05	101	Newton County, AR	1993	NA	2955	2782	173	5.9
CN0510300000000	05	103	Ouachita County, AR	1993	NA	12905	11389	1516	11.7
CN0510500000000	05	105	Perry County, AR	1993	NA	3544	3226	318	9
CN0510700000000	05	107	Phillips County, AR	1993	NA	11032	9806	1226	11.1
CN0510900000000	05	109	Pike County, AR	1993	NA	4644	4350	294	6.3
CN0511100000000	05	111	Poinsett County, AR	1993	NA	11043	10026	1017	9.2
CN0511300000000	05	113	Polk County, AR	1993	NA	8111	7742	369	4.5
CN0511500000000	05	115	Pope County, AR	1993	NA	25526	24234	1292	5.1
CN0511700000000	05	117	Prairie County, AR	1993	NA	3916	3515	401	10.2
CN0511900000000	05	119	Pulaski County, AR	1993	NA	190153	181014	9139	4.8
CN0512100000000	05	121	Randolph County, AR	1993	NA	7714	7078	636	8.2
CN0512300000000	05	123	St. Francis County, AR	1993	NA	12013	10417	1596	13.3
CN0512500000000	05	125	Saline County, AR	1993	NA	36052	34452	1600	4.4
CN0512700000000	05	127	Scott County, AR	1993	NA	5042	4853	189	3.7
CN0512900000000	05	129	Searcy County, AR	1993	NA	2982	2821	161	5.4
CN0513100000000	05	131	Sebastian County, AR	1993	NA	54263	50966	3297	6.1
CN0513300000000	05	133	Sevier County, AR	1993	NA	7070	6733	337	4.8
CN0513500000000	05	135	Sharp County, AR	1993	NA	5628	5218	410	7.3
CN0513700000000	05	137	Stone County, AR	1993	NA	4863	4568	295	6.1
CN0513900000000	05	139	Union County, AR	1993	NA	21164	19633	1531	7.2
CN0514100000000	05	141	Van Buren County, AR	1993	NA	5929	5436	493	8.3
CN0514300000000	05	143	Washington County, AR	1993	NA	67151	65112	2039	3
CN0514500000000	05	145	White County, AR	1993	NA	28084	25905	2179	7.8
CN0514700000000	05	147	Woodruff County, AR	1993	NA	4033	3602	431	10.7
CN0514900000000	05	149	Yell County, AR	1993	NA	9175	8748	427	4.7
CN0600100000000	06	001	Alameda County, CA	1993	NA	678119	633025	45094	6.6
CN0600300000000	06	003	Alpine County, CA	1993	NA	360	313	47	13.1
CN0600500000000	06	005	Amador County, CA	1993	NA	12828	11639	1189	9.3
CN0600700000000	06	007	Butte County, CA	1993	NA	82520	72685	9835	11.9
CN0600900000000	06	009	Calaveras County, CA	1993	NA	14950	13145	1805	12.1
CN0601100000000	06	011	Colusa County, CA	1993	NA	8474	6643	1831	21.6
CN0601300000000	06	013	Contra Costa County, CA	1993	NA	442474	413271	29203	6.6
CN0601500000000	06	015	Del Norte County, CA	1993	NA	9756	8377	1379	14.1
CN0601700000000	06	017	El Dorado County, CA	1993	NA	67474	61626	5848	8.7
CN0601900000000	06	019	Fresno County, CA	1993	NA	361739	305983	55756	15.4
CN0602100000000	06	021	Glenn County, CA	1993	NA	11357	9394	1963	17.3
CN0602300000000	06	023	Humboldt County, CA	1993	NA	59615	53732	5883	9.9
CN0602500000000	06	025	Imperial County, CA	1993	NA	55262	39084	16178	29.3
CN0602700000000	06	027	Inyo County, CA	1993	NA	7110	6321	789	11.1
CN0602900000000	06	029	Kern County, CA	1993	NA	273376	230356	43020	15.7
CN0603100000000	06	031	Kings County, CA	1993	NA	40941	34716	6225	15.2
CN0603300000000	06	033	Lake County, CA	1993	NA	22882	19837	3045	13.3
CN0603500000000	06	035	Lassen County, CA	1993	NA	10936	9584	1352	12.4
CN0603700000000	06	037	Los Angeles County, CA	1993	NA	4340467	3908826	431641	9.9
CN0603900000000	06	039	Madera County, CA	1993	NA	47871	40110	7761	16.2
CN0604100000000	06	041	Marin County, CA	1993	NA	130799	124103	6696	5.1
CN0604300000000	06	043	Mariposa County, CA	1993	NA	7245	6519	726	10
CN0604500000000	06	045	Mendocino County, CA	1993	NA	40369	35837	4532	11.2
CN0604700000000	06	047	Merced County, CA	1993	NA	83238	68858	14380	17.3
CN0604900000000	06	049	Modoc County, CA	1993	NA	3928	3396	532	13.5
CN0605100000000	06	051	Mono County, CA	1993	NA	5978	5418	560	9.4
CN0605300000000	06	053	Monterey County, CA	1993	NA	176787	153828	22959	13
CN0605500000000	06	055	Napa County, CA	1993	NA	58012	53450	4562	7.9
CN0605700000000	06	057	Nevada County, CA	1993	NA	40230	36847	3383	8.4
CN0605900000000	06	059	Orange County, CA	1993	NA	1327926	1237815	90111	6.8
CN0606100000000	06	061	Placer County, CA	1993	NA	93210	85691	7519	8.1
CN0606300000000	06	063	Plumas County, CA	1993	NA	9680	8222	1458	15.1
CN0606500000000	06	065	Riverside County, CA	1993	NA	582296	512030	70266	12.1
CN0606700000000	06	067	Sacramento County, CA	1993	NA	529965	485946	44019	8.3
CN0606900000000	06	069	San Benito County, CA	1993	NA	22257	18698	3559	16
CN0607100000000	06	071	San Bernardino County, CA	1993	NA	676255	609415	66840	9.9
CN0607300000000	06	073	San Diego County, CA	1993	NA	1218925	1123927	94998	7.8
CN0607500000000	06	075	San Francisco County/city, CA	1993	NA	406433	377812	28621	7
CN0607700000000	06	077	San Joaquin County, CA	1993	NA	241912	207848	34064	14.1
CN0607900000000	06	079	San Luis Obispo County, CA	1993	NA	101308	93063	8245	8.1
CN0608100000000	06	081	San Mateo County, CA	1993	NA	368686	349992	18694	5.1
CN0608300000000	06	083	Santa Barbara County, CA	1993	NA	193043	178161	14882	7.7
CN0608500000000	06	085	Santa Clara County, CA	1993	NA	847518	788965	58553	6.9
CN0608700000000	06	087	Santa Cruz County, CA	1993	NA	140410	125798	14612	10.4
CN0608900000000	06	089	Shasta County, CA	1993	NA	73197	63998	9199	12.6
CN0609100000000	06	091	Sierra County, CA	1993	NA	1808	1609	199	11
CN0609300000000	06	093	Siskiyou County, CA	1993	NA	19310	16324	2986	15.5
CN0609500000000	06	095	Solano County, CA	1993	NA	174820	160562	14258	8.2
CN0609700000000	06	097	Sonoma County, CA	1993	NA	220235	205710	14525	6.6
CN0609900000000	06	099	Stanislaus County, CA	1993	NA	194152	161604	32548	16.8
CN0610100000000	06	101	Sutter County, CA	1993	NA	34681	28185	6496	18.7
CN0610300000000	06	103	Tehama County, CA	1993	NA	23315	20259	3056	13.1
CN0610500000000	06	105	Trinity County, CA	1993	NA	5184	4321	863	16.6
CN0610700000000	06	107	Tulare County, CA	1993	NA	157669	129149	28520	18.1
CN0610900000000	06	109	Tuolumne County, CA	1993	NA	20624	18177	2447	11.9
CN0611100000000	06	111	Ventura County, CA	1993	NA	375542	341706	33836	9
CN0611300000000	06	113	Yolo County, CA	1993	NA	82746	76125	6621	8
CN0611500000000	06	115	Yuba County, CA	1993	NA	23003	18997	4006	17.4
CN0800100000000	08	001	Adams County, CO	1993	NA	150890	142831	8059	5.3
CN0800300000000	08	003	Alamosa County, CO	1993	NA	7221	6706	515	7.1
CN0800500000000	08	005	Arapahoe County, CO	1993	NA	247718	237306	10412	4.2
CN0800700000000	08	007	Archuleta County, CO	1993	NA	3018	2789	229	7.6
CN0800900000000	08	009	Baca County, CO	1993	NA	2088	2032	56	2.7
CN0801100000000	08	011	Bent County, CO	1993	NA	2182	2093	89	4.1
CN0801300000000	08	013	Boulder County, CO	1993	NA	139978	133548	6430	4.6
CN0801400000000	08	014	Broomfield County/city, CO	1993	NA	15790	15243	547	3.5
CN0801500000000	08	015	Chaffee County, CO	1993	NA	6404	6021	383	6
CN0801700000000	08	017	Cheyenne County, CO	1993	NA	1144	1105	39	3.4
CN0801900000000	08	019	Clear Creek County, CO	1993	NA	4964	4609	355	7.2
CN0802100000000	08	021	Conejos County, CO	1993	NA	3226	2912	314	9.7
CN0802300000000	08	023	Costilla County, CO	1993	NA	1732	1538	194	11.2
CN0802500000000	08	025	Crowley County, CO	1993	NA	1186	1118	68	5.7
CN0802700000000	08	027	Custer County, CO	1993	NA	1276	1205	71	5.6
CN0802900000000	08	029	Delta County, CO	1993	NA	9214	8561	653	7.1
CN0803100000000	08	031	Denver County/city, CO	1993	NA	266899	250685	16214	6.1
CN0803300000000	08	033	Dolores County, CO	1993	NA	718	622	96	13.4
CN0803500000000	08	035	Douglas County, CO	1993	NA	46219	44677	1542	3.3
CN0803700000000	08	037	Eagle County, CO	1993	NA	14891	14107	784	5.3
CN0803900000000	08	039	Elbert County, CO	1993	NA	6982	6637	345	4.9
CN0804100000000	08	041	El Paso County, CO	1993	NA	209021	196036	12985	6.2
CN0804300000000	08	043	Fremont County, CO	1993	NA	15206	14002	1204	7.9
CN0804500000000	08	045	Garfield County, CO	1993	NA	18223	17059	1164	6.4
CN0804700000000	08	047	Gilpin County, CO	1993	NA	3280	3148	132	4
CN0804900000000	08	049	Grand County, CO	1993	NA	4936	4683	253	5.1
CN0805100000000	08	051	Gunnison County, CO	1993	NA	6935	6500	435	6.3
CN0805300000000	08	053	Hinsdale County, CO	1993	NA	525	502	23	4.4
CN0805500000000	08	055	Huerfano County, CO	1993	NA	2850	2603	247	8.7
CN0805700000000	08	057	Jackson County, CO	1993	NA	1103	1031	72	6.5
CN0805900000000	08	059	Jefferson County, CO	1993	NA	272607	261038	11569	4.2
CN0806100000000	08	061	Kiowa County, CO	1993	NA	830	814	16	1.9
CN0806300000000	08	063	Kit Carson County, CO	1993	NA	3272	3150	122	3.7
CN0806500000000	08	065	Lake County, CO	1993	NA	3022	2684	338	11.2
CN0806700000000	08	067	La Plata County, CO	1993	NA	20434	19225	1209	5.9
CN0806900000000	08	069	Larimer County, CO	1993	NA	116475	111237	5238	4.5
CN0807100000000	08	071	Las Animas County, CO	1993	NA	5751	5289	462	8
CN0807300000000	08	073	Lincoln County, CO	1993	NA	2499	2397	102	4.1
CN0807500000000	08	075	Logan County, CO	1993	NA	8555	8210	345	4
CN0807700000000	08	077	Mesa County, CO	1993	NA	49874	46379	3495	7
CN0807900000000	08	079	Mineral County, CO	1993	NA	379	355	24	6.3
CN0808100000000	08	081	Moffat County, CO	1993	NA	6247	5786	461	7.4
CN0808300000000	08	083	Montezuma County, CO	1993	NA	10669	9851	818	7.7
CN0808500000000	08	085	Montrose County, CO	1993	NA	12941	12178	763	5.9
CN0808700000000	08	087	Morgan County, CO	1993	NA	11811	11353	458	3.9
CN0808900000000	08	089	Otero County, CO	1993	NA	8387	7874	513	6.1
CN0809100000000	08	091	Ouray County, CO	1993	NA	1392	1325	67	4.8
CN0809300000000	08	093	Park County, CO	1993	NA	5613	5286	327	5.8
CN0809500000000	08	095	Phillips County, CO	1993	NA	1796	1757	39	2.2
CN0809700000000	08	097	Pitkin County, CO	1993	NA	8572	8025	547	6.4
CN0809900000000	08	099	Prowers County, CO	1993	NA	6024	5725	299	5
CN0810100000000	08	101	Pueblo County, CO	1993	NA	53750	49285	4465	8.3
CN0810300000000	08	103	Rio Blanco County, CO	1993	NA	3458	3287	171	4.9
CN0810500000000	08	105	Rio Grande County, CO	1993	NA	4950	4522	428	8.6
CN0810700000000	08	107	Routt County, CO	1993	NA	9508	8975	533	5.6
CN0810900000000	08	109	Saguache County, CO	1993	NA	2358	2087	271	11.5
CN0811100000000	08	111	San Juan County, CO	1993	NA	331	261	70	21.1
CN0811300000000	08	113	San Miguel County, CO	1993	NA	3653	3481	172	4.7
CN0811500000000	08	115	Sedgwick County, CO	1993	NA	1207	1157	50	4.1
CN0811700000000	08	117	Summit County, CO	1993	NA	9593	9193	400	4.2
CN0811900000000	08	119	Teller County, CO	1993	NA	10003	9244	759	7.6
CN0812100000000	08	121	Washington County, CO	1993	NA	2184	2113	71	3.3
CN0812300000000	08	123	Weld County, CO	1993	NA	73211	69379	3832	5.2
CN0812500000000	08	125	Yuma County, CO	1993	NA	3978	3854	124	3.1
CN0900100000000	09	001	Fairfield County, CT	1993	NA	457022	430794	26228	5.7
CN0900300000000	09	003	Hartford County, CT	1993	NA	455764	422436	33328	7.3
CN0900500000000	09	005	Litchfield County, CT	1993	NA	104152	97499	6653	6.4
CN0900700000000	09	007	Middlesex County, CT	1993	NA	83995	78714	5281	6.3
CN0900900000000	09	009	New Haven County, CT	1993	NA	432532	402049	30483	7
CN0901100000000	09	011	New London County, CT	1993	NA	132814	124487	8327	6.3
CN0901300000000	09	013	Tolland County, CT	1993	NA	73469	69024	4445	6.1
CN0901500000000	09	015	Windham County, CT	1993	NA	55972	51576	4396	7.9
CN1000100000000	10	001	Kent County, DE	1993	NA	66846	63026	3820	5.7
CN1000300000000	10	003	New Castle County, DE	1993	NA	243758	231925	11833	4.9
CN1000500000000	10	005	Sussex County, DE	1993	NA	66250	62826	3424	5.2
CN1100100000000	11	001	District of Columbia	1993	NA	315856	288925	26931	8.5
CN1200100000000	12	001	Alachua County, FL	1993	NA	99614	95690	3924	3.9
CN1200300000000	12	003	Baker County, FL	1993	NA	8697	7914	783	9
CN1200500000000	12	005	Bay County, FL	1993	NA	65338	59148	6190	9.5
CN1200700000000	12	007	Bradford County, FL	1993	NA	9653	9053	600	6.2
CN1200900000000	12	009	Brevard County, FL	1993	NA	212712	196150	16562	7.8
CN1201100000000	12	011	Broward County, FL	1993	NA	712806	662029	50777	7.1
CN1201300000000	12	013	Calhoun County, FL	1993	NA	4457	4156	301	6.8
CN1201500000000	12	015	Charlotte County, FL	1993	NA	44968	42012	2956	6.6
CN1201700000000	12	017	Citrus County, FL	1993	NA	34453	31374	3079	8.9
CN1201900000000	12	019	Clay County, FL	1993	NA	58630	55709	2921	5
CN1202100000000	12	021	Collier County, FL	1993	NA	80525	73639	6886	8.6
CN1202300000000	12	023	Columbia County, FL	1993	NA	22053	19990	2063	9.4
CN1202700000000	12	027	DeSoto County, FL	1993	NA	10178	9127	1051	10.3
CN1202900000000	12	029	Dixie County, FL	1993	NA	3954	3609	345	8.7
CN1203100000000	12	031	Duval County, FL	1993	NA	361822	341294	20528	5.7
CN1203300000000	12	033	Escambia County, FL	1993	NA	123065	116742	6323	5.1
CN1203500000000	12	035	Flagler County, FL	1993	NA	13905	13073	832	6
CN1203700000000	12	037	Franklin County, FL	1993	NA	4447	4284	163	3.7
CN1203900000000	12	039	Gadsden County, FL	1993	NA	18938	17717	1221	6.4
CN1204100000000	12	041	Gilchrist County, FL	1993	NA	4215	3956	259	6.1
CN1204300000000	12	043	Glades County, FL	1993	NA	3486	3079	407	11.7
CN1204500000000	12	045	Gulf County, FL	1993	NA	5846	5419	427	7.3
CN1204700000000	12	047	Hamilton County, FL	1993	NA	3778	3169	609	16.1
CN1204900000000	12	049	Hardee County, FL	1993	NA	10423	8785	1638	15.7
CN1205100000000	12	051	Hendry County, FL	1993	NA	15721	13298	2423	15.4
CN1205300000000	12	053	Hernando County, FL	1993	NA	40122	37099	3023	7.5
CN1205500000000	12	055	Highlands County, FL	1993	NA	27377	24511	2866	10.5
CN1205700000000	12	057	Hillsborough County, FL	1993	NA	480840	449262	31578	6.6
CN1205900000000	12	059	Holmes County, FL	1993	NA	6580	6108	472	7.2
CN1206100000000	12	061	Indian River County, FL	1993	NA	40126	35505	4621	11.5
CN1206300000000	12	063	Jackson County, FL	1993	NA	19903	18605	1298	6.5
CN1206500000000	12	065	Jefferson County, FL	1993	NA	5610	5344	266	4.7
CN1206700000000	12	067	Lafayette County, FL	1993	NA	2351	2210	141	6
CN1206900000000	12	069	Lake County, FL	1993	NA	71310	66401	4909	6.9
CN1207100000000	12	071	Lee County, FL	1993	NA	165264	155513	9751	5.9
CN1207300000000	12	073	Leon County, FL	1993	NA	121340	116880	4460	3.7
CN1207500000000	12	075	Levy County, FL	1993	NA	11539	10767	772	6.7
CN1207700000000	12	077	Liberty County, FL	1993	NA	2292	2200	92	4
CN1207900000000	12	079	Madison County, FL	1993	NA	6978	6496	482	6.9
CN1208100000000	12	081	Manatee County, FL	1993	NA	98842	93469	5373	5.4
CN1208300000000	12	083	Marion County, FL	1993	NA	90860	83496	7364	8.1
CN1208500000000	12	085	Martin County, FL	1993	NA	46088	41470	4618	10
CN1208600000000	12	086	Miami-Dade County, FL	1993	NA	987593	911777	75816	7.7
CN1208700000000	12	087	Monroe County, FL	1993	NA	43277	41704	1573	3.6
CN1208900000000	12	089	Nassau County, FL	1993	NA	24545	23039	1506	6.1
CN1209100000000	12	091	Okaloosa County, FL	1993	NA	71868	67384	4484	6.2
CN1209300000000	12	093	Okeechobee County, FL	1993	NA	15318	13739	1579	10.3
CN1209500000000	12	095	Orange County, FL	1993	NA	417638	391034	26604	6.4
CN1209700000000	12	097	Osceola County, FL	1993	NA	66663	62313	4350	6.5
CN1209900000000	12	099	Palm Beach County, FL	1993	NA	455657	413471	42186	9.3
CN1210100000000	12	101	Pasco County, FL	1993	NA	115513	106603	8910	7.7
CN1210300000000	12	103	Pinellas County, FL	1993	NA	434160	407174	26986	6.2
CN1210500000000	12	105	Polk County, FL	1993	NA	200560	180573	19987	10
CN1210700000000	12	107	Putnam County, FL	1993	NA	30049	27689	2360	7.9
CN1210900000000	12	109	St. Johns County, FL	1993	NA	48958	46007	2951	6
CN1211100000000	12	111	St. Lucie County, FL	1993	NA	73815	63843	9972	13.5
CN1211300000000	12	113	Santa Rosa County, FL	1993	NA	44312	42243	2069	4.7
CN1211500000000	12	115	Sarasota County, FL	1993	NA	126895	120305	6590	5.2
CN1211700000000	12	117	Seminole County, FL	1993	NA	184094	173205	10889	5.9
CN1211900000000	12	119	Sumter County, FL	1993	NA	12227	11344	883	7.2
CN1212100000000	12	121	Suwannee County, FL	1993	NA	12670	11473	1197	9.4
CN1212300000000	12	123	Taylor County, FL	1993	NA	7846	6615	1231	15.7
CN1212500000000	12	125	Union County, FL	1993	NA	4008	3805	203	5.1
CN1212700000000	12	127	Volusia County, FL	1993	NA	176725	164620	12105	6.8
CN1212900000000	12	129	Wakulla County, FL	1993	NA	8885	8482	403	4.5
CN1213100000000	12	131	Walton County, FL	1993	NA	14212	13426	786	5.5
CN1213300000000	12	133	Washington County, FL	1993	NA	7952	7320	632	7.9
CN1300100000000	13	001	Appling County, GA	1993	NA	8261	7335	926	11.2
CN1300300000000	13	003	Atkinson County, GA	1993	NA	2844	2604	240	8.4
CN1300500000000	13	005	Bacon County, GA	1993	NA	4512	4157	355	7.9
CN1300700000000	13	007	Baker County, GA	1993	NA	1343	1137	206	15.3
CN1300900000000	13	009	Baldwin County, GA	1993	NA	17048	16253	795	4.7
CN1301100000000	13	011	Banks County, GA	1993	NA	5801	5481	320	5.5
CN1301300000000	13	013	Barrow County, GA	1993	NA	16379	15264	1115	6.8
CN1301500000000	13	015	Bartow County, GA	1993	NA	31166	28954	2212	7.1
CN1301700000000	13	017	Ben Hill County, GA	1993	NA	7961	7364	597	7.5
CN1301900000000	13	019	Berrien County, GA	1993	NA	6418	5899	519	8.1
CN1302100000000	13	021	Bibb County, GA	1993	NA	69920	65609	4311	6.2
CN1302300000000	13	023	Bleckley County, GA	1993	NA	4950	4707	243	4.9
CN1302500000000	13	025	Brantley County, GA	1993	NA	5026	4576	450	9
CN1302700000000	13	027	Brooks County, GA	1993	NA	6566	6259	307	4.7
CN1302900000000	13	029	Bryan County, GA	1993	NA	8369	7970	399	4.8
CN1303100000000	13	031	Bulloch County, GA	1993	NA	20533	19782	751	3.7
CN1303300000000	13	033	Burke County, GA	1993	NA	8530	7475	1055	12.4
CN1303500000000	13	035	Butts County, GA	1993	NA	7121	6644	477	6.7
CN1303700000000	13	037	Calhoun County, GA	1993	NA	2084	1782	302	14.5
CN1303900000000	13	039	Camden County, GA	1993	NA	15058	14395	663	4.4
CN1304300000000	13	043	Candler County, GA	1993	NA	3741	3567	174	4.7
CN1304500000000	13	045	Carroll County, GA	1993	NA	37690	35372	2318	6.2
CN1304700000000	13	047	Catoosa County, GA	1993	NA	23094	21985	1109	4.8
CN1304900000000	13	049	Charlton County, GA	1993	NA	3889	3661	228	5.9
CN1305100000000	13	051	Chatham County, GA	1993	NA	102863	96425	6438	6.3
CN1305300000000	13	053	Chattahoochee County, GA	1993	NA	2059	1877	182	8.8
CN1305500000000	13	055	Chattooga County, GA	1993	NA	11799	11088	711	6
CN1305700000000	13	057	Cherokee County, GA	1993	NA	56874	54442	2432	4.3
CN1305900000000	13	059	Clarke County, GA	1993	NA	42806	41051	1755	4.1
CN1306100000000	13	061	Clay County, GA	1993	NA	1466	1349	117	8
CN1306300000000	13	063	Clayton County, GA	1993	NA	107045	100246	6799	6.4
CN1306500000000	13	065	Clinch County, GA	1993	NA	3524	3381	143	4.1
CN1306700000000	13	067	Cobb County, GA	1993	NA	289740	275925	13815	4.8
CN1306900000000	13	069	Coffee County, GA	1993	NA	15476	14363	1113	7.2
CN1307100000000	13	071	Colquitt County, GA	1993	NA	16986	16021	965	5.7
CN1307300000000	13	073	Columbia County, GA	1993	NA	37959	36027	1932	5.1
CN1307500000000	13	075	Cook County, GA	1993	NA	6900	6414	486	7
CN1307700000000	13	077	Coweta County, GA	1993	NA	31632	29879	1753	5.5
CN1307900000000	13	079	Crawford County, GA	1993	NA	4917	4572	345	7
CN1308100000000	13	081	Crisp County, GA	1993	NA	9124	8468	656	7.2
CN1308300000000	13	083	Dade County, GA	1993	NA	6508	6161	347	5.3
CN1308500000000	13	085	Dawson County, GA	1993	NA	6757	6420	337	5
CN1308700000000	13	087	Decatur County, GA	1993	NA	10920	9977	943	8.6
CN1308900000000	13	089	DeKalb County, GA	1993	NA	327039	307751	19288	5.9
CN1309100000000	13	091	Dodge County, GA	1993	NA	8823	8241	582	6.6
CN1309300000000	13	093	Dooly County, GA	1993	NA	4292	3974	318	7.4
CN1309500000000	13	095	Dougherty County, GA	1993	NA	43788	39650	4138	9.5
CN1309700000000	13	097	Douglas County, GA	1993	NA	42162	40150	2012	4.8
CN1309900000000	13	099	Early County, GA	1993	NA	5172	4657	515	10
CN1310100000000	13	101	Echols County, GA	1993	NA	1017	939	78	7.7
CN1310300000000	13	103	Effingham County, GA	1993	NA	13497	12838	659	4.9
CN1310500000000	13	105	Elbert County, GA	1993	NA	8561	7720	841	9.8
CN1310700000000	13	107	Emanuel County, GA	1993	NA	8569	7647	922	10.8
CN1310900000000	13	109	Evans County, GA	1993	NA	4358	3954	404	9.3
CN1311100000000	13	111	Fannin County, GA	1993	NA	7942	7314	628	7.9
CN1311300000000	13	113	Fayette County, GA	1993	NA	37763	36488	1275	3.4
CN1311500000000	13	115	Floyd County, GA	1993	NA	44443	41479	2964	6.7
CN1311700000000	13	117	Forsyth County, GA	1993	NA	28466	27343	1123	3.9
CN1311900000000	13	119	Franklin County, GA	1993	NA	8948	8358	590	6.6
CN1312100000000	13	121	Fulton County, GA	1993	NA	352098	329009	23089	6.6
CN1312300000000	13	123	Gilmer County, GA	1993	NA	6694	6166	528	7.9
CN1312500000000	13	125	Glascock County, GA	1993	NA	1158	1084	74	6.4
CN1312700000000	13	127	Glynn County, GA	1993	NA	31844	30390	1454	4.6
CN1312900000000	13	129	Gordon County, GA	1993	NA	19820	18465	1355	6.8
CN1313100000000	13	131	Grady County, GA	1993	NA	9737	8977	760	7.8
CN1313300000000	13	133	Greene County, GA	1993	NA	5106	4534	572	11.2
CN1313500000000	13	135	Gwinnett County, GA	1993	NA	244829	234262	10567	4.3
CN1313700000000	13	137	Habersham County, GA	1993	NA	14387	13736	651	4.5
CN1313900000000	13	139	Hall County, GA	1993	NA	58941	56214	2727	4.6
CN1314100000000	13	141	Hancock County, GA	1993	NA	3903	3535	368	9.4
CN1314300000000	13	143	Haralson County, GA	1993	NA	9202	8293	909	9.9
CN1314500000000	13	145	Harris County, GA	1993	NA	8999	8575	424	4.7
CN1314700000000	13	147	Hart County, GA	1993	NA	9120	8443	677	7.4
CN1314900000000	13	149	Heard County, GA	1993	NA	4015	3706	309	7.7
CN1315100000000	13	151	Henry County, GA	1993	NA	38564	36916	1648	4.3
CN1315300000000	13	153	Houston County, GA	1993	NA	44826	42517	2309	5.2
CN1315500000000	13	155	Irwin County, GA	1993	NA	4091	3838	253	6.2
CN1315700000000	13	157	Jackson County, GA	1993	NA	16597	15714	883	5.3
CN1315900000000	13	159	Jasper County, GA	1993	NA	3834	3525	309	8.1
CN1316100000000	13	161	Jeff Davis County, GA	1993	NA	5635	5155	480	8.5
CN1316300000000	13	163	Jefferson County, GA	1993	NA	7862	7248	614	7.8
CN1316500000000	13	165	Jenkins County, GA	1993	NA	3904	3660	244	6.3
CN1316700000000	13	167	Johnson County, GA	1993	NA	3906	3652	254	6.5
CN1316900000000	13	169	Jones County, GA	1993	NA	10740	10191	549	5.1
CN1317100000000	13	171	Lamar County, GA	1993	NA	6795	6437	358	5.3
CN1317300000000	13	173	Lanier County, GA	1993	NA	2695	2549	146	5.4
CN1317500000000	13	175	Laurens County, GA	1993	NA	20147	19071	1076	5.3
CN1317700000000	13	177	Lee County, GA	1993	NA	8847	8315	532	6
CN1317900000000	13	179	Liberty County, GA	1993	NA	15109	13668	1441	9.5
CN1318100000000	13	181	Lincoln County, GA	1993	NA	3839	3594	245	6.4
CN1318300000000	13	183	Long County, GA	1993	NA	2695	2550	145	5.4
CN1318500000000	13	185	Lowndes County, GA	1993	NA	36099	34080	2019	5.6
CN1318700000000	13	187	Lumpkin County, GA	1993	NA	7706	7342	364	4.7
CN1318900000000	13	189	McDuffie County, GA	1993	NA	9443	8783	660	7
CN1319100000000	13	191	McIntosh County, GA	1993	NA	3446	3196	250	7.3
CN1319300000000	13	193	Macon County, GA	1993	NA	5732	4938	794	13.9
CN1319500000000	13	195	Madison County, GA	1993	NA	11622	11073	549	4.7
CN1319700000000	13	197	Marion County, GA	1993	NA	3280	3053	227	6.9
CN1319900000000	13	199	Meriwether County, GA	1993	NA	9268	8419	849	9.2
CN1320100000000	13	201	Miller County, GA	1993	NA	2937	2703	234	8
CN1320500000000	13	205	Mitchell County, GA	1993	NA	9479	8451	1028	10.8
CN1320700000000	13	207	Monroe County, GA	1993	NA	7748	7256	492	6.4
CN1320900000000	13	209	Montgomery County, GA	1993	NA	3389	3114	275	8.1
CN1321100000000	13	211	Morgan County, GA	1993	NA	6262	5834	428	6.8
CN1321300000000	13	213	Murray County, GA	1993	NA	16356	15499	857	5.2
CN1321500000000	13	215	Muscogee County, GA	1993	NA	77944	72691	5253	6.7
CN1321700000000	13	217	Newton County, GA	1993	NA	22315	20951	1364	6.1
CN1321900000000	13	219	Oconee County, GA	1993	NA	10073	9773	300	3
CN1322100000000	13	221	Oglethorpe County, GA	1993	NA	5043	4688	355	7
CN1322300000000	13	223	Paulding County, GA	1993	NA	26527	25261	1266	4.8
CN1322500000000	13	225	Peach County, GA	1993	NA	9853	9072	781	7.9
CN1322700000000	13	227	Pickens County, GA	1993	NA	7926	7395	531	6.7
CN1322900000000	13	229	Pierce County, GA	1993	NA	6779	6247	532	7.8
CN1323100000000	13	231	Pike County, GA	1993	NA	5050	4695	355	7
CN1323300000000	13	233	Polk County, GA	1993	NA	15656	13871	1785	11.4
CN1323500000000	13	235	Pulaski County, GA	1993	NA	4014	3803	211	5.3
CN1323700000000	13	237	Putnam County, GA	1993	NA	7384	7057	327	4.4
CN1323900000000	13	239	Quitman County, GA	1993	NA	1018	939	79	7.8
CN1324100000000	13	241	Rabun County, GA	1993	NA	6108	5584	524	8.6
CN1324300000000	13	243	Randolph County, GA	1993	NA	3175	2899	276	8.7
CN1324500000000	13	245	Richmond County, GA	1993	NA	84852	77959	6893	8.1
CN1324700000000	13	247	Rockdale County, GA	1993	NA	32846	31350	1496	4.6
CN1324900000000	13	249	Schley County, GA	1993	NA	1490	1380	110	7.4
CN1325100000000	13	251	Screven County, GA	1993	NA	6573	6088	485	7.4
CN1325300000000	13	253	Seminole County, GA	1993	NA	4352	4001	351	8.1
CN1325500000000	13	255	Spalding County, GA	1993	NA	27415	25681	1734	6.3
CN1325700000000	13	257	Stephens County, GA	1993	NA	12451	11647	804	6.5
CN1325900000000	13	259	Stewart County, GA	1993	NA	2366	2195	171	7.2
CN1326100000000	13	261	Sumter County, GA	1993	NA	14046	12928	1118	8
CN1326300000000	13	263	Talbot County, GA	1993	NA	2487	2281	206	8.3
CN1326500000000	13	265	Taliaferro County, GA	1993	NA	702	651	51	7.3
CN1326700000000	13	267	Tattnall County, GA	1993	NA	6788	6278	510	7.5
CN1326900000000	13	269	Taylor County, GA	1993	NA	3378	3030	348	10.3
CN1327100000000	13	271	Telfair County, GA	1993	NA	4896	4472	424	8.7
CN1327300000000	13	273	Terrell County, GA	1993	NA	4641	4194	447	9.6
CN1327500000000	13	275	Thomas County, GA	1993	NA	18863	17785	1078	5.7
CN1327700000000	13	277	Tift County, GA	1993	NA	18832	17393	1439	7.6
CN1327900000000	13	279	Toombs County, GA	1993	NA	11032	10038	994	9
CN1328100000000	13	281	Towns County, GA	1993	NA	2762	2534	228	8.3
CN1328300000000	13	283	Treutlen County, GA	1993	NA	2616	2369	247	9.4
CN1328500000000	13	285	Troup County, GA	1993	NA	25917	23714	2203	8.5
CN1328700000000	13	287	Turner County, GA	1993	NA	3954	3647	307	7.8
CN1328900000000	13	289	Twiggs County, GA	1993	NA	3879	3639	240	6.2
CN1329100000000	13	291	Union County, GA	1993	NA	6065	5682	383	6.3
CN1329300000000	13	293	Upson County, GA	1993	NA	12872	12110	762	5.9
CN1329500000000	13	295	Walker County, GA	1993	NA	29501	27700	1801	6.1
CN1329700000000	13	297	Walton County, GA	1993	NA	21000	19661	1339	6.4
CN1329900000000	13	299	Ware County, GA	1993	NA	15100	14063	1037	6.9
CN1330100000000	13	301	Warren County, GA	1993	NA	2483	2274	209	8.4
CN1330300000000	13	303	Washington County, GA	1993	NA	8950	8536	414	4.6
CN1330500000000	13	305	Wayne County, GA	1993	NA	11196	10090	1106	9.9
CN1330700000000	13	307	Webster County, GA	1993	NA	1119	1062	57	5.1
CN1330900000000	13	309	Wheeler County, GA	1993	NA	2037	1900	137	6.7
CN1331100000000	13	311	White County, GA	1993	NA	8109	7750	359	4.4
CN1331300000000	13	313	Whitfield County, GA	1993	NA	42987	40996	1991	4.6
CN1331500000000	13	315	Wilcox County, GA	1993	NA	3018	2821	197	6.5
CN1331700000000	13	317	Wilkes County, GA	1993	NA	5332	5003	329	6.2
CN1331900000000	13	319	Wilkinson County, GA	1993	NA	4548	4291	257	5.7
CN1332100000000	13	321	Worth County, GA	1993	NA	9272	8625	647	7
CN1500100000000	15	001	Hawaii County, HI	1993	NA	65430	60327	5103	7.8
CN1500300000000	15	003	Honolulu County/city, HI	1993	NA	426442	412676	13766	3.2
CN1500700000000	15	007	Kauai County, HI	1993	NA	28465	24678	3787	13.3
CN1500900000000	15	009	Maui County, HI	1993	NA	66067	62433	3634	5.5
CN1600100000000	16	001	Ada County, ID	1993	NA	129844	124839	5005	3.9
CN1600300000000	16	003	Adams County, ID	1993	NA	1692	1455	237	14
CN1600500000000	16	005	Bannock County, ID	1993	NA	35578	33375	2203	6.2
CN1600700000000	16	007	Bear Lake County, ID	1993	NA	2751	2594	157	5.7
CN1600900000000	16	009	Benewah County, ID	1993	NA	3940	3529	411	10.4
CN1601100000000	16	011	Bingham County, ID	1993	NA	20417	19278	1139	5.6
CN1601300000000	16	013	Blaine County, ID	1993	NA	8897	8389	508	5.7
CN1601500000000	16	015	Boise County, ID	1993	NA	2185	2033	152	7
CN1601700000000	16	017	Bonner County, ID	1993	NA	14584	13196	1388	9.5
CN1601900000000	16	019	Bonneville County, ID	1993	NA	43341	41512	1829	4.2
CN1602100000000	16	021	Boundary County, ID	1993	NA	3995	3636	359	9
CN1602300000000	16	023	Butte County, ID	1993	NA	1572	1477	95	6
CN1602500000000	16	025	Camas County, ID	1993	NA	399	380	19	4.8
CN1602700000000	16	027	Canyon County, ID	1993	NA	49089	45955	3134	6.4
CN1602900000000	16	029	Caribou County, ID	1993	NA	3296	3069	227	6.9
CN1603100000000	16	031	Cassia County, ID	1993	NA	8652	7932	720	8.3
CN1603300000000	16	033	Clark County, ID	1993	NA	433	409	24	5.5
CN1603500000000	16	035	Clearwater County, ID	1993	NA	4119	3492	627	15.2
CN1603700000000	16	037	Custer County, ID	1993	NA	1711	1458	253	14.8
CN1603900000000	16	039	Elmore County, ID	1993	NA	7750	7211	539	7
CN1604100000000	16	041	Franklin County, ID	1993	NA	3988	3855	133	3.3
CN1604300000000	16	043	Fremont County, ID	1993	NA	4482	4090	392	8.7
CN1604500000000	16	045	Gem County, ID	1993	NA	5373	4969	404	7.5
CN1604700000000	16	047	Gooding County, ID	1993	NA	5444	5163	281	5.2
CN1604900000000	16	049	Idaho County, ID	1993	NA	6549	5727	822	12.6
CN1605100000000	16	051	Jefferson County, ID	1993	NA	8995	8524	471	5.2
CN1605300000000	16	053	Jerome County, ID	1993	NA	7313	6852	461	6.3
CN1605500000000	16	055	Kootenai County, ID	1993	NA	43571	40192	3379	7.8
CN1605700000000	16	057	Latah County, ID	1993	NA	15484	14971	513	3.3
CN1605900000000	16	059	Lemhi County, ID	1993	NA	3530	3162	368	10.4
CN1606100000000	16	061	Lewis County, ID	1993	NA	1591	1461	130	8.2
CN1606300000000	16	063	Lincoln County, ID	1993	NA	1690	1591	99	5.9
CN1606500000000	16	065	Madison County, ID	1993	NA	8938	8670	268	3
CN1606700000000	16	067	Minidoka County, ID	1993	NA	9281	8467	814	8.8
CN1606900000000	16	069	Nez Perce County, ID	1993	NA	21705	20888	817	3.8
CN1607100000000	16	071	Oneida County, ID	1993	NA	1366	1319	47	3.4
CN1607300000000	16	073	Owyhee County, ID	1993	NA	3460	3273	187	5.4
CN1607500000000	16	075	Payette County, ID	1993	NA	9641	8841	800	8.3
CN1607700000000	16	077	Power County, ID	1993	NA	3757	3560	197	5.2
CN1607900000000	16	079	Shoshone County, ID	1993	NA	6793	5853	940	13.8
CN1608100000000	16	081	Teton County, ID	1993	NA	2008	1929	79	3.9
CN1608300000000	16	083	Twin Falls County, ID	1993	NA	26587	24879	1708	6.4
CN1608500000000	16	085	Valley County, ID	1993	NA	3914	3489	425	10.9
CN1608700000000	16	087	Washington County, ID	1993	NA	4400	4018	382	8.7
CN1700100000000	17	001	Adams County, IL	1993	NA	35672	33560	2112	5.9
CN1700300000000	17	003	Alexander County, IL	1993	NA	4179	3665	514	12.3
CN1700500000000	17	005	Bond County, IL	1993	NA	7551	7016	535	7.1
CN1700700000000	17	007	Boone County, IL	1993	NA	19316	17142	2174	11.3
CN1700900000000	17	009	Brown County, IL	1993	NA	2542	2409	133	5.2
CN1701100000000	17	011	Bureau County, IL	1993	NA	18859	17667	1192	6.3
CN1701300000000	17	013	Calhoun County, IL	1993	NA	2855	2472	383	13.4
CN1701500000000	17	015	Carroll County, IL	1993	NA	8827	8239	588	6.7
CN1701700000000	17	017	Cass County, IL	1993	NA	7369	6912	457	6.2
CN1701900000000	17	019	Champaign County, IL	1993	NA	94348	90296	4052	4.3
CN1702100000000	17	021	Christian County, IL	1993	NA	18414	17158	1256	6.8
CN1702300000000	17	023	Clark County, IL	1993	NA	9593	9077	516	5.4
CN1702500000000	17	025	Clay County, IL	1993	NA	6656	6106	550	8.3
CN1702700000000	17	027	Clinton County, IL	1993	NA	16712	15635	1077	6.4
CN1702900000000	17	029	Coles County, IL	1993	NA	26816	25481	1335	5
CN1703100000000	17	031	Cook County, IL	1993	NA	2636393	2410985	225408	8.5
CN1703300000000	17	033	Crawford County, IL	1993	NA	10644	9968	676	6.4
CN1703500000000	17	035	Cumberland County, IL	1993	NA	5353	5024	329	6.1
CN1703700000000	17	037	DeKalb County, IL	1993	NA	43829	41190	2639	6
CN1703900000000	17	039	De Witt County, IL	1993	NA	9564	8975	589	6.2
CN1704100000000	17	041	Douglas County, IL	1993	NA	10722	10073	649	6.1
CN1704300000000	17	043	DuPage County, IL	1993	NA	481359	454734	26625	5.5
CN1704500000000	17	045	Edgar County, IL	1993	NA	8961	8276	685	7.6
CN1704700000000	17	047	Edwards County, IL	1993	NA	3739	3516	223	6
CN1704900000000	17	049	Effingham County, IL	1993	NA	17124	16056	1068	6.2
CN1705100000000	17	051	Fayette County, IL	1993	NA	10312	9509	803	7.8
CN1705300000000	17	053	Ford County, IL	1993	NA	6996	6521	475	6.8
CN1705500000000	17	055	Franklin County, IL	1993	NA	16798	14665	2133	12.7
CN1705700000000	17	057	Fulton County, IL	1993	NA	15144	13736	1408	9.3
CN1705900000000	17	059	Gallatin County, IL	1993	NA	3032	2631	401	13.2
CN1706100000000	17	061	Greene County, IL	1993	NA	7093	6666	427	6
CN1706300000000	17	063	Grundy County, IL	1993	NA	17934	15919	2015	11.2
CN1706500000000	17	065	Hamilton County, IL	1993	NA	3751	3341	410	10.9
CN1706700000000	17	067	Hancock County, IL	1993	NA	11387	10707	680	6
CN1706900000000	17	069	Hardin County, IL	1993	NA	1978	1789	189	9.6
CN1707100000000	17	071	Henderson County, IL	1993	NA	4916	4622	294	6
CN1707300000000	17	073	Henry County, IL	1993	NA	25996	24461	1535	5.9
CN1707500000000	17	075	Iroquois County, IL	1993	NA	17474	16609	865	5
CN1707700000000	17	077	Jackson County, IL	1993	NA	29702	27768	1934	6.5
CN1707900000000	17	079	Jasper County, IL	1993	NA	4979	4671	308	6.2
CN1708100000000	17	081	Jefferson County, IL	1993	NA	18117	16431	1686	9.3
CN1708300000000	17	083	Jersey County, IL	1993	NA	10420	9617	803	7.7
CN1708500000000	17	085	Jo Daviess County, IL	1993	NA	12959	12382	577	4.5
CN1708700000000	17	087	Johnson County, IL	1993	NA	4403	3886	517	11.7
CN1708900000000	17	089	Kane County, IL	1993	NA	185224	171508	13716	7.4
CN1709100000000	17	091	Kankakee County, IL	1993	NA	50361	46662	3699	7.3
CN1709300000000	17	093	Kendall County, IL	1993	NA	23462	22152	1310	5.6
CN1709500000000	17	095	Knox County, IL	1993	NA	29571	27774	1797	6.1
CN1709700000000	17	097	Lake County, IL	1993	NA	296228	281108	15120	5.1
CN1709900000000	17	099	LaSalle County, IL	1993	NA	55732	50529	5203	9.3
CN1710100000000	17	101	Lawrence County, IL	1993	NA	7248	6714	534	7.4
CN1710300000000	17	103	Lee County, IL	1993	NA	17207	16185	1022	5.9
CN1710500000000	17	105	Livingston County, IL	1993	NA	20219	19332	887	4.4
CN1710700000000	17	107	Logan County, IL	1993	NA	13632	12877	755	5.5
CN1710900000000	17	109	McDonough County, IL	1993	NA	18619	18031	588	3.2
CN1711100000000	17	111	McHenry County, IL	1993	NA	115325	107773	7552	6.5
CN1711300000000	17	113	McLean County, IL	1993	NA	77113	74337	2776	3.6
CN1711500000000	17	115	Macon County, IL	1993	NA	60810	55596	5214	8.6
CN1711700000000	17	117	Macoupin County, IL	1993	NA	23551	21733	1818	7.7
CN1711900000000	17	119	Madison County, IL	1993	NA	126392	117801	8591	6.8
CN1712100000000	17	121	Marion County, IL	1993	NA	21246	19117	2129	10
CN1712300000000	17	123	Marshall County, IL	1993	NA	6631	6265	366	5.5
CN1712500000000	17	125	Mason County, IL	1993	NA	8246	7489	757	9.2
CN1712700000000	17	127	Massac County, IL	1993	NA	7724	7219	505	6.5
CN1712900000000	17	129	Menard County, IL	1993	NA	6129	5838	291	4.7
CN1713100000000	17	131	Mercer County, IL	1993	NA	8843	8170	673	7.6
CN1713300000000	17	133	Monroe County, IL	1993	NA	12495	11861	634	5.1
CN1713500000000	17	135	Montgomery County, IL	1993	NA	14541	13238	1303	9
CN1713700000000	17	137	Morgan County, IL	1993	NA	18908	17996	912	4.8
CN1713900000000	17	139	Moultrie County, IL	1993	NA	7927	7448	479	6
CN1714100000000	17	141	Ogle County, IL	1993	NA	26156	24351	1805	6.9
CN1714300000000	17	143	Peoria County, IL	1993	NA	92465	86752	5713	6.2
CN1714500000000	17	145	Perry County, IL	1993	NA	8288	7014	1274	15.4
CN1714700000000	17	147	Piatt County, IL	1993	NA	8649	8086	563	6.5
CN1714900000000	17	149	Pike County, IL	1993	NA	8896	8263	633	7.1
CN1715100000000	17	151	Pope County, IL	1993	NA	1686	1481	205	12.2
CN1715300000000	17	153	Pulaski County, IL	1993	NA	2975	2592	383	12.9
CN1715500000000	17	155	Putnam County, IL	1993	NA	3094	2863	231	7.5
CN1715700000000	17	157	Randolph County, IL	1993	NA	15136	13636	1500	9.9
CN1715900000000	17	159	Richland County, IL	1993	NA	9901	9461	440	4.4
CN1716100000000	17	161	Rock Island County, IL	1993	NA	75191	70343	4848	6.4
CN1716300000000	17	163	St. Clair County, IL	1993	NA	117480	108975	8505	7.2
CN1716500000000	17	165	Saline County, IL	1993	NA	11239	9628	1611	14.3
CN1716700000000	17	167	Sangamon County, IL	1993	NA	102535	97832	4703	4.6
CN1716900000000	17	169	Schuyler County, IL	1993	NA	3697	3461	236	6.4
CN1717100000000	17	171	Scott County, IL	1993	NA	2845	2660	185	6.5
CN1717300000000	17	173	Shelby County, IL	1993	NA	10998	10279	719	6.5
CN1717500000000	17	175	Stark County, IL	1993	NA	2848	2646	202	7.1
CN1717700000000	17	177	Stephenson County, IL	1993	NA	26326	24727	1599	6.1
CN1717900000000	17	179	Tazewell County, IL	1993	NA	66220	62175	4045	6.1
CN1718100000000	17	181	Union County, IL	1993	NA	8546	7369	1177	13.8
CN1718300000000	17	183	Vermilion County, IL	1993	NA	41917	37853	4064	9.7
CN1718500000000	17	185	Wabash County, IL	1993	NA	6159	5612	547	8.9
CN1718700000000	17	187	Warren County, IL	1993	NA	10112	9483	629	6.2
CN1718900000000	17	189	Washington County, IL	1993	NA	7915	7430	485	6.1
CN1719100000000	17	191	Wayne County, IL	1993	NA	8223	7543	680	8.3
CN1719300000000	17	193	White County, IL	1993	NA	7561	6833	728	9.6
CN1719500000000	17	195	Whiteside County, IL	1993	NA	31119	29271	1848	5.9
CN1719700000000	17	197	Will County, IL	1993	NA	201255	185570	15685	7.8
CN1719900000000	17	199	Williamson County, IL	1993	NA	27552	24465	3087	11.2
CN1720100000000	17	201	Winnebago County, IL	1993	NA	143982	133052	10930	7.6
CN1720300000000	17	203	Woodford County, IL	1993	NA	17361	16717	644	3.7
CN1800100000000	18	001	Adams County, IN	1993	NA	15544	14757	787	5.1
CN1800300000000	18	003	Allen County, IN	1993	NA	167741	159081	8660	5.2
CN1800500000000	18	005	Bartholomew County, IN	1993	NA	36802	35331	1471	4
CN1800700000000	18	007	Benton County, IN	1993	NA	5100	4833	267	5.2
CN1800900000000	18	009	Blackford County, IN	1993	NA	6138	5504	634	10.3
CN1801100000000	18	011	Boone County, IN	1993	NA	21689	21016	673	3.1
CN1801300000000	18	013	Brown County, IN	1993	NA	7973	7747	226	2.8
CN1801500000000	18	015	Carroll County, IN	1993	NA	11018	10532	486	4.4
CN1801700000000	18	017	Cass County, IN	1993	NA	18902	17522	1380	7.3
CN1801900000000	18	019	Clark County, IN	1993	NA	47886	45425	2461	5.1
CN1802100000000	18	021	Clay County, IN	1993	NA	12269	11552	717	5.8
CN1802300000000	18	023	Clinton County, IN	1993	NA	15194	14520	674	4.4
CN1802500000000	18	025	Crawford County, IN	1993	NA	4730	4204	526	11.1
CN1802700000000	18	027	Daviess County, IN	1993	NA	13122	12453	669	5.1
CN1802900000000	18	029	Dearborn County, IN	1993	NA	20646	19184	1462	7.1
CN1803100000000	18	031	Decatur County, IN	1993	NA	14047	13512	535	3.8
CN1803300000000	18	033	DeKalb County, IN	1993	NA	20081	19084	997	5
CN1803500000000	18	035	Delaware County, IN	1993	NA	62614	58663	3951	6.3
CN1803700000000	18	037	Dubois County, IN	1993	NA	21372	20700	672	3.1
CN1803900000000	18	039	Elkhart County, IN	1993	NA	88372	85001	3371	3.8
CN1804100000000	18	041	Fayette County, IN	1993	NA	12784	11613	1171	9.2
CN1804300000000	18	043	Floyd County, IN	1993	NA	34890	33443	1447	4.1
CN1804500000000	18	045	Fountain County, IN	1993	NA	8614	7945	669	7.8
CN1804700000000	18	047	Franklin County, IN	1993	NA	10016	9314	702	7
CN1804900000000	18	049	Fulton County, IN	1993	NA	9904	9333	571	5.8
CN1805100000000	18	051	Gibson County, IN	1993	NA	16506	15266	1240	7.5
CN1805300000000	18	053	Grant County, IN	1993	NA	35890	33067	2823	7.9
CN1805500000000	18	055	Greene County, IN	1993	NA	15289	13946	1343	8.8
CN1805700000000	18	057	Hamilton County, IN	1993	NA	70904	69277	1627	2.3
CN1805900000000	18	059	Hancock County, IN	1993	NA	25872	24952	920	3.6
CN1806100000000	18	061	Harrison County, IN	1993	NA	15924	15218	706	4.4
CN1806300000000	18	063	Hendricks County, IN	1993	NA	43836	42746	1090	2.5
CN1806500000000	18	065	Henry County, IN	1993	NA	24308	22364	1944	8
CN1806700000000	18	067	Howard County, IN	1993	NA	42425	39882	2543	6
CN1806900000000	18	069	Huntington County, IN	1993	NA	19433	18483	950	4.9
CN1807100000000	18	071	Jackson County, IN	1993	NA	20185	19084	1101	5.5
CN1807300000000	18	073	Jasper County, IN	1993	NA	13029	12136	893	6.9
CN1807500000000	18	075	Jay County, IN	1993	NA	11168	10292	876	7.8
CN1807700000000	18	077	Jefferson County, IN	1993	NA	14616	13784	832	5.7
CN1807900000000	18	079	Jennings County, IN	1993	NA	12836	12265	571	4.4
CN1808100000000	18	081	Johnson County, IN	1993	NA	52690	50958	1732	3.3
CN1808300000000	18	083	Knox County, IN	1993	NA	19756	18843	913	4.6
CN1808500000000	18	085	Kosciusko County, IN	1993	NA	35516	33887	1629	4.6
CN1808700000000	18	087	LaGrange County, IN	1993	NA	15055	14379	676	4.5
CN1808900000000	18	089	Lake County, IN	1993	NA	227001	209571	17430	7.7
CN1809100000000	18	091	LaPorte County, IN	1993	NA	53897	50561	3336	6.2
CN1809300000000	18	093	Lawrence County, IN	1993	NA	22780	20976	1804	7.9
CN1809500000000	18	095	Madison County, IN	1993	NA	64765	60800	3965	6.1
CN1809700000000	18	097	Marion County, IN	1993	NA	438377	418102	20275	4.6
CN1809900000000	18	099	Marshall County, IN	1993	NA	24410	23301	1109	4.5
CN1810100000000	18	101	Martin County, IN	1993	NA	5098	4790	308	6
CN1810300000000	18	103	Miami County, IN	1993	NA	16153	15118	1035	6.4
CN1810500000000	18	105	Monroe County, IN	1993	NA	57773	55488	2285	4
CN1810700000000	18	107	Montgomery County, IN	1993	NA	19529	18896	633	3.2
CN1810900000000	18	109	Morgan County, IN	1993	NA	31083	29705	1378	4.4
CN1811100000000	18	111	Newton County, IN	1993	NA	6764	6379	385	5.7
CN1811300000000	18	113	Noble County, IN	1993	NA	21998	20930	1068	4.9
CN1811500000000	18	115	Ohio County, IN	1993	NA	2607	2457	150	5.8
CN1811700000000	18	117	Orange County, IN	1993	NA	9216	8331	885	9.6
CN1811900000000	18	119	Owen County, IN	1993	NA	9802	9226	576	5.9
CN1812100000000	18	121	Parke County, IN	1993	NA	7642	7135	507	6.6
CN1812300000000	18	123	Perry County, IN	1993	NA	9203	8418	785	8.5
CN1812500000000	18	125	Pike County, IN	1993	NA	6071	5694	377	6.2
CN1812700000000	18	127	Porter County, IN	1993	NA	70091	66375	3716	5.3
CN1812900000000	18	129	Posey County, IN	1993	NA	13352	12796	556	4.2
CN1813100000000	18	131	Pulaski County, IN	1993	NA	6024	5605	419	7
CN1813300000000	18	133	Putnam County, IN	1993	NA	15761	15152	609	3.9
CN1813500000000	18	135	Randolph County, IN	1993	NA	12072	10779	1293	10.7
CN1813700000000	18	137	Ripley County, IN	1993	NA	12816	11984	832	6.5
CN1813900000000	18	139	Rush County, IN	1993	NA	9471	8910	561	5.9
CN1814100000000	18	141	St. Joseph County, IN	1993	NA	128351	121481	6870	5.4
CN1814300000000	18	143	Scott County, IN	1993	NA	10045	9417	628	6.3
CN1814500000000	18	145	Shelby County, IN	1993	NA	22096	20995	1101	5
CN1814700000000	18	147	Spencer County, IN	1993	NA	10375	9673	702	6.8
CN1814900000000	18	149	Starke County, IN	1993	NA	10677	9914	763	7.1
CN1815100000000	18	151	Steuben County, IN	1993	NA	16084	15333	751	4.7
CN1815300000000	18	153	Sullivan County, IN	1993	NA	9762	8888	874	9
CN1815500000000	18	155	Switzerland County, IN	1993	NA	3964	3732	232	5.9
CN1815700000000	18	157	Tippecanoe County, IN	1993	NA	68446	66254	2192	3.2
CN1815900000000	18	159	Tipton County, IN	1993	NA	8724	8296	428	4.9
CN1816100000000	18	161	Union County, IN	1993	NA	3685	3450	235	6.4
CN1816300000000	18	163	Vanderburgh County, IN	1993	NA	88621	83656	4965	5.6
CN1816500000000	18	165	Vermillion County, IN	1993	NA	8055	7366	689	8.6
CN1816700000000	18	167	Vigo County, IN	1993	NA	53067	49507	3560	6.7
CN1816900000000	18	169	Wabash County, IN	1993	NA	17914	16926	988	5.5
CN1817100000000	18	171	Warren County, IN	1993	NA	3874	3656	218	5.6
CN1817300000000	18	173	Warrick County, IN	1993	NA	25821	24499	1322	5.1
CN1817500000000	18	175	Washington County, IN	1993	NA	11194	10370	824	7.4
CN1817700000000	18	177	Wayne County, IN	1993	NA	37366	33872	3494	9.4
CN1817900000000	18	179	Wells County, IN	1993	NA	13955	13368	587	4.2
CN1818100000000	18	181	White County, IN	1993	NA	14491	13664	827	5.7
CN1818300000000	18	183	Whitley County, IN	1993	NA	15300	14641	659	4.3
CN1900100000000	19	001	Adair County, IA	1993	NA	4144	4007	137	3.3
CN1900300000000	19	003	Adams County, IA	1993	NA	2367	2287	80	3.4
CN1900500000000	19	005	Allamakee County, IA	1993	NA	7481	7128	353	4.7
CN1900700000000	19	007	Appanoose County, IA	1993	NA	6793	6436	357	5.3
CN1900900000000	19	009	Audubon County, IA	1993	NA	3651	3565	86	2.4
CN1901100000000	19	011	Benton County, IA	1993	NA	11668	11206	462	4
CN1901300000000	19	013	Black Hawk County, IA	1993	NA	69190	65398	3792	5.5
CN1901500000000	19	015	Boone County, IA	1993	NA	13453	12968	485	3.6
CN1901700000000	19	017	Bremer County, IA	1993	NA	12662	12160	502	4
CN1901900000000	19	019	Buchanan County, IA	1993	NA	10380	9801	579	5.6
CN1902100000000	19	021	Buena Vista County, IA	1993	NA	11087	10788	299	2.7
CN1902300000000	19	023	Butler County, IA	1993	NA	7929	7494	435	5.5
CN1902500000000	19	025	Calhoun County, IA	1993	NA	5265	5079	186	3.5
CN1902700000000	19	027	Carroll County, IA	1993	NA	12122	11746	376	3.1
CN1902900000000	19	029	Cass County, IA	1993	NA	7788	7399	389	5
CN1903100000000	19	031	Cedar County, IA	1993	NA	9666	9355	311	3.2
CN1903300000000	19	033	Cerro Gordo County, IA	1993	NA	25975	24632	1343	5.2
CN1903500000000	19	035	Cherokee County, IA	1993	NA	7046	6848	198	2.8
CN1903700000000	19	037	Chickasaw County, IA	1993	NA	7475	7027	448	6
CN1903900000000	19	039	Clarke County, IA	1993	NA	4088	3747	341	8.3
CN1904100000000	19	041	Clay County, IA	1993	NA	9406	9138	268	2.8
CN1904300000000	19	043	Clayton County, IA	1993	NA	9671	9131	540	5.6
CN1904500000000	19	045	Clinton County, IA	1993	NA	27388	26039	1349	4.9
CN1904700000000	19	047	Crawford County, IA	1993	NA	8879	8491	388	4.4
CN1904900000000	19	049	Dallas County, IA	1993	NA	17827	17299	528	3
CN1905100000000	19	051	Davis County, IA	1993	NA	4282	4094	188	4.4
CN1905300000000	19	053	Decatur County, IA	1993	NA	3950	3654	296	7.5
CN1905500000000	19	055	Delaware County, IA	1993	NA	9081	8575	506	5.6
CN1905700000000	19	057	Des Moines County, IA	1993	NA	23711	22427	1284	5.4
CN1905900000000	19	059	Dickinson County, IA	1993	NA	9495	9177	318	3.3
CN1906100000000	19	061	Dubuque County, IA	1993	NA	49887	47822	2065	4.1
CN1906300000000	19	063	Emmet County, IA	1993	NA	5754	5500	254	4.4
CN1906500000000	19	065	Fayette County, IA	1993	NA	10787	10274	513	4.8
CN1906700000000	19	067	Floyd County, IA	1993	NA	8711	8099	612	7
CN1906900000000	19	069	Franklin County, IA	1993	NA	5869	5658	211	3.6
CN1907100000000	19	071	Fremont County, IA	1993	NA	3933	3737	196	5
CN1907300000000	19	073	Greene County, IA	1993	NA	5290	5079	211	4
CN1907500000000	19	075	Grundy County, IA	1993	NA	6107	5917	190	3.1
CN1907700000000	19	077	Guthrie County, IA	1993	NA	5883	5646	237	4
CN1907900000000	19	079	Hamilton County, IA	1993	NA	8520	8216	304	3.6
CN1908100000000	19	081	Hancock County, IA	1993	NA	5902	5672	230	3.9
CN1908300000000	19	083	Hardin County, IA	1993	NA	9582	9197	385	4
CN1908500000000	19	085	Harrison County, IA	1993	NA	7609	7247	362	4.8
CN1908700000000	19	087	Henry County, IA	1993	NA	10823	10443	380	3.5
CN1908900000000	19	089	Howard County, IA	1993	NA	4883	4698	185	3.8
CN1909100000000	19	091	Humboldt County, IA	1993	NA	5253	5077	176	3.4
CN1909300000000	19	093	Ida County, IA	1993	NA	4077	3976	101	2.5
CN1909500000000	19	095	Iowa County, IA	1993	NA	9392	9172	220	2.3
CN1909700000000	19	097	Jackson County, IA	1993	NA	10917	10366	551	5
CN1909900000000	19	099	Jasper County, IA	1993	NA	18154	17474	680	3.7
CN1910100000000	19	101	Jefferson County, IA	1993	NA	9564	9150	414	4.3
CN1910300000000	19	103	Johnson County, IA	1993	NA	63817	62094	1723	2.7
CN1910500000000	19	105	Jones County, IA	1993	NA	9440	8985	455	4.8
CN1910700000000	19	107	Keokuk County, IA	1993	NA	5153	4895	258	5
CN1910900000000	19	109	Kossuth County, IA	1993	NA	8809	8483	326	3.7
CN1911100000000	19	111	Lee County, IA	1993	NA	19661	18228	1433	7.3
CN1911300000000	19	113	Linn County, IA	1993	NA	104727	101140	3587	3.4
CN1911500000000	19	115	Louisa County, IA	1993	NA	6554	6226	328	5
CN1911700000000	19	117	Lucas County, IA	1993	NA	4404	4126	278	6.3
CN1911900000000	19	119	Lyon County, IA	1993	NA	5926	5761	165	2.8
CN1912100000000	19	121	Madison County, IA	1993	NA	7037	6724	313	4.4
CN1912300000000	19	123	Mahaska County, IA	1993	NA	11122	10688	434	3.9
CN1912500000000	19	125	Marion County, IA	1993	NA	17123	16521	602	3.5
CN1912700000000	19	127	Marshall County, IA	1993	NA	20770	19925	845	4.1
CN1912900000000	19	129	Mills County, IA	1993	NA	6544	6321	223	3.4
CN1913100000000	19	131	Mitchell County, IA	1993	NA	5498	5290	208	3.8
CN1913300000000	19	133	Monona County, IA	1993	NA	5166	4963	203	3.9
CN1913500000000	19	135	Monroe County, IA	1993	NA	4103	3897	206	5
CN1913700000000	19	137	Montgomery County, IA	1993	NA	6147	5895	252	4.1
CN1913900000000	19	139	Muscatine County, IA	1993	NA	21873	20981	892	4.1
CN1914100000000	19	141	O'Brien County, IA	1993	NA	7934	7731	203	2.6
CN1914300000000	19	143	Osceola County, IA	1993	NA	3642	3531	111	3
CN1914500000000	19	145	Page County, IA	1993	NA	8975	8627	348	3.9
CN1914700000000	19	147	Palo Alto County, IA	1993	NA	5302	5122	180	3.4
CN1914900000000	19	149	Plymouth County, IA	1993	NA	12912	12555	357	2.8
CN1915100000000	19	151	Pocahontas County, IA	1993	NA	4252	4134	118	2.8
CN1915300000000	19	153	Polk County, IA	1993	NA	208701	201373	7328	3.5
CN1915500000000	19	155	Pottawattamie County, IA	1993	NA	46738	44819	1919	4.1
CN1915700000000	19	157	Poweshiek County, IA	1993	NA	10364	9862	502	4.8
CN1915900000000	19	159	Ringgold County, IA	1993	NA	2682	2584	98	3.7
CN1916100000000	19	161	Sac County, IA	1993	NA	6040	5843	197	3.3
CN1916300000000	19	163	Scott County, IA	1993	NA	85465	81412	4053	4.7
CN1916500000000	19	165	Shelby County, IA	1993	NA	6829	6524	305	4.5
CN1916700000000	19	167	Sioux County, IA	1993	NA	16874	16436	438	2.6
CN1916900000000	19	169	Story County, IA	1993	NA	44901	43520	1381	3.1
CN1917100000000	19	171	Tama County, IA	1993	NA	9106	8697	409	4.5
CN1917300000000	19	173	Taylor County, IA	1993	NA	3230	3098	132	4.1
CN1917500000000	19	175	Union County, IA	1993	NA	6468	6171	297	4.6
CN1917700000000	19	177	Van Buren County, IA	1993	NA	4031	3858	173	4.3
CN1917900000000	19	179	Wapello County, IA	1993	NA	18542	17481	1061	5.7
CN1918100000000	19	181	Warren County, IA	1993	NA	22539	21841	698	3.1
CN1918300000000	19	183	Washington County, IA	1993	NA	11156	10788	368	3.3
CN1918500000000	19	185	Wayne County, IA	1993	NA	3294	3117	177	5.4
CN1918700000000	19	187	Webster County, IA	1993	NA	20271	19282	989	4.9
CN1918900000000	19	189	Winnebago County, IA	1993	NA	6698	6481	217	3.2
CN1919100000000	19	191	Winneshiek County, IA	1993	NA	11913	11263	650	5.5
CN1919300000000	19	193	Woodbury County, IA	1993	NA	55055	53339	1716	3.1
CN1919500000000	19	195	Worth County, IA	1993	NA	4089	3904	185	4.5
CN1919700000000	19	197	Wright County, IA	1993	NA	7021	6739	282	4
CN2000100000000	20	001	Allen County, KS	1993	NA	6805	6420	385	5.7
CN2000300000000	20	003	Anderson County, KS	1993	NA	3930	3628	302	7.7
CN2000500000000	20	005	Atchison County, KS	1993	NA	8340	7698	642	7.7
CN2000700000000	20	007	Barber County, KS	1993	NA	2825	2736	89	3.2
CN2000900000000	20	009	Barton County, KS	1993	NA	15351	14628	723	4.7
CN2001100000000	20	011	Bourbon County, KS	1993	NA	6836	6331	505	7.4
CN2001300000000	20	013	Brown County, KS	1993	NA	4876	4590	286	5.9
CN2001500000000	20	015	Butler County, KS	1993	NA	28773	27125	1648	5.7
CN2001700000000	20	017	Chase County, KS	1993	NA	1427	1354	73	5.1
CN2001900000000	20	019	Chautauqua County, KS	1993	NA	1766	1672	94	5.3
CN2002100000000	20	021	Cherokee County, KS	1993	NA	9771	9014	757	7.7
CN2002300000000	20	023	Cheyenne County, KS	1993	NA	1519	1486	33	2.2
CN2002500000000	20	025	Clark County, KS	1993	NA	1289	1261	28	2.2
CN2002700000000	20	027	Clay County, KS	1993	NA	4650	4490	160	3.4
CN2002900000000	20	029	Cloud County, KS	1993	NA	5420	5260	160	3
CN2003100000000	20	031	Coffey County, KS	1993	NA	4430	4192	238	5.4
CN2003300000000	20	033	Comanche County, KS	1993	NA	1077	1057	20	1.9
CN2003500000000	20	035	Cowley County, KS	1993	NA	18620	17601	1019	5.5
CN2003700000000	20	037	Crawford County, KS	1993	NA	17164	16090	1074	6.3
CN2003900000000	20	039	Decatur County, KS	1993	NA	1927	1874	53	2.8
CN2004100000000	20	041	Dickinson County, KS	1993	NA	9856	9419	437	4.4
CN2004300000000	20	043	Doniphan County, KS	1993	NA	3990	3682	308	7.7
CN2004500000000	20	045	Douglas County, KS	1993	NA	48869	46490	2379	4.9
CN2004700000000	20	047	Edwards County, KS	1993	NA	1837	1776	61	3.3
CN2004900000000	20	049	Elk County, KS	1993	NA	1451	1362	89	6.1
CN2005100000000	20	051	Ellis County, KS	1993	NA	15406	14821	585	3.8
CN2005300000000	20	053	Ellsworth County, KS	1993	NA	2909	2800	109	3.7
CN2005500000000	20	055	Finney County, KS	1993	NA	18802	18066	736	3.9
CN2005700000000	20	057	Ford County, KS	1993	NA	14552	14070	482	3.3
CN2005900000000	20	059	Franklin County, KS	1993	NA	12097	11357	740	6.1
CN2006100000000	20	061	Geary County, KS	1993	NA	11382	10507	875	7.7
CN2006300000000	20	063	Gove County, KS	1993	NA	1516	1485	31	2
CN2006500000000	20	065	Graham County, KS	1993	NA	1704	1658	46	2.7
CN2006700000000	20	067	Grant County, KS	1993	NA	3873	3756	117	3
CN2006900000000	20	069	Gray County, KS	1993	NA	2627	2563	64	2.4
CN2007100000000	20	071	Greeley County, KS	1993	NA	849	818	31	3.7
CN2007300000000	20	073	Greenwood County, KS	1993	NA	3530	3310	220	6.2
CN2007500000000	20	075	Hamilton County, KS	1993	NA	1233	1200	33	2.7
CN2007700000000	20	077	Harper County, KS	1993	NA	3096	2972	124	4
CN2007900000000	20	079	Harvey County, KS	1993	NA	16584	15957	627	3.8
CN2008100000000	20	081	Haskell County, KS	1993	NA	2002	1947	55	2.7
CN2008300000000	20	083	Hodgeman County, KS	1993	NA	997	977	20	2
CN2008500000000	20	085	Jackson County, KS	1993	NA	6206	5810	396	6.4
CN2008700000000	20	087	Jefferson County, KS	1993	NA	9137	8659	478	5.2
CN2008900000000	20	089	Jewell County, KS	1993	NA	2128	2088	40	1.9
CN2009100000000	20	091	Johnson County, KS	1993	NA	228876	221437	7439	3.3
CN2009300000000	20	093	Kearny County, KS	1993	NA	2098	2026	72	3.4
CN2009500000000	20	095	Kingman County, KS	1993	NA	4049	3810	239	5.9
CN2009700000000	20	097	Kiowa County, KS	1993	NA	1705	1661	44	2.6
CN2009900000000	20	099	Labette County, KS	1993	NA	11036	10165	871	7.9
CN2010100000000	20	101	Lane County, KS	1993	NA	1109	1091	18	1.6
CN2010300000000	20	103	Leavenworth County, KS	1993	NA	27109	25575	1534	5.7
CN2010500000000	20	105	Lincoln County, KS	1993	NA	1860	1788	72	3.9
CN2010700000000	20	107	Linn County, KS	1993	NA	3357	3008	349	10.4
CN2010900000000	20	109	Logan County, KS	1993	NA	1590	1539	51	3.2
CN2011100000000	20	111	Lyon County, KS	1993	NA	19207	18319	888	4.6
CN2011300000000	20	113	McPherson County, KS	1993	NA	15263	14813	450	2.9
CN2011500000000	20	115	Marion County, KS	1993	NA	6603	6401	202	3.1
CN2011700000000	20	117	Marshall County, KS	1993	NA	5652	5507	145	2.6
CN2011900000000	20	119	Meade County, KS	1993	NA	2093	2047	46	2.2
CN2012100000000	20	121	Miami County, KS	1993	NA	12623	11946	677	5.4
CN2012300000000	20	123	Mitchell County, KS	1993	NA	3604	3494	110	3.1
CN2012500000000	20	125	Montgomery County, KS	1993	NA	17945	16844	1101	6.1
CN2012700000000	20	127	Morris County, KS	1993	NA	3113	2974	139	4.5
CN2012900000000	20	129	Morton County, KS	1993	NA	1675	1621	54	3.2
CN2013100000000	20	131	Nemaha County, KS	1993	NA	5442	5300	142	2.6
CN2013300000000	20	133	Neosho County, KS	1993	NA	8712	8255	457	5.2
CN2013500000000	20	135	Ness County, KS	1993	NA	1961	1915	46	2.3
CN2013700000000	20	137	Norton County, KS	1993	NA	2878	2831	47	1.6
CN2013900000000	20	139	Osage County, KS	1993	NA	7812	7281	531	6.8
CN2014100000000	20	141	Osborne County, KS	1993	NA	2557	2482	75	2.9
CN2014300000000	20	143	Ottawa County, KS	1993	NA	2803	2710	93	3.3
CN2014500000000	20	145	Pawnee County, KS	1993	NA	3910	3780	130	3.3
CN2014700000000	20	147	Phillips County, KS	1993	NA	3218	3136	82	2.5
CN2014900000000	20	149	Pottawatomie County, KS	1993	NA	9097	8731	366	4
CN2015100000000	20	151	Pratt County, KS	1993	NA	5051	4865	186	3.7
CN2015300000000	20	153	Rawlins County, KS	1993	NA	1651	1625	26	1.6
CN2015500000000	20	155	Reno County, KS	1993	NA	31918	30422	1496	4.7
CN2015700000000	20	157	Republic County, KS	1993	NA	3352	3286	66	2
CN2015900000000	20	159	Rice County, KS	1993	NA	5012	4767	245	4.9
CN2016100000000	20	161	Riley County, KS	1993	NA	29001	27763	1238	4.3
CN2016300000000	20	163	Rooks County, KS	1993	NA	2868	2760	108	3.8
CN2016500000000	20	165	Rush County, KS	1993	NA	1856	1805	51	2.7
CN2016700000000	20	167	Russell County, KS	1993	NA	3849	3690	159	4.1
CN2016900000000	20	169	Saline County, KS	1993	NA	28809	27631	1178	4.1
CN2017100000000	20	171	Scott County, KS	1993	NA	2705	2626	79	2.9
CN2017300000000	20	173	Sedgwick County, KS	1993	NA	227821	214417	13404	5.9
CN2017500000000	20	175	Seward County, KS	1993	NA	9924	9478	446	4.5
CN2017700000000	20	177	Shawnee County, KS	1993	NA	89793	85416	4377	4.9
CN2017900000000	20	179	Sheridan County, KS	1993	NA	1470	1433	37	2.5
CN2018100000000	20	181	Sherman County, KS	1993	NA	3880	3741	139	3.6
CN2018300000000	20	183	Smith County, KS	1993	NA	2459	2401	58	2.4
CN2018500000000	20	185	Stafford County, KS	1993	NA	2455	2361	94	3.8
CN2018700000000	20	187	Stanton County, KS	1993	NA	1054	1026	28	2.7
CN2018900000000	20	189	Stevens County, KS	1993	NA	2455	2385	70	2.9
CN2019100000000	20	191	Sumner County, KS	1993	NA	12888	11980	908	7
CN2019300000000	20	193	Thomas County, KS	1993	NA	4419	4278	141	3.2
CN2019500000000	20	195	Trego County, KS	1993	NA	1858	1816	42	2.3
CN2019700000000	20	197	Wabaunsee County, KS	1993	NA	3417	3247	170	5
CN2019900000000	20	199	Wallace County, KS	1993	NA	830	812	18	2.2
CN2020100000000	20	201	Washington County, KS	1993	NA	3613	3486	127	3.5
CN2020300000000	20	203	Wichita County, KS	1993	NA	1296	1260	36	2.8
CN2020500000000	20	205	Wilson County, KS	1993	NA	4801	4532	269	5.6
CN2020700000000	20	207	Woodson County, KS	1993	NA	1933	1824	109	5.6
CN2020900000000	20	209	Wyandotte County, KS	1993	NA	78278	71198	7080	9
CN2100100000000	21	001	Adair County, KY	1993	NA	7865	7366	499	6.3
CN2100300000000	21	003	Allen County, KY	1993	NA	8002	7627	375	4.7
CN2100500000000	21	005	Anderson County, KY	1993	NA	8618	8254	364	4.2
CN2100700000000	21	007	Ballard County, KY	1993	NA	3848	3511	337	8.8
CN2100900000000	21	009	Barren County, KY	1993	NA	17153	16228	925	5.4
CN2101100000000	21	011	Bath County, KY	1993	NA	4514	3974	540	12
CN2101300000000	21	013	Bell County, KY	1993	NA	10378	9274	1104	10.6
CN2101500000000	21	015	Boone County, KY	1993	NA	35032	33189	1843	5.3
CN2101700000000	21	017	Bourbon County, KY	1993	NA	9586	9120	466	4.9
CN2101900000000	21	019	Boyd County, KY	1993	NA	23152	20533	2619	11.3
CN2102100000000	21	021	Boyle County, KY	1993	NA	13124	12457	667	5.1
CN2102300000000	21	023	Bracken County, KY	1993	NA	3684	3357	327	8.9
CN2102500000000	21	025	Breathitt County, KY	1993	NA	5083	4580	503	9.9
CN2102700000000	21	027	Breckinridge County, KY	1993	NA	7435	6935	500	6.7
CN2102900000000	21	029	Bullitt County, KY	1993	NA	27601	26642	959	3.5
CN2103100000000	21	031	Butler County, KY	1993	NA	5362	5005	357	6.7
CN2103300000000	21	033	Caldwell County, KY	1993	NA	6708	6174	534	8
CN2103500000000	21	035	Calloway County, KY	1993	NA	16194	15294	900	5.6
CN2103700000000	21	037	Campbell County, KY	1993	NA	43303	40948	2355	5.4
CN2103900000000	21	039	Carlisle County, KY	1993	NA	2589	2411	178	6.9
CN2104100000000	21	041	Carroll County, KY	1993	NA	4668	4399	269	5.8
CN2104300000000	21	043	Carter County, KY	1993	NA	11068	9283	1785	16.1
CN2104500000000	21	045	Casey County, KY	1993	NA	6845	6315	530	7.7
CN2104700000000	21	047	Christian County, KY	1993	NA	22852	21594	1258	5.5
CN2104900000000	21	049	Clark County, KY	1993	NA	14858	14072	786	5.3
CN2105100000000	21	051	Clay County, KY	1993	NA	7078	6405	673	9.5
CN2105300000000	21	053	Clinton County, KY	1993	NA	4487	4131	356	7.9
CN2105500000000	21	055	Crittenden County, KY	1993	NA	4110	3815	295	7.2
CN2105700000000	21	057	Cumberland County, KY	1993	NA	2944	2703	241	8.2
CN2105900000000	21	059	Daviess County, KY	1993	NA	46056	43164	2892	6.3
CN2106100000000	21	061	Edmonson County, KY	1993	NA	4519	4024	495	11
CN2106300000000	21	063	Elliott County, KY	1993	NA	2407	2044	363	15.1
CN2106500000000	21	065	Estill County, KY	1993	NA	5814	5319	495	8.5
CN2106700000000	21	067	Fayette County, KY	1993	NA	131886	127374	4512	3.4
CN2106900000000	21	069	Fleming County, KY	1993	NA	6499	6001	498	7.7
CN2107100000000	21	071	Floyd County, KY	1993	NA	14728	13288	1440	9.8
CN2107300000000	21	073	Franklin County, KY	1993	NA	24016	23223	793	3.3
CN2107500000000	21	075	Fulton County, KY	1993	NA	3721	3476	245	6.6
CN2107700000000	21	077	Gallatin County, KY	1993	NA	2814	2646	168	6
CN2107900000000	21	079	Garrard County, KY	1993	NA	6198	5828	370	6
CN2108100000000	21	081	Grant County, KY	1993	NA	8296	7738	558	6.7
CN2108300000000	21	083	Graves County, KY	1993	NA	15968	14783	1185	7.4
CN2108500000000	21	085	Grayson County, KY	1993	NA	10176	9325	851	8.4
CN2108700000000	21	087	Green County, KY	1993	NA	5284	5041	243	4.6
CN2108900000000	21	089	Greenup County, KY	1993	NA	16537	14728	1809	10.9
CN2109100000000	21	091	Hancock County, KY	1993	NA	3474	3146	328	9.4
CN2109300000000	21	093	Hardin County, KY	1993	NA	34983	32611	2372	6.8
CN2109500000000	21	095	Harlan County, KY	1993	NA	10276	9025	1251	12.2
CN2109700000000	21	097	Harrison County, KY	1993	NA	7578	7097	481	6.3
CN2109900000000	21	099	Hart County, KY	1993	NA	7301	6857	444	6.1
CN2110100000000	21	101	Henderson County, KY	1993	NA	22869	21611	1258	5.5
CN2110300000000	21	103	Henry County, KY	1993	NA	7488	7186	302	4
CN2110500000000	21	105	Hickman County, KY	1993	NA	2515	2366	149	5.9
CN2110700000000	21	107	Hopkins County, KY	1993	NA	20741	19057	1684	8.1
CN2110900000000	21	109	Jackson County, KY	1993	NA	4393	3985	408	9.3
CN2111100000000	21	111	Jefferson County, KY	1993	NA	352686	335090	17596	5
CN2111300000000	21	113	Jessamine County, KY	1993	NA	17743	17106	637	3.6
CN2111500000000	21	115	Johnson County, KY	1993	NA	9818	9095	723	7.4
CN2111700000000	21	117	Kenton County, KY	1993	NA	75304	71523	3781	5
CN2111900000000	21	119	Knott County, KY	1993	NA	5908	5218	690	11.7
CN2112100000000	21	121	Knox County, KY	1993	NA	10412	9499	913	8.8
CN2112300000000	21	123	Larue County, KY	1993	NA	5608	5355	253	4.5
CN2112500000000	21	125	Laurel County, KY	1993	NA	20074	18629	1445	7.2
CN2112700000000	21	127	Lawrence County, KY	1993	NA	4812	4245	567	11.8
CN2112900000000	21	129	Lee County, KY	1993	NA	2415	2157	258	10.7
CN2113100000000	21	131	Leslie County, KY	1993	NA	4438	4052	386	8.7
CN2113300000000	21	133	Letcher County, KY	1993	NA	8307	7127	1180	14.2
CN2113500000000	21	135	Lewis County, KY	1993	NA	5760	4927	833	14.5
CN2113700000000	21	137	Lincoln County, KY	1993	NA	9717	9119	598	6.2
CN2113900000000	21	139	Livingston County, KY	1993	NA	4613	4243	370	8
CN2114100000000	21	141	Logan County, KY	1993	NA	12907	12264	643	5
CN2114300000000	21	143	Lyon County, KY	1993	NA	2955	2763	192	6.5
CN2114500000000	21	145	McCracken County, KY	1993	NA	31840	30394	1446	4.5
CN2114700000000	21	147	McCreary County, KY	1993	NA	6073	5411	662	10.9
CN2114900000000	21	149	McLean County, KY	1993	NA	4419	3833	586	13.3
CN2115100000000	21	151	Madison County, KY	1993	NA	31231	29876	1355	4.3
CN2115300000000	21	153	Magoffin County, KY	1993	NA	4343	3672	671	15.5
CN2115500000000	21	155	Marion County, KY	1993	NA	8421	7738	683	8.1
CN2115700000000	21	157	Marshall County, KY	1993	NA	13305	12263	1042	7.8
CN2115900000000	21	159	Martin County, KY	1993	NA	3596	3202	394	11
CN2116100000000	21	161	Mason County, KY	1993	NA	8555	7834	721	8.4
CN2116300000000	21	163	Meade County, KY	1993	NA	9296	8756	540	5.8
CN2116500000000	21	165	Menifee County, KY	1993	NA	2223	1903	320	14.4
CN2116700000000	21	167	Mercer County, KY	1993	NA	10397	9752	645	6.2
CN2116900000000	21	169	Metcalfe County, KY	1993	NA	4567	4315	252	5.5
CN2117100000000	21	171	Monroe County, KY	1993	NA	5238	5016	222	4.2
CN2117300000000	21	173	Montgomery County, KY	1993	NA	9716	8693	1023	10.5
CN2117500000000	21	175	Morgan County, KY	1993	NA	4464	3952	512	11.5
CN2117700000000	21	177	Muhlenberg County, KY	1993	NA	11720	10428	1292	11
CN2117900000000	21	179	Nelson County, KY	1993	NA	15804	14792	1012	6.4
CN2118100000000	21	181	Nicholas County, KY	1993	NA	3586	3282	304	8.5
CN2118300000000	21	183	Ohio County, KY	1993	NA	9155	8218	937	10.2
CN2118500000000	21	185	Oldham County, KY	1993	NA	19534	19071	463	2.4
CN2118700000000	21	187	Owen County, KY	1993	NA	4607	4415	192	4.2
CN2118900000000	21	189	Owsley County, KY	1993	NA	1479	1401	78	5.3
CN2119100000000	21	191	Pendleton County, KY	1993	NA	5949	5608	341	5.7
CN2119300000000	21	193	Perry County, KY	1993	NA	11477	10335	1142	10
CN2119500000000	21	195	Pike County, KY	1993	NA	27066	23873	3193	11.8
CN2119700000000	21	197	Powell County, KY	1993	NA	6044	5475	569	9.4
CN2119900000000	21	199	Pulaski County, KY	1993	NA	23502	21645	1857	7.9
CN2120100000000	21	201	Robertson County, KY	1993	NA	947	886	61	6.4
CN2120300000000	21	203	Rockcastle County, KY	1993	NA	5657	5177	480	8.5
CN2120500000000	21	205	Rowan County, KY	1993	NA	9123	8489	634	6.9
CN2120700000000	21	207	Russell County, KY	1993	NA	6777	6119	658	9.7
CN2120900000000	21	209	Scott County, KY	1993	NA	13845	13339	506	3.7
CN2121100000000	21	211	Shelby County, KY	1993	NA	14875	14460	415	2.8
CN2121300000000	21	213	Simpson County, KY	1993	NA	8170	7576	594	7.3
CN2121500000000	21	215	Spencer County, KY	1993	NA	4113	3976	137	3.3
CN2121700000000	21	217	Taylor County, KY	1993	NA	11461	11022	439	3.8
CN2121900000000	21	219	Todd County, KY	1993	NA	5331	5106	225	4.2
CN2122100000000	21	221	Trigg County, KY	1993	NA	5513	5177	336	6.1
CN2122300000000	21	223	Trimble County, KY	1993	NA	2936	2800	136	4.6
CN2122500000000	21	225	Union County, KY	1993	NA	6962	6344	618	8.9
CN2122700000000	21	227	Warren County, KY	1993	NA	44474	42349	2125	4.8
CN2122900000000	21	229	Washington County, KY	1993	NA	5674	5472	202	3.6
CN2123100000000	21	231	Wayne County, KY	1993	NA	7676	7102	574	7.5
CN2123300000000	21	233	Webster County, KY	1993	NA	5849	5332	517	8.8
CN2123500000000	21	235	Whitley County, KY	1993	NA	13339	12283	1056	7.9
CN2123700000000	21	237	Wolfe County, KY	1993	NA	3077	2740	337	11
CN2123900000000	21	239	Woodford County, KY	1993	NA	11748	11360	388	3.3
CN2200100000000	22	001	Acadia Parish, LA	1993	NA	21619	19926	1693	7.8
CN2200300000000	22	003	Allen Parish, LA	1993	NA	8364	7493	871	10.4
CN2200500000000	22	005	Ascension Parish, LA	1993	NA	28137	26093	2044	7.3
CN2200700000000	22	007	Assumption Parish, LA	1993	NA	9081	8167	914	10.1
CN2200900000000	22	009	Avoyelles Parish, LA	1993	NA	14511	13015	1496	10.3
CN2201100000000	22	011	Beauregard Parish, LA	1993	NA	12493	11490	1003	8
CN2201300000000	22	013	Bienville Parish, LA	1993	NA	6195	5766	429	6.9
CN2201500000000	22	015	Bossier Parish, LA	1993	NA	40657	38183	2474	6.1
CN2201700000000	22	017	Caddo Parish, LA	1993	NA	111923	105085	6838	6.1
CN2201900000000	22	019	Calcasieu Parish, LA	1993	NA	79299	73648	5651	7.1
CN2202100000000	22	021	Caldwell Parish, LA	1993	NA	4275	3926	349	8.2
CN2202300000000	22	023	Cameron Parish, LA	1993	NA	3615	3383	232	6.4
CN2202500000000	22	025	Catahoula Parish, LA	1993	NA	4975	4544	431	8.7
CN2202700000000	22	027	Claiborne Parish, LA	1993	NA	5699	5333	366	6.4
CN2202900000000	22	029	Concordia Parish, LA	1993	NA	8340	7430	910	10.9
CN2203100000000	22	031	De Soto Parish, LA	1993	NA	10063	9144	919	9.1
CN2203300000000	22	033	East Baton Rouge Parish, LA	1993	NA	196745	186514	10231	5.2
CN2203500000000	22	035	East Carroll Parish, LA	1993	NA	3440	2944	496	14.4
CN2203700000000	22	037	East Feliciana Parish, LA	1993	NA	7624	7091	533	7
CN2203900000000	22	039	Evangeline Parish, LA	1993	NA	11997	11089	908	7.6
CN2204100000000	22	041	Franklin Parish, LA	1993	NA	10140	9228	912	9
CN2204300000000	22	043	Grant Parish, LA	1993	NA	6870	6362	508	7.4
CN2204500000000	22	045	Iberia Parish, LA	1993	NA	29159	27012	2147	7.4
CN2204700000000	22	047	Iberville Parish, LA	1993	NA	13071	11762	1309	10
CN2204900000000	22	049	Jackson Parish, LA	1993	NA	6195	5874	321	5.2
CN2205100000000	22	051	Jefferson Parish, LA	1993	NA	231073	212178	18895	8.2
CN2205300000000	22	053	Jefferson Davis Parish, LA	1993	NA	11641	10645	996	8.6
CN2205500000000	22	055	Lafayette Parish, LA	1993	NA	84497	80396	4101	4.9
CN2205700000000	22	057	Lafourche Parish, LA	1993	NA	36283	34093	2190	6
CN2205900000000	22	059	LaSalle Parish, LA	1993	NA	6041	5581	460	7.6
CN2206100000000	22	061	Lincoln Parish, LA	1993	NA	18234	17749	485	2.7
CN2206300000000	22	063	Livingston Parish, LA	1993	NA	35127	32182	2945	8.4
CN2206500000000	22	065	Madison Parish, LA	1993	NA	4961	4343	618	12.5
CN2206700000000	22	067	Morehouse Parish, LA	1993	NA	12873	11683	1190	9.2
CN2206900000000	22	069	Natchitoches Parish, LA	1993	NA	15903	14795	1108	7
CN2207100000000	22	071	Orleans Parish, LA	1993	NA	203760	183388	20372	10
CN2207300000000	22	073	Ouachita Parish, LA	1993	NA	65086	61347	3739	5.7
CN2207500000000	22	075	Plaquemines Parish, LA	1993	NA	10224	9203	1021	10
CN2207700000000	22	077	Pointe Coupee Parish, LA	1993	NA	9700	8803	897	9.2
CN2207900000000	22	079	Rapides Parish, LA	1993	NA	55771	52453	3318	5.9
CN2208100000000	22	081	Red River Parish, LA	1993	NA	3727	3396	331	8.9
CN2208300000000	22	083	Richland Parish, LA	1993	NA	8380	7560	820	9.8
CN2208500000000	22	085	Sabine Parish, LA	1993	NA	8982	8407	575	6.4
CN2208700000000	22	087	St. Bernard Parish, LA	1993	NA	31183	28070	3113	10
CN2208900000000	22	089	St. Charles Parish, LA	1993	NA	21287	18944	2343	11
CN2209100000000	22	091	St. Helena Parish, LA	1993	NA	3879	3599	280	7.2
CN2209300000000	22	093	St. James Parish, LA	1993	NA	8745	7752	993	11.4
CN2209500000000	22	095	St. John the Baptist Parish, LA	1993	NA	19189	16615	2574	13.4
CN2209700000000	22	097	St. Landry Parish, LA	1993	NA	29597	26858	2739	9.3
CN2209900000000	22	099	St. Martin Parish, LA	1993	NA	18873	17608	1265	6.7
CN2210100000000	22	101	St. Mary Parish, LA	1993	NA	23621	21470	2151	9.1
CN2210300000000	22	103	St. Tammany Parish, LA	1993	NA	75660	69220	6440	8.5
CN2210500000000	22	105	Tangipahoa Parish, LA	1993	NA	38555	34870	3685	9.6
CN2210700000000	22	107	Tensas Parish, LA	1993	NA	3056	2805	251	8.2
CN2210900000000	22	109	Terrebonne Parish, LA	1993	NA	40616	38159	2457	6
CN2211100000000	22	111	Union Parish, LA	1993	NA	10564	9975	589	5.6
CN2211300000000	22	113	Vermilion Parish, LA	1993	NA	21174	19609	1565	7.4
CN2211500000000	22	115	Vernon Parish, LA	1993	NA	16945	15709	1236	7.3
CN2211700000000	22	117	Washington Parish, LA	1993	NA	16153	14755	1398	8.7
CN2211900000000	22	119	Webster Parish, LA	1993	NA	17632	15991	1641	9.3
CN2212100000000	22	121	West Baton Rouge Parish, LA	1993	NA	9302	8596	706	7.6
CN2212300000000	22	123	West Carroll Parish, LA	1993	NA	5354	4603	751	14
CN2212500000000	22	125	West Feliciana Parish, LA	1993	NA	3631	3359	272	7.5
CN2212700000000	22	127	Winn Parish, LA	1993	NA	6196	5948	248	4
CN2300100000000	23	001	Androscoggin County, ME	1993	NA	56192	51761	4431	7.9
CN2300300000000	23	003	Aroostook County, ME	1993	NA	39505	35240	4265	10.8
CN2300500000000	23	005	Cumberland County, ME	1993	NA	128839	121823	7016	5.4
CN2300700000000	23	007	Franklin County, ME	1993	NA	14907	13817	1090	7.3
CN2300900000000	23	009	Hancock County, ME	1993	NA	25389	23437	1952	7.7
CN2301100000000	23	011	Kennebec County, ME	1993	NA	59313	55067	4246	7.2
CN2301300000000	23	013	Knox County, ME	1993	NA	18655	17614	1041	5.6
CN2301500000000	23	015	Lincoln County, ME	1993	NA	16238	15251	987	6.1
CN2301700000000	23	017	Oxford County, ME	1993	NA	25491	23193	2298	9
CN2301900000000	23	019	Penobscot County, ME	1993	NA	73758	68585	5173	7
CN2302100000000	23	021	Piscataquis County, ME	1993	NA	8459	7689	770	9.1
CN2302300000000	23	023	Sagadahoc County, ME	1993	NA	15777	14942	835	5.3
CN2302500000000	23	025	Somerset County, ME	1993	NA	25392	22870	2522	9.9
CN2302700000000	23	027	Waldo County, ME	1993	NA	17032	15541	1491	8.8
CN2302900000000	23	029	Washington County, ME	1993	NA	16351	14396	1955	12
CN2303100000000	23	031	York County, ME	1993	NA	87531	81970	5561	6.4
CN2400100000000	24	001	Allegany County, MD	1993	NA	32727	28938	3789	11.6
CN2400300000000	24	003	Anne Arundel County, MD	1993	NA	239833	226788	13045	5.4
CN2400500000000	24	005	Baltimore County, MD	1993	NA	387268	361351	25917	6.7
CN2400900000000	24	009	Calvert County, MD	1993	NA	31332	29864	1468	4.7
CN2401100000000	24	011	Caroline County, MD	1993	NA	15117	13937	1180	7.8
CN2401300000000	24	013	Carroll County, MD	1993	NA	72310	68475	3835	5.3
CN2401500000000	24	015	Cecil County, MD	1993	NA	37065	33902	3163	8.5
CN2401700000000	24	017	Charles County, MD	1993	NA	56108	53574	2534	4.5
CN2401900000000	24	019	Dorchester County, MD	1993	NA	15595	13976	1619	10.4
CN2402100000000	24	021	Frederick County, MD	1993	NA	89670	85518	4152	4.6
CN2402300000000	24	023	Garrett County, MD	1993	NA	13901	12126	1775	12.8
CN2402500000000	24	025	Harford County, MD	1993	NA	104173	97592	6581	6.3
CN2402700000000	24	027	Howard County, MD	1993	NA	122011	117300	4711	3.9
CN2402900000000	24	029	Kent County, MD	1993	NA	9761	9064	697	7.1
CN2403100000000	24	031	Montgomery County, MD	1993	NA	448482	432865	15617	3.5
CN2403300000000	24	033	Prince George's County, MD	1993	NA	431050	407899	23151	5.4
CN2403500000000	24	035	Queen Anne's County, MD	1993	NA	18793	17737	1056	5.6
CN2403700000000	24	037	St. Mary's County, MD	1993	NA	40622	38294	2328	5.7
CN2403900000000	24	039	Somerset County, MD	1993	NA	11428	10057	1371	12
CN2404100000000	24	041	Talbot County, MD	1993	NA	17169	16458	711	4.1
CN2404300000000	24	043	Washington County, MD	1993	NA	65345	59747	5598	8.6
CN2404500000000	24	045	Wicomico County, MD	1993	NA	46381	43183	3198	6.9
CN2404700000000	24	047	Worcester County, MD	1993	NA	23094	20554	2540	11
CN2451000000000	24	510	Baltimore city, MD	1993	NA	329210	294950	34260	10.4
CN2500100000000	25	001	Barnstable County, MA	1993	NA	99899	90855	9044	9.1
CN2500300000000	25	003	Berkshire County, MA	1993	NA	67930	62380	5550	8.2
CN2500500000000	25	005	Bristol County, MA	1993	NA	265608	239171	26437	10
CN2500700000000	25	007	Dukes County, MA	1993	NA	7762	7207	555	7.2
CN2500900000000	25	009	Essex County, MA	1993	NA	348288	323128	25160	7.2
CN2501100000000	25	011	Franklin County, MA	1993	NA	36564	34331	2233	6.1
CN2501300000000	25	013	Hampden County, MA	1993	NA	217268	198810	18458	8.5
CN2501500000000	25	015	Hampshire County, MA	1993	NA	78642	74475	4167	5.3
CN2501700000000	25	017	Middlesex County, MA	1993	NA	781722	736458	45264	5.8
CN2501900000000	25	019	Nantucket County/town, MA	1993	NA	5310	5113	197	3.7
CN2502100000000	25	021	Norfolk County, MA	1993	NA	342204	322732	19472	5.7
CN2502300000000	25	023	Plymouth County, MA	1993	NA	229810	212013	17797	7.7
CN2502500000000	25	025	Suffolk County, MA	1993	NA	330427	307884	22543	6.8
CN2502700000000	25	027	Worcester County, MA	1993	NA	362863	338024	24839	6.8
CN2600100000000	26	001	Alcona County, MI	1993	NA	4485	3870	615	13.7
CN2600300000000	26	003	Alger County, MI	1993	NA	4038	3633	405	10
CN2600500000000	26	005	Allegan County, MI	1993	NA	48399	45660	2739	5.7
CN2600700000000	26	007	Alpena County, MI	1993	NA	15006	13090	1916	12.8
CN2600900000000	26	009	Antrim County, MI	1993	NA	9276	8314	962	10.4
CN2601100000000	26	011	Arenac County, MI	1993	NA	6477	5800	677	10.5
CN2601300000000	26	013	Baraga County, MI	1993	NA	3545	3134	411	11.6
CN2601500000000	26	015	Barry County, MI	1993	NA	26663	24991	1672	6.3
CN2601700000000	26	017	Bay County, MI	1993	NA	54526	50384	4142	7.6
CN2601900000000	26	019	Benzie County, MI	1993	NA	6652	5968	684	10.3
CN2602100000000	26	021	Berrien County, MI	1993	NA	82530	76195	6335	7.7
CN2602300000000	26	023	Branch County, MI	1993	NA	19230	17699	1531	8
CN2602500000000	26	025	Calhoun County, MI	1993	NA	66009	61756	4253	6.4
CN2602700000000	26	027	Cass County, MI	1993	NA	24957	23497	1460	5.9
CN2602900000000	26	029	Charlevoix County, MI	1993	NA	12440	11038	1402	11.3
CN2603100000000	26	031	Cheboygan County, MI	1993	NA	10932	9658	1274	11.7
CN2603300000000	26	033	Chippewa County, MI	1993	NA	16671	14831	1840	11
CN2603500000000	26	035	Clare County, MI	1993	NA	10180	9100	1080	10.6
CN2603700000000	26	037	Clinton County, MI	1993	NA	31999	30229	1770	5.5
CN2603900000000	26	039	Crawford County, MI	1993	NA	5571	5002	569	10.2
CN2604100000000	26	041	Delta County, MI	1993	NA	17942	15904	2038	11.4
CN2604300000000	26	043	Dickinson County, MI	1993	NA	13257	12208	1049	7.9
CN2604500000000	26	045	Eaton County, MI	1993	NA	52238	49438	2800	5.4
CN2604700000000	26	047	Emmet County, MI	1993	NA	15340	13590	1750	11.4
CN2604900000000	26	049	Genesee County, MI	1993	NA	199795	179394	20401	10.2
CN2605100000000	26	051	Gladwin County, MI	1993	NA	8468	7529	939	11.1
CN2605300000000	26	053	Gogebic County, MI	1993	NA	8213	7432	781	9.5
CN2605500000000	26	055	Grand Traverse County, MI	1993	NA	40167	37664	2503	6.2
CN2605700000000	26	057	Gratiot County, MI	1993	NA	19459	17900	1559	8
CN2605900000000	26	059	Hillsdale County, MI	1993	NA	21750	20271	1479	6.8
CN2606100000000	26	061	Houghton County, MI	1993	NA	15858	14509	1349	8.5
CN2606300000000	26	063	Huron County, MI	1993	NA	16640	14941	1699	10.2
CN2606500000000	26	065	Ingham County, MI	1993	NA	147699	139594	8105	5.5
CN2606700000000	26	067	Ionia County, MI	1993	NA	26770	24406	2364	8.8
CN2606900000000	26	069	Iosco County, MI	1993	NA	10834	9447	1387	12.8
CN2607100000000	26	071	Iron County, MI	1993	NA	5573	4970	603	10.8
CN2607300000000	26	073	Isabella County, MI	1993	NA	26309	24799	1510	5.7
CN2607500000000	26	075	Jackson County, MI	1993	NA	73546	67667	5879	8
CN2607700000000	26	077	Kalamazoo County, MI	1993	NA	122076	116519	5557	4.6
CN2607900000000	26	079	Kalkaska County, MI	1993	NA	6990	6188	802	11.5
CN2608100000000	26	081	Kent County, MI	1993	NA	282251	266240	16011	5.7
CN2608300000000	26	083	Keweenaw County, MI	1993	NA	693	588	105	15.2
CN2608500000000	26	085	Lake County, MI	1993	NA	3268	2825	443	13.6
CN2608700000000	26	087	Lapeer County, MI	1993	NA	39396	35872	3524	8.9
CN2608900000000	26	089	Leelanau County, MI	1993	NA	10012	9373	639	6.4
CN2609100000000	26	091	Lenawee County, MI	1993	NA	45033	42410	2623	5.8
CN2609300000000	26	093	Livingston County, MI	1993	NA	67953	65045	2908	4.3
CN2609500000000	26	095	Luce County, MI	1993	NA	2387	2021	366	15.3
CN2609700000000	26	097	Mackinac County, MI	1993	NA	6703	5875	828	12.4
CN2609900000000	26	099	Macomb County, MI	1993	NA	404971	378249	26722	6.6
CN2610100000000	26	101	Manistee County, MI	1993	NA	9967	8700	1267	12.7
CN2610300000000	26	103	Marquette County, MI	1993	NA	33447	30956	2491	7.4
CN2610500000000	26	105	Mason County, MI	1993	NA	14044	12548	1496	10.7
CN2610700000000	26	107	Mecosta County, MI	1993	NA	17247	16004	1243	7.2
CN2610900000000	26	109	Menominee County, MI	1993	NA	12814	11839	975	7.6
CN2611100000000	26	111	Midland County, MI	1993	NA	40228	37364	2864	7.1
CN2611300000000	26	113	Missaukee County, MI	1993	NA	5855	5346	509	8.7
CN2611500000000	26	115	Monroe County, MI	1993	NA	67201	61856	5345	8
CN2611700000000	26	117	Montcalm County, MI	1993	NA	24408	21969	2439	10
CN2611900000000	26	119	Montmorency County, MI	1993	NA	3543	2976	567	16
CN2612100000000	26	121	Muskegon County, MI	1993	NA	76573	69890	6683	8.7
CN2612300000000	26	123	Newaygo County, MI	1993	NA	19720	17715	2005	10.2
CN2612500000000	26	125	Oakland County, MI	1993	NA	627307	590400	36907	5.9
CN2612700000000	26	127	Oceana County, MI	1993	NA	12046	10497	1549	12.9
CN2612900000000	26	129	Ogemaw County, MI	1993	NA	7880	7037	843	10.7
CN2613100000000	26	131	Ontonagon County, MI	1993	NA	3941	3596	345	8.8
CN2613300000000	26	133	Osceola County, MI	1993	NA	10324	9343	981	9.5
CN2613500000000	26	135	Oscoda County, MI	1993	NA	3415	3084	331	9.7
CN2613700000000	26	137	Otsego County, MI	1993	NA	11040	10198	842	7.6
CN2613900000000	26	139	Ottawa County, MI	1993	NA	112800	107437	5363	4.8
CN2614100000000	26	141	Presque Isle County, MI	1993	NA	6404	5349	1055	16.5
CN2614300000000	26	143	Roscommon County, MI	1993	NA	7837	7031	806	10.3
CN2614500000000	26	145	Saginaw County, MI	1993	NA	98601	91307	7294	7.4
CN2614700000000	26	147	St. Clair County, MI	1993	NA	74089	67933	6156	8.3
CN2614900000000	26	149	St. Joseph County, MI	1993	NA	30893	28999	1894	6.1
CN2615100000000	26	151	Sanilac County, MI	1993	NA	20008	17992	2016	10.1
CN2615300000000	26	153	Schoolcraft County, MI	1993	NA	3964	3430	534	13.5
CN2615500000000	26	155	Shiawassee County, MI	1993	NA	35462	32048	3414	9.6
CN2615700000000	26	157	Tuscola County, MI	1993	NA	26734	24242	2492	9.3
CN2615900000000	26	159	Van Buren County, MI	1993	NA	35147	32316	2831	8.1
CN2616100000000	26	161	Washtenaw County, MI	1993	NA	162309	155560	6749	4.2
CN2616300000000	26	163	Wayne County, MI	1993	NA	942688	866617	76071	8.1
CN2616500000000	26	165	Wexford County, MI	1993	NA	13359	11908	1451	10.9
CN2700100000000	27	001	Aitkin County, MN	1993	NA	5597	4926	671	12
CN2700300000000	27	003	Anoka County, MN	1993	NA	156619	149276	7343	4.7
CN2700500000000	27	005	Becker County, MN	1993	NA	12892	11480	1412	11
CN2700700000000	27	007	Beltrami County, MN	1993	NA	17117	15823	1294	7.6
CN2700900000000	27	009	Benton County, MN	1993	NA	18567	17539	1028	5.5
CN2701100000000	27	011	Big Stone County, MN	1993	NA	2853	2679	174	6.1
CN2701300000000	27	013	Blue Earth County, MN	1993	NA	31105	30018	1087	3.5
CN2701500000000	27	015	Brown County, MN	1993	NA	14555	13854	701	4.8
CN2701700000000	27	017	Carlton County, MN	1993	NA	15054	13827	1227	8.2
CN2701900000000	27	019	Carver County, MN	1993	NA	31662	30551	1111	3.5
CN2702100000000	27	021	Cass County, MN	1993	NA	10444	9402	1042	10
CN2702300000000	27	023	Chippewa County, MN	1993	NA	6475	6117	358	5.5
CN2702500000000	27	025	Chisago County, MN	1993	NA	17260	16110	1150	6.7
CN2702700000000	27	027	Clay County, MN	1993	NA	28253	27143	1110	3.9
CN2702900000000	27	029	Clearwater County, MN	1993	NA	3991	3260	731	18.3
CN2703100000000	27	031	Cook County, MN	1993	NA	2737	2584	153	5.6
CN2703300000000	27	033	Cottonwood County, MN	1993	NA	6176	5810	366	5.9
CN2703500000000	27	035	Crow Wing County, MN	1993	NA	24180	22292	1888	7.8
CN2703700000000	27	037	Dakota County, MN	1993	NA	182861	176218	6643	3.6
CN2703900000000	27	039	Dodge County, MN	1993	NA	8648	8097	551	6.4
CN2704100000000	27	041	Douglas County, MN	1993	NA	15209	14334	875	5.8
CN2704300000000	27	043	Faribault County, MN	1993	NA	8168	7633	535	6.5
CN2704500000000	27	045	Fillmore County, MN	1993	NA	10256	9659	597	5.8
CN2704700000000	27	047	Freeborn County, MN	1993	NA	17454	16489	965	5.5
CN2704900000000	27	049	Goodhue County, MN	1993	NA	23527	22492	1035	4.4
CN2705100000000	27	051	Grant County, MN	1993	NA	3002	2819	183	6.1
CN2705300000000	27	053	Hennepin County, MN	1993	NA	626538	600577	25961	4.1
CN2705500000000	27	055	Houston County, MN	1993	NA	10483	10000	483	4.6
CN2705700000000	27	057	Hubbard County, MN	1993	NA	7237	6576	661	9.1
CN2705900000000	27	059	Isanti County, MN	1993	NA	14153	13213	940	6.6
CN2706100000000	27	061	Itasca County, MN	1993	NA	19721	17318	2403	12.2
CN2706300000000	27	063	Jackson County, MN	1993	NA	5623	5345	278	4.9
CN2706500000000	27	065	Kanabec County, MN	1993	NA	7092	6332	760	10.7
CN2706700000000	27	067	Kandiyohi County, MN	1993	NA	19704	18802	902	4.6
CN2706900000000	27	069	Kittson County, MN	1993	NA	2524	2346	178	7.1
CN2707100000000	27	071	Koochiching County, MN	1993	NA	6619	5844	775	11.7
CN2707300000000	27	073	Lac qui Parle County, MN	1993	NA	3943	3775	168	4.3
CN2707500000000	27	075	Lake County, MN	1993	NA	5509	5074	435	7.9
CN2707700000000	27	077	Lake of the Woods County, MN	1993	NA	2185	2092	93	4.3
CN2707900000000	27	079	Le Sueur County, MN	1993	NA	13002	12239	763	5.9
CN2708100000000	27	081	Lincoln County, MN	1993	NA	3173	3019	154	4.9
CN2708300000000	27	083	Lyon County, MN	1993	NA	14740	14226	514	3.5
CN2708500000000	27	085	McLeod County, MN	1993	NA	19540	18548	992	5.1
CN2708700000000	27	087	Mahnomen County, MN	1993	NA	2788	2524	264	9.5
CN2708900000000	27	089	Marshall County, MN	1993	NA	4856	4245	611	12.6
CN2709100000000	27	091	Martin County, MN	1993	NA	11656	10778	878	7.5
CN2709300000000	27	093	Meeker County, MN	1993	NA	9608	8829	779	8.1
CN2709500000000	27	095	Mille Lacs County, MN	1993	NA	9934	9124	810	8.2
CN2709700000000	27	097	Morrison County, MN	1993	NA	14826	13430	1396	9.4
CN2709900000000	27	099	Mower County, MN	1993	NA	18524	17817	707	3.8
CN2710100000000	27	101	Murray County, MN	1993	NA	4532	4271	261	5.8
CN2710300000000	27	103	Nicollet County, MN	1993	NA	17272	16703	569	3.3
CN2710500000000	27	105	Nobles County, MN	1993	NA	10273	9863	410	4
CN2710700000000	27	107	Norman County, MN	1993	NA	3594	3348	246	6.8
CN2710900000000	27	109	Olmsted County, MN	1993	NA	65419	63362	2057	3.1
CN2711100000000	27	111	Otter Tail County, MN	1993	NA	25669	23794	1875	7.3
CN2711300000000	27	113	Pennington County, MN	1993	NA	7206	6627	579	8
CN2711500000000	27	115	Pine County, MN	1993	NA	11364	10278	1086	9.6
CN2711700000000	27	117	Pipestone County, MN	1993	NA	4989	4720	269	5.4
CN2711900000000	27	119	Polk County, MN	1993	NA	16385	15449	936	5.7
CN2712100000000	27	121	Pope County, MN	1993	NA	5209	4901	308	5.9
CN2712300000000	27	123	Ramsey County, MN	1993	NA	272280	261265	11015	4
CN2712500000000	27	125	Red Lake County, MN	1993	NA	2076	1793	283	13.6
CN2712700000000	27	127	Redwood County, MN	1993	NA	8456	8076	380	4.5
CN2712900000000	27	129	Renville County, MN	1993	NA	9251	8657	594	6.4
CN2713100000000	27	131	Rice County, MN	1993	NA	27918	26462	1456	5.2
CN2713300000000	27	133	Rock County, MN	1993	NA	4765	4632	133	2.8
CN2713500000000	27	135	Roseau County, MN	1993	NA	8213	7787	426	5.2
CN2713700000000	27	137	St. Louis County, MN	1993	NA	98600	91185	7415	7.5
CN2713900000000	27	139	Scott County, MN	1993	NA	37427	35799	1628	4.3
CN2714100000000	27	141	Sherburne County, MN	1993	NA	25809	24337	1472	5.7
CN2714300000000	27	143	Sibley County, MN	1993	NA	6817	6318	499	7.3
CN2714500000000	27	145	Stearns County, MN	1993	NA	70351	66925	3426	4.9
CN2714700000000	27	147	Steele County, MN	1993	NA	17516	16800	716	4.1
CN2714900000000	27	149	Stevens County, MN	1993	NA	5259	5042	217	4.1
CN2715100000000	27	151	Swift County, MN	1993	NA	5006	4733	273	5.5
CN2715300000000	27	153	Todd County, MN	1993	NA	10555	9746	809	7.7
CN2715500000000	27	155	Traverse County, MN	1993	NA	1789	1695	94	5.3
CN2715700000000	27	157	Wabasha County, MN	1993	NA	11013	10509	504	4.6
CN2715900000000	27	159	Wadena County, MN	1993	NA	5922	5543	379	6.4
CN2716100000000	27	161	Waseca County, MN	1993	NA	8968	8455	513	5.7
CN2716300000000	27	163	Washington County, MN	1993	NA	94115	90548	3567	3.8
CN2716500000000	27	165	Watonwan County, MN	1993	NA	5889	5646	243	4.1
CN2716700000000	27	167	Wilkin County, MN	1993	NA	3503	3365	138	3.9
CN2716900000000	27	169	Winona County, MN	1993	NA	27848	26542	1306	4.7
CN2717100000000	27	171	Wright County, MN	1993	NA	40592	38264	2328	5.7
CN2717300000000	27	173	Yellow Medicine County, MN	1993	NA	5892	5594	298	5.1
CN2800100000000	28	001	Adams County, MS	1993	NA	14928	13817	1111	7.4
CN2800300000000	28	003	Alcorn County, MS	1993	NA	15600	14489	1111	7.1
CN2800500000000	28	005	Amite County, MS	1993	NA	5192	4819	373	7.2
CN2800700000000	28	007	Attala County, MS	1993	NA	7743	6891	852	11
CN2800900000000	28	009	Benton County, MS	1993	NA	3111	2907	204	6.6
CN2801100000000	28	011	Bolivar County, MS	1993	NA	18429	16598	1831	9.9
CN2801300000000	28	013	Calhoun County, MS	1993	NA	7298	6955	343	4.7
CN2801500000000	28	015	Carroll County, MS	1993	NA	4250	4001	249	5.9
CN2801700000000	28	017	Chickasaw County, MS	1993	NA	8987	8249	738	8.2
CN2801900000000	28	019	Choctaw County, MS	1993	NA	3399	3076	323	9.5
CN2802100000000	28	021	Claiborne County, MS	1993	NA	3894	3451	443	11.4
CN2802300000000	28	023	Clarke County, MS	1993	NA	8155	7695	460	5.6
CN2802500000000	28	025	Clay County, MS	1993	NA	9380	8488	892	9.5
CN2802700000000	28	027	Coahoma County, MS	1993	NA	11970	10629	1341	11.2
CN2802900000000	28	029	Copiah County, MS	1993	NA	11206	10320	886	7.9
CN2803100000000	28	031	Covington County, MS	1993	NA	7755	7225	530	6.8
CN2803300000000	28	033	DeSoto County, MS	1993	NA	39691	37758	1933	4.9
CN2803500000000	28	035	Forrest County, MS	1993	NA	31301	29475	1826	5.8
CN2803700000000	28	037	Franklin County, MS	1993	NA	3286	3056	230	7
CN2803900000000	28	039	George County, MS	1993	NA	7776	6805	971	12.5
CN2804100000000	28	041	Greene County, MS	1993	NA	4452	3941	511	11.5
CN2804300000000	28	043	Grenada County, MS	1993	NA	10005	9231	774	7.7
CN2804500000000	28	045	Hancock County, MS	1993	NA	15001	14063	938	6.3
CN2804700000000	28	047	Harrison County, MS	1993	NA	79627	75425	4202	5.3
CN2804900000000	28	049	Hinds County, MS	1993	NA	126941	119995	6946	5.5
CN2805100000000	28	051	Holmes County, MS	1993	NA	7124	6345	779	10.9
CN2805300000000	28	053	Humphreys County, MS	1993	NA	5301	4730	571	10.8
CN2805500000000	28	055	Issaquena County, MS	1993	NA	881	763	118	13.4
CN2805700000000	28	057	Itawamba County, MS	1993	NA	10790	10284	506	4.7
CN2805900000000	28	059	Jackson County, MS	1993	NA	62911	59240	3671	5.8
CN2806100000000	28	061	Jasper County, MS	1993	NA	7292	6779	513	7
CN2806300000000	28	063	Jefferson County, MS	1993	NA	2431	2004	427	17.6
CN2806500000000	28	065	Jefferson Davis County, MS	1993	NA	4992	4474	518	10.4
CN2806700000000	28	067	Jones County, MS	1993	NA	28958	27297	1661	5.7
CN2806900000000	28	069	Kemper County, MS	1993	NA	4180	3834	346	8.3
CN2807100000000	28	071	Lafayette County, MS	1993	NA	15161	14774	387	2.6
CN2807300000000	28	073	Lamar County, MS	1993	NA	14722	14113	609	4.1
CN2807500000000	28	075	Lauderdale County, MS	1993	NA	34666	32681	1985	5.7
CN2807700000000	28	077	Lawrence County, MS	1993	NA	5280	4812	468	8.9
CN2807900000000	28	079	Leake County, MS	1993	NA	8384	7787	597	7.1
CN2808100000000	28	081	Lee County, MS	1993	NA	37652	35920	1732	4.6
CN2808300000000	28	083	Leflore County, MS	1993	NA	15948	14369	1579	9.9
CN2808500000000	28	085	Lincoln County, MS	1993	NA	12900	11728	1172	9.1
CN2808700000000	28	087	Lowndes County, MS	1993	NA	26867	25228	1639	6.1
CN2808900000000	28	089	Madison County, MS	1993	NA	29903	28537	1366	4.6
CN2809100000000	28	091	Marion County, MS	1993	NA	10262	9242	1020	9.9
CN2809300000000	28	093	Marshall County, MS	1993	NA	13791	12497	1294	9.4
CN2809500000000	28	095	Monroe County, MS	1993	NA	16907	15771	1136	6.7
CN2809700000000	28	097	Montgomery County, MS	1993	NA	5415	5008	407	7.5
CN2809900000000	28	099	Neshoba County, MS	1993	NA	12969	12329	640	4.9
CN2810100000000	28	101	Newton County, MS	1993	NA	8726	8202	524	6
CN2810300000000	28	103	Noxubee County, MS	1993	NA	4500	4081	419	9.3
CN2810500000000	28	105	Oktibbeha County, MS	1993	NA	18358	17715	643	3.5
CN2810700000000	28	107	Panola County, MS	1993	NA	13231	11938	1293	9.8
CN2810900000000	28	109	Pearl River County, MS	1993	NA	17814	16556	1258	7.1
CN2811100000000	28	111	Perry County, MS	1993	NA	4463	4021	442	9.9
CN2811300000000	28	113	Pike County, MS	1993	NA	15689	14384	1305	8.3
CN2811500000000	28	115	Pontotoc County, MS	1993	NA	12375	11777	598	4.8
CN2811700000000	28	117	Prentiss County, MS	1993	NA	11783	11189	594	5
CN2811900000000	28	119	Quitman County, MS	1993	NA	3959	3491	468	11.8
CN2812100000000	28	121	Rankin County, MS	1993	NA	49484	47797	1687	3.4
CN2812300000000	28	123	Scott County, MS	1993	NA	13265	12699	566	4.3
CN2812500000000	28	125	Sharkey County, MS	1993	NA	3255	2850	405	12.4
CN2812700000000	28	127	Simpson County, MS	1993	NA	10906	10386	520	4.8
CN2812900000000	28	129	Smith County, MS	1993	NA	6404	6107	297	4.6
CN2813100000000	28	131	Stone County, MS	1993	NA	5067	4665	402	7.9
CN2813300000000	28	133	Sunflower County, MS	1993	NA	12200	10768	1432	11.7
CN2813500000000	28	135	Tallahatchie County, MS	1993	NA	5889	5254	635	10.8
CN2813700000000	28	137	Tate County, MS	1993	NA	10446	9701	745	7.1
CN2813900000000	28	139	Tippah County, MS	1993	NA	9568	9005	563	5.9
CN2814100000000	28	141	Tishomingo County, MS	1993	NA	10542	9910	632	6
CN2814300000000	28	143	Tunica County, MS	1993	NA	3448	3110	338	9.8
CN2814500000000	28	145	Union County, MS	1993	NA	11842	11243	599	5.1
CN2814700000000	28	147	Walthall County, MS	1993	NA	5732	5301	431	7.5
CN2814900000000	28	149	Warren County, MS	1993	NA	23640	21744	1896	8
CN2815100000000	28	151	Washington County, MS	1993	NA	27949	24932	3017	10.8
CN2815300000000	28	153	Wayne County, MS	1993	NA	8828	8014	814	9.2
CN2815500000000	28	155	Webster County, MS	1993	NA	4505	4252	253	5.6
CN2815700000000	28	157	Wilkinson County, MS	1993	NA	3443	3059	384	11.2
CN2815900000000	28	159	Winston County, MS	1993	NA	7930	7009	921	11.6
CN2816100000000	28	161	Yalobusha County, MS	1993	NA	5068	4727	341	6.7
CN2816300000000	28	163	Yazoo County, MS	1993	NA	9766	8946	820	8.4
CN2900100000000	29	001	Adair County, MO	1993	NA	13735	13204	531	3.9
CN2900300000000	29	003	Andrew County, MO	1993	NA	7515	7003	512	6.8
CN2900500000000	29	005	Atchison County, MO	1993	NA	2848	2722	126	4.4
CN2900700000000	29	007	Audrain County, MO	1993	NA	11880	11214	666	5.6
CN2900900000000	29	009	Barry County, MO	1993	NA	13574	12629	945	7
CN2901100000000	29	011	Barton County, MO	1993	NA	6257	6008	249	4
CN2901300000000	29	013	Bates County, MO	1993	NA	7333	6757	576	7.9
CN2901500000000	29	015	Benton County, MO	1993	NA	5629	5050	579	10.3
CN2901700000000	29	017	Bollinger County, MO	1993	NA	4795	4360	435	9.1
CN2901900000000	29	019	Boone County, MO	1993	NA	72042	69836	2206	3.1
CN2902100000000	29	021	Buchanan County, MO	1993	NA	40955	37299	3656	8.9
CN2902300000000	29	023	Butler County, MO	1993	NA	18167	16561	1606	8.8
CN2902500000000	29	025	Caldwell County, MO	1993	NA	3642	3336	306	8.4
CN2902700000000	29	027	Callaway County, MO	1993	NA	18191	17189	1002	5.5
CN2902900000000	29	029	Camden County, MO	1993	NA	14277	12881	1396	9.8
CN2903100000000	29	031	Cape Girardeau County, MO	1993	NA	33756	31766	1990	5.9
CN2903300000000	29	033	Carroll County, MO	1993	NA	5067	4609	458	9
CN2903500000000	29	035	Carter County, MO	1993	NA	2441	2148	293	12
CN2903700000000	29	037	Cass County, MO	1993	NA	36673	34909	1764	4.8
CN2903900000000	29	039	Cedar County, MO	1993	NA	5220	4904	316	6.1
CN2904100000000	29	041	Chariton County, MO	1993	NA	4031	3658	373	9.3
CN2904300000000	29	043	Christian County, MO	1993	NA	20748	19568	1180	5.7
CN2904500000000	29	045	Clark County, MO	1993	NA	3412	3208	204	6
CN2904700000000	29	047	Clay County, MO	1993	NA	92003	88309	3694	4
CN2904900000000	29	049	Clinton County, MO	1993	NA	8398	7977	421	5
CN2905100000000	29	051	Cole County, MO	1993	NA	35325	33774	1551	4.4
CN2905300000000	29	053	Cooper County, MO	1993	NA	8131	7582	549	6.8
CN2905500000000	29	055	Crawford County, MO	1993	NA	9910	8846	1064	10.7
CN2905700000000	29	057	Dade County, MO	1993	NA	3052	2839	213	7
CN2905900000000	29	059	Dallas County, MO	1993	NA	5927	5376	551	9.3
CN2906100000000	29	061	Daviess County, MO	1993	NA	3304	3019	285	8.6
CN2906300000000	29	063	DeKalb County, MO	1993	NA	3839	3577	262	6.8
CN2906500000000	29	065	Dent County, MO	1993	NA	6178	5626	552	8.9
CN2906700000000	29	067	Douglas County, MO	1993	NA	5539	5171	368	6.6
CN2906900000000	29	069	Dunklin County, MO	1993	NA	13463	12062	1401	10.4
CN2907100000000	29	071	Franklin County, MO	1993	NA	42745	39886	2859	6.7
CN2907300000000	29	073	Gasconade County, MO	1993	NA	7282	6476	806	11.1
CN2907500000000	29	075	Gentry County, MO	1993	NA	3306	3159	147	4.4
CN2907700000000	29	077	Greene County, MO	1993	NA	118330	112065	6265	5.3
CN2907900000000	29	079	Grundy County, MO	1993	NA	5050	4730	320	6.3
CN2908100000000	29	081	Harrison County, MO	1993	NA	4131	3920	211	5.1
CN2908300000000	29	083	Henry County, MO	1993	NA	9543	8725	818	8.6
CN2908500000000	29	085	Hickory County, MO	1993	NA	2714	2482	232	8.5
CN2908700000000	29	087	Holt County, MO	1993	NA	2839	2676	163	5.7
CN2908900000000	29	089	Howard County, MO	1993	NA	4740	4478	262	5.5
CN2909100000000	29	091	Howell County, MO	1993	NA	16174	14958	1216	7.5
CN2909300000000	29	093	Iron County, MO	1993	NA	4295	3725	570	13.3
CN2909500000000	29	095	Jackson County, MO	1993	NA	339078	319685	19393	5.7
CN2909700000000	29	097	Jasper County, MO	1993	NA	48647	45843	2804	5.8
CN2909900000000	29	099	Jefferson County, MO	1993	NA	93704	87950	5754	6.1
CN2910100000000	29	101	Johnson County, MO	1993	NA	21377	20506	871	4.1
CN2910300000000	29	103	Knox County, MO	1993	NA	1852	1744	108	5.8
CN2910500000000	29	105	Laclede County, MO	1993	NA	13505	12331	1174	8.7
CN2910700000000	29	107	Lafayette County, MO	1993	NA	15365	14537	828	5.4
CN2910900000000	29	109	Lawrence County, MO	1993	NA	14835	13845	990	6.7
CN2911100000000	29	111	Lewis County, MO	1993	NA	5048	4755	293	5.8
CN2911300000000	29	113	Lincoln County, MO	1993	NA	15625	14317	1308	8.4
CN2911500000000	29	115	Linn County, MO	1993	NA	6890	6132	758	11
CN2911700000000	29	117	Livingston County, MO	1993	NA	6986	6599	387	5.5
CN2911900000000	29	119	McDonald County, MO	1993	NA	6970	6476	494	7.1
CN2912100000000	29	121	Macon County, MO	1993	NA	7612	6770	842	11.1
CN2912300000000	29	123	Madison County, MO	1993	NA	4821	4195	626	13
CN2912500000000	29	125	Maries County, MO	1993	NA	4098	3788	310	7.6
CN2912700000000	29	127	Marion County, MO	1993	NA	14636	13636	1000	6.8
CN2912900000000	29	129	Mercer County, MO	1993	NA	1844	1764	80	4.3
CN2913100000000	29	131	Miller County, MO	1993	NA	10627	9482	1145	10.8
CN2913300000000	29	133	Mississippi County, MO	1993	NA	6071	5384	687	11.3
CN2913500000000	29	135	Moniteau County, MO	1993	NA	6543	6095	448	6.8
CN2913700000000	29	137	Monroe County, MO	1993	NA	4074	3769	305	7.5
CN2913900000000	29	139	Montgomery County, MO	1993	NA	5616	5199	417	7.4
CN2914100000000	29	141	Morgan County, MO	1993	NA	7486	6783	703	9.4
CN2914300000000	29	143	New Madrid County, MO	1993	NA	8518	7666	852	10
CN2914500000000	29	145	Newton County, MO	1993	NA	24471	22929	1542	6.3
CN2914700000000	29	147	Nodaway County, MO	1993	NA	11534	11183	351	3
CN2914900000000	29	149	Oregon County, MO	1993	NA	4135	3833	302	7.3
CN2915100000000	29	151	Osage County, MO	1993	NA	6618	6309	309	4.7
CN2915300000000	29	153	Ozark County, MO	1993	NA	3872	3600	272	7
CN2915500000000	29	155	Pemiscot County, MO	1993	NA	8025	6838	1187	14.8
CN2915700000000	29	157	Perry County, MO	1993	NA	9709	9092	617	6.4
CN2915900000000	29	159	Pettis County, MO	1993	NA	19123	17437	1686	8.8
CN2916100000000	29	161	Phelps County, MO	1993	NA	17697	16520	1177	6.7
CN2916300000000	29	163	Pike County, MO	1993	NA	7128	6482	646	9.1
CN2916500000000	29	165	Platte County, MO	1993	NA	37628	36306	1322	3.5
CN2916700000000	29	167	Polk County, MO	1993	NA	10542	9911	631	6
CN2916900000000	29	169	Pulaski County, MO	1993	NA	12672	11294	1378	10.9
CN2917100000000	29	171	Putnam County, MO	1993	NA	2034	1954	80	3.9
CN2917300000000	29	173	Ralls County, MO	1993	NA	4779	4490	289	6
CN2917500000000	29	175	Randolph County, MO	1993	NA	10475	9516	959	9.2
CN2917700000000	29	177	Ray County, MO	1993	NA	10383	9742	641	6.2
CN2917900000000	29	179	Reynolds County, MO	1993	NA	3079	2793	286	9.3
CN2918100000000	29	181	Ripley County, MO	1993	NA	4760	4214	546	11.5
CN2918300000000	29	183	St. Charles County, MO	1993	NA	131511	124907	6604	5
CN2918500000000	29	185	St. Clair County, MO	1993	NA	3708	3440	268	7.2
CN2918600000000	29	186	Ste. Genevieve County, MO	1993	NA	8417	7749	668	7.9
CN2918700000000	29	187	St. Francois County, MO	1993	NA	21369	18739	2630	12.3
CN2918900000000	29	189	St. Louis County, MO	1993	NA	543345	518791	24554	4.5
CN2919500000000	29	195	Saline County, MO	1993	NA	11202	10463	739	6.6
CN2919700000000	29	197	Schuyler County, MO	1993	NA	2288	2131	157	6.9
CN2919900000000	29	199	Scotland County, MO	1993	NA	2290	2193	97	4.2
CN2920100000000	29	201	Scott County, MO	1993	NA	19021	17500	1521	8
CN2920300000000	29	203	Shannon County, MO	1993	NA	3784	3434	350	9.2
CN2920500000000	29	205	Shelby County, MO	1993	NA	3220	3006	214	6.6
CN2920700000000	29	207	Stoddard County, MO	1993	NA	13228	11776	1452	11
CN2920900000000	29	209	Stone County, MO	1993	NA	12842	11411	1431	11.1
CN2921100000000	29	211	Sullivan County, MO	1993	NA	2704	2560	144	5.3
CN2921300000000	29	213	Taney County, MO	1993	NA	24144	21943	2201	9.1
CN2921500000000	29	215	Texas County, MO	1993	NA	9924	8338	1586	16
CN2921700000000	29	217	Vernon County, MO	1993	NA	8441	7991	450	5.3
CN2921900000000	29	219	Warren County, MO	1993	NA	10645	9911	734	6.9
CN2922100000000	29	221	Washington County, MO	1993	NA	8387	7152	1235	14.7
CN2922300000000	29	223	Wayne County, MO	1993	NA	4117	3230	887	21.5
CN2922500000000	29	225	Webster County, MO	1993	NA	11936	11207	729	6.1
CN2922700000000	29	227	Worth County, MO	1993	NA	965	907	58	6
CN2922900000000	29	229	Wright County, MO	1993	NA	7824	7137	687	8.8
CN2951000000000	29	510	St. Louis city, MO	1993	NA	170007	155208	14799	8.7
CN3000100000000	30	001	Beaverhead County, MT	1993	NA	4611	4365	246	5.3
CN3000300000000	30	003	Big Horn County, MT	1993	NA	4989	4365	624	12.5
CN3000500000000	30	005	Blaine County, MT	1993	NA	2785	2544	241	8.7
CN3000700000000	30	007	Broadwater County, MT	1993	NA	1781	1704	77	4.3
CN3000900000000	30	009	Carbon County, MT	1993	NA	3855	3634	221	5.7
CN3001100000000	30	011	Carter County, MT	1993	NA	871	848	23	2.6
CN3001300000000	30	013	Cascade County, MT	1993	NA	35643	33429	2214	6.2
CN3001500000000	30	015	Chouteau County, MT	1993	NA	2507	2454	53	2.1
CN3001700000000	30	017	Custer County, MT	1993	NA	6062	5752	310	5.1
CN3001900000000	30	019	Daniels County, MT	1993	NA	1124	1103	21	1.9
CN3002100000000	30	021	Dawson County, MT	1993	NA	4818	4641	177	3.7
CN3002300000000	30	023	Deer Lodge County, MT	1993	NA	4147	3755	392	9.5
CN3002500000000	30	025	Fallon County, MT	1993	NA	1509	1448	61	4
CN3002700000000	30	027	Fergus County, MT	1993	NA	5701	5385	316	5.5
CN3002900000000	30	029	Flathead County, MT	1993	NA	34202	31762	2440	7.1
CN3003100000000	30	031	Gallatin County, MT	1993	NA	32958	31479	1479	4.5
CN3003300000000	30	033	Garfield County, MT	1993	NA	874	860	14	1.6
CN3003500000000	30	035	Glacier County, MT	1993	NA	5387	4772	615	11.4
CN3003700000000	30	037	Golden Valley County, MT	1993	NA	472	450	22	4.7
CN3003900000000	30	039	Granite County, MT	1993	NA	1304	1204	100	7.7
CN3004100000000	30	041	Hill County, MT	1993	NA	8605	8073	532	6.2
CN3004300000000	30	043	Jefferson County, MT	1993	NA	4303	4101	202	4.7
CN3004500000000	30	045	Judith Basin County, MT	1993	NA	1039	1003	36	3.5
CN3004700000000	30	047	Lake County, MT	1993	NA	10058	9272	786	7.8
CN3004900000000	30	049	Lewis and Clark County, MT	1993	NA	26643	25298	1345	5
CN3005100000000	30	051	Liberty County, MT	1993	NA	988	964	24	2.4
CN3005300000000	30	053	Lincoln County, MT	1993	NA	8101	6848	1253	15.5
CN3005500000000	30	055	McCone County, MT	1993	NA	1114	1079	35	3.1
CN3005700000000	30	057	Madison County, MT	1993	NA	3321	3197	124	3.7
CN3005900000000	30	059	Meagher County, MT	1993	NA	910	857	53	5.8
CN3006100000000	30	061	Mineral County, MT	1993	NA	1632	1479	153	9.4
CN3006300000000	30	063	Missoula County, MT	1993	NA	46405	43741	2664	5.7
CN3006500000000	30	065	Musselshell County, MT	1993	NA	1788	1680	108	6
CN3006700000000	30	067	Park County, MT	1993	NA	9428	9036	392	4.2
CN3006900000000	30	069	Petroleum County, MT	1993	NA	302	285	17	5.6
CN3007100000000	30	071	Phillips County, MT	1993	NA	2402	2309	93	3.9
CN3007300000000	30	073	Pondera County, MT	1993	NA	2933	2835	98	3.3
CN3007500000000	30	075	Powder River County, MT	1993	NA	1158	1130	28	2.4
CN3007700000000	30	077	Powell County, MT	1993	NA	2528	2301	227	9
CN3007900000000	30	079	Prairie County, MT	1993	NA	650	624	26	4
CN3008100000000	30	081	Ravalli County, MT	1993	NA	13796	12619	1177	8.5
CN3008300000000	30	083	Richland County, MT	1993	NA	5341	4963	378	7.1
CN3008500000000	30	085	Roosevelt County, MT	1993	NA	4279	3896	383	9
CN3008700000000	30	087	Rosebud County, MT	1993	NA	4715	4350	365	7.7
CN3008900000000	30	089	Sanders County, MT	1993	NA	3818	3348	470	12.3
CN3009100000000	30	091	Sheridan County, MT	1993	NA	2095	2059	36	1.7
CN3009300000000	30	093	Silver Bow County, MT	1993	NA	16672	15546	1126	6.8
CN3009500000000	30	095	Stillwater County, MT	1993	NA	3342	3207	135	4
CN3009700000000	30	097	Sweet Grass County, MT	1993	NA	1643	1598	45	2.7
CN3009900000000	30	099	Teton County, MT	1993	NA	2776	2711	65	2.3
CN3010100000000	30	101	Toole County, MT	1993	NA	2786	2683	103	3.7
CN3010300000000	30	103	Treasure County, MT	1993	NA	457	439	18	3.9
CN3010500000000	30	105	Valley County, MT	1993	NA	4162	3973	189	4.5
CN3010700000000	30	107	Wheatland County, MT	1993	NA	1144	1095	49	4.3
CN3010900000000	30	109	Wibaux County, MT	1993	NA	554	534	20	3.6
CN3011100000000	30	111	Yellowstone County, MT	1993	NA	65155	62013	3142	4.8
CN3100100000000	31	001	Adams County, NE	1993	NA	15470	15197	273	1.8
CN3100300000000	31	003	Antelope County, NE	1993	NA	3267	3174	93	2.8
CN3100500000000	31	005	Arthur County, NE	1993	NA	222	219	3	1.4
CN3100700000000	31	007	Banner County, NE	1993	NA	423	418	5	1.2
CN3100900000000	31	009	Blaine County, NE	1993	NA	342	327	15	4.4
CN3101100000000	31	011	Boone County, NE	1993	NA	2920	2867	53	1.8
CN3101300000000	31	013	Box Butte County, NE	1993	NA	6256	6051	205	3.3
CN3101500000000	31	015	Boyd County, NE	1993	NA	1198	1159	39	3.3
CN3101700000000	31	017	Brown County, NE	1993	NA	1790	1728	62	3.5
CN3101900000000	31	019	Buffalo County, NE	1993	NA	22827	22262	565	2.5
CN3102100000000	31	021	Burt County, NE	1993	NA	3631	3489	142	3.9
CN3102300000000	31	023	Butler County, NE	1993	NA	4031	3907	124	3.1
CN3102500000000	31	025	Cass County, NE	1993	NA	11091	10728	363	3.3
CN3102700000000	31	027	Cedar County, NE	1993	NA	4897	4796	101	2.1
CN3102900000000	31	029	Chase County, NE	1993	NA	1908	1862	46	2.4
CN3103100000000	31	031	Cherry County, NE	1993	NA	3294	3227	67	2
CN3103300000000	31	033	Cheyenne County, NE	1993	NA	5066	4952	114	2.3
CN3103500000000	31	035	Clay County, NE	1993	NA	3418	3348	70	2
CN3103700000000	31	037	Colfax County, NE	1993	NA	4705	4615	90	1.9
CN3103900000000	31	039	Cuming County, NE	1993	NA	5147	5045	102	2
CN3104100000000	31	041	Custer County, NE	1993	NA	5788	5647	141	2.4
CN3104300000000	31	043	Dakota County, NE	1993	NA	9428	9196	232	2.5
CN3104500000000	31	045	Dawes County, NE	1993	NA	4512	4355	157	3.5
CN3104700000000	31	047	Dawson County, NE	1993	NA	13064	12663	401	3.1
CN3104900000000	31	049	Deuel County, NE	1993	NA	1107	1086	21	1.9
CN3105100000000	31	051	Dixon County, NE	1993	NA	2986	2892	94	3.1
CN3105300000000	31	053	Dodge County, NE	1993	NA	17874	17281	593	3.3
CN3105500000000	31	055	Douglas County, NE	1993	NA	235656	228339	7317	3.1
CN3105700000000	31	057	Dundy County, NE	1993	NA	1256	1237	19	1.5
CN3105900000000	31	059	Fillmore County, NE	1993	NA	3283	3208	75	2.3
CN3106100000000	31	061	Franklin County, NE	1993	NA	1627	1590	37	2.3
CN3106300000000	31	063	Frontier County, NE	1993	NA	1536	1507	29	1.9
CN3106500000000	31	065	Furnas County, NE	1993	NA	2574	2524	50	1.9
CN3106700000000	31	067	Gage County, NE	1993	NA	12054	11786	268	2.2
CN3106900000000	31	069	Garden County, NE	1993	NA	1086	1067	19	1.7
CN3107100000000	31	071	Garfield County, NE	1993	NA	1075	1046	29	2.7
CN3107300000000	31	073	Gosper County, NE	1993	NA	1237	1212	25	2
CN3107500000000	31	075	Grant County, NE	1993	NA	386	382	4	1
CN3107700000000	31	077	Greeley County, NE	1993	NA	1457	1415	42	2.9
CN3107900000000	31	079	Hall County, NE	1993	NA	29640	28955	685	2.3
CN3108100000000	31	081	Hamilton County, NE	1993	NA	5105	5019	86	1.7
CN3108300000000	31	083	Harlan County, NE	1993	NA	1765	1726	39	2.2
CN3108500000000	31	085	Hayes County, NE	1993	NA	504	490	14	2.8
CN3108700000000	31	087	Hitchcock County, NE	1993	NA	1655	1615	40	2.4
CN3108900000000	31	089	Holt County, NE	1993	NA	6393	6215	178	2.8
CN3109100000000	31	091	Hooker County, NE	1993	NA	410	401	9	2.2
CN3109300000000	31	093	Howard County, NE	1993	NA	3307	3229	78	2.4
CN3109500000000	31	095	Jefferson County, NE	1993	NA	4381	4271	110	2.5
CN3109700000000	31	097	Johnson County, NE	1993	NA	2401	2335	66	2.7
CN3109900000000	31	099	Kearney County, NE	1993	NA	3415	3358	57	1.7
CN3110100000000	31	101	Keith County, NE	1993	NA	4371	4238	133	3
CN3110300000000	31	103	Keya Paha County, NE	1993	NA	498	482	16	3.2
CN3110500000000	31	105	Kimball County, NE	1993	NA	2127	2073	54	2.5
CN3110700000000	31	107	Knox County, NE	1993	NA	4504	4369	135	3
CN3110900000000	31	109	Lancaster County, NE	1993	NA	131091	127944	3147	2.4
CN3111100000000	31	111	Lincoln County, NE	1993	NA	17367	16701	666	3.8
CN3111300000000	31	113	Logan County, NE	1993	NA	447	440	7	1.6
CN3111500000000	31	115	Loup County, NE	1993	NA	425	415	10	2.4
CN3111700000000	31	117	McPherson County, NE	1993	NA	300	296	4	1.3
CN3111900000000	31	119	Madison County, NE	1993	NA	18785	18268	517	2.8
CN3112100000000	31	121	Merrick County, NE	1993	NA	4558	4473	85	1.9
CN3112300000000	31	123	Morrill County, NE	1993	NA	2744	2621	123	4.5
CN3112500000000	31	125	Nance County, NE	1993	NA	1964	1908	56	2.9
CN3112700000000	31	127	Nemaha County, NE	1993	NA	3899	3740	159	4.1
CN3112900000000	31	129	Nuckolls County, NE	1993	NA	2480	2428	52	2.1
CN3113100000000	31	131	Otoe County, NE	1993	NA	7409	7167	242	3.3
CN3113300000000	31	133	Pawnee County, NE	1993	NA	1505	1463	42	2.8
CN3113500000000	31	135	Perkins County, NE	1993	NA	1418	1384	34	2.4
CN3113700000000	31	137	Phelps County, NE	1993	NA	5186	5120	66	1.3
CN3113900000000	31	139	Pierce County, NE	1993	NA	3867	3777	90	2.3
CN3114100000000	31	141	Platte County, NE	1993	NA	16922	16524	398	2.4
CN3114300000000	31	143	Polk County, NE	1993	NA	2547	2492	55	2.2
CN3114500000000	31	145	Red Willow County, NE	1993	NA	6001	5851	150	2.5
CN3114700000000	31	147	Richardson County, NE	1993	NA	4792	4614	178	3.7
CN3114900000000	31	149	Rock County, NE	1993	NA	971	938	33	3.4
CN3115100000000	31	151	Saline County, NE	1993	NA	6870	6762	108	1.6
CN3115300000000	31	153	Sarpy County, NE	1993	NA	51339	49938	1401	2.7
CN3115500000000	31	155	Saunders County, NE	1993	NA	10435	10165	270	2.6
CN3115700000000	31	157	Scotts Bluff County, NE	1993	NA	18637	17822	815	4.4
CN3115900000000	31	159	Seward County, NE	1993	NA	8972	8771	201	2.2
CN3116100000000	31	161	Sheridan County, NE	1993	NA	2992	2926	66	2.2
CN3116300000000	31	163	Sherman County, NE	1993	NA	1538	1494	44	2.9
CN3116500000000	31	165	Sioux County, NE	1993	NA	822	809	13	1.6
CN3116700000000	31	167	Stanton County, NE	1993	NA	3210	3129	81	2.5
CN3116900000000	31	169	Thayer County, NE	1993	NA	3217	3150	67	2.1
CN3117100000000	31	171	Thomas County, NE	1993	NA	416	393	23	5.5
CN3117300000000	31	173	Thurston County, NE	1993	NA	2583	2393	190	7.4
CN3117500000000	31	175	Valley County, NE	1993	NA	2734	2670	64	2.3
CN3117700000000	31	177	Washington County, NE	1993	NA	9574	9346	228	2.4
CN3117900000000	31	179	Wayne County, NE	1993	NA	5640	5481	159	2.8
CN3118100000000	31	181	Webster County, NE	1993	NA	1827	1790	37	2
CN3118300000000	31	183	Wheeler County, NE	1993	NA	433	422	11	2.5
CN3118500000000	31	185	York County, NE	1993	NA	8119	7975	144	1.8
CN3200100000000	32	001	Churchill County, NV	1993	NA	8631	7895	736	8.5
CN3200300000000	32	003	Clark County, NV	1993	NA	489718	456199	33519	6.8
CN3200500000000	32	005	Douglas County, NV	1993	NA	16695	15494	1201	7.2
CN3200700000000	32	007	Elko County, NV	1993	NA	20308	18999	1309	6.4
CN3200900000000	32	009	Esmeralda County, NV	1993	NA	762	684	78	10.2
CN3201100000000	32	011	Eureka County, NV	1993	NA	813	754	59	7.3
CN3201300000000	32	013	Humboldt County, NV	1993	NA	8163	7720	443	5.4
CN3201500000000	32	015	Lander County, NV	1993	NA	3101	2749	352	11.4
CN3201700000000	32	017	Lincoln County, NV	1993	NA	1451	1282	169	11.6
CN3201900000000	32	019	Lyon County, NV	1993	NA	10573	9505	1068	10.1
CN3202100000000	32	021	Mineral County, NV	1993	NA	3123	2850	273	8.7
CN3202300000000	32	023	Nye County, NV	1993	NA	10540	9802	738	7
CN3202700000000	32	027	Pershing County, NV	1993	NA	2110	1981	129	6.1
CN3202900000000	32	029	Storey County, NV	1993	NA	1431	1355	76	5.3
CN3203100000000	32	031	Washoe County, NV	1993	NA	165539	155728	9811	5.9
CN3203300000000	32	033	White Pine County, NV	1993	NA	3619	3172	447	12.4
CN3251000000000	32	510	Carson City, NV	1993	NA	22318	20076	2242	10
CN3300100000000	33	001	Belknap County, NH	1993	NA	26539	24822	1717	6.5
CN3300300000000	33	003	Carroll County, NH	1993	NA	18942	17951	991	5.2
CN3300500000000	33	005	Cheshire County, NH	1993	NA	38432	36560	1872	4.9
CN3300700000000	33	007	Coos County, NH	1993	NA	17385	15806	1579	9.1
CN3300900000000	33	009	Grafton County, NH	1993	NA	40110	38115	1995	5
CN3301100000000	33	011	Hillsborough County, NH	1993	NA	190040	178002	12038	6.3
CN3301300000000	33	013	Merrimack County, NH	1993	NA	66507	63485	3022	4.5
CN3301500000000	33	015	Rockingham County, NH	1993	NA	142498	132080	10418	7.3
CN3301700000000	33	017	Strafford County, NH	1993	NA	57352	54120	3232	5.6
CN3301900000000	33	019	Sullivan County, NH	1993	NA	19673	18647	1026	5.2
CN3400100000000	34	001	Atlantic County, NJ	1993	NA	122274	110610	11664	9.5
CN3400300000000	34	003	Bergen County, NJ	1993	NA	429816	400582	29234	6.8
CN3400500000000	34	005	Burlington County, NJ	1993	NA	203148	190600	12548	6.2
CN3400700000000	34	007	Camden County, NJ	1993	NA	250879	232112	18767	7.5
CN3400900000000	34	009	Cape May County, NJ	1993	NA	45298	39291	6007	13.3
CN3401100000000	34	011	Cumberland County, NJ	1993	NA	63903	56555	7348	11.5
CN3401300000000	34	013	Essex County, NJ	1993	NA	377012	341997	35015	9.3
CN3401500000000	34	015	Gloucester County, NJ	1993	NA	121368	112473	8895	7.3
CN3401700000000	34	017	Hudson County, NJ	1993	NA	279870	251357	28513	10.2
CN3401900000000	34	019	Hunterdon County, NJ	1993	NA	61466	58724	2742	4.5
CN3402100000000	34	021	Mercer County, NJ	1993	NA	169872	159919	9953	5.9
CN3402300000000	34	023	Middlesex County, NJ	1993	NA	377054	351150	25904	6.9
CN3402500000000	34	025	Monmouth County, NJ	1993	NA	292423	273927	18496	6.3
CN3402700000000	34	027	Morris County, NJ	1993	NA	242187	228231	13956	5.8
CN3402900000000	34	029	Ocean County, NJ	1993	NA	195308	181483	13825	7.1
CN3403100000000	34	031	Passaic County, NJ	1993	NA	229925	206580	23345	10.2
CN3403300000000	34	033	Salem County, NJ	1993	NA	30871	28661	2210	7.2
CN3403500000000	34	035	Somerset County, NJ	1993	NA	145803	138620	7183	4.9
CN3403700000000	34	037	Sussex County, NJ	1993	NA	72013	66774	5239	7.3
CN3403900000000	34	039	Union County, NJ	1993	NA	260668	239386	21282	8.2
CN3404100000000	34	041	Warren County, NJ	1993	NA	48218	44803	3415	7.1
CN3500100000000	35	001	Bernalillo County, NM	1993	NA	270072	253120	16952	6.3
CN3500300000000	35	003	Catron County, NM	1993	NA	1183	1056	127	10.7
CN3500500000000	35	005	Chaves County, NM	1993	NA	24626	22877	1749	7.1
CN3500600000000	35	006	Cibola County, NM	1993	NA	8891	7812	1079	12.1
CN3500700000000	35	007	Colfax County, NM	1993	NA	6337	5850	487	7.7
CN3500900000000	35	009	Curry County, NM	1993	NA	19145	18011	1134	5.9
CN3501100000000	35	011	De Baca County, NM	1993	NA	939	885	54	5.8
CN3501300000000	35	013	Dona Ana County, NM	1993	NA	62033	57232	4801	7.7
CN3501500000000	35	015	Eddy County, NM	1993	NA	23365	21343	2022	8.7
CN3501700000000	35	017	Grant County, NM	1993	NA	11512	10532	980	8.5
CN3501900000000	35	019	Guadalupe County, NM	1993	NA	1817	1600	217	11.9
CN3502100000000	35	021	Harding County, NM	1993	NA	459	437	22	4.8
CN3502300000000	35	023	Hidalgo County, NM	1993	NA	2861	2690	171	6
CN3502500000000	35	025	Lea County, NM	1993	NA	24565	23200	1365	5.6
CN3502700000000	35	027	Lincoln County, NM	1993	NA	6577	6197	380	5.8
CN3502800000000	35	028	Los Alamos County, NM	1993	NA	11098	10969	129	1.2
CN3502900000000	35	029	Luna County, NM	1993	NA	8971	7591	1380	15.4
CN3503100000000	35	031	McKinley County, NM	1993	NA	24397	22712	1685	6.9
CN3503300000000	35	033	Mora County, NM	1993	NA	1598	1276	322	20.2
CN3503500000000	35	035	Otero County, NM	1993	NA	19335	17823	1512	7.8
CN3503700000000	35	037	Quay County, NM	1993	NA	4906	4620	286	5.8
CN3503900000000	35	039	Rio Arriba County, NM	1993	NA	16131	14122	2009	12.5
CN3504100000000	35	041	Roosevelt County, NM	1993	NA	6792	6467	325	4.8
CN3504300000000	35	043	Sandoval County, NM	1993	NA	33791	31936	1855	5.5
CN3504500000000	35	045	San Juan County, NM	1993	NA	43444	39175	4269	9.8
CN3504700000000	35	047	San Miguel County, NM	1993	NA	11583	10558	1025	8.8
CN3504900000000	35	049	Santa Fe County, NM	1993	NA	61248	59071	2177	3.6
CN3505100000000	35	051	Sierra County, NM	1993	NA	3626	3454	172	4.7
CN3505300000000	35	053	Socorro County, NM	1993	NA	6385	5806	579	9.1
CN3505500000000	35	055	Taos County, NM	1993	NA	12109	10337	1772	14.6
CN3505700000000	35	057	Torrance County, NM	1993	NA	4579	4195	384	8.4
CN3505900000000	35	059	Union County, NM	1993	NA	1882	1815	67	3.6
CN3506100000000	35	061	Valencia County, NM	1993	NA	22327	20955	1372	6.1
CN3600100000000	36	001	Albany County, NY	1993	NA	156673	150059	6614	4.2
CN3600300000000	36	003	Allegany County, NY	1993	NA	22820	20857	1963	8.6
CN3600500000000	36	005	Bronx County, NY	1993	NA	452438	397202	55236	12.2
CN3600700000000	36	007	Broome County, NY	1993	NA	103482	96354	7128	6.9
CN3600900000000	36	009	Cattaraugus County, NY	1993	NA	38779	35360	3419	8.8
CN3601100000000	36	011	Cayuga County, NY	1993	NA	38125	35469	2656	7
CN3601300000000	36	013	Chautauqua County, NY	1993	NA	68396	63684	4712	6.9
CN3601500000000	36	015	Chemung County, NY	1993	NA	42864	40436	2428	5.7
CN3601700000000	36	017	Chenango County, NY	1993	NA	25148	23104	2044	8.1
CN3601900000000	36	019	Clinton County, NY	1993	NA	40731	37607	3124	7.7
CN3602100000000	36	021	Columbia County, NY	1993	NA	32772	31086	1686	5.1
CN3602300000000	36	023	Cortland County, NY	1993	NA	24663	22700	1963	8
CN3602500000000	36	025	Delaware County, NY	1993	NA	20990	19563	1427	6.8
CN3602700000000	36	027	Dutchess County, NY	1993	NA	123084	112541	10543	8.6
CN3602900000000	36	029	Erie County, NY	1993	NA	471279	440225	31054	6.6
CN3603100000000	36	031	Essex County, NY	1993	NA	18015	16109	1906	10.6
CN3603300000000	36	033	Franklin County, NY	1993	NA	21440	19599	1841	8.6
CN3603500000000	36	035	Fulton County, NY	1993	NA	27063	24933	2130	7.9
CN3603700000000	36	037	Genesee County, NY	1993	NA	32067	29952	2115	6.6
CN3603900000000	36	039	Greene County, NY	1993	NA	21455	19639	1816	8.5
CN3604100000000	36	041	Hamilton County, NY	1993	NA	2803	2489	314	11.2
CN3604300000000	36	043	Herkimer County, NY	1993	NA	30326	27996	2330	7.7
CN3604500000000	36	045	Jefferson County, NY	1993	NA	44966	39963	5003	11.1
CN3604700000000	36	047	Kings County, NY	1993	NA	942128	833137	108991	11.6
CN3604900000000	36	049	Lewis County, NY	1993	NA	12527	11258	1269	10.1
CN3605100000000	36	051	Livingston County, NY	1993	NA	33416	31517	1899	5.7
CN3605300000000	36	053	Madison County, NY	1993	NA	35443	33035	2408	6.8
CN3605500000000	36	055	Monroe County, NY	1993	NA	384691	367085	17606	4.6
CN3605700000000	36	057	Montgomery County, NY	1993	NA	24234	22401	1833	7.6
CN3605900000000	36	059	Nassau County, NY	1993	NA	676982	637145	39837	5.9
CN3606100000000	36	061	New York County, NY	1993	NA	770169	700532	69637	9
CN3606300000000	36	063	Niagara County, NY	1993	NA	108537	100370	8167	7.5
CN3606500000000	36	065	Oneida County, NY	1993	NA	113467	106470	6997	6.2
CN3606700000000	36	067	Onondaga County, NY	1993	NA	241118	226966	14152	5.9
CN3606900000000	36	069	Ontario County, NY	1993	NA	52516	49740	2776	5.3
CN3607100000000	36	071	Orange County, NY	1993	NA	156289	146925	9364	6
CN3607300000000	36	073	Orleans County, NY	1993	NA	21248	19667	1581	7.4
CN3607500000000	36	075	Oswego County, NY	1993	NA	57970	52578	5392	9.3
CN3607700000000	36	077	Otsego County, NY	1993	NA	31078	29166	1912	6.2
CN3607900000000	36	079	Putnam County, NY	1993	NA	48577	45982	2595	5.3
CN3608100000000	36	081	Queens County, NY	1993	NA	945067	853345	91722	9.7
CN3608300000000	36	083	Rensselaer County, NY	1993	NA	82131	77853	4278	5.2
CN3608500000000	36	085	Richmond County, NY	1993	NA	184816	167449	17367	9.4
CN3608700000000	36	087	Rockland County, NY	1993	NA	144276	135353	8923	6.2
CN3608900000000	36	089	St. Lawrence County, NY	1993	NA	50961	46401	4560	8.9
CN3609100000000	36	091	Saratoga County, NY	1993	NA	100413	95414	4999	5
CN3609300000000	36	093	Schenectady County, NY	1993	NA	75243	71371	3872	5.1
CN3609500000000	36	095	Schoharie County, NY	1993	NA	15608	14546	1062	6.8
CN3609700000000	36	097	Schuyler County, NY	1993	NA	8893	8226	667	7.5
CN3609900000000	36	099	Seneca County, NY	1993	NA	16104	15078	1026	6.4
CN3610100000000	36	101	Steuben County, NY	1993	NA	48495	45273	3222	6.6
CN3610300000000	36	103	Suffolk County, NY	1993	NA	695135	644627	50508	7.3
CN3610500000000	36	105	Sullivan County, NY	1993	NA	33526	30788	2738	8.2
CN3610700000000	36	107	Tioga County, NY	1993	NA	26360	24667	1693	6.4
CN3610900000000	36	109	Tompkins County, NY	1993	NA	48739	46763	1976	4.1
CN3611100000000	36	111	Ulster County, NY	1993	NA	83191	77066	6125	7.4
CN3611300000000	36	113	Warren County, NY	1993	NA	31909	29264	2645	8.3
CN3611500000000	36	115	Washington County, NY	1993	NA	28916	26971	1945	6.7
CN3611700000000	36	117	Wayne County, NY	1993	NA	48023	45088	2935	6.1
CN3611900000000	36	119	Westchester County, NY	1993	NA	444257	419654	24603	5.5
CN3612100000000	36	121	Wyoming County, NY	1993	NA	20929	19247	1682	8
CN3612300000000	36	123	Yates County, NY	1993	NA	11842	11178	664	5.6
CN3700100000000	37	001	Alamance County, NC	1993	NA	62949	60158	2791	4.4
CN3700300000000	37	003	Alexander County, NC	1993	NA	16541	16020	521	3.1
CN3700500000000	37	005	Alleghany County, NC	1993	NA	4903	4654	249	5.1
CN3700700000000	37	007	Anson County, NC	1993	NA	11752	10691	1061	9
CN3700900000000	37	009	Ashe County, NC	1993	NA	11731	10884	847	7.2
CN3701100000000	37	011	Avery County, NC	1993	NA	7289	6684	605	8.3
CN3701300000000	37	013	Beaufort County, NC	1993	NA	19887	18520	1367	6.9
CN3701500000000	37	015	Bertie County, NC	1993	NA	8964	8384	580	6.5
CN3701700000000	37	017	Bladen County, NC	1993	NA	15351	14009	1342	8.7
CN3701900000000	37	019	Brunswick County, NC	1993	NA	28043	25012	3031	10.8
CN3702100000000	37	021	Buncombe County, NC	1993	NA	98310	94188	4122	4.2
CN3702300000000	37	023	Burke County, NC	1993	NA	43146	41181	1965	4.6
CN3702500000000	37	025	Cabarrus County, NC	1993	NA	57758	55257	2501	4.3
CN3702700000000	37	027	Caldwell County, NC	1993	NA	41004	39375	1629	4
CN3702900000000	37	029	Camden County, NC	1993	NA	2847	2720	127	4.5
CN3703100000000	37	031	Carteret County, NC	1993	NA	27364	25569	1795	6.6
CN3703300000000	37	033	Caswell County, NC	1993	NA	10946	10436	510	4.7
CN3703500000000	37	035	Catawba County, NC	1993	NA	73246	70204	3042	4.2
CN3703700000000	37	037	Chatham County, NC	1993	NA	23019	22424	595	2.6
CN3703900000000	37	039	Cherokee County, NC	1993	NA	9305	8363	942	10.1
CN3704100000000	37	041	Chowan County, NC	1993	NA	6722	6374	348	5.2
CN3704300000000	37	043	Clay County, NC	1993	NA	3307	3015	292	8.8
CN3704500000000	37	045	Cleveland County, NC	1993	NA	45717	43258	2459	5.4
CN3704700000000	37	047	Columbus County, NC	1993	NA	25154	23021	2133	8.5
CN3704900000000	37	049	Craven County, NC	1993	NA	34225	32217	2008	5.9
CN3705100000000	37	051	Cumberland County, NC	1993	NA	111569	105536	6033	5.4
CN3705300000000	37	053	Currituck County, NC	1993	NA	7454	7161	293	3.9
CN3705500000000	37	055	Dare County, NC	1993	NA	15057	13951	1106	7.3
CN3705700000000	37	057	Davidson County, NC	1993	NA	74900	71805	3095	4.1
CN3705900000000	37	059	Davie County, NC	1993	NA	15916	15276	640	4
CN3706100000000	37	061	Duplin County, NC	1993	NA	20955	19313	1642	7.8
CN3706300000000	37	063	Durham County, NC	1993	NA	106602	102886	3716	3.5
CN3706500000000	37	065	Edgecombe County, NC	1993	NA	27729	25747	1982	7.1
CN3706700000000	37	067	Forsyth County, NC	1993	NA	147730	141584	6146	4.2
CN3706900000000	37	069	Franklin County, NC	1993	NA	20108	19120	988	4.9
CN3707100000000	37	071	Gaston County, NC	1993	NA	96460	91424	5036	5.2
CN3707300000000	37	073	Gates County, NC	1993	NA	4273	4125	148	3.5
CN3707500000000	37	075	Graham County, NC	1993	NA	4273	3677	596	13.9
CN3707700000000	37	077	Granville County, NC	1993	NA	21107	20111	996	4.7
CN3707900000000	37	079	Greene County, NC	1993	NA	7782	7422	360	4.6
CN3708100000000	37	081	Guilford County, NC	1993	NA	207287	198227	9060	4.4
CN3708300000000	37	083	Halifax County, NC	1993	NA	24960	22992	1968	7.9
CN3708500000000	37	085	Harnett County, NC	1993	NA	32093	30550	1543	4.8
CN3708700000000	37	087	Haywood County, NC	1993	NA	23671	22197	1474	6.2
CN3708900000000	37	089	Henderson County, NC	1993	NA	33382	31994	1388	4.2
CN3709100000000	37	091	Hertford County, NC	1993	NA	10501	9502	999	9.5
CN3709300000000	37	093	Hoke County, NC	1993	NA	10354	9521	833	8
CN3709500000000	37	095	Hyde County, NC	1993	NA	2849	2562	287	10.1
CN3709700000000	37	097	Iredell County, NC	1993	NA	54872	52834	2038	3.7
CN3709900000000	37	099	Jackson County, NC	1993	NA	14483	13510	973	6.7
CN3710100000000	37	101	Johnston County, NC	1993	NA	47761	45959	1802	3.8
CN3710300000000	37	103	Jones County, NC	1993	NA	4478	4259	219	4.9
CN3710500000000	37	105	Lee County, NC	1993	NA	24143	22942	1201	5
CN3710700000000	37	107	Lenoir County, NC	1993	NA	29056	27082	1974	6.8
CN3710900000000	37	109	Lincoln County, NC	1993	NA	29422	28171	1251	4.3
CN3711100000000	37	111	McDowell County, NC	1993	NA	19376	18222	1154	6
CN3711300000000	37	113	Macon County, NC	1993	NA	12167	11351	816	6.7
CN3711500000000	37	115	Madison County, NC	1993	NA	8561	8138	423	4.9
CN3711700000000	37	117	Martin County, NC	1993	NA	12992	12097	895	6.9
CN3711900000000	37	119	Mecklenburg County, NC	1993	NA	315947	302017	13930	4.4
CN3712100000000	37	121	Mitchell County, NC	1993	NA	6843	6303	540	7.9
CN3712300000000	37	123	Montgomery County, NC	1993	NA	11840	10896	944	8
CN3712500000000	37	125	Moore County, NC	1993	NA	28650	26903	1747	6.1
CN3712700000000	37	127	Nash County, NC	1993	NA	43617	40928	2689	6.2
CN3712900000000	37	129	New Hanover County, NC	1993	NA	71720	66583	5137	7.2
CN3713100000000	37	131	Northampton County, NC	1993	NA	8752	8191	561	6.4
CN3713300000000	37	133	Onslow County, NC	1993	NA	42520	40493	2027	4.8
CN3713500000000	37	135	Orange County, NC	1993	NA	57624	56320	1304	2.3
CN3713700000000	37	137	Pamlico County, NC	1993	NA	5154	4941	213	4.1
CN3713900000000	37	139	Pasquotank County, NC	1993	NA	13854	13093	761	5.5
CN3714100000000	37	141	Pender County, NC	1993	NA	13693	12512	1181	8.6
CN3714300000000	37	143	Perquimans County, NC	1993	NA	4405	4189	216	4.9
CN3714500000000	37	145	Person County, NC	1993	NA	16298	15039	1259	7.7
CN3714700000000	37	147	Pitt County, NC	1993	NA	59056	56017	3039	5.1
CN3714900000000	37	149	Polk County, NC	1993	NA	7304	7077	227	3.1
CN3715100000000	37	151	Randolph County, NC	1993	NA	64736	62783	1953	3
CN3715300000000	37	153	Richmond County, NC	1993	NA	21361	19503	1858	8.7
CN3715500000000	37	155	Robeson County, NC	1993	NA	54737	50256	4481	8.2
CN3715700000000	37	157	Rockingham County, NC	1993	NA	47047	44327	2720	5.8
CN3715900000000	37	159	Rowan County, NC	1993	NA	59490	57076	2414	4.1
CN3716100000000	37	161	Rutherford County, NC	1993	NA	30739	28994	1745	5.7
CN3716300000000	37	163	Sampson County, NC	1993	NA	23539	21884	1655	7
CN3716500000000	37	165	Scotland County, NC	1993	NA	17481	15896	1585	9.1
CN3716700000000	37	167	Stanly County, NC	1993	NA	27934	26496	1438	5.1
CN3716900000000	37	169	Stokes County, NC	1993	NA	20821	20137	684	3.3
CN3717100000000	37	171	Surry County, NC	1993	NA	35335	33880	1455	4.1
CN3717300000000	37	173	Swain County, NC	1993	NA	6135	5189	946	15.4
CN3717500000000	37	175	Transylvania County, NC	1993	NA	11510	10949	561	4.9
CN3717700000000	37	177	Tyrrell County, NC	1993	NA	1900	1665	235	12.4
CN3717900000000	37	179	Union County, NC	1993	NA	49810	47746	2064	4.1
CN3718100000000	37	181	Vance County, NC	1993	NA	19942	18203	1739	8.7
CN3718300000000	37	183	Wake County, NC	1993	NA	281383	272667	8716	3.1
CN3718500000000	37	185	Warren County, NC	1993	NA	7308	6716	592	8.1
CN3718700000000	37	187	Washington County, NC	1993	NA	6099	5568	531	8.7
CN3718900000000	37	189	Watauga County, NC	1993	NA	21154	20545	609	2.9
CN3719100000000	37	191	Wayne County, NC	1993	NA	46921	44379	2542	5.4
CN3719300000000	37	193	Wilkes County, NC	1993	NA	32134	31015	1119	3.5
CN3719500000000	37	195	Wilson County, NC	1993	NA	36735	32914	3821	10.4
CN3719700000000	37	197	Yadkin County, NC	1993	NA	16714	16132	582	3.5
CN3719900000000	37	199	Yancey County, NC	1993	NA	6323	5832	491	7.8
CN3800100000000	38	001	Adams County, ND	1993	NA	1499	1465	34	2.3
CN3800300000000	38	003	Barnes County, ND	1993	NA	5573	5379	194	3.5
CN3800500000000	38	005	Benson County, ND	1993	NA	2627	2268	359	13.7
CN3800700000000	38	007	Billings County, ND	1993	NA	549	529	20	3.6
CN3800900000000	38	009	Bottineau County, ND	1993	NA	3341	3204	137	4.1
CN3801100000000	38	011	Bowman County, ND	1993	NA	1825	1755	70	3.8
CN3801300000000	38	013	Burke County, ND	1993	NA	1100	1056	44	4
CN3801500000000	38	015	Burleigh County, ND	1993	NA	36593	35190	1403	3.8
CN3801700000000	38	017	Cass County, ND	1993	NA	63481	61785	1696	2.7
CN3801900000000	38	019	Cavalier County, ND	1993	NA	2603	2472	131	5
CN3802100000000	38	021	Dickey County, ND	1993	NA	2809	2737	72	2.6
CN3802300000000	38	023	Divide County, ND	1993	NA	1170	1147	23	2
CN3802500000000	38	025	Dunn County, ND	1993	NA	1891	1821	70	3.7
CN3802700000000	38	027	Eddy County, ND	1993	NA	1252	1146	106	8.5
CN3802900000000	38	029	Emmons County, ND	1993	NA	2098	2010	88	4.2
CN3803100000000	38	031	Foster County, ND	1993	NA	1951	1874	77	3.9
CN3803300000000	38	033	Golden Valley County, ND	1993	NA	922	882	40	4.3
CN3803500000000	38	035	Grand Forks County, ND	1993	NA	35703	34547	1156	3.2
CN3803700000000	38	037	Grant County, ND	1993	NA	1511	1459	52	3.4
CN3803900000000	38	039	Griggs County, ND	1993	NA	1536	1493	43	2.8
CN3804100000000	38	041	Hettinger County, ND	1993	NA	1366	1318	48	3.5
CN3804300000000	38	043	Kidder County, ND	1993	NA	1445	1371	74	5.1
CN3804500000000	38	045	LaMoure County, ND	1993	NA	2326	2264	62	2.7
CN3804700000000	38	047	Logan County, ND	1993	NA	1206	1183	23	1.9
CN3804900000000	38	049	McHenry County, ND	1993	NA	2762	2596	166	6
CN3805100000000	38	051	McIntosh County, ND	1993	NA	1714	1674	40	2.3
CN3805300000000	38	053	McKenzie County, ND	1993	NA	2805	2722	83	3
CN3805500000000	38	055	McLean County, ND	1993	NA	4539	4268	271	6
CN3805700000000	38	057	Mercer County, ND	1993	NA	4906	4484	422	8.6
CN3805900000000	38	059	Morton County, ND	1993	NA	12944	12279	665	5.1
CN3806100000000	38	061	Mountrail County, ND	1993	NA	3289	3030	259	7.9
CN3806300000000	38	063	Nelson County, ND	1993	NA	1720	1655	65	3.8
CN3806500000000	38	065	Oliver County, ND	1993	NA	1132	1088	44	3.9
CN3806700000000	38	067	Pembina County, ND	1993	NA	4804	4390	414	8.6
CN3806900000000	38	069	Pierce County, ND	1993	NA	2273	2205	68	3
CN3807100000000	38	071	Ramsey County, ND	1993	NA	6480	6220	260	4
CN3807300000000	38	073	Ransom County, ND	1993	NA	2639	2544	95	3.6
CN3807500000000	38	075	Renville County, ND	1993	NA	1356	1323	33	2.4
CN3807700000000	38	077	Richland County, ND	1993	NA	8390	8056	334	4
CN3807900000000	38	079	Rolette County, ND	1993	NA	5131	4345	786	15.3
CN3808100000000	38	081	Sargent County, ND	1993	NA	2146	2087	59	2.7
CN3808300000000	38	083	Sheridan County, ND	1993	NA	703	679	24	3.4
CN3808500000000	38	085	Sioux County, ND	1993	NA	1391	1140	251	18
CN3808700000000	38	087	Slope County, ND	1993	NA	397	380	17	4.3
CN3808900000000	38	089	Stark County, ND	1993	NA	12020	11508	512	4.3
CN3809100000000	38	091	Steele County, ND	1993	NA	1022	1005	17	1.7
CN3809300000000	38	093	Stutsman County, ND	1993	NA	11133	10692	441	4
CN3809500000000	38	095	Towner County, ND	1993	NA	1647	1608	39	2.4
CN3809700000000	38	097	Traill County, ND	1993	NA	3823	3669	154	4
CN3809900000000	38	099	Walsh County, ND	1993	NA	6466	6069	397	6.1
CN3810100000000	38	101	Ward County, ND	1993	NA	27202	25916	1286	4.7
CN3810300000000	38	103	Wells County, ND	1993	NA	2529	2359	170	6.7
CN3810500000000	38	105	Williams County, ND	1993	NA	10197	9721	476	4.7
CN3900100000000	39	001	Adams County, OH	1993	NA	11252	9537	1715	15.2
CN3900300000000	39	003	Allen County, OH	1993	NA	51700	47513	4187	8.1
CN3900500000000	39	005	Ashland County, OH	1993	NA	25488	23620	1868	7.3
CN3900700000000	39	007	Ashtabula County, OH	1993	NA	45223	41240	3983	8.8
CN3900900000000	39	009	Athens County, OH	1993	NA	24901	23308	1593	6.4
CN3901100000000	39	011	Auglaize County, OH	1993	NA	23948	22156	1792	7.5
CN3901300000000	39	013	Belmont County, OH	1993	NA	30896	28082	2814	9.1
CN3901500000000	39	015	Brown County, OH	1993	NA	17859	16198	1661	9.3
CN3901700000000	39	017	Butler County, OH	1993	NA	157583	146791	10792	6.8
CN3901900000000	39	019	Carroll County, OH	1993	NA	12555	11601	954	7.6
CN3902100000000	39	021	Champaign County, OH	1993	NA	19363	17669	1694	8.7
CN3902300000000	39	023	Clark County, OH	1993	NA	69160	64872	4288	6.2
CN3902500000000	39	025	Clermont County, OH	1993	NA	84792	79392	5400	6.4
CN3902700000000	39	027	Clinton County, OH	1993	NA	20116	18765	1351	6.7
CN3902900000000	39	029	Columbiana County, OH	1993	NA	50774	46403	4371	8.6
CN3903100000000	39	031	Coshocton County, OH	1993	NA	16359	15212	1147	7
CN3903300000000	39	033	Crawford County, OH	1993	NA	22496	20620	1876	8.3
CN3903500000000	39	035	Cuyahoga County, OH	1993	NA	676029	631674	44355	6.6
CN3903700000000	39	037	Darke County, OH	1993	NA	28347	26591	1756	6.2
CN3903900000000	39	039	Defiance County, OH	1993	NA	20265	18880	1385	6.8
CN3904100000000	39	041	Delaware County, OH	1993	NA	40065	38069	1996	5
CN3904300000000	39	043	Erie County, OH	1993	NA	42456	39617	2839	6.7
CN3904500000000	39	045	Fairfield County, OH	1993	NA	57162	53792	3370	5.9
CN3904700000000	39	047	Fayette County, OH	1993	NA	14185	13241	944	6.7
CN3904900000000	39	049	Franklin County, OH	1993	NA	552370	526661	25709	4.7
CN3905100000000	39	051	Fulton County, OH	1993	NA	21329	19829	1500	7
CN3905300000000	39	053	Gallia County, OH	1993	NA	13518	12273	1245	9.2
CN3905500000000	39	055	Geauga County, OH	1993	NA	42691	40590	2101	4.9
CN3905700000000	39	057	Greene County, OH	1993	NA	67165	63882	3283	4.9
CN3905900000000	39	059	Guernsey County, OH	1993	NA	18461	16207	2254	12.2
CN3906100000000	39	061	Hamilton County, OH	1993	NA	439491	414520	24971	5.7
CN3906300000000	39	063	Hancock County, OH	1993	NA	38413	36549	1864	4.9
CN3906500000000	39	065	Hardin County, OH	1993	NA	14689	13570	1119	7.6
CN3906700000000	39	067	Harrison County, OH	1993	NA	7435	6789	646	8.7
CN3906900000000	39	069	Henry County, OH	1993	NA	16511	15182	1329	8
CN3907100000000	39	071	Highland County, OH	1993	NA	16857	15476	1381	8.2
CN3907300000000	39	073	Hocking County, OH	1993	NA	12122	10853	1269	10.5
CN3907500000000	39	075	Holmes County, OH	1993	NA	15951	15364	587	3.7
CN3907700000000	39	077	Huron County, OH	1993	NA	29288	25965	3323	11.3
CN3907900000000	39	079	Jackson County, OH	1993	NA	13752	12505	1247	9.1
CN3908100000000	39	081	Jefferson County, OH	1993	NA	31964	28863	3101	9.7
CN3908300000000	39	083	Knox County, OH	1993	NA	25668	24120	1548	6
CN3908500000000	39	085	Lake County, OH	1993	NA	120602	112689	7913	6.6
CN3908700000000	39	087	Lawrence County, OH	1993	NA	25760	23584	2176	8.4
CN3908900000000	39	089	Licking County, OH	1993	NA	67206	63363	3843	5.7
CN3909100000000	39	091	Logan County, OH	1993	NA	22808	21143	1665	7.3
CN3909300000000	39	093	Lorain County, OH	1993	NA	134728	126233	8495	6.3
CN3909500000000	39	095	Lucas County, OH	1993	NA	224765	208713	16052	7.1
CN3909700000000	39	097	Madison County, OH	1993	NA	19260	17937	1323	6.9
CN3909900000000	39	099	Mahoning County, OH	1993	NA	118991	108664	10327	8.7
CN3910100000000	39	101	Marion County, OH	1993	NA	31399	29025	2374	7.6
CN3910300000000	39	103	Medina County, OH	1993	NA	68642	64947	3695	5.4
CN3910500000000	39	105	Meigs County, OH	1993	NA	8494	7498	996	11.7
CN3910700000000	39	107	Mercer County, OH	1993	NA	20189	18668	1521	7.5
CN3910900000000	39	109	Miami County, OH	1993	NA	49086	46041	3045	6.2
CN3911100000000	39	111	Monroe County, OH	1993	NA	6338	5588	750	11.8
CN3911300000000	39	113	Montgomery County, OH	1993	NA	281547	265839	15708	5.6
CN3911500000000	39	115	Morgan County, OH	1993	NA	5490	4791	699	12.7
CN3911700000000	39	117	Morrow County, OH	1993	NA	13853	12847	1006	7.3
CN3911900000000	39	119	Muskingum County, OH	1993	NA	41399	37635	3764	9.1
CN3912100000000	39	121	Noble County, OH	1993	NA	5056	4571	485	9.6
CN3912300000000	39	123	Ottawa County, OH	1993	NA	20980	18959	2021	9.6
CN3912500000000	39	125	Paulding County, OH	1993	NA	9554	8920	634	6.6
CN3912700000000	39	127	Perry County, OH	1993	NA	14324	12612	1712	12
CN3912900000000	39	129	Pickaway County, OH	1993	NA	22563	21289	1274	5.6
CN3913100000000	39	131	Pike County, OH	1993	NA	10702	9272	1430	13.4
CN3913300000000	39	133	Portage County, OH	1993	NA	78813	74114	4699	6
CN3913500000000	39	135	Preble County, OH	1993	NA	20458	19133	1325	6.5
CN3913700000000	39	137	Putnam County, OH	1993	NA	18476	17252	1224	6.6
CN3913900000000	39	139	Richland County, OH	1993	NA	61996	56805	5191	8.4
CN3914100000000	39	141	Ross County, OH	1993	NA	32266	29622	2644	8.2
CN3914300000000	39	143	Sandusky County, OH	1993	NA	31184	28875	2309	7.4
CN3914500000000	39	145	Scioto County, OH	1993	NA	31632	28132	3500	11.1
CN3914700000000	39	147	Seneca County, OH	1993	NA	30001	27578	2423	8.1
CN3914900000000	39	149	Shelby County, OH	1993	NA	25638	23708	1930	7.5
CN3915100000000	39	151	Stark County, OH	1993	NA	184839	171404	13435	7.3
CN3915300000000	39	153	Summit County, OH	1993	NA	267275	250677	16598	6.2
CN3915500000000	39	155	Trumbull County, OH	1993	NA	111383	101605	9778	8.8
CN3915700000000	39	157	Tuscarawas County, OH	1993	NA	43142	39974	3168	7.3
CN3915900000000	39	159	Union County, OH	1993	NA	15577	14727	850	5.5
CN3916100000000	39	161	Van Wert County, OH	1993	NA	16174	15263	911	5.6
CN3916300000000	39	163	Vinton County, OH	1993	NA	4037	3481	556	13.8
CN3916500000000	39	165	Warren County, OH	1993	NA	64150	60206	3944	6.1
CN3916700000000	39	167	Washington County, OH	1993	NA	31842	29167	2675	8.4
CN3916900000000	39	169	Wayne County, OH	1993	NA	53663	51029	2634	4.9
CN3917100000000	39	171	Williams County, OH	1993	NA	21484	20230	1254	5.8
CN3917300000000	39	173	Wood County, OH	1993	NA	61274	58057	3217	5.3
CN3917500000000	39	175	Wyandot County, OH	1993	NA	11616	10705	911	7.8
CN4000100000000	40	001	Adair County, OK	1993	NA	9880	9353	527	5.3
CN4000300000000	40	003	Alfalfa County, OK	1993	NA	2678	2625	53	2
CN4000500000000	40	005	Atoka County, OK	1993	NA	4876	4559	317	6.5
CN4000700000000	40	007	Beaver County, OK	1993	NA	2908	2815	93	3.2
CN4000900000000	40	009	Beckham County, OK	1993	NA	9132	8606	526	5.8
CN4001100000000	40	011	Blaine County, OK	1993	NA	5036	4801	235	4.7
CN4001300000000	40	013	Bryan County, OK	1993	NA	13648	12926	722	5.3
CN4001500000000	40	015	Caddo County, OK	1993	NA	12103	11239	864	7.1
CN4001700000000	40	017	Canadian County, OK	1993	NA	39937	38429	1508	3.8
CN4001900000000	40	019	Carter County, OK	1993	NA	20590	19324	1266	6.1
CN4002100000000	40	021	Cherokee County, OK	1993	NA	16165	15007	1158	7.2
CN4002300000000	40	023	Choctaw County, OK	1993	NA	5912	5144	768	13
CN4002500000000	40	025	Cimarron County, OK	1993	NA	1774	1740	34	1.9
CN4002700000000	40	027	Cleveland County, OK	1993	NA	95999	92712	3287	3.4
CN4002900000000	40	029	Coal County, OK	1993	NA	2556	2292	264	10.3
CN4003100000000	40	031	Comanche County, OK	1993	NA	42568	39987	2581	6.1
CN4003300000000	40	033	Cotton County, OK	1993	NA	2330	2194	136	5.8
CN4003500000000	40	035	Craig County, OK	1993	NA	6419	6082	337	5.3
CN4003700000000	40	037	Creek County, OK	1993	NA	29766	27751	2015	6.8
CN4003900000000	40	039	Custer County, OK	1993	NA	13270	12704	566	4.3
CN4004100000000	40	041	Delaware County, OK	1993	NA	14195	13496	699	4.9
CN4004300000000	40	043	Dewey County, OK	1993	NA	2371	2284	87	3.7
CN4004500000000	40	045	Ellis County, OK	1993	NA	1881	1810	71	3.8
CN4004700000000	40	047	Garfield County, OK	1993	NA	27134	26097	1037	3.8
CN4004900000000	40	049	Garvin County, OK	1993	NA	11282	10476	806	7.1
CN4005100000000	40	051	Grady County, OK	1993	NA	19516	18396	1120	5.7
CN4005300000000	40	053	Grant County, OK	1993	NA	2481	2426	55	2.2
CN4005500000000	40	055	Greer County, OK	1993	NA	2388	2303	85	3.6
CN4005700000000	40	057	Harmon County, OK	1993	NA	1356	1296	60	4.4
CN4005900000000	40	059	Harper County, OK	1993	NA	2018	1962	56	2.8
CN4006100000000	40	061	Haskell County, OK	1993	NA	4319	3559	760	17.6
CN4006300000000	40	063	Hughes County, OK	1993	NA	5628	4952	676	12
CN4006500000000	40	065	Jackson County, OK	1993	NA	10687	10190	497	4.7
CN4006700000000	40	067	Jefferson County, OK	1993	NA	3219	3005	214	6.6
CN4006900000000	40	069	Johnston County, OK	1993	NA	4518	4252	266	5.9
CN4007100000000	40	071	Kay County, OK	1993	NA	23788	21810	1978	8.3
CN4007300000000	40	073	Kingfisher County, OK	1993	NA	6601	6305	296	4.5
CN4007500000000	40	075	Kiowa County, OK	1993	NA	4894	4674	220	4.5
CN4007700000000	40	077	Latimer County, OK	1993	NA	4117	3435	682	16.6
CN4007900000000	40	079	Le Flore County, OK	1993	NA	18472	16788	1684	9.1
CN4008100000000	40	081	Lincoln County, OK	1993	NA	14858	14088	770	5.2
CN4008300000000	40	083	Logan County, OK	1993	NA	13452	12862	590	4.4
CN4008500000000	40	085	Love County, OK	1993	NA	3934	3660	274	7
CN4008700000000	40	087	McClain County, OK	1993	NA	11274	10808	466	4.1
CN4008900000000	40	089	McCurtain County, OK	1993	NA	14640	13376	1264	8.6
CN4009100000000	40	091	McIntosh County, OK	1993	NA	7003	6293	710	10.1
CN4009300000000	40	093	Major County, OK	1993	NA	3737	3601	136	3.6
CN4009500000000	40	095	Marshall County, OK	1993	NA	4995	4680	315	6.3
CN4009700000000	40	097	Mayes County, OK	1993	NA	14594	13395	1199	8.2
CN4009900000000	40	099	Murray County, OK	1993	NA	5624	5107	517	9.2
CN4010100000000	40	101	Muskogee County, OK	1993	NA	29777	27416	2361	7.9
CN4010300000000	40	103	Noble County, OK	1993	NA	5295	5069	226	4.3
CN4010500000000	40	105	Nowata County, OK	1993	NA	3990	3705	285	7.1
CN4010700000000	40	107	Okfuskee County, OK	1993	NA	4495	4074	421	9.4
CN4010900000000	40	109	Oklahoma County, OK	1993	NA	305784	289415	16369	5.4
CN4011100000000	40	111	Okmulgee County, OK	1993	NA	15032	13408	1624	10.8
CN4011300000000	40	113	Osage County, OK	1993	NA	19054	18024	1030	5.4
CN4011500000000	40	115	Ottawa County, OK	1993	NA	13370	12398	972	7.3
CN4011700000000	40	117	Pawnee County, OK	1993	NA	6857	6140	717	10.5
CN4011900000000	40	119	Payne County, OK	1993	NA	33237	32286	951	2.9
CN4012100000000	40	121	Pittsburg County, OK	1993	NA	18337	16330	2007	10.9
CN4012300000000	40	123	Pontotoc County, OK	1993	NA	16191	15151	1040	6.4
CN4012500000000	40	125	Pottawatomie County, OK	1993	NA	26172	24707	1465	5.6
CN4012700000000	40	127	Pushmataha County, OK	1993	NA	4906	4507	399	8.1
CN4012900000000	40	129	Roger Mills County, OK	1993	NA	2106	2027	79	3.8
CN4013100000000	40	131	Rogers County, OK	1993	NA	30053	27930	2123	7.1
CN4013300000000	40	133	Seminole County, OK	1993	NA	10906	9965	941	8.6
CN4013500000000	40	135	Sequoyah County, OK	1993	NA	15959	14616	1343	8.4
CN4013700000000	40	137	Stephens County, OK	1993	NA	18401	17253	1148	6.2
CN4013900000000	40	139	Texas County, OK	1993	NA	8685	8422	263	3
CN4014100000000	40	141	Tillman County, OK	1993	NA	4183	3903	280	6.7
CN4014300000000	40	143	Tulsa County, OK	1993	NA	273424	256949	16475	6
CN4014500000000	40	145	Wagoner County, OK	1993	NA	24950	23596	1354	5.4
CN4014700000000	40	147	Washington County, OK	1993	NA	21046	19612	1434	6.8
CN4014900000000	40	149	Washita County, OK	1993	NA	5129	4914	215	4.2
CN4015100000000	40	151	Woods County, OK	1993	NA	4312	4200	112	2.6
CN4015300000000	40	153	Woodward County, OK	1993	NA	9016	8510	506	5.6
CN4100100000000	41	001	Baker County, OR	1993	NA	7341	6660	681	9.3
CN4100300000000	41	003	Benton County, OR	1993	NA	37653	36423	1230	3.3
CN4100500000000	41	005	Clackamas County, OR	1993	NA	170322	161461	8861	5.2
CN4100700000000	41	007	Clatsop County, OR	1993	NA	17426	15978	1448	8.3
CN4100900000000	41	009	Columbia County, OR	1993	NA	20252	18376	1876	9.3
CN4101100000000	41	011	Coos County, OR	1993	NA	28063	25115	2948	10.5
CN4101300000000	41	013	Crook County, OR	1993	NA	7710	6981	729	9.5
CN4101500000000	41	015	Curry County, OR	1993	NA	8175	7456	719	8.8
CN4101700000000	41	017	Deschutes County, OR	1993	NA	47352	43362	3990	8.4
CN4101900000000	41	019	Douglas County, OR	1993	NA	43041	38131	4910	11.4
CN4102100000000	41	021	Gilliam County, OR	1993	NA	1132	1077	55	4.9
CN4102300000000	41	023	Grant County, OR	1993	NA	4359	3850	509	11.7
CN4102500000000	41	025	Harney County, OR	1993	NA	3796	3355	441	11.6
CN4102700000000	41	027	Hood River County, OR	1993	NA	10229	9184	1045	10.2
CN4102900000000	41	029	Jackson County, OR	1993	NA	79668	73036	6632	8.3
CN4103100000000	41	031	Jefferson County, OR	1993	NA	7335	6703	632	8.6
CN4103300000000	41	033	Josephine County, OR	1993	NA	28339	25373	2966	10.5
CN4103500000000	41	035	Klamath County, OR	1993	NA	28520	25521	2999	10.5
CN4103700000000	41	037	Lake County, OR	1993	NA	3852	3498	354	9.2
CN4103900000000	41	039	Lane County, OR	1993	NA	150977	139845	11132	7.4
CN4104100000000	41	041	Lincoln County, OR	1993	NA	20576	19054	1522	7.4
CN4104300000000	41	043	Linn County, OR	1993	NA	46655	42353	4302	9.2
CN4104500000000	41	045	Malheur County, OR	1993	NA	14895	13613	1282	8.6
CN4104700000000	41	047	Marion County, OR	1993	NA	127803	118726	9077	7.1
CN4104900000000	41	049	Morrow County, OR	1993	NA	4003	3598	405	10.1
CN4105100000000	41	051	Multnomah County, OR	1993	NA	342375	320662	21713	6.3
CN4105300000000	41	053	Polk County, OR	1993	NA	26882	25284	1598	5.9
CN4105500000000	41	055	Sherman County, OR	1993	NA	944	849	95	10.1
CN4105700000000	41	057	Tillamook County, OR	1993	NA	10263	9631	632	6.2
CN4105900000000	41	059	Umatilla County, OR	1993	NA	31950	29167	2783	8.7
CN4106100000000	41	061	Union County, OR	1993	NA	12334	11404	930	7.5
CN4106300000000	41	063	Wallowa County, OR	1993	NA	3643	3275	368	10.1
CN4106500000000	41	065	Wasco County, OR	1993	NA	11848	10782	1066	9
CN4106700000000	41	067	Washington County, OR	1993	NA	204567	194124	10443	5.1
CN4106900000000	41	069	Wheeler County, OR	1993	NA	535	472	63	11.8
CN4107100000000	41	071	Yamhill County, OR	1993	NA	35022	33000	2022	5.8
CN4200100000000	42	001	Adams County, PA	1993	NA	41883	39695	2188	5.2
CN4200300000000	42	003	Allegheny County, PA	1993	NA	663330	621843	41487	6.3
CN4200500000000	42	005	Armstrong County, PA	1993	NA	31994	28712	3282	10.3
CN4200700000000	42	007	Beaver County, PA	1993	NA	86035	79566	6469	7.5
CN4200900000000	42	009	Bedford County, PA	1993	NA	23684	21464	2220	9.4
CN4201100000000	42	011	Berks County, PA	1993	NA	177838	167574	10264	5.8
CN4201300000000	42	013	Blair County, PA	1993	NA	63052	58500	4552	7.2
CN4201500000000	42	015	Bradford County, PA	1993	NA	27437	25550	1887	6.9
CN4201700000000	42	017	Bucks County, PA	1993	NA	305358	285931	19427	6.4
CN4201900000000	42	019	Butler County, PA	1993	NA	80003	74678	5325	6.7
CN4202100000000	42	021	Cambria County, PA	1993	NA	70077	62166	7911	11.3
CN4202300000000	42	023	Cameron County, PA	1993	NA	2524	2312	212	8.4
CN4202500000000	42	025	Carbon County, PA	1993	NA	26637	24392	2245	8.4
CN4202700000000	42	027	Centre County, PA	1993	NA	63010	60338	2672	4.2
CN4202900000000	42	029	Chester County, PA	1993	NA	211266	201403	9863	4.7
CN4203100000000	42	031	Clarion County, PA	1993	NA	18384	16902	1482	8.1
CN4203300000000	42	033	Clearfield County, PA	1993	NA	36556	33061	3495	9.6
CN4203500000000	42	035	Clinton County, PA	1993	NA	17470	15865	1605	9.2
CN4203700000000	42	037	Columbia County, PA	1993	NA	32251	29619	2632	8.2
CN4203900000000	42	039	Crawford County, PA	1993	NA	40134	37022	3112	7.8
CN4204100000000	42	041	Cumberland County, PA	1993	NA	113213	109212	4001	3.5
CN4204300000000	42	043	Dauphin County, PA	1993	NA	133645	127351	6294	4.7
CN4204500000000	42	045	Delaware County, PA	1993	NA	276611	259335	17276	6.2
CN4204700000000	42	047	Elk County, PA	1993	NA	17130	16216	914	5.3
CN4204900000000	42	049	Erie County, PA	1993	NA	140401	130601	9800	7
CN4205100000000	42	051	Fayette County, PA	1993	NA	56812	51313	5499	9.7
CN4205300000000	42	053	Forest County, PA	1993	NA	2070	1835	235	11.4
CN4205500000000	42	055	Franklin County, PA	1993	NA	62160	58796	3364	5.4
CN4205700000000	42	057	Fulton County, PA	1993	NA	6428	5997	431	6.7
CN4205900000000	42	059	Greene County, PA	1993	NA	15537	13694	1843	11.9
CN4206100000000	42	061	Huntingdon County, PA	1993	NA	19690	17409	2281	11.6
CN4206300000000	42	063	Indiana County, PA	1993	NA	37346	33233	4113	11
CN4206500000000	42	065	Jefferson County, PA	1993	NA	21331	19691	1640	7.7
CN4206700000000	42	067	Juniata County, PA	1993	NA	10194	9265	929	9.1
CN4206900000000	42	069	Lackawanna County, PA	1993	NA	107081	97977	9104	8.5
CN4207100000000	42	071	Lancaster County, PA	1993	NA	228613	219178	9435	4.1
CN4207300000000	42	073	Lawrence County, PA	1993	NA	40943	36933	4010	9.8
CN4207500000000	42	075	Lebanon County, PA	1993	NA	62891	59788	3103	4.9
CN4207700000000	42	077	Lehigh County, PA	1993	NA	153551	143913	9638	6.3
CN4207900000000	42	079	Luzerne County, PA	1993	NA	160012	145726	14286	8.9
CN4208100000000	42	081	Lycoming County, PA	1993	NA	57580	52805	4775	8.3
CN4208300000000	42	083	McKean County, PA	1993	NA	21209	19418	1791	8.4
CN4208500000000	42	085	Mercer County, PA	1993	NA	55332	49459	5873	10.6
CN4208700000000	42	087	Mifflin County, PA	1993	NA	22035	20340	1695	7.7
CN4208900000000	42	089	Monroe County, PA	1993	NA	49000	44195	4805	9.8
CN4209100000000	42	091	Montgomery County, PA	1993	NA	377994	357142	20852	5.5
CN4209300000000	42	093	Montour County, PA	1993	NA	8954	8574	380	4.2
CN4209500000000	42	095	Northampton County, PA	1993	NA	126308	118198	8110	6.4
CN4209700000000	42	097	Northumberland County, PA	1993	NA	45750	41688	4062	8.9
CN4209900000000	42	099	Perry County, PA	1993	NA	22625	21526	1099	4.9
CN4210100000000	42	101	Philadelphia County/city, PA	1993	NA	678420	615224	63196	9.3
CN4210300000000	42	103	Pike County, PA	1993	NA	16157	14922	1235	7.6
CN4210500000000	42	105	Potter County, PA	1993	NA	8345	7618	727	8.7
CN4210700000000	42	107	Schuylkill County, PA	1993	NA	69738	63642	6096	8.7
CN4210900000000	42	109	Snyder County, PA	1993	NA	18736	17653	1083	5.8
CN4211100000000	42	111	Somerset County, PA	1993	NA	36726	33103	3623	9.9
CN4211300000000	42	113	Sullivan County, PA	1993	NA	2733	2544	189	6.9
CN4211500000000	42	115	Susquehanna County, PA	1993	NA	19164	17460	1704	8.9
CN4211700000000	42	117	Tioga County, PA	1993	NA	19176	17741	1435	7.5
CN4211900000000	42	119	Union County, PA	1993	NA	17063	16116	947	5.6
CN4212100000000	42	121	Venango County, PA	1993	NA	25562	23319	2243	8.8
CN4212300000000	42	123	Warren County, PA	1993	NA	22436	20884	1552	6.9
CN4212500000000	42	125	Washington County, PA	1993	NA	94979	87693	7286	7.7
CN4212700000000	42	127	Wayne County, PA	1993	NA	18854	17006	1848	9.8
CN4212900000000	42	129	Westmoreland County, PA	1993	NA	180263	166157	14106	7.8
CN4213100000000	42	131	Wyoming County, PA	1993	NA	14826	13422	1404	9.5
CN4213300000000	42	133	York County, PA	1993	NA	189766	179651	10115	5.3
CN4400100000000	44	001	Bristol County, RI	1993	NA	26407	24366	2041	7.7
CN4400300000000	44	003	Kent County, RI	1993	NA	89671	82992	6679	7.4
CN4400500000000	44	005	Newport County, RI	1993	NA	41638	38245	3393	8.1
CN4400700000000	44	007	Providence County, RI	1993	NA	303046	278356	24690	8.1
CN4400900000000	44	009	Washington County, RI	1993	NA	61482	57814	3668	6
CN4500100000000	45	001	Abbeville County, SC	1993	NA	12408	11265	1143	9.2
CN4500300000000	45	003	Aiken County, SC	1993	NA	64701	59693	5008	7.7
CN4500500000000	45	005	Allendale County, SC	1993	NA	4760	4171	589	12.4
CN4500700000000	45	007	Anderson County, SC	1993	NA	79037	74649	4388	5.6
CN4500900000000	45	009	Bamberg County, SC	1993	NA	7854	6894	960	12.2
CN4501100000000	45	011	Barnwell County, SC	1993	NA	10772	9382	1390	12.9
CN4501300000000	45	013	Beaufort County, SC	1993	NA	40120	38129	1991	5
CN4501500000000	45	015	Berkeley County, SC	1993	NA	60371	56548	3823	6.3
CN4501700000000	45	017	Calhoun County, SC	1993	NA	6225	5851	374	6
CN4501900000000	45	019	Charleston County, SC	1993	NA	145555	136061	9494	6.5
CN4502100000000	45	021	Cherokee County, SC	1993	NA	23781	22367	1414	5.9
CN4502300000000	45	023	Chester County, SC	1993	NA	15923	13817	2106	13.2
CN4502500000000	45	025	Chesterfield County, SC	1993	NA	20257	18634	1623	8
CN4502700000000	45	027	Clarendon County, SC	1993	NA	12456	10717	1739	14
CN4502900000000	45	029	Colleton County, SC	1993	NA	15902	14031	1871	11.8
CN4503100000000	45	031	Darlington County, SC	1993	NA	32772	28764	4008	12.2
CN4503300000000	45	033	Dillon County, SC	1993	NA	13749	12064	1685	12.3
CN4503500000000	45	035	Dorchester County, SC	1993	NA	41711	39545	2166	5.2
CN4503700000000	45	037	Edgefield County, SC	1993	NA	9175	8542	633	6.9
CN4503900000000	45	039	Fairfield County, SC	1993	NA	11069	9873	1196	10.8
CN4504100000000	45	041	Florence County, SC	1993	NA	61452	56161	5291	8.6
CN4504300000000	45	043	Georgetown County, SC	1993	NA	23526	20480	3046	12.9
CN4504500000000	45	045	Greenville County, SC	1993	NA	180073	170818	9255	5.1
CN4504700000000	45	047	Greenwood County, SC	1993	NA	31950	29695	2255	7.1
CN4504900000000	45	049	Hampton County, SC	1993	NA	8177	7356	821	10
CN4505100000000	45	051	Horry County, SC	1993	NA	83127	75561	7566	9.1
CN4505300000000	45	053	Jasper County, SC	1993	NA	6981	6498	483	6.9
CN4505500000000	45	055	Kershaw County, SC	1993	NA	23799	21206	2593	10.9
CN4505700000000	45	057	Lancaster County, SC	1993	NA	29965	27211	2754	9.2
CN4505900000000	45	059	Laurens County, SC	1993	NA	30826	28902	1924	6.2
CN4506100000000	45	061	Lee County, SC	1993	NA	8563	7553	1010	11.8
CN4506300000000	45	063	Lexington County, SC	1993	NA	101177	96481	4696	4.6
CN4506500000000	45	065	McCormick County, SC	1993	NA	3849	3476	373	9.7
CN4506700000000	45	067	Marion County, SC	1993	NA	17158	14854	2304	13.4
CN4506900000000	45	069	Marlboro County, SC	1993	NA	12642	10967	1675	13.2
CN4507100000000	45	071	Newberry County, SC	1993	NA	17584	16291	1293	7.4
CN4507300000000	45	073	Oconee County, SC	1993	NA	28607	26123	2484	8.7
CN4507500000000	45	075	Orangeburg County, SC	1993	NA	40818	36637	4181	10.2
CN4507700000000	45	077	Pickens County, SC	1993	NA	52352	49530	2822	5.4
CN4507900000000	45	079	Richland County, SC	1993	NA	149934	141091	8843	5.9
CN4508100000000	45	081	Saluda County, SC	1993	NA	8662	8054	608	7
CN4508300000000	45	083	Spartanburg County, SC	1993	NA	123989	117666	6323	5.1
CN4508500000000	45	085	Sumter County, SC	1993	NA	44786	40891	3895	8.7
CN4508700000000	45	087	Union County, SC	1993	NA	16112	14643	1469	9.1
CN4508900000000	45	089	Williamsburg County, SC	1993	NA	17437	14853	2584	14.8
CN4509100000000	45	091	York County, SC	1993	NA	77541	72629	4912	6.3
CN4600300000000	46	003	Aurora County, SD	1993	NA	1304	1256	48	3.7
CN4600500000000	46	005	Beadle County, SD	1993	NA	9056	8803	253	2.8
CN4600700000000	46	007	Bennett County, SD	1993	NA	1012	962	50	4.9
CN4600900000000	46	009	Bon Homme County, SD	1993	NA	2990	2918	72	2.4
CN4601100000000	46	011	Brookings County, SD	1993	NA	14362	14071	291	2
CN4601300000000	46	013	Brown County, SD	1993	NA	19689	19225	464	2.4
CN4601500000000	46	015	Brule County, SD	1993	NA	2735	2634	101	3.7
CN4601700000000	46	017	Buffalo County, SD	1993	NA	733	682	51	7
CN4601900000000	46	019	Butte County, SD	1993	NA	3523	3352	171	4.9
CN4602100000000	46	021	Campbell County, SD	1993	NA	911	882	29	3.2
CN4602300000000	46	023	Charles Mix County, SD	1993	NA	4463	4299	164	3.7
CN4602500000000	46	025	Clark County, SD	1993	NA	1836	1752	84	4.6
CN4602700000000	46	027	Clay County, SD	1993	NA	6660	6570	90	1.4
CN4602900000000	46	029	Codington County, SD	1993	NA	13049	12544	505	3.9
CN4603100000000	46	031	Corson County, SD	1993	NA	1717	1345	372	21.7
CN4603300000000	46	033	Custer County, SD	1993	NA	3513	3351	162	4.6
CN4603500000000	46	035	Davison County, SD	1993	NA	9225	8954	271	2.9
CN4603700000000	46	037	Day County, SD	1993	NA	3000	2875	125	4.2
CN4603900000000	46	039	Deuel County, SD	1993	NA	2196	2102	94	4.3
CN4604100000000	46	041	Dewey County, SD	1993	NA	2100	1846	254	12.1
CN4604300000000	46	043	Douglas County, SD	1993	NA	1460	1416	44	3
CN4604500000000	46	045	Edmunds County, SD	1993	NA	2093	2058	35	1.7
CN4604700000000	46	047	Fall River County, SD	1993	NA	3310	3187	123	3.7
CN4604900000000	46	049	Faulk County, SD	1993	NA	1200	1171	29	2.4
CN4605100000000	46	051	Grant County, SD	1993	NA	4038	3835	203	5
CN4605300000000	46	053	Gregory County, SD	1993	NA	2513	2420	93	3.7
CN4605500000000	46	055	Haakon County, SD	1993	NA	1162	1111	51	4.4
CN4605700000000	46	057	Hamlin County, SD	1993	NA	2310	2215	95	4.1
CN4605900000000	46	059	Hand County, SD	1993	NA	2123	2067	56	2.6
CN4606100000000	46	061	Hanson County, SD	1993	NA	1535	1489	46	3
CN4606300000000	46	063	Harding County, SD	1993	NA	776	744	32	4.1
CN4606500000000	46	065	Hughes County, SD	1993	NA	9482	9224	258	2.7
CN4606700000000	46	067	Hutchinson County, SD	1993	NA	3746	3657	89	2.4
CN4606900000000	46	069	Hyde County, SD	1993	NA	763	740	23	3
CN4607100000000	46	071	Jackson County, SD	1993	NA	1038	974	64	6.2
CN4607300000000	46	073	Jerauld County, SD	1993	NA	1071	1033	38	3.5
CN4607500000000	46	075	Jones County, SD	1993	NA	767	736	31	4
CN4607700000000	46	077	Kingsbury County, SD	1993	NA	2584	2487	97	3.8
CN4607900000000	46	079	Lake County, SD	1993	NA	5584	5385	199	3.6
CN4608100000000	46	081	Lawrence County, SD	1993	NA	11998	11623	375	3.1
CN4608300000000	46	083	Lincoln County, SD	1993	NA	9122	8940	182	2
CN4608500000000	46	085	Lyman County, SD	1993	NA	2251	2147	104	4.6
CN4608700000000	46	087	McCook County, SD	1993	NA	2535	2459	76	3
CN4608900000000	46	089	McPherson County, SD	1993	NA	1396	1368	28	2
CN4609100000000	46	091	Marshall County, SD	1993	NA	2240	2174	66	2.9
CN4609300000000	46	093	Meade County, SD	1993	NA	11533	11099	434	3.8
CN4609500000000	46	095	Mellette County, SD	1993	NA	787	733	54	6.9
CN4609700000000	46	097	Miner County, SD	1993	NA	1365	1294	71	5.2
CN4609900000000	46	099	Minnehaha County, SD	1993	NA	76664	74873	1791	2.3
CN4610100000000	46	101	Moody County, SD	1993	NA	3306	3097	209	6.3
CN4610200000000	46	102	Oglala Lakota County, SD	1993	NA	2864	2428	436	15.2
CN4610300000000	46	103	Pennington County, SD	1993	NA	42773	41248	1525	3.6
CN4610500000000	46	105	Perkins County, SD	1993	NA	1996	1944	52	2.6
CN4610700000000	46	107	Potter County, SD	1993	NA	1473	1424	49	3.3
CN4610900000000	46	109	Roberts County, SD	1993	NA	4697	4453	244	5.2
CN4611100000000	46	111	Sanborn County, SD	1993	NA	1362	1316	46	3.4
CN4611500000000	46	115	Spink County, SD	1993	NA	3391	3294	97	2.9
CN4611700000000	46	117	Stanley County, SD	1993	NA	1584	1531	53	3.3
CN4611900000000	46	119	Sully County, SD	1993	NA	910	887	23	2.5
CN4612100000000	46	121	Todd County, SD	1993	NA	2464	2246	218	8.8
CN4612300000000	46	123	Tripp County, SD	1993	NA	3316	3206	110	3.3
CN4612500000000	46	125	Turner County, SD	1993	NA	3780	3649	131	3.5
CN4612700000000	46	127	Union County, SD	1993	NA	6248	5972	276	4.4
CN4612900000000	46	129	Walworth County, SD	1993	NA	2915	2817	98	3.4
CN4613500000000	46	135	Yankton County, SD	1993	NA	10179	9970	209	2.1
CN4613700000000	46	137	Ziebach County, SD	1993	NA	697	645	52	7.5
CN4700100000000	47	001	Anderson County, TN	1993	NA	35437	33690	1747	4.9
CN4700300000000	47	003	Bedford County, TN	1993	NA	16131	15165	966	6
CN4700500000000	47	005	Benton County, TN	1993	NA	7109	6519	590	8.3
CN4700700000000	47	007	Bledsoe County, TN	1993	NA	3465	3207	258	7.4
CN4700900000000	47	009	Blount County, TN	1993	NA	46907	44196	2711	5.8
CN4701100000000	47	011	Bradley County, TN	1993	NA	39128	36567	2561	6.5
CN4701300000000	47	013	Campbell County, TN	1993	NA	14348	12741	1607	11.2
CN4701500000000	47	015	Cannon County, TN	1993	NA	5216	4879	337	6.5
CN4701700000000	47	017	Carroll County, TN	1993	NA	13564	12703	861	6.3
CN4701900000000	47	019	Carter County, TN	1993	NA	25201	23571	1630	6.5
CN4702100000000	47	021	Cheatham County, TN	1993	NA	15408	14872	536	3.5
CN4702300000000	47	023	Chester County, TN	1993	NA	6499	6218	281	4.3
CN4702500000000	47	025	Claiborne County, TN	1993	NA	11732	11023	709	6
CN4702700000000	47	027	Clay County, TN	1993	NA	3525	3263	262	7.4
CN4702900000000	47	029	Cocke County, TN	1993	NA	14926	13074	1852	12.4
CN4703100000000	47	031	Coffee County, TN	1993	NA	20256	19053	1203	5.9
CN4703300000000	47	033	Crockett County, TN	1993	NA	6903	6354	549	8
CN4703500000000	47	035	Cumberland County, TN	1993	NA	16476	15041	1435	8.7
CN4703700000000	47	037	Davidson County, TN	1993	NA	283381	272110	11271	4
CN4703900000000	47	039	Decatur County, TN	1993	NA	4993	4618	375	7.5
CN4704100000000	47	041	DeKalb County, TN	1993	NA	7660	7105	555	7.2
CN4704300000000	47	043	Dickson County, TN	1993	NA	18016	17116	900	5
CN4704500000000	47	045	Dyer County, TN	1993	NA	16709	15456	1253	7.5
CN4704700000000	47	047	Fayette County, TN	1993	NA	11438	10607	831	7.3
CN4704900000000	47	049	Fentress County, TN	1993	NA	7157	6424	733	10.2
CN4705100000000	47	051	Franklin County, TN	1993	NA	16793	15839	954	5.7
CN4705300000000	47	053	Gibson County, TN	1993	NA	22242	20646	1596	7.2
CN4705500000000	47	055	Giles County, TN	1993	NA	13630	12964	666	4.9
CN4705700000000	47	057	Grainger County, TN	1993	NA	8655	7988	667	7.7
CN4705900000000	47	059	Greene County, TN	1993	NA	28170	25403	2767	9.8
CN4706100000000	47	061	Grundy County, TN	1993	NA	4691	4142	549	11.7
CN4706300000000	47	063	Hamblen County, TN	1993	NA	27403	25441	1962	7.2
CN4706500000000	47	065	Hamilton County, TN	1993	NA	145679	138793	6886	4.7
CN4706700000000	47	067	Hancock County, TN	1993	NA	2247	2023	224	10
CN4706900000000	47	069	Hardeman County, TN	1993	NA	9427	8420	1007	10.7
CN4707100000000	47	071	Hardin County, TN	1993	NA	10971	9647	1324	12.1
CN4707300000000	47	073	Hawkins County, TN	1993	NA	22048	20782	1266	5.7
CN4707500000000	47	075	Haywood County, TN	1993	NA	8469	7401	1068	12.6
CN4707700000000	47	077	Henderson County, TN	1993	NA	11951	11150	801	6.7
CN4707900000000	47	079	Henry County, TN	1993	NA	13676	12755	921	6.7
CN4708100000000	47	081	Hickman County, TN	1993	NA	8061	7412	649	8.1
CN4708300000000	47	083	Houston County, TN	1993	NA	3190	2799	391	12.3
CN4708500000000	47	085	Humphreys County, TN	1993	NA	7113	6259	854	12
CN4708700000000	47	087	Jackson County, TN	1993	NA	4182	3790	392	9.4
CN4708900000000	47	089	Jefferson County, TN	1993	NA	18718	17037	1681	9
CN4709100000000	47	091	Johnson County, TN	1993	NA	7184	6699	485	6.8
CN4709300000000	47	093	Knox County, TN	1993	NA	188713	181282	7431	3.9
CN4709500000000	47	095	Lake County, TN	1993	NA	2850	2691	159	5.6
CN4709700000000	47	097	Lauderdale County, TN	1993	NA	9280	7892	1388	15
CN4709900000000	47	099	Lawrence County, TN	1993	NA	20012	18731	1281	6.4
CN4710100000000	47	101	Lewis County, TN	1993	NA	4624	4218	406	8.8
CN4710300000000	47	103	Lincoln County, TN	1993	NA	14236	13277	959	6.7
CN4710500000000	47	105	Loudon County, TN	1993	NA	17716	16885	831	4.7
CN4710700000000	47	107	McMinn County, TN	1993	NA	20234	18656	1578	7.8
CN4710900000000	47	109	McNairy County, TN	1993	NA	11195	10252	943	8.4
CN4711100000000	47	111	Macon County, TN	1993	NA	8825	8384	441	5
CN4711300000000	47	113	Madison County, TN	1993	NA	40632	38393	2239	5.5
CN4711500000000	47	115	Marion County, TN	1993	NA	12043	11133	910	7.6
CN4711700000000	47	117	Marshall County, TN	1993	NA	11867	11299	568	4.8
CN4711900000000	47	119	Maury County, TN	1993	NA	32967	31121	1846	5.6
CN4712100000000	47	121	Meigs County, TN	1993	NA	3968	3521	447	11.3
CN4712300000000	47	123	Monroe County, TN	1993	NA	15167	13687	1480	9.8
CN4712500000000	47	125	Montgomery County, TN	1993	NA	44805	42358	2447	5.5
CN4712700000000	47	127	Moore County, TN	1993	NA	2727	2622	105	3.9
CN4712900000000	47	129	Morgan County, TN	1993	NA	6105	5505	600	9.8
CN4713100000000	47	131	Obion County, TN	1993	NA	14151	13134	1017	7.2
CN4713300000000	47	133	Overton County, TN	1993	NA	8800	7923	877	10
CN4713500000000	47	135	Perry County, TN	1993	NA	2956	2737	219	7.4
CN4713700000000	47	137	Pickett County, TN	1993	NA	2017	1869	148	7.3
CN4713900000000	47	139	Polk County, TN	1993	NA	6277	5768	509	8.1
CN4714100000000	47	141	Putnam County, TN	1993	NA	27485	25663	1822	6.6
CN4714300000000	47	143	Rhea County, TN	1993	NA	11035	9923	1112	10.1
CN4714500000000	47	145	Roane County, TN	1993	NA	28069	26457	1612	5.7
CN4714700000000	47	147	Robertson County, TN	1993	NA	23155	21692	1463	6.3
CN4714900000000	47	149	Rutherford County, TN	1993	NA	72891	69803	3088	4.2
CN4715100000000	47	151	Scott County, TN	1993	NA	7746	6578	1168	15.1
CN4715300000000	47	153	Sequatchie County, TN	1993	NA	4742	4369	373	7.9
CN4715500000000	47	155	Sevier County, TN	1993	NA	31149	28367	2782	8.9
CN4715700000000	47	157	Shelby County, TN	1993	NA	400623	378542	22081	5.5
CN4715900000000	47	159	Smith County, TN	1993	NA	8307	7910	397	4.8
CN4716100000000	47	161	Stewart County, TN	1993	NA	4093	3707	386	9.4
CN4716300000000	47	163	Sullivan County, TN	1993	NA	72654	69047	3607	5
CN4716500000000	47	165	Sumner County, TN	1993	NA	58439	55509	2930	5
CN4716700000000	47	167	Tipton County, TN	1993	NA	17916	16782	1134	6.3
CN4716900000000	47	169	Trousdale County, TN	1993	NA	2925	2747	178	6.1
CN4717100000000	47	171	Unicoi County, TN	1993	NA	7940	7155	785	9.9
CN4717300000000	47	173	Union County, TN	1993	NA	6695	6421	274	4.1
CN4717500000000	47	175	Van Buren County, TN	1993	NA	2437	2249	188	7.7
CN4717700000000	47	177	Warren County, TN	1993	NA	18599	17255	1344	7.2
CN4717900000000	47	179	Washington County, TN	1993	NA	49079	46259	2820	5.7
CN4718100000000	47	181	Wayne County, TN	1993	NA	7484	6933	551	7.4
CN4718300000000	47	183	Weakley County, TN	1993	NA	18047	17510	537	3
CN4718500000000	47	185	White County, TN	1993	NA	9911	9077	834	8.4
CN4718700000000	47	187	Williamson County, TN	1993	NA	48756	47338	1418	2.9
CN4718900000000	47	189	Wilson County, TN	1993	NA	38469	36896	1573	4.1
CN4800100000000	48	001	Anderson County, TX	1993	NA	18630	17467	1163	6.2
CN4800300000000	48	003	Andrews County, TX	1993	NA	6061	5606	455	7.5
CN4800500000000	48	005	Angelina County, TX	1993	NA	34384	31636	2748	8
CN4800700000000	48	007	Aransas County, TX	1993	NA	8317	7828	489	5.9
CN4800900000000	48	009	Archer County, TX	1993	NA	3875	3739	136	3.5
CN4801100000000	48	011	Armstrong County, TX	1993	NA	1005	965	40	4
CN4801300000000	48	013	Atascosa County, TX	1993	NA	14979	14049	930	6.2
CN4801500000000	48	015	Austin County, TX	1993	NA	10217	9808	409	4
CN4801700000000	48	017	Bailey County, TX	1993	NA	3891	3637	254	6.5
CN4801900000000	48	019	Bandera County, TX	1993	NA	6455	6254	201	3.1
CN4802100000000	48	021	Bastrop County, TX	1993	NA	20624	19896	728	3.5
CN4802300000000	48	023	Baylor County, TX	1993	NA	1848	1774	74	4
CN4802500000000	48	025	Bee County, TX	1993	NA	10137	8798	1339	13.2
CN4802700000000	48	027	Bell County, TX	1993	NA	84402	79434	4968	5.9
CN4802900000000	48	029	Bexar County, TX	1993	NA	603735	570095	33640	5.6
CN4803100000000	48	031	Blanco County, TX	1993	NA	3128	3022	106	3.4
CN4803300000000	48	033	Borden County, TX	1993	NA	403	391	12	3
CN4803500000000	48	035	Bosque County, TX	1993	NA	6424	6007	417	6.5
CN4803700000000	48	037	Bowie County, TX	1993	NA	39761	36073	3688	9.3
CN4803900000000	48	039	Brazoria County, TX	1993	NA	104909	96872	8037	7.7
CN4804100000000	48	041	Brazos County, TX	1993	NA	66694	64917	1777	2.7
CN4804300000000	48	043	Brewster County, TX	1993	NA	4485	4378	107	2.4
CN4804500000000	48	045	Briscoe County, TX	1993	NA	981	949	32	3.3
CN4804700000000	48	047	Brooks County, TX	1993	NA	3353	2990	363	10.8
CN4804900000000	48	049	Brown County, TX	1993	NA	15877	14578	1299	8.2
CN4805100000000	48	051	Burleson County, TX	1993	NA	7202	6858	344	4.8
CN4805300000000	48	053	Burnet County, TX	1993	NA	10282	9776	506	4.9
CN4805500000000	48	055	Caldwell County, TX	1993	NA	12715	12212	503	4
CN4805700000000	48	057	Calhoun County, TX	1993	NA	10246	9164	1082	10.6
CN4805900000000	48	059	Callahan County, TX	1993	NA	5807	5507	300	5.2
CN4806100000000	48	061	Cameron County, TX	1993	NA	117962	102097	15865	13.4
CN4806300000000	48	063	Camp County, TX	1993	NA	4988	4487	501	10
CN4806500000000	48	065	Carson County, TX	1993	NA	3592	3457	135	3.8
CN4806700000000	48	067	Cass County, TX	1993	NA	14443	12900	1543	10.7
CN4806900000000	48	069	Castro County, TX	1993	NA	4258	3957	301	7.1
CN4807100000000	48	071	Chambers County, TX	1993	NA	10342	9518	824	8
CN4807300000000	48	073	Cherokee County, TX	1993	NA	18858	17551	1307	6.9
CN4807500000000	48	075	Childress County, TX	1993	NA	3085	2932	153	5
CN4807700000000	48	077	Clay County, TX	1993	NA	4737	4526	211	4.5
CN4807900000000	48	079	Cochran County, TX	1993	NA	1887	1702	185	9.8
CN4808100000000	48	081	Coke County, TX	1993	NA	1412	1363	49	3.5
CN4808300000000	48	083	Coleman County, TX	1993	NA	3792	3565	227	6
CN4808500000000	48	085	Collin County, TX	1993	NA	182938	175291	7647	4.2
CN4808700000000	48	087	Collingsworth County, TX	1993	NA	1801	1699	102	5.7
CN4808900000000	48	089	Colorado County, TX	1993	NA	8461	8129	332	3.9
CN4809100000000	48	091	Comal County, TX	1993	NA	29360	27873	1487	5.1
CN4809300000000	48	093	Comanche County, TX	1993	NA	6413	6110	303	4.7
CN4809500000000	48	095	Concho County, TX	1993	NA	1447	1402	45	3.1
CN4809700000000	48	097	Cooke County, TX	1993	NA	15277	14245	1032	6.8
CN4809900000000	48	099	Coryell County, TX	1993	NA	19276	18270	1006	5.2
CN4810100000000	48	101	Cottle County, TX	1993	NA	903	831	72	8
CN4810300000000	48	103	Crane County, TX	1993	NA	2225	2069	156	7
CN4810500000000	48	105	Crockett County, TX	1993	NA	1909	1814	95	5
CN4810700000000	48	107	Crosby County, TX	1993	NA	3348	3104	244	7.3
CN4810900000000	48	109	Culberson County, TX	1993	NA	1410	1312	98	7
CN4811100000000	48	111	Dallam County, TX	1993	NA	3093	3003	90	2.9
CN4811300000000	48	113	Dallas County, TX	1993	NA	1103260	1031106	72154	6.5
CN4811500000000	48	115	Dawson County, TX	1993	NA	6098	5646	452	7.4
CN4811700000000	48	117	Deaf Smith County, TX	1993	NA	9294	8564	730	7.9
CN4811900000000	48	119	Delta County, TX	1993	NA	2208	2090	118	5.3
CN4812100000000	48	121	Denton County, TX	1993	NA	184621	176987	7634	4.1
CN4812300000000	48	123	DeWitt County, TX	1993	NA	8064	7628	436	5.4
CN4812500000000	48	125	Dickens County, TX	1993	NA	1024	959	65	6.3
CN4812700000000	48	127	Dimmit County, TX	1993	NA	3733	3027	706	18.9
CN4812900000000	48	129	Donley County, TX	1993	NA	1535	1479	56	3.6
CN4813100000000	48	131	Duval County, TX	1993	NA	4587	3974	613	13.4
CN4813300000000	48	133	Eastland County, TX	1993	NA	7974	7540	434	5.4
CN4813500000000	48	135	Ector County, TX	1993	NA	60082	54560	5522	9.2
CN4813700000000	48	137	Edwards County, TX	1993	NA	953	881	72	7.6
CN4813900000000	48	139	Ellis County, TX	1993	NA	45927	42896	3031	6.6
CN4814100000000	48	141	El Paso County, TX	1993	NA	279293	249307	29986	10.7
CN4814300000000	48	143	Erath County, TX	1993	NA	15091	14398	693	4.6
CN4814500000000	48	145	Falls County, TX	1993	NA	7387	6990	397	5.4
CN4814700000000	48	147	Fannin County, TX	1993	NA	11172	10328	844	7.6
CN4814900000000	48	149	Fayette County, TX	1993	NA	10145	9850	295	2.9
CN4815100000000	48	151	Fisher County, TX	1993	NA	2025	1893	132	6.5
CN4815300000000	48	153	Floyd County, TX	1993	NA	3597	3356	241	6.7
CN4815500000000	48	155	Foard County, TX	1993	NA	1061	1040	21	2
CN4815700000000	48	157	Fort Bend County, TX	1993	NA	141341	134543	6798	4.8
CN4815900000000	48	159	Franklin County, TX	1993	NA	3734	3437	297	8
CN4816100000000	48	161	Freestone County, TX	1993	NA	7514	6932	582	7.7
CN4816300000000	48	163	Frio County, TX	1993	NA	6975	6149	826	11.8
CN4816500000000	48	165	Gaines County, TX	1993	NA	6887	6531	356	5.2
CN4816700000000	48	167	Galveston County, TX	1993	NA	125193	114472	10721	8.6
CN4816900000000	48	169	Garza County, TX	1993	NA	2406	2261	145	6
CN4817100000000	48	171	Gillespie County, TX	1993	NA	9401	9197	204	2.2
CN4817300000000	48	173	Glasscock County, TX	1993	NA	601	584	17	2.8
CN4817500000000	48	175	Goliad County, TX	1993	NA	2758	2592	166	6
CN4817700000000	48	177	Gonzales County, TX	1993	NA	7645	7278	367	4.8
CN4817900000000	48	179	Gray County, TX	1993	NA	11270	10660	610	5.4
CN4818100000000	48	181	Grayson County, TX	1993	NA	46304	42889	3415	7.4
CN4818300000000	48	183	Gregg County, TX	1993	NA	56739	51200	5539	9.8
CN4818500000000	48	185	Grimes County, TX	1993	NA	8137	7715	422	5.2
CN4818700000000	48	187	Guadalupe County, TX	1993	NA	34698	33452	1246	3.6
CN4818900000000	48	189	Hale County, TX	1993	NA	17039	16075	964	5.7
CN4819100000000	48	191	Hall County, TX	1993	NA	1915	1786	129	6.7
CN4819300000000	48	193	Hamilton County, TX	1993	NA	3794	3631	163	4.3
CN4819500000000	48	195	Hansford County, TX	1993	NA	2550	2464	86	3.4
CN4819700000000	48	197	Hardeman County, TX	1993	NA	2070	1961	109	5.3
CN4819900000000	48	199	Hardin County, TX	1993	NA	21810	19667	2143	9.8
CN4820100000000	48	201	Harris County, TX	1993	NA	1639780	1515728	124052	7.6
CN4820300000000	48	203	Harrison County, TX	1993	NA	26989	24264	2725	10.1
CN4820500000000	48	205	Hartley County, TX	1993	NA	2106	2060	46	2.2
CN4820700000000	48	207	Haskell County, TX	1993	NA	2953	2806	147	5
CN4820900000000	48	209	Hays County, TX	1993	NA	38137	36903	1234	3.2
CN4821100000000	48	211	Hemphill County, TX	1993	NA	1880	1785	95	5.1
CN4821300000000	48	213	Henderson County, TX	1993	NA	25879	23960	1919	7.4
CN4821500000000	48	215	Hidalgo County, TX	1993	NA	176641	140307	36334	20.6
CN4821700000000	48	217	Hill County, TX	1993	NA	13066	12126	940	7.2
CN4821900000000	48	219	Hockley County, TX	1993	NA	11866	11275	591	5
CN4822100000000	48	221	Hood County, TX	1993	NA	14568	12807	1761	12.1
CN4822300000000	48	223	Hopkins County, TX	1993	NA	15596	14507	1089	7
CN4822500000000	48	225	Houston County, TX	1993	NA	8407	7940	467	5.6
CN4822700000000	48	227	Howard County, TX	1993	NA	14040	13302	738	5.3
CN4822900000000	48	229	Hudspeth County, TX	1993	NA	1382	1336	46	3.3
CN4823100000000	48	231	Hunt County, TX	1993	NA	32920	30352	2568	7.8
CN4823300000000	48	233	Hutchinson County, TX	1993	NA	10667	9737	930	8.7
CN4823500000000	48	235	Irion County, TX	1993	NA	945	913	32	3.4
CN4823700000000	48	237	Jack County, TX	1993	NA	3350	3210	140	4.2
CN4823900000000	48	239	Jackson County, TX	1993	NA	6931	6620	311	4.5
CN4824100000000	48	241	Jasper County, TX	1993	NA	14746	12686	2060	14
CN4824300000000	48	243	Jeff Davis County, TX	1993	NA	1032	983	49	4.7
CN4824500000000	48	245	Jefferson County, TX	1993	NA	121208	108645	12563	10.4
CN4824700000000	48	247	Jim Hogg County, TX	1993	NA	1928	1752	176	9.1
CN4824900000000	48	249	Jim Wells County, TX	1993	NA	16208	14629	1579	9.7
CN4825100000000	48	251	Johnson County, TX	1993	NA	51120	48134	2986	5.8
CN4825300000000	48	253	Jones County, TX	1993	NA	9025	8664	361	4
CN4825500000000	48	255	Karnes County, TX	1993	NA	5079	4746	333	6.6
CN4825700000000	48	257	Kaufman County, TX	1993	NA	26681	25046	1635	6.1
CN4825900000000	48	259	Kendall County, TX	1993	NA	8978	8770	208	2.3
CN4826100000000	48	261	Kenedy County, TX	1993	NA	229	223	6	2.6
CN4826300000000	48	263	Kent County, TX	1993	NA	433	414	19	4.4
CN4826500000000	48	265	Kerr County, TX	1993	NA	16662	16025	637	3.8
CN4826700000000	48	267	Kimble County, TX	1993	NA	2284	2215	69	3
CN4826900000000	48	269	King County, TX	1993	NA	156	149	7	4.5
CN4827100000000	48	271	Kinney County, TX	1993	NA	1178	1077	101	8.6
CN4827300000000	48	273	Kleberg County, TX	1993	NA	13521	12626	895	6.6
CN4827500000000	48	275	Knox County, TX	1993	NA	2389	2303	86	3.6
CN4827700000000	48	277	Lamar County, TX	1993	NA	21938	20221	1717	7.8
CN4827900000000	48	279	Lamb County, TX	1993	NA	6760	6329	431	6.4
CN4828100000000	48	281	Lampasas County, TX	1993	NA	6635	6264	371	5.6
CN4828300000000	48	283	La Salle County, TX	1993	NA	2653	2426	227	8.6
CN4828500000000	48	285	Lavaca County, TX	1993	NA	8911	8693	218	2.4
CN4828700000000	48	287	Lee County, TX	1993	NA	7142	6898	244	3.4
CN4828900000000	48	289	Leon County, TX	1993	NA	5418	4940	478	8.8
CN4829100000000	48	291	Liberty County, TX	1993	NA	25079	22252	2827	11.3
CN4829300000000	48	293	Limestone County, TX	1993	NA	9353	8834	519	5.5
CN4829500000000	48	295	Lipscomb County, TX	1993	NA	1382	1347	35	2.5
CN4829700000000	48	297	Live Oak County, TX	1993	NA	5274	5031	243	4.6
CN4829900000000	48	299	Llano County, TX	1993	NA	4512	4336	176	3.9
CN4830100000000	48	301	Loving County, TX	1993	NA	58	57	1	1.7
CN4830300000000	48	303	Lubbock County, TX	1993	NA	117025	111560	5465	4.7
CN4830500000000	48	305	Lynn County, TX	1993	NA	2933	2822	111	3.8
CN4830700000000	48	307	McCulloch County, TX	1993	NA	3729	3480	249	6.7
CN4830900000000	48	309	McLennan County, TX	1993	NA	95408	89967	5441	5.7
CN4831100000000	48	311	McMullen County, TX	1993	NA	313	300	13	4.2
CN4831300000000	48	313	Madison County, TX	1993	NA	4036	3835	201	5
CN4831500000000	48	315	Marion County, TX	1993	NA	3980	3521	459	11.5
CN4831700000000	48	317	Martin County, TX	1993	NA	1973	1918	55	2.8
CN4831900000000	48	319	Mason County, TX	1993	NA	1603	1547	56	3.5
CN4832100000000	48	321	Matagorda County, TX	1993	NA	17909	15250	2659	14.8
CN4832300000000	48	323	Maverick County, TX	1993	NA	17293	12155	5138	29.7
CN4832500000000	48	325	Medina County, TX	1993	NA	13222	12566	656	5
CN4832700000000	48	327	Menard County, TX	1993	NA	1025	988	37	3.6
CN4832900000000	48	329	Midland County, TX	1993	NA	58460	54566	3894	6.7
CN4833100000000	48	331	Milam County, TX	1993	NA	10268	9592	676	6.6
CN4833300000000	48	333	Mills County, TX	1993	NA	2114	2039	75	3.5
CN4833500000000	48	335	Mitchell County, TX	1993	NA	3216	2995	221	6.9
CN4833700000000	48	337	Montague County, TX	1993	NA	7731	7230	501	6.5
CN4833900000000	48	339	Montgomery County, TX	1993	NA	106474	100223	6251	5.9
CN4834100000000	48	341	Moore County, TX	1993	NA	8778	8452	326	3.7
CN4834300000000	48	343	Morris County, TX	1993	NA	5924	5294	630	10.6
CN4834500000000	48	345	Motley County, TX	1993	NA	793	762	31	3.9
CN4834700000000	48	347	Nacogdoches County, TX	1993	NA	26561	25273	1288	4.8
CN4834900000000	48	349	Navarro County, TX	1993	NA	19369	17858	1511	7.8
CN4835100000000	48	351	Newton County, TX	1993	NA	5718	4962	756	13.2
CN4835300000000	48	353	Nolan County, TX	1993	NA	7769	7163	606	7.8
CN4835500000000	48	355	Nueces County, TX	1993	NA	143653	130870	12783	8.9
CN4835700000000	48	357	Ochiltree County, TX	1993	NA	4495	4311	184	4.1
CN4835900000000	48	359	Oldham County, TX	1993	NA	1167	1097	70	6
CN4836100000000	48	361	Orange County, TX	1993	NA	43232	36837	6395	14.8
CN4836300000000	48	363	Palo Pinto County, TX	1993	NA	12092	10923	1169	9.7
CN4836500000000	48	365	Panola County, TX	1993	NA	8295	7456	839	10.1
CN4836700000000	48	367	Parker County, TX	1993	NA	34581	32544	2037	5.9
CN4836900000000	48	369	Parmer County, TX	1993	NA	4420	4225	195	4.4
CN4837100000000	48	371	Pecos County, TX	1993	NA	6652	6144	508	7.6
CN4837300000000	48	373	Polk County, TX	1993	NA	13499	12339	1160	8.6
CN4837500000000	48	375	Potter County, TX	1993	NA	49852	47062	2790	5.6
CN4837700000000	48	377	Presidio County, TX	1993	NA	3406	2268	1138	33.4
CN4837900000000	48	379	Rains County, TX	1993	NA	3127	2944	183	5.9
CN4838100000000	48	381	Randall County, TX	1993	NA	53577	51840	1737	3.2
CN4838300000000	48	383	Reagan County, TX	1993	NA	1975	1865	110	5.6
CN4838500000000	48	385	Real County, TX	1993	NA	1149	1072	77	6.7
CN4838700000000	48	387	Red River County, TX	1993	NA	5947	5483	464	7.8
CN4838900000000	48	389	Reeves County, TX	1993	NA	7031	6024	1007	14.3
CN4839100000000	48	391	Refugio County, TX	1993	NA	3287	3090	197	6
CN4839300000000	48	393	Roberts County, TX	1993	NA	553	535	18	3.3
CN4839500000000	48	395	Robertson County, TX	1993	NA	6750	6315	435	6.4
CN4839700000000	48	397	Rockwall County, TX	1993	NA	16727	16060	667	4
CN4839900000000	48	399	Runnels County, TX	1993	NA	5379	5116	263	4.9
CN4840100000000	48	401	Rusk County, TX	1993	NA	21019	19331	1688	8
CN4840300000000	48	403	Sabine County, TX	1993	NA	3613	3199	414	11.5
CN4840500000000	48	405	San Augustine County, TX	1993	NA	3152	2934	218	6.9
CN4840700000000	48	407	San Jacinto County, TX	1993	NA	7505	7120	385	5.1
CN4840900000000	48	409	San Patricio County, TX	1993	NA	27402	24838	2564	9.4
CN4841100000000	48	411	San Saba County, TX	1993	NA	2242	2143	99	4.4
CN4841300000000	48	413	Schleicher County, TX	1993	NA	1332	1249	83	6.2
CN4841500000000	48	415	Scurry County, TX	1993	NA	7886	7389	497	6.3
CN4841700000000	48	417	Shackelford County, TX	1993	NA	1537	1474	63	4.1
CN4841900000000	48	419	Shelby County, TX	1993	NA	9736	8946	790	8.1
CN4842100000000	48	421	Sherman County, TX	1993	NA	1407	1367	40	2.8
CN4842300000000	48	423	Smith County, TX	1993	NA	80853	75119	5734	7.1
CN4842500000000	48	425	Somervell County, TX	1993	NA	2587	2136	451	17.4
CN4842700000000	48	427	Starr County, TX	1993	NA	20195	14148	6047	29.9
CN4842900000000	48	429	Stephens County, TX	1993	NA	3950	3671	279	7.1
CN4843100000000	48	431	Sterling County, TX	1993	NA	763	732	31	4.1
CN4843300000000	48	433	Stonewall County, TX	1993	NA	816	755	61	7.5
CN4843500000000	48	435	Sutton County, TX	1993	NA	2136	2034	102	4.8
CN4843700000000	48	437	Swisher County, TX	1993	NA	4114	3925	189	4.6
CN4843900000000	48	439	Tarrant County, TX	1993	NA	690393	646660	43733	6.3
CN4844100000000	48	441	Taylor County, TX	1993	NA	57920	54697	3223	5.6
CN4844300000000	48	443	Terrell County, TX	1993	NA	595	557	38	6.4
CN4844500000000	48	445	Terry County, TX	1993	NA	6064	5638	426	7
CN4844700000000	48	447	Throckmorton County, TX	1993	NA	917	897	20	2.2
CN4844900000000	48	449	Titus County, TX	1993	NA	11788	10720	1068	9.1
CN4845100000000	48	451	Tom Green County, TX	1993	NA	49238	46700	2538	5.2
CN4845300000000	48	453	Travis County, TX	1993	NA	381622	366733	14889	3.9
CN4845500000000	48	455	Trinity County, TX	1993	NA	4886	4576	310	6.3
CN4845700000000	48	457	Tyler County, TX	1993	NA	7073	6313	760	10.7
CN4845900000000	48	459	Upshur County, TX	1993	NA	15151	14056	1095	7.2
CN4846100000000	48	461	Upton County, TX	1993	NA	1914	1808	106	5.5
CN4846300000000	48	463	Uvalde County, TX	1993	NA	10397	9122	1275	12.3
CN4846500000000	48	465	Val Verde County, TX	1993	NA	17482	15280	2202	12.6
CN4846700000000	48	467	Van Zandt County, TX	1993	NA	18240	17103	1137	6.2
CN4846900000000	48	469	Victoria County, TX	1993	NA	40809	38540	2269	5.6
CN4847100000000	48	471	Walker County, TX	1993	NA	20782	20118	664	3.2
CN4847300000000	48	473	Waller County, TX	1993	NA	11169	10636	533	4.8
CN4847500000000	48	475	Ward County, TX	1993	NA	4791	4344	447	9.3
CN4847700000000	48	477	Washington County, TX	1993	NA	13614	13195	419	3.1
CN4847900000000	48	479	Webb County, TX	1993	NA	64696	57902	6794	10.5
CN4848100000000	48	481	Wharton County, TX	1993	NA	19448	18034	1414	7.3
CN4848300000000	48	483	Wheeler County, TX	1993	NA	2677	2556	121	4.5
CN4848500000000	48	485	Wichita County, TX	1993	NA	57998	54677	3321	5.7
CN4848700000000	48	487	Wilbarger County, TX	1993	NA	7281	7013	268	3.7
CN4848900000000	48	489	Willacy County, TX	1993	NA	7393	5706	1687	22.8
CN4849100000000	48	491	Williamson County, TX	1993	NA	94245	91794	2451	2.6
CN4849300000000	48	493	Wilson County, TX	1993	NA	11527	11127	400	3.5
CN4849500000000	48	495	Winkler County, TX	1993	NA	3363	3048	315	9.4
CN4849700000000	48	497	Wise County, TX	1993	NA	17970	17041	929	5.2
CN4849900000000	48	499	Wood County, TX	1993	NA	14266	13361	905	6.3
CN4850100000000	48	501	Yoakum County, TX	1993	NA	3847	3582	265	6.9
CN4850300000000	48	503	Young County, TX	1993	NA	8926	8295	631	7.1
CN4850500000000	48	505	Zapata County, TX	1993	NA	3626	3025	601	16.6
CN4850700000000	48	507	Zavala County, TX	1993	NA	4728	3586	1142	24.2
CN4900100000000	49	001	Beaver County, UT	1993	NA	2135	2034	101	4.7
CN4900300000000	49	003	Box Elder County, UT	1993	NA	17493	16576	917	5.2
CN4900500000000	49	005	Cache County, UT	1993	NA	38747	37547	1200	3.1
CN4900700000000	49	007	Carbon County, UT	1993	NA	9032	8367	665	7.4
CN4900900000000	49	009	Daggett County, UT	1993	NA	397	382	15	3.8
CN4901100000000	49	011	Davis County, UT	1993	NA	100270	96576	3694	3.7
CN4901300000000	49	013	Duchesne County, UT	1993	NA	5757	5262	495	8.6
CN4901500000000	49	015	Emery County, UT	1993	NA	4139	3802	337	8.1
CN4901700000000	49	017	Garfield County, UT	1993	NA	2350	2121	229	9.7
CN4901900000000	49	019	Grand County, UT	1993	NA	4658	4361	297	6.4
CN4902100000000	49	021	Iron County, UT	1993	NA	11183	10758	425	3.8
CN4902300000000	49	023	Juab County, UT	1993	NA	3270	3069	201	6.1
CN4902500000000	49	025	Kane County, UT	1993	NA	2523	2350	173	6.9
CN4902700000000	49	027	Millard County, UT	1993	NA	4715	4462	253	5.4
CN4902900000000	49	029	Morgan County, UT	1993	NA	2972	2809	163	5.5
CN4903100000000	49	031	Piute County, UT	1993	NA	469	442	27	5.8
CN4903300000000	49	033	Rich County, UT	1993	NA	792	768	24	3
CN4903500000000	49	035	Salt Lake County, UT	1993	NA	421124	406071	15053	3.6
CN4903700000000	49	037	San Juan County, UT	1993	NA	5092	4726	366	7.2
CN4903900000000	49	039	Sanpete County, UT	1993	NA	7171	6715	456	6.4
CN4904100000000	49	041	Sevier County, UT	1993	NA	7129	6741	388	5.4
CN4904300000000	49	043	Summit County, UT	1993	NA	10356	9831	525	5.1
CN4904500000000	49	045	Tooele County, UT	1993	NA	12161	11491	670	5.5
CN4904700000000	49	047	Uintah County, UT	1993	NA	10030	9297	733	7.3
CN4904900000000	49	049	Utah County, UT	1993	NA	136781	131876	4905	3.6
CN4905100000000	49	051	Wasatch County, UT	1993	NA	5086	4769	317	6.2
CN4905300000000	49	053	Washington County, UT	1993	NA	26202	25247	955	3.6
CN4905500000000	49	055	Wayne County, UT	1993	NA	1087	1007	80	7.4
CN4905700000000	49	057	Weber County, UT	1993	NA	87844	83322	4522	5.1
CN5000100000000	50	001	Addison County, VT	1993	NA	18307	17158	1149	6.3
CN5000300000000	50	003	Bennington County, VT	1993	NA	18677	17783	894	4.8
CN5000500000000	50	005	Caledonia County, VT	1993	NA	14730	13707	1023	6.9
CN5000700000000	50	007	Chittenden County, VT	1993	NA	80702	77673	3029	3.8
CN5000900000000	50	009	Essex County, VT	1993	NA	2849	2626	223	7.8
CN5001100000000	50	011	Franklin County, VT	1993	NA	22004	20692	1312	6
CN5001300000000	50	013	Grand Isle County, VT	1993	NA	3045	2810	235	7.7
CN5001500000000	50	015	Lamoille County, VT	1993	NA	10979	10192	787	7.2
CN5001700000000	50	017	Orange County, VT	1993	NA	14510	13915	595	4.1
CN5001900000000	50	019	Orleans County, VT	1993	NA	12290	11226	1064	8.7
CN5002100000000	50	021	Rutland County, VT	1993	NA	32167	30207	1960	6.1
CN5002300000000	50	023	Washington County, VT	1993	NA	30316	28675	1641	5.4
CN5002500000000	50	025	Windham County, VT	1993	NA	22739	21839	900	4
CN5002700000000	50	027	Windsor County, VT	1993	NA	29269	27962	1307	4.5
CN5100100000000	51	001	Accomack County, VA	1993	NA	15637	14245	1392	8.9
CN5100300000000	51	003	Albemarle County, VA	1993	NA	35977	34971	1006	2.8
CN5100500000000	51	005	Alleghany County, VA	1993	NA	8666	8043	623	7.2
CN5100700000000	51	007	Amelia County, VA	1993	NA	4504	4215	289	6.4
CN5100900000000	51	009	Amherst County, VA	1993	NA	14724	14080	644	4.4
CN5101100000000	51	011	Appomattox County, VA	1993	NA	6267	5808	459	7.3
CN5101300000000	51	013	Arlington County, VA	1993	NA	109698	104721	4977	4.5
CN5101500000000	51	015	Augusta County, VA	1993	NA	29760	28343	1417	4.8
CN5101700000000	51	017	Bath County, VA	1993	NA	2835	2569	266	9.4
CN5101900000000	51	019	Bedford County, VA	1993	NA	30605	29376	1229	4
CN5102100000000	51	021	Bland County, VA	1993	NA	3409	3178	231	6.8
CN5102300000000	51	023	Botetourt County, VA	1993	NA	14898	14251	647	4.3
CN5102500000000	51	025	Brunswick County, VA	1993	NA	7440	6844	596	8
CN5102700000000	51	027	Buchanan County, VA	1993	NA	10849	9191	1658	15.3
CN5102900000000	51	029	Buckingham County, VA	1993	NA	5748	5416	332	5.8
CN5103100000000	51	031	Campbell County, VA	1993	NA	26686	25506	1180	4.4
CN5103300000000	51	033	Caroline County, VA	1993	NA	10505	9551	954	9.1
CN5103500000000	51	035	Carroll County, VA	1993	NA	14096	13262	834	5.9
CN5103600000000	51	036	Charles City County, VA	1993	NA	3593	3293	300	8.3
CN5103700000000	51	037	Charlotte County, VA	1993	NA	5756	5225	531	9.2
CN5104100000000	51	041	Chesterfield County, VA	1993	NA	129819	124319	5500	4.2
CN5104300000000	51	043	Clarke County, VA	1993	NA	6269	6059	210	3.3
CN5104500000000	51	045	Craig County, VA	1993	NA	2447	2293	154	6.3
CN5104700000000	51	047	Culpeper County, VA	1993	NA	14696	14084	612	4.2
CN5104900000000	51	049	Cumberland County, VA	1993	NA	4083	3864	219	5.4
CN5105100000000	51	051	Dickenson County, VA	1993	NA	6288	5310	978	15.6
CN5105300000000	51	053	Dinwiddie County, VA	1993	NA	10495	9790	705	6.7
CN5105700000000	51	057	Essex County, VA	1993	NA	4758	4423	335	7
CN5105900000000	51	059	Fairfax County, VA	1993	NA	503911	486732	17179	3.4
CN5106100000000	51	061	Fauquier County, VA	1993	NA	27030	26112	918	3.4
CN5106300000000	51	063	Floyd County, VA	1993	NA	6394	5904	490	7.7
CN5106500000000	51	065	Fluvanna County, VA	1993	NA	7320	7052	268	3.7
CN5106700000000	51	067	Franklin County, VA	1993	NA	22081	21135	946	4.3
CN5106900000000	51	069	Frederick County, VA	1993	NA	28035	26563	1472	5.3
CN5107100000000	51	071	Giles County, VA	1993	NA	8407	7739	668	7.9
CN5107300000000	51	073	Gloucester County, VA	1993	NA	16327	15576	751	4.6
CN5107500000000	51	075	Goochland County, VA	1993	NA	7997	7647	350	4.4
CN5107700000000	51	077	Grayson County, VA	1993	NA	8376	7942	434	5.2
CN5107900000000	51	079	Greene County, VA	1993	NA	6549	6281	268	4.1
CN5108100000000	51	081	Greensville County, VA	1993	NA	5279	4937	342	6.5
CN5108300000000	51	083	Halifax County, VA	1993	NA	18867	17536	1331	7.1
CN5108500000000	51	085	Hanover County, VA	1993	NA	38884	37545	1339	3.4
CN5108700000000	51	087	Henrico County, VA	1993	NA	131075	125797	5278	4
CN5108900000000	51	089	Henry County, VA	1993	NA	30498	28741	1757	5.8
CN5109100000000	51	091	Highland County, VA	1993	NA	1341	1276	65	4.8
CN5109300000000	51	093	Isle of Wight County, VA	1993	NA	13745	12853	892	6.5
CN5109500000000	51	095	James City County, VA	1993	NA	20409	19821	588	2.9
CN5109700000000	51	097	King and Queen County, VA	1993	NA	3078	2849	229	7.4
CN5109900000000	51	099	King George County, VA	1993	NA	7575	7153	422	5.6
CN5110100000000	51	101	King William County, VA	1993	NA	6149	5876	273	4.4
CN5110300000000	51	103	Lancaster County, VA	1993	NA	5333	4522	811	15.2
CN5110500000000	51	105	Lee County, VA	1993	NA	10056	8930	1126	11.2
CN5110700000000	51	107	Loudoun County, VA	1993	NA	60042	58010	2032	3.4
CN5110900000000	51	109	Louisa County, VA	1993	NA	10694	9746	948	8.9
CN5111100000000	51	111	Lunenburg County, VA	1993	NA	5006	4550	456	9.1
CN5111300000000	51	113	Madison County, VA	1993	NA	6304	6080	224	3.6
CN5111500000000	51	115	Mathews County, VA	1993	NA	4278	4097	181	4.2
CN5111700000000	51	117	Mecklenburg County, VA	1993	NA	14879	13967	912	6.1
CN5111900000000	51	119	Middlesex County, VA	1993	NA	4250	4045	205	4.8
CN5112100000000	51	121	Montgomery County, VA	1993	NA	36998	34976	2022	5.5
CN5112500000000	51	125	Nelson County, VA	1993	NA	6540	6211	329	5
CN5112700000000	51	127	New Kent County, VA	1993	NA	5937	5645	292	4.9
CN5113100000000	51	131	Northampton County, VA	1993	NA	5680	5252	428	7.5
CN5113300000000	51	133	Northumberland County, VA	1993	NA	5374	4624	750	14
CN5113500000000	51	135	Nottoway County, VA	1993	NA	6386	5963	423	6.6
CN5113700000000	51	137	Orange County, VA	1993	NA	11037	10441	596	5.4
CN5113900000000	51	139	Page County, VA	1993	NA	11667	10791	876	7.5
CN5114100000000	51	141	Patrick County, VA	1993	NA	9127	8779	348	3.8
CN5114300000000	51	143	Pittsylvania County, VA	1993	NA	30522	28765	1757	5.8
CN5114500000000	51	145	Powhatan County, VA	1993	NA	8512	8203	309	3.6
CN5114700000000	51	147	Prince Edward County, VA	1993	NA	8535	7794	741	8.7
CN5114900000000	51	149	Prince George County, VA	1993	NA	12019	11488	531	4.4
CN5115300000000	51	153	Prince William County, VA	1993	NA	125475	120989	4486	3.6
CN5115500000000	51	155	Pulaski County, VA	1993	NA	17508	15775	1733	9.9
CN5115700000000	51	157	Rappahannock County, VA	1993	NA	4009	3840	169	4.2
CN5115900000000	51	159	Richmond County, VA	1993	NA	3749	3431	318	8.5
CN5116100000000	51	161	Roanoke County, VA	1993	NA	47750	45855	1895	4
CN5116300000000	51	163	Rockbridge County, VA	1993	NA	9776	9019	757	7.7
CN5116500000000	51	165	Rockingham County, VA	1993	NA	35505	34219	1286	3.6
CN5116700000000	51	167	Russell County, VA	1993	NA	13112	11690	1422	10.8
CN5116900000000	51	169	Scott County, VA	1993	NA	10141	9309	832	8.2
CN5117100000000	51	171	Shenandoah County, VA	1993	NA	17319	16607	712	4.1
CN5117300000000	51	173	Smyth County, VA	1993	NA	17913	15775	2138	11.9
CN5117500000000	51	175	Southampton County, VA	1993	NA	7489	7074	415	5.5
CN5117700000000	51	177	Spotsylvania County, VA	1993	NA	34320	32740	1580	4.6
CN5117900000000	51	179	Stafford County, VA	1993	NA	37392	36130	1262	3.4
CN5118100000000	51	181	Surry County, VA	1993	NA	3070	2722	348	11.3
CN5118300000000	51	183	Sussex County, VA	1993	NA	4960	4544	416	8.4
CN5118500000000	51	185	Tazewell County, VA	1993	NA	20627	17905	2722	13.2
CN5118700000000	51	187	Warren County, VA	1993	NA	14598	13596	1002	6.9
CN5119100000000	51	191	Washington County, VA	1993	NA	25356	23628	1728	6.8
CN5119300000000	51	193	Westmoreland County, VA	1993	NA	7499	6654	845	11.3
CN5119500000000	51	195	Wise County, VA	1993	NA	16265	14122	2143	13.2
CN5119700000000	51	197	Wythe County, VA	1993	NA	14555	13330	1225	8.4
CN5119900000000	51	199	York County, VA	1993	NA	24219	23311	908	3.7
CN5151000000000	51	510	Alexandria city, VA	1993	NA	75793	71192	4601	6.1
CN5152000000000	51	520	Bristol city, VA	1993	NA	8804	8229	575	6.5
CN5153000000000	51	530	Buena Vista city, VA	1993	NA	3445	3015	430	12.5
CN5154000000000	51	540	Charlottesville city, VA	1993	NA	20147	19487	660	3.3
CN5155000000000	51	550	Chesapeake city, VA	1993	NA	89729	85565	4164	4.6
CN5157000000000	51	570	Colonial Heights city, VA	1993	NA	8744	8263	481	5.5
CN5158000000000	51	580	Covington city, VA	1993	NA	3321	2982	339	10.2
CN5159000000000	51	590	Danville city, VA	1993	NA	26943	24646	2297	8.5
CN5159500000000	51	595	Emporia city, VA	1993	NA	2345	2144	201	8.6
CN5160000000000	51	600	Fairfax city, VA	1993	NA	12511	12213	298	2.4
CN5161000000000	51	610	Falls Church city, VA	1993	NA	5669	5421	248	4.4
CN5162000000000	51	620	Franklin city, VA	1993	NA	3829	3564	265	6.9
CN5163000000000	51	630	Fredericksburg city, VA	1993	NA	10956	10296	660	6
CN5164000000000	51	640	Galax city, VA	1993	NA	3339	3196	143	4.3
CN5165000000000	51	650	Hampton city, VA	1993	NA	67027	62739	4288	6.4
CN5166000000000	51	660	Harrisonburg city, VA	1993	NA	17516	16982	534	3
CN5167000000000	51	670	Hopewell city, VA	1993	NA	11320	10439	881	7.8
CN5167800000000	51	678	Lexington city, VA	1993	NA	2764	2626	138	5
CN5168000000000	51	680	Lynchburg city, VA	1993	NA	32199	30638	1561	4.8
CN5168300000000	51	683	Manassas city, VA	1993	NA	17979	17243	736	4.1
CN5168500000000	51	685	Manassas Park city, VA	1993	NA	3929	3838	91	2.3
CN5169000000000	51	690	Martinsville city, VA	1993	NA	7670	7088	582	7.6
CN5170000000000	51	700	Newport News city, VA	1993	NA	82976	77620	5356	6.5
CN5171000000000	51	710	Norfolk city, VA	1993	NA	92009	85736	6273	6.8
CN5172000000000	51	720	Norton city, VA	1993	NA	1628	1485	143	8.8
CN5173000000000	51	730	Petersburg city, VA	1993	NA	18373	16609	1764	9.6
CN5173500000000	51	735	Poquoson city, VA	1993	NA	5944	5752	192	3.2
CN5174000000000	51	740	Portsmouth city, VA	1993	NA	47006	43421	3585	7.6
CN5175000000000	51	750	Radford city, VA	1993	NA	6918	6455	463	6.7
CN5176000000000	51	760	Richmond city, VA	1993	NA	101435	94604	6831	6.7
CN5177000000000	51	770	Roanoke city, VA	1993	NA	50872	47879	2993	5.9
CN5177500000000	51	775	Salem city, VA	1993	NA	13325	12843	482	3.6
CN5179000000000	51	790	Staunton city, VA	1993	NA	11425	10902	523	4.6
CN5180000000000	51	800	Suffolk city, VA	1993	NA	25746	23989	1757	6.8
CN5181000000000	51	810	Virginia Beach city, VA	1993	NA	205530	196234	9296	4.5
CN5182000000000	51	820	Waynesboro city, VA	1993	NA	9033	8396	637	7.1
CN5183000000000	51	830	Williamsburg city, VA	1993	NA	6012	5366	646	10.7
CN5184000000000	51	840	Winchester city, VA	1993	NA	12980	12189	791	6.1
CN5300100000000	53	001	Adams County, WA	1993	NA	8405	7122	1283	15.3
CN5300300000000	53	003	Asotin County, WA	1993	NA	10253	9718	535	5.2
CN5300500000000	53	005	Benton County, WA	1993	NA	68348	63606	4742	6.9
CN5300700000000	53	007	Chelan County, WA	1993	NA	32986	29488	3498	10.6
CN5300900000000	53	009	Clallam County, WA	1993	NA	23555	21224	2331	9.9
CN5301100000000	53	011	Clark County, WA	1993	NA	135682	127895	7787	5.7
CN5301300000000	53	013	Columbia County, WA	1993	NA	1521	1290	231	15.2
CN5301500000000	53	015	Cowlitz County, WA	1993	NA	38508	34331	4177	10.8
CN5301700000000	53	017	Douglas County, WA	1993	NA	17488	16050	1438	8.2
CN5301900000000	53	019	Ferry County, WA	1993	NA	2824	2390	434	15.4
CN5302100000000	53	021	Franklin County, WA	1993	NA	21741	19226	2515	11.6
CN5302300000000	53	023	Garfield County, WA	1993	NA	1096	1028	68	6.2
CN5302500000000	53	025	Grant County, WA	1993	NA	31251	27754	3497	11.2
CN5302700000000	53	027	Grays Harbor County, WA	1993	NA	28026	23790	4236	15.1
CN5302900000000	53	029	Island County, WA	1993	NA	24073	22786	1287	5.3
CN5303100000000	53	031	Jefferson County, WA	1993	NA	9306	8540	766	8.2
CN5303300000000	53	033	King County, WA	1993	NA	900329	847891	52438	5.8
CN5303500000000	53	035	Kitsap County, WA	1993	NA	88952	82965	5987	6.7
CN5303700000000	53	037	Kittitas County, WA	1993	NA	13744	12296	1448	10.5
CN5303900000000	53	039	Klickitat County, WA	1993	NA	8207	6992	1215	14.8
CN5304100000000	53	041	Lewis County, WA	1993	NA	27741	24709	3032	10.9
CN5304300000000	53	043	Lincoln County, WA	1993	NA	4469	4194	275	6.2
CN5304500000000	53	045	Mason County, WA	1993	NA	16739	15153	1586	9.5
CN5304700000000	53	047	Okanogan County, WA	1993	NA	21915	19311	2604	11.9
CN5304900000000	53	049	Pacific County, WA	1993	NA	7984	7030	954	11.9
CN5305100000000	53	051	Pend Oreille County, WA	1993	NA	3814	3281	533	14
CN5305300000000	53	053	Pierce County, WA	1993	NA	295567	273386	22181	7.5
CN5305500000000	53	055	San Juan County, WA	1993	NA	5394	4985	409	7.6
CN5305700000000	53	057	Skagit County, WA	1993	NA	43748	38872	4876	11.1
CN5305900000000	53	059	Skamania County, WA	1993	NA	4100	3502	598	14.6
CN5306100000000	53	061	Snohomish County, WA	1993	NA	275269	257732	17537	6.4
CN5306300000000	53	063	Spokane County, WA	1993	NA	184774	173734	11040	6
CN5306500000000	53	065	Stevens County, WA	1993	NA	15444	13874	1570	10.2
CN5306700000000	53	067	Thurston County, WA	1993	NA	88197	82052	6145	7
CN5306900000000	53	069	Wahkiakum County, WA	1993	NA	1651	1523	128	7.8
CN5307100000000	53	071	Walla Walla County, WA	1993	NA	24844	23157	1687	6.8
CN5307300000000	53	073	Whatcom County, WA	1993	NA	74735	68951	5784	7.7
CN5307500000000	53	075	Whitman County, WA	1993	NA	17796	17383	413	2.3
CN5307700000000	53	077	Yakima County, WA	1993	NA	111798	95791	16007	14.3
CN5400100000000	54	001	Barbour County, WV	1993	NA	6259	5388	871	13.9
CN5400300000000	54	003	Berkeley County, WV	1993	NA	30704	28246	2458	8
CN5400500000000	54	005	Boone County, WV	1993	NA	8616	7068	1548	18
CN5400700000000	54	007	Braxton County, WV	1993	NA	4899	4078	821	16.8
CN5400900000000	54	009	Brooke County, WV	1993	NA	11529	10406	1123	9.7
CN5401100000000	54	011	Cabell County, WV	1993	NA	42633	39051	3582	8.4
CN5401300000000	54	013	Calhoun County, WV	1993	NA	3047	2453	594	19.5
CN5401500000000	54	015	Clay County, WV	1993	NA	3168	2603	565	17.8
CN5401700000000	54	017	Doddridge County, WV	1993	NA	2909	2608	301	10.3
CN5401900000000	54	019	Fayette County, WV	1993	NA	17590	15110	2480	14.1
CN5402100000000	54	021	Gilmer County, WV	1993	NA	2804	2501	303	10.8
CN5402300000000	54	023	Grant County, WV	1993	NA	5013	4545	468	9.3
CN5402500000000	54	025	Greenbrier County, WV	1993	NA	15353	13268	2085	13.6
CN5402700000000	54	027	Hampshire County, WV	1993	NA	7631	6962	669	8.8
CN5402900000000	54	029	Hancock County, WV	1993	NA	15199	13809	1390	9.1
CN5403100000000	54	031	Hardy County, WV	1993	NA	6497	6184	313	4.8
CN5403300000000	54	033	Harrison County, WV	1993	NA	31157	27936	3221	10.3
CN5403500000000	54	035	Jackson County, WV	1993	NA	11977	10437	1540	12.9
CN5403700000000	54	037	Jefferson County, WV	1993	NA	19012	17861	1151	6.1
CN5403900000000	54	039	Kanawha County, WV	1993	NA	101385	93293	8092	8
CN5404100000000	54	041	Lewis County, WV	1993	NA	7281	6338	943	13
CN5404300000000	54	043	Lincoln County, WV	1993	NA	7081	6011	1070	15.1
CN5404500000000	54	045	Logan County, WV	1993	NA	15043	12686	2357	15.7
CN5404700000000	54	047	McDowell County, WV	1993	NA	8433	7199	1234	14.6
CN5404900000000	54	049	Marion County, WV	1993	NA	24281	20400	3881	16
CN5405100000000	54	051	Marshall County, WV	1993	NA	16529	14546	1983	12
CN5405300000000	54	053	Mason County, WV	1993	NA	9693	8238	1455	15
CN5405500000000	54	055	Mercer County, WV	1993	NA	27935	25501	2434	8.7
CN5405700000000	54	057	Mineral County, WV	1993	NA	11280	10451	829	7.3
CN5405900000000	54	059	Mingo County, WV	1993	NA	10569	9123	1446	13.7
CN5406100000000	54	061	Monongalia County, WV	1993	NA	38745	35520	3225	8.3
CN5406300000000	54	063	Monroe County, WV	1993	NA	4970	4531	439	8.8
CN5406500000000	54	065	Morgan County, WV	1993	NA	5844	5460	384	6.6
CN5406700000000	54	067	Nicholas County, WV	1993	NA	10523	8830	1693	16.1
CN5406900000000	54	069	Ohio County, WV	1993	NA	24172	22235	1937	8
CN5407100000000	54	071	Pendleton County, WV	1993	NA	3662	3493	169	4.6
CN5407300000000	54	073	Pleasants County, WV	1993	NA	3242	2775	467	14.4
CN5407500000000	54	075	Pocahontas County, WV	1993	NA	4133	3638	495	12
CN5407700000000	54	077	Preston County, WV	1993	NA	12749	11236	1513	11.9
CN5407900000000	54	079	Putnam County, WV	1993	NA	22627	20841	1786	7.9
CN5408100000000	54	081	Raleigh County, WV	1993	NA	31157	27135	4022	12.9
CN5408300000000	54	083	Randolph County, WV	1993	NA	12654	11175	1479	11.7
CN5408500000000	54	085	Ritchie County, WV	1993	NA	4424	3720	704	15.9
CN5408700000000	54	087	Roane County, WV	1993	NA	6006	5112	894	14.9
CN5408900000000	54	089	Summers County, WV	1993	NA	4341	3851	490	11.3
CN5409100000000	54	091	Taylor County, WV	1993	NA	6478	5581	897	13.8
CN5409300000000	54	093	Tucker County, WV	1993	NA	3635	3122	513	14.1
CN5409500000000	54	095	Tyler County, WV	1993	NA	4044	3638	406	10
CN5409700000000	54	097	Upshur County, WV	1993	NA	9767	8614	1153	11.8
CN5409900000000	54	099	Wayne County, WV	1993	NA	16631	14980	1651	9.9
CN5410100000000	54	101	Webster County, WV	1993	NA	3208	2632	576	18
CN5410300000000	54	103	Wetzel County, WV	1993	NA	7630	6588	1042	13.7
CN5410500000000	54	105	Wirt County, WV	1993	NA	2030	1702	328	16.2
CN5410700000000	54	107	Wood County, WV	1993	NA	42923	39163	3760	8.8
CN5410900000000	54	109	Wyoming County, WV	1993	NA	8718	7153	1565	18
CN5500100000000	55	001	Adams County, WI	1993	NA	7026	6615	411	5.8
CN5500300000000	55	003	Ashland County, WI	1993	NA	8027	7350	677	8.4
CN5500500000000	55	005	Barron County, WI	1993	NA	23255	21617	1638	7
CN5500700000000	55	007	Bayfield County, WI	1993	NA	7160	6601	559	7.8
CN5500900000000	55	009	Brown County, WI	1993	NA	117972	112834	5138	4.4
CN5501100000000	55	011	Buffalo County, WI	1993	NA	7584	7207	377	5
CN5501300000000	55	013	Burnett County, WI	1993	NA	6224	5791	433	7
CN5501500000000	55	015	Calumet County, WI	1993	NA	23109	21940	1169	5.1
CN5501700000000	55	017	Chippewa County, WI	1993	NA	27590	25784	1806	6.5
CN5501900000000	55	019	Clark County, WI	1993	NA	15879	14706	1173	7.4
CN5502100000000	55	021	Columbia County, WI	1993	NA	26463	24800	1663	6.3
CN5502300000000	55	023	Crawford County, WI	1993	NA	8996	8483	513	5.7
CN5502500000000	55	025	Dane County, WI	1993	NA	239896	234664	5232	2.2
CN5502700000000	55	027	Dodge County, WI	1993	NA	42177	40170	2007	4.8
CN5502900000000	55	029	Door County, WI	1993	NA	14641	13400	1241	8.5
CN5503100000000	55	031	Douglas County, WI	1993	NA	21238	19680	1558	7.3
CN5503300000000	55	033	Dunn County, WI	1993	NA	21167	20165	1002	4.7
CN5503500000000	55	035	Eau Claire County, WI	1993	NA	46358	43896	2462	5.3
CN5503700000000	55	037	Florence County, WI	1993	NA	1568	1434	134	8.5
CN5503900000000	55	039	Fond du Lac County, WI	1993	NA	52144	50052	2092	4
CN5504100000000	55	041	Forest County, WI	1993	NA	4371	4048	323	7.4
CN5504300000000	55	043	Grant County, WI	1993	NA	25736	24488	1248	4.8
CN5504500000000	55	045	Green County, WI	1993	NA	18189	17483	706	3.9
CN5504700000000	55	047	Green Lake County, WI	1993	NA	10243	9599	644	6.3
CN5504900000000	55	049	Iowa County, WI	1993	NA	12830	12277	553	4.3
CN5505100000000	55	051	Iron County, WI	1993	NA	3302	3005	297	9
CN5505300000000	55	053	Jackson County, WI	1993	NA	8997	8389	608	6.8
CN5505500000000	55	055	Jefferson County, WI	1993	NA	39287	37402	1885	4.8
CN5505700000000	55	057	Juneau County, WI	1993	NA	11096	10266	830	7.5
CN5505900000000	55	059	Kenosha County, WI	1993	NA	72211	68536	3675	5.1
CN5506100000000	55	061	Kewaunee County, WI	1993	NA	10452	9895	557	5.3
CN5506300000000	55	063	La Crosse County, WI	1993	NA	57057	54556	2501	4.4
CN5506500000000	55	065	Lafayette County, WI	1993	NA	8388	8057	331	3.9
CN5506700000000	55	067	Langlade County, WI	1993	NA	9489	8810	679	7.2
CN5506900000000	55	069	Lincoln County, WI	1993	NA	14868	13946	922	6.2
CN5507100000000	55	071	Manitowoc County, WI	1993	NA	41936	39747	2189	5.2
CN5507300000000	55	073	Marathon County, WI	1993	NA	67196	63729	3467	5.2
CN5507500000000	55	075	Marinette County, WI	1993	NA	19864	18322	1542	7.8
CN5507700000000	55	077	Marquette County, WI	1993	NA	6549	6044	505	7.7
CN5507800000000	55	078	Menominee County, WI	1993	NA	1906	1719	187	9.8
CN5507900000000	55	079	Milwaukee County, WI	1993	NA	478059	454029	24030	5
CN5508100000000	55	081	Monroe County, WI	1993	NA	19107	17973	1134	5.9
CN5508300000000	55	083	Oconto County, WI	1993	NA	14627	13441	1186	8.1
CN5508500000000	55	085	Oneida County, WI	1993	NA	18328	17389	939	5.1
CN5508700000000	55	087	Outagamie County, WI	1993	NA	91295	88119	3176	3.5
CN5508900000000	55	089	Ozaukee County, WI	1993	NA	43816	42497	1319	3
CN5509100000000	55	091	Pepin County, WI	1993	NA	3499	3306	193	5.5
CN5509300000000	55	093	Pierce County, WI	1993	NA	19102	18232	870	4.6
CN5509500000000	55	095	Polk County, WI	1993	NA	18642	17462	1180	6.3
CN5509700000000	55	097	Portage County, WI	1993	NA	37084	35181	1903	5.1
CN5509900000000	55	099	Price County, WI	1993	NA	7631	7153	478	6.3
CN5510100000000	55	101	Racine County, WI	1993	NA	91674	86081	5593	6.1
CN5510300000000	55	103	Richland County, WI	1993	NA	8446	8027	419	5
CN5510500000000	55	105	Rock County, WI	1993	NA	75499	70718	4781	6.3
CN5510700000000	55	107	Rusk County, WI	1993	NA	7177	6382	795	11.1
CN5510900000000	55	109	St. Croix County, WI	1993	NA	29272	27944	1328	4.5
CN5511100000000	55	111	Sauk County, WI	1993	NA	28487	26877	1610	5.7
CN5511300000000	55	113	Sawyer County, WI	1993	NA	7877	7268	609	7.7
CN5511500000000	55	115	Shawano County, WI	1993	NA	18385	17332	1053	5.7
CN5511700000000	55	117	Sheboygan County, WI	1993	NA	57700	55767	1933	3.4
CN5511900000000	55	119	Taylor County, WI	1993	NA	10351	9561	790	7.6
CN5512100000000	55	121	Trempealeau County, WI	1993	NA	13712	12702	1010	7.4
CN5512300000000	55	123	Vernon County, WI	1993	NA	13047	12287	760	5.8
CN5512500000000	55	125	Vilas County, WI	1993	NA	9401	8893	508	5.4
CN5512700000000	55	127	Walworth County, WI	1993	NA	49044	47572	1472	3
CN5512900000000	55	129	Washburn County, WI	1993	NA	7044	6506	538	7.6
CN5513100000000	55	131	Washington County, WI	1993	NA	59226	57078	2148	3.6
CN5513300000000	55	133	Waukesha County, WI	1993	NA	187880	181155	6725	3.6
CN5513500000000	55	135	Waupaca County, WI	1993	NA	25766	24565	1201	4.7
CN5513700000000	55	137	Waushara County, WI	1993	NA	9516	8810	706	7.4
CN5513900000000	55	139	Winnebago County, WI	1993	NA	91675	88104	3571	3.9
CN5514100000000	55	141	Wood County, WI	1993	NA	39494	37388	2106	5.3
CN5600100000000	56	001	Albany County, WY	1993	NA	15318	14908	410	2.7
CN5600300000000	56	003	Big Horn County, WY	1993	NA	4868	4568	300	6.2
CN5600500000000	56	005	Campbell County, WY	1993	NA	17188	16283	905	5.3
CN5600700000000	56	007	Carbon County, WY	1993	NA	8360	7863	497	5.9
CN5600900000000	56	009	Converse County, WY	1993	NA	6127	5785	342	5.6
CN5601100000000	56	011	Crook County, WY	1993	NA	2895	2788	107	3.7
CN5601300000000	56	013	Fremont County, WY	1993	NA	16306	15152	1154	7.1
CN5601500000000	56	015	Goshen County, WY	1993	NA	6071	5803	268	4.4
CN5601700000000	56	017	Hot Springs County, WY	1993	NA	2509	2374	135	5.4
CN5601900000000	56	019	Johnson County, WY	1993	NA	3341	3186	155	4.6
CN5602100000000	56	021	Laramie County, WY	1993	NA	37916	36402	1514	4
CN5602300000000	56	023	Lincoln County, WY	1993	NA	6175	5695	480	7.8
CN5602500000000	56	025	Natrona County, WY	1993	NA	31802	29499	2303	7.2
CN5602700000000	56	027	Niobrara County, WY	1993	NA	1134	1094	40	3.5
CN5602900000000	56	029	Park County, WY	1993	NA	13690	13140	550	4
CN5603100000000	56	031	Platte County, WY	1993	NA	3974	3765	209	5.3
CN5603300000000	56	033	Sheridan County, WY	1993	NA	13157	12559	598	4.5
CN5603500000000	56	035	Sublette County, WY	1993	NA	2841	2742	99	3.5
CN5603700000000	56	037	Sweetwater County, WY	1993	NA	21231	19947	1284	6
CN5603900000000	56	039	Teton County, WY	1993	NA	9534	9300	234	2.5
CN5604100000000	56	041	Uinta County, WY	1993	NA	10702	9787	915	8.5
CN5604300000000	56	043	Washakie County, WY	1993	NA	4520	4208	312	6.9
CN5604500000000	56	045	Weston County, WY	1993	NA	3208	3046	162	5
CN7200100000000	72	001	Adjuntas Municipio, PR	1993	NA	5296	4335	961	18.1
CN7200300000000	72	003	Aguada Municipio, PR	1993	NA	14554	11383	3171	21.8
CN7200500000000	72	005	Aguadilla Municipio, PR	1993	NA	21978	17062	4916	22.4
CN7200700000000	72	007	Aguas Buenas Municipio, PR	1993	NA	8110	6367	1743	21.5
CN7200900000000	72	009	Aibonito Municipio, PR	1993	NA	9619	7943	1676	17.4
CN7201100000000	72	011	Anasco Municipio, PR	1993	NA	10291	8151	2140	20.8
CN7201300000000	72	013	Arecibo Municipio, PR	1993	NA	29770	24158	5612	18.9
CN7201500000000	72	015	Arroyo Municipio, PR	1993	NA	5191	3918	1273	24.5
CN7201700000000	72	017	Barceloneta Municipio, PR	1993	NA	6774	5209	1565	23.1
CN7201900000000	72	019	Barranquitas Municipio, PR	1993	NA	6943	5928	1015	14.6
CN7202100000000	72	021	Bayamon Municipio, PR	1993	NA	82013	72135	9878	12
CN7202300000000	72	023	Cabo Rojo Municipio, PR	1993	NA	14099	11671	2428	17.2
CN7202500000000	72	025	Caguas Municipio, PR	1993	NA	54967	46670	8297	15.1
CN7202700000000	72	027	Camuy Municipio, PR	1993	NA	9639	7852	1787	18.5
CN7202900000000	72	029	Canovanas Municipio, PR	1993	NA	13191	10798	2393	18.1
CN7203100000000	72	031	Carolina Municipio, PR	1993	NA	74689	66302	8387	11.2
CN7203300000000	72	033	Catano Municipio, PR	1993	NA	10198	8674	1524	14.9
CN7203500000000	72	035	Cayey Municipio, PR	1993	NA	15337	12436	2901	18.9
CN7203700000000	72	037	Ceiba Municipio, PR	1993	NA	5328	4364	964	18.1
CN7203900000000	72	039	Ciales Municipio, PR	1993	NA	5397	4080	1317	24.4
CN7204100000000	72	041	Cidra Municipio, PR	1993	NA	11833	9777	2056	17.4
CN7204300000000	72	043	Coamo Municipio, PR	1993	NA	8815	6722	2093	23.7
CN7204500000000	72	045	Comerio Municipio, PR	1993	NA	5162	4280	882	17.1
CN7204700000000	72	047	Corozal Municipio, PR	1993	NA	9257	7682	1575	17
CN7204900000000	72	049	Culebra Municipio, PR	1993	NA	797	725	72	9
CN7205100000000	72	051	Dorado Municipio, PR	1993	NA	10427	8732	1695	16.3
CN7205300000000	72	053	Fajardo Municipio, PR	1993	NA	12959	10234	2725	21
CN7205400000000	72	054	Florida Municipio, PR	1993	NA	2852	2112	740	25.9
CN7205500000000	72	055	Guanica Municipio, PR	1993	NA	5142	3555	1587	30.9
CN7205700000000	72	057	Guayama Municipio, PR	1993	NA	11095	8222	2873	25.9
CN7205900000000	72	059	Guayanilla Municipio, PR	1993	NA	6517	4881	1636	25.1
CN7206100000000	72	061	Guaynabo Municipio, PR	1993	NA	37515	34328	3187	8.5
CN7206300000000	72	063	Gurabo Municipio, PR	1993	NA	10625	8827	1798	16.9
CN7206500000000	72	065	Hatillo Municipio, PR	1993	NA	10424	8234	2190	21
CN7206700000000	72	067	Hormigueros Municipio, PR	1993	NA	6637	5516	1121	16.9
CN7206900000000	72	069	Humacao Municipio, PR	1993	NA	18736	15185	3551	19
CN7207100000000	72	071	Isabela Municipio, PR	1993	NA	13175	10214	2961	22.5
CN7207300000000	72	073	Jayuya Municipio, PR	1993	NA	3788	3038	750	19.8
CN7207500000000	72	075	Juana Diaz Municipio, PR	1993	NA	13111	10181	2930	22.3
CN7207700000000	72	077	Juncos Municipio, PR	1993	NA	10029	7851	2178	21.7
CN7207900000000	72	079	Lajas Municipio, PR	1993	NA	8942	6812	2130	23.8
CN7208100000000	72	081	Lares Municipio, PR	1993	NA	8031	6271	1760	21.9
CN7208300000000	72	083	Las Marias Municipio, PR	1993	NA	3187	2470	717	22.5
CN7208500000000	72	085	Las Piedras Municipio, PR	1993	NA	9371	7611	1760	18.8
CN7208700000000	72	087	Loiza Municipio, PR	1993	NA	8552	7284	1268	14.8
CN7208900000000	72	089	Luquillo Municipio, PR	1993	NA	6524	4992	1532	23.5
CN7209100000000	72	091	Manati Municipio, PR	1993	NA	12945	10099	2846	22
CN7209300000000	72	093	Maricao Municipio, PR	1993	NA	2128	1717	411	19.3
CN7209500000000	72	095	Maunabo Municipio, PR	1993	NA	3032	2132	900	29.7
CN7209700000000	72	097	Mayaguez Municipio, PR	1993	NA	35453	29734	5719	16.1
CN7209900000000	72	099	Moca Municipio, PR	1993	NA	11632	9194	2438	21
CN7210100000000	72	101	Morovis Municipio, PR	1993	NA	8082	6370	1712	21.2
CN7210300000000	72	103	Naguabo Municipio, PR	1993	NA	6600	5160	1440	21.8
CN7210500000000	72	105	Naranjito Municipio, PR	1993	NA	6873	5646	1227	17.9
CN7210700000000	72	107	Orocovis Municipio, PR	1993	NA	5791	4530	1261	21.8
CN7210900000000	72	109	Patillas Municipio, PR	1993	NA	5792	4144	1648	28.5
CN7211100000000	72	111	Penuelas Municipio, PR	1993	NA	6695	4906	1789	26.7
CN7211300000000	72	113	Ponce Municipio, PR	1993	NA	60284	48438	11846	19.7
CN7211500000000	72	115	Quebradillas Municipio, PR	1993	NA	7369	6190	1179	16
CN7211700000000	72	117	Rincon Municipio, PR	1993	NA	5448	4541	907	16.6
CN7211900000000	72	119	Rio Grande Municipio, PR	1993	NA	15990	12903	3087	19.3
CN7212100000000	72	121	Sabana Grande Municipio, PR	1993	NA	8635	6920	1715	19.9
CN7212300000000	72	123	Salinas Municipio, PR	1993	NA	8291	5962	2329	28.1
CN7212500000000	72	125	San German Municipio, PR	1993	NA	13496	10524	2972	22
CN7212700000000	72	127	San Juan Municipio, PR	1993	NA	160428	141391	19037	11.9
CN7212900000000	72	129	San Lorenzo Municipio, PR	1993	NA	12053	9351	2702	22.4
CN7213100000000	72	131	San Sebastian Municipio, PR	1993	NA	13247	9718	3529	26.6
CN7213300000000	72	133	Santa Isabel Municipio, PR	1993	NA	5401	3429	1972	36.5
CN7213500000000	72	135	Toa Alta Municipio, PR	1993	NA	15589	13518	2071	13.3
CN7213700000000	72	137	Toa Baja Municipio, PR	1993	NA	34324	30350	3974	11.6
CN7213900000000	72	139	Trujillo Alto Municipio, PR	1993	NA	25099	22737	2362	9.4
CN7214100000000	72	141	Utuado Municipio, PR	1993	NA	8284	6643	1641	19.8
CN7214300000000	72	143	Vega Alta Municipio, PR	1993	NA	11029	9242	1787	16.2
CN7214500000000	72	145	Vega Baja Municipio, PR	1993	NA	17431	14396	3035	17.4
CN7214700000000	72	147	Vieques Municipio, PR	1993	NA	2658	2099	559	21
CN7214900000000	72	149	Villalba Municipio, PR	1993	NA	6633	4711	1922	29
CN7215100000000	72	151	Yabucoa Municipio, PR	1993	NA	11136	8478	2658	23.9
CN7215300000000	72	153	Yauco Municipio, PR	1993	NA	13078	10090	2988	22.8
NA	NA	NA	NA	NA	NA	NA	NA	NA	NA
SOURCE:  BLS, LAUS	NA	NA	NA	NA	NA	NA	NA	NA	NA
March 18, 2016	NA	NA	NA	NA	NA	NA	NA	NA	NA
