LAUS_CODE	STATE_FIPS	COUNTY_FIPS	COUNTY	YEAR	ESTIMATED	LABOR_FORCE	EMPLOYED	UNEMPLOYED_LEVEL	UNEMPLOYED_RATE
CN0100100000000	01	001	Autauga County, AL	2011	NA	25836	23677	2159	8.4
CN0100300000000	01	003	Baldwin County, AL	2011	NA	85045	77418	7627	9
CN0100500000000	01	005	Barbour County, AL	2011	NA	9849	8712	1137	11.5
CN0100700000000	01	007	Bibb County, AL	2011	NA	8933	7996	937	10.5
CN0100900000000	01	009	Blount County, AL	2011	NA	25123	22939	2184	8.7
CN0101100000000	01	011	Bullock County, AL	2011	NA	4833	4272	561	11.6
CN0101300000000	01	013	Butler County, AL	2011	NA	9188	8042	1146	12.5
CN0101500000000	01	015	Calhoun County, AL	2011	NA	51268	45963	5305	10.3
CN0101700000000	01	017	Chambers County, AL	2011	NA	15200	13380	1820	12
CN0101900000000	01	019	Cherokee County, AL	2011	NA	11476	10364	1112	9.7
CN0102100000000	01	021	Chilton County, AL	2011	NA	19539	17753	1786	9.1
CN0102300000000	01	023	Choctaw County, AL	2011	NA	4764	4138	626	13.1
CN0102500000000	01	025	Clarke County, AL	2011	NA	8843	7181	1662	18.8
CN0102700000000	01	027	Clay County, AL	2011	NA	5598	4935	663	11.8
CN0102900000000	01	029	Cleburne County, AL	2011	NA	5939	5365	574	9.7
CN0103100000000	01	031	Coffee County, AL	2011	NA	20749	19059	1690	8.1
CN0103300000000	01	033	Colbert County, AL	2011	NA	24386	21905	2481	10.2
CN0103500000000	01	035	Conecuh County, AL	2011	NA	4785	4057	728	15.2
CN0103700000000	01	037	Coosa County, AL	2011	NA	4477	3918	559	12.5
CN0103900000000	01	039	Covington County, AL	2011	NA	16367	14764	1603	9.8
CN0104100000000	01	041	Crenshaw County, AL	2011	NA	6432	5798	634	9.9
CN0104300000000	01	043	Cullman County, AL	2011	NA	35669	32279	3390	9.5
CN0104500000000	01	045	Dale County, AL	2011	NA	22017	20188	1829	8.3
CN0104700000000	01	047	Dallas County, AL	2011	NA	17514	14866	2648	15.1
CN0104900000000	01	049	DeKalb County, AL	2011	NA	29809	26279	3530	11.8
CN0105100000000	01	051	Elmore County, AL	2011	NA	36597	33521	3076	8.4
CN0105300000000	01	053	Escambia County, AL	2011	NA	14978	13355	1623	10.8
CN0105500000000	01	055	Etowah County, AL	2011	NA	44722	40238	4484	10
CN0105700000000	01	057	Fayette County, AL	2011	NA	6632	5896	736	11.1
CN0105900000000	01	059	Franklin County, AL	2011	NA	14362	12986	1376	9.6
CN0106100000000	01	061	Geneva County, AL	2011	NA	11486	10429	1057	9.2
CN0106300000000	01	063	Greene County, AL	2011	NA	3226	2668	558	17.3
CN0106500000000	01	065	Hale County, AL	2011	NA	6296	5426	870	13.8
CN0106700000000	01	067	Henry County, AL	2011	NA	7270	6563	707	9.7
CN0106900000000	01	069	Houston County, AL	2011	NA	46778	42747	4031	8.6
CN0107100000000	01	071	Jackson County, AL	2011	NA	24163	21682	2481	10.3
CN0107300000000	01	073	Jefferson County, AL	2011	NA	319652	289916	29736	9.3
CN0107500000000	01	075	Lamar County, AL	2011	NA	5826	5260	566	9.7
CN0107700000000	01	077	Lauderdale County, AL	2011	NA	44048	40026	4022	9.1
CN0107900000000	01	079	Lawrence County, AL	2011	NA	14788	13177	1611	10.9
CN0108100000000	01	081	Lee County, AL	2011	NA	68316	62812	5504	8.1
CN0108300000000	01	083	Limestone County, AL	2011	NA	38990	35631	3359	8.6
CN0108500000000	01	085	Lowndes County, AL	2011	NA	4239	3489	750	17.7
CN0108700000000	01	087	Macon County, AL	2011	NA	8512	7317	1195	14
CN0108900000000	01	089	Madison County, AL	2011	NA	171726	157512	14214	8.3
CN0109100000000	01	091	Marengo County, AL	2011	NA	7875	6884	991	12.6
CN0109300000000	01	093	Marion County, AL	2011	NA	12556	11149	1407	11.2
CN0109500000000	01	095	Marshall County, AL	2011	NA	41085	37216	3869	9.4
CN0109700000000	01	097	Mobile County, AL	2011	NA	193851	172971	20880	10.8
CN0109900000000	01	099	Monroe County, AL	2011	NA	8325	7017	1308	15.7
CN0110100000000	01	101	Montgomery County, AL	2011	NA	109092	98491	10601	9.7
CN0110300000000	01	103	Morgan County, AL	2011	NA	58319	52810	5509	9.4
CN0110500000000	01	105	Perry County, AL	2011	NA	3866	3227	639	16.5
CN0110700000000	01	107	Pickens County, AL	2011	NA	7570	6663	907	12
CN0110900000000	01	109	Pike County, AL	2011	NA	15438	14070	1368	8.9
CN0111100000000	01	111	Randolph County, AL	2011	NA	9447	8374	1073	11.4
CN0111300000000	01	113	Russell County, AL	2011	NA	24604	22077	2527	10.3
CN0111500000000	01	115	St. Clair County, AL	2011	NA	38509	35135	3374	8.8
CN0111700000000	01	117	Shelby County, AL	2011	NA	104214	97727	6487	6.2
CN0111900000000	01	119	Sumter County, AL	2011	NA	5560	4829	731	13.1
CN0112100000000	01	121	Talladega County, AL	2011	NA	35293	31192	4101	11.6
CN0112300000000	01	123	Tallapoosa County, AL	2011	NA	18363	16266	2097	11.4
CN0112500000000	01	125	Tuscaloosa County, AL	2011	NA	95463	87532	7931	8.3
CN0112700000000	01	127	Walker County, AL	2011	NA	27092	24034	3058	11.3
CN0112900000000	01	129	Washington County, AL	2011	NA	7106	6070	1036	14.6
CN0113100000000	01	131	Wilcox County, AL	2011	NA	2979	2289	690	23.2
CN0113300000000	01	133	Winston County, AL	2011	NA	9819	8492	1327	13.5
CN0201300000000	02	013	Aleutians East Borough, AK	2011	NA	2183	2048	135	6.2
CN0201600000000	02	016	Aleutians West Census Area, AK	2011	NA	4255	4007	248	5.8
CN0202000000000	02	020	Anchorage Borough/municipality, AK	2011	NA	159006	149542	9464	6
CN0205000000000	02	050	Bethel Census Area, AK	2011	NA	7221	6137	1084	15
CN0206000000000	02	060	Bristol Bay Borough, AK	2011	NA	518	472	46	8.9
CN0206800000000	02	068	Denali Borough, AK	2011	NA	1018	879	139	13.7
CN0207000000000	02	070	Dillingham Census Area, AK	2011	NA	2106	1883	223	10.6
CN0209000000000	02	090	Fairbanks North Star Borough, AK	2011	NA	48354	45238	3116	6.4
CN0210000000000	02	100	Haines Borough, AK	2011	NA	1167	1050	117	10
CN0210500000000	02	105	Hoonah-Angoon Census Area, AK	2011	NA	1099	933	166	15.1
CN0211000000000	02	110	Juneau Borough/city, AK	2011	NA	17907	16913	994	5.6
CN0212200000000	02	122	Kenai Peninsula Borough, AK	2011	NA	27273	24675	2598	9.5
CN0213000000000	02	130	Ketchikan Gateway Borough, AK	2011	NA	7180	6560	620	8.6
CN0215000000000	02	150	Kodiak Island Borough, AK	2011	NA	6783	6281	502	7.4
CN0215800000000	02	158	Kusilvak Census Area, AK	2011	NA	2759	2177	582	21.1
CN0216400000000	02	164	Lake and Peninsula Borough, AK	2011	NA	638	542	96	15
CN0217000000000	02	170	Matanuska-Susitna Borough, AK	2011	NA	43368	39390	3978	9.2
CN0218000000000	02	180	Nome Census Area, AK	2011	NA	4127	3619	508	12.3
CN0218500000000	02	185	North Slope Borough, AK	2011	NA	3993	3690	303	7.6
CN0218800000000	02	188	Northwest Arctic Borough, AK	2011	NA	2987	2524	463	15.5
CN0219500000000	02	195	Petersburg Borough, AK	2011	NA	1856	1701	155	8.4
CN0219800000000	02	198	Prince of Wales-Hyder Census Area, AK	2011	NA	2572	2254	318	12.4
CN0222000000000	02	220	Sitka Borough/city, AK	2011	NA	4632	4348	284	6.1
CN0223000000000	02	230	Skagway Municipality, AK	2011	NA	716	600	116	16.2
CN0224000000000	02	240	Southeast Fairbanks Census Area, AK	2011	NA	3202	2804	398	12.4
CN0226100000000	02	261	Valdez-Cordova Census Area, AK	2011	NA	4938	4449	489	9.9
CN0227500000000	02	275	Wrangell Borough/city, AK	2011	NA	1051	972	79	7.5
CN0228200000000	02	282	Yakutat Borough/city, AK	2011	NA	301	269	32	10.6
CN0229000000000	02	290	Yukon-Koyukuk Census Area, AK	2011	NA	2706	2208	498	18.4
CN0400100000000	04	001	Apache County, AZ	2011	NA	23040	18788	4252	18.5
CN0400300000000	04	003	Cochise County, AZ	2011	NA	55917	50589	5328	9.5
CN0400500000000	04	005	Coconino County, AZ	2011	NA	71682	64846	6836	9.5
CN0400700000000	04	007	Gila County, AZ	2011	NA	21171	18725	2446	11.6
CN0400900000000	04	009	Graham County, AZ	2011	NA	14345	12916	1429	10
CN0401100000000	04	011	Greenlee County, AZ	2011	NA	3352	2982	370	11
CN0401200000000	04	012	La Paz County, AZ	2011	NA	7827	7057	770	9.8
CN0401300000000	04	013	Maricopa County, AZ	2011	NA	1894633	1732510	162123	8.6
CN0401500000000	04	015	Mohave County, AZ	2011	NA	79594	69823	9771	12.3
CN0401700000000	04	017	Navajo County, AZ	2011	NA	43344	36914	6430	14.8
CN0401900000000	04	019	Pima County, AZ	2011	NA	466908	427335	39573	8.5
CN0402100000000	04	021	Pinal County, AZ	2011	NA	149658	135043	14615	9.8
CN0402300000000	04	023	Santa Cruz County, AZ	2011	NA	20478	17311	3167	15.5
CN0402500000000	04	025	Yavapai County, AZ	2011	NA	93132	83953	9179	9.9
CN0402700000000	04	027	Yuma County, AZ	2011	NA	91935	69677	22258	24.2
CN0500100000000	05	001	Arkansas County, AR	2011	NA	10571	9279	1292	12.2
CN0500300000000	05	003	Ashley County, AR	2011	NA	10052	8946	1106	11
CN0500500000000	05	005	Baxter County, AR	2011	NA	16587	15046	1541	9.3
CN0500700000000	05	007	Benton County, AR	2011	NA	109419	102286	7133	6.5
CN0500900000000	05	009	Boone County, AR	2011	NA	16673	15343	1330	8
CN0501100000000	05	011	Bradley County, AR	2011	NA	4721	4150	571	12.1
CN0501300000000	05	013	Calhoun County, AR	2011	NA	2655	2401	254	9.6
CN0501500000000	05	015	Carroll County, AR	2011	NA	12891	11959	932	7.2
CN0501700000000	05	017	Chicot County, AR	2011	NA	4288	3724	564	13.2
CN0501900000000	05	019	Clark County, AR	2011	NA	10459	9385	1074	10.3
CN0502100000000	05	021	Clay County, AR	2011	NA	7301	6416	885	12.1
CN0502300000000	05	023	Cleburne County, AR	2011	NA	10574	9602	972	9.2
CN0502500000000	05	025	Cleveland County, AR	2011	NA	3880	3549	331	8.5
CN0502700000000	05	027	Columbia County, AR	2011	NA	10427	9383	1044	10
CN0502900000000	05	029	Conway County, AR	2011	NA	9033	8140	893	9.9
CN0503100000000	05	031	Craighead County, AR	2011	NA	49121	45487	3634	7.4
CN0503300000000	05	033	Crawford County, AR	2011	NA	27982	25501	2481	8.9
CN0503500000000	05	035	Crittenden County, AR	2011	NA	22747	20262	2485	10.9
CN0503700000000	05	037	Cross County, AR	2011	NA	8819	8079	740	8.4
CN0503900000000	05	039	Dallas County, AR	2011	NA	3428	3015	413	12
CN0504100000000	05	041	Desha County, AR	2011	NA	6164	5477	687	11.1
CN0504300000000	05	043	Drew County, AR	2011	NA	8799	7794	1005	11.4
CN0504500000000	05	045	Faulkner County, AR	2011	NA	59399	55122	4277	7.2
CN0504700000000	05	047	Franklin County, AR	2011	NA	7794	7196	598	7.7
CN0504900000000	05	049	Fulton County, AR	2011	NA	5121	4723	398	7.8
CN0505100000000	05	051	Garland County, AR	2011	NA	41729	38069	3660	8.8
CN0505300000000	05	053	Grant County, AR	2011	NA	8548	7916	632	7.4
CN0505500000000	05	055	Greene County, AR	2011	NA	20113	18155	1958	9.7
CN0505700000000	05	057	Hempstead County, AR	2011	NA	11048	10073	975	8.8
CN0505900000000	05	059	Hot Spring County, AR	2011	NA	14631	13424	1207	8.2
CN0506100000000	05	061	Howard County, AR	2011	NA	6767	6261	506	7.5
CN0506300000000	05	063	Independence County, AR	2011	NA	16705	15143	1562	9.4
CN0506500000000	05	065	Izard County, AR	2011	NA	5226	4707	519	9.9
CN0506700000000	05	067	Jackson County, AR	2011	NA	6705	5926	779	11.6
CN0506900000000	05	069	Jefferson County, AR	2011	NA	33681	29932	3749	11.1
CN0507100000000	05	071	Johnson County, AR	2011	NA	11144	10266	878	7.9
CN0507300000000	05	073	Lafayette County, AR	2011	NA	3031	2740	291	9.6
CN0507500000000	05	075	Lawrence County, AR	2011	NA	7506	6766	740	9.9
CN0507700000000	05	077	Lee County, AR	2011	NA	3692	3340	352	9.5
CN0507900000000	05	079	Lincoln County, AR	2011	NA	4775	4328	447	9.4
CN0508100000000	05	081	Little River County, AR	2011	NA	6135	5654	481	7.8
CN0508300000000	05	083	Logan County, AR	2011	NA	9654	8803	851	8.8
CN0508500000000	05	085	Lonoke County, AR	2011	NA	33401	31076	2325	7
CN0508700000000	05	087	Madison County, AR	2011	NA	7234	6743	491	6.8
CN0508900000000	05	089	Marion County, AR	2011	NA	6752	6114	638	9.4
CN0509100000000	05	091	Miller County, AR	2011	NA	20778	19454	1324	6.4
CN0509300000000	05	093	Mississippi County, AR	2011	NA	20969	18439	2530	12.1
CN0509500000000	05	095	Monroe County, AR	2011	NA	3395	3072	323	9.5
CN0509700000000	05	097	Montgomery County, AR	2011	NA	3846	3490	356	9.3
CN0509900000000	05	099	Nevada County, AR	2011	NA	4190	3794	396	9.5
CN0510100000000	05	101	Newton County, AR	2011	NA	3797	3512	285	7.5
CN0510300000000	05	103	Ouachita County, AR	2011	NA	11140	9975	1165	10.5
CN0510500000000	05	105	Perry County, AR	2011	NA	4514	4092	422	9.3
CN0510700000000	05	107	Phillips County, AR	2011	NA	8436	7410	1026	12.2
CN0510900000000	05	109	Pike County, AR	2011	NA	4713	4245	468	9.9
CN0511100000000	05	111	Poinsett County, AR	2011	NA	10802	9768	1034	9.6
CN0511300000000	05	113	Polk County, AR	2011	NA	8961	8240	721	8
CN0511500000000	05	115	Pope County, AR	2011	NA	30617	28225	2392	7.8
CN0511700000000	05	117	Prairie County, AR	2011	NA	3929	3588	341	8.7
CN0511900000000	05	119	Pulaski County, AR	2011	NA	189816	175617	14199	7.5
CN0512100000000	05	121	Randolph County, AR	2011	NA	7182	6371	811	11.3
CN0512300000000	05	123	St. Francis County, AR	2011	NA	9836	8741	1095	11.1
CN0512500000000	05	125	Saline County, AR	2011	NA	54136	50528	3608	6.7
CN0512700000000	05	127	Scott County, AR	2011	NA	4868	4525	343	7
CN0512900000000	05	129	Searcy County, AR	2011	NA	3332	3026	306	9.2
CN0513100000000	05	131	Sebastian County, AR	2011	NA	59517	54359	5158	8.7
CN0513300000000	05	133	Sevier County, AR	2011	NA	6428	5838	590	9.2
CN0513500000000	05	135	Sharp County, AR	2011	NA	6288	5613	675	10.7
CN0513700000000	05	137	Stone County, AR	2011	NA	5396	4913	483	9
CN0513900000000	05	139	Union County, AR	2011	NA	17013	15223	1790	10.5
CN0514100000000	05	141	Van Buren County, AR	2011	NA	6763	6017	746	11
CN0514300000000	05	143	Washington County, AR	2011	NA	104674	98067	6607	6.3
CN0514500000000	05	145	White County, AR	2011	NA	36784	33596	3188	8.7
CN0514700000000	05	147	Woodruff County, AR	2011	NA	3559	3167	392	11
CN0514900000000	05	149	Yell County, AR	2011	NA	9633	8914	719	7.5
CN0600100000000	06	001	Alameda County, CA	2011	NA	786756	707381	79375	10.1
CN0600300000000	06	003	Alpine County, CA	2011	NA	594	518	76	12.8
CN0600500000000	06	005	Amador County, CA	2011	NA	15095	13040	2055	13.6
CN0600700000000	06	007	Butte County, CA	2011	NA	100647	86891	13756	13.7
CN0600900000000	06	009	Calaveras County, CA	2011	NA	20668	17769	2899	14
CN0601100000000	06	011	Colusa County, CA	2011	NA	11376	8959	2417	21.2
CN0601300000000	06	013	Contra Costa County, CA	2011	NA	529551	475011	54540	10.3
CN0601500000000	06	015	Del Norte County, CA	2011	NA	10895	9446	1449	13.3
CN0601700000000	06	017	El Dorado County, CA	2011	NA	89690	79188	10502	11.7
CN0601900000000	06	019	Fresno County, CA	2011	NA	443510	370225	73285	16.5
CN0602100000000	06	021	Glenn County, CA	2011	NA	13167	11124	2043	15.5
CN0602300000000	06	023	Humboldt County, CA	2011	NA	65106	58228	6878	10.6
CN0602500000000	06	025	Imperial County, CA	2011	NA	79456	56524	22932	28.9
CN0602700000000	06	027	Inyo County, CA	2011	NA	9682	8741	941	9.7
CN0602900000000	06	029	Kern County, CA	2011	NA	382367	325712	56655	14.8
CN0603100000000	06	031	Kings County, CA	2011	NA	59123	49718	9405	15.9
CN0603300000000	06	033	Lake County, CA	2011	NA	29611	25310	4301	14.5
CN0603500000000	06	035	Lassen County, CA	2011	NA	11785	10190	1595	13.5
CN0603700000000	06	037	Los Angeles County, CA	2011	NA	4928464	4327923	600541	12.2
CN0603900000000	06	039	Madera County, CA	2011	NA	62014	51990	10024	16.2
CN0604100000000	06	041	Marin County, CA	2011	NA	134576	124801	9775	7.3
CN0604300000000	06	043	Mariposa County, CA	2011	NA	8661	7520	1141	13.2
CN0604500000000	06	045	Mendocino County, CA	2011	NA	40953	36284	4669	11.4
CN0604700000000	06	047	Merced County, CA	2011	NA	114735	94500	20235	17.6
CN0604900000000	06	049	Modoc County, CA	2011	NA	3620	3042	578	16
CN0605100000000	06	051	Mono County, CA	2011	NA	8832	7944	888	10.1
CN0605300000000	06	053	Monterey County, CA	2011	NA	216558	189146	27412	12.7
CN0605500000000	06	055	Napa County, CA	2011	NA	70760	63846	6914	9.8
CN0605700000000	06	057	Nevada County, CA	2011	NA	49021	43590	5431	11.1
CN0605900000000	06	059	Orange County, CA	2011	NA	1546389	1406411	139978	9.1
CN0606100000000	06	061	Placer County, CA	2011	NA	173744	154923	18821	10.8
CN0606300000000	06	063	Plumas County, CA	2011	NA	8890	7326	1564	17.6
CN0606500000000	06	065	Riverside County, CA	2011	NA	978514	849635	128879	13.2
CN0606700000000	06	067	Sacramento County, CA	2011	NA	679995	597683	82312	12.1
CN0606900000000	06	069	San Benito County, CA	2011	NA	28281	24179	4102	14.5
CN0607100000000	06	071	San Bernardino County, CA	2011	NA	888513	774166	114347	12.9
CN0607300000000	06	073	San Diego County, CA	2011	NA	1524582	1367250	157332	10.3
CN0607500000000	06	075	San Francisco County/city, CA	2011	NA	494760	454861	39899	8.1
CN0607700000000	06	077	San Joaquin County, CA	2011	NA	311363	260997	50366	16.2
CN0607900000000	06	079	San Luis Obispo County, CA	2011	NA	134374	121509	12865	9.6
CN0608100000000	06	081	San Mateo County, CA	2011	NA	399859	369827	30032	7.5
CN0608300000000	06	083	Santa Barbara County, CA	2011	NA	213005	193023	19982	9.4
CN0608500000000	06	085	Santa Clara County, CA	2011	NA	939851	852426	87425	9.3
CN0608700000000	06	087	Santa Cruz County, CA	2011	NA	141335	122865	18470	13.1
CN0608900000000	06	089	Shasta County, CA	2011	NA	77044	64762	12282	15.9
CN0609100000000	06	091	Sierra County, CA	2011	NA	1601	1363	238	14.9
CN0609300000000	06	093	Siskiyou County, CA	2011	NA	19435	16134	3301	17
CN0609500000000	06	095	Solano County, CA	2011	NA	202241	177619	24622	12.2
CN0609700000000	06	097	Sonoma County, CA	2011	NA	246171	220958	25213	10.2
CN0609900000000	06	099	Stanislaus County, CA	2011	NA	242320	202360	39960	16.5
CN0610100000000	06	101	Sutter County, CA	2011	NA	45939	37596	8343	18.2
CN0610300000000	06	103	Tehama County, CA	2011	NA	25574	21744	3830	15
CN0610500000000	06	105	Trinity County, CA	2011	NA	5385	4486	899	16.7
CN0610700000000	06	107	Tulare County, CA	2011	NA	203474	168687	34787	17.1
CN0610900000000	06	109	Tuolumne County, CA	2011	NA	22725	19440	3285	14.5
CN0611100000000	06	111	Ventura County, CA	2011	NA	431718	387495	44223	10.2
CN0611300000000	06	113	Yolo County, CA	2011	NA	101806	89818	11988	11.8
CN0611500000000	06	115	Yuba County, CA	2011	NA	28948	24035	4913	17
CN0800100000000	08	001	Adams County, CO	2011	NA	236385	212931	23454	9.9
CN0800300000000	08	003	Alamosa County, CO	2011	NA	7684	6942	742	9.7
CN0800500000000	08	005	Arapahoe County, CO	2011	NA	319253	292867	26386	8.3
CN0800700000000	08	007	Archuleta County, CO	2011	NA	5748	5169	579	10.1
CN0800900000000	08	009	Baca County, CO	2011	NA	2068	1969	99	4.8
CN0801100000000	08	011	Bent County, CO	2011	NA	1929	1770	159	8.2
CN0801300000000	08	013	Boulder County, CO	2011	NA	172002	160904	11098	6.5
CN0801400000000	08	014	Broomfield County/city, CO	2011	NA	31768	29539	2229	7
CN0801500000000	08	015	Chaffee County, CO	2011	NA	8301	7702	599	7.2
CN0801700000000	08	017	Cheyenne County, CO	2011	NA	1050	1006	44	4.2
CN0801900000000	08	019	Clear Creek County, CO	2011	NA	5500	5094	406	7.4
CN0802100000000	08	021	Conejos County, CO	2011	NA	3728	3338	390	10.5
CN0802300000000	08	023	Costilla County, CO	2011	NA	1582	1397	185	11.7
CN0802500000000	08	025	Crowley County, CO	2011	NA	1488	1356	132	8.9
CN0802700000000	08	027	Custer County, CO	2011	NA	2017	1889	128	6.3
CN0802900000000	08	029	Delta County, CO	2011	NA	14409	12905	1504	10.4
CN0803100000000	08	031	Denver County/city, CO	2011	NA	352226	321953	30273	8.6
CN0803300000000	08	033	Dolores County, CO	2011	NA	947	826	121	12.8
CN0803500000000	08	035	Douglas County, CO	2011	NA	158279	148154	10125	6.4
CN0803700000000	08	037	Eagle County, CO	2011	NA	32147	29624	2523	7.8
CN0803900000000	08	039	Elbert County, CO	2011	NA	12674	11724	950	7.5
CN0804100000000	08	041	El Paso County, CO	2011	NA	307563	279542	28021	9.1
CN0804300000000	08	043	Fremont County, CO	2011	NA	15916	14005	1911	12
CN0804500000000	08	045	Garfield County, CO	2011	NA	31376	28404	2972	9.5
CN0804700000000	08	047	Gilpin County, CO	2011	NA	3269	3033	236	7.2
CN0804900000000	08	049	Grand County, CO	2011	NA	8795	8087	708	8.1
CN0805100000000	08	051	Gunnison County, CO	2011	NA	9935	9336	599	6
CN0805300000000	08	053	Hinsdale County, CO	2011	NA	473	449	24	5.1
CN0805500000000	08	055	Huerfano County, CO	2011	NA	2659	2298	361	13.6
CN0805700000000	08	057	Jackson County, CO	2011	NA	893	839	54	6
CN0805900000000	08	059	Jefferson County, CO	2011	NA	302402	278353	24049	8
CN0806100000000	08	061	Kiowa County, CO	2011	NA	836	794	42	5
CN0806300000000	08	063	Kit Carson County, CO	2011	NA	4265	4065	200	4.7
CN0806500000000	08	065	Lake County, CO	2011	NA	4377	3936	441	10.1
CN0806700000000	08	067	La Plata County, CO	2011	NA	29476	27408	2068	7
CN0806900000000	08	069	Larimer County, CO	2011	NA	170942	158704	12238	7.2
CN0807100000000	08	071	Las Animas County, CO	2011	NA	6977	6208	769	11
CN0807300000000	08	073	Lincoln County, CO	2011	NA	2193	2054	139	6.3
CN0807500000000	08	075	Logan County, CO	2011	NA	11081	10388	693	6.3
CN0807700000000	08	077	Mesa County, CO	2011	NA	75475	67738	7737	10.3
CN0807900000000	08	079	Mineral County, CO	2011	NA	426	403	23	5.4
CN0808100000000	08	081	Moffat County, CO	2011	NA	7861	7130	731	9.3
CN0808300000000	08	083	Montezuma County, CO	2011	NA	12986	11850	1136	8.7
CN0808500000000	08	085	Montrose County, CO	2011	NA	20017	17805	2212	11.1
CN0808700000000	08	087	Morgan County, CO	2011	NA	15043	14040	1003	6.7
CN0808900000000	08	089	Otero County, CO	2011	NA	8473	7629	844	10
CN0809100000000	08	091	Ouray County, CO	2011	NA	2023	1817	206	10.2
CN0809300000000	08	093	Park County, CO	2011	NA	9406	8683	723	7.7
CN0809500000000	08	095	Phillips County, CO	2011	NA	2154	2039	115	5.3
CN0809700000000	08	097	Pitkin County, CO	2011	NA	10926	10072	854	7.8
CN0809900000000	08	099	Prowers County, CO	2011	NA	6242	5829	413	6.6
CN0810100000000	08	101	Pueblo County, CO	2011	NA	75117	67211	7906	10.5
CN0810300000000	08	103	Rio Blanco County, CO	2011	NA	3119	2874	245	7.9
CN0810500000000	08	105	Rio Grande County, CO	2011	NA	5152	4519	633	12.3
CN0810700000000	08	107	Routt County, CO	2011	NA	14288	13111	1177	8.2
CN0810900000000	08	109	Saguache County, CO	2011	NA	3015	2679	336	11.1
CN0811100000000	08	111	San Juan County, CO	2011	NA	522	461	61	11.7
CN0811300000000	08	113	San Miguel County, CO	2011	NA	4885	4492	393	8
CN0811500000000	08	115	Sedgwick County, CO	2011	NA	1096	1009	87	7.9
CN0811700000000	08	117	Summit County, CO	2011	NA	19255	18003	1252	6.5
CN0811900000000	08	119	Teller County, CO	2011	NA	12154	11024	1130	9.3
CN0812100000000	08	121	Washington County, CO	2011	NA	2589	2448	141	5.4
CN0812300000000	08	123	Weld County, CO	2011	NA	134285	122737	11548	8.6
CN0812500000000	08	125	Yuma County, CO	2011	NA	4962	4701	261	5.3
CN0900100000000	09	001	Fairfield County, CT	2011	NA	476904	437780	39124	8.2
CN0900300000000	09	003	Hartford County, CT	2011	NA	479861	436459	43402	9
CN0900500000000	09	005	Litchfield County, CT	2011	NA	108020	99231	8789	8.1
CN0900700000000	09	007	Middlesex County, CT	2011	NA	93654	86510	7144	7.6
CN0900900000000	09	009	New Haven County, CT	2011	NA	462351	417569	44782	9.7
CN0901100000000	09	011	New London County, CT	2011	NA	143095	130410	12685	8.9
CN0901300000000	09	013	Tolland County, CT	2011	NA	86365	79857	6508	7.5
CN0901500000000	09	015	Windham County, CT	2011	NA	64525	58152	6373	9.9
CN1000100000000	10	001	Kent County, DE	2011	NA	74064	67996	6068	8.2
CN1000300000000	10	003	New Castle County, DE	2011	NA	277387	257260	20127	7.3
CN1000500000000	10	005	Sussex County, DE	2011	NA	91896	84830	7066	7.7
CN1100100000000	11	001	District of Columbia	2011	NA	350778	315171	35607	10.2
CN1200100000000	12	001	Alachua County, FL	2011	NA	129027	119251	9776	7.6
CN1200300000000	12	003	Baker County, FL	2011	NA	11506	10333	1173	10.2
CN1200500000000	12	005	Bay County, FL	2011	NA	87205	78311	8894	10.2
CN1200700000000	12	007	Bradford County, FL	2011	NA	11507	10462	1045	9.1
CN1200900000000	12	009	Brevard County, FL	2011	NA	265213	236336	28877	10.9
CN1201100000000	12	011	Broward County, FL	2011	NA	951445	861686	89759	9.4
CN1201300000000	12	013	Calhoun County, FL	2011	NA	5242	4698	544	10.4
CN1201500000000	12	015	Charlotte County, FL	2011	NA	65722	58308	7414	11.3
CN1201700000000	12	017	Citrus County, FL	2011	NA	52057	45546	6511	12.5
CN1201900000000	12	019	Clay County, FL	2011	NA	96166	87408	8758	9.1
CN1202100000000	12	021	Collier County, FL	2011	NA	148810	133729	15081	10.1
CN1202300000000	12	023	Columbia County, FL	2011	NA	28242	25337	2905	10.3
CN1202700000000	12	027	DeSoto County, FL	2011	NA	13884	12447	1437	10.4
CN1202900000000	12	029	Dixie County, FL	2011	NA	5754	5047	707	12.3
CN1203100000000	12	031	Duval County, FL	2011	NA	456441	409556	46885	10.3
CN1203300000000	12	033	Escambia County, FL	2011	NA	140774	127131	13643	9.7
CN1203500000000	12	035	Flagler County, FL	2011	NA	41940	37167	4773	11.4
CN1203700000000	12	037	Franklin County, FL	2011	NA	5051	4665	386	7.6
CN1203900000000	12	039	Gadsden County, FL	2011	NA	19614	17342	2272	11.6
CN1204100000000	12	041	Gilchrist County, FL	2011	NA	6857	6151	706	10.3
CN1204300000000	12	043	Glades County, FL	2011	NA	5292	4788	504	9.5
CN1204500000000	12	045	Gulf County, FL	2011	NA	6241	5638	603	9.7
CN1204700000000	12	047	Hamilton County, FL	2011	NA	4898	4389	509	10.4
CN1204900000000	12	049	Hardee County, FL	2011	NA	11916	10718	1198	10.1
CN1205100000000	12	051	Hendry County, FL	2011	NA	17971	15482	2489	13.9
CN1205300000000	12	053	Hernando County, FL	2011	NA	66199	57925	8274	12.5
CN1205500000000	12	055	Highlands County, FL	2011	NA	38151	33773	4378	11.5
CN1205700000000	12	057	Hillsborough County, FL	2011	NA	661540	598119	63421	9.6
CN1205900000000	12	059	Holmes County, FL	2011	NA	7195	6488	707	9.8
CN1206100000000	12	061	Indian River County, FL	2011	NA	61940	54097	7843	12.7
CN1206300000000	12	063	Jackson County, FL	2011	NA	18260	16531	1729	9.5
CN1206500000000	12	065	Jefferson County, FL	2011	NA	5918	5323	595	10.1
CN1206700000000	12	067	Lafayette County, FL	2011	NA	3636	3409	227	6.2
CN1206900000000	12	069	Lake County, FL	2011	NA	133860	119672	14188	10.6
CN1207100000000	12	071	Lee County, FL	2011	NA	287064	255884	31180	10.9
CN1207300000000	12	073	Leon County, FL	2011	NA	149969	138321	11648	7.8
CN1207500000000	12	075	Levy County, FL	2011	NA	16974	15125	1849	10.9
CN1207700000000	12	077	Liberty County, FL	2011	NA	2862	2600	262	9.2
CN1207900000000	12	079	Madison County, FL	2011	NA	8078	7303	775	9.6
CN1208100000000	12	081	Manatee County, FL	2011	NA	148173	133384	14789	10
CN1208300000000	12	083	Marion County, FL	2011	NA	131031	114905	16126	12.3
CN1208500000000	12	085	Martin County, FL	2011	NA	66822	60208	6614	9.9
CN1208600000000	12	086	Miami-Dade County, FL	2011	NA	1255105	1137041	118064	9.4
CN1208700000000	12	087	Monroe County, FL	2011	NA	42781	39791	2990	7
CN1208900000000	12	089	Nassau County, FL	2011	NA	36018	32556	3462	9.6
CN1209100000000	12	091	Okaloosa County, FL	2011	NA	90913	83806	7107	7.8
CN1209300000000	12	093	Okeechobee County, FL	2011	NA	17822	15695	2127	11.9
CN1209500000000	12	095	Orange County, FL	2011	NA	642178	579251	62927	9.8
CN1209700000000	12	097	Osceola County, FL	2011	NA	140286	124469	15817	11.3
CN1209900000000	12	099	Palm Beach County, FL	2011	NA	652697	587173	65524	10
CN1210100000000	12	101	Pasco County, FL	2011	NA	206715	184347	22368	10.8
CN1210300000000	12	103	Pinellas County, FL	2011	NA	463993	418950	45043	9.7
CN1210500000000	12	105	Polk County, FL	2011	NA	276920	245740	31180	11.3
CN1210700000000	12	107	Putnam County, FL	2011	NA	29776	25968	3808	12.8
CN1210900000000	12	109	St. Johns County, FL	2011	NA	101402	93552	7850	7.7
CN1211100000000	12	111	St. Lucie County, FL	2011	NA	128670	112473	16197	12.6
CN1211300000000	12	113	Santa Rosa County, FL	2011	NA	72675	66399	6276	8.6
CN1211500000000	12	115	Sarasota County, FL	2011	NA	166864	149796	17068	10.2
CN1211700000000	12	117	Seminole County, FL	2011	NA	230621	208447	22174	9.6
CN1211900000000	12	119	Sumter County, FL	2011	NA	26041	22876	3165	12.2
CN1212100000000	12	121	Suwannee County, FL	2011	NA	18870	17125	1745	9.2
CN1212300000000	12	123	Taylor County, FL	2011	NA	9444	8493	951	10.1
CN1212500000000	12	125	Union County, FL	2011	NA	5178	4754	424	8.2
CN1212700000000	12	127	Volusia County, FL	2011	NA	237832	211132	26700	11.2
CN1212900000000	12	129	Wakulla County, FL	2011	NA	14604	13398	1206	8.3
CN1213100000000	12	131	Walton County, FL	2011	NA	26285	24050	2235	8.5
CN1213300000000	12	133	Washington County, FL	2011	NA	10412	9369	1043	10
CN1300100000000	13	001	Appling County, GA	2011	NA	8875	7778	1097	12.4
CN1300300000000	13	003	Atkinson County, GA	2011	NA	3495	3047	448	12.8
CN1300500000000	13	005	Bacon County, GA	2011	NA	4508	4035	473	10.5
CN1300700000000	13	007	Baker County, GA	2011	NA	1172	1036	136	11.6
CN1300900000000	13	009	Baldwin County, GA	2011	NA	18617	16054	2563	13.8
CN1301100000000	13	011	Banks County, GA	2011	NA	8506	7720	786	9.2
CN1301300000000	13	013	Barrow County, GA	2011	NA	34618	31174	3444	9.9
CN1301500000000	13	015	Bartow County, GA	2011	NA	47746	42279	5467	11.5
CN1301700000000	13	017	Ben Hill County, GA	2011	NA	6254	5279	975	15.6
CN1301900000000	13	019	Berrien County, GA	2011	NA	7868	6886	982	12.5
CN1302100000000	13	021	Bibb County, GA	2011	NA	71223	63035	8188	11.5
CN1302300000000	13	023	Bleckley County, GA	2011	NA	5492	4759	733	13.3
CN1302500000000	13	025	Brantley County, GA	2011	NA	7463	6480	983	13.2
CN1302700000000	13	027	Brooks County, GA	2011	NA	7066	6359	707	10
CN1302900000000	13	029	Bryan County, GA	2011	NA	14722	13344	1378	9.4
CN1303100000000	13	031	Bulloch County, GA	2011	NA	33499	29978	3521	10.5
CN1303300000000	13	033	Burke County, GA	2011	NA	9953	8690	1263	12.7
CN1303500000000	13	035	Butts County, GA	2011	NA	10458	9270	1188	11.4
CN1303700000000	13	037	Calhoun County, GA	2011	NA	2522	2310	212	8.4
CN1303900000000	13	039	Camden County, GA	2011	NA	21154	19133	2021	9.6
CN1304300000000	13	043	Candler County, GA	2011	NA	5033	4549	484	9.6
CN1304500000000	13	045	Carroll County, GA	2011	NA	51917	46021	5896	11.4
CN1304700000000	13	047	Catoosa County, GA	2011	NA	32062	29433	2629	8.2
CN1304900000000	13	049	Charlton County, GA	2011	NA	4965	4437	528	10.6
CN1305100000000	13	051	Chatham County, GA	2011	NA	129639	116650	12989	10
CN1305300000000	13	053	Chattahoochee County, GA	2011	NA	2369	2095	274	11.6
CN1305500000000	13	055	Chattooga County, GA	2011	NA	10578	9411	1167	11
CN1305700000000	13	057	Cherokee County, GA	2011	NA	113843	104542	9301	8.2
CN1305900000000	13	059	Clarke County, GA	2011	NA	57177	51856	5321	9.3
CN1306100000000	13	061	Clay County, GA	2011	NA	1066	935	131	12.3
CN1306300000000	13	063	Clayton County, GA	2011	NA	126983	109948	17035	13.4
CN1306500000000	13	065	Clinch County, GA	2011	NA	2889	2572	317	11
CN1306700000000	13	067	Cobb County, GA	2011	NA	384688	350725	33963	8.8
CN1306900000000	13	069	Coffee County, GA	2011	NA	17605	15336	2269	12.9
CN1307100000000	13	071	Colquitt County, GA	2011	NA	21236	19217	2019	9.5
CN1307300000000	13	073	Columbia County, GA	2011	NA	63320	58667	4653	7.3
CN1307500000000	13	075	Cook County, GA	2011	NA	7602	6746	856	11.3
CN1307700000000	13	077	Coweta County, GA	2011	NA	65009	59123	5886	9.1
CN1307900000000	13	079	Crawford County, GA	2011	NA	5807	5181	626	10.8
CN1308100000000	13	081	Crisp County, GA	2011	NA	9203	7923	1280	13.9
CN1308300000000	13	083	Dade County, GA	2011	NA	8365	7697	668	8
CN1308500000000	13	085	Dawson County, GA	2011	NA	10882	9779	1103	10.1
CN1308700000000	13	087	Decatur County, GA	2011	NA	12066	10619	1447	12
CN1308900000000	13	089	DeKalb County, GA	2011	NA	366603	327936	38667	10.5
CN1309100000000	13	091	Dodge County, GA	2011	NA	8292	7274	1018	12.3
CN1309300000000	13	093	Dooly County, GA	2011	NA	4789	4164	625	13.1
CN1309500000000	13	095	Dougherty County, GA	2011	NA	41256	36235	5021	12.2
CN1309700000000	13	097	Douglas County, GA	2011	NA	66989	59707	7282	10.9
CN1309900000000	13	099	Early County, GA	2011	NA	4449	3938	511	11.5
CN1310100000000	13	101	Echols County, GA	2011	NA	1879	1727	152	8.1
CN1310300000000	13	103	Effingham County, GA	2011	NA	25639	23251	2388	9.3
CN1310500000000	13	105	Elbert County, GA	2011	NA	8796	7378	1418	16.1
CN1310700000000	13	107	Emanuel County, GA	2011	NA	9162	7944	1218	13.3
CN1310900000000	13	109	Evans County, GA	2011	NA	4809	4370	439	9.1
CN1311100000000	13	111	Fannin County, GA	2011	NA	10273	9113	1160	11.3
CN1311300000000	13	113	Fayette County, GA	2011	NA	53224	48960	4264	8
CN1311500000000	13	115	Floyd County, GA	2011	NA	44852	39440	5412	12.1
CN1311700000000	13	117	Forsyth County, GA	2011	NA	91061	84314	6747	7.4
CN1311900000000	13	119	Franklin County, GA	2011	NA	9751	8566	1185	12.2
CN1312100000000	13	121	Fulton County, GA	2011	NA	498861	448034	50827	10.2
CN1312300000000	13	123	Gilmer County, GA	2011	NA	12372	10917	1455	11.8
CN1312500000000	13	125	Glascock County, GA	2011	NA	1335	1193	142	10.6
CN1312700000000	13	127	Glynn County, GA	2011	NA	38256	34267	3989	10.4
CN1312900000000	13	129	Gordon County, GA	2011	NA	26267	23198	3069	11.7
CN1313100000000	13	131	Grady County, GA	2011	NA	10847	9817	1030	9.5
CN1313300000000	13	133	Greene County, GA	2011	NA	6379	5592	787	12.3
CN1313500000000	13	135	Gwinnett County, GA	2011	NA	427145	389936	37209	8.7
CN1313700000000	13	137	Habersham County, GA	2011	NA	18337	16411	1926	10.5
CN1313900000000	13	139	Hall County, GA	2011	NA	87726	79953	7773	8.9
CN1314100000000	13	141	Hancock County, GA	2011	NA	2961	2375	586	19.8
CN1314300000000	13	143	Haralson County, GA	2011	NA	12255	10833	1422	11.6
CN1314500000000	13	145	Harris County, GA	2011	NA	16399	15184	1215	7.4
CN1314700000000	13	147	Hart County, GA	2011	NA	11146	9898	1248	11.2
CN1314900000000	13	149	Heard County, GA	2011	NA	5169	4584	585	11.3
CN1315100000000	13	151	Henry County, GA	2011	NA	102687	92085	10602	10.3
CN1315300000000	13	153	Houston County, GA	2011	NA	68352	62512	5840	8.5
CN1315500000000	13	155	Irwin County, GA	2011	NA	3541	3054	487	13.8
CN1315700000000	13	157	Jackson County, GA	2011	NA	28906	26135	2771	9.6
CN1315900000000	13	159	Jasper County, GA	2011	NA	6796	6047	749	11
CN1316100000000	13	161	Jeff Davis County, GA	2011	NA	6512	5692	820	12.6
CN1316300000000	13	163	Jefferson County, GA	2011	NA	7121	6177	944	13.3
CN1316500000000	13	165	Jenkins County, GA	2011	NA	3206	2746	460	14.3
CN1316700000000	13	167	Johnson County, GA	2011	NA	4165	3703	462	11.1
CN1316900000000	13	169	Jones County, GA	2011	NA	13817	12544	1273	9.2
CN1317100000000	13	171	Lamar County, GA	2011	NA	8116	7002	1114	13.7
CN1317300000000	13	173	Lanier County, GA	2011	NA	3951	3536	415	10.5
CN1317500000000	13	175	Laurens County, GA	2011	NA	20302	17493	2809	13.8
CN1317700000000	13	177	Lee County, GA	2011	NA	14330	13119	1211	8.5
CN1317900000000	13	179	Liberty County, GA	2011	NA	27588	25015	2573	9.3
CN1318100000000	13	181	Lincoln County, GA	2011	NA	3636	3216	420	11.6
CN1318300000000	13	183	Long County, GA	2011	NA	6375	5809	566	8.9
CN1318500000000	13	185	Lowndes County, GA	2011	NA	51359	46277	5082	9.9
CN1318700000000	13	187	Lumpkin County, GA	2011	NA	14884	13429	1455	9.8
CN1318900000000	13	189	McDuffie County, GA	2011	NA	9405	8150	1255	13.3
CN1319100000000	13	191	McIntosh County, GA	2011	NA	6188	5530	658	10.6
CN1319300000000	13	193	Macon County, GA	2011	NA	5281	4550	731	13.8
CN1319500000000	13	195	Madison County, GA	2011	NA	13222	11885	1337	10.1
CN1319700000000	13	197	Marion County, GA	2011	NA	3681	3297	384	10.4
CN1319900000000	13	199	Meriwether County, GA	2011	NA	9244	8009	1235	13.4
CN1320100000000	13	201	Miller County, GA	2011	NA	2737	2486	251	9.2
CN1320500000000	13	205	Mitchell County, GA	2011	NA	9523	8568	955	10
CN1320700000000	13	207	Monroe County, GA	2011	NA	12739	11503	1236	9.7
CN1320900000000	13	209	Montgomery County, GA	2011	NA	3913	3397	516	13.2
CN1321100000000	13	211	Morgan County, GA	2011	NA	8639	7771	868	10
CN1321300000000	13	213	Murray County, GA	2011	NA	17062	14692	2370	13.9
CN1321500000000	13	215	Muscogee County, GA	2011	NA	82863	74559	8304	10
CN1321700000000	13	217	Newton County, GA	2011	NA	48399	42424	5975	12.3
CN1321900000000	13	219	Oconee County, GA	2011	NA	16910	15727	1183	7
CN1322100000000	13	221	Oglethorpe County, GA	2011	NA	6999	6319	680	9.7
CN1322300000000	13	223	Paulding County, GA	2011	NA	74316	67219	7097	9.5
CN1322500000000	13	225	Peach County, GA	2011	NA	12693	11189	1504	11.8
CN1322700000000	13	227	Pickens County, GA	2011	NA	14063	12582	1481	10.5
CN1322900000000	13	229	Pierce County, GA	2011	NA	8099	7236	863	10.7
CN1323100000000	13	231	Pike County, GA	2011	NA	8437	7577	860	10.2
CN1323300000000	13	233	Polk County, GA	2011	NA	18679	16532	2147	11.5
CN1323500000000	13	235	Pulaski County, GA	2011	NA	4486	4055	431	9.6
CN1323700000000	13	237	Putnam County, GA	2011	NA	8667	7541	1126	13
CN1323900000000	13	239	Quitman County, GA	2011	NA	979	879	100	10.2
CN1324100000000	13	241	Rabun County, GA	2011	NA	7034	6163	871	12.4
CN1324300000000	13	243	Randolph County, GA	2011	NA	2945	2569	376	12.8
CN1324500000000	13	245	Richmond County, GA	2011	NA	88510	78559	9951	11.2
CN1324700000000	13	247	Rockdale County, GA	2011	NA	42258	37516	4742	11.2
CN1324900000000	13	249	Schley County, GA	2011	NA	2162	1914	248	11.5
CN1325100000000	13	251	Screven County, GA	2011	NA	5768	4857	911	15.8
CN1325300000000	13	253	Seminole County, GA	2011	NA	3272	2860	412	12.6
CN1325500000000	13	255	Spalding County, GA	2011	NA	28573	24569	4004	14
CN1325700000000	13	257	Stephens County, GA	2011	NA	11743	10340	1403	11.9
CN1325900000000	13	259	Stewart County, GA	2011	NA	2337	2108	229	9.8
CN1326100000000	13	261	Sumter County, GA	2011	NA	13933	12183	1750	12.6
CN1326300000000	13	263	Talbot County, GA	2011	NA	2918	2611	307	10.5
CN1326500000000	13	265	Taliaferro County, GA	2011	NA	618	521	97	15.7
CN1326700000000	13	267	Tattnall County, GA	2011	NA	9874	9005	869	8.8
CN1326900000000	13	269	Taylor County, GA	2011	NA	3179	2720	459	14.4
CN1327100000000	13	271	Telfair County, GA	2011	NA	5282	4583	699	13.2
CN1327300000000	13	273	Terrell County, GA	2011	NA	3850	3388	462	12
CN1327500000000	13	275	Thomas County, GA	2011	NA	18338	16437	1901	10.4
CN1327700000000	13	277	Tift County, GA	2011	NA	18942	16652	2290	12.1
CN1327900000000	13	279	Toombs County, GA	2011	NA	12433	10766	1667	13.4
CN1328100000000	13	281	Towns County, GA	2011	NA	4357	3811	546	12.5
CN1328300000000	13	283	Treutlen County, GA	2011	NA	2989	2592	397	13.3
CN1328500000000	13	285	Troup County, GA	2011	NA	34505	30705	3800	11
CN1328700000000	13	287	Turner County, GA	2011	NA	3598	3084	514	14.3
CN1328900000000	13	289	Twiggs County, GA	2011	NA	3255	2751	504	15.5
CN1329100000000	13	291	Union County, GA	2011	NA	9480	8517	963	10.2
CN1329300000000	13	293	Upson County, GA	2011	NA	12013	10621	1392	11.6
CN1329500000000	13	295	Walker County, GA	2011	NA	31064	28025	3039	9.8
CN1329700000000	13	297	Walton County, GA	2011	NA	41220	36929	4291	10.4
CN1329900000000	13	299	Ware County, GA	2011	NA	15280	13556	1724	11.3
CN1330100000000	13	301	Warren County, GA	2011	NA	2648	2209	439	16.6
CN1330300000000	13	303	Washington County, GA	2011	NA	8116	7082	1034	12.7
CN1330500000000	13	305	Wayne County, GA	2011	NA	12504	10985	1519	12.1
CN1330700000000	13	307	Webster County, GA	2011	NA	1067	945	122	11.4
CN1330900000000	13	309	Wheeler County, GA	2011	NA	1981	1690	291	14.7
CN1331100000000	13	311	White County, GA	2011	NA	13169	11861	1308	9.9
CN1331300000000	13	313	Whitfield County, GA	2011	NA	47462	41846	5616	11.8
CN1331500000000	13	315	Wilcox County, GA	2011	NA	2933	2558	375	12.8
CN1331700000000	13	317	Wilkes County, GA	2011	NA	3931	3384	547	13.9
CN1331900000000	13	319	Wilkinson County, GA	2011	NA	3775	3288	487	12.9
CN1332100000000	13	321	Worth County, GA	2011	NA	9795	8669	1126	11.5
CN1500100000000	15	001	Hawaii County, HI	2011	NA	89455	80734	8721	9.7
CN1500300000000	15	003	Honolulu County/city, HI	2011	NA	453983	427178	26805	5.9
CN1500700000000	15	007	Kauai County, HI	2011	NA	35558	32528	3030	8.5
CN1500900000000	15	009	Maui County, HI	2011	NA	81258	74880	6378	7.8
CN1600100000000	16	001	Ada County, ID	2011	NA	200304	185600	14704	7.3
CN1600300000000	16	003	Adams County, ID	2011	NA	1745	1433	312	17.9
CN1600500000000	16	005	Bannock County, ID	2011	NA	41065	37980	3085	7.5
CN1600700000000	16	007	Bear Lake County, ID	2011	NA	2922	2744	178	6.1
CN1600900000000	16	009	Benewah County, ID	2011	NA	4152	3600	552	13.3
CN1601100000000	16	011	Bingham County, ID	2011	NA	22849	21220	1629	7.1
CN1601300000000	16	013	Blaine County, ID	2011	NA	11877	10847	1030	8.7
CN1601500000000	16	015	Boise County, ID	2011	NA	3060	2748	312	10.2
CN1601700000000	16	017	Bonner County, ID	2011	NA	19047	16695	2352	12.3
CN1601900000000	16	019	Bonneville County, ID	2011	NA	49344	45925	3419	6.9
CN1602100000000	16	021	Boundary County, ID	2011	NA	5386	4763	623	11.6
CN1602300000000	16	023	Butte County, ID	2011	NA	1325	1217	108	8.2
CN1602500000000	16	025	Camas County, ID	2011	NA	639	560	79	12.4
CN1602700000000	16	027	Canyon County, ID	2011	NA	85518	76495	9023	10.6
CN1602900000000	16	029	Caribou County, ID	2011	NA	3885	3595	290	7.5
CN1603100000000	16	031	Cassia County, ID	2011	NA	11198	10460	738	6.6
CN1603300000000	16	033	Clark County, ID	2011	NA	516	470	46	8.9
CN1603500000000	16	035	Clearwater County, ID	2011	NA	3356	2897	459	13.7
CN1603700000000	16	037	Custer County, ID	2011	NA	2302	2119	183	7.9
CN1603900000000	16	039	Elmore County, ID	2011	NA	11004	10092	912	8.3
CN1604100000000	16	041	Franklin County, ID	2011	NA	6251	5912	339	5.4
CN1604300000000	16	043	Fremont County, ID	2011	NA	6707	6188	519	7.7
CN1604500000000	16	045	Gem County, ID	2011	NA	7708	6875	833	10.8
CN1604700000000	16	047	Gooding County, ID	2011	NA	8355	7790	565	6.8
CN1604900000000	16	049	Idaho County, ID	2011	NA	6686	5862	824	12.3
CN1605100000000	16	051	Jefferson County, ID	2011	NA	12513	11645	868	6.9
CN1605300000000	16	053	Jerome County, ID	2011	NA	11031	10198	833	7.6
CN1605500000000	16	055	Kootenai County, ID	2011	NA	69335	62302	7033	10.1
CN1605700000000	16	057	Latah County, ID	2011	NA	19256	18044	1212	6.3
CN1605900000000	16	059	Lemhi County, ID	2011	NA	3668	3291	377	10.3
CN1606100000000	16	061	Lewis County, ID	2011	NA	1554	1457	97	6.2
CN1606300000000	16	063	Lincoln County, ID	2011	NA	2682	2362	320	11.9
CN1606500000000	16	065	Madison County, ID	2011	NA	17907	16961	946	5.3
CN1606700000000	16	067	Minidoka County, ID	2011	NA	10566	9832	734	6.9
CN1606900000000	16	069	Nez Perce County, ID	2011	NA	20095	18817	1278	6.4
CN1607100000000	16	071	Oneida County, ID	2011	NA	2017	1900	117	5.8
CN1607300000000	16	073	Owyhee County, ID	2011	NA	4888	4676	212	4.3
CN1607500000000	16	075	Payette County, ID	2011	NA	11165	10162	1003	9
CN1607700000000	16	077	Power County, ID	2011	NA	3929	3584	345	8.8
CN1607900000000	16	079	Shoshone County, ID	2011	NA	5514	4715	799	14.5
CN1608100000000	16	081	Teton County, ID	2011	NA	5328	4969	359	6.7
CN1608300000000	16	083	Twin Falls County, ID	2011	NA	37138	34191	2947	7.9
CN1608500000000	16	085	Valley County, ID	2011	NA	4656	3999	657	14.1
CN1608700000000	16	087	Washington County, ID	2011	NA	4736	4274	462	9.8
CN1700100000000	17	001	Adams County, IL	2011	NA	34374	32001	2373	6.9
CN1700300000000	17	003	Alexander County, IL	2011	NA	2889	2516	373	12.9
CN1700500000000	17	005	Bond County, IL	2011	NA	8484	7694	790	9.3
CN1700700000000	17	007	Boone County, IL	2011	NA	27121	23925	3196	11.8
CN1700900000000	17	009	Brown County, IL	2011	NA	2589	2428	161	6.2
CN1701100000000	17	011	Bureau County, IL	2011	NA	18733	16880	1853	9.9
CN1701300000000	17	013	Calhoun County, IL	2011	NA	2497	2254	243	9.7
CN1701500000000	17	015	Carroll County, IL	2011	NA	8299	7553	746	9
CN1701700000000	17	017	Cass County, IL	2011	NA	6892	6327	565	8.2
CN1701900000000	17	019	Champaign County, IL	2011	NA	108198	99977	8221	7.6
CN1702100000000	17	021	Christian County, IL	2011	NA	16842	15224	1618	9.6
CN1702300000000	17	023	Clark County, IL	2011	NA	8112	7271	841	10.4
CN1702500000000	17	025	Clay County, IL	2011	NA	6687	5977	710	10.6
CN1702700000000	17	027	Clinton County, IL	2011	NA	20695	19301	1394	6.7
CN1702900000000	17	029	Coles County, IL	2011	NA	24775	22450	2325	9.4
CN1703100000000	17	031	Cook County, IL	2011	NA	2636432	2360932	275500	10.4
CN1703300000000	17	033	Crawford County, IL	2011	NA	10814	10027	787	7.3
CN1703500000000	17	035	Cumberland County, IL	2011	NA	5939	5426	513	8.6
CN1703700000000	17	037	DeKalb County, IL	2011	NA	55737	50558	5179	9.3
CN1703900000000	17	039	De Witt County, IL	2011	NA	8735	7996	739	8.5
CN1704100000000	17	041	Douglas County, IL	2011	NA	10192	9370	822	8.1
CN1704300000000	17	043	DuPage County, IL	2011	NA	501986	460854	41132	8.2
CN1704500000000	17	045	Edgar County, IL	2011	NA	9326	8348	978	10.5
CN1704700000000	17	047	Edwards County, IL	2011	NA	3136	2881	255	8.1
CN1704900000000	17	049	Effingham County, IL	2011	NA	18644	17362	1282	6.9
CN1705100000000	17	051	Fayette County, IL	2011	NA	11156	10125	1031	9.2
CN1705300000000	17	053	Ford County, IL	2011	NA	7128	6519	609	8.5
CN1705500000000	17	055	Franklin County, IL	2011	NA	17601	15637	1964	11.2
CN1705700000000	17	057	Fulton County, IL	2011	NA	17415	15589	1826	10.5
CN1705900000000	17	059	Gallatin County, IL	2011	NA	2576	2347	229	8.9
CN1706100000000	17	061	Greene County, IL	2011	NA	6702	6116	586	8.7
CN1706300000000	17	063	Grundy County, IL	2011	NA	25753	22471	3282	12.7
CN1706500000000	17	065	Hamilton County, IL	2011	NA	3913	3575	338	8.6
CN1706700000000	17	067	Hancock County, IL	2011	NA	9621	8739	882	9.2
CN1706900000000	17	069	Hardin County, IL	2011	NA	1749	1560	189	10.8
CN1707100000000	17	071	Henderson County, IL	2011	NA	3853	3546	307	8
CN1707300000000	17	073	Henry County, IL	2011	NA	26588	24509	2079	7.8
CN1707500000000	17	075	Iroquois County, IL	2011	NA	15637	14192	1445	9.2
CN1707700000000	17	077	Jackson County, IL	2011	NA	29625	27261	2364	8
CN1707900000000	17	079	Jasper County, IL	2011	NA	4999	4607	392	7.8
CN1708100000000	17	081	Jefferson County, IL	2011	NA	18168	16474	1694	9.3
CN1708300000000	17	083	Jersey County, IL	2011	NA	11579	10544	1035	8.9
CN1708500000000	17	085	Jo Daviess County, IL	2011	NA	12126	11166	960	7.9
CN1708700000000	17	087	Johnson County, IL	2011	NA	4390	3876	514	11.7
CN1708900000000	17	089	Kane County, IL	2011	NA	267554	241485	26069	9.7
CN1709100000000	17	091	Kankakee County, IL	2011	NA	55813	49324	6489	11.6
CN1709300000000	17	093	Kendall County, IL	2011	NA	62635	56794	5841	9.3
CN1709500000000	17	095	Knox County, IL	2011	NA	24845	22659	2186	8.8
CN1709700000000	17	097	Lake County, IL	2011	NA	367616	335089	32527	8.8
CN1709900000000	17	099	LaSalle County, IL	2011	NA	60816	54332	6484	10.7
CN1710100000000	17	101	Lawrence County, IL	2011	NA	6571	5872	699	10.6
CN1710300000000	17	103	Lee County, IL	2011	NA	18826	17119	1707	9.1
CN1710500000000	17	105	Livingston County, IL	2011	NA	18830	17242	1588	8.4
CN1710700000000	17	107	Logan County, IL	2011	NA	13693	12629	1064	7.8
CN1710900000000	17	109	McDonough County, IL	2011	NA	15139	13941	1198	7.9
CN1711100000000	17	111	McHenry County, IL	2011	NA	166760	150286	16474	9.9
CN1711300000000	17	113	McLean County, IL	2011	NA	95760	89451	6309	6.6
CN1711500000000	17	115	Macon County, IL	2011	NA	55209	49725	5484	9.9
CN1711700000000	17	117	Macoupin County, IL	2011	NA	24747	22345	2402	9.7
CN1711900000000	17	119	Madison County, IL	2011	NA	137685	125360	12325	9
CN1712100000000	17	121	Marion County, IL	2011	NA	19108	17196	1912	10
CN1712300000000	17	123	Marshall County, IL	2011	NA	6338	5775	563	8.9
CN1712500000000	17	125	Mason County, IL	2011	NA	7166	6404	762	10.6
CN1712700000000	17	127	Massac County, IL	2011	NA	7115	6486	629	8.8
CN1712900000000	17	129	Menard County, IL	2011	NA	7039	6524	515	7.3
CN1713100000000	17	131	Mercer County, IL	2011	NA	8864	8126	738	8.3
CN1713300000000	17	133	Monroe County, IL	2011	NA	18112	16893	1219	6.7
CN1713500000000	17	135	Montgomery County, IL	2011	NA	13628	12007	1621	11.9
CN1713700000000	17	137	Morgan County, IL	2011	NA	18086	16630	1456	8.1
CN1713900000000	17	139	Moultrie County, IL	2011	NA	7463	6895	568	7.6
CN1714100000000	17	141	Ogle County, IL	2011	NA	27406	24271	3135	11.4
CN1714300000000	17	143	Peoria County, IL	2011	NA	96121	87255	8866	9.2
CN1714500000000	17	145	Perry County, IL	2011	NA	9459	8496	963	10.2
CN1714700000000	17	147	Piatt County, IL	2011	NA	9016	8392	624	6.9
CN1714900000000	17	149	Pike County, IL	2011	NA	7912	7277	635	8
CN1715100000000	17	151	Pope County, IL	2011	NA	1971	1796	175	8.9
CN1715300000000	17	153	Pulaski County, IL	2011	NA	2357	2075	282	12
CN1715500000000	17	155	Putnam County, IL	2011	NA	3197	2869	328	10.3
CN1715700000000	17	157	Randolph County, IL	2011	NA	14793	13573	1220	8.2
CN1715900000000	17	159	Richland County, IL	2011	NA	7803	7160	643	8.2
CN1716100000000	17	161	Rock Island County, IL	2011	NA	76240	69764	6476	8.5
CN1716300000000	17	163	St. Clair County, IL	2011	NA	132755	119842	12913	9.7
CN1716500000000	17	165	Saline County, IL	2011	NA	11649	10542	1107	9.5
CN1716700000000	17	167	Sangamon County, IL	2011	NA	107360	99276	8084	7.5
CN1716900000000	17	169	Schuyler County, IL	2011	NA	3768	3466	302	8
CN1717100000000	17	171	Scott County, IL	2011	NA	2842	2608	234	8.2
CN1717300000000	17	173	Shelby County, IL	2011	NA	11026	10024	1002	9.1
CN1717500000000	17	175	Stark County, IL	2011	NA	2971	2711	260	8.8
CN1717700000000	17	177	Stephenson County, IL	2011	NA	24188	21823	2365	9.8
CN1717900000000	17	179	Tazewell County, IL	2011	NA	71490	65548	5942	8.3
CN1718100000000	17	181	Union County, IL	2011	NA	7753	6851	902	11.6
CN1718300000000	17	183	Vermilion County, IL	2011	NA	37392	33670	3722	10
CN1718500000000	17	185	Wabash County, IL	2011	NA	5808	5292	516	8.9
CN1718700000000	17	187	Warren County, IL	2011	NA	9124	8464	660	7.2
CN1718900000000	17	189	Washington County, IL	2011	NA	8712	8138	574	6.6
CN1719100000000	17	191	Wayne County, IL	2011	NA	8203	7546	657	8
CN1719300000000	17	193	White County, IL	2011	NA	7420	6834	586	7.9
CN1719500000000	17	195	Whiteside County, IL	2011	NA	29650	26844	2806	9.5
CN1719700000000	17	197	Will County, IL	2011	NA	354428	316756	37672	10.6
CN1719900000000	17	199	Williamson County, IL	2011	NA	32306	29385	2921	9
CN1720100000000	17	201	Winnebago County, IL	2011	NA	147177	129688	17489	11.9
CN1720300000000	17	203	Woodford County, IL	2011	NA	20489	19167	1322	6.5
CN1800100000000	18	001	Adams County, IN	2011	NA	16154	14891	1263	7.8
CN1800300000000	18	003	Allen County, IN	2011	NA	176122	159785	16337	9.3
CN1800500000000	18	005	Bartholomew County, IN	2011	NA	40024	36981	3043	7.6
CN1800700000000	18	007	Benton County, IN	2011	NA	4644	4277	367	7.9
CN1800900000000	18	009	Blackford County, IN	2011	NA	5623	4932	691	12.3
CN1801100000000	18	011	Boone County, IN	2011	NA	29815	27812	2003	6.7
CN1801300000000	18	013	Brown County, IN	2011	NA	7430	6746	684	9.2
CN1801500000000	18	015	Carroll County, IN	2011	NA	10125	9282	843	8.3
CN1801700000000	18	017	Cass County, IN	2011	NA	18181	16467	1714	9.4
CN1801900000000	18	019	Clark County, IN	2011	NA	55550	50606	4944	8.9
CN1802100000000	18	021	Clay County, IN	2011	NA	12995	11646	1349	10.4
CN1802300000000	18	023	Clinton County, IN	2011	NA	16748	15304	1444	8.6
CN1802500000000	18	025	Crawford County, IN	2011	NA	4866	4289	577	11.9
CN1802700000000	18	027	Daviess County, IN	2011	NA	14887	13978	909	6.1
CN1802900000000	18	029	Dearborn County, IN	2011	NA	25339	22898	2441	9.6
CN1803100000000	18	031	Decatur County, IN	2011	NA	13013	11740	1273	9.8
CN1803300000000	18	033	DeKalb County, IN	2011	NA	20488	18501	1987	9.7
CN1803500000000	18	035	Delaware County, IN	2011	NA	54650	49103	5547	10.2
CN1803700000000	18	037	Dubois County, IN	2011	NA	21938	20606	1332	6.1
CN1803900000000	18	039	Elkhart County, IN	2011	NA	95376	85122	10254	10.8
CN1804100000000	18	041	Fayette County, IN	2011	NA	9512	8317	1195	12.6
CN1804300000000	18	043	Floyd County, IN	2011	NA	37766	34752	3014	8
CN1804500000000	18	045	Fountain County, IN	2011	NA	8624	7796	828	9.6
CN1804700000000	18	047	Franklin County, IN	2011	NA	11221	10094	1127	10
CN1804900000000	18	049	Fulton County, IN	2011	NA	10200	9258	942	9.2
CN1805100000000	18	051	Gibson County, IN	2011	NA	17282	16015	1267	7.3
CN1805300000000	18	053	Grant County, IN	2011	NA	33438	29968	3470	10.4
CN1805500000000	18	055	Greene County, IN	2011	NA	14179	12709	1470	10.4
CN1805700000000	18	057	Hamilton County, IN	2011	NA	148120	139511	8609	5.8
CN1805900000000	18	059	Hancock County, IN	2011	NA	35797	32847	2950	8.2
CN1806100000000	18	061	Harrison County, IN	2011	NA	18773	17095	1678	8.9
CN1806300000000	18	063	Hendricks County, IN	2011	NA	76017	70712	5305	7
CN1806500000000	18	065	Henry County, IN	2011	NA	21288	18838	2450	11.5
CN1806700000000	18	067	Howard County, IN	2011	NA	36051	32289	3762	10.4
CN1806900000000	18	069	Huntington County, IN	2011	NA	19150	17270	1880	9.8
CN1807100000000	18	071	Jackson County, IN	2011	NA	20549	18752	1797	8.7
CN1807300000000	18	073	Jasper County, IN	2011	NA	16095	14635	1460	9.1
CN1807500000000	18	075	Jay County, IN	2011	NA	10528	9583	945	9
CN1807700000000	18	077	Jefferson County, IN	2011	NA	15170	13687	1483	9.8
CN1807900000000	18	079	Jennings County, IN	2011	NA	13340	11803	1537	11.5
CN1808100000000	18	081	Johnson County, IN	2011	NA	72052	66469	5583	7.7
CN1808300000000	18	083	Knox County, IN	2011	NA	18459	17084	1375	7.4
CN1808500000000	18	085	Kosciusko County, IN	2011	NA	38972	35490	3482	8.9
CN1808700000000	18	087	LaGrange County, IN	2011	NA	16665	15167	1498	9
CN1808900000000	18	089	Lake County, IN	2011	NA	229337	207371	21966	9.6
CN1809100000000	18	091	LaPorte County, IN	2011	NA	50456	45218	5238	10.4
CN1809300000000	18	093	Lawrence County, IN	2011	NA	20791	18375	2416	11.6
CN1809500000000	18	095	Madison County, IN	2011	NA	58819	52409	6410	10.9
CN1809700000000	18	097	Marion County, IN	2011	NA	456011	410958	45053	9.9
CN1809900000000	18	099	Marshall County, IN	2011	NA	23452	21230	2222	9.5
CN1810100000000	18	101	Martin County, IN	2011	NA	5344	4943	401	7.5
CN1810300000000	18	103	Miami County, IN	2011	NA	15937	14272	1665	10.4
CN1810500000000	18	105	Monroe County, IN	2011	NA	67561	62473	5088	7.5
CN1810700000000	18	107	Montgomery County, IN	2011	NA	18713	17054	1659	8.9
CN1810900000000	18	109	Morgan County, IN	2011	NA	34902	31637	3265	9.4
CN1811100000000	18	111	Newton County, IN	2011	NA	6990	6300	690	9.9
CN1811300000000	18	113	Noble County, IN	2011	NA	23132	20801	2331	10.1
CN1811500000000	18	115	Ohio County, IN	2011	NA	3210	2905	305	9.5
CN1811700000000	18	117	Orange County, IN	2011	NA	8865	7816	1049	11.8
CN1811900000000	18	119	Owen County, IN	2011	NA	10137	8999	1138	11.2
CN1812100000000	18	121	Parke County, IN	2011	NA	7195	6443	752	10.5
CN1812300000000	18	123	Perry County, IN	2011	NA	9062	8237	825	9.1
CN1812500000000	18	125	Pike County, IN	2011	NA	6231	5744	487	7.8
CN1812700000000	18	127	Porter County, IN	2011	NA	82289	75567	6722	8.2
CN1812900000000	18	129	Posey County, IN	2011	NA	13421	12498	923	6.9
CN1813100000000	18	131	Pulaski County, IN	2011	NA	6401	5884	517	8.1
CN1813300000000	18	133	Putnam County, IN	2011	NA	16596	14799	1797	10.8
CN1813500000000	18	135	Randolph County, IN	2011	NA	13023	11672	1351	10.4
CN1813700000000	18	137	Ripley County, IN	2011	NA	14938	13526	1412	9.5
CN1813900000000	18	139	Rush County, IN	2011	NA	8584	7766	818	9.5
CN1814100000000	18	141	St. Joseph County, IN	2011	NA	130604	117384	13220	10.1
CN1814300000000	18	143	Scott County, IN	2011	NA	10378	9146	1232	11.9
CN1814500000000	18	145	Shelby County, IN	2011	NA	22512	20380	2132	9.5
CN1814700000000	18	147	Spencer County, IN	2011	NA	11031	10185	846	7.7
CN1814900000000	18	149	Starke County, IN	2011	NA	10332	9153	1179	11.4
CN1815100000000	18	151	Steuben County, IN	2011	NA	18565	16902	1663	9
CN1815300000000	18	153	Sullivan County, IN	2011	NA	8891	8064	827	9.3
CN1815500000000	18	155	Switzerland County, IN	2011	NA	4987	4580	407	8.2
CN1815700000000	18	157	Tippecanoe County, IN	2011	NA	87455	80922	6533	7.5
CN1815900000000	18	159	Tipton County, IN	2011	NA	7956	7240	716	9
CN1816100000000	18	161	Union County, IN	2011	NA	3667	3343	324	8.8
CN1816300000000	18	163	Vanderburgh County, IN	2011	NA	92759	85341	7418	8
CN1816500000000	18	165	Vermillion County, IN	2011	NA	7647	6749	898	11.7
CN1816700000000	18	167	Vigo County, IN	2011	NA	50514	45310	5204	10.3
CN1816900000000	18	169	Wabash County, IN	2011	NA	15706	14204	1502	9.6
CN1817100000000	18	171	Warren County, IN	2011	NA	4271	3924	347	8.1
CN1817300000000	18	173	Warrick County, IN	2011	NA	31119	28911	2208	7.1
CN1817500000000	18	175	Washington County, IN	2011	NA	13515	12081	1434	10.6
CN1817700000000	18	177	Wayne County, IN	2011	NA	30992	27547	3445	11.1
CN1817900000000	18	179	Wells County, IN	2011	NA	14049	12892	1157	8.2
CN1818100000000	18	181	White County, IN	2011	NA	13108	11974	1134	8.7
CN1818300000000	18	183	Whitley County, IN	2011	NA	17325	15709	1616	9.3
CN1900100000000	19	001	Adair County, IA	2011	NA	4095	3896	199	4.9
CN1900300000000	19	003	Adams County, IA	2011	NA	2208	2110	98	4.4
CN1900500000000	19	005	Allamakee County, IA	2011	NA	7743	7187	556	7.2
CN1900700000000	19	007	Appanoose County, IA	2011	NA	6051	5632	419	6.9
CN1900900000000	19	009	Audubon County, IA	2011	NA	3362	3169	193	5.7
CN1901100000000	19	011	Benton County, IA	2011	NA	14115	13296	819	5.8
CN1901300000000	19	013	Black Hawk County, IA	2011	NA	70903	66768	4135	5.8
CN1901500000000	19	015	Boone County, IA	2011	NA	14654	13927	727	5
CN1901700000000	19	017	Bremer County, IA	2011	NA	13839	13235	604	4.4
CN1901900000000	19	019	Buchanan County, IA	2011	NA	11164	10532	632	5.7
CN1902100000000	19	021	Buena Vista County, IA	2011	NA	11335	10824	511	4.5
CN1902300000000	19	023	Butler County, IA	2011	NA	8170	7759	411	5
CN1902500000000	19	025	Calhoun County, IA	2011	NA	4508	4251	257	5.7
CN1902700000000	19	027	Carroll County, IA	2011	NA	11608	11140	468	4
CN1902900000000	19	029	Cass County, IA	2011	NA	7287	6853	434	6
CN1903100000000	19	031	Cedar County, IA	2011	NA	10871	10310	561	5.2
CN1903300000000	19	033	Cerro Gordo County, IA	2011	NA	24155	22674	1481	6.1
CN1903500000000	19	035	Cherokee County, IA	2011	NA	6934	6605	329	4.7
CN1903700000000	19	037	Chickasaw County, IA	2011	NA	6488	6082	406	6.3
CN1903900000000	19	039	Clarke County, IA	2011	NA	4685	4356	329	7
CN1904100000000	19	041	Clay County, IA	2011	NA	9250	8747	503	5.4
CN1904300000000	19	043	Clayton County, IA	2011	NA	10339	9700	639	6.2
CN1904500000000	19	045	Clinton County, IA	2011	NA	25849	24139	1710	6.6
CN1904700000000	19	047	Crawford County, IA	2011	NA	8816	8399	417	4.7
CN1904900000000	19	049	Dallas County, IA	2011	NA	38207	36576	1631	4.3
CN1905100000000	19	051	Davis County, IA	2011	NA	4186	3931	255	6.1
CN1905300000000	19	053	Decatur County, IA	2011	NA	4342	4125	217	5
CN1905500000000	19	055	Delaware County, IA	2011	NA	10249	9690	559	5.5
CN1905700000000	19	057	Des Moines County, IA	2011	NA	20300	18931	1369	6.7
CN1905900000000	19	059	Dickinson County, IA	2011	NA	9254	8671	583	6.3
CN1906100000000	19	061	Dubuque County, IA	2011	NA	54366	51618	2748	5.1
CN1906300000000	19	063	Emmet County, IA	2011	NA	5786	5462	324	5.6
CN1906500000000	19	065	Fayette County, IA	2011	NA	11037	10351	686	6.2
CN1906700000000	19	067	Floyd County, IA	2011	NA	8289	7752	537	6.5
CN1906900000000	19	069	Franklin County, IA	2011	NA	5969	5663	306	5.1
CN1907100000000	19	071	Fremont County, IA	2011	NA	3966	3737	229	5.8
CN1907300000000	19	073	Greene County, IA	2011	NA	5187	4897	290	5.6
CN1907500000000	19	075	Grundy County, IA	2011	NA	6701	6367	334	5
CN1907700000000	19	077	Guthrie County, IA	2011	NA	5689	5341	348	6.1
CN1907900000000	19	079	Hamilton County, IA	2011	NA	7467	6810	657	8.8
CN1908100000000	19	081	Hancock County, IA	2011	NA	5936	5604	332	5.6
CN1908300000000	19	083	Hardin County, IA	2011	NA	8984	8456	528	5.9
CN1908500000000	19	085	Harrison County, IA	2011	NA	7816	7383	433	5.5
CN1908700000000	19	087	Henry County, IA	2011	NA	9827	9159	668	6.8
CN1908900000000	19	089	Howard County, IA	2011	NA	5319	5035	284	5.3
CN1909100000000	19	091	Humboldt County, IA	2011	NA	5169	4909	260	5
CN1909300000000	19	093	Ida County, IA	2011	NA	3792	3608	184	4.9
CN1909500000000	19	095	Iowa County, IA	2011	NA	9606	9125	481	5
CN1909700000000	19	097	Jackson County, IA	2011	NA	10988	10274	714	6.5
CN1909900000000	19	099	Jasper County, IA	2011	NA	18601	17355	1246	6.7
CN1910100000000	19	101	Jefferson County, IA	2011	NA	8814	8286	528	6
CN1910300000000	19	103	Johnson County, IA	2011	NA	79653	76439	3214	4
CN1910500000000	19	105	Jones County, IA	2011	NA	10912	10278	634	5.8
CN1910700000000	19	107	Keokuk County, IA	2011	NA	5470	5135	335	6.1
CN1910900000000	19	109	Kossuth County, IA	2011	NA	8352	7988	364	4.4
CN1911100000000	19	111	Lee County, IA	2011	NA	17436	16016	1420	8.1
CN1911300000000	19	113	Linn County, IA	2011	NA	119353	112574	6779	5.7
CN1911500000000	19	115	Louisa County, IA	2011	NA	5904	5544	360	6.1
CN1911700000000	19	117	Lucas County, IA	2011	NA	4184	3963	221	5.3
CN1911900000000	19	119	Lyon County, IA	2011	NA	6774	6563	211	3.1
CN1912100000000	19	121	Madison County, IA	2011	NA	8272	7779	493	6
CN1912300000000	19	123	Mahaska County, IA	2011	NA	11831	11141	690	5.8
CN1912500000000	19	125	Marion County, IA	2011	NA	17159	16225	934	5.4
CN1912700000000	19	127	Marshall County, IA	2011	NA	20043	18725	1318	6.6
CN1912900000000	19	129	Mills County, IA	2011	NA	7445	7077	368	4.9
CN1913100000000	19	131	Mitchell County, IA	2011	NA	5651	5383	268	4.7
CN1913300000000	19	133	Monona County, IA	2011	NA	4773	4442	331	6.9
CN1913500000000	19	135	Monroe County, IA	2011	NA	4033	3762	271	6.7
CN1913700000000	19	137	Montgomery County, IA	2011	NA	5033	4738	295	5.9
CN1913900000000	19	139	Muscatine County, IA	2011	NA	21405	19997	1408	6.6
CN1914100000000	19	141	O'Brien County, IA	2011	NA	8102	7763	339	4.2
CN1914300000000	19	143	Osceola County, IA	2011	NA	3526	3369	157	4.5
CN1914500000000	19	145	Page County, IA	2011	NA	6855	6464	391	5.7
CN1914700000000	19	147	Palo Alto County, IA	2011	NA	4773	4549	224	4.7
CN1914900000000	19	149	Plymouth County, IA	2011	NA	14245	13610	635	4.5
CN1915100000000	19	151	Pocahontas County, IA	2011	NA	4080	3901	179	4.4
CN1915300000000	19	153	Polk County, IA	2011	NA	242920	229153	13767	5.7
CN1915500000000	19	155	Pottawattamie County, IA	2011	NA	49527	46759	2768	5.6
CN1915700000000	19	157	Poweshiek County, IA	2011	NA	10393	9814	579	5.6
CN1915900000000	19	159	Ringgold County, IA	2011	NA	2599	2480	119	4.6
CN1916100000000	19	161	Sac County, IA	2011	NA	5616	5368	248	4.4
CN1916300000000	19	163	Scott County, IA	2011	NA	87075	81733	5342	6.1
CN1916500000000	19	165	Shelby County, IA	2011	NA	6715	6425	290	4.3
CN1916700000000	19	167	Sioux County, IA	2011	NA	19525	18806	719	3.7
CN1916900000000	19	169	Story County, IA	2011	NA	53195	51099	2096	3.9
CN1917100000000	19	171	Tama County, IA	2011	NA	9187	8626	561	6.1
CN1917300000000	19	173	Taylor County, IA	2011	NA	3150	3001	149	4.7
CN1917500000000	19	175	Union County, IA	2011	NA	6957	6591	366	5.3
CN1917700000000	19	177	Van Buren County, IA	2011	NA	3848	3605	243	6.3
CN1917900000000	19	179	Wapello County, IA	2011	NA	18114	16818	1296	7.2
CN1918100000000	19	181	Warren County, IA	2011	NA	25946	24601	1345	5.2
CN1918300000000	19	183	Washington County, IA	2011	NA	12310	11733	577	4.7
CN1918500000000	19	185	Wayne County, IA	2011	NA	2823	2667	156	5.5
CN1918700000000	19	187	Webster County, IA	2011	NA	19770	18392	1378	7
CN1918900000000	19	189	Winnebago County, IA	2011	NA	5444	5116	328	6
CN1919100000000	19	191	Winneshiek County, IA	2011	NA	12109	11506	603	5
CN1919300000000	19	193	Woodbury County, IA	2011	NA	54547	51419	3128	5.7
CN1919500000000	19	195	Worth County, IA	2011	NA	4287	4013	274	6.4
CN1919700000000	19	197	Wright County, IA	2011	NA	6786	6321	465	6.9
CN2000100000000	20	001	Allen County, KS	2011	NA	7032	6468	564	8
CN2000300000000	20	003	Anderson County, KS	2011	NA	4490	4148	342	7.6
CN2000500000000	20	005	Atchison County, KS	2011	NA	7926	7209	717	9
CN2000700000000	20	007	Barber County, KS	2011	NA	2778	2667	111	4
CN2000900000000	20	009	Barton County, KS	2011	NA	15036	14252	784	5.2
CN2001100000000	20	011	Bourbon County, KS	2011	NA	6876	6259	617	9
CN2001300000000	20	013	Brown County, KS	2011	NA	5186	4877	309	6
CN2001500000000	20	015	Butler County, KS	2011	NA	32445	30171	2274	7
CN2001700000000	20	017	Chase County, KS	2011	NA	1338	1265	73	5.5
CN2001900000000	20	019	Chautauqua County, KS	2011	NA	1699	1559	140	8.2
CN2002100000000	20	021	Cherokee County, KS	2011	NA	10801	9924	877	8.1
CN2002300000000	20	023	Cheyenne County, KS	2011	NA	1346	1288	58	4.3
CN2002500000000	20	025	Clark County, KS	2011	NA	1211	1165	46	3.8
CN2002700000000	20	027	Clay County, KS	2011	NA	4389	4141	248	5.7
CN2002900000000	20	029	Cloud County, KS	2011	NA	4527	4279	248	5.5
CN2003100000000	20	031	Coffey County, KS	2011	NA	4649	4285	364	7.8
CN2003300000000	20	033	Comanche County, KS	2011	NA	980	937	43	4.4
CN2003500000000	20	035	Cowley County, KS	2011	NA	17096	15896	1200	7
CN2003700000000	20	037	Crawford County, KS	2011	NA	19169	17652	1517	7.9
CN2003900000000	20	039	Decatur County, KS	2011	NA	1415	1347	68	4.8
CN2004100000000	20	041	Dickinson County, KS	2011	NA	10109	9442	667	6.6
CN2004300000000	20	043	Doniphan County, KS	2011	NA	4453	4105	348	7.8
CN2004500000000	20	045	Douglas County, KS	2011	NA	63747	60141	3606	5.7
CN2004700000000	20	047	Edwards County, KS	2011	NA	1664	1589	75	4.5
CN2004900000000	20	049	Elk County, KS	2011	NA	1382	1277	105	7.6
CN2005100000000	20	051	Ellis County, KS	2011	NA	17841	17209	632	3.5
CN2005300000000	20	053	Ellsworth County, KS	2011	NA	3491	3349	142	4.1
CN2005500000000	20	055	Finney County, KS	2011	NA	20743	19857	886	4.3
CN2005700000000	20	057	Ford County, KS	2011	NA	18271	17483	788	4.3
CN2005900000000	20	059	Franklin County, KS	2011	NA	13989	12817	1172	8.4
CN2006100000000	20	061	Geary County, KS	2011	NA	13174	11964	1210	9.2
CN2006300000000	20	063	Gove County, KS	2011	NA	1498	1448	50	3.3
CN2006500000000	20	065	Graham County, KS	2011	NA	1416	1357	59	4.2
CN2006700000000	20	067	Grant County, KS	2011	NA	4104	3932	172	4.2
CN2006900000000	20	069	Gray County, KS	2011	NA	3585	3466	119	3.3
CN2007100000000	20	071	Greeley County, KS	2011	NA	842	816	26	3.1
CN2007300000000	20	073	Greenwood County, KS	2011	NA	3466	3236	230	6.6
CN2007500000000	20	075	Hamilton County, KS	2011	NA	1746	1697	49	2.8
CN2007700000000	20	077	Harper County, KS	2011	NA	2895	2731	164	5.7
CN2007900000000	20	079	Harvey County, KS	2011	NA	17387	16330	1057	6.1
CN2008100000000	20	081	Haskell County, KS	2011	NA	2414	2329	85	3.5
CN2008300000000	20	083	Hodgeman County, KS	2011	NA	1109	1067	42	3.8
CN2008500000000	20	085	Jackson County, KS	2011	NA	7419	6973	446	6
CN2008700000000	20	087	Jefferson County, KS	2011	NA	10450	9707	743	7.1
CN2008900000000	20	089	Jewell County, KS	2011	NA	1528	1456	72	4.7
CN2009100000000	20	091	Johnson County, KS	2011	NA	308303	291774	16529	5.4
CN2009300000000	20	093	Kearny County, KS	2011	NA	2179	2083	96	4.4
CN2009500000000	20	095	Kingman County, KS	2011	NA	3823	3579	244	6.4
CN2009700000000	20	097	Kiowa County, KS	2011	NA	1344	1287	57	4.2
CN2009900000000	20	099	Labette County, KS	2011	NA	11038	10039	999	9.1
CN2010100000000	20	101	Lane County, KS	2011	NA	959	915	44	4.6
CN2010300000000	20	103	Leavenworth County, KS	2011	NA	34425	31917	2508	7.3
CN2010500000000	20	105	Lincoln County, KS	2011	NA	1877	1780	97	5.2
CN2010700000000	20	107	Linn County, KS	2011	NA	4501	3999	502	11.2
CN2010900000000	20	109	Logan County, KS	2011	NA	1774	1716	58	3.3
CN2011100000000	20	111	Lyon County, KS	2011	NA	17333	16222	1111	6.4
CN2011300000000	20	113	McPherson County, KS	2011	NA	16652	15892	760	4.6
CN2011500000000	20	115	Marion County, KS	2011	NA	6471	6104	367	5.7
CN2011700000000	20	117	Marshall County, KS	2011	NA	5992	5713	279	4.7
CN2011900000000	20	119	Meade County, KS	2011	NA	2534	2440	94	3.7
CN2012100000000	20	121	Miami County, KS	2011	NA	16914	15696	1218	7.2
CN2012300000000	20	123	Mitchell County, KS	2011	NA	3893	3753	140	3.6
CN2012500000000	20	125	Montgomery County, KS	2011	NA	18272	16458	1814	9.9
CN2012700000000	20	127	Morris County, KS	2011	NA	3289	3069	220	6.7
CN2012900000000	20	129	Morton County, KS	2011	NA	1674	1612	62	3.7
CN2013100000000	20	131	Nemaha County, KS	2011	NA	5900	5672	228	3.9
CN2013300000000	20	133	Neosho County, KS	2011	NA	7400	6713	687	9.3
CN2013500000000	20	135	Ness County, KS	2011	NA	1623	1568	55	3.4
CN2013700000000	20	137	Norton County, KS	2011	NA	3138	3028	110	3.5
CN2013900000000	20	139	Osage County, KS	2011	NA	8568	7857	711	8.3
CN2014100000000	20	141	Osborne County, KS	2011	NA	2261	2160	101	4.5
CN2014300000000	20	143	Ottawa County, KS	2011	NA	3270	3082	188	5.7
CN2014500000000	20	145	Pawnee County, KS	2011	NA	3481	3322	159	4.6
CN2014700000000	20	147	Phillips County, KS	2011	NA	3019	2866	153	5.1
CN2014900000000	20	149	Pottawatomie County, KS	2011	NA	11564	10986	578	5
CN2015100000000	20	151	Pratt County, KS	2011	NA	5362	5091	271	5.1
CN2015300000000	20	153	Rawlins County, KS	2011	NA	1518	1465	53	3.5
CN2015500000000	20	155	Reno County, KS	2011	NA	32636	30664	1972	6
CN2015700000000	20	157	Republic County, KS	2011	NA	2683	2580	103	3.8
CN2015900000000	20	159	Rice County, KS	2011	NA	5388	5109	279	5.2
CN2016100000000	20	161	Riley County, KS	2011	NA	35427	33724	1703	4.8
CN2016300000000	20	163	Rooks County, KS	2011	NA	2726	2581	145	5.3
CN2016500000000	20	165	Rush County, KS	2011	NA	1841	1760	81	4.4
CN2016700000000	20	167	Russell County, KS	2011	NA	3784	3607	177	4.7
CN2016900000000	20	169	Saline County, KS	2011	NA	30761	28891	1870	6.1
CN2017100000000	20	171	Scott County, KS	2011	NA	2725	2623	102	3.7
CN2017300000000	20	173	Sedgwick County, KS	2011	NA	249217	229352	19865	8
CN2017500000000	20	175	Seward County, KS	2011	NA	10820	10321	499	4.6
CN2017700000000	20	177	Shawnee County, KS	2011	NA	92932	86630	6302	6.8
CN2017900000000	20	179	Sheridan County, KS	2011	NA	1526	1477	49	3.2
CN2018100000000	20	181	Sherman County, KS	2011	NA	3205	3076	129	4
CN2018300000000	20	183	Smith County, KS	2011	NA	2265	2174	91	4
CN2018500000000	20	185	Stafford County, KS	2011	NA	2317	2198	119	5.1
CN2018700000000	20	187	Stanton County, KS	2011	NA	1064	1021	43	4
CN2018900000000	20	189	Stevens County, KS	2011	NA	2765	2653	112	4.1
CN2019100000000	20	191	Sumner County, KS	2011	NA	11573	10687	886	7.7
CN2019300000000	20	193	Thomas County, KS	2011	NA	4600	4431	169	3.7
CN2019500000000	20	195	Trego County, KS	2011	NA	1494	1424	70	4.7
CN2019700000000	20	197	Wabaunsee County, KS	2011	NA	3837	3597	240	6.3
CN2019900000000	20	199	Wallace County, KS	2011	NA	882	834	48	5.4
CN2020100000000	20	201	Washington County, KS	2011	NA	3309	3158	151	4.6
CN2020300000000	20	203	Wichita County, KS	2011	NA	1329	1278	51	3.8
CN2020500000000	20	205	Wilson County, KS	2011	NA	4270	3782	488	11.4
CN2020700000000	20	207	Woodson County, KS	2011	NA	1718	1602	116	6.8
CN2020900000000	20	209	Wyandotte County, KS	2011	NA	74544	67430	7114	9.5
CN2100100000000	21	001	Adair County, KY	2011	NA	7747	6834	913	11.8
CN2100300000000	21	003	Allen County, KY	2011	NA	9111	8215	896	9.8
CN2100500000000	21	005	Anderson County, KY	2011	NA	11567	10603	964	8.3
CN2100700000000	21	007	Ballard County, KY	2011	NA	3884	3497	387	10
CN2100900000000	21	009	Barren County, KY	2011	NA	19890	17940	1950	9.8
CN2101100000000	21	011	Bath County, KY	2011	NA	4835	4224	611	12.6
CN2101300000000	21	013	Bell County, KY	2011	NA	10190	8976	1214	11.9
CN2101500000000	21	015	Boone County, KY	2011	NA	64221	59178	5043	7.9
CN2101700000000	21	017	Bourbon County, KY	2011	NA	10046	9198	848	8.4
CN2101900000000	21	019	Boyd County, KY	2011	NA	20244	18162	2082	10.3
CN2102100000000	21	021	Boyle County, KY	2011	NA	13157	11743	1414	10.7
CN2102300000000	21	023	Bracken County, KY	2011	NA	3981	3553	428	10.8
CN2102500000000	21	025	Breathitt County, KY	2011	NA	4410	3847	563	12.8
CN2102700000000	21	027	Breckinridge County, KY	2011	NA	8280	7323	957	11.6
CN2102900000000	21	029	Bullitt County, KY	2011	NA	38954	35079	3875	9.9
CN2103100000000	21	031	Butler County, KY	2011	NA	5452	4867	585	10.7
CN2103300000000	21	033	Caldwell County, KY	2011	NA	5695	5149	546	9.6
CN2103500000000	21	035	Calloway County, KY	2011	NA	19019	17593	1426	7.5
CN2103700000000	21	037	Campbell County, KY	2011	NA	48811	44758	4053	8.3
CN2103900000000	21	039	Carlisle County, KY	2011	NA	2305	2101	204	8.9
CN2104100000000	21	041	Carroll County, KY	2011	NA	5110	4487	623	12.2
CN2104300000000	21	043	Carter County, KY	2011	NA	11696	10079	1617	13.8
CN2104500000000	21	045	Casey County, KY	2011	NA	6980	6283	697	10
CN2104700000000	21	047	Christian County, KY	2011	NA	26810	23916	2894	10.8
CN2104900000000	21	049	Clark County, KY	2011	NA	17537	15804	1733	9.9
CN2105100000000	21	051	Clay County, KY	2011	NA	6052	5142	910	15
CN2105300000000	21	053	Clinton County, KY	2011	NA	4281	3794	487	11.4
CN2105500000000	21	055	Crittenden County, KY	2011	NA	4174	3819	355	8.5
CN2105700000000	21	057	Cumberland County, KY	2011	NA	3118	2775	343	11
CN2105900000000	21	059	Daviess County, KY	2011	NA	47742	43754	3988	8.4
CN2106100000000	21	061	Edmonson County, KY	2011	NA	5122	4523	599	11.7
CN2106300000000	21	063	Elliott County, KY	2011	NA	2331	1963	368	15.8
CN2106500000000	21	065	Estill County, KY	2011	NA	5607	4910	697	12.4
CN2106700000000	21	067	Fayette County, KY	2011	NA	164926	153602	11324	6.9
CN2106900000000	21	069	Fleming County, KY	2011	NA	6466	5779	687	10.6
CN2107100000000	21	071	Floyd County, KY	2011	NA	13716	12183	1533	11.2
CN2107300000000	21	073	Franklin County, KY	2011	NA	24611	22664	1947	7.9
CN2107500000000	21	075	Fulton County, KY	2011	NA	2659	2327	332	12.5
CN2107700000000	21	077	Gallatin County, KY	2011	NA	4004	3574	430	10.7
CN2107900000000	21	079	Garrard County, KY	2011	NA	7810	7026	784	10
CN2108100000000	21	081	Grant County, KY	2011	NA	11623	10385	1238	10.7
CN2108300000000	21	083	Graves County, KY	2011	NA	16903	15367	1536	9.1
CN2108500000000	21	085	Grayson County, KY	2011	NA	11397	9999	1398	12.3
CN2108700000000	21	087	Green County, KY	2011	NA	5452	4925	527	9.7
CN2108900000000	21	089	Greenup County, KY	2011	NA	15208	13502	1706	11.2
CN2109100000000	21	091	Hancock County, KY	2011	NA	4080	3738	342	8.4
CN2109300000000	21	093	Hardin County, KY	2011	NA	47443	43077	4366	9.2
CN2109500000000	21	095	Harlan County, KY	2011	NA	10025	8904	1121	11.2
CN2109700000000	21	097	Harrison County, KY	2011	NA	8950	8050	900	10.1
CN2109900000000	21	099	Hart County, KY	2011	NA	8196	7387	809	9.9
CN2110100000000	21	101	Henderson County, KY	2011	NA	22865	20810	2055	9
CN2110300000000	21	103	Henry County, KY	2011	NA	7752	7070	682	8.8
CN2110500000000	21	105	Hickman County, KY	2011	NA	2282	2078	204	8.9
CN2110700000000	21	107	Hopkins County, KY	2011	NA	21545	19720	1825	8.5
CN2110900000000	21	109	Jackson County, KY	2011	NA	5294	4576	718	13.6
CN2111100000000	21	111	Jefferson County, KY	2011	NA	378781	342935	35846	9.5
CN2111300000000	21	113	Jessamine County, KY	2011	NA	24650	22732	1918	7.8
CN2111500000000	21	115	Johnson County, KY	2011	NA	8691	7747	944	10.9
CN2111700000000	21	117	Kenton County, KY	2011	NA	83780	76372	7408	8.8
CN2111900000000	21	119	Knott County, KY	2011	NA	5849	5157	692	11.8
CN2112100000000	21	121	Knox County, KY	2011	NA	10634	9220	1414	13.3
CN2112300000000	21	123	Larue County, KY	2011	NA	6046	5441	605	10
CN2112500000000	21	125	Laurel County, KY	2011	NA	24978	22114	2864	11.5
CN2112700000000	21	127	Lawrence County, KY	2011	NA	5774	5097	677	11.7
CN2112900000000	21	129	Lee County, KY	2011	NA	2512	2195	317	12.6
CN2113100000000	21	131	Leslie County, KY	2011	NA	3632	3173	459	12.6
CN2113300000000	21	133	Letcher County, KY	2011	NA	8883	7974	909	10.2
CN2113500000000	21	135	Lewis County, KY	2011	NA	5517	4799	718	13
CN2113700000000	21	137	Lincoln County, KY	2011	NA	10405	9129	1276	12.3
CN2113900000000	21	139	Livingston County, KY	2011	NA	4024	3583	441	11
CN2114100000000	21	141	Logan County, KY	2011	NA	12440	11327	1113	8.9
CN2114300000000	21	143	Lyon County, KY	2011	NA	3078	2759	319	10.4
CN2114500000000	21	145	McCracken County, KY	2011	NA	30974	28299	2675	8.6
CN2114700000000	21	147	McCreary County, KY	2011	NA	5690	4858	832	14.6
CN2114900000000	21	149	McLean County, KY	2011	NA	4564	4159	405	8.9
CN2115100000000	21	151	Madison County, KY	2011	NA	44056	40587	3469	7.9
CN2115300000000	21	153	Magoffin County, KY	2011	NA	4150	3439	711	17.1
CN2115500000000	21	155	Marion County, KY	2011	NA	9200	8203	997	10.8
CN2115700000000	21	157	Marshall County, KY	2011	NA	15441	14012	1429	9.3
CN2115900000000	21	159	Martin County, KY	2011	NA	3870	3522	348	9
CN2116100000000	21	161	Mason County, KY	2011	NA	7660	6871	789	10.3
CN2116300000000	21	163	Meade County, KY	2011	NA	12815	11370	1445	11.3
CN2116500000000	21	165	Menifee County, KY	2011	NA	2543	2185	358	14.1
CN2116700000000	21	167	Mercer County, KY	2011	NA	10234	9173	1061	10.4
CN2116900000000	21	169	Metcalfe County, KY	2011	NA	4611	4093	518	11.2
CN2117100000000	21	171	Monroe County, KY	2011	NA	4834	4398	436	9
CN2117300000000	21	173	Montgomery County, KY	2011	NA	12080	10727	1353	11.2
CN2117500000000	21	175	Morgan County, KY	2011	NA	5232	4656	576	11
CN2117700000000	21	177	Muhlenberg County, KY	2011	NA	12942	11614	1328	10.3
CN2117900000000	21	179	Nelson County, KY	2011	NA	21806	19488	2318	10.6
CN2118100000000	21	181	Nicholas County, KY	2011	NA	3585	3260	325	9.1
CN2118300000000	21	183	Ohio County, KY	2011	NA	10352	9332	1020	9.9
CN2118500000000	21	185	Oldham County, KY	2011	NA	29260	27225	2035	7
CN2118700000000	21	187	Owen County, KY	2011	NA	5701	5266	435	7.6
CN2118900000000	21	189	Owsley County, KY	2011	NA	1389	1206	183	13.2
CN2119100000000	21	191	Pendleton County, KY	2011	NA	7201	6421	780	10.8
CN2119300000000	21	193	Perry County, KY	2011	NA	11020	9875	1145	10.4
CN2119500000000	21	195	Pike County, KY	2011	NA	24323	22094	2229	9.2
CN2119700000000	21	197	Powell County, KY	2011	NA	5153	4487	666	12.9
CN2119900000000	21	199	Pulaski County, KY	2011	NA	27525	24591	2934	10.7
CN2120100000000	21	201	Robertson County, KY	2011	NA	859	763	96	11.2
CN2120300000000	21	203	Rockcastle County, KY	2011	NA	7193	6369	824	11.5
CN2120500000000	21	205	Rowan County, KY	2011	NA	11237	10168	1069	9.5
CN2120700000000	21	207	Russell County, KY	2011	NA	7350	6488	862	11.7
CN2120900000000	21	209	Scott County, KY	2011	NA	25543	23511	2032	8
CN2121100000000	21	211	Shelby County, KY	2011	NA	21968	20222	1746	7.9
CN2121300000000	21	213	Simpson County, KY	2011	NA	8612	7662	950	11
CN2121500000000	21	215	Spencer County, KY	2011	NA	9248	8411	837	9.1
CN2121700000000	21	217	Taylor County, KY	2011	NA	11925	10634	1291	10.8
CN2121900000000	21	219	Todd County, KY	2011	NA	5708	5210	498	8.7
CN2122100000000	21	221	Trigg County, KY	2011	NA	6190	5487	703	11.4
CN2122300000000	21	223	Trimble County, KY	2011	NA	4016	3559	457	11.4
CN2122500000000	21	225	Union County, KY	2011	NA	7598	6914	684	9
CN2122700000000	21	227	Warren County, KY	2011	NA	58969	54095	4874	8.3
CN2122900000000	21	229	Washington County, KY	2011	NA	6125	5557	568	9.3
CN2123100000000	21	231	Wayne County, KY	2011	NA	7888	6763	1125	14.3
CN2123300000000	21	233	Webster County, KY	2011	NA	6212	5713	499	8
CN2123500000000	21	235	Whitley County, KY	2011	NA	13901	12228	1673	12
CN2123700000000	21	237	Wolfe County, KY	2011	NA	2104	1791	313	14.9
CN2123900000000	21	239	Woodford County, KY	2011	NA	14326	13393	933	6.5
CN2200100000000	22	001	Acadia Parish, LA	2011	NA	25791	24068	1723	6.7
CN2200300000000	22	003	Allen Parish, LA	2011	NA	9214	8375	839	9.1
CN2200500000000	22	005	Ascension Parish, LA	2011	NA	53941	50141	3800	7
CN2200700000000	22	007	Assumption Parish, LA	2011	NA	9974	8770	1204	12.1
CN2200900000000	22	009	Avoyelles Parish, LA	2011	NA	16638	15240	1398	8.4
CN2201100000000	22	011	Beauregard Parish, LA	2011	NA	14269	13098	1171	8.2
CN2201300000000	22	013	Bienville Parish, LA	2011	NA	5860	5266	594	10.1
CN2201500000000	22	015	Bossier Parish, LA	2011	NA	56901	53561	3340	5.9
CN2201700000000	22	017	Caddo Parish, LA	2011	NA	115609	106425	9184	7.9
CN2201900000000	22	019	Calcasieu Parish, LA	2011	NA	87010	80317	6693	7.7
CN2202100000000	22	021	Caldwell Parish, LA	2011	NA	4103	3693	410	10
CN2202300000000	22	023	Cameron Parish, LA	2011	NA	3250	3063	187	5.8
CN2202500000000	22	025	Catahoula Parish, LA	2011	NA	4060	3641	419	10.3
CN2202700000000	22	027	Claiborne Parish, LA	2011	NA	6866	6295	571	8.3
CN2202900000000	22	029	Concordia Parish, LA	2011	NA	7813	7063	750	9.6
CN2203100000000	22	031	De Soto Parish, LA	2011	NA	11228	10278	950	8.5
CN2203300000000	22	033	East Baton Rouge Parish, LA	2011	NA	221086	204338	16748	7.6
CN2203500000000	22	035	East Carroll Parish, LA	2011	NA	2342	1918	424	18.1
CN2203700000000	22	037	East Feliciana Parish, LA	2011	NA	8049	7366	683	8.5
CN2203900000000	22	039	Evangeline Parish, LA	2011	NA	13026	11930	1096	8.4
CN2204100000000	22	041	Franklin Parish, LA	2011	NA	7961	7032	929	11.7
CN2204300000000	22	043	Grant Parish, LA	2011	NA	8358	7655	703	8.4
CN2204500000000	22	045	Iberia Parish, LA	2011	NA	31877	29358	2519	7.9
CN2204700000000	22	047	Iberville Parish, LA	2011	NA	13976	12529	1447	10.4
CN2204900000000	22	049	Jackson Parish, LA	2011	NA	6945	6431	514	7.4
CN2205100000000	22	051	Jefferson Parish, LA	2011	NA	213027	197665	15362	7.2
CN2205300000000	22	053	Jefferson Davis Parish, LA	2011	NA	12907	11976	931	7.2
CN2205500000000	22	055	Lafayette Parish, LA	2011	NA	113869	107117	6752	5.9
CN2205700000000	22	057	Lafourche Parish, LA	2011	NA	44381	41664	2717	6.1
CN2205900000000	22	059	LaSalle Parish, LA	2011	NA	6689	6306	383	5.7
CN2206100000000	22	061	Lincoln Parish, LA	2011	NA	20086	18229	1857	9.2
CN2206300000000	22	063	Livingston Parish, LA	2011	NA	61455	56967	4488	7.3
CN2206500000000	22	065	Madison Parish, LA	2011	NA	3980	3476	504	12.7
CN2206700000000	22	067	Morehouse Parish, LA	2011	NA	11062	9466	1596	14.4
CN2206900000000	22	069	Natchitoches Parish, LA	2011	NA	16143	14652	1491	9.2
CN2207100000000	22	071	Orleans Parish, LA	2011	NA	165726	151413	14313	8.6
CN2207300000000	22	073	Ouachita Parish, LA	2011	NA	69852	64029	5823	8.3
CN2207500000000	22	075	Plaquemines Parish, LA	2011	NA	10086	9448	638	6.3
CN2207700000000	22	077	Pointe Coupee Parish, LA	2011	NA	9980	9068	912	9.1
CN2207900000000	22	079	Rapides Parish, LA	2011	NA	58206	53753	4453	7.7
CN2208100000000	22	081	Red River Parish, LA	2011	NA	4049	3737	312	7.7
CN2208300000000	22	083	Richland Parish, LA	2011	NA	8796	7839	957	10.9
CN2208500000000	22	085	Sabine Parish, LA	2011	NA	9460	8785	675	7.1
CN2208700000000	22	087	St. Bernard Parish, LA	2011	NA	16856	15424	1432	8.5
CN2208900000000	22	089	St. Charles Parish, LA	2011	NA	24836	23044	1792	7.2
CN2209100000000	22	091	St. Helena Parish, LA	2011	NA	4637	4002	635	13.7
CN2209300000000	22	093	St. James Parish, LA	2011	NA	9943	8738	1205	12.1
CN2209500000000	22	095	St. John the Baptist Parish, LA	2011	NA	20953	18736	2217	10.6
CN2209700000000	22	097	St. Landry Parish, LA	2011	NA	33637	30471	3166	9.4
CN2209900000000	22	099	St. Martin Parish, LA	2011	NA	24085	22309	1776	7.4
CN2210100000000	22	101	St. Mary Parish, LA	2011	NA	25136	22898	2238	8.9
CN2210300000000	22	103	St. Tammany Parish, LA	2011	NA	107963	101175	6788	6.3
CN2210500000000	22	105	Tangipahoa Parish, LA	2011	NA	53286	48168	5118	9.6
CN2210700000000	22	107	Tensas Parish, LA	2011	NA	1979	1723	256	12.9
CN2210900000000	22	109	Terrebonne Parish, LA	2011	NA	49902	46798	3104	6.2
CN2211100000000	22	111	Union Parish, LA	2011	NA	9345	8464	881	9.4
CN2211300000000	22	113	Vermilion Parish, LA	2011	NA	25357	23684	1673	6.6
CN2211500000000	22	115	Vernon Parish, LA	2011	NA	19235	17501	1734	9
CN2211700000000	22	117	Washington Parish, LA	2011	NA	16615	15039	1576	9.5
CN2211900000000	22	119	Webster Parish, LA	2011	NA	16569	14900	1669	10.1
CN2212100000000	22	121	West Baton Rouge Parish, LA	2011	NA	11927	10999	928	7.8
CN2212300000000	22	123	West Carroll Parish, LA	2011	NA	4268	3590	678	15.9
CN2212500000000	22	125	West Feliciana Parish, LA	2011	NA	5138	4799	339	6.6
CN2212700000000	22	127	Winn Parish, LA	2011	NA	5651	5119	532	9.4
CN2300100000000	23	001	Androscoggin County, ME	2011	NA	56041	51497	4544	8.1
CN2300300000000	23	003	Aroostook County, ME	2011	NA	34531	31148	3383	9.8
CN2300500000000	23	005	Cumberland County, ME	2011	NA	158118	148107	10011	6.3
CN2300700000000	23	007	Franklin County, ME	2011	NA	15477	14076	1401	9.1
CN2300900000000	23	009	Hancock County, ME	2011	NA	30097	27430	2667	8.9
CN2301100000000	23	011	Kennebec County, ME	2011	NA	63279	58540	4739	7.5
CN2301300000000	23	013	Knox County, ME	2011	NA	20451	18948	1503	7.3
CN2301500000000	23	015	Lincoln County, ME	2011	NA	17130	15797	1333	7.8
CN2301700000000	23	017	Oxford County, ME	2011	NA	27867	24942	2925	10.5
CN2301900000000	23	019	Penobscot County, ME	2011	NA	79566	72972	6594	8.3
CN2302100000000	23	021	Piscataquis County, ME	2011	NA	7944	7137	807	10.2
CN2302300000000	23	023	Sagadahoc County, ME	2011	NA	19145	17851	1294	6.8
CN2302500000000	23	025	Somerset County, ME	2011	NA	24691	22008	2683	10.9
CN2302700000000	23	027	Waldo County, ME	2011	NA	20395	18709	1686	8.3
CN2302900000000	23	029	Washington County, ME	2011	NA	14889	13312	1577	10.6
CN2303100000000	23	031	York County, ME	2011	NA	109659	101611	8048	7.3
CN2400100000000	24	001	Allegany County, MD	2011	NA	34089	31003	3086	9.1
CN2400300000000	24	003	Anne Arundel County, MD	2011	NA	289348	271057	18291	6.3
CN2400500000000	24	005	Baltimore County, MD	2011	NA	435564	402076	33488	7.7
CN2400900000000	24	009	Calvert County, MD	2011	NA	47715	44614	3101	6.5
CN2401100000000	24	011	Caroline County, MD	2011	NA	17483	15974	1509	8.6
CN2401300000000	24	013	Carroll County, MD	2011	NA	92842	87145	5697	6.1
CN2401500000000	24	015	Cecil County, MD	2011	NA	52101	47474	4627	8.9
CN2401700000000	24	017	Charles County, MD	2011	NA	78999	73700	5299	6.7
CN2401900000000	24	019	Dorchester County, MD	2011	NA	16523	14686	1837	11.1
CN2402100000000	24	021	Frederick County, MD	2011	NA	128573	120301	8272	6.4
CN2402300000000	24	023	Garrett County, MD	2011	NA	15810	14483	1327	8.4
CN2402500000000	24	025	Harford County, MD	2011	NA	133830	124175	9655	7.2
CN2402700000000	24	027	Howard County, MD	2011	NA	163953	155441	8512	5.2
CN2402900000000	24	029	Kent County, MD	2011	NA	10768	9900	868	8.1
CN2403100000000	24	031	Montgomery County, MD	2011	NA	536858	508575	28283	5.3
CN2403300000000	24	033	Prince George's County, MD	2011	NA	482936	446880	36056	7.5
CN2403500000000	24	035	Queen Anne's County, MD	2011	NA	26609	24801	1808	6.8
CN2403700000000	24	037	St. Mary's County, MD	2011	NA	54268	50845	3423	6.3
CN2403900000000	24	039	Somerset County, MD	2011	NA	9876	8721	1155	11.7
CN2404100000000	24	041	Talbot County, MD	2011	NA	19451	18002	1449	7.4
CN2404300000000	24	043	Washington County, MD	2011	NA	76485	69775	6710	8.8
CN2404500000000	24	045	Wicomico County, MD	2011	NA	50546	45581	4965	9.8
CN2404700000000	24	047	Worcester County, MD	2011	NA	26345	22729	3616	13.7
CN2451000000000	24	510	Baltimore city, MD	2011	NA	295593	264148	31445	10.6
CN2500100000000	25	001	Barnstable County, MA	2011	NA	109691	99736	9955	9.1
CN2500300000000	25	003	Berkshire County, MA	2011	NA	66697	61449	5248	7.9
CN2500500000000	25	005	Bristol County, MA	2011	NA	284948	258076	26872	9.4
CN2500700000000	25	007	Dukes County, MA	2011	NA	9162	8303	859	9.4
CN2500900000000	25	009	Essex County, MA	2011	NA	392526	362596	29930	7.6
CN2501100000000	25	011	Franklin County, MA	2011	NA	39535	36948	2587	6.5
CN2501300000000	25	013	Hampden County, MA	2011	NA	219138	198691	20447	9.3
CN2501500000000	25	015	Hampshire County, MA	2011	NA	84971	79726	5245	6.2
CN2501700000000	25	017	Middlesex County, MA	2011	NA	824003	775397	48606	5.9
CN2501900000000	25	019	Nantucket County/town, MA	2011	NA	6211	5675	536	8.6
CN2502100000000	25	021	Norfolk County, MA	2011	NA	357305	334827	22478	6.3
CN2502300000000	25	023	Plymouth County, MA	2011	NA	260808	240547	20261	7.8
CN2502500000000	25	025	Suffolk County, MA	2011	NA	396308	370009	26299	6.6
CN2502700000000	25	027	Worcester County, MA	2011	NA	418007	385775	32232	7.7
CN2600100000000	26	001	Alcona County, MI	2011	NA	3807	3261	546	14.3
CN2600300000000	26	003	Alger County, MI	2011	NA	3475	3035	440	12.7
CN2600500000000	26	005	Allegan County, MI	2011	NA	56816	51848	4968	8.7
CN2600700000000	26	007	Alpena County, MI	2011	NA	13684	12200	1484	10.8
CN2600900000000	26	009	Antrim County, MI	2011	NA	10165	8817	1348	13.3
CN2601100000000	26	011	Arenac County, MI	2011	NA	6688	5747	941	14.1
CN2601300000000	26	013	Baraga County, MI	2011	NA	3661	3060	601	16.4
CN2601500000000	26	015	Barry County, MI	2011	NA	28877	26517	2360	8.2
CN2601700000000	26	017	Bay County, MI	2011	NA	53317	48064	5253	9.9
CN2601900000000	26	019	Benzie County, MI	2011	NA	8693	7646	1047	12
CN2602100000000	26	021	Berrien County, MI	2011	NA	74551	66972	7579	10.2
CN2602300000000	26	023	Branch County, MI	2011	NA	19173	17165	2008	10.5
CN2602500000000	26	025	Calhoun County, MI	2011	NA	63216	57020	6196	9.8
CN2602700000000	26	027	Cass County, MI	2011	NA	24419	22057	2362	9.7
CN2602900000000	26	029	Charlevoix County, MI	2011	NA	12925	11352	1573	12.2
CN2603100000000	26	031	Cheboygan County, MI	2011	NA	10839	9507	1332	12.3
CN2603300000000	26	033	Chippewa County, MI	2011	NA	17390	15503	1887	10.9
CN2603500000000	26	035	Clare County, MI	2011	NA	12169	10563	1606	13.2
CN2603700000000	26	037	Clinton County, MI	2011	NA	38944	36232	2712	7
CN2603900000000	26	039	Crawford County, MI	2011	NA	5498	4793	705	12.8
CN2604100000000	26	041	Delta County, MI	2011	NA	17814	15897	1917	10.8
CN2604300000000	26	043	Dickinson County, MI	2011	NA	12810	11581	1229	9.6
CN2604500000000	26	045	Eaton County, MI	2011	NA	55660	51191	4469	8
CN2604700000000	26	047	Emmet County, MI	2011	NA	18043	15684	2359	13.1
CN2604900000000	26	049	Genesee County, MI	2011	NA	182814	161919	20895	11.4
CN2605100000000	26	051	Gladwin County, MI	2011	NA	10115	8799	1316	13
CN2605300000000	26	053	Gogebic County, MI	2011	NA	6947	6122	825	11.9
CN2605500000000	26	055	Grand Traverse County, MI	2011	NA	46656	42083	4573	9.8
CN2605700000000	26	057	Gratiot County, MI	2011	NA	19075	17162	1913	10
CN2605900000000	26	059	Hillsdale County, MI	2011	NA	20651	18454	2197	10.6
CN2606100000000	26	061	Houghton County, MI	2011	NA	17322	15662	1660	9.6
CN2606300000000	26	063	Huron County, MI	2011	NA	16412	14815	1597	9.7
CN2606500000000	26	065	Ingham County, MI	2011	NA	145123	132289	12834	8.8
CN2606700000000	26	067	Ionia County, MI	2011	NA	29106	26261	2845	9.8
CN2606900000000	26	069	Iosco County, MI	2011	NA	10130	8830	1300	12.8
CN2607100000000	26	071	Iron County, MI	2011	NA	5170	4634	536	10.4
CN2607300000000	26	073	Isabella County, MI	2011	NA	34911	31986	2925	8.4
CN2607500000000	26	075	Jackson County, MI	2011	NA	72614	65424	7190	9.9
CN2607700000000	26	077	Kalamazoo County, MI	2011	NA	126186	115549	10637	8.4
CN2607900000000	26	079	Kalkaska County, MI	2011	NA	7595	6606	989	13
CN2608100000000	26	081	Kent County, MI	2011	NA	315111	289297	25814	8.2
CN2608300000000	26	083	Keweenaw County, MI	2011	NA	1017	877	140	13.8
CN2608500000000	26	085	Lake County, MI	2011	NA	3858	3331	527	13.7
CN2608700000000	26	087	Lapeer County, MI	2011	NA	39862	34587	5275	13.2
CN2608900000000	26	089	Leelanau County, MI	2011	NA	10324	9378	946	9.2
CN2609100000000	26	091	Lenawee County, MI	2011	NA	48269	43261	5008	10.4
CN2609300000000	26	093	Livingston County, MI	2011	NA	92626	84286	8340	9
CN2609500000000	26	095	Luce County, MI	2011	NA	2412	2117	295	12.2
CN2609700000000	26	097	Mackinac County, MI	2011	NA	5289	4595	694	13.1
CN2609900000000	26	099	Macomb County, MI	2011	NA	409065	363484	45581	11.1
CN2610100000000	26	101	Manistee County, MI	2011	NA	10684	9406	1278	12
CN2610300000000	26	103	Marquette County, MI	2011	NA	33939	30923	3016	8.9
CN2610500000000	26	105	Mason County, MI	2011	NA	14263	12694	1569	11
CN2610700000000	26	107	Mecosta County, MI	2011	NA	19137	16974	2163	11.3
CN2610900000000	26	109	Menominee County, MI	2011	NA	11815	10736	1079	9.1
CN2611100000000	26	111	Midland County, MI	2011	NA	40869	37450	3419	8.4
CN2611300000000	26	113	Missaukee County, MI	2011	NA	7037	6272	765	10.9
CN2611500000000	26	115	Monroe County, MI	2011	NA	73660	66681	6979	9.5
CN2611700000000	26	117	Montcalm County, MI	2011	NA	27300	24140	3160	11.6
CN2611900000000	26	119	Montmorency County, MI	2011	NA	3346	2742	604	18.1
CN2612100000000	26	121	Muskegon County, MI	2011	NA	75669	67008	8661	11.4
CN2612300000000	26	123	Newaygo County, MI	2011	NA	22463	20074	2389	10.6
CN2612500000000	26	125	Oakland County, MI	2011	NA	610881	552660	58221	9.5
CN2612700000000	26	127	Oceana County, MI	2011	NA	12988	11165	1823	14
CN2612900000000	26	129	Ogemaw County, MI	2011	NA	8786	7663	1123	12.8
CN2613100000000	26	131	Ontonagon County, MI	2011	NA	2777	2326	451	16.2
CN2613300000000	26	133	Osceola County, MI	2011	NA	10170	9012	1158	11.4
CN2613500000000	26	135	Oscoda County, MI	2011	NA	3149	2589	560	17.8
CN2613700000000	26	137	Otsego County, MI	2011	NA	11452	10058	1394	12.2
CN2613900000000	26	139	Ottawa County, MI	2011	NA	139598	128452	11146	8
CN2614100000000	26	141	Presque Isle County, MI	2011	NA	5569	4673	896	16.1
CN2614300000000	26	143	Roscommon County, MI	2011	NA	8383	7143	1240	14.8
CN2614500000000	26	145	Saginaw County, MI	2011	NA	89803	80647	9156	10.2
CN2614700000000	26	147	St. Clair County, MI	2011	NA	74208	64509	9699	13.1
CN2614900000000	26	149	St. Joseph County, MI	2011	NA	27609	24606	3003	10.9
CN2615100000000	26	151	Sanilac County, MI	2011	NA	19505	17119	2386	12.2
CN2615300000000	26	153	Schoolcraft County, MI	2011	NA	3678	3189	489	13.3
CN2615500000000	26	155	Shiawassee County, MI	2011	NA	33632	30023	3609	10.7
CN2615700000000	26	157	Tuscola County, MI	2011	NA	25165	22145	3020	12
CN2615900000000	26	159	Van Buren County, MI	2011	NA	36445	32241	4204	11.5
CN2616100000000	26	161	Washtenaw County, MI	2011	NA	180797	168467	12330	6.8
CN2616300000000	26	163	Wayne County, MI	2011	NA	774443	674177	100266	12.9
CN2616500000000	26	165	Wexford County, MI	2011	NA	14656	12870	1786	12.2
CN2700100000000	27	001	Aitkin County, MN	2011	NA	7112	6431	681	9.6
CN2700300000000	27	003	Anoka County, MN	2011	NA	187000	174217	12783	6.8
CN2700500000000	27	005	Becker County, MN	2011	NA	17715	16451	1264	7.1
CN2700700000000	27	007	Beltrami County, MN	2011	NA	22491	20650	1841	8.2
CN2700900000000	27	009	Benton County, MN	2011	NA	21250	19645	1605	7.6
CN2701100000000	27	011	Big Stone County, MN	2011	NA	2902	2715	187	6.4
CN2701300000000	27	013	Blue Earth County, MN	2011	NA	38315	36245	2070	5.4
CN2701500000000	27	015	Brown County, MN	2011	NA	15042	14157	885	5.9
CN2701700000000	27	017	Carlton County, MN	2011	NA	17630	16286	1344	7.6
CN2701900000000	27	019	Carver County, MN	2011	NA	52129	49252	2877	5.5
CN2702100000000	27	021	Cass County, MN	2011	NA	14149	12730	1419	10
CN2702300000000	27	023	Chippewa County, MN	2011	NA	7183	6730	453	6.3
CN2702500000000	27	025	Chisago County, MN	2011	NA	28983	26777	2206	7.6
CN2702700000000	27	027	Clay County, MN	2011	NA	34623	32703	1920	5.5
CN2702900000000	27	029	Clearwater County, MN	2011	NA	4573	4030	543	11.9
CN2703100000000	27	031	Cook County, MN	2011	NA	3051	2842	209	6.9
CN2703300000000	27	033	Cottonwood County, MN	2011	NA	6139	5762	377	6.1
CN2703500000000	27	035	Crow Wing County, MN	2011	NA	31556	28798	2758	8.7
CN2703700000000	27	037	Dakota County, MN	2011	NA	227975	214174	13801	6.1
CN2703900000000	27	039	Dodge County, MN	2011	NA	11235	10559	676	6
CN2704100000000	27	041	Douglas County, MN	2011	NA	19780	18584	1196	6
CN2704300000000	27	043	Faribault County, MN	2011	NA	7794	7242	552	7.1
CN2704500000000	27	045	Fillmore County, MN	2011	NA	11224	10479	745	6.6
CN2704700000000	27	047	Freeborn County, MN	2011	NA	17051	15919	1132	6.6
CN2704900000000	27	049	Goodhue County, MN	2011	NA	26931	25318	1613	6
CN2705100000000	27	051	Grant County, MN	2011	NA	3375	3142	233	6.9
CN2705300000000	27	053	Hennepin County, MN	2011	NA	656063	616331	39732	6.1
CN2705500000000	27	055	Houston County, MN	2011	NA	10665	9930	735	6.9
CN2705700000000	27	057	Hubbard County, MN	2011	NA	9512	8638	874	9.2
CN2705900000000	27	059	Isanti County, MN	2011	NA	20589	18874	1715	8.3
CN2706100000000	27	061	Itasca County, MN	2011	NA	22519	20478	2041	9.1
CN2706300000000	27	063	Jackson County, MN	2011	NA	6090	5760	330	5.4
CN2706500000000	27	065	Kanabec County, MN	2011	NA	8709	7834	875	10
CN2706700000000	27	067	Kandiyohi County, MN	2011	NA	23643	22229	1414	6
CN2706900000000	27	069	Kittson County, MN	2011	NA	2604	2426	178	6.8
CN2707100000000	27	071	Koochiching County, MN	2011	NA	6811	6242	569	8.4
CN2707300000000	27	073	Lac qui Parle County, MN	2011	NA	3974	3733	241	6.1
CN2707500000000	27	075	Lake County, MN	2011	NA	5814	5414	400	6.9
CN2707700000000	27	077	Lake of the Woods County, MN	2011	NA	2339	2194	145	6.2
CN2707900000000	27	079	Le Sueur County, MN	2011	NA	15684	14494	1190	7.6
CN2708100000000	27	081	Lincoln County, MN	2011	NA	3448	3270	178	5.2
CN2708300000000	27	083	Lyon County, MN	2011	NA	15396	14586	810	5.3
CN2708500000000	27	085	McLeod County, MN	2011	NA	20344	18789	1555	7.6
CN2708700000000	27	087	Mahnomen County, MN	2011	NA	2493	2304	189	7.6
CN2708900000000	27	089	Marshall County, MN	2011	NA	5787	5304	483	8.3
CN2709100000000	27	091	Martin County, MN	2011	NA	11212	10468	744	6.6
CN2709300000000	27	093	Meeker County, MN	2011	NA	12844	11853	991	7.7
CN2709500000000	27	095	Mille Lacs County, MN	2011	NA	12924	11683	1241	9.6
CN2709700000000	27	097	Morrison County, MN	2011	NA	18752	17210	1542	8.2
CN2709900000000	27	099	Mower County, MN	2011	NA	20818	19641	1177	5.7
CN2710100000000	27	101	Murray County, MN	2011	NA	5039	4725	314	6.2
CN2710300000000	27	103	Nicollet County, MN	2011	NA	19939	18924	1015	5.1
CN2710500000000	27	105	Nobles County, MN	2011	NA	11485	10880	605	5.3
CN2710700000000	27	107	Norman County, MN	2011	NA	3649	3405	244	6.7
CN2710900000000	27	109	Olmsted County, MN	2011	NA	81313	77037	4276	5.3
CN2711100000000	27	111	Otter Tail County, MN	2011	NA	30890	28916	1974	6.4
CN2711300000000	27	113	Pennington County, MN	2011	NA	8559	7903	656	7.7
CN2711500000000	27	115	Pine County, MN	2011	NA	15150	13817	1333	8.8
CN2711700000000	27	117	Pipestone County, MN	2011	NA	5031	4704	327	6.5
CN2711900000000	27	119	Polk County, MN	2011	NA	17420	16196	1224	7
CN2712100000000	27	121	Pope County, MN	2011	NA	5860	5515	345	5.9
CN2712300000000	27	123	Ramsey County, MN	2011	NA	272394	254310	18084	6.6
CN2712500000000	27	125	Red Lake County, MN	2011	NA	2424	2228	196	8.1
CN2712700000000	27	127	Redwood County, MN	2011	NA	8385	7878	507	6
CN2712900000000	27	129	Renville County, MN	2011	NA	8545	7919	626	7.3
CN2713100000000	27	131	Rice County, MN	2011	NA	34771	32464	2307	6.6
CN2713300000000	27	133	Rock County, MN	2011	NA	5617	5380	237	4.2
CN2713500000000	27	135	Roseau County, MN	2011	NA	8528	8072	456	5.3
CN2713700000000	27	137	St. Louis County, MN	2011	NA	102271	94758	7513	7.3
CN2713900000000	27	139	Scott County, MN	2011	NA	74896	70578	4318	5.8
CN2714100000000	27	141	Sherburne County, MN	2011	NA	48872	45383	3489	7.1
CN2714300000000	27	143	Sibley County, MN	2011	NA	8500	7915	585	6.9
CN2714500000000	27	145	Stearns County, MN	2011	NA	85989	80611	5378	6.3
CN2714700000000	27	147	Steele County, MN	2011	NA	21118	19753	1365	6.5
CN2714900000000	27	149	Stevens County, MN	2011	NA	5587	5315	272	4.9
CN2715100000000	27	151	Swift County, MN	2011	NA	5194	4823	371	7.1
CN2715300000000	27	153	Todd County, MN	2011	NA	13296	12393	903	6.8
CN2715500000000	27	155	Traverse County, MN	2011	NA	1843	1733	110	6
CN2715700000000	27	157	Wabasha County, MN	2011	NA	11954	11217	737	6.2
CN2715900000000	27	159	Wadena County, MN	2011	NA	6319	5750	569	9
CN2716100000000	27	161	Waseca County, MN	2011	NA	10582	9916	666	6.3
CN2716300000000	27	163	Washington County, MN	2011	NA	133063	125221	7842	5.9
CN2716500000000	27	165	Watonwan County, MN	2011	NA	6267	5871	396	6.3
CN2716700000000	27	167	Wilkin County, MN	2011	NA	3818	3605	213	5.6
CN2716900000000	27	169	Winona County, MN	2011	NA	29435	27721	1714	5.8
CN2717100000000	27	171	Wright County, MN	2011	NA	70299	65495	4804	6.8
CN2717300000000	27	173	Yellow Medicine County, MN	2011	NA	5743	5415	328	5.7
CN2800100000000	28	001	Adams County, MS	2011	NA	12915	11523	1392	10.8
CN2800300000000	28	003	Alcorn County, MS	2011	NA	16192	14435	1757	10.9
CN2800500000000	28	005	Amite County, MS	2011	NA	4993	4421	572	11.5
CN2800700000000	28	007	Attala County, MS	2011	NA	7982	7090	892	11.2
CN2800900000000	28	009	Benton County, MS	2011	NA	3388	2969	419	12.4
CN2801100000000	28	011	Bolivar County, MS	2011	NA	15023	13348	1675	11.1
CN2801300000000	28	013	Calhoun County, MS	2011	NA	7115	6495	620	8.7
CN2801500000000	28	015	Carroll County, MS	2011	NA	3804	3341	463	12.2
CN2801700000000	28	017	Chickasaw County, MS	2011	NA	8255	7312	943	11.4
CN2801900000000	28	019	Choctaw County, MS	2011	NA	3807	3419	388	10.2
CN2802100000000	28	021	Claiborne County, MS	2011	NA	3690	3102	588	15.9
CN2802300000000	28	023	Clarke County, MS	2011	NA	6755	5958	797	11.8
CN2802500000000	28	025	Clay County, MS	2011	NA	8696	7401	1295	14.9
CN2802700000000	28	027	Coahoma County, MS	2011	NA	10686	9206	1480	13.8
CN2802900000000	28	029	Copiah County, MS	2011	NA	12254	10840	1414	11.5
CN2803100000000	28	031	Covington County, MS	2011	NA	8535	7738	797	9.3
CN2803300000000	28	033	DeSoto County, MS	2011	NA	83144	77164	5980	7.2
CN2803500000000	28	035	Forrest County, MS	2011	NA	35065	31522	3543	10.1
CN2803700000000	28	037	Franklin County, MS	2011	NA	3218	2870	348	10.8
CN2803900000000	28	039	George County, MS	2011	NA	9052	7954	1098	12.1
CN2804100000000	28	041	Greene County, MS	2011	NA	4692	4125	567	12.1
CN2804300000000	28	043	Grenada County, MS	2011	NA	9709	8715	994	10.2
CN2804500000000	28	045	Hancock County, MS	2011	NA	20060	18157	1903	9.5
CN2804700000000	28	047	Harrison County, MS	2011	NA	90572	82496	8076	8.9
CN2804900000000	28	049	Hinds County, MS	2011	NA	118305	107045	11260	9.5
CN2805100000000	28	051	Holmes County, MS	2011	NA	6895	5661	1234	17.9
CN2805300000000	28	053	Humphreys County, MS	2011	NA	3422	2789	633	18.5
CN2805500000000	28	055	Issaquena County, MS	2011	NA	516	412	104	20.2
CN2805700000000	28	057	Itawamba County, MS	2011	NA	10572	9516	1056	10
CN2805900000000	28	059	Jackson County, MS	2011	NA	65563	58738	6825	10.4
CN2806100000000	28	061	Jasper County, MS	2011	NA	7184	6359	825	11.5
CN2806300000000	28	063	Jefferson County, MS	2011	NA	2539	2067	472	18.6
CN2806500000000	28	065	Jefferson Davis County, MS	2011	NA	4636	3991	645	13.9
CN2806700000000	28	067	Jones County, MS	2011	NA	29123	26630	2493	8.6
CN2806900000000	28	069	Kemper County, MS	2011	NA	3916	3358	558	14.2
CN2807100000000	28	071	Lafayette County, MS	2011	NA	22931	20961	1970	8.6
CN2807300000000	28	073	Lamar County, MS	2011	NA	28508	26473	2035	7.1
CN2807500000000	28	075	Lauderdale County, MS	2011	NA	34382	30858	3524	10.2
CN2807700000000	28	077	Lawrence County, MS	2011	NA	5076	4487	589	11.6
CN2807900000000	28	079	Leake County, MS	2011	NA	8871	8007	864	9.7
CN2808100000000	28	081	Lee County, MS	2011	NA	41068	37105	3963	9.6
CN2808300000000	28	083	Leflore County, MS	2011	NA	11626	9895	1731	14.9
CN2808500000000	28	085	Lincoln County, MS	2011	NA	14829	13383	1446	9.8
CN2808700000000	28	087	Lowndes County, MS	2011	NA	27321	24446	2875	10.5
CN2808900000000	28	089	Madison County, MS	2011	NA	50716	47222	3494	6.9
CN2809100000000	28	091	Marion County, MS	2011	NA	10922	9756	1166	10.7
CN2809300000000	28	093	Marshall County, MS	2011	NA	15773	13927	1846	11.7
CN2809500000000	28	095	Monroe County, MS	2011	NA	16576	14580	1996	12
CN2809700000000	28	097	Montgomery County, MS	2011	NA	4677	4097	580	12.4
CN2809900000000	28	099	Neshoba County, MS	2011	NA	11969	10855	1114	9.3
CN2810100000000	28	101	Newton County, MS	2011	NA	9393	8526	867	9.2
CN2810300000000	28	103	Noxubee County, MS	2011	NA	4379	3742	637	14.5
CN2810500000000	28	105	Oktibbeha County, MS	2011	NA	22769	20594	2175	9.6
CN2810700000000	28	107	Panola County, MS	2011	NA	14708	12768	1940	13.2
CN2810900000000	28	109	Pearl River County, MS	2011	NA	24313	22044	2269	9.3
CN2811100000000	28	111	Perry County, MS	2011	NA	4671	4054	617	13.2
CN2811300000000	28	113	Pike County, MS	2011	NA	15766	13942	1824	11.6
CN2811500000000	28	115	Pontotoc County, MS	2011	NA	14019	12710	1309	9.3
CN2811700000000	28	117	Prentiss County, MS	2011	NA	11731	10511	1220	10.4
CN2811900000000	28	119	Quitman County, MS	2011	NA	3123	2658	465	14.9
CN2812100000000	28	121	Rankin County, MS	2011	NA	73498	68814	4684	6.4
CN2812300000000	28	123	Scott County, MS	2011	NA	13667	12513	1154	8.4
CN2812500000000	28	125	Sharkey County, MS	2011	NA	2024	1729	295	14.6
CN2812700000000	28	127	Simpson County, MS	2011	NA	11579	10522	1057	9.1
CN2812900000000	28	129	Smith County, MS	2011	NA	7400	6792	608	8.2
CN2813100000000	28	131	Stone County, MS	2011	NA	7040	6283	757	10.8
CN2813300000000	28	133	Sunflower County, MS	2011	NA	9849	8363	1486	15.1
CN2813500000000	28	135	Tallahatchie County, MS	2011	NA	6078	5341	737	12.1
CN2813700000000	28	137	Tate County, MS	2011	NA	12835	11504	1331	10.4
CN2813900000000	28	139	Tippah County, MS	2011	NA	9290	8191	1099	11.8
CN2814100000000	28	141	Tishomingo County, MS	2011	NA	8070	7097	973	12.1
CN2814300000000	28	143	Tunica County, MS	2011	NA	5140	4396	744	14.5
CN2814500000000	28	145	Union County, MS	2011	NA	13295	11980	1315	9.9
CN2814700000000	28	147	Walthall County, MS	2011	NA	5826	5124	702	12
CN2814900000000	28	149	Warren County, MS	2011	NA	23541	21148	2393	10.2
CN2815100000000	28	151	Washington County, MS	2011	NA	21179	17894	3285	15.5
CN2815300000000	28	153	Wayne County, MS	2011	NA	8743	7745	998	11.4
CN2815500000000	28	155	Webster County, MS	2011	NA	4399	3941	458	10.4
CN2815700000000	28	157	Wilkinson County, MS	2011	NA	3457	3008	449	13
CN2815900000000	28	159	Winston County, MS	2011	NA	8003	6936	1067	13.3
CN2816100000000	28	161	Yalobusha County, MS	2011	NA	5372	4740	632	11.8
CN2816300000000	28	163	Yazoo County, MS	2011	NA	10139	8920	1219	12
CN2900100000000	29	001	Adair County, MO	2011	NA	10917	9981	936	8.6
CN2900300000000	29	003	Andrew County, MO	2011	NA	9753	9077	676	6.9
CN2900500000000	29	005	Atchison County, MO	2011	NA	2894	2657	237	8.2
CN2900700000000	29	007	Audrain County, MO	2011	NA	11294	10368	926	8.2
CN2900900000000	29	009	Barry County, MO	2011	NA	15264	13895	1369	9
CN2901100000000	29	011	Barton County, MO	2011	NA	5636	5140	496	8.8
CN2901300000000	29	013	Bates County, MO	2011	NA	8385	7539	846	10.1
CN2901500000000	29	015	Benton County, MO	2011	NA	7228	6439	789	10.9
CN2901700000000	29	017	Bollinger County, MO	2011	NA	5757	5239	518	9
CN2901900000000	29	019	Boone County, MO	2011	NA	94108	88736	5372	5.7
CN2902100000000	29	021	Buchanan County, MO	2011	NA	46473	42713	3760	8.1
CN2902300000000	29	023	Butler County, MO	2011	NA	18816	17122	1694	9
CN2902500000000	29	025	Caldwell County, MO	2011	NA	4450	4064	386	8.7
CN2902700000000	29	027	Callaway County, MO	2011	NA	22085	20405	1680	7.6
CN2902900000000	29	029	Camden County, MO	2011	NA	19150	17015	2135	11.1
CN2903100000000	29	031	Cape Girardeau County, MO	2011	NA	40687	37944	2743	6.7
CN2903300000000	29	033	Carroll County, MO	2011	NA	4743	4247	496	10.5
CN2903500000000	29	035	Carter County, MO	2011	NA	2640	2342	298	11.3
CN2903700000000	29	037	Cass County, MO	2011	NA	53084	48585	4499	8.5
CN2903900000000	29	039	Cedar County, MO	2011	NA	6002	5480	522	8.7
CN2904100000000	29	041	Chariton County, MO	2011	NA	4098	3731	367	9
CN2904300000000	29	043	Christian County, MO	2011	NA	40908	37869	3039	7.4
CN2904500000000	29	045	Clark County, MO	2011	NA	3405	3064	341	10
CN2904700000000	29	047	Clay County, MO	2011	NA	125652	116366	9286	7.4
CN2904900000000	29	049	Clinton County, MO	2011	NA	11033	10050	983	8.9
CN2905100000000	29	051	Cole County, MO	2011	NA	40384	37846	2538	6.3
CN2905300000000	29	053	Cooper County, MO	2011	NA	7948	7231	717	9
CN2905500000000	29	055	Crawford County, MO	2011	NA	10856	9676	1180	10.9
CN2905700000000	29	057	Dade County, MO	2011	NA	3433	3114	319	9.3
CN2905900000000	29	059	Dallas County, MO	2011	NA	7226	6429	797	11
CN2906100000000	29	061	Daviess County, MO	2011	NA	4056	3695	361	8.9
CN2906300000000	29	063	DeKalb County, MO	2011	NA	5035	4632	403	8
CN2906500000000	29	065	Dent County, MO	2011	NA	6418	5796	622	9.7
CN2906700000000	29	067	Douglas County, MO	2011	NA	5196	4666	530	10.2
CN2906900000000	29	069	Dunklin County, MO	2011	NA	12350	10853	1497	12.1
CN2907100000000	29	071	Franklin County, MO	2011	NA	52944	47965	4979	9.4
CN2907300000000	29	073	Gasconade County, MO	2011	NA	7633	6958	675	8.8
CN2907500000000	29	075	Gentry County, MO	2011	NA	3587	3338	249	6.9
CN2907700000000	29	077	Greene County, MO	2011	NA	144414	133822	10592	7.3
CN2907900000000	29	079	Grundy County, MO	2011	NA	4955	4604	351	7.1
CN2908100000000	29	081	Harrison County, MO	2011	NA	4021	3679	342	8.5
CN2908300000000	29	083	Henry County, MO	2011	NA	9923	8965	958	9.7
CN2908500000000	29	085	Hickory County, MO	2011	NA	3572	3155	417	11.7
CN2908700000000	29	087	Holt County, MO	2011	NA	2701	2506	195	7.2
CN2908900000000	29	089	Howard County, MO	2011	NA	4866	4465	401	8.2
CN2909100000000	29	091	Howell County, MO	2011	NA	16532	14948	1584	9.6
CN2909300000000	29	093	Iron County, MO	2011	NA	3570	3068	502	14.1
CN2909500000000	29	095	Jackson County, MO	2011	NA	358229	324168	34061	9.5
CN2909700000000	29	097	Jasper County, MO	2011	NA	58850	54387	4463	7.6
CN2909900000000	29	099	Jefferson County, MO	2011	NA	116930	106665	10265	8.8
CN2910100000000	29	101	Johnson County, MO	2011	NA	23500	21356	2144	9.1
CN2910300000000	29	103	Knox County, MO	2011	NA	1979	1837	142	7.2
CN2910500000000	29	105	Laclede County, MO	2011	NA	15921	14122	1799	11.3
CN2910700000000	29	107	Lafayette County, MO	2011	NA	17464	15875	1589	9.1
CN2910900000000	29	109	Lawrence County, MO	2011	NA	17396	15949	1447	8.3
CN2911100000000	29	111	Lewis County, MO	2011	NA	5142	4784	358	7
CN2911300000000	29	113	Lincoln County, MO	2011	NA	26691	24003	2688	10.1
CN2911500000000	29	115	Linn County, MO	2011	NA	5335	4701	634	11.9
CN2911700000000	29	117	Livingston County, MO	2011	NA	7090	6553	537	7.6
CN2911900000000	29	119	McDonald County, MO	2011	NA	10239	9384	855	8.4
CN2912100000000	29	121	Macon County, MO	2011	NA	7489	6870	619	8.3
CN2912300000000	29	123	Madison County, MO	2011	NA	5361	4803	558	10.4
CN2912500000000	29	125	Maries County, MO	2011	NA	4207	3852	355	8.4
CN2912700000000	29	127	Marion County, MO	2011	NA	14547	13459	1088	7.5
CN2912900000000	29	129	Mercer County, MO	2011	NA	1838	1715	123	6.7
CN2913100000000	29	131	Miller County, MO	2011	NA	11381	10077	1304	11.5
CN2913300000000	29	133	Mississippi County, MO	2011	NA	6072	5488	584	9.6
CN2913500000000	29	135	Moniteau County, MO	2011	NA	7374	6809	565	7.7
CN2913700000000	29	137	Monroe County, MO	2011	NA	4093	3689	404	9.9
CN2913900000000	29	139	Montgomery County, MO	2011	NA	5954	5363	591	9.9
CN2914100000000	29	141	Morgan County, MO	2011	NA	7874	6878	996	12.6
CN2914300000000	29	143	New Madrid County, MO	2011	NA	8236	7436	800	9.7
CN2914500000000	29	145	Newton County, MO	2011	NA	28981	26668	2313	8
CN2914700000000	29	147	Nodaway County, MO	2011	NA	11602	10805	797	6.9
CN2914900000000	29	149	Oregon County, MO	2011	NA	4063	3665	398	9.8
CN2915100000000	29	151	Osage County, MO	2011	NA	7424	6965	459	6.2
CN2915300000000	29	153	Ozark County, MO	2011	NA	3580	3157	423	11.8
CN2915500000000	29	155	Pemiscot County, MO	2011	NA	7194	6356	838	11.6
CN2915700000000	29	157	Perry County, MO	2011	NA	9873	9216	657	6.7
CN2915900000000	29	159	Pettis County, MO	2011	NA	20169	18505	1664	8.3
CN2916100000000	29	161	Phelps County, MO	2011	NA	19933	18252	1681	8.4
CN2916300000000	29	163	Pike County, MO	2011	NA	8208	7524	684	8.3
CN2916500000000	29	165	Platte County, MO	2011	NA	52035	48433	3602	6.9
CN2916700000000	29	167	Polk County, MO	2011	NA	14326	12989	1337	9.3
CN2916900000000	29	169	Pulaski County, MO	2011	NA	16671	15222	1449	8.7
CN2917100000000	29	171	Putnam County, MO	2011	NA	2372	2211	161	6.8
CN2917300000000	29	173	Ralls County, MO	2011	NA	5648	5225	423	7.5
CN2917500000000	29	175	Randolph County, MO	2011	NA	10817	9682	1135	10.5
CN2917700000000	29	177	Ray County, MO	2011	NA	11438	10376	1062	9.3
CN2917900000000	29	179	Reynolds County, MO	2011	NA	2319	2013	306	13.2
CN2918100000000	29	181	Ripley County, MO	2011	NA	5487	4831	656	12
CN2918300000000	29	183	St. Charles County, MO	2011	NA	206298	192073	14225	6.9
CN2918500000000	29	185	St. Clair County, MO	2011	NA	4023	3617	406	10.1
CN2918600000000	29	186	Ste. Genevieve County, MO	2011	NA	9316	8454	862	9.3
CN2918700000000	29	187	St. Francois County, MO	2011	NA	26794	23899	2895	10.8
CN2918900000000	29	189	St. Louis County, MO	2011	NA	534224	492327	41897	7.8
CN2919500000000	29	195	Saline County, MO	2011	NA	11121	10231	890	8
CN2919700000000	29	197	Schuyler County, MO	2011	NA	1908	1734	174	9.1
CN2919900000000	29	199	Scotland County, MO	2011	NA	2332	2178	154	6.6
CN2920100000000	29	201	Scott County, MO	2011	NA	19679	17950	1729	8.8
CN2920300000000	29	203	Shannon County, MO	2011	NA	3134	2722	412	13.1
CN2920500000000	29	205	Shelby County, MO	2011	NA	3205	2975	230	7.2
CN2920700000000	29	207	Stoddard County, MO	2011	NA	13700	12326	1374	10
CN2920900000000	29	209	Stone County, MO	2011	NA	14181	12399	1782	12.6
CN2921100000000	29	211	Sullivan County, MO	2011	NA	2837	2600	237	8.4
CN2921300000000	29	213	Taney County, MO	2011	NA	26143	22699	3444	13.2
CN2921500000000	29	215	Texas County, MO	2011	NA	9767	8817	950	9.7
CN2921700000000	29	217	Vernon County, MO	2011	NA	9598	8904	694	7.2
CN2921900000000	29	219	Warren County, MO	2011	NA	17114	15559	1555	9.1
CN2922100000000	29	221	Washington County, MO	2011	NA	10139	8901	1238	12.2
CN2922300000000	29	223	Wayne County, MO	2011	NA	5500	4942	558	10.1
CN2922500000000	29	225	Webster County, MO	2011	NA	16180	14736	1444	8.9
CN2922700000000	29	227	Worth County, MO	2011	NA	1241	1170	71	5.7
CN2922900000000	29	229	Wright County, MO	2011	NA	7605	6859	746	9.8
CN2951000000000	29	510	St. Louis city, MO	2011	NA	164340	147357	16983	10.3
CN3000100000000	30	001	Beaverhead County, MT	2011	NA	4934	4633	301	6.1
CN3000300000000	30	003	Big Horn County, MT	2011	NA	5638	4961	677	12
CN3000500000000	30	005	Blaine County, MT	2011	NA	2486	2309	177	7.1
CN3000700000000	30	007	Broadwater County, MT	2011	NA	2494	2310	184	7.4
CN3000900000000	30	009	Carbon County, MT	2011	NA	5292	4988	304	5.7
CN3001100000000	30	011	Carter County, MT	2011	NA	684	657	27	3.9
CN3001300000000	30	013	Cascade County, MT	2011	NA	38333	35882	2451	6.4
CN3001500000000	30	015	Chouteau County, MT	2011	NA	2652	2531	121	4.6
CN3001700000000	30	017	Custer County, MT	2011	NA	6367	6108	259	4.1
CN3001900000000	30	019	Daniels County, MT	2011	NA	943	910	33	3.5
CN3002100000000	30	021	Dawson County, MT	2011	NA	4547	4381	166	3.7
CN3002300000000	30	023	Deer Lodge County, MT	2011	NA	5156	4837	319	6.2
CN3002500000000	30	025	Fallon County, MT	2011	NA	1952	1901	51	2.6
CN3002700000000	30	027	Fergus County, MT	2011	NA	5906	5546	360	6.1
CN3002900000000	30	029	Flathead County, MT	2011	NA	43591	38821	4770	10.9
CN3003100000000	30	031	Gallatin County, MT	2011	NA	51559	48461	3098	6
CN3003300000000	30	033	Garfield County, MT	2011	NA	777	747	30	3.9
CN3003500000000	30	035	Glacier County, MT	2011	NA	6061	5372	689	11.4
CN3003700000000	30	037	Golden Valley County, MT	2011	NA	391	371	20	5.1
CN3003900000000	30	039	Granite County, MT	2011	NA	1457	1325	132	9.1
CN3004100000000	30	041	Hill County, MT	2011	NA	7986	7486	500	6.3
CN3004300000000	30	043	Jefferson County, MT	2011	NA	5619	5267	352	6.3
CN3004500000000	30	045	Judith Basin County, MT	2011	NA	968	908	60	6.2
CN3004700000000	30	047	Lake County, MT	2011	NA	12553	11409	1144	9.1
CN3004900000000	30	049	Lewis and Clark County, MT	2011	NA	34503	32668	1835	5.3
CN3005100000000	30	051	Liberty County, MT	2011	NA	1018	977	41	4
CN3005300000000	30	053	Lincoln County, MT	2011	NA	8212	6996	1216	14.8
CN3005500000000	30	055	McCone County, MT	2011	NA	1098	1065	33	3
CN3005700000000	30	057	Madison County, MT	2011	NA	4178	3872	306	7.3
CN3005900000000	30	059	Meagher County, MT	2011	NA	910	843	67	7.4
CN3006100000000	30	061	Mineral County, MT	2011	NA	1791	1574	217	12.1
CN3006300000000	30	063	Missoula County, MT	2011	NA	58780	54816	3964	6.7
CN3006500000000	30	065	Musselshell County, MT	2011	NA	2329	2175	154	6.6
CN3006700000000	30	067	Park County, MT	2011	NA	7883	7229	654	8.3
CN3006900000000	30	069	Petroleum County, MT	2011	NA	280	264	16	5.7
CN3007100000000	30	071	Phillips County, MT	2011	NA	2126	1979	147	6.9
CN3007300000000	30	073	Pondera County, MT	2011	NA	2930	2753	177	6
CN3007500000000	30	075	Powder River County, MT	2011	NA	1058	1008	50	4.7
CN3007700000000	30	077	Powell County, MT	2011	NA	2990	2761	229	7.7
CN3007900000000	30	079	Prairie County, MT	2011	NA	531	502	29	5.5
CN3008100000000	30	081	Ravalli County, MT	2011	NA	18660	16985	1675	9
CN3008300000000	30	083	Richland County, MT	2011	NA	6151	5961	190	3.1
CN3008500000000	30	085	Roosevelt County, MT	2011	NA	4629	4301	328	7.1
CN3008700000000	30	087	Rosebud County, MT	2011	NA	4445	4121	324	7.3
CN3008900000000	30	089	Sanders County, MT	2011	NA	4861	4212	649	13.4
CN3009100000000	30	091	Sheridan County, MT	2011	NA	1885	1818	67	3.6
CN3009300000000	30	093	Silver Bow County, MT	2011	NA	16956	15838	1118	6.6
CN3009500000000	30	095	Stillwater County, MT	2011	NA	4824	4573	251	5.2
CN3009700000000	30	097	Sweet Grass County, MT	2011	NA	1703	1623	80	4.7
CN3009900000000	30	099	Teton County, MT	2011	NA	2941	2774	167	5.7
CN3010100000000	30	101	Toole County, MT	2011	NA	2387	2276	111	4.7
CN3010300000000	30	103	Treasure County, MT	2011	NA	378	357	21	5.6
CN3010500000000	30	105	Valley County, MT	2011	NA	3937	3752	185	4.7
CN3010700000000	30	107	Wheatland County, MT	2011	NA	837	770	67	8
CN3010900000000	30	109	Wibaux County, MT	2011	NA	526	504	22	4.2
CN3011100000000	30	111	Yellowstone County, MT	2011	NA	77147	72938	4209	5.5
CN3100100000000	31	001	Adams County, NE	2011	NA	16487	15777	710	4.3
CN3100300000000	31	003	Antelope County, NE	2011	NA	3598	3467	131	3.6
CN3100500000000	31	005	Arthur County, NE	2011	NA	231	217	14	6.1
CN3100700000000	31	007	Banner County, NE	2011	NA	433	413	20	4.6
CN3100900000000	31	009	Blaine County, NE	2011	NA	280	265	15	5.4
CN3101100000000	31	011	Boone County, NE	2011	NA	3041	2930	111	3.7
CN3101300000000	31	013	Box Butte County, NE	2011	NA	5981	5728	253	4.2
CN3101500000000	31	015	Boyd County, NE	2011	NA	1149	1105	44	3.8
CN3101700000000	31	017	Brown County, NE	2011	NA	1464	1397	67	4.6
CN3101900000000	31	019	Buffalo County, NE	2011	NA	26864	25922	942	3.5
CN3102100000000	31	021	Burt County, NE	2011	NA	3638	3429	209	5.7
CN3102300000000	31	023	Butler County, NE	2011	NA	4745	4566	179	3.8
CN3102500000000	31	025	Cass County, NE	2011	NA	13380	12679	701	5.2
CN3102700000000	31	027	Cedar County, NE	2011	NA	4709	4554	155	3.3
CN3102900000000	31	029	Chase County, NE	2011	NA	2346	2289	57	2.4
CN3103100000000	31	031	Cherry County, NE	2011	NA	3453	3348	105	3
CN3103300000000	31	033	Cheyenne County, NE	2011	NA	5684	5511	173	3
CN3103500000000	31	035	Clay County, NE	2011	NA	3483	3339	144	4.1
CN3103700000000	31	037	Colfax County, NE	2011	NA	5684	5464	220	3.9
CN3103900000000	31	039	Cuming County, NE	2011	NA	4924	4756	168	3.4
CN3104100000000	31	041	Custer County, NE	2011	NA	6048	5842	206	3.4
CN3104300000000	31	043	Dakota County, NE	2011	NA	11014	10366	648	5.9
CN3104500000000	31	045	Dawes County, NE	2011	NA	5473	5261	212	3.9
CN3104700000000	31	047	Dawson County, NE	2011	NA	13190	12531	659	5
CN3104900000000	31	049	Deuel County, NE	2011	NA	1068	1031	37	3.5
CN3105100000000	31	051	Dixon County, NE	2011	NA	3161	3017	144	4.6
CN3105300000000	31	053	Dodge County, NE	2011	NA	19131	18190	941	4.9
CN3105500000000	31	055	Douglas County, NE	2011	NA	282043	268236	13807	4.9
CN3105700000000	31	057	Dundy County, NE	2011	NA	1275	1238	37	2.9
CN3105900000000	31	059	Fillmore County, NE	2011	NA	3324	3209	115	3.5
CN3106100000000	31	061	Franklin County, NE	2011	NA	1671	1601	70	4.2
CN3106300000000	31	063	Frontier County, NE	2011	NA	1602	1545	57	3.6
CN3106500000000	31	065	Furnas County, NE	2011	NA	2712	2613	99	3.7
CN3106700000000	31	067	Gage County, NE	2011	NA	11191	10544	647	5.8
CN3106900000000	31	069	Garden County, NE	2011	NA	1260	1215	45	3.6
CN3107100000000	31	071	Garfield County, NE	2011	NA	1206	1165	41	3.4
CN3107300000000	31	073	Gosper County, NE	2011	NA	1130	1090	40	3.5
CN3107500000000	31	075	Grant County, NE	2011	NA	454	439	15	3.3
CN3107700000000	31	077	Greeley County, NE	2011	NA	1361	1308	53	3.9
CN3107900000000	31	079	Hall County, NE	2011	NA	32013	30581	1432	4.5
CN3108100000000	31	081	Hamilton County, NE	2011	NA	4833	4650	183	3.8
CN3108300000000	31	083	Harlan County, NE	2011	NA	1894	1832	62	3.3
CN3108500000000	31	085	Hayes County, NE	2011	NA	679	658	21	3.1
CN3108700000000	31	087	Hitchcock County, NE	2011	NA	1376	1309	67	4.9
CN3108900000000	31	089	Holt County, NE	2011	NA	5941	5737	204	3.4
CN3109100000000	31	091	Hooker County, NE	2011	NA	447	426	21	4.7
CN3109300000000	31	093	Howard County, NE	2011	NA	3395	3257	138	4.1
CN3109500000000	31	095	Jefferson County, NE	2011	NA	4375	4186	189	4.3
CN3109700000000	31	097	Johnson County, NE	2011	NA	2215	2108	107	4.8
CN3109900000000	31	099	Kearney County, NE	2011	NA	3904	3778	126	3.2
CN3110100000000	31	101	Keith County, NE	2011	NA	4655	4465	190	4.1
CN3110300000000	31	103	Keya Paha County, NE	2011	NA	602	584	18	3
CN3110500000000	31	105	Kimball County, NE	2011	NA	2181	2102	79	3.6
CN3110700000000	31	107	Knox County, NE	2011	NA	4762	4577	185	3.9
CN3110900000000	31	109	Lancaster County, NE	2011	NA	164156	157591	6565	4
CN3111100000000	31	111	Lincoln County, NE	2011	NA	19422	18571	851	4.4
CN3111300000000	31	113	Logan County, NE	2011	NA	509	491	18	3.5
CN3111500000000	31	115	Loup County, NE	2011	NA	378	360	18	4.8
CN3111700000000	31	117	McPherson County, NE	2011	NA	366	357	9	2.5
CN3111900000000	31	119	Madison County, NE	2011	NA	19091	18314	777	4.1
CN3112100000000	31	121	Merrick County, NE	2011	NA	4174	3996	178	4.3
CN3112300000000	31	123	Morrill County, NE	2011	NA	2658	2568	90	3.4
CN3112500000000	31	125	Nance County, NE	2011	NA	2063	1987	76	3.7
CN3112700000000	31	127	Nemaha County, NE	2011	NA	3961	3764	197	5
CN3112900000000	31	129	Nuckolls County, NE	2011	NA	2496	2406	90	3.6
CN3113100000000	31	131	Otoe County, NE	2011	NA	8555	8121	434	5.1
CN3113300000000	31	133	Pawnee County, NE	2011	NA	1653	1591	62	3.8
CN3113500000000	31	135	Perkins County, NE	2011	NA	1803	1751	52	2.9
CN3113700000000	31	137	Phelps County, NE	2011	NA	5013	4830	183	3.7
CN3113900000000	31	139	Pierce County, NE	2011	NA	4212	4063	149	3.5
CN3114100000000	31	141	Platte County, NE	2011	NA	17825	17083	742	4.2
CN3114300000000	31	143	Polk County, NE	2011	NA	3000	2897	103	3.4
CN3114500000000	31	145	Red Willow County, NE	2011	NA	6287	6069	218	3.5
CN3114700000000	31	147	Richardson County, NE	2011	NA	4405	4139	266	6
CN3114900000000	31	149	Rock County, NE	2011	NA	899	875	24	2.7
CN3115100000000	31	151	Saline County, NE	2011	NA	7344	6998	346	4.7
CN3115300000000	31	153	Sarpy County, NE	2011	NA	86350	82692	3658	4.2
CN3115500000000	31	155	Saunders County, NE	2011	NA	11202	10688	514	4.6
CN3115700000000	31	157	Scotts Bluff County, NE	2011	NA	19209	18245	964	5
CN3115900000000	31	159	Seward County, NE	2011	NA	8767	8430	337	3.8
CN3116100000000	31	161	Sheridan County, NE	2011	NA	2831	2730	101	3.6
CN3116300000000	31	163	Sherman County, NE	2011	NA	1759	1683	76	4.3
CN3116500000000	31	165	Sioux County, NE	2011	NA	844	815	29	3.4
CN3116700000000	31	167	Stanton County, NE	2011	NA	3628	3493	135	3.7
CN3116900000000	31	169	Thayer County, NE	2011	NA	2926	2830	96	3.3
CN3117100000000	31	171	Thomas County, NE	2011	NA	426	404	22	5.2
CN3117300000000	31	173	Thurston County, NE	2011	NA	3122	2804	318	10.2
CN3117500000000	31	175	Valley County, NE	2011	NA	2149	2063	86	4
CN3117700000000	31	177	Washington County, NE	2011	NA	11240	10751	489	4.4
CN3117900000000	31	179	Wayne County, NE	2011	NA	5608	5414	194	3.5
CN3118100000000	31	181	Webster County, NE	2011	NA	1736	1656	80	4.6
CN3118300000000	31	183	Wheeler County, NE	2011	NA	524	507	17	3.2
CN3118500000000	31	185	York County, NE	2011	NA	7515	7189	326	4.3
CN3200100000000	32	001	Churchill County, NV	2011	NA	11240	9836	1404	12.5
CN3200300000000	32	003	Clark County, NV	2011	NA	995128	863507	131621	13.2
CN3200500000000	32	005	Douglas County, NV	2011	NA	23235	20166	3069	13.2
CN3200700000000	32	007	Elko County, NV	2011	NA	28191	26153	2038	7.2
CN3200900000000	32	009	Esmeralda County, NV	2011	NA	421	388	33	7.8
CN3201100000000	32	011	Eureka County, NV	2011	NA	1072	998	74	6.9
CN3201300000000	32	013	Humboldt County, NV	2011	NA	8735	8052	683	7.8
CN3201500000000	32	015	Lander County, NV	2011	NA	3220	2936	284	8.8
CN3201700000000	32	017	Lincoln County, NV	2011	NA	2080	1849	231	11.1
CN3201900000000	32	019	Lyon County, NV	2011	NA	22938	19090	3848	16.8
CN3202100000000	32	021	Mineral County, NV	2011	NA	2195	1883	312	14.2
CN3202300000000	32	023	Nye County, NV	2011	NA	16916	14087	2829	16.7
CN3202700000000	32	027	Pershing County, NV	2011	NA	2479	2212	267	10.8
CN3202900000000	32	029	Storey County, NV	2011	NA	1974	1664	310	15.7
CN3203100000000	32	031	Washoe County, NV	2011	NA	221679	193778	27901	12.6
CN3203300000000	32	033	White Pine County, NV	2011	NA	5093	4650	443	8.7
CN3251000000000	32	510	Carson City, NV	2011	NA	26520	23015	3505	13.2
CN3300100000000	33	001	Belknap County, NH	2011	NA	32049	30285	1764	5.5
CN3300300000000	33	003	Carroll County, NH	2011	NA	24764	23415	1349	5.4
CN3300500000000	33	005	Cheshire County, NH	2011	NA	42545	40409	2136	5
CN3300700000000	33	007	Coos County, NH	2011	NA	16347	15156	1191	7.3
CN3300900000000	33	009	Grafton County, NH	2011	NA	48734	46562	2172	4.5
CN3301100000000	33	011	Hillsborough County, NH	2011	NA	225079	212340	12739	5.7
CN3301300000000	33	013	Merrimack County, NH	2011	NA	81097	77105	3992	4.9
CN3301500000000	33	015	Rockingham County, NH	2011	NA	172122	162479	9643	5.6
CN3301700000000	33	017	Strafford County, NH	2011	NA	69613	65926	3687	5.3
CN3301900000000	33	019	Sullivan County, NH	2011	NA	23952	22855	1097	4.6
CN3400100000000	34	001	Atlantic County, NJ	2011	NA	139577	122104	17473	12.5
CN3400300000000	34	003	Bergen County, NJ	2011	NA	481715	444591	37124	7.7
CN3400500000000	34	005	Burlington County, NJ	2011	NA	236043	215513	20530	8.7
CN3400700000000	34	007	Camden County, NJ	2011	NA	263211	234675	28536	10.8
CN3400900000000	34	009	Cape May County, NJ	2011	NA	49591	42240	7351	14.8
CN3401100000000	34	011	Cumberland County, NJ	2011	NA	71923	62610	9313	12.9
CN3401300000000	34	013	Essex County, NJ	2011	NA	382913	341465	41448	10.8
CN3401500000000	34	015	Gloucester County, NJ	2011	NA	152130	136663	15467	10.2
CN3401700000000	34	017	Hudson County, NJ	2011	NA	357354	324656	32698	9.2
CN3401900000000	34	019	Hunterdon County, NJ	2011	NA	67734	63055	4679	6.9
CN3402100000000	34	021	Mercer County, NJ	2011	NA	193401	177384	16017	8.3
CN3402300000000	34	023	Middlesex County, NJ	2011	NA	426827	389567	37260	8.7
CN3402500000000	34	025	Monmouth County, NJ	2011	NA	329845	301573	28272	8.6
CN3402700000000	34	027	Morris County, NJ	2011	NA	265458	246701	18757	7.1
CN3402900000000	34	029	Ocean County, NJ	2011	NA	266042	238334	27708	10.4
CN3403100000000	34	031	Passaic County, NJ	2011	NA	253663	225744	27919	11
CN3403300000000	34	033	Salem County, NJ	2011	NA	32453	28681	3772	11.6
CN3403500000000	34	035	Somerset County, NJ	2011	NA	174327	161446	12881	7.4
CN3403700000000	34	037	Sussex County, NJ	2011	NA	81750	74189	7561	9.2
CN3403900000000	34	039	Union County, NJ	2011	NA	280496	253788	26708	9.5
CN3404100000000	34	041	Warren County, NJ	2011	NA	58820	53486	5334	9.1
CN3500100000000	35	001	Bernalillo County, NM	2011	NA	323703	300392	23311	7.2
CN3500300000000	35	003	Catron County, NM	2011	NA	1161	1032	129	11.1
CN3500500000000	35	005	Chaves County, NM	2011	NA	27596	25732	1864	6.8
CN3500600000000	35	006	Cibola County, NM	2011	NA	9275	8397	878	9.5
CN3500700000000	35	007	Colfax County, NM	2011	NA	6319	5806	513	8.1
CN3500900000000	35	009	Curry County, NM	2011	NA	21478	20388	1090	5.1
CN3501100000000	35	011	De Baca County, NM	2011	NA	818	776	42	5.1
CN3501300000000	35	013	Dona Ana County, NM	2011	NA	93392	86338	7054	7.6
CN3501500000000	35	015	Eddy County, NM	2011	NA	26492	25144	1348	5.1
CN3501700000000	35	017	Grant County, NM	2011	NA	12775	11845	930	7.3
CN3501900000000	35	019	Guadalupe County, NM	2011	NA	1656	1481	175	10.6
CN3502100000000	35	021	Harding County, NM	2011	NA	297	278	19	6.4
CN3502300000000	35	023	Hidalgo County, NM	2011	NA	2285	2112	173	7.6
CN3502500000000	35	025	Lea County, NM	2011	NA	27249	25729	1520	5.6
CN3502700000000	35	027	Lincoln County, NM	2011	NA	9110	8493	617	6.8
CN3502800000000	35	028	Los Alamos County, NM	2011	NA	9277	8949	328	3.5
CN3502900000000	35	029	Luna County, NM	2011	NA	11495	9169	2326	20.2
CN3503100000000	35	031	McKinley County, NM	2011	NA	24976	22496	2480	9.9
CN3503300000000	35	033	Mora County, NM	2011	NA	2379	2085	294	12.4
CN3503500000000	35	035	Otero County, NM	2011	NA	24688	23004	1684	6.8
CN3503700000000	35	037	Quay County, NM	2011	NA	3391	3065	326	9.6
CN3503900000000	35	039	Rio Arriba County, NM	2011	NA	17254	15654	1600	9.3
CN3504100000000	35	041	Roosevelt County, NM	2011	NA	8327	7850	477	5.7
CN3504300000000	35	043	Sandoval County, NM	2011	NA	60822	55935	4887	8
CN3504500000000	35	045	San Juan County, NM	2011	NA	55028	50701	4327	7.9
CN3504700000000	35	047	San Miguel County, NM	2011	NA	11097	10043	1054	9.5
CN3504900000000	35	049	Santa Fe County, NM	2011	NA	73631	69047	4584	6.2
CN3505100000000	35	051	Sierra County, NM	2011	NA	3888	3505	383	9.9
CN3505300000000	35	053	Socorro County, NM	2011	NA	6841	6318	523	7.6
CN3505500000000	35	055	Taos County, NM	2011	NA	15172	13580	1592	10.5
CN3505700000000	35	057	Torrance County, NM	2011	NA	5875	5202	673	11.5
CN3505900000000	35	059	Union County, NM	2011	NA	1941	1850	91	4.7
CN3506100000000	35	061	Valencia County, NM	2011	NA	30667	27909	2758	9
CN3600100000000	36	001	Albany County, NY	2011	NA	158289	147330	10959	6.9
CN3600300000000	36	003	Allegany County, NY	2011	NA	23657	21545	2112	8.9
CN3600500000000	36	005	Bronx County, NY	2011	NA	584353	514635	69718	11.9
CN3600700000000	36	007	Broome County, NY	2011	NA	94727	86579	8148	8.6
CN3600900000000	36	009	Cattaraugus County, NY	2011	NA	38540	34943	3597	9.3
CN3601100000000	36	011	Cayuga County, NY	2011	NA	39068	35899	3169	8.1
CN3601300000000	36	013	Chautauqua County, NY	2011	NA	61661	56616	5045	8.2
CN3601500000000	36	015	Chemung County, NY	2011	NA	40803	37606	3197	7.8
CN3601700000000	36	017	Chenango County, NY	2011	NA	23830	21760	2070	8.7
CN3601900000000	36	019	Clinton County, NY	2011	NA	38413	34729	3684	9.6
CN3602100000000	36	021	Columbia County, NY	2011	NA	31452	29216	2236	7.1
CN3602300000000	36	023	Cortland County, NY	2011	NA	24341	22284	2057	8.5
CN3602500000000	36	025	Delaware County, NY	2011	NA	21717	19833	1884	8.7
CN3602700000000	36	027	Dutchess County, NY	2011	NA	146309	135325	10984	7.5
CN3602900000000	36	029	Erie County, NY	2011	NA	458769	422123	36646	8
CN3603100000000	36	031	Essex County, NY	2011	NA	18201	16546	1655	9.1
CN3603300000000	36	033	Franklin County, NY	2011	NA	21725	19744	1981	9.1
CN3603500000000	36	035	Fulton County, NY	2011	NA	25552	22854	2698	10.6
CN3603700000000	36	037	Genesee County, NY	2011	NA	30922	28516	2406	7.8
CN3603900000000	36	039	Greene County, NY	2011	NA	21576	19552	2024	9.4
CN3604100000000	36	041	Hamilton County, NY	2011	NA	2442	2201	241	9.9
CN3604300000000	36	043	Herkimer County, NY	2011	NA	30723	28048	2675	8.7
CN3604500000000	36	045	Jefferson County, NY	2011	NA	48934	44154	4780	9.8
CN3604700000000	36	047	Kings County, NY	2011	NA	1170616	1058657	111959	9.6
CN3604900000000	36	049	Lewis County, NY	2011	NA	12393	11197	1196	9.7
CN3605100000000	36	051	Livingston County, NY	2011	NA	32007	29560	2447	7.6
CN3605300000000	36	053	Madison County, NY	2011	NA	34733	31896	2837	8.2
CN3605500000000	36	055	Monroe County, NY	2011	NA	373786	345099	28687	7.7
CN3605700000000	36	057	Montgomery County, NY	2011	NA	23432	21034	2398	10.2
CN3605900000000	36	059	Nassau County, NY	2011	NA	683283	636681	46602	6.8
CN3606100000000	36	061	New York County, NY	2011	NA	882224	813275	68949	7.8
CN3606300000000	36	063	Niagara County, NY	2011	NA	105602	95951	9651	9.1
CN3606500000000	36	065	Oneida County, NY	2011	NA	108979	100271	8708	8
CN3606700000000	36	067	Onondaga County, NY	2011	NA	232622	214674	17948	7.7
CN3606900000000	36	069	Ontario County, NY	2011	NA	55756	51805	3951	7.1
CN3607100000000	36	071	Orange County, NY	2011	NA	178868	165070	13798	7.7
CN3607300000000	36	073	Orleans County, NY	2011	NA	18812	17075	1737	9.2
CN3607500000000	36	075	Oswego County, NY	2011	NA	57994	51752	6242	10.8
CN3607700000000	36	077	Otsego County, NY	2011	NA	31375	28950	2425	7.7
CN3607900000000	36	079	Putnam County, NY	2011	NA	51607	47980	3627	7
CN3608100000000	36	081	Queens County, NY	2011	NA	1108920	1019249	89671	8.1
CN3608300000000	36	083	Rensselaer County, NY	2011	NA	82767	76480	6287	7.6
CN3608500000000	36	085	Richmond County, NY	2011	NA	216722	196872	19850	9.2
CN3608700000000	36	087	Rockland County, NY	2011	NA	148873	138245	10628	7.1
CN3608900000000	36	089	St. Lawrence County, NY	2011	NA	48900	43824	5076	10.4
CN3609100000000	36	091	Saratoga County, NY	2011	NA	115669	107973	7696	6.7
CN3609300000000	36	093	Schenectady County, NY	2011	NA	77068	71293	5775	7.5
CN3609500000000	36	095	Schoharie County, NY	2011	NA	15557	14163	1394	9
CN3609700000000	36	097	Schuyler County, NY	2011	NA	9008	8212	796	8.8
CN3609900000000	36	099	Seneca County, NY	2011	NA	16104	14829	1275	7.9
CN3610100000000	36	101	Steuben County, NY	2011	NA	46123	41919	4204	9.1
CN3610300000000	36	103	Suffolk County, NY	2011	NA	770533	711930	58603	7.6
CN3610500000000	36	105	Sullivan County, NY	2011	NA	35480	32335	3145	8.9
CN3610700000000	36	107	Tioga County, NY	2011	NA	25818	23832	1986	7.7
CN3610900000000	36	109	Tompkins County, NY	2011	NA	54190	50910	3280	6.1
CN3611100000000	36	111	Ulster County, NY	2011	NA	91289	84123	7166	7.8
CN3611300000000	36	113	Warren County, NY	2011	NA	33619	30619	3000	8.9
CN3611500000000	36	115	Washington County, NY	2011	NA	29721	27318	2403	8.1
CN3611700000000	36	117	Wayne County, NY	2011	NA	46445	42533	3912	8.4
CN3611900000000	36	119	Westchester County, NY	2011	NA	473504	440021	33483	7.1
CN3612100000000	36	121	Wyoming County, NY	2011	NA	18881	17232	1649	8.7
CN3612300000000	36	123	Yates County, NY	2011	NA	12086	11181	905	7.5
CN3700100000000	37	001	Alamance County, NC	2011	NA	77265	69803	7462	9.7
CN3700300000000	37	003	Alexander County, NC	2011	NA	17893	15875	2018	11.3
CN3700500000000	37	005	Alleghany County, NC	2011	NA	4630	4064	566	12.2
CN3700700000000	37	007	Anson County, NC	2011	NA	11099	9735	1364	12.3
CN3700900000000	37	009	Ashe County, NC	2011	NA	13245	11795	1450	10.9
CN3701100000000	37	011	Avery County, NC	2011	NA	7766	6904	862	11.1
CN3701300000000	37	013	Beaufort County, NC	2011	NA	21473	19085	2388	11.1
CN3701500000000	37	015	Bertie County, NC	2011	NA	9071	7976	1095	12.1
CN3701700000000	37	017	Bladen County, NC	2011	NA	14863	12871	1992	13.4
CN3701900000000	37	019	Brunswick County, NC	2011	NA	47015	41273	5742	12.2
CN3702100000000	37	021	Buncombe County, NC	2011	NA	124660	114760	9900	7.9
CN3702300000000	37	023	Burke County, NC	2011	NA	41196	36483	4713	11.4
CN3702500000000	37	025	Cabarrus County, NC	2011	NA	89830	80488	9342	10.4
CN3702700000000	37	027	Caldwell County, NC	2011	NA	37342	32395	4947	13.2
CN3702900000000	37	029	Camden County, NC	2011	NA	4591	4198	393	8.6
CN3703100000000	37	031	Carteret County, NC	2011	NA	30966	27960	3006	9.7
CN3703300000000	37	033	Caswell County, NC	2011	NA	10109	8918	1191	11.8
CN3703500000000	37	035	Catawba County, NC	2011	NA	76812	67852	8960	11.7
CN3703700000000	37	037	Chatham County, NC	2011	NA	31120	28595	2525	8.1
CN3703900000000	37	039	Cherokee County, NC	2011	NA	11594	10221	1373	11.8
CN3704100000000	37	041	Chowan County, NC	2011	NA	5957	5233	724	12.2
CN3704300000000	37	043	Clay County, NC	2011	NA	4145	3667	478	11.5
CN3704500000000	37	045	Cleveland County, NC	2011	NA	45873	40201	5672	12.4
CN3704700000000	37	047	Columbus County, NC	2011	NA	23939	20734	3205	13.4
CN3704900000000	37	049	Craven County, NC	2011	NA	41925	37500	4425	10.6
CN3705100000000	37	051	Cumberland County, NC	2011	NA	132538	118604	13934	10.5
CN3705300000000	37	053	Currituck County, NC	2011	NA	12350	11232	1118	9.1
CN3705500000000	37	055	Dare County, NC	2011	NA	20053	17443	2610	13
CN3705700000000	37	057	Davidson County, NC	2011	NA	79406	70659	8747	11
CN3705900000000	37	059	Davie County, NC	2011	NA	19991	17876	2115	10.6
CN3706100000000	37	061	Duplin County, NC	2011	NA	26233	23751	2482	9.5
CN3706300000000	37	063	Durham County, NC	2011	NA	145292	133534	11758	8.1
CN3706500000000	37	065	Edgecombe County, NC	2011	NA	24925	21057	3868	15.5
CN3706700000000	37	067	Forsyth County, NC	2011	NA	173621	156559	17062	9.8
CN3706900000000	37	069	Franklin County, NC	2011	NA	27941	24963	2978	10.7
CN3707100000000	37	071	Gaston County, NC	2011	NA	100475	88559	11916	11.9
CN3707300000000	37	073	Gates County, NC	2011	NA	5426	4981	445	8.2
CN3707500000000	37	075	Graham County, NC	2011	NA	3617	2964	653	18.1
CN3707700000000	37	077	Granville County, NC	2011	NA	27862	25380	2482	8.9
CN3707900000000	37	079	Greene County, NC	2011	NA	9558	8640	918	9.6
CN3708100000000	37	081	Guilford County, NC	2011	NA	253095	226641	26454	10.5
CN3708300000000	37	083	Halifax County, NC	2011	NA	22346	19085	3261	14.6
CN3708500000000	37	085	Harnett County, NC	2011	NA	49138	43552	5586	11.4
CN3708700000000	37	087	Haywood County, NC	2011	NA	27510	24736	2774	10.1
CN3708900000000	37	089	Henderson County, NC	2011	NA	48402	44291	4111	8.5
CN3709100000000	37	091	Hertford County, NC	2011	NA	9632	8539	1093	11.3
CN3709300000000	37	093	Hoke County, NC	2011	NA	19451	17335	2116	10.9
CN3709500000000	37	095	Hyde County, NC	2011	NA	2114	1831	283	13.4
CN3709700000000	37	097	Iredell County, NC	2011	NA	78531	69589	8942	11.4
CN3709900000000	37	099	Jackson County, NC	2011	NA	18070	16059	2011	11.1
CN3710100000000	37	101	Johnston County, NC	2011	NA	82457	74629	7828	9.5
CN3710300000000	37	103	Jones County, NC	2011	NA	4583	4096	487	10.6
CN3710500000000	37	105	Lee County, NC	2011	NA	27228	23873	3355	12.3
CN3710700000000	37	107	Lenoir County, NC	2011	NA	27601	24596	3005	10.9
CN3710900000000	37	109	Lincoln County, NC	2011	NA	39803	35353	4450	11.2
CN3711100000000	37	111	McDowell County, NC	2011	NA	20594	18048	2546	12.4
CN3711300000000	37	113	Macon County, NC	2011	NA	15483	13729	1754	11.3
CN3711500000000	37	115	Madison County, NC	2011	NA	9435	8467	968	10.3
CN3711700000000	37	117	Martin County, NC	2011	NA	10638	9316	1322	12.4
CN3711900000000	37	119	Mecklenburg County, NC	2011	NA	513764	462812	50952	9.9
CN3712100000000	37	121	Mitchell County, NC	2011	NA	6738	5938	800	11.9
CN3712300000000	37	123	Montgomery County, NC	2011	NA	11505	10149	1356	11.8
CN3712500000000	37	125	Moore County, NC	2011	NA	37081	33542	3539	9.5
CN3712700000000	37	127	Nash County, NC	2011	NA	46919	41064	5855	12.5
CN3712900000000	37	129	New Hanover County, NC	2011	NA	107501	97230	10271	9.6
CN3713100000000	37	131	Northampton County, NC	2011	NA	8630	7574	1056	12.2
CN3713300000000	37	133	Onslow County, NC	2011	NA	62686	57493	5193	8.3
CN3713500000000	37	135	Orange County, NC	2011	NA	70173	65582	4591	6.5
CN3713700000000	37	137	Pamlico County, NC	2011	NA	5481	4948	533	9.7
CN3713900000000	37	139	Pasquotank County, NC	2011	NA	18269	16383	1886	10.3
CN3714100000000	37	141	Pender County, NC	2011	NA	24622	21831	2791	11.3
CN3714300000000	37	143	Perquimans County, NC	2011	NA	5303	4721	582	11
CN3714500000000	37	145	Person County, NC	2011	NA	18560	16347	2213	11.9
CN3714700000000	37	147	Pitt County, NC	2011	NA	85776	77087	8689	10.1
CN3714900000000	37	149	Polk County, NC	2011	NA	8444	7657	787	9.3
CN3715100000000	37	151	Randolph County, NC	2011	NA	68708	61191	7517	10.9
CN3715300000000	37	153	Richmond County, NC	2011	NA	18285	15615	2670	14.6
CN3715500000000	37	155	Robeson County, NC	2011	NA	53473	45863	7610	14.2
CN3715700000000	37	157	Rockingham County, NC	2011	NA	43567	38210	5357	12.3
CN3715900000000	37	159	Rowan County, NC	2011	NA	63505	55598	7907	12.5
CN3716100000000	37	161	Rutherford County, NC	2011	NA	26482	22625	3857	14.6
CN3716300000000	37	163	Sampson County, NC	2011	NA	29686	26786	2900	9.8
CN3716500000000	37	165	Scotland County, NC	2011	NA	12855	10537	2318	18
CN3716700000000	37	167	Stanly County, NC	2011	NA	28833	25440	3393	11.8
CN3716900000000	37	169	Stokes County, NC	2011	NA	22507	20163	2344	10.4
CN3717100000000	37	171	Surry County, NC	2011	NA	33832	30178	3654	10.8
CN3717300000000	37	173	Swain County, NC	2011	NA	6484	5470	1014	15.6
CN3717500000000	37	175	Transylvania County, NC	2011	NA	13393	12130	1263	9.4
CN3717700000000	37	177	Tyrrell County, NC	2011	NA	1633	1389	244	14.9
CN3717900000000	37	179	Union County, NC	2011	NA	102404	93069	9335	9.1
CN3718100000000	37	181	Vance County, NC	2011	NA	18646	15867	2779	14.9
CN3718300000000	37	183	Wake County, NC	2011	NA	487849	449517	38332	7.9
CN3718500000000	37	185	Warren County, NC	2011	NA	7641	6574	1067	14
CN3718700000000	37	187	Washington County, NC	2011	NA	4989	4147	842	16.9
CN3718900000000	37	189	Watauga County, NC	2011	NA	27002	24875	2127	7.9
CN3719100000000	37	191	Wayne County, NC	2011	NA	54885	49924	4961	9
CN3719300000000	37	193	Wilkes County, NC	2011	NA	31095	27435	3660	11.8
CN3719500000000	37	195	Wilson County, NC	2011	NA	38258	32935	5323	13.9
CN3719700000000	37	197	Yadkin County, NC	2011	NA	17963	16113	1850	10.3
CN3719900000000	37	199	Yancey County, NC	2011	NA	7874	6981	893	11.3
CN3800100000000	38	001	Adams County, ND	2011	NA	1165	1132	33	2.8
CN3800300000000	38	003	Barnes County, ND	2011	NA	6046	5808	238	3.9
CN3800500000000	38	005	Benson County, ND	2011	NA	2930	2753	177	6
CN3800700000000	38	007	Billings County, ND	2011	NA	440	423	17	3.9
CN3800900000000	38	009	Bottineau County, ND	2011	NA	3436	3307	129	3.8
CN3801100000000	38	011	Bowman County, ND	2011	NA	1876	1835	41	2.2
CN3801300000000	38	013	Burke County, ND	2011	NA	1235	1206	29	2.3
CN3801500000000	38	015	Burleigh County, ND	2011	NA	46730	45210	1520	3.3
CN3801700000000	38	017	Cass County, ND	2011	NA	89620	86697	2923	3.3
CN3801900000000	38	019	Cavalier County, ND	2011	NA	2249	2181	68	3
CN3802100000000	38	021	Dickey County, ND	2011	NA	2823	2741	82	2.9
CN3802300000000	38	023	Divide County, ND	2011	NA	1579	1551	28	1.8
CN3802500000000	38	025	Dunn County, ND	2011	NA	2929	2868	61	2.1
CN3802700000000	38	027	Eddy County, ND	2011	NA	1273	1210	63	4.9
CN3802900000000	38	029	Emmons County, ND	2011	NA	1771	1664	107	6
CN3803100000000	38	031	Foster County, ND	2011	NA	1766	1710	56	3.2
CN3803300000000	38	033	Golden Valley County, ND	2011	NA	980	956	24	2.4
CN3803500000000	38	035	Grand Forks County, ND	2011	NA	37731	36342	1389	3.7
CN3803700000000	38	037	Grant County, ND	2011	NA	1392	1343	49	3.5
CN3803900000000	38	039	Griggs County, ND	2011	NA	1267	1229	38	3
CN3804100000000	38	041	Hettinger County, ND	2011	NA	1489	1446	43	2.9
CN3804300000000	38	043	Kidder County, ND	2011	NA	1357	1286	71	5.2
CN3804500000000	38	045	LaMoure County, ND	2011	NA	2398	2326	72	3
CN3804700000000	38	047	Logan County, ND	2011	NA	978	948	30	3.1
CN3804900000000	38	049	McHenry County, ND	2011	NA	3326	3172	154	4.6
CN3805100000000	38	051	McIntosh County, ND	2011	NA	1309	1260	49	3.7
CN3805300000000	38	053	McKenzie County, ND	2011	NA	4620	4537	83	1.8
CN3805500000000	38	055	McLean County, ND	2011	NA	4982	4746	236	4.7
CN3805700000000	38	057	Mercer County, ND	2011	NA	4142	3918	224	5.4
CN3805900000000	38	059	Morton County, ND	2011	NA	15833	15197	636	4
CN3806100000000	38	061	Mountrail County, ND	2011	NA	6500	6360	140	2.2
CN3806300000000	38	063	Nelson County, ND	2011	NA	1664	1592	72	4.3
CN3806500000000	38	065	Oliver County, ND	2011	NA	925	868	57	6.2
CN3806700000000	38	067	Pembina County, ND	2011	NA	3929	3658	271	6.9
CN3806900000000	38	069	Pierce County, ND	2011	NA	1936	1843	93	4.8
CN3807100000000	38	071	Ramsey County, ND	2011	NA	6073	5841	232	3.8
CN3807300000000	38	073	Ransom County, ND	2011	NA	2879	2777	102	3.5
CN3807500000000	38	075	Renville County, ND	2011	NA	1446	1406	40	2.8
CN3807700000000	38	077	Richland County, ND	2011	NA	8883	8544	339	3.8
CN3807900000000	38	079	Rolette County, ND	2011	NA	5154	4590	564	10.9
CN3808100000000	38	081	Sargent County, ND	2011	NA	2111	2046	65	3.1
CN3808300000000	38	083	Sheridan County, ND	2011	NA	799	767	32	4
CN3808500000000	38	085	Sioux County, ND	2011	NA	1330	1258	72	5.4
CN3808700000000	38	087	Slope County, ND	2011	NA	493	483	10	2
CN3808900000000	38	089	Stark County, ND	2011	NA	16072	15719	353	2.2
CN3809100000000	38	091	Steele County, ND	2011	NA	1114	1085	29	2.6
CN3809300000000	38	093	Stutsman County, ND	2011	NA	10840	10428	412	3.8
CN3809500000000	38	095	Towner County, ND	2011	NA	1350	1309	41	3
CN3809700000000	38	097	Traill County, ND	2011	NA	4606	4438	168	3.6
CN3809900000000	38	099	Walsh County, ND	2011	NA	5968	5668	300	5
CN3810100000000	38	101	Ward County, ND	2011	NA	32491	31454	1037	3.2
CN3810300000000	38	103	Wells County, ND	2011	NA	2311	2210	101	4.4
CN3810500000000	38	105	Williams County, ND	2011	NA	20091	19807	284	1.4
CN3900100000000	39	001	Adams County, OH	2011	NA	11524	9871	1653	14.3
CN3900300000000	39	003	Allen County, OH	2011	NA	50958	46106	4852	9.5
CN3900500000000	39	005	Ashland County, OH	2011	NA	26144	23560	2584	9.9
CN3900700000000	39	007	Ashtabula County, OH	2011	NA	47581	42405	5176	10.9
CN3900900000000	39	009	Athens County, OH	2011	NA	27851	25090	2761	9.9
CN3901100000000	39	011	Auglaize County, OH	2011	NA	24128	22175	1953	8.1
CN3901300000000	39	013	Belmont County, OH	2011	NA	32286	29203	3083	9.5
CN3901500000000	39	015	Brown County, OH	2011	NA	20658	18210	2448	11.9
CN3901700000000	39	017	Butler County, OH	2011	NA	188924	171787	17137	9.1
CN3901900000000	39	019	Carroll County, OH	2011	NA	14111	12672	1439	10.2
CN3902100000000	39	021	Champaign County, OH	2011	NA	19527	17682	1845	9.4
CN3902300000000	39	023	Clark County, OH	2011	NA	67537	61130	6407	9.5
CN3902500000000	39	025	Clermont County, OH	2011	NA	103615	94143	9472	9.1
CN3902700000000	39	027	Clinton County, OH	2011	NA	18047	15611	2436	13.5
CN3902900000000	39	029	Columbiana County, OH	2011	NA	51859	46595	5264	10.2
CN3903100000000	39	031	Coshocton County, OH	2011	NA	16799	14872	1927	11.5
CN3903300000000	39	033	Crawford County, OH	2011	NA	20800	18400	2400	11.5
CN3903500000000	39	035	Cuyahoga County, OH	2011	NA	623251	576023	47228	7.6
CN3903700000000	39	037	Darke County, OH	2011	NA	26655	24188	2467	9.3
CN3903900000000	39	039	Defiance County, OH	2011	NA	19246	17389	1857	9.6
CN3904100000000	39	041	Delaware County, OH	2011	NA	95206	89265	5941	6.2
CN3904300000000	39	043	Erie County, OH	2011	NA	39811	36025	3786	9.5
CN3904500000000	39	045	Fairfield County, OH	2011	NA	73970	68017	5953	8
CN3904700000000	39	047	Fayette County, OH	2011	NA	14367	12857	1510	10.5
CN3904900000000	39	049	Franklin County, OH	2011	NA	627448	578794	48654	7.8
CN3905100000000	39	051	Fulton County, OH	2011	NA	22636	20456	2180	9.6
CN3905300000000	39	053	Gallia County, OH	2011	NA	13034	11573	1461	11.2
CN3905500000000	39	055	Geauga County, OH	2011	NA	48654	45721	2933	6
CN3905700000000	39	057	Greene County, OH	2011	NA	81800	75046	6754	8.3
CN3905900000000	39	059	Guernsey County, OH	2011	NA	18474	16475	1999	10.8
CN3906100000000	39	061	Hamilton County, OH	2011	NA	407539	371426	36113	8.9
CN3906300000000	39	063	Hancock County, OH	2011	NA	40075	36960	3115	7.8
CN3906500000000	39	065	Hardin County, OH	2011	NA	15104	13663	1441	9.5
CN3906700000000	39	067	Harrison County, OH	2011	NA	7026	6277	749	10.7
CN3906900000000	39	069	Henry County, OH	2011	NA	14399	12856	1543	10.7
CN3907100000000	39	071	Highland County, OH	2011	NA	18111	15675	2436	13.5
CN3907300000000	39	073	Hocking County, OH	2011	NA	13803	12430	1373	9.9
CN3907500000000	39	075	Holmes County, OH	2011	NA	19592	18355	1237	6.3
CN3907700000000	39	077	Huron County, OH	2011	NA	29709	26329	3380	11.4
CN3907900000000	39	079	Jackson County, OH	2011	NA	13966	12312	1654	11.8
CN3908100000000	39	081	Jefferson County, OH	2011	NA	32004	28157	3847	12
CN3908300000000	39	083	Knox County, OH	2011	NA	30505	27841	2664	8.7
CN3908500000000	39	085	Lake County, OH	2011	NA	125191	116647	8544	6.8
CN3908700000000	39	087	Lawrence County, OH	2011	NA	27088	24518	2570	9.5
CN3908900000000	39	089	Licking County, OH	2011	NA	86838	79550	7288	8.4
CN3909100000000	39	091	Logan County, OH	2011	NA	22851	20621	2230	9.8
CN3909300000000	39	093	Lorain County, OH	2011	NA	149725	137981	11744	7.8
CN3909500000000	39	095	Lucas County, OH	2011	NA	213380	192278	21102	9.9
CN3909700000000	39	097	Madison County, OH	2011	NA	20331	18723	1608	7.9
CN3909900000000	39	099	Mahoning County, OH	2011	NA	112957	101863	11094	9.8
CN3910100000000	39	101	Marion County, OH	2011	NA	29582	26662	2920	9.9
CN3910300000000	39	103	Medina County, OH	2011	NA	93801	87823	5978	6.4
CN3910500000000	39	105	Meigs County, OH	2011	NA	9814	8524	1290	13.1
CN3910700000000	39	107	Mercer County, OH	2011	NA	22180	20683	1497	6.7
CN3910900000000	39	109	Miami County, OH	2011	NA	53466	48585	4881	9.1
CN3911100000000	39	111	Monroe County, OH	2011	NA	6600	5949	651	9.9
CN3911300000000	39	113	Montgomery County, OH	2011	NA	260110	234828	25282	9.7
CN3911500000000	39	115	Morgan County, OH	2011	NA	6788	6016	772	11.4
CN3911700000000	39	117	Morrow County, OH	2011	NA	17138	15402	1736	10.1
CN3911900000000	39	119	Muskingum County, OH	2011	NA	41313	36810	4503	10.9
CN3912100000000	39	121	Noble County, OH	2011	NA	4989	4323	666	13.3
CN3912300000000	39	123	Ottawa County, OH	2011	NA	22475	19987	2488	11.1
CN3912500000000	39	125	Paulding County, OH	2011	NA	9458	8535	923	9.8
CN3912700000000	39	127	Perry County, OH	2011	NA	16427	14524	1903	11.6
CN3912900000000	39	129	Pickaway County, OH	2011	NA	25885	23505	2380	9.2
CN3913100000000	39	131	Pike County, OH	2011	NA	11035	9357	1678	15.2
CN3913300000000	39	133	Portage County, OH	2011	NA	89382	81464	7918	8.9
CN3913500000000	39	135	Preble County, OH	2011	NA	21728	19648	2080	9.6
CN3913700000000	39	137	Putnam County, OH	2011	NA	19252	17820	1432	7.4
CN3913900000000	39	139	Richland County, OH	2011	NA	58139	51964	6175	10.6
CN3914100000000	39	141	Ross County, OH	2011	NA	34318	30901	3417	10
CN3914300000000	39	143	Sandusky County, OH	2011	NA	32721	29723	2998	9.2
CN3914500000000	39	145	Scioto County, OH	2011	NA	31833	27843	3990	12.5
CN3914700000000	39	147	Seneca County, OH	2011	NA	28806	26029	2777	9.6
CN3914900000000	39	149	Shelby County, OH	2011	NA	24239	21895	2344	9.7
CN3915100000000	39	151	Stark County, OH	2011	NA	189210	171558	17652	9.3
CN3915300000000	39	153	Summit County, OH	2011	NA	276591	251471	25120	9.1
CN3915500000000	39	155	Trumbull County, OH	2011	NA	97442	87035	10407	10.7
CN3915700000000	39	157	Tuscarawas County, OH	2011	NA	45405	41189	4216	9.3
CN3915900000000	39	159	Union County, OH	2011	NA	26723	24807	1916	7.2
CN3916100000000	39	161	Van Wert County, OH	2011	NA	14541	13189	1352	9.3
CN3916300000000	39	163	Vinton County, OH	2011	NA	5733	5050	683	11.9
CN3916500000000	39	165	Warren County, OH	2011	NA	109603	100969	8634	7.9
CN3916700000000	39	167	Washington County, OH	2011	NA	29041	26123	2918	10
CN3916900000000	39	169	Wayne County, OH	2011	NA	59186	54654	4532	7.7
CN3917100000000	39	171	Williams County, OH	2011	NA	18932	16895	2037	10.8
CN3917300000000	39	173	Wood County, OH	2011	NA	68376	62697	5679	8.3
CN3917500000000	39	175	Wyandot County, OH	2011	NA	12120	11002	1118	9.2
CN4000100000000	40	001	Adair County, OK	2011	NA	8849	8039	810	9.2
CN4000300000000	40	003	Alfalfa County, OK	2011	NA	2558	2453	105	4.1
CN4000500000000	40	005	Atoka County, OK	2011	NA	5013	4585	428	8.5
CN4000700000000	40	007	Beaver County, OK	2011	NA	2952	2845	107	3.6
CN4000900000000	40	009	Beckham County, OK	2011	NA	11336	10918	418	3.7
CN4001100000000	40	011	Blaine County, OK	2011	NA	4355	4123	232	5.3
CN4001300000000	40	013	Bryan County, OK	2011	NA	17508	16471	1037	5.9
CN4001500000000	40	015	Caddo County, OK	2011	NA	11619	10795	824	7.1
CN4001700000000	40	017	Canadian County, OK	2011	NA	61519	58827	2692	4.4
CN4001900000000	40	019	Carter County, OK	2011	NA	21652	20264	1388	6.4
CN4002100000000	40	021	Cherokee County, OK	2011	NA	19236	17835	1401	7.3
CN4002300000000	40	023	Choctaw County, OK	2011	NA	6028	5486	542	9
CN4002500000000	40	025	Cimarron County, OK	2011	NA	1371	1325	46	3.4
CN4002700000000	40	027	Cleveland County, OK	2011	NA	133181	127129	6052	4.5
CN4002900000000	40	029	Coal County, OK	2011	NA	2352	2154	198	8.4
CN4003100000000	40	031	Comanche County, OK	2011	NA	50693	47787	2906	5.7
CN4003300000000	40	033	Cotton County, OK	2011	NA	2915	2738	177	6.1
CN4003500000000	40	035	Craig County, OK	2011	NA	6347	5947	400	6.3
CN4003700000000	40	037	Creek County, OK	2011	NA	31308	29105	2203	7
CN4003900000000	40	039	Custer County, OK	2011	NA	15181	14571	610	4
CN4004100000000	40	041	Delaware County, OK	2011	NA	17318	16080	1238	7.1
CN4004300000000	40	043	Dewey County, OK	2011	NA	2470	2374	96	3.9
CN4004500000000	40	045	Ellis County, OK	2011	NA	2113	2033	80	3.8
CN4004700000000	40	047	Garfield County, OK	2011	NA	28821	27546	1275	4.4
CN4004900000000	40	049	Garvin County, OK	2011	NA	12203	11494	709	5.8
CN4005100000000	40	051	Grady County, OK	2011	NA	25282	23942	1340	5.3
CN4005300000000	40	053	Grant County, OK	2011	NA	2545	2450	95	3.7
CN4005500000000	40	055	Greer County, OK	2011	NA	2144	2008	136	6.3
CN4005700000000	40	057	Harmon County, OK	2011	NA	1319	1248	71	5.4
CN4005900000000	40	059	Harper County, OK	2011	NA	1869	1800	69	3.7
CN4006100000000	40	061	Haskell County, OK	2011	NA	4677	4262	415	8.9
CN4006300000000	40	063	Hughes County, OK	2011	NA	5474	4962	512	9.4
CN4006500000000	40	065	Jackson County, OK	2011	NA	11348	10727	621	5.5
CN4006700000000	40	067	Jefferson County, OK	2011	NA	2660	2497	163	6.1
CN4006900000000	40	069	Johnston County, OK	2011	NA	3713	3397	316	8.5
CN4007100000000	40	071	Kay County, OK	2011	NA	20647	19042	1605	7.8
CN4007300000000	40	073	Kingfisher County, OK	2011	NA	7580	7286	294	3.9
CN4007500000000	40	075	Kiowa County, OK	2011	NA	4268	4048	220	5.2
CN4007700000000	40	077	Latimer County, OK	2011	NA	4436	3995	441	9.9
CN4007900000000	40	079	Le Flore County, OK	2011	NA	20136	18340	1796	8.9
CN4008100000000	40	081	Lincoln County, OK	2011	NA	15504	14658	846	5.5
CN4008300000000	40	083	Logan County, OK	2011	NA	20211	19228	983	4.9
CN4008500000000	40	085	Love County, OK	2011	NA	4915	4668	247	5
CN4008700000000	40	087	McClain County, OK	2011	NA	17256	16442	814	4.7
CN4008900000000	40	089	McCurtain County, OK	2011	NA	14754	13246	1508	10.2
CN4009100000000	40	091	McIntosh County, OK	2011	NA	7394	6611	783	10.6
CN4009300000000	40	093	Major County, OK	2011	NA	4051	3889	162	4
CN4009500000000	40	095	Marshall County, OK	2011	NA	6687	6285	402	6
CN4009700000000	40	097	Mayes County, OK	2011	NA	18145	16768	1377	7.6
CN4009900000000	40	099	Murray County, OK	2011	NA	6484	6165	319	4.9
CN4010100000000	40	101	Muskogee County, OK	2011	NA	29891	27680	2211	7.4
CN4010300000000	40	103	Noble County, OK	2011	NA	5340	5066	274	5.1
CN4010500000000	40	105	Nowata County, OK	2011	NA	4910	4518	392	8
CN4010700000000	40	107	Okfuskee County, OK	2011	NA	4420	4042	378	8.6
CN4010900000000	40	109	Oklahoma County, OK	2011	NA	357336	338450	18886	5.3
CN4011100000000	40	111	Okmulgee County, OK	2011	NA	16537	15045	1492	9
CN4011300000000	40	113	Osage County, OK	2011	NA	21263	19824	1439	6.8
CN4011500000000	40	115	Ottawa County, OK	2011	NA	14313	13234	1079	7.5
CN4011700000000	40	117	Pawnee County, OK	2011	NA	7606	7010	596	7.8
CN4011900000000	40	119	Payne County, OK	2011	NA	36823	34988	1835	5
CN4012100000000	40	121	Pittsburg County, OK	2011	NA	19051	17653	1398	7.3
CN4012300000000	40	123	Pontotoc County, OK	2011	NA	18124	17141	983	5.4
CN4012500000000	40	125	Pottawatomie County, OK	2011	NA	31369	29492	1877	6
CN4012700000000	40	127	Pushmataha County, OK	2011	NA	4952	4523	429	8.7
CN4012900000000	40	129	Roger Mills County, OK	2011	NA	1902	1841	61	3.2
CN4013100000000	40	131	Rogers County, OK	2011	NA	43070	40594	2476	5.7
CN4013300000000	40	133	Seminole County, OK	2011	NA	9974	9144	830	8.3
CN4013500000000	40	135	Sequoyah County, OK	2011	NA	17481	15871	1610	9.2
CN4013700000000	40	137	Stephens County, OK	2011	NA	20405	19214	1191	5.8
CN4013900000000	40	139	Texas County, OK	2011	NA	8837	8448	389	4.4
CN4014100000000	40	141	Tillman County, OK	2011	NA	3356	3160	196	5.8
CN4014300000000	40	143	Tulsa County, OK	2011	NA	304059	285655	18404	6.1
CN4014500000000	40	145	Wagoner County, OK	2011	NA	35134	33069	2065	5.9
CN4014700000000	40	147	Washington County, OK	2011	NA	24203	22815	1388	5.7
CN4014900000000	40	149	Washita County, OK	2011	NA	5511	5264	247	4.5
CN4015100000000	40	151	Woods County, OK	2011	NA	4490	4336	154	3.4
CN4015300000000	40	153	Woodward County, OK	2011	NA	9919	9457	462	4.7
CN4100100000000	41	001	Baker County, OR	2011	NA	7317	6523	794	10.9
CN4100300000000	41	003	Benton County, OR	2011	NA	45957	43019	2938	6.4
CN4100500000000	41	005	Clackamas County, OR	2011	NA	204119	186047	18072	8.9
CN4100700000000	41	007	Clatsop County, OR	2011	NA	19036	17243	1793	9.4
CN4100900000000	41	009	Columbia County, OR	2011	NA	23569	20906	2663	11.3
CN4101100000000	41	011	Coos County, OR	2011	NA	27968	24726	3242	11.6
CN4101300000000	41	013	Crook County, OR	2011	NA	9451	8101	1350	14.3
CN4101500000000	41	015	Curry County, OR	2011	NA	9213	8105	1108	12
CN4101700000000	41	017	Deschutes County, OR	2011	NA	80559	70657	9902	12.3
CN4101900000000	41	019	Douglas County, OR	2011	NA	47485	41453	6032	12.7
CN4102100000000	41	021	Gilliam County, OR	2011	NA	973	879	94	9.7
CN4102300000000	41	023	Grant County, OR	2011	NA	3422	2950	472	13.8
CN4102500000000	41	025	Harney County, OR	2011	NA	3727	3231	496	13.3
CN4102700000000	41	027	Hood River County, OR	2011	NA	14329	13195	1134	7.9
CN4102900000000	41	029	Jackson County, OR	2011	NA	100467	88693	11774	11.7
CN4103100000000	41	031	Jefferson County, OR	2011	NA	9598	8375	1223	12.7
CN4103300000000	41	033	Josephine County, OR	2011	NA	34489	30133	4356	12.6
CN4103500000000	41	035	Klamath County, OR	2011	NA	31289	27533	3756	12
CN4103700000000	41	037	Lake County, OR	2011	NA	3753	3261	492	13.1
CN4103900000000	41	039	Lane County, OR	2011	NA	177473	160315	17158	9.7
CN4104100000000	41	041	Lincoln County, OR	2011	NA	21942	19651	2291	10.4
CN4104300000000	41	043	Linn County, OR	2011	NA	56637	50197	6440	11.4
CN4104500000000	41	045	Malheur County, OR	2011	NA	13373	12111	1262	9.4
CN4104700000000	41	047	Marion County, OR	2011	NA	154593	138379	16214	10.5
CN4104900000000	41	049	Morrow County, OR	2011	NA	5792	5316	476	8.2
CN4105100000000	41	051	Multnomah County, OR	2011	NA	424717	389294	35423	8.3
CN4105300000000	41	053	Polk County, OR	2011	NA	36294	32929	3365	9.3
CN4105500000000	41	055	Sherman County, OR	2011	NA	920	818	102	11.1
CN4105700000000	41	057	Tillamook County, OR	2011	NA	11647	10493	1154	9.9
CN4105900000000	41	059	Umatilla County, OR	2011	NA	37378	33818	3560	9.5
CN4106100000000	41	061	Union County, OR	2011	NA	12458	11216	1242	10
CN4106300000000	41	063	Wallowa County, OR	2011	NA	3487	3061	426	12.2
CN4106500000000	41	065	Wasco County, OR	2011	NA	13905	12681	1224	8.8
CN4106700000000	41	067	Washington County, OR	2011	NA	294384	271644	22740	7.7
CN4106900000000	41	069	Wheeler County, OR	2011	NA	767	702	65	8.5
CN4107100000000	41	071	Yamhill County, OR	2011	NA	51404	46668	4736	9.2
CN4200100000000	42	001	Adams County, PA	2011	NA	54084	50472	3612	6.7
CN4200300000000	42	003	Allegheny County, PA	2011	NA	643099	597444	45655	7.1
CN4200500000000	42	005	Armstrong County, PA	2011	NA	33636	30876	2760	8.2
CN4200700000000	42	007	Beaver County, PA	2011	NA	85923	79212	6711	7.8
CN4200900000000	42	009	Bedford County, PA	2011	NA	24974	22705	2269	9.1
CN4201100000000	42	011	Berks County, PA	2011	NA	210162	193589	16573	7.9
CN4201300000000	42	013	Blair County, PA	2011	NA	61524	57041	4483	7.3
CN4201500000000	42	015	Bradford County, PA	2011	NA	32016	29943	2073	6.5
CN4201700000000	42	017	Bucks County, PA	2011	NA	336345	311783	24562	7.3
CN4201900000000	42	019	Butler County, PA	2011	NA	96649	90204	6445	6.7
CN4202100000000	42	021	Cambria County, PA	2011	NA	66183	60429	5754	8.7
CN4202300000000	42	023	Cameron County, PA	2011	NA	2510	2242	268	10.7
CN4202500000000	42	025	Carbon County, PA	2011	NA	31872	28669	3203	10
CN4202700000000	42	027	Centre County, PA	2011	NA	77399	73198	4201	5.4
CN4202900000000	42	029	Chester County, PA	2011	NA	270053	254461	15592	5.8
CN4203100000000	42	031	Clarion County, PA	2011	NA	19104	17208	1896	9.9
CN4203300000000	42	033	Clearfield County, PA	2011	NA	38042	34475	3567	9.4
CN4203500000000	42	035	Clinton County, PA	2011	NA	19181	17576	1605	8.4
CN4203700000000	42	037	Columbia County, PA	2011	NA	34787	31780	3007	8.6
CN4203900000000	42	039	Crawford County, PA	2011	NA	41532	38208	3324	8
CN4204100000000	42	041	Cumberland County, PA	2011	NA	124441	116527	7914	6.4
CN4204300000000	42	043	Dauphin County, PA	2011	NA	140468	129837	10631	7.6
CN4204500000000	42	045	Delaware County, PA	2011	NA	286908	264657	22251	7.8
CN4204700000000	42	047	Elk County, PA	2011	NA	16867	15621	1246	7.4
CN4204900000000	42	049	Erie County, PA	2011	NA	137287	126100	11187	8.1
CN4205100000000	42	051	Fayette County, PA	2011	NA	59675	53677	5998	10.1
CN4205300000000	42	053	Forest County, PA	2011	NA	2035	1843	192	9.4
CN4205500000000	42	055	Franklin County, PA	2011	NA	75529	69998	5531	7.3
CN4205700000000	42	057	Fulton County, PA	2011	NA	7352	6609	743	10.1
CN4205900000000	42	059	Greene County, PA	2011	NA	18192	16803	1389	7.6
CN4206100000000	42	061	Huntingdon County, PA	2011	NA	21006	18886	2120	10.1
CN4206300000000	42	063	Indiana County, PA	2011	NA	44025	40571	3454	7.8
CN4206500000000	42	065	Jefferson County, PA	2011	NA	21792	19890	1902	8.7
CN4206700000000	42	067	Juniata County, PA	2011	NA	12010	11126	884	7.4
CN4206900000000	42	069	Lackawanna County, PA	2011	NA	107276	97816	9460	8.8
CN4207100000000	42	071	Lancaster County, PA	2011	NA	266002	247732	18270	6.9
CN4207300000000	42	073	Lawrence County, PA	2011	NA	43051	39435	3616	8.4
CN4207500000000	42	075	Lebanon County, PA	2011	NA	69837	65004	4833	6.9
CN4207700000000	42	077	Lehigh County, PA	2011	NA	179458	163937	15521	8.6
CN4207900000000	42	079	Luzerne County, PA	2011	NA	159846	144503	15343	9.6
CN4208100000000	42	081	Lycoming County, PA	2011	NA	61092	56365	4727	7.7
CN4208300000000	42	083	McKean County, PA	2011	NA	20113	18357	1756	8.7
CN4208500000000	42	085	Mercer County, PA	2011	NA	53350	49144	4206	7.9
CN4208700000000	42	087	Mifflin County, PA	2011	NA	20998	19129	1869	8.9
CN4208900000000	42	089	Monroe County, PA	2011	NA	82201	74223	7978	9.7
CN4209100000000	42	091	Montgomery County, PA	2011	NA	430375	402423	27952	6.5
CN4209300000000	42	093	Montour County, PA	2011	NA	9191	8617	574	6.2
CN4209500000000	42	095	Northampton County, PA	2011	NA	152612	140025	12587	8.2
CN4209700000000	42	097	Northumberland County, PA	2011	NA	44957	40835	4122	9.2
CN4209900000000	42	099	Perry County, PA	2011	NA	24723	22896	1827	7.4
CN4210100000000	42	101	Philadelphia County/city, PA	2011	NA	690937	617219	73718	10.7
CN4210300000000	42	103	Pike County, PA	2011	NA	26043	23459	2584	9.9
CN4210500000000	42	105	Potter County, PA	2011	NA	7834	7117	717	9.2
CN4210700000000	42	107	Schuylkill County, PA	2011	NA	70054	63221	6833	9.8
CN4210900000000	42	109	Snyder County, PA	2011	NA	19813	18288	1525	7.7
CN4211100000000	42	111	Somerset County, PA	2011	NA	36950	33654	3296	8.9
CN4211300000000	42	113	Sullivan County, PA	2011	NA	3039	2818	221	7.3
CN4211500000000	42	115	Susquehanna County, PA	2011	NA	21927	20185	1742	7.9
CN4211700000000	42	117	Tioga County, PA	2011	NA	21194	19712	1482	7
CN4211900000000	42	119	Union County, PA	2011	NA	19063	17775	1288	6.8
CN4212100000000	42	121	Venango County, PA	2011	NA	26398	24448	1950	7.4
CN4212300000000	42	123	Warren County, PA	2011	NA	20446	18911	1535	7.5
CN4212500000000	42	125	Washington County, PA	2011	NA	105892	98109	7783	7.3
CN4212700000000	42	127	Wayne County, PA	2011	NA	23277	21389	1888	8.1
CN4212900000000	42	129	Westmoreland County, PA	2011	NA	185898	171896	14002	7.5
CN4213100000000	42	131	Wyoming County, PA	2011	NA	14330	13070	1260	8.8
CN4213300000000	42	133	York County, PA	2011	NA	230666	213373	17293	7.5
CN4400100000000	44	001	Bristol County, RI	2011	NA	26289	23764	2525	9.6
CN4400300000000	44	003	Kent County, RI	2011	NA	92730	82872	9858	10.6
CN4400500000000	44	005	Newport County, RI	2011	NA	44448	39980	4468	10.1
CN4400700000000	44	007	Providence County, RI	2011	NA	326158	288279	37879	11.6
CN4400900000000	44	009	Washington County, RI	2011	NA	70431	63352	7079	10.1
CN4500100000000	45	001	Abbeville County, SC	2011	NA	10780	9437	1343	12.5
CN4500300000000	45	003	Aiken County, SC	2011	NA	73303	66504	6799	9.3
CN4500500000000	45	005	Allendale County, SC	2011	NA	3279	2677	602	18.4
CN4500700000000	45	007	Anderson County, SC	2011	NA	85900	77037	8863	10.3
CN4500900000000	45	009	Bamberg County, SC	2011	NA	6316	5290	1026	16.2
CN4501100000000	45	011	Barnwell County, SC	2011	NA	9203	7802	1401	15.2
CN4501300000000	45	013	Beaufort County, SC	2011	NA	65469	59777	5692	8.7
CN4501500000000	45	015	Berkeley County, SC	2011	NA	85778	77572	8206	9.6
CN4501700000000	45	017	Calhoun County, SC	2011	NA	7092	6215	877	12.4
CN4501900000000	45	019	Charleston County, SC	2011	NA	183009	167780	15229	8.3
CN4502100000000	45	021	Cherokee County, SC	2011	NA	23644	20162	3482	14.7
CN4502300000000	45	023	Chester County, SC	2011	NA	14411	11914	2497	17.3
CN4502500000000	45	025	Chesterfield County, SC	2011	NA	21164	18443	2721	12.9
CN4502700000000	45	027	Clarendon County, SC	2011	NA	13640	11661	1979	14.5
CN4502900000000	45	029	Colleton County, SC	2011	NA	16662	14309	2353	14.1
CN4503100000000	45	031	Darlington County, SC	2011	NA	30450	26517	3933	12.9
CN4503300000000	45	033	Dillon County, SC	2011	NA	13654	11495	2159	15.8
CN4503500000000	45	035	Dorchester County, SC	2011	NA	67006	60998	6008	9
CN4503700000000	45	037	Edgefield County, SC	2011	NA	10913	9829	1084	9.9
CN4503900000000	45	039	Fairfield County, SC	2011	NA	10547	9016	1531	14.5
CN4504100000000	45	041	Florence County, SC	2011	NA	64430	57197	7233	11.2
CN4504300000000	45	043	Georgetown County, SC	2011	NA	25531	22063	3468	13.6
CN4504500000000	45	045	Greenville County, SC	2011	NA	224175	204795	19380	8.6
CN4504700000000	45	047	Greenwood County, SC	2011	NA	32039	28403	3636	11.3
CN4504900000000	45	049	Hampton County, SC	2011	NA	8634	7516	1118	12.9
CN4505100000000	45	051	Horry County, SC	2011	NA	132344	116578	15766	11.9
CN4505300000000	45	053	Jasper County, SC	2011	NA	10993	9904	1089	9.9
CN4505500000000	45	055	Kershaw County, SC	2011	NA	28181	25074	3107	11
CN4505700000000	45	057	Lancaster County, SC	2011	NA	34152	29600	4552	13.3
CN4505900000000	45	059	Laurens County, SC	2011	NA	30350	26823	3527	11.6
CN4506100000000	45	061	Lee County, SC	2011	NA	6880	5765	1115	16.2
CN4506300000000	45	063	Lexington County, SC	2011	NA	134344	123621	10723	8
CN4506500000000	45	065	McCormick County, SC	2011	NA	3632	3137	495	13.6
CN4506700000000	45	067	Marion County, SC	2011	NA	14164	11654	2510	17.7
CN4506900000000	45	069	Marlboro County, SC	2011	NA	10748	8632	2116	19.7
CN4507100000000	45	071	Newberry County, SC	2011	NA	18577	16653	1924	10.4
CN4507300000000	45	073	Oconee County, SC	2011	NA	33272	29935	3337	10
CN4507500000000	45	075	Orangeburg County, SC	2011	NA	40241	33877	6364	15.8
CN4507700000000	45	077	Pickens County, SC	2011	NA	54730	49326	5404	9.9
CN4507900000000	45	079	Richland County, SC	2011	NA	186481	169282	17199	9.2
CN4508100000000	45	081	Saluda County, SC	2011	NA	8672	7826	846	9.8
CN4508300000000	45	083	Spartanburg County, SC	2011	NA	133260	118717	14543	10.9
CN4508500000000	45	085	Sumter County, SC	2011	NA	44814	39405	5409	12.1
CN4508700000000	45	087	Union County, SC	2011	NA	12232	10271	1961	16
CN4508900000000	45	089	Williamsburg County, SC	2011	NA	13427	11185	2242	16.7
CN4509100000000	45	091	York County, SC	2011	NA	117004	104225	12779	10.9
CN4600300000000	46	003	Aurora County, SD	2011	NA	1667	1614	53	3.2
CN4600500000000	46	005	Beadle County, SD	2011	NA	9484	9125	359	3.8
CN4600700000000	46	007	Bennett County, SD	2011	NA	1178	1092	86	7.3
CN4600900000000	46	009	Bon Homme County, SD	2011	NA	3115	2960	155	5
CN4601100000000	46	011	Brookings County, SD	2011	NA	17871	17079	792	4.4
CN4601300000000	46	013	Brown County, SD	2011	NA	20751	19951	800	3.9
CN4601500000000	46	015	Brule County, SD	2011	NA	2709	2600	109	4
CN4601700000000	46	017	Buffalo County, SD	2011	NA	735	659	76	10.3
CN4601900000000	46	019	Butte County, SD	2011	NA	5018	4772	246	4.9
CN4602100000000	46	021	Campbell County, SD	2011	NA	870	836	34	3.9
CN4602300000000	46	023	Charles Mix County, SD	2011	NA	4124	3919	205	5
CN4602500000000	46	025	Clark County, SD	2011	NA	1944	1851	93	4.8
CN4602700000000	46	027	Clay County, SD	2011	NA	7482	7179	303	4
CN4602900000000	46	029	Codington County, SD	2011	NA	15337	14638	699	4.6
CN4603100000000	46	031	Corson County, SD	2011	NA	1533	1418	115	7.5
CN4603300000000	46	033	Custer County, SD	2011	NA	4073	3845	228	5.6
CN4603500000000	46	035	Davison County, SD	2011	NA	11047	10611	436	3.9
CN4603700000000	46	037	Day County, SD	2011	NA	3045	2846	199	6.5
CN4603900000000	46	039	Deuel County, SD	2011	NA	2513	2360	153	6.1
CN4604100000000	46	041	Dewey County, SD	2011	NA	2410	2019	391	16.2
CN4604300000000	46	043	Douglas County, SD	2011	NA	1751	1680	71	4.1
CN4604500000000	46	045	Edmunds County, SD	2011	NA	2352	2274	78	3.3
CN4604700000000	46	047	Fall River County, SD	2011	NA	3186	2995	191	6
CN4604900000000	46	049	Faulk County, SD	2011	NA	1170	1121	49	4.2
CN4605100000000	46	051	Grant County, SD	2011	NA	4615	4393	222	4.8
CN4605300000000	46	053	Gregory County, SD	2011	NA	2158	2059	99	4.6
CN4605500000000	46	055	Haakon County, SD	2011	NA	1109	1068	41	3.7
CN4605700000000	46	057	Hamlin County, SD	2011	NA	3094	2956	138	4.5
CN4605900000000	46	059	Hand County, SD	2011	NA	1861	1799	62	3.3
CN4606100000000	46	061	Hanson County, SD	2011	NA	1799	1712	87	4.8
CN4606300000000	46	063	Harding County, SD	2011	NA	820	787	33	4
CN4606500000000	46	065	Hughes County, SD	2011	NA	9961	9598	363	3.6
CN4606700000000	46	067	Hutchinson County, SD	2011	NA	3779	3634	145	3.8
CN4606900000000	46	069	Hyde County, SD	2011	NA	784	755	29	3.7
CN4607100000000	46	071	Jackson County, SD	2011	NA	1383	1279	104	7.5
CN4607300000000	46	073	Jerauld County, SD	2011	NA	1230	1186	44	3.6
CN4607500000000	46	075	Jones County, SD	2011	NA	671	649	22	3.3
CN4607700000000	46	077	Kingsbury County, SD	2011	NA	2874	2747	127	4.4
CN4607900000000	46	079	Lake County, SD	2011	NA	6186	5879	307	5
CN4608100000000	46	081	Lawrence County, SD	2011	NA	12807	12188	619	4.8
CN4608300000000	46	083	Lincoln County, SD	2011	NA	26932	25963	969	3.6
CN4608500000000	46	085	Lyman County, SD	2011	NA	1905	1783	122	6.4
CN4608700000000	46	087	McCook County, SD	2011	NA	3178	3037	141	4.4
CN4608900000000	46	089	McPherson County, SD	2011	NA	1162	1110	52	4.5
CN4609100000000	46	091	Marshall County, SD	2011	NA	2496	2356	140	5.6
CN4609300000000	46	093	Meade County, SD	2011	NA	13076	12441	635	4.9
CN4609500000000	46	095	Mellette County, SD	2011	NA	862	807	55	6.4
CN4609700000000	46	097	Miner County, SD	2011	NA	1294	1236	58	4.5
CN4609900000000	46	099	Minnehaha County, SD	2011	NA	99359	94899	4460	4.5
CN4610100000000	46	101	Moody County, SD	2011	NA	4124	3860	264	6.4
CN4610200000000	46	102	Oglala Lakota County, SD	2011	NA	3726	3198	528	14.2
CN4610300000000	46	103	Pennington County, SD	2011	NA	52984	50421	2563	4.8
CN4610500000000	46	105	Perkins County, SD	2011	NA	1569	1501	68	4.3
CN4610700000000	46	107	Potter County, SD	2011	NA	1237	1171	66	5.3
CN4610900000000	46	109	Roberts County, SD	2011	NA	5030	4692	338	6.7
CN4611100000000	46	111	Sanborn County, SD	2011	NA	1332	1276	56	4.2
CN4611500000000	46	115	Spink County, SD	2011	NA	3486	3341	145	4.2
CN4611700000000	46	117	Stanley County, SD	2011	NA	1915	1839	76	4
CN4611900000000	46	119	Sully County, SD	2011	NA	873	840	33	3.8
CN4612100000000	46	121	Todd County, SD	2011	NA	3369	3081	288	8.5
CN4612300000000	46	123	Tripp County, SD	2011	NA	3245	3123	122	3.8
CN4612500000000	46	125	Turner County, SD	2011	NA	4812	4614	198	4.1
CN4612700000000	46	127	Union County, SD	2011	NA	7644	7246	398	5.2
CN4612900000000	46	129	Walworth County, SD	2011	NA	2360	2194	166	7
CN4613500000000	46	135	Yankton County, SD	2011	NA	11411	10902	509	4.5
CN4613700000000	46	137	Ziebach County, SD	2011	NA	1059	991	68	6.4
CN4700100000000	47	001	Anderson County, TN	2011	NA	35172	32094	3078	8.8
CN4700300000000	47	003	Bedford County, TN	2011	NA	20906	18553	2353	11.3
CN4700500000000	47	005	Benton County, TN	2011	NA	7132	6319	813	11.4
CN4700700000000	47	007	Bledsoe County, TN	2011	NA	4496	3989	507	11.3
CN4700900000000	47	009	Blount County, TN	2011	NA	61745	56702	5043	8.2
CN4701100000000	47	011	Bradley County, TN	2011	NA	47447	43224	4223	8.9
CN4701300000000	47	013	Campbell County, TN	2011	NA	16122	14233	1889	11.7
CN4701500000000	47	015	Cannon County, TN	2011	NA	6093	5465	628	10.3
CN4701700000000	47	017	Carroll County, TN	2011	NA	13684	12026	1658	12.1
CN4701900000000	47	019	Carter County, TN	2011	NA	26279	23643	2636	10
CN4702100000000	47	021	Cheatham County, TN	2011	NA	20332	18608	1724	8.5
CN4702300000000	47	023	Chester County, TN	2011	NA	8531	7756	775	9.1
CN4702500000000	47	025	Claiborne County, TN	2011	NA	13685	12173	1512	11
CN4702700000000	47	027	Clay County, TN	2011	NA	3416	3054	362	10.6
CN4702900000000	47	029	Cocke County, TN	2011	NA	15778	13699	2079	13.2
CN4703100000000	47	031	Coffee County, TN	2011	NA	24717	22264	2453	9.9
CN4703300000000	47	033	Crockett County, TN	2011	NA	7327	6555	772	10.5
CN4703500000000	47	035	Cumberland County, TN	2011	NA	23832	21413	2419	10.2
CN4703700000000	47	037	Davidson County, TN	2011	NA	350092	323712	26380	7.5
CN4703900000000	47	039	Decatur County, TN	2011	NA	5331	4711	620	11.6
CN4704100000000	47	041	DeKalb County, TN	2011	NA	8223	7311	912	11.1
CN4704300000000	47	043	Dickson County, TN	2011	NA	24323	22002	2321	9.5
CN4704500000000	47	045	Dyer County, TN	2011	NA	17698	15500	2198	12.4
CN4704700000000	47	047	Fayette County, TN	2011	NA	18773	16987	1786	9.5
CN4704900000000	47	049	Fentress County, TN	2011	NA	7504	6648	856	11.4
CN4705100000000	47	051	Franklin County, TN	2011	NA	19291	17486	1805	9.4
CN4705300000000	47	053	Gibson County, TN	2011	NA	23852	21129	2723	11.4
CN4705500000000	47	055	Giles County, TN	2011	NA	14313	12886	1427	10
CN4705700000000	47	057	Grainger County, TN	2011	NA	10004	8837	1167	11.7
CN4705900000000	47	059	Greene County, TN	2011	NA	30708	27208	3500	11.4
CN4706100000000	47	061	Grundy County, TN	2011	NA	5534	4847	687	12.4
CN4706300000000	47	063	Hamblen County, TN	2011	NA	28311	25244	3067	10.8
CN4706500000000	47	065	Hamilton County, TN	2011	NA	171726	158391	13335	7.8
CN4706700000000	47	067	Hancock County, TN	2011	NA	2429	2092	337	13.9
CN4706900000000	47	069	Hardeman County, TN	2011	NA	10176	8946	1230	12.1
CN4707100000000	47	071	Hardin County, TN	2011	NA	11456	10167	1289	11.3
CN4707300000000	47	073	Hawkins County, TN	2011	NA	25738	23191	2547	9.9
CN4707500000000	47	075	Haywood County, TN	2011	NA	8503	7327	1176	13.8
CN4707700000000	47	077	Henderson County, TN	2011	NA	13586	12071	1515	11.2
CN4707900000000	47	079	Henry County, TN	2011	NA	14448	12884	1564	10.8
CN4708100000000	47	081	Hickman County, TN	2011	NA	10894	9777	1117	10.3
CN4708300000000	47	083	Houston County, TN	2011	NA	3568	3170	398	11.2
CN4708500000000	47	085	Humphreys County, TN	2011	NA	8849	7923	926	10.5
CN4708700000000	47	087	Jackson County, TN	2011	NA	4749	4194	555	11.7
CN4708900000000	47	089	Jefferson County, TN	2011	NA	24314	21765	2549	10.5
CN4709100000000	47	091	Johnson County, TN	2011	NA	7529	6660	869	11.5
CN4709300000000	47	093	Knox County, TN	2011	NA	233360	217245	16115	6.9
CN4709500000000	47	095	Lake County, TN	2011	NA	2198	1933	265	12.1
CN4709700000000	47	097	Lauderdale County, TN	2011	NA	10648	9325	1323	12.4
CN4709900000000	47	099	Lawrence County, TN	2011	NA	19253	17245	2008	10.4
CN4710100000000	47	101	Lewis County, TN	2011	NA	5255	4576	679	12.9
CN4710300000000	47	103	Lincoln County, TN	2011	NA	15771	14722	1049	6.7
CN4710500000000	47	105	Loudon County, TN	2011	NA	22586	20633	1953	8.6
CN4710700000000	47	107	McMinn County, TN	2011	NA	23065	20491	2574	11.2
CN4710900000000	47	109	McNairy County, TN	2011	NA	10403	9226	1177	11.3
CN4711100000000	47	111	Macon County, TN	2011	NA	10338	9277	1061	10.3
CN4711300000000	47	113	Madison County, TN	2011	NA	49066	44498	4568	9.3
CN4711500000000	47	115	Marion County, TN	2011	NA	12513	11205	1308	10.5
CN4711700000000	47	117	Marshall County, TN	2011	NA	14431	12781	1650	11.4
CN4711900000000	47	119	Maury County, TN	2011	NA	41313	37081	4232	10.2
CN4712100000000	47	121	Meigs County, TN	2011	NA	4984	4388	596	12
CN4712300000000	47	123	Monroe County, TN	2011	NA	19588	17345	2243	11.5
CN4712500000000	47	125	Montgomery County, TN	2011	NA	77267	70667	6600	8.5
CN4712700000000	47	127	Moore County, TN	2011	NA	3341	3111	230	6.9
CN4712900000000	47	129	Morgan County, TN	2011	NA	8475	7560	915	10.8
CN4713100000000	47	131	Obion County, TN	2011	NA	15287	13433	1854	12.1
CN4713300000000	47	133	Overton County, TN	2011	NA	10016	8992	1024	10.2
CN4713500000000	47	135	Perry County, TN	2011	NA	3030	2676	354	11.7
CN4713700000000	47	137	Pickett County, TN	2011	NA	2434	2159	275	11.3
CN4713900000000	47	139	Polk County, TN	2011	NA	7427	6600	827	11.1
CN4714100000000	47	141	Putnam County, TN	2011	NA	34387	31327	3060	8.9
CN4714300000000	47	143	Rhea County, TN	2011	NA	13854	12294	1560	11.3
CN4714500000000	47	145	Roane County, TN	2011	NA	24447	22232	2215	9.1
CN4714700000000	47	147	Robertson County, TN	2011	NA	34127	31263	2864	8.4
CN4714900000000	47	149	Rutherford County, TN	2011	NA	144110	132654	11456	7.9
CN4715100000000	47	151	Scott County, TN	2011	NA	9144	7539	1605	17.6
CN4715300000000	47	153	Sequatchie County, TN	2011	NA	6093	5471	622	10.2
CN4715500000000	47	155	Sevier County, TN	2011	NA	49713	44746	4967	10
CN4715700000000	47	157	Shelby County, TN	2011	NA	451309	408345	42964	9.5
CN4715900000000	47	159	Smith County, TN	2011	NA	8861	7954	907	10.2
CN4716100000000	47	161	Stewart County, TN	2011	NA	5657	4955	702	12.4
CN4716300000000	47	163	Sullivan County, TN	2011	NA	74647	68445	6202	8.3
CN4716500000000	47	165	Sumner County, TN	2011	NA	84927	78236	6691	7.9
CN4716700000000	47	167	Tipton County, TN	2011	NA	28855	25878	2977	10.3
CN4716900000000	47	169	Trousdale County, TN	2011	NA	3762	3370	392	10.4
CN4717100000000	47	171	Unicoi County, TN	2011	NA	7904	7032	872	11
CN4717300000000	47	173	Union County, TN	2011	NA	7846	7048	798	10.2
CN4717500000000	47	175	Van Buren County, TN	2011	NA	2297	2028	269	11.7
CN4717700000000	47	177	Warren County, TN	2011	NA	17934	16102	1832	10.2
CN4717900000000	47	179	Washington County, TN	2011	NA	61291	56366	4925	8
CN4718100000000	47	181	Wayne County, TN	2011	NA	6812	6080	732	10.7
CN4718300000000	47	183	Weakley County, TN	2011	NA	16711	14806	1905	11.4
CN4718500000000	47	185	White County, TN	2011	NA	12485	11254	1231	9.9
CN4718700000000	47	187	Williamson County, TN	2011	NA	97414	91713	5701	5.9
CN4718900000000	47	189	Wilson County, TN	2011	NA	60063	55525	4538	7.6
CN4800100000000	48	001	Anderson County, TX	2011	NA	22194	20570	1624	7.3
CN4800300000000	48	003	Andrews County, TX	2011	NA	7794	7405	389	5
CN4800500000000	48	005	Angelina County, TX	2011	NA	38118	35107	3011	7.9
CN4800700000000	48	007	Aransas County, TX	2011	NA	9815	8954	861	8.8
CN4800900000000	48	009	Archer County, TX	2011	NA	4484	4212	272	6.1
CN4801100000000	48	011	Armstrong County, TX	2011	NA	1037	987	50	4.8
CN4801300000000	48	013	Atascosa County, TX	2011	NA	19891	18303	1588	8
CN4801500000000	48	015	Austin County, TX	2011	NA	14153	13036	1117	7.9
CN4801700000000	48	017	Bailey County, TX	2011	NA	3290	3044	246	7.5
CN4801900000000	48	019	Bandera County, TX	2011	NA	9179	8491	688	7.5
CN4802100000000	48	021	Bastrop County, TX	2011	NA	35719	32884	2835	7.9
CN4802300000000	48	023	Baylor County, TX	2011	NA	1862	1751	111	6
CN4802500000000	48	025	Bee County, TX	2011	NA	10591	9683	908	8.6
CN4802700000000	48	027	Bell County, TX	2011	NA	133465	122763	10702	8
CN4802900000000	48	029	Bexar County, TX	2011	NA	829870	770139	59731	7.2
CN4803100000000	48	031	Blanco County, TX	2011	NA	5420	5112	308	5.7
CN4803300000000	48	033	Borden County, TX	2011	NA	389	368	21	5.4
CN4803500000000	48	035	Bosque County, TX	2011	NA	8408	7709	699	8.3
CN4803700000000	48	037	Bowie County, TX	2011	NA	42338	38833	3505	8.3
CN4803900000000	48	039	Brazoria County, TX	2011	NA	158581	145857	12724	8
CN4804100000000	48	041	Brazos County, TX	2011	NA	99772	93755	6017	6
CN4804300000000	48	043	Brewster County, TX	2011	NA	4862	4592	270	5.6
CN4804500000000	48	045	Briscoe County, TX	2011	NA	722	678	44	6.1
CN4804700000000	48	047	Brooks County, TX	2011	NA	2689	2405	284	10.6
CN4804900000000	48	049	Brown County, TX	2011	NA	16378	15067	1311	8
CN4805100000000	48	051	Burleson County, TX	2011	NA	7764	7199	565	7.3
CN4805300000000	48	053	Burnet County, TX	2011	NA	20659	19265	1394	6.7
CN4805500000000	48	055	Caldwell County, TX	2011	NA	16857	15437	1420	8.4
CN4805700000000	48	057	Calhoun County, TX	2011	NA	10602	9698	904	8.5
CN4805900000000	48	059	Callahan County, TX	2011	NA	6018	5587	431	7.2
CN4806100000000	48	061	Cameron County, TX	2011	NA	165823	146773	19050	11.5
CN4806300000000	48	063	Camp County, TX	2011	NA	5679	5171	508	8.9
CN4806500000000	48	065	Carson County, TX	2011	NA	3425	3254	171	5
CN4806700000000	48	067	Cass County, TX	2011	NA	13305	11888	1417	10.7
CN4806900000000	48	069	Castro County, TX	2011	NA	4091	3886	205	5
CN4807100000000	48	071	Chambers County, TX	2011	NA	16802	15242	1560	9.3
CN4807300000000	48	073	Cherokee County, TX	2011	NA	22209	20404	1805	8.1
CN4807500000000	48	075	Childress County, TX	2011	NA	3084	2925	159	5.2
CN4807700000000	48	077	Clay County, TX	2011	NA	5516	5159	357	6.5
CN4807900000000	48	079	Cochran County, TX	2011	NA	1498	1371	127	8.5
CN4808100000000	48	081	Coke County, TX	2011	NA	1536	1448	88	5.7
CN4808300000000	48	083	Coleman County, TX	2011	NA	3400	3101	299	8.8
CN4808500000000	48	085	Collin County, TX	2011	NA	438645	409063	29582	6.7
CN4808700000000	48	087	Collingsworth County, TX	2011	NA	1307	1231	76	5.8
CN4808900000000	48	089	Colorado County, TX	2011	NA	10108	9326	782	7.7
CN4809100000000	48	091	Comal County, TX	2011	NA	54641	50881	3760	6.9
CN4809300000000	48	093	Comanche County, TX	2011	NA	5946	5505	441	7.4
CN4809500000000	48	095	Concho County, TX	2011	NA	1576	1503	73	4.6
CN4809700000000	48	097	Cooke County, TX	2011	NA	20367	19137	1230	6
CN4809900000000	48	099	Coryell County, TX	2011	NA	25663	23687	1976	7.7
CN4810100000000	48	101	Cottle County, TX	2011	NA	667	617	50	7.5
CN4810300000000	48	103	Crane County, TX	2011	NA	1919	1792	127	6.6
CN4810500000000	48	105	Crockett County, TX	2011	NA	1715	1602	113	6.6
CN4810700000000	48	107	Crosby County, TX	2011	NA	3005	2753	252	8.4
CN4810900000000	48	109	Culberson County, TX	2011	NA	1018	948	70	6.9
CN4811100000000	48	111	Dallam County, TX	2011	NA	4054	3877	177	4.4
CN4811300000000	48	113	Dallas County, TX	2011	NA	1212288	1113577	98711	8.1
CN4811500000000	48	115	Dawson County, TX	2011	NA	5223	4832	391	7.5
CN4811700000000	48	117	Deaf Smith County, TX	2011	NA	9633	9109	524	5.4
CN4811900000000	48	119	Delta County, TX	2011	NA	2632	2420	212	8.1
CN4812100000000	48	121	Denton County, TX	2011	NA	379534	354648	24886	6.6
CN4812300000000	48	123	DeWitt County, TX	2011	NA	9475	8864	611	6.4
CN4812500000000	48	125	Dickens County, TX	2011	NA	910	771	139	15.3
CN4812700000000	48	127	Dimmit County, TX	2011	NA	4913	4533	380	7.7
CN4812900000000	48	129	Donley County, TX	2011	NA	1814	1697	117	6.4
CN4813100000000	48	131	Duval County, TX	2011	NA	5210	4721	489	9.4
CN4813300000000	48	133	Eastland County, TX	2011	NA	8421	7775	646	7.7
CN4813500000000	48	135	Ector County, TX	2011	NA	72809	68356	4453	6.1
CN4813700000000	48	137	Edwards County, TX	2011	NA	991	926	65	6.6
CN4813900000000	48	139	Ellis County, TX	2011	NA	76874	70912	5962	7.8
CN4814100000000	48	141	El Paso County, TX	2011	NA	346748	313903	32845	9.5
CN4814300000000	48	143	Erath County, TX	2011	NA	20688	19438	1250	6
CN4814500000000	48	145	Falls County, TX	2011	NA	7185	6591	594	8.3
CN4814700000000	48	147	Fannin County, TX	2011	NA	15277	14016	1261	8.3
CN4814900000000	48	149	Fayette County, TX	2011	NA	12510	11788	722	5.8
CN4815100000000	48	151	Fisher County, TX	2011	NA	1941	1812	129	6.6
CN4815300000000	48	153	Floyd County, TX	2011	NA	3328	3072	256	7.7
CN4815500000000	48	155	Foard County, TX	2011	NA	667	618	49	7.3
CN4815700000000	48	157	Fort Bend County, TX	2011	NA	308363	286479	21884	7.1
CN4815900000000	48	159	Franklin County, TX	2011	NA	4756	4368	388	8.2
CN4816100000000	48	161	Freestone County, TX	2011	NA	8079	7447	632	7.8
CN4816300000000	48	163	Frio County, TX	2011	NA	7973	7455	518	6.5
CN4816500000000	48	165	Gaines County, TX	2011	NA	8508	8076	432	5.1
CN4816700000000	48	167	Galveston County, TX	2011	NA	149857	136627	13230	8.8
CN4816900000000	48	169	Garza County, TX	2011	NA	2225	2091	134	6
CN4817100000000	48	171	Gillespie County, TX	2011	NA	12447	11785	662	5.3
CN4817300000000	48	173	Glasscock County, TX	2011	NA	748	716	32	4.3
CN4817500000000	48	175	Goliad County, TX	2011	NA	3377	3158	219	6.5
CN4817700000000	48	177	Gonzales County, TX	2011	NA	9474	8891	583	6.2
CN4817900000000	48	179	Gray County, TX	2011	NA	9634	8979	655	6.8
CN4818100000000	48	181	Grayson County, TX	2011	NA	60176	55436	4740	7.9
CN4818300000000	48	183	Gregg County, TX	2011	NA	61082	56722	4360	7.1
CN4818500000000	48	185	Grimes County, TX	2011	NA	11618	10714	904	7.8
CN4818700000000	48	187	Guadalupe County, TX	2011	NA	66766	62439	4327	6.5
CN4818900000000	48	189	Hale County, TX	2011	NA	16238	15023	1215	7.5
CN4819100000000	48	191	Hall County, TX	2011	NA	1401	1279	122	8.7
CN4819300000000	48	193	Hamilton County, TX	2011	NA	3880	3634	246	6.3
CN4819500000000	48	195	Hansford County, TX	2011	NA	3047	2923	124	4.1
CN4819700000000	48	197	Hardeman County, TX	2011	NA	1873	1743	130	6.9
CN4819900000000	48	199	Hardin County, TX	2011	NA	26253	23766	2487	9.5
CN4820100000000	48	201	Harris County, TX	2011	NA	2110507	1944945	165562	7.8
CN4820300000000	48	203	Harrison County, TX	2011	NA	31521	28848	2673	8.5
CN4820500000000	48	205	Hartley County, TX	2011	NA	2813	2702	111	3.9
CN4820700000000	48	207	Haskell County, TX	2011	NA	3039	2876	163	5.4
CN4820900000000	48	209	Hays County, TX	2011	NA	83333	77746	5587	6.7
CN4821100000000	48	211	Hemphill County, TX	2011	NA	2390	2307	83	3.5
CN4821300000000	48	213	Henderson County, TX	2011	NA	35053	32068	2985	8.5
CN4821500000000	48	215	Hidalgo County, TX	2011	NA	326443	288558	37885	11.6
CN4821700000000	48	217	Hill County, TX	2011	NA	15891	14582	1309	8.2
CN4821900000000	48	219	Hockley County, TX	2011	NA	11360	10641	719	6.3
CN4822100000000	48	221	Hood County, TX	2011	NA	23627	21752	1875	7.9
CN4822300000000	48	223	Hopkins County, TX	2011	NA	16864	15625	1239	7.3
CN4822500000000	48	225	Houston County, TX	2011	NA	10660	9830	830	7.8
CN4822700000000	48	227	Howard County, TX	2011	NA	13256	12390	866	6.5
CN4822900000000	48	229	Hudspeth County, TX	2011	NA	1388	1277	111	8
CN4823100000000	48	231	Hunt County, TX	2011	NA	38438	35040	3398	8.8
CN4823300000000	48	233	Hutchinson County, TX	2011	NA	9914	9132	782	7.9
CN4823500000000	48	235	Irion County, TX	2011	NA	877	830	47	5.4
CN4823700000000	48	237	Jack County, TX	2011	NA	3715	3457	258	6.9
CN4823900000000	48	239	Jackson County, TX	2011	NA	7355	6897	458	6.2
CN4824100000000	48	241	Jasper County, TX	2011	NA	15035	13180	1855	12.3
CN4824300000000	48	243	Jeff Davis County, TX	2011	NA	1251	1189	62	5
CN4824500000000	48	245	Jefferson County, TX	2011	NA	115463	102305	13158	11.4
CN4824700000000	48	247	Jim Hogg County, TX	2011	NA	2330	2129	201	8.6
CN4824900000000	48	249	Jim Wells County, TX	2011	NA	19762	18201	1561	7.9
CN4825100000000	48	251	Johnson County, TX	2011	NA	72762	67105	5657	7.8
CN4825300000000	48	253	Jones County, TX	2011	NA	6138	5630	508	8.3
CN4825500000000	48	255	Karnes County, TX	2011	NA	4887	4508	379	7.8
CN4825700000000	48	257	Kaufman County, TX	2011	NA	51525	47390	4135	8
CN4825900000000	48	259	Kendall County, TX	2011	NA	16921	15894	1027	6.1
CN4826100000000	48	261	Kenedy County, TX	2011	NA	238	223	15	6.3
CN4826300000000	48	263	Kent County, TX	2011	NA	554	528	26	4.7
CN4826500000000	48	265	Kerr County, TX	2011	NA	21830	20375	1455	6.7
CN4826700000000	48	267	Kimble County, TX	2011	NA	2234	2095	139	6.2
CN4826900000000	48	269	King County, TX	2011	NA	288	277	11	3.8
CN4827100000000	48	271	Kinney County, TX	2011	NA	1271	1142	129	10.1
CN4827300000000	48	273	Kleberg County, TX	2011	NA	15389	14156	1233	8
CN4827500000000	48	275	Knox County, TX	2011	NA	1906	1796	110	5.8
CN4827700000000	48	277	Lamar County, TX	2011	NA	23383	21095	2288	9.8
CN4827900000000	48	279	Lamb County, TX	2011	NA	6730	6221	509	7.6
CN4828100000000	48	281	Lampasas County, TX	2011	NA	9139	8448	691	7.6
CN4828300000000	48	283	La Salle County, TX	2011	NA	3136	2926	210	6.7
CN4828500000000	48	285	Lavaca County, TX	2011	NA	9621	9049	572	5.9
CN4828700000000	48	287	Lee County, TX	2011	NA	8870	8297	573	6.5
CN4828900000000	48	289	Leon County, TX	2011	NA	7158	6537	621	8.7
CN4829100000000	48	291	Liberty County, TX	2011	NA	30785	27372	3413	11.1
CN4829300000000	48	293	Limestone County, TX	2011	NA	9576	8783	793	8.3
CN4829500000000	48	295	Lipscomb County, TX	2011	NA	1743	1663	80	4.6
CN4829700000000	48	297	Live Oak County, TX	2011	NA	5234	4923	311	5.9
CN4829900000000	48	299	Llano County, TX	2011	NA	8014	7394	620	7.7
CN4830100000000	48	301	Loving County, TX	2011	NA	66	62	4	6.1
CN4830300000000	48	303	Lubbock County, TX	2011	NA	145820	137065	8755	6
CN4830500000000	48	305	Lynn County, TX	2011	NA	3084	2881	203	6.6
CN4830700000000	48	307	McCulloch County, TX	2011	NA	4360	4102	258	5.9
CN4830900000000	48	309	McLennan County, TX	2011	NA	113365	104945	8420	7.4
CN4831100000000	48	311	McMullen County, TX	2011	NA	660	640	20	3
CN4831300000000	48	313	Madison County, TX	2011	NA	4682	4295	387	8.3
CN4831500000000	48	315	Marion County, TX	2011	NA	4423	3962	461	10.4
CN4831700000000	48	317	Martin County, TX	2011	NA	2351	2220	131	5.6
CN4831900000000	48	319	Mason County, TX	2011	NA	1965	1847	118	6
CN4832100000000	48	321	Matagorda County, TX	2011	NA	17794	15732	2062	11.6
CN4832300000000	48	323	Maverick County, TX	2011	NA	23914	20560	3354	14
CN4832500000000	48	325	Medina County, TX	2011	NA	20245	18733	1512	7.5
CN4832700000000	48	327	Menard County, TX	2011	NA	945	877	68	7.2
CN4832900000000	48	329	Midland County, TX	2011	NA	76676	73030	3646	4.8
CN4833100000000	48	331	Milam County, TX	2011	NA	10409	9350	1059	10.2
CN4833300000000	48	333	Mills County, TX	2011	NA	2173	2036	137	6.3
CN4833500000000	48	335	Mitchell County, TX	2011	NA	2943	2722	221	7.5
CN4833700000000	48	337	Montague County, TX	2011	NA	9602	8978	624	6.5
CN4833900000000	48	339	Montgomery County, TX	2011	NA	231782	215406	16376	7.1
CN4834100000000	48	341	Moore County, TX	2011	NA	11759	11192	567	4.8
CN4834300000000	48	343	Morris County, TX	2011	NA	5814	5116	698	12
CN4834500000000	48	345	Motley County, TX	2011	NA	594	553	41	6.9
CN4834700000000	48	347	Nacogdoches County, TX	2011	NA	30628	28488	2140	7
CN4834900000000	48	349	Navarro County, TX	2011	NA	23085	21215	1870	8.1
CN4835100000000	48	351	Newton County, TX	2011	NA	6040	5271	769	12.7
CN4835300000000	48	353	Nolan County, TX	2011	NA	7352	6837	515	7
CN4835500000000	48	355	Nueces County, TX	2011	NA	164278	151227	13051	7.9
CN4835700000000	48	357	Ochiltree County, TX	2011	NA	5108	4862	246	4.8
CN4835900000000	48	359	Oldham County, TX	2011	NA	980	938	42	4.3
CN4836100000000	48	361	Orange County, TX	2011	NA	39187	34675	4512	11.5
CN4836300000000	48	363	Palo Pinto County, TX	2011	NA	13481	12414	1067	7.9
CN4836500000000	48	365	Panola County, TX	2011	NA	11944	10968	976	8.2
CN4836700000000	48	367	Parker County, TX	2011	NA	57353	53403	3950	6.9
CN4836900000000	48	369	Parmer County, TX	2011	NA	5292	5057	235	4.4
CN4837100000000	48	371	Pecos County, TX	2011	NA	7199	6767	432	6
CN4837300000000	48	373	Polk County, TX	2011	NA	17651	16004	1647	9.3
CN4837500000000	48	375	Potter County, TX	2011	NA	58757	55265	3492	5.9
CN4837700000000	48	377	Presidio County, TX	2011	NA	3781	3207	574	15.2
CN4837900000000	48	379	Rains County, TX	2011	NA	5168	4744	424	8.2
CN4838100000000	48	381	Randall County, TX	2011	NA	68124	64749	3375	5
CN4838300000000	48	383	Reagan County, TX	2011	NA	2018	1930	88	4.4
CN4838500000000	48	385	Real County, TX	2011	NA	1136	1024	112	9.9
CN4838700000000	48	387	Red River County, TX	2011	NA	5493	4829	664	12.1
CN4838900000000	48	389	Reeves County, TX	2011	NA	5543	5098	445	8
CN4839100000000	48	391	Refugio County, TX	2011	NA	3419	3160	259	7.6
CN4839300000000	48	393	Roberts County, TX	2011	NA	480	456	24	5
CN4839500000000	48	395	Robertson County, TX	2011	NA	7544	6851	693	9.2
CN4839700000000	48	397	Rockwall County, TX	2011	NA	40616	37737	2879	7.1
CN4839900000000	48	399	Runnels County, TX	2011	NA	5108	4734	374	7.3
CN4840100000000	48	401	Rusk County, TX	2011	NA	24286	22576	1710	7
CN4840300000000	48	403	Sabine County, TX	2011	NA	3462	2917	545	15.7
CN4840500000000	48	405	San Augustine County, TX	2011	NA	3154	2708	446	14.1
CN4840700000000	48	407	San Jacinto County, TX	2011	NA	11367	10270	1097	9.7
CN4840900000000	48	409	San Patricio County, TX	2011	NA	30231	27295	2936	9.7
CN4841100000000	48	411	San Saba County, TX	2011	NA	2522	2369	153	6.1
CN4841300000000	48	413	Schleicher County, TX	2011	NA	1699	1603	96	5.7
CN4841500000000	48	415	Scurry County, TX	2011	NA	7407	6987	420	5.7
CN4841700000000	48	417	Shackelford County, TX	2011	NA	2007	1912	95	4.7
CN4841900000000	48	419	Shelby County, TX	2011	NA	11977	10952	1025	8.6
CN4842100000000	48	421	Sherman County, TX	2011	NA	1578	1506	72	4.6
CN4842300000000	48	423	Smith County, TX	2011	NA	102136	94189	7947	7.8
CN4842500000000	48	425	Somervell County, TX	2011	NA	4084	3767	317	7.8
CN4842700000000	48	427	Starr County, TX	2011	NA	26168	21930	4238	16.2
CN4842900000000	48	429	Stephens County, TX	2011	NA	4440	4095	345	7.8
CN4843100000000	48	431	Sterling County, TX	2011	NA	682	649	33	4.8
CN4843300000000	48	433	Stonewall County, TX	2011	NA	746	705	41	5.5
CN4843500000000	48	435	Sutton County, TX	2011	NA	1947	1815	132	6.8
CN4843700000000	48	437	Swisher County, TX	2011	NA	3152	2940	212	6.7
CN4843900000000	48	439	Tarrant County, TX	2011	NA	950514	878726	71788	7.6
CN4844100000000	48	441	Taylor County, TX	2011	NA	64678	60429	4249	6.6
CN4844300000000	48	443	Terrell County, TX	2011	NA	518	486	32	6.2
CN4844500000000	48	445	Terry County, TX	2011	NA	5853	5437	416	7.1
CN4844700000000	48	447	Throckmorton County, TX	2011	NA	873	812	61	7
CN4844900000000	48	449	Titus County, TX	2011	NA	13719	12590	1129	8.2
CN4845100000000	48	451	Tom Green County, TX	2011	NA	53262	49931	3331	6.3
CN4845300000000	48	453	Travis County, TX	2011	NA	594040	556184	37856	6.4
CN4845500000000	48	455	Trinity County, TX	2011	NA	5719	5173	546	9.5
CN4845700000000	48	457	Tyler County, TX	2011	NA	7842	6898	944	12
CN4845900000000	48	459	Upshur County, TX	2011	NA	18615	17133	1482	8
CN4846100000000	48	461	Upton County, TX	2011	NA	1571	1488	83	5.3
CN4846300000000	48	463	Uvalde County, TX	2011	NA	12144	11066	1078	8.9
CN4846500000000	48	465	Val Verde County, TX	2011	NA	20461	18625	1836	9
CN4846700000000	48	467	Van Zandt County, TX	2011	NA	23741	21848	1893	8
CN4846900000000	48	469	Victoria County, TX	2011	NA	43741	40791	2950	6.7
CN4847100000000	48	471	Walker County, TX	2011	NA	23171	21352	1819	7.9
CN4847300000000	48	473	Waller County, TX	2011	NA	20344	18677	1667	8.2
CN4847500000000	48	475	Ward County, TX	2011	NA	4940	4619	321	6.5
CN4847700000000	48	477	Washington County, TX	2011	NA	15682	14646	1036	6.6
CN4847900000000	48	479	Webb County, TX	2011	NA	107892	99885	8007	7.4
CN4848100000000	48	481	Wharton County, TX	2011	NA	21498	19723	1775	8.3
CN4848300000000	48	483	Wheeler County, TX	2011	NA	2856	2715	141	4.9
CN4848500000000	48	485	Wichita County, TX	2011	NA	59026	54960	4066	6.9
CN4848700000000	48	487	Wilbarger County, TX	2011	NA	6039	5601	438	7.3
CN4848900000000	48	489	Willacy County, TX	2011	NA	7721	6450	1271	16.5
CN4849100000000	48	491	Williamson County, TX	2011	NA	230895	215239	15656	6.8
CN4849300000000	48	493	Wilson County, TX	2011	NA	21547	20142	1405	6.5
CN4849500000000	48	495	Winkler County, TX	2011	NA	3051	2834	217	7.1
CN4849700000000	48	497	Wise County, TX	2011	NA	28152	26022	2130	7.6
CN4849900000000	48	499	Wood County, TX	2011	NA	16973	15506	1467	8.6
CN4850100000000	48	501	Yoakum County, TX	2011	NA	4165	3948	217	5.2
CN4850300000000	48	503	Young County, TX	2011	NA	8593	7978	615	7.2
CN4850500000000	48	505	Zapata County, TX	2011	NA	6467	5944	523	8.1
CN4850700000000	48	507	Zavala County, TX	2011	NA	4590	3944	646	14.1
CN4900100000000	49	001	Beaver County, UT	2011	NA	3044	2800	244	8
CN4900300000000	49	003	Box Elder County, UT	2011	NA	23186	21444	1742	7.5
CN4900500000000	49	005	Cache County, UT	2011	NA	56612	53638	2974	5.3
CN4900700000000	49	007	Carbon County, UT	2011	NA	9547	8824	723	7.6
CN4900900000000	49	009	Daggett County, UT	2011	NA	471	442	29	6.2
CN4901100000000	49	011	Davis County, UT	2011	NA	146629	137787	8842	6
CN4901300000000	49	013	Duchesne County, UT	2011	NA	8445	7882	563	6.7
CN4901500000000	49	015	Emery County, UT	2011	NA	5070	4698	372	7.3
CN4901700000000	49	017	Garfield County, UT	2011	NA	2962	2646	316	10.7
CN4901900000000	49	019	Grand County, UT	2011	NA	5317	4797	520	9.8
CN4902100000000	49	021	Iron County, UT	2011	NA	19868	18227	1641	8.3
CN4902300000000	49	023	Juab County, UT	2011	NA	4595	4219	376	8.2
CN4902500000000	49	025	Kane County, UT	2011	NA	3492	3232	260	7.4
CN4902700000000	49	027	Millard County, UT	2011	NA	6169	5842	327	5.3
CN4902900000000	49	029	Morgan County, UT	2011	NA	4245	4002	243	5.7
CN4903100000000	49	031	Piute County, UT	2011	NA	530	477	53	10
CN4903300000000	49	033	Rich County, UT	2011	NA	982	911	71	7.2
CN4903500000000	49	035	Salt Lake County, UT	2011	NA	546296	510115	36181	6.6
CN4903700000000	49	037	San Juan County, UT	2011	NA	5954	5359	595	10
CN4903900000000	49	039	Sanpete County, UT	2011	NA	11110	10235	875	7.9
CN4904100000000	49	041	Sevier County, UT	2011	NA	9502	8796	706	7.4
CN4904300000000	49	043	Summit County, UT	2011	NA	21205	19912	1293	6.1
CN4904500000000	49	045	Tooele County, UT	2011	NA	27279	25330	1949	7.1
CN4904700000000	49	047	Uintah County, UT	2011	NA	15518	14585	933	6
CN4904900000000	49	049	Utah County, UT	2011	NA	231181	216636	14545	6.3
CN4905100000000	49	051	Wasatch County, UT	2011	NA	11381	10584	797	7
CN4905300000000	49	053	Washington County, UT	2011	NA	55996	51025	4971	8.9
CN4905500000000	49	055	Wayne County, UT	2011	NA	1430	1286	144	10.1
CN4905700000000	49	057	Weber County, UT	2011	NA	112431	103607	8824	7.8
CN5000100000000	50	001	Addison County, VT	2011	NA	21099	20058	1041	4.9
CN5000300000000	50	003	Bennington County, VT	2011	NA	19956	18682	1274	6.4
CN5000500000000	50	005	Caledonia County, VT	2011	NA	16598	15552	1046	6.3
CN5000700000000	50	007	Chittenden County, VT	2011	NA	95504	91485	4019	4.2
CN5000900000000	50	009	Essex County, VT	2011	NA	3059	2803	256	8.4
CN5001100000000	50	011	Franklin County, VT	2011	NA	27902	26462	1440	5.2
CN5001300000000	50	013	Grand Isle County, VT	2011	NA	4167	3901	266	6.4
CN5001500000000	50	015	Lamoille County, VT	2011	NA	14552	13541	1011	6.9
CN5001700000000	50	017	Orange County, VT	2011	NA	16597	15711	886	5.3
CN5001900000000	50	019	Orleans County, VT	2011	NA	14169	12973	1196	8.4
CN5002100000000	50	021	Rutland County, VT	2011	NA	33287	31025	2262	6.8
CN5002300000000	50	023	Washington County, VT	2011	NA	34864	33029	1835	5.3
CN5002500000000	50	025	Windham County, VT	2011	NA	24981	23581	1400	5.6
CN5002700000000	50	027	Windsor County, VT	2011	NA	31373	29660	1713	5.5
CN5100100000000	51	001	Accomack County, VA	2011	NA	16591	15198	1393	8.4
CN5100300000000	51	003	Albemarle County, VA	2011	NA	52161	49252	2909	5.6
CN5100500000000	51	005	Alleghany County, VA	2011	NA	7908	7286	622	7.9
CN5100700000000	51	007	Amelia County, VA	2011	NA	6262	5793	469	7.5
CN5100900000000	51	009	Amherst County, VA	2011	NA	16181	15003	1178	7.3
CN5101100000000	51	011	Appomattox County, VA	2011	NA	7262	6684	578	8
CN5101300000000	51	013	Arlington County, VA	2011	NA	141853	136519	5334	3.8
CN5101500000000	51	015	Augusta County, VA	2011	NA	37430	35060	2370	6.3
CN5101700000000	51	017	Bath County, VA	2011	NA	2576	2413	163	6.3
CN5101900000000	51	019	Bedford County, VA	2011	NA	38817	36307	2510	6.5
CN5102100000000	51	021	Bland County, VA	2011	NA	2859	2647	212	7.4
CN5102300000000	51	023	Botetourt County, VA	2011	NA	17729	16689	1040	5.9
CN5102500000000	51	025	Brunswick County, VA	2011	NA	6818	6098	720	10.6
CN5102700000000	51	027	Buchanan County, VA	2011	NA	8475	7750	725	8.6
CN5102900000000	51	029	Buckingham County, VA	2011	NA	6594	5963	631	9.6
CN5103100000000	51	031	Campbell County, VA	2011	NA	27607	25629	1978	7.2
CN5103300000000	51	033	Caroline County, VA	2011	NA	14477	13175	1302	9
CN5103500000000	51	035	Carroll County, VA	2011	NA	13629	12284	1345	9.9
CN5103600000000	51	036	Charles City County, VA	2011	NA	3937	3583	354	9
CN5103700000000	51	037	Charlotte County, VA	2011	NA	5399	4871	528	9.8
CN5104100000000	51	041	Chesterfield County, VA	2011	NA	171539	159940	11599	6.8
CN5104300000000	51	043	Clarke County, VA	2011	NA	7773	7328	445	5.7
CN5104500000000	51	045	Craig County, VA	2011	NA	2481	2294	187	7.5
CN5104700000000	51	047	Culpeper County, VA	2011	NA	23397	21908	1489	6.4
CN5104900000000	51	049	Cumberland County, VA	2011	NA	4561	4212	349	7.7
CN5105100000000	51	051	Dickenson County, VA	2011	NA	5459	4920	539	9.9
CN5105300000000	51	053	Dinwiddie County, VA	2011	NA	13643	12555	1088	8
CN5105700000000	51	057	Essex County, VA	2011	NA	5699	5226	473	8.3
CN5105900000000	51	059	Fairfax County, VA	2011	NA	620197	590687	29510	4.8
CN5106100000000	51	061	Fauquier County, VA	2011	NA	36128	34138	1990	5.5
CN5106300000000	51	063	Floyd County, VA	2011	NA	8334	7806	528	6.3
CN5106500000000	51	065	Fluvanna County, VA	2011	NA	13266	12494	772	5.8
CN5106700000000	51	067	Franklin County, VA	2011	NA	27679	25608	2071	7.5
CN5106900000000	51	069	Frederick County, VA	2011	NA	43199	40397	2802	6.5
CN5107100000000	51	071	Giles County, VA	2011	NA	8274	7613	661	8
CN5107300000000	51	073	Gloucester County, VA	2011	NA	19550	18323	1227	6.3
CN5107500000000	51	075	Goochland County, VA	2011	NA	10374	9716	658	6.3
CN5107700000000	51	077	Grayson County, VA	2011	NA	7206	6424	782	10.9
CN5107900000000	51	079	Greene County, VA	2011	NA	9792	9201	591	6
CN5108100000000	51	081	Greensville County, VA	2011	NA	4581	4179	402	8.8
CN5108300000000	51	083	Halifax County, VA	2011	NA	16361	14564	1797	11
CN5108500000000	51	085	Hanover County, VA	2011	NA	54957	51675	3282	6
CN5108700000000	51	087	Henrico County, VA	2011	NA	170535	159037	11498	6.7
CN5108900000000	51	089	Henry County, VA	2011	NA	22821	19949	2872	12.6
CN5109100000000	51	091	Highland County, VA	2011	NA	1460	1378	82	5.6
CN5109300000000	51	093	Isle of Wight County, VA	2011	NA	18880	17569	1311	6.9
CN5109500000000	51	095	James City County, VA	2011	NA	32605	30618	1987	6.1
CN5109700000000	51	097	King and Queen County, VA	2011	NA	3664	3394	270	7.4
CN5109900000000	51	099	King George County, VA	2011	NA	11721	10904	817	7
CN5110100000000	51	101	King William County, VA	2011	NA	8703	8104	599	6.9
CN5110300000000	51	103	Lancaster County, VA	2011	NA	5590	5072	518	9.3
CN5110500000000	51	105	Lee County, VA	2011	NA	10229	9451	778	7.6
CN5110700000000	51	107	Loudoun County, VA	2011	NA	181515	173042	8473	4.7
CN5110900000000	51	109	Louisa County, VA	2011	NA	17943	16717	1226	6.8
CN5111100000000	51	111	Lunenburg County, VA	2011	NA	5511	5039	472	8.6
CN5111300000000	51	113	Madison County, VA	2011	NA	7223	6844	379	5.2
CN5111500000000	51	115	Mathews County, VA	2011	NA	4244	3967	277	6.5
CN5111700000000	51	117	Mecklenburg County, VA	2011	NA	14059	12599	1460	10.4
CN5111900000000	51	119	Middlesex County, VA	2011	NA	5138	4805	333	6.5
CN5112100000000	51	121	Montgomery County, VA	2011	NA	48374	45309	3065	6.3
CN5112500000000	51	125	Nelson County, VA	2011	NA	7604	7123	481	6.3
CN5112700000000	51	127	New Kent County, VA	2011	NA	10439	9770	669	6.4
CN5113100000000	51	131	Northampton County, VA	2011	NA	6364	5799	565	8.9
CN5113300000000	51	133	Northumberland County, VA	2011	NA	6031	5489	542	9
CN5113500000000	51	135	Nottoway County, VA	2011	NA	6893	6400	493	7.2
CN5113700000000	51	137	Orange County, VA	2011	NA	15788	14606	1182	7.5
CN5113900000000	51	139	Page County, VA	2011	NA	12491	11106	1385	11.1
CN5114100000000	51	141	Patrick County, VA	2011	NA	8047	7178	869	10.8
CN5114300000000	51	143	Pittsylvania County, VA	2011	NA	31169	28329	2840	9.1
CN5114500000000	51	145	Powhatan County, VA	2011	NA	13555	12708	847	6.2
CN5114700000000	51	147	Prince Edward County, VA	2011	NA	10386	9450	936	9
CN5114900000000	51	149	Prince George County, VA	2011	NA	14530	13396	1134	7.8
CN5115300000000	51	153	Prince William County, VA	2011	NA	225195	212446	12749	5.7
CN5115500000000	51	155	Pulaski County, VA	2011	NA	16880	15413	1467	8.7
CN5115700000000	51	157	Rappahannock County, VA	2011	NA	4003	3778	225	5.6
CN5115900000000	51	159	Richmond County, VA	2011	NA	4267	3982	285	6.7
CN5116100000000	51	161	Roanoke County, VA	2011	NA	49724	46896	2828	5.7
CN5116300000000	51	163	Rockbridge County, VA	2011	NA	11010	10263	747	6.8
CN5116500000000	51	165	Rockingham County, VA	2011	NA	41314	38822	2492	6
CN5116700000000	51	167	Russell County, VA	2011	NA	11942	10809	1133	9.5
CN5116900000000	51	169	Scott County, VA	2011	NA	10156	9411	745	7.3
CN5117100000000	51	171	Shenandoah County, VA	2011	NA	21084	19597	1487	7.1
CN5117300000000	51	173	Smyth County, VA	2011	NA	13750	12250	1500	10.9
CN5117500000000	51	175	Southampton County, VA	2011	NA	9441	8715	726	7.7
CN5117700000000	51	177	Spotsylvania County, VA	2011	NA	64277	59971	4306	6.7
CN5117900000000	51	179	Stafford County, VA	2011	NA	65148	61126	4022	6.2
CN5118100000000	51	181	Surry County, VA	2011	NA	3760	3442	318	8.5
CN5118300000000	51	183	Sussex County, VA	2011	NA	4381	3922	459	10.5
CN5118500000000	51	185	Tazewell County, VA	2011	NA	18195	16749	1446	7.9
CN5118700000000	51	187	Warren County, VA	2011	NA	20119	18629	1490	7.4
CN5119100000000	51	191	Washington County, VA	2011	NA	27899	25914	1985	7.1
CN5119300000000	51	193	Westmoreland County, VA	2011	NA	9402	8695	707	7.5
CN5119500000000	51	195	Wise County, VA	2011	NA	17257	15933	1324	7.7
CN5119700000000	51	197	Wythe County, VA	2011	NA	14385	13062	1323	9.2
CN5119900000000	51	199	York County, VA	2011	NA	31907	29945	1962	6.1
CN5151000000000	51	510	Alexandria city, VA	2011	NA	92505	88377	4128	4.5
CN5152000000000	51	520	Bristol city, VA	2011	NA	8098	7426	672	8.3
CN5153000000000	51	530	Buena Vista city, VA	2011	NA	3240	2944	296	9.1
CN5154000000000	51	540	Charlottesville city, VA	2011	NA	23247	21947	1300	5.6
CN5155000000000	51	550	Chesapeake city, VA	2011	NA	114650	106720	7930	6.9
CN5157000000000	51	570	Colonial Heights city, VA	2011	NA	8560	7915	645	7.5
CN5158000000000	51	580	Covington city, VA	2011	NA	2663	2413	250	9.4
CN5159000000000	51	590	Danville city, VA	2011	NA	20279	17918	2361	11.6
CN5159500000000	51	595	Emporia city, VA	2011	NA	2557	2280	277	10.8
CN5160000000000	51	600	Fairfax city, VA	2011	NA	12712	12087	625	4.9
CN5161000000000	51	610	Falls Church city, VA	2011	NA	7517	7198	319	4.2
CN5162000000000	51	620	Franklin city, VA	2011	NA	3672	3255	417	11.4
CN5163000000000	51	630	Fredericksburg city, VA	2011	NA	13068	12022	1046	8
CN5164000000000	51	640	Galax city, VA	2011	NA	3105	2784	321	10.3
CN5165000000000	51	650	Hampton city, VA	2011	NA	66445	60507	5938	8.9
CN5166000000000	51	660	Harrisonburg city, VA	2011	NA	23788	21933	1855	7.8
CN5167000000000	51	670	Hopewell city, VA	2011	NA	9911	8791	1120	11.3
CN5167800000000	51	678	Lexington city, VA	2011	NA	2293	2083	210	9.2
CN5168000000000	51	680	Lynchburg city, VA	2011	NA	35762	32878	2884	8.1
CN5168300000000	51	683	Manassas city, VA	2011	NA	21403	20099	1304	6.1
CN5168500000000	51	685	Manassas Park city, VA	2011	NA	8634	8151	483	5.6
CN5169000000000	51	690	Martinsville city, VA	2011	NA	5902	5005	897	15.2
CN5170000000000	51	700	Newport News city, VA	2011	NA	90697	83305	7392	8.2
CN5171000000000	51	710	Norfolk city, VA	2011	NA	112932	103527	9405	8.3
CN5172000000000	51	720	Norton city, VA	2011	NA	2113	1966	147	7
CN5173000000000	51	730	Petersburg city, VA	2011	NA	13714	11950	1764	12.9
CN5173500000000	51	735	Poquoson city, VA	2011	NA	6369	6005	364	5.7
CN5174000000000	51	740	Portsmouth city, VA	2011	NA	45777	41496	4281	9.4
CN5175000000000	51	750	Radford city, VA	2011	NA	8082	7401	681	8.4
CN5176000000000	51	760	Richmond city, VA	2011	NA	107647	98520	9127	8.5
CN5177000000000	51	770	Roanoke city, VA	2011	NA	49488	45492	3996	8.1
CN5177500000000	51	775	Salem city, VA	2011	NA	12834	12017	817	6.4
CN5179000000000	51	790	Staunton city, VA	2011	NA	12005	11154	851	7.1
CN5180000000000	51	800	Suffolk city, VA	2011	NA	41913	38790	3123	7.5
CN5181000000000	51	810	Virginia Beach city, VA	2011	NA	229211	215118	14093	6.1
CN5182000000000	51	820	Waynesboro city, VA	2011	NA	10176	9355	821	8.1
CN5183000000000	51	830	Williamsburg city, VA	2011	NA	6745	6138	607	9
CN5184000000000	51	840	Winchester city, VA	2011	NA	14078	13032	1046	7.4
CN5300100000000	53	001	Adams County, WA	2011	NA	8257	7425	832	10.1
CN5300300000000	53	003	Asotin County, WA	2011	NA	10051	9158	893	8.9
CN5300500000000	53	005	Benton County, WA	2011	NA	92903	85275	7628	8.2
CN5300700000000	53	007	Chelan County, WA	2011	NA	41402	37911	3491	8.4
CN5300900000000	53	009	Clallam County, WA	2011	NA	28488	25371	3117	10.9
CN5301100000000	53	011	Clark County, WA	2011	NA	211482	186816	24666	11.7
CN5301300000000	53	013	Columbia County, WA	2011	NA	1854	1680	174	9.4
CN5301500000000	53	015	Cowlitz County, WA	2011	NA	44774	39434	5340	11.9
CN5301700000000	53	017	Douglas County, WA	2011	NA	19281	17473	1808	9.4
CN5301900000000	53	019	Ferry County, WA	2011	NA	2528	2088	440	17.4
CN5302100000000	53	021	Franklin County, WA	2011	NA	38700	35199	3501	9
CN5302300000000	53	023	Garfield County, WA	2011	NA	1030	952	78	7.6
CN5302500000000	53	025	Grant County, WA	2011	NA	42786	38460	4326	10.1
CN5302700000000	53	027	Grays Harbor County, WA	2011	NA	29705	25667	4038	13.6
CN5302900000000	53	029	Island County, WA	2011	NA	32640	29678	2962	9.1
CN5303100000000	53	031	Jefferson County, WA	2011	NA	12072	10810	1262	10.5
CN5303300000000	53	033	King County, WA	2011	NA	1108889	1021048	87841	7.9
CN5303500000000	53	035	Kitsap County, WA	2011	NA	117324	107470	9854	8.4
CN5303700000000	53	037	Kittitas County, WA	2011	NA	20765	18841	1924	9.3
CN5303900000000	53	039	Klickitat County, WA	2011	NA	10157	8958	1199	11.8
CN5304100000000	53	041	Lewis County, WA	2011	NA	32542	28390	4152	12.8
CN5304300000000	53	043	Lincoln County, WA	2011	NA	5298	4868	430	8.1
CN5304500000000	53	045	Mason County, WA	2011	NA	23792	21005	2787	11.7
CN5304700000000	53	047	Okanogan County, WA	2011	NA	21338	19145	2193	10.3
CN5304900000000	53	049	Pacific County, WA	2011	NA	8220	7114	1106	13.5
CN5305100000000	53	051	Pend Oreille County, WA	2011	NA	4862	4181	681	14
CN5305300000000	53	053	Pierce County, WA	2011	NA	386867	347772	39095	10.1
CN5305500000000	53	055	San Juan County, WA	2011	NA	8063	7479	584	7.2
CN5305700000000	53	057	Skagit County, WA	2011	NA	57143	51131	6012	10.5
CN5305900000000	53	059	Skamania County, WA	2011	NA	5083	4463	620	12.2
CN5306100000000	53	061	Snohomish County, WA	2011	NA	384100	347747	36353	9.5
CN5306300000000	53	063	Spokane County, WA	2011	NA	230795	208508	22287	9.7
CN5306500000000	53	065	Stevens County, WA	2011	NA	18296	16036	2260	12.4
CN5306700000000	53	067	Thurston County, WA	2011	NA	123314	112238	11076	9
CN5306900000000	53	069	Wahkiakum County, WA	2011	NA	1429	1224	205	14.3
CN5307100000000	53	071	Walla Walla County, WA	2011	NA	29623	27252	2371	8
CN5307300000000	53	073	Whatcom County, WA	2011	NA	102742	93482	9260	9
CN5307500000000	53	075	Whitman County, WA	2011	NA	22511	21051	1460	6.5
CN5307700000000	53	077	Yakima County, WA	2011	NA	120326	107392	12934	10.7
CN5400100000000	54	001	Barbour County, WV	2011	NA	6777	6142	635	9.4
CN5400300000000	54	003	Berkeley County, WV	2011	NA	51211	47258	3953	7.7
CN5400500000000	54	005	Boone County, WV	2011	NA	8680	7980	700	8.1
CN5400700000000	54	007	Braxton County, WV	2011	NA	5497	4885	612	11.1
CN5400900000000	54	009	Brooke County, WV	2011	NA	10713	9667	1046	9.8
CN5401100000000	54	011	Cabell County, WV	2011	NA	42919	39853	3066	7.1
CN5401300000000	54	013	Calhoun County, WV	2011	NA	2867	2504	363	12.7
CN5401500000000	54	015	Clay County, WV	2011	NA	3573	3132	441	12.3
CN5401700000000	54	017	Doddridge County, WV	2011	NA	3325	3088	237	7.1
CN5401900000000	54	019	Fayette County, WV	2011	NA	17734	16146	1588	9
CN5402100000000	54	021	Gilmer County, WV	2011	NA	2815	2586	229	8.1
CN5402300000000	54	023	Grant County, WV	2011	NA	6190	5634	556	9
CN5402500000000	54	025	Greenbrier County, WV	2011	NA	15567	14268	1299	8.3
CN5402700000000	54	027	Hampshire County, WV	2011	NA	9800	8934	866	8.8
CN5402900000000	54	029	Hancock County, WV	2011	NA	13894	12420	1474	10.6
CN5403100000000	54	031	Hardy County, WV	2011	NA	5693	5095	598	10.5
CN5403300000000	54	033	Harrison County, WV	2011	NA	31381	29143	2238	7.1
CN5403500000000	54	035	Jackson County, WV	2011	NA	12018	10783	1235	10.3
CN5403700000000	54	037	Jefferson County, WV	2011	NA	27221	25523	1698	6.2
CN5403900000000	54	039	Kanawha County, WV	2011	NA	91673	85161	6512	7.1
CN5404100000000	54	041	Lewis County, WV	2011	NA	7171	6636	535	7.5
CN5404300000000	54	043	Lincoln County, WV	2011	NA	7678	6860	818	10.7
CN5404500000000	54	045	Logan County, WV	2011	NA	12913	11764	1149	8.9
CN5404700000000	54	047	McDowell County, WV	2011	NA	6671	5875	796	11.9
CN5404900000000	54	049	Marion County, WV	2011	NA	26740	24902	1838	6.9
CN5405100000000	54	051	Marshall County, WV	2011	NA	14338	13056	1282	8.9
CN5405300000000	54	053	Mason County, WV	2011	NA	11051	9846	1205	10.9
CN5405500000000	54	055	Mercer County, WV	2011	NA	23732	21694	2038	8.6
CN5405700000000	54	057	Mineral County, WV	2011	NA	12183	11106	1077	8.8
CN5405900000000	54	059	Mingo County, WV	2011	NA	9201	8410	791	8.6
CN5406100000000	54	061	Monongalia County, WV	2011	NA	48549	45850	2699	5.6
CN5406300000000	54	063	Monroe County, WV	2011	NA	5781	5322	459	7.9
CN5406500000000	54	065	Morgan County, WV	2011	NA	7588	6958	630	8.3
CN5406700000000	54	067	Nicholas County, WV	2011	NA	10952	9954	998	9.1
CN5406900000000	54	069	Ohio County, WV	2011	NA	21324	19763	1561	7.3
CN5407100000000	54	071	Pendleton County, WV	2011	NA	3648	3385	263	7.2
CN5407300000000	54	073	Pleasants County, WV	2011	NA	2918	2633	285	9.8
CN5407500000000	54	075	Pocahontas County, WV	2011	NA	3684	3275	409	11.1
CN5407700000000	54	077	Preston County, WV	2011	NA	14635	13519	1116	7.6
CN5407900000000	54	079	Putnam County, WV	2011	NA	26290	24366	1924	7.3
CN5408100000000	54	081	Raleigh County, WV	2011	NA	33020	30644	2376	7.2
CN5408300000000	54	083	Randolph County, WV	2011	NA	12083	10906	1177	9.7
CN5408500000000	54	085	Ritchie County, WV	2011	NA	4310	3918	392	9.1
CN5408700000000	54	087	Roane County, WV	2011	NA	5412	4712	700	12.9
CN5408900000000	54	089	Summers County, WV	2011	NA	4693	4258	435	9.3
CN5409100000000	54	091	Taylor County, WV	2011	NA	7430	6878	552	7.4
CN5409300000000	54	093	Tucker County, WV	2011	NA	3225	2922	303	9.4
CN5409500000000	54	095	Tyler County, WV	2011	NA	3601	3222	379	10.5
CN5409700000000	54	097	Upshur County, WV	2011	NA	10239	9351	888	8.7
CN5409900000000	54	099	Wayne County, WV	2011	NA	16504	15157	1347	8.2
CN5410100000000	54	101	Webster County, WV	2011	NA	3632	3289	343	9.4
CN5410300000000	54	103	Wetzel County, WV	2011	NA	7043	6297	746	10.6
CN5410500000000	54	105	Wirt County, WV	2011	NA	2278	2015	263	11.5
CN5410700000000	54	107	Wood County, WV	2011	NA	38647	35451	3196	8.3
CN5410900000000	54	109	Wyoming County, WV	2011	NA	8313	7581	732	8.8
CN5500100000000	55	001	Adams County, WI	2011	NA	9062	7993	1069	11.8
CN5500300000000	55	003	Ashland County, WI	2011	NA	8310	7465	845	10.2
CN5500500000000	55	005	Barron County, WI	2011	NA	23753	21738	2015	8.5
CN5500700000000	55	007	Bayfield County, WI	2011	NA	7747	6912	835	10.8
CN5500900000000	55	009	Brown County, WI	2011	NA	137599	127695	9904	7.2
CN5501100000000	55	011	Buffalo County, WI	2011	NA	6954	6474	480	6.9
CN5501300000000	55	013	Burnett County, WI	2011	NA	7584	6804	780	10.3
CN5501500000000	55	015	Calumet County, WI	2011	NA	27522	25887	1635	5.9
CN5501700000000	55	017	Chippewa County, WI	2011	NA	33386	30798	2588	7.8
CN5501900000000	55	019	Clark County, WI	2011	NA	17321	15866	1455	8.4
CN5502100000000	55	021	Columbia County, WI	2011	NA	31791	29282	2509	7.9
CN5502300000000	55	023	Crawford County, WI	2011	NA	8456	7674	782	9.2
CN5502500000000	55	025	Dane County, WI	2011	NA	295320	279638	15682	5.3
CN5502700000000	55	027	Dodge County, WI	2011	NA	47635	43913	3722	7.8
CN5502900000000	55	029	Door County, WI	2011	NA	15611	13742	1869	12
CN5503100000000	55	031	Douglas County, WI	2011	NA	23619	21841	1778	7.5
CN5503300000000	55	033	Dunn County, WI	2011	NA	23374	21663	1711	7.3
CN5503500000000	55	035	Eau Claire County, WI	2011	NA	57744	54035	3709	6.4
CN5503700000000	55	037	Florence County, WI	2011	NA	2211	1991	220	10
CN5503900000000	55	039	Fond du Lac County, WI	2011	NA	56215	52106	4109	7.3
CN5504100000000	55	041	Forest County, WI	2011	NA	4187	3701	486	11.6
CN5504300000000	55	043	Grant County, WI	2011	NA	27925	26028	1897	6.8
CN5504500000000	55	045	Green County, WI	2011	NA	21132	19674	1458	6.9
CN5504700000000	55	047	Green Lake County, WI	2011	NA	10386	9535	851	8.2
CN5504900000000	55	049	Iowa County, WI	2011	NA	13755	12743	1012	7.4
CN5505100000000	55	051	Iron County, WI	2011	NA	2756	2460	296	10.7
CN5505300000000	55	053	Jackson County, WI	2011	NA	10226	9409	817	8
CN5505500000000	55	055	Jefferson County, WI	2011	NA	46446	42920	3526	7.6
CN5505700000000	55	057	Juneau County, WI	2011	NA	13713	12450	1263	9.2
CN5505900000000	55	059	Kenosha County, WI	2011	NA	86210	78406	7804	9.1
CN5506100000000	55	061	Kewaunee County, WI	2011	NA	11179	10351	828	7.4
CN5506300000000	55	063	La Crosse County, WI	2011	NA	65562	61642	3920	6
CN5506500000000	55	065	Lafayette County, WI	2011	NA	9481	8875	606	6.4
CN5506700000000	55	067	Langlade County, WI	2011	NA	10064	9045	1019	10.1
CN5506900000000	55	069	Lincoln County, WI	2011	NA	15333	13824	1509	9.8
CN5507100000000	55	071	Manitowoc County, WI	2011	NA	44508	40754	3754	8.4
CN5507300000000	55	073	Marathon County, WI	2011	NA	72719	66986	5733	7.9
CN5507500000000	55	075	Marinette County, WI	2011	NA	21528	19441	2087	9.7
CN5507700000000	55	077	Marquette County, WI	2011	NA	7610	6852	758	10
CN5507800000000	55	078	Menominee County, WI	2011	NA	1603	1328	275	17.2
CN5507900000000	55	079	Milwaukee County, WI	2011	NA	477634	433298	44336	9.3
CN5508100000000	55	081	Monroe County, WI	2011	NA	23185	21481	1704	7.3
CN5508300000000	55	083	Oconto County, WI	2011	NA	21122	19093	2029	9.6
CN5508500000000	55	085	Oneida County, WI	2011	NA	18898	17118	1780	9.4
CN5508700000000	55	087	Outagamie County, WI	2011	NA	100380	93288	7092	7.1
CN5508900000000	55	089	Ozaukee County, WI	2011	NA	47453	44547	2906	6.1
CN5509100000000	55	091	Pepin County, WI	2011	NA	4100	3839	261	6.4
CN5509300000000	55	093	Pierce County, WI	2011	NA	24000	22550	1450	6
CN5509500000000	55	095	Polk County, WI	2011	NA	24149	22071	2078	8.6
CN5509700000000	55	097	Portage County, WI	2011	NA	39012	36075	2937	7.5
CN5509900000000	55	099	Price County, WI	2011	NA	7229	6582	647	9
CN5510100000000	55	101	Racine County, WI	2011	NA	100526	91435	9091	9
CN5510300000000	55	103	Richland County, WI	2011	NA	9676	8955	721	7.5
CN5510500000000	55	105	Rock County, WI	2011	NA	81191	73453	7738	9.5
CN5510700000000	55	107	Rusk County, WI	2011	NA	6888	6127	761	11
CN5510900000000	55	109	St. Croix County, WI	2011	NA	47522	44475	3047	6.4
CN5511100000000	55	111	Sauk County, WI	2011	NA	36011	33272	2739	7.6
CN5511300000000	55	113	Sawyer County, WI	2011	NA	8185	7275	910	11.1
CN5511500000000	55	115	Shawano County, WI	2011	NA	21777	19792	1985	9.1
CN5511700000000	55	117	Sheboygan County, WI	2011	NA	61058	56065	4993	8.2
CN5511900000000	55	119	Taylor County, WI	2011	NA	11298	10340	958	8.5
CN5512100000000	55	121	Trempealeau County, WI	2011	NA	16199	15124	1075	6.6
CN5512300000000	55	123	Vernon County, WI	2011	NA	15179	14122	1057	7
CN5512500000000	55	125	Vilas County, WI	2011	NA	10164	9048	1116	11
CN5512700000000	55	127	Walworth County, WI	2011	NA	56267	51773	4494	8
CN5512900000000	55	129	Washburn County, WI	2011	NA	7985	7274	711	8.9
CN5513100000000	55	131	Washington County, WI	2011	NA	75300	70133	5167	6.9
CN5513300000000	55	133	Waukesha County, WI	2011	NA	217786	203727	14059	6.5
CN5513500000000	55	135	Waupaca County, WI	2011	NA	27713	25401	2312	8.3
CN5513700000000	55	137	Waushara County, WI	2011	NA	11920	10753	1167	9.8
CN5513900000000	55	139	Winnebago County, WI	2011	NA	92407	85895	6512	7
CN5514100000000	55	141	Wood County, WI	2011	NA	40012	36676	3336	8.3
CN5600100000000	56	001	Albany County, WY	2011	NA	21832	20915	917	4.2
CN5600300000000	56	003	Big Horn County, WY	2011	NA	5741	5391	350	6.1
CN5600500000000	56	005	Campbell County, WY	2011	NA	25872	24605	1267	4.9
CN5600700000000	56	007	Carbon County, WY	2011	NA	8158	7670	488	6
CN5600900000000	56	009	Converse County, WY	2011	NA	7659	7289	370	4.8
CN5601100000000	56	011	Crook County, WY	2011	NA	3885	3696	189	4.9
CN5601300000000	56	013	Fremont County, WY	2011	NA	21212	19844	1368	6.4
CN5601500000000	56	015	Goshen County, WY	2011	NA	7641	7275	366	4.8
CN5601700000000	56	017	Hot Springs County, WY	2011	NA	2600	2468	132	5.1
CN5601900000000	56	019	Johnson County, WY	2011	NA	4517	4233	284	6.3
CN5602100000000	56	021	Laramie County, WY	2011	NA	47167	44249	2918	6.2
CN5602300000000	56	023	Lincoln County, WY	2011	NA	8740	8054	686	7.8
CN5602500000000	56	025	Natrona County, WY	2011	NA	41123	38628	2495	6.1
CN5602700000000	56	027	Niobrara County, WY	2011	NA	1395	1337	58	4.2
CN5602900000000	56	029	Park County, WY	2011	NA	16094	15164	930	5.8
CN5603100000000	56	031	Platte County, WY	2011	NA	4963	4714	249	5
CN5603300000000	56	033	Sheridan County, WY	2011	NA	16062	14951	1111	6.9
CN5603500000000	56	035	Sublette County, WY	2011	NA	5902	5632	270	4.6
CN5603700000000	56	037	Sweetwater County, WY	2011	NA	23891	22633	1258	5.3
CN5603900000000	56	039	Teton County, WY	2011	NA	13637	12614	1023	7.5
CN5604100000000	56	041	Uinta County, WY	2011	NA	10167	9537	630	6.2
CN5604300000000	56	043	Washakie County, WY	2011	NA	4591	4335	256	5.6
CN5604500000000	56	045	Weston County, WY	2011	NA	3966	3785	181	4.6
CN7200100000000	72	001	Adjuntas Municipio, PR	2011	NA	5084	4009	1075	21.1
CN7200300000000	72	003	Aguada Municipio, PR	2011	NA	13118	10516	2602	19.8
CN7200500000000	72	005	Aguadilla Municipio, PR	2011	NA	16679	13369	3310	19.8
CN7200700000000	72	007	Aguas Buenas Municipio, PR	2011	NA	7569	5990	1579	20.9
CN7200900000000	72	009	Aibonito Municipio, PR	2011	NA	7345	5879	1466	20
CN7201100000000	72	011	Anasco Municipio, PR	2011	NA	9608	7828	1780	18.5
CN7201300000000	72	013	Arecibo Municipio, PR	2011	NA	26613	21888	4725	17.8
CN7201500000000	72	015	Arroyo Municipio, PR	2011	NA	5945	4561	1384	23.3
CN7201700000000	72	017	Barceloneta Municipio, PR	2011	NA	6338	4909	1429	22.5
CN7201900000000	72	019	Barranquitas Municipio, PR	2011	NA	7952	6574	1378	17.3
CN7202100000000	72	021	Bayamon Municipio, PR	2011	NA	73797	64479	9318	12.6
CN7202300000000	72	023	Cabo Rojo Municipio, PR	2011	NA	14928	12452	2476	16.6
CN7202500000000	72	025	Caguas Municipio, PR	2011	NA	52920	44964	7956	15
CN7202700000000	72	027	Camuy Municipio, PR	2011	NA	10345	8695	1650	15.9
CN7202900000000	72	029	Canovanas Municipio, PR	2011	NA	17012	14218	2794	16.4
CN7203100000000	72	031	Carolina Municipio, PR	2011	NA	68174	59923	8251	12.1
CN7203300000000	72	033	Catano Municipio, PR	2011	NA	8929	7578	1351	15.1
CN7203500000000	72	035	Cayey Municipio, PR	2011	NA	17621	14826	2795	15.9
CN7203700000000	72	037	Ceiba Municipio, PR	2011	NA	4490	3559	931	20.7
CN7203900000000	72	039	Ciales Municipio, PR	2011	NA	4472	3382	1090	24.4
CN7204100000000	72	041	Cidra Municipio, PR	2011	NA	16957	14318	2639	15.6
CN7204300000000	72	043	Coamo Municipio, PR	2011	NA	12180	9471	2709	22.2
CN7204500000000	72	045	Comerio Municipio, PR	2011	NA	5611	4421	1190	21.2
CN7204700000000	72	047	Corozal Municipio, PR	2011	NA	10047	8267	1780	17.7
CN7204900000000	72	049	Culebra Municipio, PR	2011	NA	767	705	62	8.1
CN7205100000000	72	051	Dorado Municipio, PR	2011	NA	13086	11672	1414	10.8
CN7205300000000	72	053	Fajardo Municipio, PR	2011	NA	13186	10512	2674	20.3
CN7205400000000	72	054	Florida Municipio, PR	2011	NA	3680	2918	762	20.7
CN7205500000000	72	055	Guanica Municipio, PR	2011	NA	4929	3671	1258	25.5
CN7205700000000	72	057	Guayama Municipio, PR	2011	NA	14057	10882	3175	22.6
CN7205900000000	72	059	Guayanilla Municipio, PR	2011	NA	5910	4568	1342	22.7
CN7206100000000	72	061	Guaynabo Municipio, PR	2011	NA	39582	36423	3159	8
CN7206300000000	72	063	Gurabo Municipio, PR	2011	NA	17302	15026	2276	13.2
CN7206500000000	72	065	Hatillo Municipio, PR	2011	NA	13700	11388	2312	16.9
CN7206700000000	72	067	Hormigueros Municipio, PR	2011	NA	5949	5019	930	15.6
CN7206900000000	72	069	Humacao Municipio, PR	2011	NA	19629	15429	4200	21.4
CN7207100000000	72	071	Isabela Municipio, PR	2011	NA	12943	10411	2532	19.6
CN7207300000000	72	073	Jayuya Municipio, PR	2011	NA	4733	3820	913	19.3
CN7207500000000	72	075	Juana Diaz Municipio, PR	2011	NA	16785	13807	2978	17.7
CN7207700000000	72	077	Juncos Municipio, PR	2011	NA	13055	10653	2402	18.4
CN7207900000000	72	079	Lajas Municipio, PR	2011	NA	6258	4797	1461	23.3
CN7208100000000	72	081	Lares Municipio, PR	2011	NA	7920	6278	1642	20.7
CN7208300000000	72	083	Las Marias Municipio, PR	2011	NA	3928	3269	659	16.8
CN7208500000000	72	085	Las Piedras Municipio, PR	2011	NA	11997	9691	2306	19.2
CN7208700000000	72	087	Loiza Municipio, PR	2011	NA	9656	8200	1456	15.1
CN7208900000000	72	089	Luquillo Municipio, PR	2011	NA	7072	5600	1472	20.8
CN7209100000000	72	091	Manati Municipio, PR	2011	NA	12833	10595	2238	17.4
CN7209300000000	72	093	Maricao Municipio, PR	2011	NA	2201	1794	407	18.5
CN7209500000000	72	095	Maunabo Municipio, PR	2011	NA	3444	2577	867	25.2
CN7209700000000	72	097	Mayaguez Municipio, PR	2011	NA	26408	21525	4883	18.5
CN7209900000000	72	099	Moca Municipio, PR	2011	NA	11686	9294	2392	20.5
CN7210100000000	72	101	Morovis Municipio, PR	2011	NA	8854	7013	1841	20.8
CN7210300000000	72	103	Naguabo Municipio, PR	2011	NA	8709	7033	1676	19.2
CN7210500000000	72	105	Naranjito Municipio, PR	2011	NA	7935	6415	1520	19.2
CN7210700000000	72	107	Orocovis Municipio, PR	2011	NA	5788	4591	1197	20.7
CN7210900000000	72	109	Patillas Municipio, PR	2011	NA	5692	4222	1470	25.8
CN7211100000000	72	111	Penuelas Municipio, PR	2011	NA	7126	5514	1612	22.6
CN7211300000000	72	113	Ponce Municipio, PR	2011	NA	53626	44602	9024	16.8
CN7211500000000	72	115	Quebradillas Municipio, PR	2011	NA	6548	5273	1275	19.5
CN7211700000000	72	117	Rincon Municipio, PR	2011	NA	4907	3942	965	19.7
CN7211900000000	72	119	Rio Grande Municipio, PR	2011	NA	18180	15547	2633	14.5
CN7212100000000	72	121	Sabana Grande Municipio, PR	2011	NA	7233	5661	1572	21.7
CN7212300000000	72	123	Salinas Municipio, PR	2011	NA	9069	6704	2365	26.1
CN7212500000000	72	125	San German Municipio, PR	2011	NA	11455	9321	2134	18.6
CN7212700000000	72	127	San Juan Municipio, PR	2011	NA	148387	133606	14781	10
CN7212900000000	72	129	San Lorenzo Municipio, PR	2011	NA	12964	10677	2287	17.6
CN7213100000000	72	131	San Sebastian Municipio, PR	2011	NA	11581	8911	2670	23.1
CN7213300000000	72	133	Santa Isabel Municipio, PR	2011	NA	9783	7633	2150	22
CN7213500000000	72	135	Toa Alta Municipio, PR	2011	NA	26694	23589	3105	11.6
CN7213700000000	72	137	Toa Baja Municipio, PR	2011	NA	32616	28600	4016	12.3
CN7213900000000	72	139	Trujillo Alto Municipio, PR	2011	NA	29102	26226	2876	9.9
CN7214100000000	72	141	Utuado Municipio, PR	2011	NA	7720	6159	1561	20.2
CN7214300000000	72	143	Vega Alta Municipio, PR	2011	NA	10505	8752	1753	16.7
CN7214500000000	72	145	Vega Baja Municipio, PR	2011	NA	15293	12430	2863	18.7
CN7214700000000	72	147	Vieques Municipio, PR	2011	NA	3174	2671	503	15.8
CN7214900000000	72	149	Villalba Municipio, PR	2011	NA	8485	6681	1804	21.3
CN7215100000000	72	151	Yabucoa Municipio, PR	2011	NA	10630	7924	2706	25.5
CN7215300000000	72	153	Yauco Municipio, PR	2011	NA	11760	9263	2497	21.2
NA	NA	NA	NA	NA	NA	NA	NA	NA	NA
SOURCE:  BLS, LAUS	NA	NA	NA	NA	NA	NA	NA	NA	NA
April 17, 2020	NA	NA	NA	NA	NA	NA	NA	NA	NA
